ibge;anomes;cadunico_tot_fam;cadunico_tot_pes;cadunico_tot_fam_rpc_ate_meio_sm;cadunico_tot_pes_rpc_ate_meio_sm;cadunico_tot_fam_pob;cadunico_tot_pes_pob;cadunico_tot_fam_ext_pob;cadunico_tot_pes_ext_pob;cadunico_tot_fam_pob_e_ext_pob;cadunico_tot_pes_pob_e_ext_pob
110001;201712;3288;10291;2689;9249;710;2584;1160;4033;1870;6617
110002;201712;11537;32012;8578;26995;2678;9058;2717;8442;5395;17500
110003;201712;680;2063;516;1728;161;576;97;303;258;879
110004;201712;8304;25127;6414;21418;1944;6826;1292;4666;3236;11492
110005;201712;2097;5888;1458;4733;354;1218;538;1806;892;3024
110006;201712;1666;4882;1067;3617;313;1128;126;428;439;1556
110007;201712;1245;3595;1009;3181;331;1095;332;1214;663;2309
110008;201712;2390;7785;2167;7472;277;886;1666;5999;1943;6885
110009;201712;4133;12222;3020;10370;912;3259;914;3282;1826;6541
110010;201712;6039;20412;5075;18785;1524;5522;2151;8952;3675;14474
110011;201712;6450;19076;5091;16479;1714;5777;1206;3971;2920;9748
110012;201712;13960;38313;10244;31929;2735;8939;1962;6239;4697;15178
110013;201712;5346;16473;4398;14663;1764;6073;851;3083;2615;9156
110014;201712;3651;10145;2815;8723;842;2694;1153;3506;1995;6200
110015;201712;4731;13598;3087;10307;828;2937;420;1407;1248;4344
110018;201712;3464;9433;2321;7521;564;2082;663;2051;1227;4133
110020;201712;66257;172538;46889;145531;10514;34521;18228;60051;28742;94572
110025;201712;4363;11711;3178;9699;519;1674;1817;5449;2336;7123
110026;201712;513;1556;446;1443;130;463;189;605;319;1068
110028;201712;5970;17177;4246;13803;1265;4429;533;1698;1798;6127
110029;201712;1291;3338;867;2692;224;714;367;1153;591;1867
110030;201712;10348;27160;7506;23045;1616;5595;2994;9142;4610;14737
110032;201712;3225;9845;2481;8274;865;2931;592;1994;1457;4925
110033;201712;4388;14155;3666;12799;1325;4685;1022;3939;2347;8624
110034;201712;3315;8743;2516;7598;827;2648;1125;3419;1952;6067
110037;201712;1685;5528;1400;4945;347;1273;644;2257;991;3530
110040;201712;2986;9020;2322;7781;745;2666;626;2023;1371;4689
110045;201712;4654;14559;3956;13574;1302;4802;1575;5395;2877;10197
110050;201712;1611;4948;1275;4299;528;1835;319;1080;847;2915
110060;201712;792;2527;591;2099;212;794;67;264;279;1058
110070;201712;1907;6278;1573;5502;572;2090;387;1303;959;3393
110080;201712;4729;12521;3738;11303;1026;3244;1792;5620;2818;8864
110090;201712;637;1785;444;1431;117;405;183;562;300;967
110092;201712;1165;3619;976;3328;162;609;545;1892;707;2501
110094;201712;3111;9171;2477;8137;856;2908;799;2689;1655;5597
110100;201712;1907;5938;1651;5445;352;1253;857;2809;1209;4062
110110;201712;1557;4715;1221;4194;437;1571;274;1004;711;2575
110120;201712;1470;4528;1108;3764;329;1178;239;813;568;1991
110130;201712;2370;6361;1604;5063;413;1449;499;1554;912;3003
110140;201712;2194;7014;1671;5933;455;1703;403;1403;858;3106
110143;201712;1401;3950;1016;3221;348;1140;281;890;629;2030
110145;201712;1006;2825;663;2166;163;570;221;719;384;1289
110146;201712;415;1193;301;1013;58;190;144;510;202;700
110147;201712;643;1811;436;1405;109;362;157;477;266;839
110148;201712;1011;3061;608;2104;110;414;72;251;182;665
110149;201712;2949;8660;2171;7379;855;2858;637;2350;1492;5208
110150;201712;2122;6077;1680;5402;708;2525;390;1185;1098;3710
110155;201712;724;2256;596;1958;133;467;236;752;369;1219
110160;201712;1618;5163;1271;4434;467;1603;294;1084;761;2687
110170;201712;2282;6383;1624;5144;353;1166;790;2471;1143;3637
110175;201712;1458;4361;1151;3903;190;694;585;2086;775;2780
110180;201712;1152;3304;907;2871;269;823;389;1283;658;2106
120001;201712;2799;9034;2440;8493;502;1753;1408;5172;1910;6925
120005;201712;1709;6801;1560;6545;180;829;1158;5015;1338;5844
120010;201712;5113;16505;4512;15515;610;2049;3181;11273;3791;13322
120013;201712;2028;7997;1919;7845;511;2001;1094;4827;1605;6828
120017;201712;1982;6967;1808;6660;400;1513;996;3905;1396;5418
120020;201712;13968;60477;13321;59215;1562;7371;9850;44896;11412;52267
120025;201712;2518;8141;2228;7764;472;1677;1345;4809;1817;6486
120030;201712;6392;25253;6194;24932;338;1682;5267;21273;5605;22955
120032;201712;1579;7481;1500;7292;107;657;1174;5694;1281;6351
120033;201712;3821;14843;3624;14502;165;857;3160;12600;3325;13457
120034;201712;2237;8780;1989;8342;139;817;1555;6427;1694;7244
120035;201712;3295;14306;3182;14100;281;1440;2543;11358;2824;12798
120038;201712;2587;8980;2397;8639;596;2223;1281;4736;1877;6959
120039;201712;1825;8475;1763;8360;172;1036;1331;6335;1503;7371
120040;201712;41129;142301;37257;135764;7599;29472;20981;77851;28580;107323
120042;201712;3066;12297;2861;11843;174;915;2279;9404;2453;10319
120043;201712;1160;5223;1098;5082;64;382;945;4385;1009;4767
120045;201712;4974;15534;4595;15115;209;787;4182;13744;4391;14531
120050;201712;8279;32484;7760;31552;852;3822;5749;23895;6601;27717
120060;201712;8101;34838;7763;34235;584;3131;6387;28346;6971;31477
120070;201712;2720;9661;2571;9396;353;1273;1775;6706;2128;7979
120080;201712;3824;13920;3541;13444;610;2420;2398;9271;3008;11691
130002;201712;3117;12831;2893;12512;116;633;2592;11258;2708;11891
130006;201712;2216;8980;1896;8389;149;775;1440;6359;1589;7134
130008;201712;2384;8886;2147;8484;97;502;1789;7073;1886;7575
130010;201712;3661;10856;3233;10367;90;352;2986;9584;3076;9936
130014;201712;3071;9722;2578;8888;426;1553;1653;5777;2079;7330
130020;201712;2679;10474;2506;10181;130;758;2042;8239;2172;8997
130030;201712;8811;31057;8200;30394;170;477;7726;29159;7896;29636
130040;201712;3811;11528;3264;10811;225;769;2602;8750;2827;9519
130050;201712;6773;26143;5923;25036;234;1019;5276;22699;5510;23718
130060;201712;6741;28844;5997;27772;536;3161;4650;21472;5186;24633
130063;201712;4902;18943;4438;18398;139;710;4091;17073;4230;17783
130068;201712;3277;13197;2916;12468;225;1170;2196;9402;2421;10572
130070;201712;8164;26365;7133;25198;368;1245;6230;22523;6598;23768
130080;201712;5800;24374;5306;23699;452;2543;4188;18771;4640;21314
130083;201712;2444;9009;2224;8697;214;977;1725;6727;1939;7704
130090;201712;3099;10305;2856;9979;63;280;2572;9112;2635;9392
130100;201712;6361;22015;5886;21491;99;337;5609;20691;5708;21028
130110;201712;7042;21750;6331;20896;555;1599;5324;18100;5879;19699
130115;201712;5084;16975;4658;16402;123;469;4087;14547;4210;15016
130120;201712;14756;54956;13698;53580;1369;5591;11047;44071;12416;49662
130130;201712;4629;16600;3950;15712;469;2153;2970;11726;3439;13879
130140;201712;6396;24617;6224;24419;232;1027;5774;22717;6006;23744
130150;201712;3491;13795;3346;13604;121;722;3034;12288;3155;13010
130160;201712;4558;17872;4163;17363;329;1660;3445;14518;3774;16178
130165;201712;3010;12113;2864;11863;121;690;2503;10333;2624;11023
130170;201712;10565;33939;8781;31805;705;2798;7181;26510;7886;29308
130180;201712;3995;12765;3764;12493;54;253;3576;11849;3630;12102
130185;201712;14426;40406;11997;37796;523;1179;10533;34649;11056;35828
130190;201712;17068;58441;14645;55085;1881;7118;10487;40904;12368;48022
130195;201712;2172;8600;1898;8234;92;425;1685;7405;1777;7830
130200;201712;2101;6775;1841;6412;166;579;1428;5118;1594;5697
130210;201712;1398;5364;1264;5204;115;654;997;4028;1112;4682
130220;201712;2024;7922;1852;7619;142;712;1418;5875;1560;6587
130230;201712;3859;17522;3543;17044;350;1968;2843;13852;3193;15820
130240;201712;9816;33625;8477;31722;238;1382;7449;27917;7687;29299
130250;201712;22884;73710;20653;71143;1602;5422;17115;60553;18717;65975
130255;201712;4115;14608;3746;13992;269;1200;3013;11293;3282;12493
130260;201712;236766;743054;206146;694164;62297;223830;84503;288569;146800;512399
130270;201712;7500;30306;6766;29140;814;3727;4960;22033;5774;25760
130280;201712;3436;14132;3257;13931;83;368;3060;13254;3143;13622
130290;201712;11851;41496;10841;40349;225;545;10287;39114;10512;39659
130300;201712;4602;17089;4291;16622;229;1141;3696;14313;3925;15454
130310;201712;5468;20166;4950;19462;387;1580;4087;16358;4474;17938
130320;201712;3121;10983;2786;10533;335;1233;2026;7929;2361;9162
130330;201712;4040;13974;3508;13299;155;782;3051;11545;3206;12327
130340;201712;19887;71354;17896;68986;1530;5864;14938;59192;16468;65056
130350;201712;3675;14240;3443;13918;191;1122;2948;11777;3139;12899
130353;201712;6189;18733;5352;17655;889;2801;3686;12938;4575;15739
130356;201712;4749;16713;4295;15980;508;1989;3060;11670;3568;13659
130360;201712;3298;9663;2872;9212;87;225;2677;8724;2764;8949
130370;201712;5683;22224;5120;21463;203;1182;4409;18494;4612;19676
130380;201712;7549;31603;7230;31133;496;2637;6192;26490;6688;29127
130390;201712;5305;23540;4917;22814;531;2863;3680;17053;4211;19916
130395;201712;2330;7847;2049;7345;238;892;1463;5268;1701;6160
130400;201712;2362;8257;2082;7857;113;449;1827;6964;1940;7413
130406;201712;10851;40627;9676;39038;1796;7477;6581;27149;8377;34626
130410;201712;3990;14744;3500;13887;1040;4313;1672;6865;2712;11178
130420;201712;11605;45877;10565;44506;1151;5323;8343;35638;9494;40961
130423;201712;3762;13403;3402;12946;172;897;2955;11126;3127;12023
130426;201712;2628;10595;2507;10412;88;420;2300;9642;2388;10062
130430;201712;3843;12487;3548;12077;422;1415;2757;9555;3179;10970
130440;201712;4133;13824;3749;13371;103;399;3473;12488;3576;12887
140002;201712;1820;5786;1636;5553;113;476;1284;4303;1397;4779
140005;201712;3385;9351;3217;9170;102;312;3036;8655;3138;8967
140010;201712;49304;139169;39576;125020;9894;32883;15414;51922;25308;84805
140015;201712;3261;10268;2951;9901;186;611;2544;8699;2730;9310
140017;201712;3389;10816;3026;10337;301;1009;2252;8061;2553;9070
140020;201712;4826;15286;4200;14443;396;1619;3156;10836;3552;12455
140023;201712;2201;7101;1864;6588;245;906;1300;4684;1545;5590
140028;201712;2061;5565;1815;5241;204;672;1366;3844;1570;4516
140030;201712;3930;11793;3561;11319;390;1119;2796;9136;3186;10255
140040;201712;1895;8354;1793;8213;86;506;1630;7445;1716;7951
140045;201712;2589;9637;2222;9110;413;1652;1438;6283;1851;7935
140047;201712;6015;18097;5138;16730;1100;3627;2768;9514;3868;13141
140050;201712;1422;4331;1219;4032;156;500;825;2800;981;3300
140060;201712;1410;4077;1256;3853;120;356;1001;3107;1121;3463
140070;201712;1731;9438;1674;9281;151;1048;1300;7181;1451;8229
150010;201712;39710;107434;36857;103615;1583;5171;31864;88974;33447;94145
150013;201712;1786;5018;1528;4726;136;385;1147;3685;1283;4070
150020;201712;12839;41923;12261;41135;1328;3539;10084;35226;11412;38765
150030;201712;8373;33052;7769;32294;431;1848;6773;28545;7204;30393
150034;201712;4069;11123;3543;10385;265;814;2890;8523;3155;9337
150040;201712;13130;39430;11531;37580;1106;2808;9391;32524;10497;35332
150050;201712;6303;23445;5899;22843;172;892;5319;20629;5491;21521
150060;201712;18612;55675;16282;52065;3712;11726;9044;30258;12756;41984
150070;201712;6288;24867;5642;24144;179;963;5179;22401;5358;23364
150080;201712;80728;201324;68523;185201;15786;43997;28466;84860;44252;128857
150085;201712;6013;19443;5569;18893;264;779;5035;17381;5299;18160
150090;201712;10148;38661;9600;37789;760;3271;7648;30372;8408;33643
150095;201712;5418;17197;4890;16467;297;917;4010;13878;4307;14795
150100;201712;3180;11384;2852;10799;225;894;2179;8274;2404;9168
150110;201712;3751;17357;3689;17275;219;1048;3294;15626;3513;16674
150120;201712;6965;24137;6767;23847;335;994;5924;21529;6259;22523
150125;201712;742;2067;618;1913;113;395;375;1140;488;1535
150130;201712;22424;66844;20105;63546;2561;7358;14515;47577;17076;54935
150140;201712;186333;488514;167705;463898;25343;68894;110639;316061;135982;384955
150145;201712;4621;14085;4072;13347;614;1811;3019;10299;3633;12110
150150;201712;12965;37157;11859;35653;1263;3931;8872;27044;10135;30975
150157;201712;3166;9230;2673;8573;312;1097;1846;6056;2158;7153
150160;201712;2993;9345;2805;9040;682;2182;1569;5222;2251;7404
150170;201712;23935;80927;21167;76637;3646;12790;13307;51208;16953;63998
150172;201712;3599;11133;3015;10251;298;957;2244;7883;2542;8840
150175;201712;1779;5462;1599;5184;148;549;1215;3986;1363;4535
150178;201712;10024;29230;8418;27302;574;1916;6762;22485;7336;24401
150180;201712;19890;76776;18760;75320;1040;4425;16259;66208;17299;70633
150190;201712;6925;23763;6617;23361;210;903;5998;21245;6208;22148
150195;201712;5493;17540;5208;17094;109;400;4785;15736;4894;16136
150200;201712;5453;16678;5040;16212;68;196;4784;15537;4852;15733
150210;201712;24885;91567;23758;90059;1941;7277;19352;75655;21293;82932
150215;201712;7436;22761;6481;21296;2094;6958;2605;9061;4699;16019
150220;201712;10886;33273;9770;31585;1922;6122;5529;18678;7451;24800
150230;201712;12344;36774;10713;34580;1622;5038;7131;24256;8753;29294
150240;201712;32992;96239;27657;86721;9348;30057;7156;23371;16504;53428
150250;201712;4186;17084;4009;16818;637;2688;2918;12599;3555;15287
150260;201712;2235;8213;2107;8007;257;979;1521;5899;1778;6878
150270;201712;8143;23909;6101;21142;1851;6574;2536;9325;4387;15899
150275;201712;6114;21196;5698;20570;446;1664;4561;16627;5007;18291
150276;201712;2247;6434;1943;6066;278;862;1431;4635;1709;5497
150277;201712;4948;14074;4182;13161;462;1353;3175;10533;3637;11886
150280;201712;6055;26510;5882;26154;557;2456;4717;21336;5274;23792
150285;201712;3134;11580;2831;11119;324;1387;1962;7854;2286;9241
150290;201712;10488;28926;9732;28100;578;1269;8559;25577;9137;26846
150293;201712;9852;24883;7089;21206;1938;5905;2841;9411;4779;15316
150295;201712;7624;21114;5969;19161;1776;5695;2803;10227;4579;15922
150300;201712;2037;6578;1869;6350;70;349;1576;5336;1646;5685
150304;201712;4119;12992;3578;12114;633;2094;2265;7993;2898;10087
150307;201712;6410;21003;6018;20433;359;1176;5097;17515;5456;18691
150309;201712;5992;19555;5148;18174;1276;4386;2519;9536;3795;13922
150310;201712;6615;27238;6260;26764;343;1737;5379;23174;5722;24911
150320;201712;9410;25112;8600;24092;544;1490;6892;19514;7436;21004
150330;201712;14233;47082;13231;45561;1785;6254;9632;34014;11417;40268
150340;201712;2680;8021;2437;7664;252;745;1803;5801;2055;6546
150345;201712;7307;22797;6665;21951;520;1804;5441;18158;5961;19962
150350;201712;8255;23894;7695;23211;930;2245;6090;19173;7020;21418
150360;201712;22414;65917;18605;61200;2522;7884;12793;43937;15315;51821
150370;201712;9548;33255;8523;31838;841;3077;6415;24870;7256;27947
150375;201712;3091;13247;2804;12785;332;1581;2195;10126;2527;11707
150380;201712;9651;27190;8242;25243;426;1329;6911;21488;7337;22817
150390;201712;7702;32967;7145;31964;1191;5067;4843;22640;6034;27707
150400;201712;6008;22887;5747;22389;362;1431;4738;18664;5100;20095
150405;201712;8420;24194;7504;23083;518;1270;6026;19347;6544;20617
150410;201712;1734;6110;1550;5770;238;903;971;3688;1209;4591
150420;201712;34187;108546;27646;98291;9529;35559;7457;30482;16986;66041
150430;201712;7686;24639;7257;24021;771;2388;5646;19253;6417;21641
150440;201712;5535;18488;5246;18076;382;1251;4350;15251;4732;16502
150442;201712;22148;61090;19231;56823;2922;8496;11908;36577;14830;45073
150445;201712;5619;18693;5097;17853;334;1178;4154;14760;4488;15938
150450;201712;4632;21229;4404;20885;388;1953;3652;17527;4040;19480
150460;201712;7823;26715;7192;25925;263;1145;6175;23029;6438;24174
150470;201712;17894;53263;16912;52094;1169;3114;14704;46174;15873;49288
150475;201712;4143;13971;3749;13381;250;922;3039;11079;3289;12001
150480;201712;13944;47397;12601;45275;1893;6730;8907;33162;10800;39892
150490;201712;7667;28078;7289;27581;220;1065;6523;24757;6743;25822
150495;201712;4992;18106;4841;17909;137;568;4483;16672;4620;17240
150497;201712;2517;8843;2190;8251;610;2369;1029;4064;1639;6433
150500;201712;3221;8666;2911;8205;327;863;2250;6400;2577;7263
150503;201712;3980;11744;3085;10458;991;3408;1267;4655;2258;8063
150506;201712;10303;34390;9205;32838;2012;6687;5724;22002;7736;28689
150510;201712;9910;37434;8792;35217;1370;5244;5717;24224;7087;29468
150520;201712;6936;26966;6827;26827;178;789;6430;25385;6608;26174
150530;201712;12518;42766;11059;40488;1384;4316;8135;31178;9519;35494
150540;201712;4656;13714;4050;12815;196;635;3420;10840;3616;11475
150543;201712;6334;18191;5351;16879;926;2960;3547;11719;4473;14679
150548;201712;9707;30676;8922;29702;309;913;8169;27480;8478;28393
150549;201712;2002;6317;1804;6090;61;255;1625;5487;1686;5742
150550;201712;19282;60203;16664;55802;4761;16153;6719;23858;11480;40011
150553;201712;22323;72830;18069;64760;6340;23701;4955;19368;11295;43069
150555;201712;1744;5029;1425;4525;84;271;1033;3284;1117;3555
150560;201712;1815;5858;1640;5514;310;989;912;3181;1222;4170
150563;201712;2481;8113;2230;7672;482;1772;1193;4129;1675;5901
150565;201712;3977;13480;3610;12890;114;555;3055;10971;3169;11526
150570;201712;5968;20979;5776;20645;392;1478;4703;16860;5095;18338
150580;201712;9830;41327;9255;40646;620;2953;7845;35129;8465;38082
150590;201712;6529;24924;6141;24409;173;872;5660;22524;5833;23396
150600;201712;8429;31093;7919;30411;223;988;7189;27834;7412;28822
150610;201712;2455;8030;2250;7614;160;605;1779;5957;1939;6562
150611;201712;2825;9106;2621;8765;125;459;2227;7444;2352;7903
150613;201712;12420;35640;9629;31070;2249;7527;4201;14044;6450;21571
150616;201712;3049;8970;2277;7648;567;2090;671;2166;1238;4256
150618;201712;6515;20907;5582;19298;1060;3684;3196;11507;4256;15191
150619;201712;5275;16937;4621;15925;365;1419;3562;12204;3927;13623
150620;201712;6387;22081;5656;21133;776;2898;4096;15652;4872;18550
150630;201712;6185;17328;5800;16877;333;991;5070;14899;5403;15890
150635;201712;4053;12586;3602;11763;801;2678;1775;5928;2576;8606
150640;201712;2095;6143;1941;5974;38;119;1813;5674;1851;5793
150650;201712;11336;33589;10169;31537;3055;9298;4283;14191;7338;23489
150655;201712;5484;16666;5067;16002;324;1007;4187;13311;4511;14318
150658;201712;4422;12897;3738;11953;759;2624;2233;7369;2992;9993
150660;201712;5656;16805;5092;16019;628;1941;3453;11074;4081;13015
150670;201712;7599;19390;6136;17658;611;1626;4820;14363;5431;15989
150680;201712;62743;199408;50055;179402;13307;47729;21308;85686;34615;133415
150690;201712;2205;6263;1966;5927;134;393;1608;4907;1742;5300
150700;201712;6009;18785;5514;18134;589;1858;4130;14037;4719;15895
150710;201712;4187;13938;3746;13233;323;1234;2765;9886;3088;11120
150715;201712;5338;17007;4686;15994;347;1203;3740;12975;4087;14178
150720;201712;6356;24760;6002;24134;504;2234;4784;19478;5288;21712
150730;201712;10581;34804;9509;33134;1118;4014;7108;25324;8226;29338
150740;201712;3667;11157;3216;10383;489;1582;2052;6729;2541;8311
150745;201712;4802;14809;4154;13914;826;2971;2691;9074;3517;12045
150746;201712;1359;4438;1278;4287;103;324;1004;3437;1107;3761
150747;201712;5148;16361;4577;15581;855;2640;2895;10586;3750;13226
150750;201712;3505;11264;3089;10663;200;769;2444;8572;2644;9341
150760;201712;11654;35607;10718;34447;1282;3939;7959;26288;9241;30227
150770;201712;6043;22520;5808;22182;151;485;5299;21046;5450;21531
150775;201712;963;2860;802;2594;143;541;461;1456;604;1997
150780;201712;3860;12220;3670;11998;99;376;3392;11146;3491;11522
150790;201712;5122;15999;4592;15398;264;770;3783;13683;4047;14453
150795;201712;14295;46276;12974;44144;3080;10056;7328;26501;10408;36557
150796;201712;3312;9218;2908;8736;218;661;2347;7178;2565;7839
150797;201712;3866;12636;3391;11873;126;420;2841;10048;2967;10468
150800;201712;13307;42780;12231;41474;2129;6596;8574;30807;10703;37403
150803;201712;6657;23293;6209;22583;552;2109;4932;18084;5484;20193
150805;201712;2899;9839;2583;9310;301;1052;1937;7135;2238;8187
150808;201712;5785;18006;4443;15563;1658;6364;486;1862;2144;8226
150810;201712;19456;56571;15466;51597;2892;9436;9010;32378;11902;41814
150812;201712;5267;15802;4749;14912;509;1757;3496;10754;4005;12511
150815;201712;8451;27364;7438;26080;763;2650;5765;20732;6528;23382
150820;201712;11232;32333;10036;30948;954;2622;7833;25101;8787;27723
150830;201712;12060;45729;11451;44965;478;2481;9778;39197;10256;41678
150835;201712;2213;7724;2047;7420;466;1708;1057;3955;1523;5663
150840;201712;7292;21714;5843;19190;1300;4546;2610;8684;3910;13230
160005;201712;973;2960;894;2821;27;119;808;2520;835;2639
160010;201712;1692;5213;1688;5209;11;18;1668;5165;1679;5183
160015;201712;2000;6997;1875;6826;99;352;1693;6242;1792;6594
160020;201712;1898;6813;1716;6542;242;1001;1266;4840;1508;5841
160021;201712;1076;4404;1012;4312;95;533;809;3397;904;3930
160023;201712;1137;4413;1062;4296;84;308;857;3577;941;3885
160025;201712;1586;4683;1557;4651;30;75;1506;4524;1536;4599
160027;201712;8207;23694;7565;22975;763;2100;6122;19218;6885;21318
160030;201712;52583;171014;45779;160838;11123;37804;23491;90242;34614;128046
160040;201712;4876;17493;4437;16901;135;736;4096;15461;4231;16197
160050;201712;3683;12829;3146;12057;1475;5394;1011;4599;2486;9993
160053;201712;3185;11216;3018;11004;552;1908;2115;7982;2667;9890
160055;201712;580;2259;573;2250;23;113;531;2065;554;2178
160060;201712;18210;56951;16416;54908;1383;4568;13442;45745;14825;50313
160070;201712;2921;11227;2693;10845;187;854;2173;8887;2360;9741
160080;201712;2764;9894;2633;9736;85;393;2401;8906;2486;9299
170025;201712;601;1754;479;1584;137;441;214;737;351;1178
170030;201712;1132;3673;927;3266;177;675;458;1640;635;2315
170035;201712;1422;3849;1100;3328;106;349;645;1981;751;2330
170040;201712;1798;5446;1506;5068;134;497;837;3008;971;3505
170070;201712;1599;4090;1189;3555;165;515;684;2095;849;2610
170100;201712;2374;6939;2001;6349;192;610;1423;4593;1615;5203
170105;201712;733;2270;532;1828;144;490;198;692;342;1182
170110;201712;870;2823;705;2504;134;510;335;1217;469;1727
170130;201712;1327;4120;1005;3494;207;746;476;1740;683;2486
170190;201712;1475;4289;1047;3603;345;1119;235;1041;580;2160
170200;201712;1557;4137;959;3021;273;944;187;541;460;1485
170210;201712;28156;78725;21877;68597;7491;25628;3160;10853;10651;36481
170215;201712;1249;3665;1040;3365;75;302;765;2449;840;2751
170220;201712;5594;18317;4944;17064;1262;4260;2422;8829;3684;13089
170230;201712;1270;4008;1006;3476;241;847;326;1156;567;2003
170240;201712;2688;7859;2118;6939;194;778;1427;4616;1621;5394
170255;201712;3716;11361;2738;9504;708;2527;1106;3943;1814;6470
170270;201712;1042;2528;678;2025;34;107;456;1346;490;1453
170290;201712;2917;8363;2523;7918;184;408;2077;6919;2261;7327
170300;201712;1888;5540;1531;4963;189;607;982;3280;1171;3887
170305;201712;738;2164;577;1849;80;291;285;886;365;1177
170307;201712;986;3473;809;3110;165;629;404;1613;569;2242
170310;201712;1452;4039;1094;3408;228;778;527;1622;755;2400
170320;201712;1039;2900;775;2473;128;431;395;1297;523;1728
170330;201712;811;2622;734;2497;44;189;564;1880;608;2069
170360;201712;461;1386;359;1214;55;220;211;677;266;897
170370;201712;1296;3610;992;3105;159;505;485;1547;644;2052
170380;201712;1794;5597;1386;4928;158;638;790;2877;948;3515
170382;201712;574;1760;475;1589;77;268;282;941;359;1209
170384;201712;1526;5912;1309;5479;364;1610;533;2246;897;3856
170386;201712;781;2231;493;1650;87;324;98;306;185;630
170388;201712;583;1726;424;1443;68;251;192;645;260;896
170389;201712;1000;3347;856;3097;53;226;653;2365;706;2591
170390;201712;1451;3769;1102;3326;84;259;860;2648;944;2907
170410;201712;532;1667;411;1455;25;110;265;930;290;1040
170460;201712;405;1120;308;955;40;146;176;536;216;682
170510;201712;820;2617;624;2231;82;341;316;1104;398;1445
170550;201712;6283;17572;4581;14629;1415;4957;739;2442;2154;7399
170555;201712;1317;3743;1039;3309;112;382;552;1801;664;2183
170560;201712;1126;3328;851;2952;123;476;449;1729;572;2205
170600;201712;1350;3861;1119;3528;285;819;604;2028;889;2847
170610;201712;1672;4819;1275;4143;106;404;831;2656;937;3060
170625;201712;409;1159;276;873;36;118;96;282;132;400
170650;201712;1254;3856;962;3332;214;763;381;1414;595;2177
170700;201712;3551;10783;2795;9449;606;2225;1197;4171;1803;6396
170710;201712;1619;4636;1270;4003;277;952;569;1717;846;2669
170720;201712;1838;4800;1550;4388;79;171;1321;3862;1400;4033
170730;201712;944;2842;737;2488;180;628;333;1172;513;1800
170740;201712;2051;7286;1750;6715;240;948;1115;4329;1355;5277
170755;201712;852;2551;622;2093;81;318;292;970;373;1288
170765;201712;1201;3252;851;2690;217;700;336;1140;553;1840
170770;201712;1707;5525;1492;5154;215;750;960;3358;1175;4108
170820;201712;3929;13703;3466;12846;514;1856;2048;8091;2562;9947
170825;201712;981;2388;792;2132;65;148;552;1530;617;1678
170830;201712;1383;3936;1127;3526;38;101;929;2949;967;3050
170900;201712;2447;8547;2247;8220;186;741;1813;6680;1999;7421
170930;201712;3591;10387;2966;9345;678;2319;1337;4313;2015;6632
170950;201712;12266;34917;8805;28902;2598;9610;1278;4385;3876;13995
170980;201712;488;1342;371;1161;38;145;213;626;251;771
171050;201712;1551;5066;1383;4766;82;391;1072;3636;1154;4027
171070;201712;1386;4179;1211;3918;300;869;682;2457;982;3326
171090;201712;1090;2767;896;2503;66;168;654;1830;720;1998
171110;201712;570;1658;421;1389;111;410;166;478;277;888
171150;201712;1040;2764;644;2048;71;258;401;1276;472;1534
171180;201712;712;2088;477;1610;89;322;201;699;290;1021
171190;201712;1533;5655;1367;5341;253;1011;747;3053;1000;4064
171195;201712;843;2892;707;2649;123;513;422;1605;545;2118
171200;201712;576;1724;444;1481;116;409;155;506;271;915
171215;201712;441;1270;333;1064;71;250;139;427;210;677
171240;201712;731;2593;624;2365;57;277;394;1501;451;1778
171245;201712;599;1952;473;1672;90;351;218;744;308;1095
171250;201712;1002;2836;764;2442;195;633;360;1175;555;1808
171270;201712;400;1557;345;1417;93;356;151;704;244;1060
171280;201712;861;2684;687;2373;158;526;298;1138;456;1664
171320;201712;3903;11306;3101;9890;678;2164;1361;4605;2039;6769
171330;201712;2700;7704;2111;6703;503;1654;1004;3281;1507;4935
171360;201712;1424;4423;1230;4162;95;356;971;3305;1066;3661
171370;201712;678;1818;537;1625;58;193;365;1117;423;1310
171380;201712;1327;4037;1066;3591;217;810;529;1797;746;2607
171395;201712;925;2702;659;2179;102;402;328;1059;430;1461
171420;201712;1797;5627;1340;4685;241;923;599;2095;840;3018
171430;201712;1029;3086;848;2762;102;355;560;1781;662;2136
171488;201712;2432;7402;1992;6697;363;1238;1094;3848;1457;5086
171500;201712;903;2494;709;2184;70;232;487;1509;557;1741
171510;201712;799;2786;714;2628;53;238;492;1833;545;2071
171515;201712;464;1308;348;1104;28;94;209;655;237;749
171525;201712;590;1867;494;1690;36;162;319;1039;355;1201
171550;201712;336;1054;243;896;45;188;115;429;160;617
171570;201712;1234;3782;1058;3463;205;642;625;2138;830;2780
171575;201712;1858;5059;1238;3922;195;656;545;1709;740;2365
171610;201712;5448;16152;4181;13945;1038;3818;1147;4000;2185;7818
171620;201712;2812;7892;2349;7260;130;456;1912;5983;2042;6439
171630;201712;930;2721;767;2481;171;601;441;1446;612;2047
171650;201712;2038;6132;1502;5088;371;1268;504;1803;875;3071
171660;201712;2316;6208;1631;4980;269;847;869;2657;1138;3504
171665;201712;1364;3933;1037;3415;201;710;482;1641;683;2351
171670;201712;1844;5059;1429;4387;265;916;729;2192;994;3108
171700;201712;1160;3523;885;3026;140;473;467;1640;607;2113
171720;201712;773;2157;628;1910;82;276;425;1270;507;1546
171750;201712;1206;3579;865;2935;235;803;205;781;440;1584
171780;201712;1272;3333;913;2811;84;279;597;1821;681;2100
171790;201712;1431;5002;1158;4392;283;1093;513;2045;796;3138
171800;201712;686;2029;547;1817;62;220;339;1139;401;1359
171820;201712;10195;30025;8038;26332;1941;6762;2962;10153;4903;16915
171830;201712;1437;5097;1240;4694;234;927;665;2557;899;3484
171840;201712;682;1872;558;1686;37;118;409;1217;446;1335
171845;201712;634;1742;497;1526;73;265;278;874;351;1139
171850;201712;856;3054;734;2796;73;319;497;1876;570;2195
171855;201712;1091;3417;964;3195;84;284;647;2126;731;2410
171865;201712;391;1327;337;1240;68;276;163;590;231;866
171870;201712;750;2178;556;1804;89;310;269;938;358;1248
171875;201712;1200;3713;973;3333;68;282;719;2441;787;2723
171880;201712;990;3340;906;3238;63;210;743;2746;806;2956
171884;201712;942;2515;681;2132;136;483;214;750;350;1233
171886;201712;1331;4029;985;3382;286;1039;185;679;471;1718
171888;201712;751;2194;519;1741;49;172;320;1066;369;1238
171889;201712;486;1503;419;1372;74;268;189;639;263;907
171890;201712;1135;3252;876;2842;158;521;509;1675;667;2196
171900;201712;489;1774;375;1493;93;367;137;577;230;944
172000;201712;589;1854;484;1646;76;289;250;825;326;1114
172010;201712;1057;3728;945;3495;93;436;611;2191;704;2627
172015;201712;329;1277;270;1151;52;214;128;555;180;769
172020;201712;2243;7349;2072;7073;188;745;1549;5283;1737;6028
172025;201712;736;2116;533;1777;63;251;306;1028;369;1279
172030;201712;1220;3701;1055;3431;31;128;861;2791;892;2919
172049;201712;1329;3306;879;2612;316;986;387;1170;703;2156
172065;201712;1388;3596;1118;3277;67;169;995;2967;1062;3136
172080;201712;2369;7312;1949;6532;146;566;1338;4485;1484;5051
172085;201712;469;1332;311;1000;59;170;101;315;160;485
172090;201712;4004;10628;3190;9474;111;347;2674;8022;2785;8369
172093;201712;487;1491;366;1263;71;284;189;619;260;903
172097;201712;644;1786;475;1518;89;308;195;633;284;941
172100;201712;38824;104310;27422;85495;6788;23291;7752;25283;14540;48574
172110;201712;1591;6027;1383;5685;150;650;1023;4357;1173;5007
172120;201712;4806;15004;3855;13483;705;2495;2058;7473;2763;9968
172125;201712;269;817;205;705;30;115;105;366;135;481
172130;201712;724;2219;582;1985;26;95;426;1492;452;1587
172208;201712;2287;6208;1865;5594;256;772;1144;3463;1400;4235
172210;201712;2605;7403;2082;6664;451;1495;1140;3663;1591;5158
210005;201712;20054;60870;16453;55228;4955;17313;6364;22441;11319;39754
210010;201712;1685;5738;1545;5492;52;220;1338;4779;1390;4999
210015;201712;3276;10259;2931;9741;160;424;2475;8449;2635;8873
210020;201712;7317;16879;6594;16068;115;296;6138;14912;6253;15208
210030;201712;4986;16681;4707;16306;250;1206;4045;13869;4295;15075
210040;201712;2123;6201;1928;5976;33;66;1792;5658;1825;5724
210043;201712;6783;18301;5637;16974;743;2084;3969;12729;4712;14813
210047;201712;6422;22346;5835;21520;316;1457;4959;18259;5275;19716
210050;201712;2227;7979;1807;7169;319;1350;1058;4303;1377;5653
210055;201712;1757;5953;1609;5714;75;294;1295;4610;1370;4904
210060;201712;6789;26516;6235;25439;887;3699;4293;17959;5180;21658
210070;201712;7296;21039;6798;20442;54;155;6446;19572;6500;19727
210080;201712;3687;13026;3613;12935;16;67;3522;12659;3538;12726
210083;201712;4732;15801;4187;15209;74;347;3959;14440;4033;14787
210087;201712;2863;8358;2587;7992;191;574;2128;6712;2319;7286
210090;201712;9943;30811;9448;30036;319;1144;8523;27061;8842;28205
210095;201712;6009;20869;5646;20410;297;1210;4906;17896;5203;19106
210100;201712;6960;20923;6415;20174;225;869;5510;17306;5735;18175
210110;201712;2712;9120;2575;8938;54;233;2398;8326;2452;8559
210120;201712;24707;67893;21050;63415;2688;6953;14561;46828;17249;53781
210125;201712;3797;11410;3574;11153;580;1394;2764;9158;3344;10552
210130;201712;4241;12005;3731;11331;211;643;3102;9443;3313;10086
210135;201712;1524;4635;1353;4373;60;205;1116;3638;1176;3843
210140;201712;16713;50709;13856;46808;3044;10547;7569;26468;10613;37015
210150;201712;4604;11378;4088;10713;68;257;3698;9559;3766;9816
210160;201712;16653;51599;15382;49727;1374;4285;11795;39302;13169;43587
210170;201712;13925;47364;13371;46667;631;2282;12032;42278;12663;44560
210173;201712;2464;9410;2319;9170;47;271;2170;8580;2217;8851
210177;201712;3015;9111;2850;8915;56;135;2712;8577;2768;8712
210180;201712;1467;4222;1351;4067;34;124;1203;3595;1237;3719
210190;201712;4795;14849;4374;14072;133;654;3557;11193;3690;11847
210193;201712;1237;3884;1127;3716;49;183;924;3065;973;3248
210197;201712;1981;6644;1824;6449;217;693;1389;5126;1606;5819
210200;201712;7708;25753;7148;24948;752;2626;5641;20113;6393;22739
210203;201712;6953;21494;6468;20855;404;1226;5629;18479;6033;19705
210207;201712;3306;10242;3031;9830;170;471;2499;8343;2669;8814
210210;201712;8203;27460;7809;26922;95;486;7211;25094;7306;25580
210215;201712;1787;6338;1632;6118;68;336;1420;5328;1488;5664
210220;201712;5811;21417;5505;20887;261;1320;4729;17778;4990;19098
210230;201712;5089;16130;4689;15542;237;696;4137;13889;4374;14585
210232;201712;12446;39210;10240;36263;1521;5515;6539;25038;8060;30553
210235;201712;3629;11016;3217;10504;121;485;2828;9303;2949;9788
210237;201712;2318;8676;2214;8545;22;103;2132;8268;2154;8371
210240;201712;2788;8823;2585;8501;108;398;2226;7307;2334;7705
210250;201712;5413;17041;5000;16522;114;589;4485;14738;4599;15327
210255;201712;2653;8291;2326;7704;309;1079;1599;5280;1908;6359
210260;201712;5177;16428;4708;15701;340;1177;3854;12938;4194;14115
210270;201712;4897;14091;4472;13506;102;511;3971;11862;4073;12373
210275;201712;3522;8777;3264;8478;73;126;3088;8146;3161;8272
210280;201712;5518;16543;4628;15238;249;1183;3435;11112;3684;12295
210290;201712;6019;18918;5583;18392;156;593;4990;16511;5146;17104
210300;201712;35389;97059;29429;89623;2013;6345;22205;70482;24218;76827
210310;201712;2911;7863;2656;7516;68;140;2387;6816;2455;6956
210312;201712;2410;7051;2200;6795;46;231;1995;6130;2041;6361
210315;201712;2797;8360;2416;7892;74;219;2127;7137;2201;7356
210317;201712;3920;12606;3685;12332;131;513;3370;11312;3501;11825
210320;201712;18665;60661;17484;59142;587;2564;15691;53137;16278;55701
210325;201712;3497;10560;3119;10009;107;391;2724;8832;2831;9223
210330;201712;29642;80667;24551;74487;5742;16410;13078;45383;18820;61793
210340;201712;10781;32656;9776;31240;1035;3078;7133;23978;8168;27056
210350;201712;9511;28505;8502;27151;315;1110;7212;23222;7527;24332
210355;201712;3927;14164;3525;13541;134;703;2966;11506;3100;12209
210360;201712;14958;44396;13504;42374;721;2724;11175;34868;11896;37592
210370;201712;9815;23048;8064;21175;302;622;7165;19398;7467;20020
210375;201712;3024;8848;2421;8036;663;2215;1164;4114;1827;6329
210380;201712;5598;15209;5044;14506;306;795;4312;12636;4618;13431
210390;201712;2759;10006;2555;9662;133;650;2139;8086;2272;8736
210400;201712;4744;14863;4395;14436;110;289;4088;13589;4198;13878
210405;201712;7381;20580;5972;18535;1269;3867;3136;10337;4405;14204
210407;201712;1921;6754;1629;6193;142;604;1253;4722;1395;5326
210408;201712;2359;9211;2238;9045;160;785;1835;7519;1995;8304
210409;201712;3644;12959;3370;12570;117;653;2921;10867;3038;11520
210410;201712;3511;11156;3181;10671;240;727;2536;8754;2776;9481
210420;201712;4020;13163;3673;12550;181;629;3094;10660;3275;11289
210430;201712;2214;6568;2095;6433;123;328;1826;5684;1949;6012
210440;201712;4099;11808;3892;11552;72;216;3697;11007;3769;11223
210450;201712;2559;8108;2299;7705;118;422;1857;6214;1975;6636
210455;201712;3799;10616;3248;9952;690;1996;2138;6863;2828;8859
210460;201712;3398;10766;3083;10311;127;533;2609;8703;2736;9236
210462;201712;1392;4863;1250;4596;56;273;1010;3684;1066;3957
210465;201712;2603;8121;2332;7743;98;299;2060;6947;2158;7246
210467;201712;6033;19921;5564;19374;318;1203;4852;17090;5170;18293
210470;201712;2092;5551;1467;4639;75;211;1118;3624;1193;3835
210480;201712;15078;46973;12992;44326;1740;5624;9128;33304;10868;38928
210490;201712;3713;9870;3130;9050;81;274;2733;7902;2814;8176
210500;201712;6102;25162;5795;24566;467;2292;4607;19474;5074;21766
210510;201712;6295;21280;5849;20751;263;781;5115;18704;5378;19485
210515;201712;3561;10948;3274;10643;120;329;3004;9971;3124;10300
210520;201712;2577;7621;2296;7249;114;400;2008;6378;2122;6778
210530;201712;48751;130871;40838;118953;6934;25494;11915;42076;18849;67570
210535;201712;3180;10894;3033;10698;84;304;2731;9730;2815;10034
210540;201712;13595;43431;11979;41259;1632;5479;8307;30003;9939;35482
210542;201712;5768;15369;5011;14542;237;496;4518;13469;4755;13965
210545;201712;2297;7233;2153;7015;47;218;1928;6216;1975;6434
210547;201712;3614;12970;3301;12397;376;1355;2369;9224;2745;10579
210550;201712;5870;17685;5150;16849;314;966;4436;14819;4750;15785
210560;201712;3754;11653;3352;10991;115;446;2878;9364;2993;9810
210565;201712;1428;5090;1223;4764;43;218;1010;4019;1053;4237
210570;201712;11345;31580;10367;30453;378;922;9413;28099;9791;29021
210580;201712;2992;8472;2672;8078;283;538;2100;6762;2383;7300
210590;201712;3983;12585;3615;12097;159;741;3175;10518;3334;11259
210592;201712;2508;7708;2365;7483;32;170;2098;6578;2130;6748
210594;201712;2704;7475;2129;6586;101;284;1573;5042;1674;5326
210596;201712;2448;9092;2288;8761;171;760;1782;6855;1953;7615
210598;201712;1793;5364;1663;5197;48;178;1531;4797;1579;4975
210600;201712;2954;8396;2529;7823;88;278;2071;6437;2159;6715
210610;201712;2456;7750;2227;7462;93;438;1974;6514;2067;6952
210620;201712;2161;6793;1921;6496;38;99;1772;6115;1810;6214
210630;201712;3141;11014;2855;10597;190;912;2290;8374;2480;9286
210632;201712;4355;14739;3959;14148;384;1527;3050;10910;3434;12437
210635;201712;1861;6543;1746;6344;132;408;1461;5469;1593;5877
210637;201712;2492;8572;2268;8234;137;607;1788;6543;1925;7150
210640;201712;4791;18689;4711;18605;33;136;4619;18305;4652;18441
210650;201712;7044;20756;6742;20366;84;261;6492;19650;6576;19911
210660;201712;8506;24889;7659;23631;319;1179;6622;20237;6941;21416
210663;201712;2642;8118;2507;7955;117;374;2157;7019;2274;7393
210667;201712;1892;6291;1766;6092;67;275;1570;5464;1637;5739
210670;201712;4432;15834;4182;15433;181;847;3633;13382;3814;14229
210675;201712;5069;13986;4537;13289;338;824;3773;11424;4111;12248
210680;201712;4003;10539;3412;9828;131;299;3012;8822;3143;9121
210690;201712;7513;24851;6979;24280;271;1012;6166;21982;6437;22994
210700;201712;2731;7740;2349;7278;190;452;1852;6277;2042;6729
210710;201712;4732;15558;4403;15068;158;721;3837;13090;3995;13811
210720;201712;2689;9280;2528;9067;62;318;2320;8273;2382;8591
210725;201712;1174;4312;1060;4099;38;138;812;3289;850;3427
210730;201712;1203;3416;1031;3182;74;227;821;2556;895;2783
210735;201712;4405;14077;3911;13320;327;1180;3197;11022;3524;12202
210740;201712;5185;14733;4701;14241;149;676;4217;12595;4366;13271
210745;201712;4257;11731;3990;11403;185;428;3553;10284;3738;10712
210750;201712;19404;51750;16960;48933;1734;4980;12712;37641;14446;42621
210760;201712;5568;16263;5149;15806;27;74;5014;15471;5041;15545
210770;201712;5832;15855;5018;14915;61;266;4619;13752;4680;14018
210780;201712;7230;24264;6587;23158;693;2311;4925;17796;5618;20107
210790;201712;4720;14805;4371;14374;169;416;3540;12400;3709;12816
210800;201712;4833;13339;4265;12625;79;298;3876;11449;3955;11747
210805;201712;3821;14925;3688;14724;139;690;3246;13019;3385;13709
210810;201712;5028;15213;4642;14712;248;514;4096;13407;4344;13921
210820;201712;7223;20925;6307;19486;740;2227;4246;13389;4986;15616
210825;201712;6113;20027;5760;19578;317;999;5000;17346;5317;18345
210830;201712;8171;23353;7675;22748;541;1257;6566;20110;7107;21367
210840;201712;3402;9228;3085;8783;97;306;2672;7559;2769;7865
210845;201712;5803;16879;5602;16666;37;75;5517;16498;5554;16573
210850;201712;5843;20365;5240;19399;436;1920;3973;14675;4409;16595
210860;201712;17667;51089;15421;48016;978;2948;12438;39576;13416;42524
210870;201712;6047;19010;5311;18127;392;1259;4412;15379;4804;16638
210880;201712;4245;13614;3980;13290;255;972;3334;11135;3589;12107
210890;201712;4568;13756;4168;13283;278;695;3507;11701;3785;12396
210900;201712;4840;14286;3749;12366;1421;5016;766;2818;2187;7834
210905;201712;1863;5544;1616;5202;71;178;1387;4575;1458;4753
210910;201712;7628;24138;6672;22540;886;3073;4454;15173;5340;18246
210920;201712;2917;10325;2630;9922;100;543;2268;8517;2368;9060
210923;201712;1404;4669;1284;4471;98;379;944;3320;1042;3699
210927;201712;4939;15813;4511;15352;109;347;4196;14477;4305;14824
210930;201712;2482;8748;2287;8452;128;642;1861;6758;1989;7400
210940;201712;3348;11179;3174;10918;141;658;2773;9388;2914;10046
210945;201712;5833;17855;5557;17528;271;715;4950;15832;5221;16547
210950;201712;5141;15383;4100;13813;518;1570;2837;9987;3355;11557
210955;201712;1746;5552;1538;5230;145;471;1100;3866;1245;4337
210960;201712;8851;27822;8045;26693;1614;4990;4966;17701;6580;22691
210970;201712;1296;4372;1113;4049;96;429;835;2942;931;3371
210975;201712;1693;5632;1594;5447;128;471;1211;4135;1339;4606
210980;201712;10396;23692;9594;22879;242;422;9062;21902;9304;22324
210990;201712;15966;47853;13106;43902;2014;6920;8093;28115;10107;35035
211000;201712;14558;45361;12866;43439;654;2675;10804;37177;11458;39852
211003;201712;4982;17070;4420;16370;195;908;3698;13931;3893;14839
211010;201712;6415;23801;5973;23198;80;465;5531;21646;5611;22111
211020;201712;7800;24762;7402;24209;417;1560;6322;20699;6739;22259
211023;201712;2082;6968;1975;6810;109;415;1648;5660;1757;6075
211027;201712;2675;9697;2614;9590;226;893;2186;8025;2412;8918
211030;201712;3754;11069;3431;10716;298;647;2909;9521;3207;10168
211040;201712;4498;16555;4302;16263;160;864;3774;14247;3934;15111
211050;201712;9785;24975;9089;24144;217;567;8504;22608;8721;23175
211060;201712;5785;19964;5504;19529;285;1162;4841;17179;5126;18341
211065;201712;2023;6167;1781;5830;51;145;1602;5307;1653;5452
211070;201712;7783;26210;6987;24914;448;1639;5621;20314;6069;21953
211080;201712;1298;3748;1085;3427;57;301;857;2553;914;2854
211085;201712;1968;6297;1792;6030;139;457;1473;5010;1612;5467
211090;201712;3315;9364;3027;8984;65;306;2696;7897;2761;8203
211100;201712;6453;17073;6197;16734;47;161;5928;15974;5975;16135
211102;201712;2902;10830;2705;10554;161;719;2340;9177;2501;9896
211105;201712;2415;7898;2019;7215;240;880;1370;4922;1610;5802
211107;201712;4364;13978;3865;13271;209;718;3142;11150;3351;11868
211110;201712;6133;17502;4767;15474;633;1919;3279;11099;3912;13018
211120;201712;34636;97295;31882;94042;4412;12124;23508;71748;27920;83872
211125;201712;2012;6260;1744;5826;85;321;1472;4941;1557;5262
211130;201712;175073;456680;164069;442920;24034;66943;77714;233698;101748;300641
211140;201712;4971;15787;4559;15186;223;775;3870;12912;4093;13687
211150;201712;9601;27274;8501;25921;296;1101;7322;22379;7618;23480
211153;201712;2580;7990;2238;7556;429;1516;1474;5183;1903;6699
211157;201712;1078;3519;920;3268;53;288;637;2263;690;2551
211160;201712;3980;12566;3310;11449;210;992;2390;8025;2600;9017
211163;201712;1686;5671;1602;5553;27;82;1500;5284;1527;5366
211167;201712;1507;4911;1421;4774;30;129;1334;4472;1364;4601
211170;201712;5942;15511;5679;15189;67;220;5404;14404;5471;14624
211172;201712;2427;6972;2175;6582;83;308;1835;5435;1918;5743
211174;201712;2695;8198;2502;7940;70;345;2255;7084;2325;7429
211176;201712;4088;12683;3447;11808;288;1139;2613;8981;2901;10120
211178;201712;4474;10723;4002;10194;31;109;3794;9578;3825;9687
211180;201712;4081;14020;3832;13645;262;995;3247;11667;3509;12662
211190;201712;3008;9348;2657;8817;59;292;2295;7549;2354;7841
211195;201712;1413;4177;1191;3884;67;202;985;3314;1052;3516
211200;201712;2026;6363;1727;5957;193;689;1154;4105;1347;4794
211210;201712;6610;20242;6152;19613;312;1084;5332;17071;5644;18155
211220;201712;33615;93420;29177;87784;3916;11832;20166;62680;24082;74512
211223;201712;4873;14696;4415;13986;458;1325;3303;10733;3761;12058
211227;201712;1616;5779;1504;5607;38;179;1327;4995;1365;5174
211230;201712;7379;23494;6686;22349;611;2095;5151;17313;5762;19408
211240;201712;8035;26961;7633;26443;206;1079;6960;23798;7166;24877
211245;201712;5734;16529;5633;16425;41;84;5570;16290;5611;16374
211250;201712;13845;41135;12876;39971;647;2066;11257;35192;11904;37258
211260;201712;7922;25261;7381;24548;258;1009;6676;22286;6934;23295
211270;201712;10078;33708;8891;32178;419;1959;7294;26742;7713;28701
211280;201712;13268;38441;12025;36876;814;2034;9925;31469;10739;33503
211285;201712;1665;6014;1463;5637;255;1042;714;2858;969;3900
211290;201712;6930;22467;6569;21971;262;984;5764;19369;6026;20353
211300;201712;8093;23665;7462;22844;75;193;7076;21806;7151;21999
211400;201712;11387;34889;9641;32289;1890;6402;5481;19826;7371;26228
220005;201712;1819;5085;1622;4783;45;194;1332;3810;1377;4004
220010;201712;1450;4217;1255;3891;25;109;1005;3065;1030;3174
220020;201712;3181;9906;2933;9479;399;1315;2042;6602;2441;7917
220025;201712;2248;5366;1968;4961;35;104;1629;4013;1664;4117
220027;201712;1259;3368;1099;3151;41;147;894;2541;935;2688
220030;201712;3117;8213;2966;7977;119;360;2552;6727;2671;7087
220040;201712;7072;21651;6444;20506;1201;3752;4080;13164;5281;16916
220045;201712;1369;4456;1210;4148;50;256;930;3108;980;3364
220050;201712;4409;12998;3769;11995;159;663;3154;9934;3313;10597
220060;201712;2173;5109;1848;4732;30;68;1687;4321;1717;4389
220070;201712;2413;6675;2122;6223;94;262;1717;5009;1811;5271
220080;201712;656;1972;601;1885;27;110;503;1515;530;1625
220090;201712;1741;4333;1435;3907;24;83;1257;3403;1281;3486
220095;201712;683;1799;638;1738;8;22;596;1618;604;1640
220100;201712;1324;3872;1080;3420;48;208;872;2703;920;2911
220105;201712;2091;6584;1827;6052;137;466;1333;4452;1470;4918
220110;201712;3374;9568;3156;9189;62;255;2777;7966;2839;8221
220115;201712;2595;8289;2448;8047;101;420;2164;7002;2265;7422
220117;201712;1301;3326;1023;2911;23;74;873;2461;896;2535
220120;201712;11430;33683;10527;32554;125;541;9924;30638;10049;31179
220130;201712;936;2897;818;2722;18;122;722;2357;740;2479
220140;201712;1640;4275;1442;4037;98;222;1231;3496;1329;3718
220150;201712;6669;20042;6237;19422;147;720;5465;16750;5612;17470
220155;201712;1091;3255;860;2826;25;98;598;1936;623;2034
220157;201712;1060;2675;900;2405;17;65;740;1920;757;1985
220160;201712;2584;7666;2251;7044;57;296;1843;5644;1900;5940
220170;201712;1369;3935;1156;3596;25;130;1003;3048;1028;3178
220173;201712;2013;5913;1612;5136;45;217;1317;4055;1362;4272
220177;201712;1801;5376;1754;5315;12;42;1703;5165;1715;5207
220180;201712;1152;2968;894;2495;10;41;669;1769;679;1810
220190;201712;5186;15384;4633;14648;428;1398;3560;11389;3988;12787
220191;201712;1370;4500;1280;4338;89;381;929;3067;1018;3448
220192;201712;1818;5089;1443;4415;41;157;1139;3417;1180;3574
220194;201712;1729;5104;1537;4799;71;281;1258;3851;1329;4132
220196;201712;1998;5592;1820;5288;66;267;1537;4369;1603;4636
220198;201712;1258;3651;1009;3317;8;27;958;3187;966;3214
220200;201712;4589;14575;4184;14047;296;1075;3406;11449;3702;12524
220202;201712;2150;6234;1846;5694;30;149;1581;4779;1611;4928
220205;201712;2608;7132;2305;6683;41;164;2013;5742;2054;5906
220207;201712;839;2548;713;2325;61;231;485;1566;546;1797
220208;201712;1721;5443;1414;4844;312;1188;643;2210;955;3398
220209;201712;1604;4701;1370;4289;31;136;1112;3468;1143;3604
220210;201712;1598;4274;1380;3899;32;136;1122;3070;1154;3206
220211;201712;1495;4141;1414;4025;20;91;1258;3571;1278;3662
220213;201712;1683;4677;1506;4323;30;116;1253;3515;1283;3631
220217;201712;1951;6180;1856;6062;30;121;1747;5741;1777;5862
220220;201712;10358;27911;8842;25567;545;1432;6593;19486;7138;20918
220225;201712;1134;3162;930;2881;22;86;782;2400;804;2486
220230;201712;5567;14361;4906;13489;183;512;4262;11735;4445;12247
220240;201712;2877;8717;2645;8281;94;362;2191;6827;2285;7189
220245;201712;1535;3961;1245;3583;13;48;1100;3232;1113;3280
220250;201712;2655;8129;2418;7773;56;239;2134;6858;2190;7097
220253;201712;1634;4647;1368;4173;146;426;1044;3170;1190;3596
220255;201712;1768;4649;1501;4229;23;123;1247;3369;1270;3492
220260;201712;4291;13678;3756;12720;211;766;2932;9948;3143;10714
220265;201712;1242;4229;1133;4054;70;295;852;3030;922;3325
220270;201712;6656;21272;6269;20570;398;1636;5107;16295;5505;17931
220271;201712;1507;4027;1295;3703;47;144;1092;3137;1139;3281
220272;201712;1688;5008;1512;4686;33;118;1194;3645;1227;3763
220273;201712;1191;3447;1017;3124;42;156;791;2410;833;2566
220275;201712;2141;5331;1685;4744;42;163;1458;4069;1500;4232
220277;201712;2128;5733;1833;5256;34;122;1524;4294;1558;4416
220280;201712;1508;3992;1294;3635;59;199;1058;2878;1117;3077
220285;201712;1491;3954;1269;3666;20;85;1182;3398;1202;3483
220290;201712;5702;18347;4795;17028;450;1808;3428;12177;3878;13985
220300;201712;1822;5843;1571;5474;56;326;1292;4389;1348;4715
220310;201712;2568;7976;2189;7531;56;305;1892;6421;1948;6726
220320;201712;2821;8535;2327;7614;158;614;1762;5672;1920;6286
220323;201712;1516;5077;1276;4697;87;348;1019;3750;1106;4098
220325;201712;1196;3700;1017;3355;45;191;809;2647;854;2838
220327;201712;1338;4159;1199;3917;42;215;999;3167;1041;3382
220330;201712;3735;10051;3229;9352;170;520;2635;7586;2805;8106
220335;201712;1751;5338;1562;5117;15;55;1463;4806;1478;4861
220340;201712;1814;4920;1480;4368;56;203;1088;3120;1144;3323
220342;201712;1137;3561;1035;3402;41;175;849;2798;890;2973
220345;201712;2977;7126;2440;6379;18;44;2305;6020;2323;6064
220350;201712;3507;9281;2890;8270;142;478;2194;6180;2336;6658
220360;201712;1168;3143;968;2831;32;111;791;2249;823;2360
220370;201712;9131;25946;8227;24714;229;900;7318;21813;7547;22713
220375;201712;1412;4417;1320;4297;8;24;1288;4206;1296;4230
220380;201712;1477;3735;1216;3363;37;121;1042;2838;1079;2959
220385;201712;798;1980;629;1688;11;42;530;1380;541;1422
220390;201712;8499;25132;7303;23035;1891;5970;3007;10002;4898;15972
220400;201712;1493;3733;1151;3185;24;91;902;2403;926;2494
220410;201712;1143;3280;952;2955;60;185;765;2341;825;2526
220415;201712;815;2236;709;2064;24;83;539;1534;563;1617
220420;201712;2058;5878;1671;5126;83;270;1248;3774;1331;4044
220430;201712;2437;6680;2374;6597;97;281;2126;5869;2223;6150
220435;201712;1689;4743;1509;4453;55;185;1179;3434;1234;3619
220440;201712;2425;7827;2159;7393;139;516;1783;6009;1922;6525
220450;201712;2074;6066;1746;5614;253;923;1231;3915;1484;4838
220455;201712;1312;4151;1237;4048;33;154;1088;3527;1121;3681
220460;201712;920;2451;833;2347;43;143;719;1979;762;2122
220465;201712;2347;7547;2113;7190;164;601;1602;5473;1766;6074
220470;201712;3538;10283;3186;9707;118;407;2575;7719;2693;8126
220480;201712;2361;6618;1968;5950;131;345;1463;4383;1594;4728
220490;201712;2323;6283;2113;6022;42;162;1882;5308;1924;5470
220500;201712;2786;7568;2445;7006;63;264;1969;5465;2032;5729
220510;201712;2712;7935;2198;7025;91;298;1685;5400;1776;5698
220515;201712;1689;4131;1511;3892;50;125;1341;3443;1391;3568
220520;201712;4990;13345;4562;12757;85;257;4147;11594;4232;11851
220525;201712;1220;3386;1123;3247;24;91;969;2766;993;2857
220527;201712;1303;3854;1150;3574;40;125;941;2959;981;3084
220530;201712;1205;3390;1072;3195;36;148;967;2822;1003;2970
220535;201712;810;2338;751;2261;51;157;599;1805;650;1962
220540;201712;3357;10687;3175;10398;92;409;2781;9044;2873;9453
220545;201712;1371;4447;1283;4282;94;385;1034;3393;1128;3778
220550;201712;8892;27879;8067;26462;566;2096;6163;19941;6729;22037
220551;201712;1419;4325;1245;4039;55;231;989;3126;1044;3357
220552;201712;1510;4590;1292;4167;43;228;1045;3243;1088;3471
220553;201712;1599;4480;1355;4097;54;171;1057;3271;1111;3442
220554;201712;808;2274;658;2033;43;108;512;1591;555;1699
220555;201712;2053;6647;1907;6414;53;263;1610;5349;1663;5612
220556;201712;1282;3871;1128;3572;41;191;869;2635;910;2826
220557;201712;1535;4769;1330;4358;87;321;965;3104;1052;3425
220558;201712;1120;3336;971;3121;36;163;790;2480;826;2643
220559;201712;1612;4339;1395;3988;14;46;1172;3357;1186;3403
220560;201712;1629;3963;1320;3537;40;99;1145;3043;1185;3142
220570;201712;7158;22575;6599;21660;621;2113;4959;16435;5580;18548
220580;201712;6479;19164;6201;18715;178;586;5564;16667;5742;17253
220585;201712;1968;6505;1788;6170;79;325;1446;4941;1525;5266
220590;201712;1288;3706;1101;3422;112;357;752;2352;864;2709
220595;201712;2399;6798;2236;6586;19;105;2105;6129;2124;6234
220600;201712;1338;3139;1086;2809;74;112;898;2390;972;2502
220605;201712;1733;5094;1478;4659;35;158;1174;3603;1209;3761
220610;201712;2844;8738;2680;8501;45;209;2460;7777;2505;7986
220620;201712;7554;24515;7124;23927;217;975;6426;21424;6643;22399
220630;201712;380;1157;305;1027;44;172;176;601;220;773
220635;201712;1657;5382;1466;4981;72;294;1106;3702;1178;3996
220640;201712;2711;7540;2322;6959;81;283;1946;5788;2027;6071
220650;201712;2064;6001;1788;5499;68;232;1367;4178;1435;4410
220660;201712;2797;8271;2495;7893;93;406;2150;6658;2243;7064
220665;201712;1274;3992;1129;3753;26;142;960;3139;986;3281
220667;201712;1615;5328;1459;5045;78;292;1177;4082;1255;4374
220669;201712;1727;5522;1646;5374;92;413;1348;4323;1440;4736
220670;201712;1972;5617;1713;5297;51;155;1528;4725;1579;4880
220672;201712;2583;7163;2289;6797;108;328;2016;6027;2124;6355
220675;201712;1248;3499;1146;3319;60;158;893;2590;953;2748
220680;201712;2549;7383;2426;7221;125;378;2133;6341;2258;6719
220690;201712;1617;4432;1407;4086;127;325;1049;3108;1176;3433
220695;201712;935;2664;849;2497;27;92;698;2034;725;2126
220700;201712;8321;22682;6992;20726;365;1236;5385;15802;5750;17038
220710;201712;840;2432;654;2055;52;144;462;1442;514;1586
220720;201712;1969;4981;1801;4732;38;127;1566;4080;1604;4207
220730;201712;1337;3861;1120;3509;28;121;919;2830;947;2951
220735;201712;998;2426;777;2058;25;63;648;1703;673;1766
220740;201712;1401;4092;1147;3761;35;127;977;3218;1012;3345
220750;201712;3711;10335;3358;9817;185;538;2850;8333;3035;8871
220755;201712;1121;3061;992;2851;35;122;794;2222;829;2344
220760;201712;2871;8850;2564;8430;90;361;2224;7310;2314;7671
220770;201712;20214;65506;17784;60991;6404;22819;5521;19884;11925;42703
220775;201712;1104;2994;1051;2935;18;68;1023;2846;1041;2914
220777;201712;1555;4151;1236;3616;41;114;946;2746;987;2860
220779;201712;1342;3331;1209;3144;30;113;1059;2709;1089;2822
220780;201712;5459;14535;4733;13381;247;834;3817;10561;4064;11395
220785;201712;1409;3260;1290;3086;25;34;1216;2912;1241;2946
220790;201712;10095;29543;9145;28131;338;1401;7730;23436;8068;24837
220793;201712;791;2240;691;2073;27;102;572;1698;599;1800
220795;201712;1420;3847;1288;3674;33;129;1151;3270;1184;3399
220800;201712;15955;40942;13596;37462;843;2432;9647;26095;10490;28527
220810;201712;2935;8510;2560;7839;61;250;2129;6390;2190;6640
220820;201712;5268;14040;4636;13140;442;1165;3530;10060;3972;11225
220830;201712;7040;19717;6462;18853;346;1072;5307;15432;5653;16504
220840;201712;12686;39687;10971;36193;2153;6923;5971;20124;8124;27047
220850;201712;2952;9557;2705;9254;72;358;2428;8271;2500;8629
220855;201712;601;1753;513;1602;21;94;415;1268;436;1362
220860;201712;975;2522;854;2340;19;67;762;2064;781;2131
220865;201712;2559;6926;2014;5990;62;253;1599;4613;1661;4866
220870;201712;2398;7630;2055;7162;38;205;1871;6473;1909;6678
220880;201712;4979;12767;4477;12169;48;150;4197;11387;4245;11537
220885;201712;1229;4290;1071;3997;64;325;823;3058;887;3383
220887;201712;1307;3146;1166;2952;11;40;1096;2753;1107;2793
220890;201712;1558;5167;1340;4747;102;351;991;3565;1093;3916
220900;201712;1946;5056;1657;4647;37;100;1446;4034;1483;4134
220910;201712;1487;4388;1286;4085;33;115;1133;3612;1166;3727
220915;201712;948;2643;797;2349;21;93;632;1806;653;1899
220920;201712;1341;4663;1157;4390;81;390;907;3371;988;3761
220930;201712;1513;4585;1355;4345;35;156;1211;3807;1246;3963
220935;201712;1043;3051;844;2623;29;128;577;1671;606;1799
220937;201712;1370;3725;1182;3433;27;103;965;2749;992;2852
220940;201712;1376;4145;1169;3726;47;208;864;2664;911;2872
220945;201712;401;1474;363;1393;21;113;264;988;285;1101
220950;201712;1359;3246;902;2495;18;78;699;1864;717;1942
220955;201712;1530;4124;1335;3788;46;124;1114;3171;1160;3295
220960;201712;884;2251;692;1940;18;68;545;1505;563;1573
220965;201712;1700;4851;1542;4599;27;165;1329;3833;1356;3998
220970;201712;1858;4917;1446;4244;67;182;1123;3325;1190;3507
220975;201712;711;2230;636;2136;25;162;564;1801;589;1963
220980;201712;1198;3473;1070;3262;34;131;880;2650;914;2781
220985;201712;1179;3375;1073;3216;49;201;827;2366;876;2567
220987;201712;1459;4506;1275;4181;64;283;1035;3331;1099;3614
220990;201712;1717;4962;1474;4561;40;194;1171;3525;1211;3719
220995;201712;1192;3519;919;3075;68;279;654;2198;722;2477
220997;201712;2377;6990;2235;6780;46;176;2070;6236;2116;6412
221000;201712;4061;11948;3766;11479;174;723;3091;9243;3265;9966
221005;201712;1396;4083;1269;3846;110;327;962;2863;1072;3190
221010;201712;1194;3003;1000;2760;25;85;874;2377;899;2462
221020;201712;1586;4964;1469;4726;43;201;1096;3463;1139;3664
221030;201712;1509;4278;1324;3991;41;182;1093;3230;1134;3412
221035;201712;1349;3748;1246;3612;24;52;1153;3408;1177;3460
221037;201712;598;1760;512;1604;12;57;360;1072;372;1129
221038;201712;549;1545;424;1324;19;68;285;885;304;953
221039;201712;894;2432;787;2271;21;86;664;1865;685;1951
221040;201712;4311;13250;3928;12594;164;574;3139;10096;3303;10670
221050;201712;3499;10037;3207;9665;55;232;2912;8696;2967;8928
221060;201712;8225;23382;6990;21367;329;1106;5316;16611;5645;17717
221062;201712;1219;4134;1062;3819;48;259;834;2936;882;3195
221063;201712;1140;3462;993;3229;73;259;717;2319;790;2578
221065;201712;2667;7046;2327;6471;46;152;2018;5536;2064;5688
221070;201712;3508;11126;3004;10153;174;637;2253;7603;2427;8240
221080;201712;3481;8678;2809;7676;79;294;2263;6104;2342;6398
221090;201712;1375;3737;1165;3378;19;79;998;2830;1017;2909
221093;201712;1470;4315;1371;4114;167;528;882;2547;1049;3075
221095;201712;898;2392;767;2179;6;21;637;1765;643;1786
221097;201712;807;2188;634;1869;21;78;466;1325;487;1403
221100;201712;97749;281873;87872;264779;16420;50787;50203;149716;66623;200503
221110;201712;10185;30979;9355;29942;285;1315;8140;25738;8425;27053
221120;201712;4100;12513;3819;12039;347;1167;3027;9519;3374;10686
221130;201712;4610;12717;3606;10677;984;2844;1474;4445;2458;7289
221135;201712;1538;4402;1390;4192;41;157;1216;3626;1257;3783
221140;201712;1298;3160;1147;2946;11;37;1027;2593;1038;2630
221150;201712;1142;2877;901;2451;24;90;700;1815;724;1905
221160;201712;770;1985;706;1899;19;45;586;1568;605;1613
221170;201712;1091;3215;984;3037;25;83;799;2453;824;2536
230010;201712;3275;8806;2617;7630;185;613;1967;5630;2152;6243
230015;201712;2881;9752;2658;9321;256;1063;1815;6255;2071;7318
230020;201712;13282;42570;12797;41791;487;1985;10940;35351;11427;37336
230030;201712;12069;32682;10574;30526;286;1008;9171;26339;9457;27347
230040;201712;4174;11356;3556;10310;142;542;2832;8076;2974;8618
230050;201712;2676;8732;1969;6916;448;1519;660;2352;1108;3871
230060;201712;2313;6530;1905;5762;57;229;1530;4529;1587;4758
230070;201712;4016;11449;3378;10181;193;672;2329;7102;2522;7774
230075;201712;9053;30228;8385;29008;445;2190;6724;22697;7169;24887
230080;201712;2464;5963;1983;5256;44;184;1701;4428;1745;4612
230090;201712;3937;10650;3447;9865;200;655;2607;7335;2807;7990
230100;201712;17413;48592;15619;45902;2006;6249;9779;28854;11785;35103
230110;201712;11591;36164;10418;33732;2003;6603;5587;18228;7590;24831
230120;201712;7491;20737;6509;19195;617;1698;4716;14252;5333;15950
230125;201712;2977;8295;2460;7408;106;385;1888;5652;1994;6037
230130;201712;5678;18138;4752;16161;513;1865;3060;10218;3573;12083
230140;201712;3503;10749;2949;9755;162;649;2113;6927;2275;7576
230150;201712;1619;4919;1385;4400;267;830;721;2351;988;3181
230160;201712;6297;17435;5465;16180;228;855;4452;13010;4680;13865
230170;201712;5991;18067;5220;16607;252;976;3872;12080;4124;13056
230180;201712;1658;4723;1410;4234;43;195;1076;3092;1119;3287
230185;201712;3927;12237;3444;11363;349;1269;2443;8099;2792;9368
230190;201712;12464;38300;10832;35116;1699;5714;5709;18614;7408;24328
230195;201712;5153;15520;4572;14510;324;1157;3542;11075;3866;12232
230200;201712;4891;13712;4280;12526;194;607;3339;9559;3533;10166
230205;201712;4019;12785;3619;12074;202;857;2655;8721;2857;9578
230210;201712;9387;24982;8002;22915;561;1772;5775;16465;6336;18237
230220;201712;13302;35896;11860;33529;608;1943;9499;26459;10107;28402
230230;201712;6924;21586;6264;20271;533;1782;4523;14616;5056;16398
230240;201712;13038;35310;11483;32806;530;1480;9167;26111;9697;27591
230250;201712;9157;27267;9047;27083;420;1526;7131;20864;7551;22390
230260;201712;14330;45845;12926;42947;1764;6205;7493;25088;9257;31293
230270;201712;7416;20982;6026;18384;643;2022;3900;11992;4543;14014
230280;201712;20065;56861;17133;51797;845;3330;13261;38962;14106;42292
230290;201712;4696;13748;4032;12371;465;1323;2807;8745;3272;10068
230300;201712;4334;12444;4094;12106;147;606;3519;10182;3666;10788
230310;201712;4791;13911;4098;12692;131;529;2986;9061;3117;9590
230320;201712;7466;21962;6573;20337;356;1372;4993;15199;5349;16571
230330;201712;4710;13358;3918;11843;227;713;2855;8537;3082;9250
230340;201712;3544;11409;3064;10413;274;1003;2108;7092;2382;8095
230350;201712;18381;52944;16465;49699;1133;4046;10701;32625;11834;36671
230360;201712;2984;8362;2364;7213;149;515;1629;4908;1778;5423
230365;201712;3010;7785;2571;7074;76;330;2173;5857;2249;6187
230370;201712;52939;159721;46213;148968;10589;35147;21789;73110;32378;108257
230380;201712;6402;18252;5196;15983;186;695;3723;11259;3909;11954
230390;201712;3292;10204;2905;9535;150;652;2199;7063;2349;7715
230393;201712;3002;9559;2549;8638;107;571;1903;6198;2010;6769
230395;201712;5597;15683;4942;14529;541;1552;3301;9876;3842;11428
230400;201712;5594;16224;4971;15167;191;838;3941;11699;4132;12537
230410;201712;14644;44741;12028;39481;1494;5037;7259;23971;8753;29008
230420;201712;24453;74049;21351;68030;3309;11229;11317;35895;14626;47124
230423;201712;4428;13730;3908;12698;148;629;3113;9957;3261;10586
230425;201712;5511;17797;5042;16789;565;1930;3365;11226;3930;13156
230426;201712;2552;7012;1964;5874;48;209;1476;4318;1524;4527
230427;201712;1813;5283;1291;4086;76;263;866;2632;942;2895
230428;201712;9288;26586;8356;25089;1346;4319;4662;13891;6008;18210
230430;201712;4452;13514;3865;12439;240;928;2866;8962;3106;9890
230435;201712;5391;15623;4663;14342;622;1974;2793;8645;3415;10619
230440;201712;380415;1030206;323961;940258;57191;173710;167318;487579;224509;661289
230445;201712;4428;11945;3732;10730;212;567;2662;7579;2874;8146
230450;201712;3503;10664;3073;9907;227;930;2215;7011;2442;7941
230460;201712;1935;5943;1692;5502;97;378;1328;4303;1425;4681
230465;201712;4026;11603;3335;10349;118;519;2423;7262;2541;7781
230470;201712;11093;38554;10186;36761;965;4147;7315;26002;8280;30149
230480;201712;1407;4290;1194;3862;106;418;863;2711;969;3129
230490;201712;2306;6843;2011;6282;233;747;1127;3423;1360;4170
230495;201712;5632;17603;5059;16533;438;1774;3353;10796;3791;12570
230500;201712;8425;29331;7928;28356;424;1882;6088;21715;6512;23597
230510;201712;1602;5293;1186;4281;231;887;464;1667;695;2554
230520;201712;4301;12911;3893;12126;320;1093;2734;8398;3054;9491
230523;201712;15019;46191;12571;40876;2989;9978;3225;10996;6214;20974
230526;201712;3945;11488;3367;10459;157;684;2617;7894;2774;8578
230530;201712;5210;16412;4554;15306;504;1800;3183;10791;3687;12591
230533;201712;3997;10682;3456;9696;234;645;2655;7454;2889;8099
230535;201712;5447;15555;4637;14090;320;962;3213;9960;3533;10922
230540;201712;16482;46908;14753;44262;375;1561;12565;37189;12940;38750
230550;201712;19371;54818;16483;49591;2232;7166;9396;28033;11628;35199
230560;201712;7337;19624;5984;17164;128;501;4908;13811;5036;14312
230565;201712;3328;9127;2689;7976;93;343;1990;5861;2083;6204
230570;201712;3511;9207;3040;8563;80;237;2543;7121;2623;7358
230580;201712;9674;27864;8700;26433;428;1591;7243;21786;7671;23377
230590;201712;8958;26683;7493;23924;558;2006;5199;16162;5757;18168
230600;201712;3748;10103;2839;8314;105;333;1849;5470;1954;5803
230610;201712;6287;18665;5652;17649;481;1513;4255;13321;4736;14834
230620;201712;2100;5855;1619;4854;157;500;951;2792;1108;3292
230625;201712;7988;24481;7038;22529;2101;7022;1872;6218;3973;13240
230630;201712;10484;32427;9376;30207;2516;7610;4040;14096;6556;21706
230640;201712;26620;83090;24230;79323;1831;6782;18838;61362;20669;68144
230650;201712;4778;14032;4180;12865;284;955;3124;9454;3408;10409
230655;201712;9309;33164;8881;32390;611;2592;7003;25613;7614;28205
230660;201712;6081;18427;5101;16519;202;1045;4102;12960;4304;14005
230670;201712;5976;15165;4571;12768;173;519;3542;9654;3715;10173
230680;201712;2541;7370;2194;6695;250;777;1428;4353;1678;5130
230690;201712;6410;20000;5929;18965;600;2112;3633;11420;4233;13532
230700;201712;9346;25398;8200;23250;382;1318;6131;16851;6513;18169
230710;201712;7145;22690;6203;20907;561;2024;4509;15151;5070;17175
230720;201712;1847;5708;1562;5096;162;534;997;3229;1159;3763
230725;201712;3543;11661;3076;10498;761;2662;1025;3496;1786;6158
230730;201712;53873;156426;45247;142280;11449;39292;14577;48118;26026;87410
230740;201712;6074;17546;5406;16409;162;632;4308;12950;4470;13582
230750;201712;8137;22725;6906;20662;246;903;5368;15671;5614;16574
230760;201712;11216;31705;10086;29749;835;2844;7187;20658;8022;23502
230763;201712;4312;12714;3733;11603;212;835;2834;8496;3046;9331
230765;201712;39251;116419;34049;106988;7939;26258;12082;38648;20021;64906
230770;201712;25823;68261;22136;63117;2896;8699;13774;39413;16670;48112
230780;201712;5804;21269;5504;20627;954;3560;3156;12291;4110;15851
230790;201712;2856;8645;2645;8302;154;530;2100;6594;2254;7124
230800;201712;7693;25815;6969;24289;979;3751;3921;13520;4900;17271
230810;201712;11577;36008;10584;34359;524;2055;8241;26332;8765;28387
230820;201712;3162;10593;2733;9659;294;1219;1666;5739;1960;6958
230830;201712;7470;21792;6433;19897;241;1022;5078;15369;5319;16391
230835;201712;3973;10043;3148;8723;121;414;2545;6884;2666;7298
230837;201712;3091;10103;2672;9272;160;726;1973;6678;2133;7404
230840;201712;8792;27235;7786;25501;570;2033;5981;19664;6551;21697
230850;201712;9102;27614;8164;25881;601;2102;5819;18372;6420;20474
230860;201712;4958;13580;4239;12483;175;623;3544;10322;3719;10945
230870;201712;17216;43846;14880;40308;593;1733;11719;31576;12312;33309
230880;201712;1978;6417;1835;6156;80;404;1396;4543;1476;4947
230890;201712;4311;14660;3986;14013;372;1450;2787;9721;3159;11171
230900;201712;2946;9234;2482;8238;332;1124;1490;4892;1822;6016
230910;201712;3014;8606;2455;7629;101;481;1921;5838;2022;6319
230920;201712;4431;12670;3996;12048;144;562;3415;10201;3559;10763
230930;201712;6594;19449;5649;17606;453;1539;3766;11628;4219;13167
230940;201712;7609;21070;6747;19655;217;688;5598;16222;5815;16910
230945;201712;6406;18909;5611;17376;451;1513;3785;11811;4236;13324
230950;201712;6329;16461;5741;15729;134;324;5115;14292;5249;14616
230960;201712;13458;41022;12205;38567;1968;6467;6115;19532;8083;25999
230970;201712;13371;38581;11499;35432;2114;6893;5498;17030;7612;23923
230980;201712;2718;8213;2361;7573;526;1626;1289;4293;1815;5919
230990;201712;1758;5033;1438;4435;93;389;968;2862;1061;3251
231000;201712;2528;6822;2106;5982;97;291;1476;4119;1573;4410
231010;201712;2987;7937;2447;7034;172;564;1817;5130;1989;5694
231020;201712;7997;26126;7359;24709;1280;4107;4320;15023;5600;19130
231025;201712;7336;21892;6612;20643;1101;3502;4087;12935;5188;16437
231030;201712;6903;21788;5710;19206;1026;3502;2997;10114;4023;13616
231040;201712;3109;9345;2717;8610;103;418;2075;6471;2178;6889
231050;201712;11658;31615;9527;27867;589;1727;7166;20728;7755;22455
231060;201712;2507;7733;2269;7336;95;429;1751;5588;1846;6017
231070;201712;8038;24642;7041;22701;1167;3835;3879;12649;5046;16484
231080;201712;3933;11846;3552;11174;138;710;2761;8347;2899;9057
231085;201712;5520;15471;4907;14709;392;1135;3668;11275;4060;12410
231090;201712;4188;11426;3271;9600;121;440;2302;6572;2423;7012
231095;201712;2063;6443;1760;5764;156;572;1212;3922;1368;4494
231100;201712;2974;9103;2547;8303;209;703;1833;5956;2042;6659
231110;201712;3363;10707;3304;10599;227;892;2391;7519;2618;8411
231120;201712;1915;6188;1732;5813;158;549;1153;3869;1311;4418
231123;201712;1968;5216;1661;4664;88;270;1230;3382;1318;3652
231126;201712;5871;16622;4759;14497;208;752;3419;10184;3627;10936
231130;201712;18689;54298;16443;50887;1861;6380;10908;34103;12769;40483
231135;201712;4130;11902;3489;10723;181;675;2520;7598;2701;8273
231140;201712;17110;51233;14403;46157;942;3905;9850;30753;10792;34658
231150;201712;5211;15034;4457;13576;720;2183;2257;7021;2977;9204
231160;201712;5643;18179;5204;17309;1119;3489;2712;9419;3831;12908
231170;201712;4211;12951;3552;11573;232;880;2475;7861;2707;8741
231180;201712;13953;40749;11998;36653;2565;7934;5370;16292;7935;24226
231190;201712;4016;11576;3483;10678;186;767;2624;7768;2810;8535
231195;201712;4503;14699;3898;13416;271;1182;2773;9284;3044;10466
231200;201712;7936;25784;6850;23505;294;1467;5095;16965;5389;18432
231210;201712;4720;14670;4114;13638;197;862;3115;10076;3312;10938
231220;201712;11651;31770;9584;27857;550;1697;7016;19926;7566;21623
231230;201712;8910;28932;8051;27555;596;2337;6040;20744;6636;23081
231240;201712;11470;34943;10374;32777;1839;5916;5904;18874;7743;24790
231250;201712;1946;5289;1361;3930;125;355;736;2092;861;2447
231260;201712;3183;9516;2846;8961;346;1035;1872;6050;2218;7085
231270;201712;6703;18058;5732;16505;197;803;4416;12438;4613;13241
231280;201712;1674;5383;1561;5165;140;470;1116;3700;1256;4170
231290;201712;35856;112310;31583;103403;5642;19308;14510;47058;20152;66366
231300;201712;3978;11480;3265;10018;272;884;2141;6472;2413;7356
231310;201712;7383;20303;5993;17517;710;2085;3673;10599;4383;12684
231320;201712;7219;21033;5811;18266;153;697;4467;13814;4620;14511
231325;201712;2551;7304;2160;6658;429;1281;1142;3618;1571;4899
231330;201712;10267;32366;8763;29230;1730;5708;4476;15306;6206;21014
231335;201712;5451;14960;4652;13595;119;546;3946;11309;4065;11855
231340;201712;17447;55640;15868;52998;1239;4274;11885;40114;13124;44388
231350;201712;14950;42266;13781;40665;347;1090;12462;36903;12809;37993
231355;201712;4463;13821;4012;13022;226;869;3051;9841;3277;10710
231360;201712;7465;23276;6568;21713;652;2232;4622;15458;5274;17690
231370;201712;2339;6366;1839;5496;52;150;1385;4117;1437;4267
231375;201712;4190;13649;3865;13044;150;683;3173;10549;3323;11232
231380;201712;5599;15848;5250;15401;171;435;4559;13679;4730;14114
231390;201712;3343;10132;3010;9561;218;811;2147;6663;2365;7474
231395;201712;3877;12085;3326;11133;637;2144;1792;6098;2429;8242
231400;201712;8944;26764;8044;25044;405;1572;6169;18855;6574;20427
231410;201712;14725;47004;13216;44574;985;3499;10050;33703;11035;37202
240010;201712;2495;7043;1957;6033;195;707;1190;3565;1385;4272
240020;201712;10720;32250;9428;29779;1153;3938;5827;18359;6980;22297
240030;201712;2538;6933;2440;6796;115;373;2150;5930;2265;6303
240040;201712;858;2449;696;2121;16;79;514;1494;530;1573
240050;201712;3319;8925;2746;7902;68;230;2155;6082;2223;6312
240060;201712;1377;3847;1191;3491;43;150;942;2694;985;2844
240070;201712;2242;6780;2066;6415;244;788;1476;4520;1720;5308
240080;201712;2813;7620;2385;6942;104;376;1802;5177;1906;5553
240090;201712;2244;5818;1840;5122;34;123;1465;3999;1499;4122
240100;201712;8452;22773;7069;20140;485;1479;5192;14420;5677;15899
240110;201712;4555;13747;3969;12655;396;1417;2534;7971;2930;9388
240120;201712;2535;8709;2394;8416;265;1065;1585;5502;1850;6567
240130;201712;2978;7189;2593;6598;85;276;2263;5656;2348;5932
240140;201712;2154;6440;1814;5775;203;747;1163;3643;1366;4390
240145;201712;6001;17887;5165;16445;818;2732;3180;10294;3998;13026
240150;201712;873;2698;772;2485;53;209;586;1822;639;2031
240160;201712;1378;4284;1200;3952;81;312;837;2782;918;3094
240165;201712;843;2541;730;2302;101;315;485;1528;586;1843
240170;201712;2267;6639;1941;6045;253;885;1192;3598;1445;4483
240180;201712;2723;8413;2361;7659;420;1384;1363;4506;1783;5890
240185;201712;1282;4267;1172;4082;67;286;959;3321;1026;3607
240190;201712;957;2980;845;2788;25;120;689;2243;714;2363
240200;201712;11295;30340;9511;27435;1629;4847;4431;12963;6060;17810
240210;201712;2781;7576;2510;7121;69;281;2101;5787;2170;6068
240220;201712;7277;23706;6599;22685;592;2498;4769;16360;5361;18858
240230;201712;5750;14997;4777;13399;282;780;3739;10479;4021;11259
240240;201712;1773;5372;1062;3564;169;585;226;711;395;1296
240250;201712;2658;7595;2467;7339;193;521;1960;5885;2153;6406
240260;201712;11865;38496;11060;37134;1484;5223;7187;24515;8671;29738
240270;201712;2271;6926;2079;6624;121;368;1683;5435;1804;5803
240280;201712;1590;4275;1390;3994;50;164;1149;3243;1199;3407
240290;201712;1184;3593;1008;3227;43;208;675;1994;718;2202
240300;201712;2257;6023;1668;4861;122;392;948;2704;1070;3096
240310;201712;9139;25155;7859;23007;1004;3087;4346;12715;5350;15802
240320;201712;2002;5620;1428;4428;33;159;1135;3319;1168;3478
240325;201712;29297;82999;23644;73191;6703;21826;6279;20653;12982;42479
240330;201712;1454;4294;1216;3800;60;238;820;2458;880;2696
240340;201712;1953;4860;1600;4316;91;241;1226;3248;1317;3489
240350;201712;2030;5502;1867;5308;43;151;1649;4689;1692;4840
240360;201712;6839;20702;6114;19548;1373;4313;3209;10823;4582;15136
240370;201712;2007;5490;1582;4658;129;382;1021;2982;1150;3364
240375;201712;861;2267;757;2074;36;145;569;1477;605;1622
240380;201712;2328;6767;1703;5349;159;515;950;2935;1109;3450
240390;201712;912;2437;691;1980;9;25;480;1291;489;1316
240400;201712;1318;3481;1021;2910;35;123;703;1915;738;2038
240410;201712;501;1598;441;1465;59;234;264;851;323;1085
240420;201712;4548;17121;4166;16230;648;3072;2256;8595;2904;11667
240430;201712;3251;9005;2854;8239;201;714;2136;5942;2337;6656
240440;201712;2531;6069;2159;5561;237;633;1511;3844;1748;4477
240450;201712;3914;11296;3226;9993;371;1248;1912;5790;2283;7038
240460;201712;2980;8789;2772;8490;255;870;2182;6647;2437;7517
240470;201712;3604;11097;2815;9426;359;1223;1597;5360;1956;6583
240480;201712;540;1472;397;1192;36;111;193;573;229;684
240485;201712;2091;6274;1776;5652;172;560;1183;3815;1355;4375
240490;201712;1728;4302;1419;3784;30;70;1203;3203;1233;3273
240500;201712;2212;6041;1933;5646;65;221;1620;4710;1685;4931
240510;201712;1639;4618;1513;4432;118;372;1236;3562;1354;3934
240520;201712;1278;3440;1088;3164;45;184;916;2588;961;2772
240530;201712;1883;6030;1742;5791;145;536;1318;4334;1463;4870
240540;201712;2014;5416;1817;5121;64;232;1574;4350;1638;4582
240550;201712;719;2014;621;1842;37;117;465;1372;502;1489
240560;201712;3297;9036;2898;8489;303;779;2165;6468;2468;7247
240570;201712;2928;7931;2073;5997;284;881;983;2594;1267;3475
240580;201712;7520;22722;6946;21733;524;1825;5541;17224;6065;19049
240590;201712;708;1947;605;1759;20;76;476;1355;496;1431
240600;201712;1657;4679;1244;3808;100;353;767;2260;867;2613
240610;201712;4441;12518;3799;11329;244;812;2663;7817;2907;8629
240615;201712;1026;2960;818;2526;90;324;531;1557;621;1881
240620;201712;1830;5313;1573;4864;121;359;1242;3819;1363;4178
240630;201712;2023;6024;1838;5709;151;391;1261;4028;1412;4419
240640;201712;912;2525;736;2237;58;226;509;1491;567;1717
240650;201712;3903;11206;3491;10532;174;554;2766;8312;2940;8866
240660;201712;2550;7426;2385;7188;104;368;2052;6088;2156;6456
240670;201712;2451;7239;2047;6373;185;657;1284;3861;1469;4518
240680;201712;1544;4368;1241;3834;63;230;883;2670;946;2900
240690;201712;898;2372;726;2073;24;84;590;1627;614;1711
240700;201712;2436;7155;2030;6408;69;292;1585;4885;1654;5177
240710;201712;15603;42848;13747;39519;2678;7480;7390;21819;10068;29299
240720;201712;5127;13861;4500;12840;839;2487;2570;7202;3409;9689
240725;201712;1045;3129;816;2602;45;155;524;1632;569;1787
240730;201712;2104;6117;1798;5515;116;373;1347;4079;1463;4452
240740;201712;1842;5128;1581;4638;70;288;1159;3229;1229;3517
240750;201712;2031;7407;1855;7045;361;1491;964;3699;1325;5190
240760;201712;1385;3586;1017;3005;59;158;771;2310;830;2468
240770;201712;3046;8664;2702;8179;130;505;2258;6702;2388;7207
240780;201712;5411;14977;4453;13434;544;1683;2728;8374;3272;10057
240790;201712;864;2546;715;2258;21;86;544;1714;565;1800
240800;201712;35156;96785;30112;88477;5422;16569;13898;41244;19320;57813
240810;201712;79460;224211;71726;210599;17144;50252;33992;102001;51136;152253
240820;201712;5262;16811;4704;15868;969;3344;2442;8592;3411;11936
240830;201712;8597;25745;7959;24777;338;1433;6579;20178;6917;21611
240840;201712;1121;3006;928;2665;81;243;632;1769;713;2012
240850;201712;1254;3629;931;2899;67;214;514;1590;581;1804
240860;201712;1243;3473;978;2975;31;138;736;2129;767;2267
240870;201712;1160;3019;902;2575;64;193;617;1717;681;1910
240880;201712;1237;4034;1167;3894;89;332;933;3085;1022;3417
240890;201712;4731;13126;3744;11217;658;2060;1737;5150;2395;7210
240895;201712;2590;8789;2412;8492;242;910;1816;6451;2058;7361
240910;201712;3047;8781;2649;7998;76;285;2153;6429;2229;6714
240920;201712;789;2451;677;2224;79;279;365;1193;444;1472
240930;201712;3472;8580;2989;7993;85;188;2421;6586;2506;6774
240933;201712;1702;4344;1457;3948;45;163;1201;3181;1246;3344
240940;201712;6204;15872;4982;13847;388;1111;3495;9510;3883;10621
240950;201712;947;2989;846;2782;42;181;630;2025;672;2206
240960;201712;788;2386;686;2181;48;162;496;1549;544;1711
240970;201712;1826;4961;1516;4402;61;234;1226;3430;1287;3664
240980;201712;2845;9187;2608;8752;280;1071;1862;6147;2142;7218
240990;201712;2517;7451;2326;7060;314;1024;1610;4804;1924;5828
241000;201712;954;2610;806;2339;35;117;562;1609;597;1726
241010;201712;2664;8879;2510;8586;270;1129;1807;5964;2077;7093
241020;201712;2037;5575;1541;4554;192;523;895;2636;1087;3159
241025;201712;1684;4999;1413;4494;86;297;942;2999;1028;3296
241030;201712;2394;7782;2034;7018;193;736;1357;4637;1550;5373
241040;201712;2268;7392;2033;6991;130;552;1567;5381;1697;5933
241050;201712;1260;3654;1062;3289;57;200;767;2325;824;2525
241060;201712;768;2197;679;2024;56;160;463;1376;519;1536
241070;201712;639;1831;571;1714;40;152;436;1228;476;1380
241080;201712;1132;3269;871;2749;21;98;640;1974;661;2072
241090;201712;1905;5771;1636;5291;69;313;1258;4013;1327;4326
241100;201712;1103;3237;922;2831;51;181;639;1904;690;2085
241105;201712;1100;3323;929;3015;248;788;371;1244;619;2032
241110;201712;862;2575;682;2171;33;124;449;1375;482;1499
241120;201712;7084;21182;6278;19730;1391;4135;3249;10909;4640;15044
241140;201712;3284;8692;2768;7697;175;481;2039;5536;2214;6017
241142;201712;761;2130;569;1746;44;155;336;995;380;1150
241150;201712;5484;15501;4893;14502;251;946;3779;10977;4030;11923
241160;201712;1426;4090;1252;3798;158;462;851;2577;1009;3039
241170;201712;1185;3230;1061;3020;54;175;864;2382;918;2557
241180;201712;959;2608;712;2107;72;214;384;1122;456;1336
241190;201712;1115;3018;903;2584;34;129;655;1788;689;1917
241200;201712;17807;49955;15638;46656;3550;10886;7433;22786;10983;33672
241210;201712;1439;3964;1112;3301;107;333;671;1960;778;2293
241220;201712;8028;25564;7247;24151;2186;7334;3006;10489;5192;17823
241230;201712;2981;8321;2686;7848;110;420;2240;6356;2350;6776
241240;201712;1180;3440;692;2261;48;179;351;1153;399;1332
241250;201712;5864;17594;4813;15563;200;1006;3562;11061;3762;12067
241255;201712;1836;6471;1636;6019;202;886;1017;3681;1219;4567
241260;201712;5009;13368;3957;11665;116;507;2954;8504;3070;9011
241270;201712;1800;5392;1546;4889;114;453;1121;3478;1235;3931
241280;201712;1842;5133;1665;4821;104;318;1331;3798;1435;4116
241290;201712;3120;8195;2490;7142;107;385;1918;5374;2025;5759
241300;201712;1470;4102;1230;3667;42;132;827;2419;869;2551
241310;201712;1812;5002;1625;4698;51;195;1372;3902;1423;4097
241320;201712;893;3101;801;2882;93;389;528;1872;621;2261
241330;201712;1377;4134;1278;4005;50;212;1114;3445;1164;3657
241335;201712;2877;8374;2593;7869;114;404;2153;6443;2267;6847
241340;201712;1739;5233;1411;4491;300;987;616;1927;916;2914
241350;201712;1856;5704;1678;5367;98;370;1271;3965;1369;4335
241355;201712;1335;3711;1077;3234;37;146;828;2457;865;2603
241360;201712;2071;5448;1665;4651;68;205;1235;3373;1303;3578
241370;201712;1346;3897;1074;3358;87;312;698;2092;785;2404
241380;201712;640;1786;511;1531;62;207;304;880;366;1087
241390;201712;2613;8315;2415;7993;181;663;1883;6230;2064;6893
241400;201712;3593;10219;3223;9682;243;797;2524;7554;2767;8351
241410;201712;2355;7113;2036;6555;413;1387;1093;3513;1506;4900
241415;201712;1611;4801;1382;4382;118;412;1029;3207;1147;3619
241420;201712;2074;7133;1841;6703;554;2145;591;2184;1145;4329
241430;201712;522;1513;399;1252;37;130;245;745;282;875
241440;201712;6755;22733;6136;21625;508;2117;4639;16191;5147;18308
241445;201712;956;2704;909;2647;30;65;827;2470;857;2535
241450;201712;2867;7419;2546;6962;268;689;1882;5173;2150;5862
241460;201712;3430;9703;2958;8710;201;698;2116;6051;2317;6749
241470;201712;1362;3704;1109;3348;55;201;893;2671;948;2872
241475;201712;1234;3631;961;3084;34;186;702;2121;736;2307
241480;201712;2614;8504;2330;7965;882;3016;630;2487;1512;5503
241490;201712;687;1743;553;1525;24;72;387;1032;411;1104
241500;201712;759;2337;648;2200;19;82;556;1874;575;1956
250010;201712;2722;8313;2262;7319;80;344;1673;5280;1753;5624
250020;201712;1565;4373;1179;3619;57;171;819;2469;876;2640
250030;201712;6747;19083;6137;18193;348;1144;4974;14518;5322;15662
250040;201712;3884;12714;3544;12015;324;1220;2512;8416;2836;9636
250050;201712;3299;9866;3041;9468;297;998;2273;6977;2570;7975
250053;201712;1202;3544;1097;3387;99;336;798;2472;897;2808
250057;201712;651;2506;631;2481;3;8;604;2414;607;2422
250060;201712;5144;14549;4724;13974;429;1299;3688;10976;4117;12275
250070;201712;3831;11467;3503;10858;65;332;2712;8097;2777;8429
250073;201712;757;2184;647;1997;17;67;497;1477;514;1544
250077;201712;2184;6132;1673;5256;97;319;1206;3757;1303;4076
250080;201712;4274;11787;3930;11279;127;463;3315;9348;3442;9811
250090;201712;2670;7210;2459;6878;126;311;2043;5687;2169;5998
250100;201712;3781;11954;3518;11472;179;738;2870;9110;3049;9848
250110;201712;4790;13940;4454;13445;429;1538;3479;10217;3908;11755
250115;201712;501;1522;450;1440;17;92;336;1028;353;1120
250120;201712;1685;5236;1470;4850;60;265;1170;3840;1230;4105
250130;201712;5283;15795;4640;14703;123;662;3720;11532;3843;12194
250135;201712;1058;3131;977;2998;23;93;820;2489;843;2582
250140;201712;2071;6565;2001;6454;98;432;1670;5327;1768;5759
250150;201712;4810;15892;4420;15146;183;891;3434;11499;3617;12390
250153;201712;1461;3825;1200;3444;27;112;996;2802;1023;2914
250157;201712;1765;5551;1605;5214;199;617;1115;3666;1314;4283
250160;201712;3592;9734;3093;9050;54;183;2810;8219;2864;8402
250170;201712;1634;4573;1468;4317;65;236;1203;3505;1268;3741
250180;201712;16216;44896;14837;42927;1043;3515;11176;31595;12219;35110
250190;201712;4015;11406;3583;10710;512;1463;2324;6966;2836;8429
250200;201712;1851;5389;1560;4928;56;221;1278;4010;1334;4231
250205;201712;779;2668;729;2557;22;122;587;2031;609;2153
250210;201712;1488;4741;1376;4551;59;295;1089;3507;1148;3802
250215;201712;1362;4127;1211;3897;70;267;800;2554;870;2821
250220;201712;708;2033;567;1819;25;90;426;1356;451;1446
250230;201712;1635;3925;1245;3298;35;122;987;2518;1022;2640
250240;201712;2240;7141;2052;6806;72;280;1685;5541;1757;5821
250250;201712;4397;12853;3944;12222;124;433;3282;10127;3406;10560
250260;201712;1646;4791;1420;4401;41;139;1138;3522;1179;3661
250270;201712;1260;3820;1103;3622;79;256;827;2838;906;3094
250280;201712;3338;9765;2919;9089;151;528;2284;7062;2435;7590
250290;201712;1711;4646;1465;4299;18;47;1229;3612;1247;3659
250300;201712;5098;14793;4825;14451;264;1119;4111;11978;4375;13097
250310;201712;1089;3227;958;2997;32;133;751;2277;783;2410
250320;201712;8719;23911;7982;22943;646;2042;6341;18014;6987;20056
250330;201712;2359;7099;2007;6573;131;460;1553;5031;1684;5491
250340;201712;1088;3036;946;2811;14;53;804;2350;818;2403
250350;201712;4095;11303;3719;10807;150;396;3208;9419;3358;9815
250355;201712;1933;6037;1783;5850;27;146;1624;5306;1651;5452
250360;201712;1774;5132;1650;4929;33;112;1377;4101;1410;4213
250370;201712;11481;32238;10027;30359;516;1791;8354;25120;8870;26911
250375;201712;1036;3010;926;2857;17;64;828;2574;845;2638
250380;201712;1616;4446;1514;4311;53;202;1251;3428;1304;3630
250390;201712;1766;4741;1475;4251;185;509;987;2873;1172;3382
250400;201712;70470;181365;52542;153214;13801;42176;18022;54349;31823;96525
250403;201712;1581;4947;1439;4761;156;664;1004;3215;1160;3879
250407;201712;1202;3216;1028;2951;75;174;754;2173;829;2347
250410;201712;545;1656;478;1528;12;62;395;1212;407;1274
250415;201712;1905;5566;1690;5188;66;224;1333;4093;1399;4317
250420;201712;1207;3481;1104;3335;20;78;1007;3037;1027;3115
250430;201712;6137;16002;5437;14972;196;628;4497;12137;4693;12765
250435;201712;1355;4016;1191;3737;46;184;913;2822;959;3006
250440;201712;4433;12390;3958;11733;101;378;3384;9924;3485;10302
250450;201712;1837;5076;1574;4714;40;152;1303;3845;1343;3997
250460;201712;6422;18664;6027;18162;297;923;5262;15997;5559;16920
250470;201712;1497;3987;1240;3618;64;232;935;2645;999;2877
250480;201712;3678;10848;3355;10427;48;208;3018;9424;3066;9632
250485;201712;684;1615;497;1332;29;84;397;1026;426;1110
250490;201712;4240;11823;3911;11405;279;933;3190;9239;3469;10172
250500;201712;1883;5431;1685;5103;93;310;1350;4074;1443;4384
250510;201712;5063;13542;4432;12688;84;257;3971;11395;4055;11652
250520;201712;1761;5081;1572;4798;182;608;1032;3078;1214;3686
250523;201712;1928;5239;1785;5060;79;347;1541;4227;1620;4574
250527;201712;1587;4384;1477;4245;32;111;1360;3884;1392;3995
250530;201712;593;1771;522;1670;18;74;464;1474;482;1548
250535;201712;1348;4109;1235;3893;41;204;972;2982;1013;3186
250540;201712;2513;6552;2196;6184;56;163;1951;5485;2007;5648
250550;201712;840;2805;762;2673;31;154;616;2107;647;2261
250560;201712;1652;4892;1529;4707;48;189;1265;3791;1313;3980
250570;201712;2515;7777;2209;7206;93;410;1765;5605;1858;6015
250580;201712;1051;2767;945;2610;51;189;779;2104;830;2293
250590;201712;809;2431;726;2299;22;109;596;1828;618;1937
250600;201712;7212;20345;6595;19409;477;1291;5340;15849;5817;17140
250610;201712;2969;8556;2733;8209;157;545;2232;6635;2389;7180
250620;201712;683;1949;602;1789;38;147;446;1290;484;1437
250625;201712;2519;7570;2339;7288;52;224;2032;6204;2084;6428
250630;201712;9330;27782;8184;25524;1305;4226;4894;14998;6199;19224
250640;201712;3383;10055;3157;9737;123;554;2663;8011;2786;8565
250650;201712;858;2229;729;2058;36;119;582;1586;618;1705
250660;201712;1671;4304;1504;4085;30;80;1373;3713;1403;3793
250670;201712;2286;7446;2147;7202;60;324;1834;5994;1894;6318
250680;201712;5007;13018;4670;12629;142;491;4235;11318;4377;11809
250690;201712;6313;15388;5840;14790;189;457;5305;13393;5494;13850
250700;201712;4338;12572;3894;11884;412;1294;2839;8598;3251;9892
250710;201712;4363;13093;3831;12372;345;1227;2739;8906;3084;10133
250720;201712;2691;7398;2456;7030;40;185;2218;6277;2258;6462
250730;201712;3739;10496;3360;9975;191;686;2762;7987;2953;8673
250740;201712;1889;5108;1590;4672;137;444;1231;3532;1368;3976
250750;201712;94219;255972;84624;241992;9205;28487;57405;161419;66610;189906
250760;201712;2300;6217;2014;5772;129;390;1578;4442;1707;4832
250770;201712;3757;12199;3479;11827;294;1174;2553;8600;2847;9774
250780;201712;1701;4846;1450;4363;127;428;1001;2942;1128;3370
250790;201712;2297;7218;2106;6906;322;1087;1320;4382;1642;5469
250800;201712;2471;6801;2148;6272;92;231;1754;5112;1846;5343
250810;201712;1244;3517;1049;3229;39;149;851;2596;890;2745
250820;201712;1788;5618;1731;5548;77;319;1545;4901;1622;5220
250830;201712;5237;16405;4750;15399;364;1421;3357;10624;3721;12045
250840;201712;860;2744;731;2474;20;91;509;1730;529;1821
250850;201712;1906;5726;1701;5385;51;274;1377;4229;1428;4503
250855;201712;1043;3058;901;2809;34;152;692;2099;726;2251
250860;201712;3155;9887;2638;8959;484;1762;1318;4520;1802;6282
250870;201712;1063;3010;913;2723;36;128;732;2163;768;2291
250880;201712;1517;4085;1244;3681;155;449;815;2472;970;2921
250890;201712;9281;26586;8707;25780;687;2616;6890;19771;7577;22387
250900;201712;2674;8265;2341;7627;99;369;1886;6031;1985;6400
250905;201712;2091;6331;1997;6205;87;339;1741;5360;1828;5699
250910;201712;5030;13947;4586;13337;144;532;3938;11394;4082;11926
250915;201712;1746;4562;1394;4192;26;53;1289;3961;1315;4014
250920;201712;3151;8739;2922;8369;322;866;2135;6085;2457;6951
250930;201712;2019;5794;1868;5572;95;354;1538;4489;1633;4843
250933;201712;1103;3518;986;3279;43;210;703;2255;746;2465
250937;201712;686;1989;573;1780;34;125;428;1304;462;1429
250939;201712;1624;4584;1412;4246;41;178;1163;3390;1204;3568
250940;201712;3694;10626;3437;10217;53;212;3081;9167;3134;9379
250950;201712;1440;4072;1208;3766;34;142;1047;3254;1081;3396
250960;201712;1048;3258;964;3116;31;132;789;2501;820;2633
250970;201712;8329;22555;7148;20651;446;1489;5358;15206;5804;16695
250980;201712;2496;7115;2276;6702;60;253;1840;5256;1900;5509
250990;201712;1915;6251;1685;5753;104;474;1238;4106;1342;4580
251000;201712;2084;5956;1736;5395;44;201;1444;4426;1488;4627
251010;201712;2611;7547;2349;7128;40;151;2103;6379;2143;6530
251020;201712;1654;4537;1522;4373;51;160;1389;3978;1440;4138
251030;201712;991;2784;877;2558;45;158;616;1740;661;1898
251040;201712;1755;5303;1540;4926;58;281;1241;3853;1299;4134
251050;201712;1078;3039;886;2669;86;285;623;1798;709;2083
251060;201712;1018;2270;749;1918;18;84;604;1497;622;1581
251065;201712;455;1297;372;1182;18;77;253;746;271;823
251070;201712;720;2102;642;1999;17;67;547;1686;564;1753
251080;201712;18645;50255;15911;46160;2699;8196;9134;26795;11833;34991
251090;201712;2825;8412;2426;7648;84;319;1891;5867;1975;6186
251100;201712;869;2717;769;2542;34;162;547;1725;581;1887
251110;201712;1742;4949;1515;4511;59;174;1148;3376;1207;3550
251120;201712;6421;20344;5826;19427;359;1472;4465;14735;4824;16207
251130;201712;3655;9057;3311;8672;273;735;2892;7560;3165;8295
251140;201712;4272;12480;3930;11983;114;465;3258;9859;3372;10324
251150;201712;2648;8037;2429;7699;142;607;1925;5936;2067;6543
251160;201712;1887;6047;1760;5855;80;280;1546;5175;1626;5455
251170;201712;1484;4312;1374;4183;37;143;1246;3793;1283;3936
251180;201712;2468;7246;2175;6796;232;796;1433;4429;1665;5225
251190;201712;4401;11881;4161;11586;81;301;3774;10329;3855;10630
251200;201712;3990;12596;3723;12259;85;347;3347;11082;3432;11429
251203;201712;935;3118;889;3020;34;158;680;2247;714;2405
251207;201712;1013;3046;833;2709;22;122;580;1826;602;1948
251210;201712;7490;20359;6247;18763;330;989;5000;15171;5330;16160
251220;201712;1163;2980;931;2665;45;114;731;2114;776;2228
251230;201712;4598;12850;4087;12147;168;609;3466;10094;3634;10703
251240;201712;3413;9840;2954;9178;215;702;2205;6726;2420;7428
251250;201712;9961;28279;9054;26935;853;2761;6494;18820;7347;21581
251260;201712;455;1423;410;1343;14;62;313;1008;327;1070
251270;201712;4120;13166;3725;12652;122;560;3183;10813;3305;11373
251272;201712;1281;3583;1196;3461;37;142;1064;3053;1101;3195
251274;201712;893;2643;741;2370;49;210;502;1514;551;1724
251275;201712;1222;3519;1098;3311;45;186;831;2380;876;2566
251276;201712;1149;3329;1079;3228;51;224;894;2614;945;2838
251278;201712;590;1782;520;1645;46;174;355;1111;401;1285
251280;201712;2236;6435;2047;6119;55;257;1654;4773;1709;5030
251290;201712;5527;14656;5215;14255;339;1229;4326;11431;4665;12660
251300;201712;753;2412;706;2335;14;64;591;1935;605;1999
251310;201712;2789;8208;2553;7853;94;447;2059;6151;2153;6598
251315;201712;1629;5320;1517;5128;96;341;1176;3937;1272;4278
251320;201712;1721;4635;1227;3800;52;185;864;2661;916;2846
251330;201712;1844;4690;1515;4278;43;168;1365;3818;1408;3986
251335;201712;1016;3223;919;3069;54;230;701;2263;755;2493
251340;201712;3473;9440;2925;8711;127;434;2225;6531;2352;6965
251350;201712;1099;3389;1015;3247;35;154;828;2568;863;2722
251360;201712;1770;5351;1463;4928;26;115;1266;4298;1292;4413
251365;201712;716;2106;583;1815;12;53;452;1393;464;1446
251370;201712;22383;66343;21300;64826;2043;6823;16014;48248;18057;55071
251380;201712;1280;3834;1103;3541;25;122;930;2888;955;3010
251385;201712;714;1884;563;1621;21;66;405;1109;426;1175
251390;201712;5810;18545;5068;17142;1057;3764;2608;8739;3665;12503
251392;201712;995;2830;857;2604;43;167;635;1874;678;2041
251394;201712;620;1993;537;1850;26;120;408;1375;434;1495
251396;201712;750;2089;643;1913;40;105;440;1291;480;1396
251398;201712;915;2505;698;2124;27;111;501;1467;528;1578
251400;201712;1117;3062;927;2794;50;174;668;1944;718;2118
251410;201712;1603;3948;1314;3515;25;90;1099;2857;1124;2947
251420;201712;1867;5197;1570;4846;64;270;1225;3687;1289;3957
251430;201712;1528;4997;1380;4750;41;214;1190;4033;1231;4247
251440;201712;1129;3321;921;2914;27;104;733;2304;760;2408
251445;201712;1525;4519;1434;4397;87;337;1149;3427;1236;3764
251450;201712;4371;13505;3978;12943;90;413;3337;10746;3427;11159
251455;201712;1002;3124;889;2904;54;235;657;2095;711;2330
251460;201712;833;2505;750;2374;29;117;622;1989;651;2106
251465;201712;433;1351;364;1193;15;66;276;893;291;959
251470;201712;1133;3212;881;2675;82;259;546;1619;628;1878
251480;201712;915;2517;788;2308;27;116;584;1642;611;1758
251490;201712;1806;5125;1520;4714;116;392;1030;3147;1146;3539
251500;201712;1759;5400;1661;5220;81;327;1400;4322;1481;4649
251510;201712;2451;7900;2185;7345;221;847;1375;4523;1596;5370
251520;201712;943;2563;734;2143;85;225;463;1338;548;1563
251530;201712;12427;32855;11264;31274;187;867;9947;27112;10134;27979
251540;201712;2790;8596;2550;8141;114;440;2029;6373;2143;6813
251550;201712;3511;8888;2849;8030;78;273;2370;6627;2448;6900
251560;201712;608;1894;549;1796;94;337;327;1019;421;1356
251570;201712;936;2739;766;2399;26;103;549;1655;575;1758
251580;201712;1836;4808;1644;4544;159;423;1282;3534;1441;3957
251590;201712;1534;4251;1367;4042;56;180;1110;3249;1166;3429
251593;201712;971;2911;891;2793;110;365;543;1659;653;2024
251597;201712;1952;5817;1869;5710;28;108;1708;5178;1736;5286
251600;201712;6391;18100;5803;17200;214;716;4828;14143;5042;14859
251610;201712;3282;9534;2862;8760;316;912;1970;6115;2286;7027
251615;201712;1134;3078;918;2714;27;125;679;1929;706;2054
251620;201712;16432;41110;13846;38048;293;738;11577;33357;11870;34095
251630;201712;4544;11321;3753;10219;218;621;2840;7660;3058;8281
251640;201712;2064;6135;1886;5793;70;299;1587;4773;1657;5072
251650;201712;4010;11064;3593;10516;171;574;3054;8884;3225;9458
251660;201712;3432;10658;3052;9975;88;435;2540;8121;2628;8556
251670;201712;4319;12487;3824;11830;35;165;3534;10960;3569;11125
251675;201712;691;2090;634;2015;101;349;401;1252;502;1601
251680;201712;2651;7464;2170;6736;60;223;1762;5424;1822;5647
251690;201712;3285;9507;2875;8720;83;281;2102;6244;2185;6525
251700;201712;1861;5914;1740;5755;80;380;1453;4695;1533;5075
251710;201712;823;2188;555;1626;58;210;282;794;340;1004
251720;201712;1381;4068;1142;3615;35;151;874;2672;909;2823
251740;201712;681;1914;539;1658;39;134;365;1084;404;1218
260005;201712;25940;59899;21801;54246;2875;7084;14510;35971;17385;43055
260010;201712;9602;25672;8048;23478;594;1759;5041;15045;5635;16804
260020;201712;6485;16433;5464;14931;137;549;4579;12356;4716;12905
260030;201712;6181;17009;5363;15741;257;876;4253;12448;4510;13324
260040;201712;8302;22302;6926;20394;693;1956;4820;14495;5513;16451
260050;201712;11456;33966;10509;32829;397;1390;9116;28825;9513;30215
260060;201712;3820;10410;3313;9544;261;716;2504;7277;2765;7993
260070;201712;9723;26815;8690;25210;703;2326;6356;18149;7059;20475
260080;201712;6335;15450;5591;14357;211;631;4611;11593;4822;12224
260090;201712;5129;13497;4703;12920;587;1577;3451;9603;4038;11180
260100;201712;3209;8720;2742;8055;127;456;2243;6560;2370;7016
260105;201712;5131;13917;4668;13258;130;545;3982;11051;4112;11596
260110;201712;22114;59431;20083;56837;989;2961;17306;48861;18295;51822
260120;201712;13302;37902;11591;35106;1875;5768;6836;21293;8711;27061
260130;201712;3037;8327;2801;7948;278;835;2077;5803;2355;6638
260140;201712;12657;30556;10938;28413;606;1743;8986;23368;9592;25111
260150;201712;3334;8519;2881;7952;167;545;2373;6480;2540;7025
260160;201712;5775;17002;4955;15905;133;607;4249;13735;4382;14342
260170;201712;16798;45075;15434;43193;1268;3442;12154;34175;13422;37617
260180;201712;3280;9507;2956;9033;152;533;2490;7529;2642;8062
260190;201712;16715;36823;14705;34431;250;738;12880;29662;13130;30400
260200;201712;11129;27543;9845;25929;382;1104;8691;22784;9073;23888
260210;201712;11870;34682;10267;32083;388;1524;8320;25934;8708;27458
260220;201712;9671;25600;9178;24971;261;907;8302;22334;8563;23241
260230;201712;9916;26656;8792;25102;378;1299;7033;19905;7411;21204
260240;201712;2814;8333;2461;7791;215;733;1865;5896;2080;6629
260250;201712;2165;5972;1890;5572;81;290;1533;4431;1614;4721
260260;201712;12100;33603;10736;31549;573;2028;8426;24475;8999;26503
260270;201712;3575;10068;3263;9616;195;825;2517;7167;2712;7992
260280;201712;12850;40291;11802;38760;539;2042;10102;33158;10641;35200
260290;201712;34636;97092;31463;92019;4522;13735;20038;58196;24560;71931
260300;201712;8959;26116;7904;24566;275;1213;6391;19777;6666;20990
260310;201712;4382;12456;3936;11819;560;1567;2697;8360;3257;9927
260320;201712;7322;22319;6623;21083;289;1054;5416;17112;5705;18166
260330;201712;2503;7919;2302;7532;108;421;1804;5761;1912;6182
260340;201712;1942;5414;1733;5119;35;136;1526;4471;1561;4607
260345;201712;22598;65467;20345;61702;4480;14636;8993;26434;13473;41070
260350;201712;4946;12823;4507;12232;139;475;3925;10537;4064;11012
260360;201712;2470;6787;2232;6360;86;376;1550;4327;1636;4703
260370;201712;5438;16353;4770;15154;260;1043;3620;11347;3880;12390
260380;201712;4833;15200;4263;14271;240;960;3135;10393;3375;11353
260390;201712;4175;13062;3612;11912;264;955;2479;8058;2743;9013
260392;201712;3423;11049;3114;10638;158;790;2598;8752;2756;9542
260400;201712;14454;38047;13120;36107;1107;3375;9771;26403;10878;29778
260410;201712;59736;162406;49808;147511;11656;36566;20539;62473;32195;99039
260415;201712;3746;11187;3267;10255;149;673;2341;7072;2490;7745
260420;201712;12347;27486;10829;25796;188;596;9875;23301;10063;23897
260430;201712;2875;9033;2486;8290;162;631;1726;5690;1888;6321
260440;201712;3427;9754;3016;9000;202;762;2282;6606;2484;7368
260450;201712;5264;14291;4896;13822;178;529;4293;12146;4471;12675
260460;201712;5273;16642;4770;15668;644;2384;2798;8971;3442;11355
260470;201712;4787;13255;4145;12517;112;299;3686;11436;3798;11735
260480;201712;4180;11336;3543;10430;373;1240;2353;7057;2726;8297
260490;201712;4996;12589;4395;11573;110;406;3801;9732;3911;10138
260500;201712;5946;16114;5075;14823;573;1621;3368;9996;3941;11617
260510;201712;9285;23253;8108;21687;237;766;7193;19063;7430;19829
260515;201712;4499;13110;3446;11026;173;621;2265;7162;2438;7783
260520;201712;16872;41654;15545;39883;1142;2990;12504;31886;13646;34876
260530;201712;9206;27899;8072;26092;247;1098;6820;21900;7067;22998
260540;201712;6056;14603;5469;13937;555;1157;4526;11869;5081;13026
260545;201712;48;146;23;87;7;24;4;17;11;41
260550;201712;2799;8592;2358;7672;221;879;1416;4516;1637;5395
260560;201712;6166;16004;5367;14883;132;564;4610;12580;4742;13144
260570;201712;7000;21052;6336;20082;602;1956;4866;15485;5468;17441
260580;201712;3890;10267;3497;9676;51;213;3137;8566;3188;8779
260590;201712;6472;15831;5767;15019;260;708;4966;12989;5226;13697
260600;201712;29384;81092;24980;74166;1444;5116;18437;54030;19881;59146
260610;201712;6407;18330;5976;17694;511;1611;4491;13225;5002;14836
260620;201712;14638;42892;13797;41515;2019;6711;8926;26302;10945;33013
260630;201712;2325;6408;1949;5836;52;220;1622;4818;1674;5038
260640;201712;18089;46269;16281;44013;1268;3797;12367;33129;13635;36926
260650;201712;5392;16061;4652;14872;190;804;3837;12189;4027;12993
260660;201712;7428;20102;6525;18956;186;765;5560;15907;5746;16672
260670;201712;2257;5930;1869;5361;105;306;1346;3842;1451;4148
260680;201712;22439;60010;19786;55701;2760;7932;11365;31857;14125;39789
260690;201712;3587;9532;2991;8585;123;394;2406;6871;2529;7265
260700;201712;5722;17154;5538;16943;23;38;5418;16746;5441;16784
260710;201712;1303;3597;1219;3480;68;225;899;2631;967;2856
260720;201712;18850;55667;17342;53129;3038;9459;10181;31219;13219;40678
260730;201712;6931;21578;6275;20613;415;1603;5058;16330;5473;17933
260740;201712;1301;3797;1150;3546;26;93;955;2948;981;3041
260750;201712;6950;19900;6006;18698;157;463;5388;17065;5545;17528
260760;201712;5141;13056;4596;12387;221;667;3787;10258;4008;10925
260765;201712;7393;24108;6785;23146;825;3416;4545;15101;5370;18517
260770;201712;3744;9991;3279;9222;105;346;2587;7215;2692;7561
260775;201712;4983;14133;4611;13577;304;1167;3448;9850;3752;11017
260780;201712;3603;11152;3315;10632;466;1647;2094;6569;2560;8216
260790;201712;108937;264415;96895;247495;17650;45200;56681;144469;74331;189669
260795;201712;3063;8575;2680;7987;155;522;2012;6021;2167;6543
260800;201712;5421;13090;4938;12415;115;391;4432;10803;4547;11194
260805;201712;3595;10759;3052;9820;233;884;2117;6738;2350;7622
260810;201712;6385;17981;5908;17083;537;1580;4414;12597;4951;14177
260820;201712;4156;10907;3677;10196;340;1197;2637;7052;2977;8249
260825;201712;2838;8869;2500;8288;131;545;1868;6131;1999;6676
260830;201712;4037;12336;3427;11174;477;1492;2256;7488;2733;8980
260840;201712;4150;11582;3666;10862;192;603;2995;8818;3187;9421
260845;201712;4017;11314;3752;10844;315;907;2779;8029;3094;8936
260850;201712;4905;14917;4284;13640;570;1928;2464;7713;3034;9641
260860;201712;3525;10358;3008;9355;123;480;2365;7222;2488;7702
260870;201712;4268;10911;3742;10240;129;477;3235;8685;3364;9162
260875;201712;6379;17351;5483;15934;725;2124;3563;10476;4288;12600
260880;201712;9789;28177;8734;26456;414;1323;7031;21404;7445;22727
260890;201712;12913;35787;11809;34140;937;3058;8530;24229;9467;27287
260900;201712;5449;16465;4693;15080;344;1361;3144;9907;3488;11268
260910;201712;3088;8981;2751;8413;121;431;2108;6407;2229;6838
260915;201712;4700;14903;4289;14342;63;347;3938;13115;4001;13462
260920;201712;3199;9381;2897;8982;122;441;2437;7656;2559;8097
260930;201712;3663;11925;3265;11226;228;881;2455;8427;2683;9308
260940;201712;14033;35616;12672;33497;1137;3280;9117;23686;10254;26966
260950;201712;6357;18853;5341;16855;762;2592;2697;8142;3459;10734
260960;201712;58140;148386;50471;136856;8238;23774;28324;75687;36562;99461
260970;201712;4898;14194;4461;13624;188;604;3534;10906;3722;11510
260980;201712;4177;12922;3828;12484;78;337;3451;11252;3529;11589
260990;201712;17119;50610;15177;47928;935;3331;11741;37009;12676;40340
261000;201712;15494;40095;12905;36350;1087;3350;8698;24739;9785;28089
261010;201712;2459;6674;2224;6378;73;180;2007;5802;2080;5982
261020;201712;6281;17769;5455;16279;437;1426;4074;11830;4511;13256
261030;201712;3910;11439;3407;10624;185;606;2685;8342;2870;8948
261040;201712;5084;15873;4268;14144;293;1114;3058;9942;3351;11056
261050;201712;7375;20788;6782;19783;695;1981;4637;13587;5332;15568
261060;201712;12460;34352;11389;32708;799;2503;8902;25298;9701;27801
261070;201712;53530;125516;46281;115395;4136;10359;33228;82233;37364;92592
261080;201712;5742;15698;5417;15233;235;656;4828;13650;5063;14306
261090;201712;16532;43398;15086;41433;578;1876;12845;35017;13423;36893
261100;201712;7998;24151;7059;22623;840;2774;4696;15317;5536;18091
261110;201712;58812;173077;51378;161099;12350;40516;23329;74929;35679;115445
261120;201712;3762;9737;3272;9137;71;224;2933;8224;3004;8448
261130;201712;7369;18093;6617;17202;159;467;5899;15278;6058;15745
261140;201712;3295;8434;2974;7970;254;741;2233;5929;2487;6670
261150;201712;5224;14501;4651;13615;162;594;3938;11428;4100;12022
261153;201712;1970;5895;1683;5424;87;349;1183;3778;1270;4127
261160;201712;196610;497531;174753;465995;44604;123925;72627;197361;117231;321286
261170;201712;5691;14919;5173;14188;294;807;4151;11332;4445;12139
261180;201712;9600;25631;8697;24414;704;2199;6209;17247;6913;19446
261190;201712;4839;14728;4444;14190;397;1568;3217;10035;3614;11603
261200;201712;3464;8287;3070;7804;254;684;2428;6103;2682;6787
261210;201712;1861;4749;1673;4481;70;209;1475;3941;1545;4150
261220;201712;13324;39832;11229;35689;1589;5454;6311;19924;7900;25378
261230;201712;4622;13700;3966;12878;93;398;3363;11036;3456;11434
261240;201712;4906;13419;4382;12587;345;953;3419;9840;3764;10793
261245;201712;3467;10377;2980;9514;127;584;2341;7234;2468;7818
261247;201712;2975;9098;2540;8302;156;595;1831;5958;1987;6553
261250;201712;18912;47718;16727;45059;2973;7711;10656;29891;13629;37602
261255;201712;3990;12141;3508;11250;186;820;2735;8516;2921;9336
261260;201712;12477;34454;10923;32511;390;1469;9275;27626;9665;29095
261270;201712;3829;10840;3444;10224;239;831;2644;7645;2883;8476
261280;201712;2551;7478;2306;7063;93;381;1856;5556;1949;5937
261290;201712;2917;8088;2569;7635;128;464;2031;6069;2159;6533
261300;201712;11149;33770;9664;31063;784;3022;6690;21037;7474;24059
261310;201712;6992;20552;6351;19534;1304;4089;3698;11352;5002;15441
261320;201712;5791;17145;5181;16082;133;541;4289;13107;4422;13648
261330;201712;5651;15149;5267;14647;201;804;4576;12445;4777;13249
261340;201712;3947;12448;3553;11845;245;1044;2634;8705;2879;9749
261350;201712;8129;25185;7556;24246;179;901;6251;19663;6430;20564
261360;201712;8240;20964;7122;19386;379;1113;5713;15247;6092;16360
261370;201712;18756;53486;17331;51258;3302;10047;9972;29619;13274;39666
261380;201712;3927;12865;3630;12248;545;2027;2249;7460;2794;9487
261390;201712;16009;47651;14154;44473;1666;5647;8781;27572;10447;33219
261400;201712;4591;15357;4075;14260;201;892;2980;10248;3181;11140
261410;201712;9101;24282;7843;22284;570;1695;6228;17648;6798;19343
261420;201712;6961;22849;6605;22372;1171;4471;4162;13988;5333;18459
261430;201712;3477;10283;2956;9474;136;455;2377;7646;2513;8101
261440;201712;1517;4679;1345;4351;46;223;966;3037;1012;3260
261450;201712;13614;38643;12858;37588;343;1270;11032;32088;11375;33358
261460;201712;6959;19983;6430;19229;261;867;5602;16689;5863;17556
261470;201712;4086;10831;3696;10313;59;280;3090;8620;3149;8900
261480;201712;4387;14354;3893;13516;229;959;2977;10128;3206;11087
261485;201712;4957;14679;4342;13652;448;1626;2910;8984;3358;10610
261500;201712;5494;14985;4851;14114;415;1171;3522;10521;3937;11692
261510;201712;1819;5721;1603;5343;97;387;1200;4014;1297;4401
261520;201712;2582;8031;2422;7724;97;381;1658;5424;1755;5805
261530;201712;10478;33225;9234;30757;1492;5595;4323;14222;5815;19817
261540;201712;7300;22341;6668;21319;1203;3905;3877;12683;5080;16588
261550;201712;3516;9609;3166;9069;250;836;2362;6646;2612;7482
261560;201712;7276;22807;6473;21693;485;2003;4868;16228;5353;18231
261570;201712;3397;9722;2883;8881;249;898;1936;5849;2185;6747
261580;201712;6322;17549;5751;16688;158;694;5092;14576;5250;15270
261590;201712;2623;7004;2167;6319;98;291;1674;4933;1772;5224
261600;201712;5163;13624;4370;12459;382;1096;3017;8740;3399;9836
261610;201712;2464;6700;2088;6137;72;253;1654;4869;1726;5122
261618;201712;2462;6561;2211;6224;98;292;1825;5069;1923;5361
261620;201712;3910;11940;3659;11526;848;2521;2137;7054;2985;9575
261630;201712;6945;19921;5915;18032;516;1897;3680;10808;4196;12705
261640;201712;34276;81979;31322;78437;1828;4052;25620;66324;27448;70376
261650;201712;4000;10918;3600;10393;151;584;2705;7846;2856;8430
270010;201712;4264;15354;3879;14616;205;1090;3053;11299;3258;12389
270020;201712;3778;10102;3425;9615;234;807;2807;7646;3041;8453
270030;201712;34545;99922;31024;94190;4979;15257;19220;58913;24199;74170
270040;201712;10660;30607;9514;29170;624;2250;7644;23412;8268;25662
270050;201712;4696;11980;4146;11352;238;662;3584;9893;3822;10555
270060;201712;1893;5263;1694;4996;195;580;1219;3668;1414;4248
270070;201712;4435;13228;3953;12531;162;749;3305;10212;3467;10961
270080;201712;1322;3958;1119;3584;90;318;808;2518;898;2836
270090;201712;1993;6195;1772;5755;83;387;1385;4334;1468;4721
270100;201712;5387;15590;4906;14878;364;1319;3846;11479;4210;12798
270110;201712;2980;7891;2522;7387;203;625;1965;5899;2168;6524
270120;201712;3009;8256;2656;7816;78;306;2370;6948;2448;7254
270130;201712;5275;14626;4612;13868;320;1046;3693;11235;4013;12281
270135;201712;1876;4826;1644;4552;85;197;1462;4101;1547;4298
270140;201712;10364;23900;8516;21459;450;1727;6920;16505;7370;18232
270150;201712;2611;8204;2522;8090;26;98;2470;7918;2496;8016
270160;201712;5070;16062;4535;15379;129;657;3957;13287;4086;13944
270170;201712;3563;11023;3162;10450;328;1370;2219;7126;2547;8496
270180;201712;2255;7161;2070;6906;70;333;1763;5771;1833;6104
270190;201712;1713;5341;1596;5190;70;261;1335;4354;1405;4615
270200;201712;2511;7916;2223;7527;160;674;1645;5418;1805;6092
270210;201712;5184;13697;4602;12990;201;657;4064;11389;4265;12046
270220;201712;1259;3858;1134;3673;219;811;650;2048;869;2859
270230;201712;9652;29452;8434;27451;896;3548;5405;17009;6301;20557
270235;201712;5903;18869;5391;18015;278;1168;4362;14432;4640;15600
270240;201712;10366;29099;8659;26943;1248;4250;5846;18128;7094;22378
270250;201712;2891;7630;2614;7276;298;778;1994;5601;2292;6379
270255;201712;4694;13842;3647;11922;200;824;2621;8350;2821;9174
270260;201712;5573;17204;5267;16731;174;793;4577;14161;4751;14954
270270;201712;1084;2998;994;2878;161;489;632;1796;793;2285
270280;201712;3744;9767;3065;8880;396;844;2151;6527;2547;7371
270290;201712;7760;25698;7167;24678;359;1667;5906;20000;6265;21667
270300;201712;3988;11322;3230;10490;267;959;2363;7714;2630;8673
270310;201712;7162;21065;6290;19706;191;996;5240;15896;5431;16892
270320;201712;5742;17298;5233;16417;687;2288;3605;11129;4292;13417
270330;201712;3873;13155;3555;12714;313;1199;2758;9949;3071;11148
270340;201712;1628;4759;1402;4459;82;321;1132;3523;1214;3844
270350;201712;1898;4823;1627;4480;165;492;1181;3283;1346;3775
270360;201712;2207;6289;2029;6075;112;320;1805;5480;1917;5800
270370;201712;1410;4578;1293;4369;64;285;1005;3370;1069;3655
270375;201712;2971;7595;2544;7051;50;147;2313;6427;2363;6574
270380;201712;5741;17125;5049;16215;436;1499;3712;12072;4148;13571
270390;201712;1227;3291;1034;3014;30;112;826;2369;856;2481
270400;201712;6186;17696;5407;16480;237;893;4133;12255;4370;13148
270410;201712;4558;14132;4118;13356;298;1136;3069;9795;3367;10931
270420;201712;5674;17457;5321;16995;214;957;4408;13815;4622;14772
270430;201712;131369;354421;110422;325381;28835;89699;41435;126398;70270;216097
270440;201712;4801;13640;4216;12905;141;586;3454;10537;3595;11123
270450;201712;6505;18798;5923;18081;340;1259;4855;14701;5195;15960
270460;201712;3378;8387;2994;7930;80;259;2681;6997;2761;7256
270470;201712;10546;32123;9477;30517;1034;3647;6600;21490;7634;25137
270480;201712;2858;8268;2457;7626;229;847;1822;5474;2051;6321
270490;201712;982;2944;878;2814;51;196;690;2194;741;2390
270500;201712;4824;15481;4442;14980;192;944;3706;12292;3898;13236
270510;201712;5810;16450;5119;15501;559;2112;3669;10614;4228;12726
270520;201712;3634;11089;3068;10081;938;3262;971;3403;1909;6665
270530;201712;1204;3691;1104;3542;71;237;827;2665;898;2902
270540;201712;2076;6472;1867;6195;86;425;1562;5037;1648;5462
270550;201712;6636;18639;5714;17586;551;1668;4325;13670;4876;15338
270560;201712;3150;8931;2819;8453;165;570;2189;6489;2354;7059
270570;201712;3789;11706;3346;10992;178;745;2683;8678;2861;9423
270580;201712;2143;6331;2018;6162;81;246;1785;5490;1866;5736
270590;201712;1459;4568;1374;4464;6;25;1353;4399;1359;4424
270600;201712;2786;8902;2496;8424;115;590;2092;6867;2207;7457
270610;201712;3433;9730;2987;9151;122;469;2573;7753;2695;8222
270620;201712;1336;4256;1228;4061;53;243;1022;3282;1075;3525
270630;201712;14684;42304;13262;40078;1342;4283;9749;29597;11091;33880
270640;201712;5578;16593;4898;15551;229;968;3950;12223;4179;13191
270642;201712;2305;7835;2143;7599;143;731;1704;5858;1847;6589
270644;201712;3002;8253;2551;7658;249;781;1893;5776;2142;6557
270650;201712;3432;10489;3173;10127;422;1742;2241;6812;2663;8554
270660;201712;2152;5411;1707;4796;79;251;1268;3547;1347;3798
270670;201712;15885;39558;13640;36945;1142;3087;10644;29142;11786;32229
270680;201712;4662;12627;4266;12179;75;155;4030;11598;4105;11753
270690;201712;9443;24091;8095;22583;1459;3765;5566;16139;7025;19904
270700;201712;556;1734;483;1601;57;240;325;1033;382;1273
270710;201712;5813;17770;5410;17257;291;1274;4536;14174;4827;15448
270720;201712;3340;10689;2976;10065;108;634;2495;8213;2603;8847
270730;201712;6749;17914;6250;17367;401;1006;5359;15350;5760;16356
270740;201712;2305;6303;2093;6031;104;378;1757;4980;1861;5358
270750;201712;5177;15064;4640;14276;363;1317;3602;10999;3965;12316
270760;201712;3474;9981;3063;9358;93;396;2589;7800;2682;8196
270770;201712;19750;50068;16093;45624;3003;8106;9235;28056;12238;36162
270780;201712;1791;5438;1690;5293;119;401;1379;4335;1498;4736
270790;201712;1525;4583;1367;4360;188;631;902;2882;1090;3513
270800;201712;10779;31149;9881;29913;472;2001;8416;24888;8888;26889
270810;201712;3100;9325;2486;8242;195;798;1717;5588;1912;6386
270820;201712;1730;5383;1492;4972;147;553;1064;3499;1211;4052
270830;201712;5634;13945;4780;12874;311;917;3856;10497;4167;11414
270840;201712;8046;24517;7286;23470;223;1206;6362;19935;6585;21141
270850;201712;7995;22114;7285;21193;563;2156;5781;16111;6344;18267
270860;201712;10776;28691;9147;26690;747;2477;6906;19845;7653;22322
270870;201712;2065;6117;1779;5570;209;710;1223;3778;1432;4488
270880;201712;8113;24962;7448;24010;330;1422;6166;19532;6496;20954
270890;201712;2437;7150;2181;6753;170;618;1609;4862;1779;5480
270895;201712;2924;9934;2751;9689;96;527;2438;8407;2534;8934
270900;201712;1797;4790;1425;4203;60;197;1123;3236;1183;3433
270910;201712;3518;10968;3147;10314;155;690;2409;7730;2564;8420
270915;201712;8842;28108;7627;25918;1023;4026;4773;15880;5796;19906
270920;201712;5899;18279;5546;17771;253;1202;4719;14652;4972;15854
270930;201712;16199;41523;13297;38115;2345;6331;8642;25736;10987;32067
270940;201712;5678;17630;5186;17022;331;1543;4003;12834;4334;14377
280010;201712;656;1821;567;1667;29;129;402;1087;431;1216
280020;201712;4754;13084;4125;12075;543;1613;2707;7926;3250;9539
280030;201712;70026;177224;57840;159677;15799;45003;21540;62347;37339;107350
280040;201712;3106;8920;2742;8360;290;944;1916;5807;2206;6751
280050;201712;3591;11001;3271;10493;617;2067;1911;6122;2528;8189
280060;201712;5007;14674;4159;13287;734;2477;2106;6885;2840;9362
280067;201712;6785;18411;5778;16798;628;1866;3832;11101;4460;12967
280070;201712;1937;6118;1861;5994;124;391;1563;5027;1687;5418
280100;201712;3659;10825;3247;10144;386;1325;2240;7006;2626;8331
280110;201712;1300;3897;1195;3725;55;226;992;3002;1047;3228
280120;201712;7717;23417;6987;22198;925;2735;4988;16281;5913;19016
280130;201712;8152;21040;7365;19887;740;2102;5537;14981;6277;17083
280140;201712;5612;14272;5092;13550;336;903;4171;11092;4507;11995
280150;201712;3678;10090;3387;9692;180;619;2800;7907;2980;8526
280160;201712;1253;3692;1041;3316;149;500;644;2015;793;2515
280170;201712;5027;13911;4576;13279;293;828;3714;10897;4007;11725
280190;201712;1202;2893;1002;2601;63;193;799;2001;862;2194
280200;201712;1146;3327;1015;3118;103;385;741;2206;844;2591
280210;201712;14585;39781;12865;37427;2274;6850;7340;21824;9614;28674
280220;201712;1775;4880;1577;4609;51;221;1293;3774;1344;3995
280230;201712;3335;9434;3008;8949;234;798;2273;6652;2507;7450
280240;201712;3428;9400;3112;8911;91;369;2642;7420;2733;7789
280250;201712;836;2174;662;1887;86;271;356;981;442;1252
280260;201712;2050;5300;1891;5107;54;153;1758;4755;1812;4908
280270;201712;2204;6562;1987;6223;106;391;1673;5169;1779;5560
280280;201712;4123;13217;3716;12592;593;1758;2404;8641;2997;10399
280290;201712;16847;48442;15116;45891;1737;5934;9841;29915;11578;35849
280300;201712;10029;27816;8890;26524;502;1744;6845;21301;7347;23045
280310;201712;1337;3673;1135;3315;37;137;841;2381;878;2518
280320;201712;8536;25179;7633;23776;1048;3496;4735;14611;5783;18107
280330;201712;4512;11881;3994;11124;276;877;3162;8604;3438;9481
280340;201712;4600;10837;4000;10152;261;616;3384;8780;3645;9396
280350;201712;22097;58849;19265;54696;2279;6673;13155;37454;15434;44127
280360;201712;5542;16543;5090;15776;836;2693;3011;9388;3847;12081
280370;201712;1988;5121;1675;4630;111;294;1279;3516;1390;3810
280380;201712;996;2931;877;2752;96;352;601;1847;697;2199
280390;201712;3027;8558;2622;7811;153;532;1973;5803;2126;6335
280400;201712;3772;10457;3401;9897;699;1959;1903;5794;2602;7753
280410;201712;2115;6476;1765;5785;191;671;1049;3353;1240;4024
280420;201712;4190;11696;3836;11178;138;447;3372;9802;3510;10249
280430;201712;2094;5343;1861;5015;73;264;1477;3884;1550;4148
280440;201712;4661;12842;4110;12095;287;914;3236;9385;3523;10299
280445;201712;2366;6231;2117;5794;48;163;1610;4239;1658;4402
280450;201712;9806;23588;8852;22356;391;822;7737;19795;8128;20617
280460;201712;6550;16687;6011;15917;592;1570;4740;12598;5332;14168
280470;201712;1791;5226;1592;4878;72;241;1218;3731;1290;3972
280480;201712;33426;90852;30478;86671;3405;10788;21267;59516;24672;70304
280490;201712;3809;11163;3262;10237;120;509;2474;7573;2594;8082
280500;201712;916;2345;808;2194;37;116;668;1805;705;1921
280510;201712;2531;7198;2231;6755;118;472;1624;4875;1742;5347
280520;201712;1708;4488;1529;4258;105;280;1252;3494;1357;3774
280530;201712;2464;6324;2229;6033;121;342;1834;4952;1955;5294
280540;201712;9092;24812;8326;23733;197;912;7352;20423;7549;21335
280550;201712;6752;16795;5547;14962;320;852;4221;11244;4541;12096
280560;201712;7179;20824;6768;20244;215;863;5882;17282;6097;18145
280570;201712;6284;16388;5245;15009;326;1074;3802;10791;4128;11865
280580;201712;5235;15646;4563;14465;601;1861;2988;9669;3589;11530
280590;201712;2649;7054;2307;6616;168;694;1636;4514;1804;5208
280600;201712;3347;9723;3031;9270;234;812;2264;6878;2498;7690
280610;201712;2458;6383;2239;6090;160;460;1812;4871;1972;5331
280620;201712;5298;14300;4606;13244;432;1093;3304;9869;3736;10962
280630;201712;3585;11283;3286;10819;229;819;2574;8580;2803;9399
280640;201712;2307;6677;2132;6485;54;139;1985;6114;2039;6253
280650;201712;1070;3098;922;2888;93;323;668;2048;761;2371
280660;201712;2762;7237;2558;6997;150;396;2195;6025;2345;6421
280670;201712;17299;42536;15516;40212;1335;3686;11632;30161;12967;33847
280680;201712;2777;7142;2358;6465;160;408;1762;4771;1922;5179
280690;201712;959;2538;828;2360;52;158;630;1766;682;1924
280700;201712;1064;2914;936;2703;28;101;719;2043;747;2144
280710;201712;13555;32479;11830;30463;599;1061;10314;27421;10913;28482
280720;201712;2519;5995;2181;5608;152;414;1503;4143;1655;4557
280730;201712;1085;2790;981;2641;60;195;784;2074;844;2269
280740;201712;13389;34763;11473;31782;1233;3417;7574;21020;8807;24437
280750;201712;3423;10074;3112;9543;195;720;2264;6833;2459;7553
280760;201712;5784;16824;5184;15882;706;2181;3279;10354;3985;12535
290010;201712;2982;6521;2106;5163;16;61;1733;4041;1749;4102
290020;201712;4815;14250;4582;13925;248;656;3996;12268;4244;12924
290030;201712;3705;9933;3241;9371;206;580;2715;7866;2921;8446
290035;201712;5040;11669;4113;10452;255;559;3270;8573;3525;9132
290040;201712;4370;10779;3666;9974;173;533;2892;8052;3065;8585
290050;201712;2217;7229;1915;6659;140;573;1337;4600;1477;5173
290060;201712;1304;3290;1028;2876;105;369;706;1889;811;2258
290070;201712;33138;80103;28686;74367;3469;9136;18242;48298;21711;57434
290080;201712;5649;16732;4764;15473;648;2178;3100;10264;3748;12442
290090;201712;2302;4430;1732;3832;50;101;1585;3520;1635;3621
290100;201712;9073;25249;7780;23260;1044;2997;4830;14888;5874;17885
290110;201712;4916;13902;4563;13288;526;1607;3120;9005;3646;10612
290115;201712;4385;12788;3870;12098;188;655;3195;10049;3383;10704
290120;201712;6914;17213;5656;15685;164;574;4814;13153;4978;13727
290130;201712;4562;11608;3673;10504;129;546;2943;8224;3072;8770
290135;201712;4495;10807;3696;9542;249;723;2765;6931;3014;7654
290140;201712;4492;12780;3730;11797;141;513;3243;10264;3384;10777
290150;201712;2243;6494;2112;6294;199;610;1597;4662;1796;5272
290160;201712;3209;7899;2983;7621;373;772;2298;6016;2671;6788
290170;201712;2690;8109;2490;7855;88;369;2217;6922;2305;7291
290180;201712;2894;8134;2404;7346;113;402;1886;5720;1999;6122
290190;201712;3917;12213;3603;11768;179;809;2866;9204;3045;10013
290195;201712;2313;6083;1879;5416;62;284;1513;4282;1575;4566
290200;201712;3946;11582;3389;10720;205;684;2672;8425;2877;9109
290205;201712;3382;9099;2988;8508;138;535;2356;6511;2494;7046
290210;201712;13514;39097;12052;37087;1152;3202;9110;28967;10262;32169
290220;201712;2655;7051;2428;6761;171;536;1981;5442;2152;5978
290225;201712;3408;7450;2798;6795;42;90;2622;6394;2664;6484
290230;201712;2315;6952;2123;6722;91;353;1812;5736;1903;6089
290240;201712;3699;9662;3094;8881;147;516;2473;6977;2620;7493
290250;201712;3899;11811;3545;11350;103;277;3052;10198;3155;10475
290260;201712;5266;13994;4304;12560;237;859;3385;9762;3622;10621
290265;201712;3528;10522;2952;9471;135;579;2261;7158;2396;7737
290270;201712;11836;41307;11227;40305;830;3489;8781;31249;9611;34738
290280;201712;5741;17518;5161;16576;375;1292;3831;12275;4206;13567
290290;201712;9917;29891;8470;27316;845;2832;5897;19016;6742;21848
290300;201712;4512;12475;3260;10100;199;709;2241;6960;2440;7669
290310;201712;1502;4143;1262;3799;120;446;868;2547;988;2993
290320;201712;25406;69978;21492;64761;5361;16449;10227;32138;15588;48587
290323;201712;3572;9919;3207;9433;81;275;2685;7787;2766;8062
290327;201712;4297;12534;3725;11475;320;994;2670;8224;2990;9218
290330;201712;1962;4480;1688;4182;51;104;1526;3829;1577;3933
290340;201712;5684;15677;4638;14370;790;2595;3018;9425;3808;12020
290350;201712;4655;13900;3965;12703;346;1177;2813;9113;3159;10290
290360;201712;4878;13697;4224;12818;111;402;3647;11093;3758;11495
290370;201712;5034;12883;3943;11446;213;566;3085;9093;3298;9659
290380;201712;5507;15381;4784;14342;154;533;4070;12271;4224;12804
290390;201712;14768;43250;12891;40440;1460;4708;8602;27603;10062;32311
290395;201712;2709;8453;2308;7712;82;379;1804;5993;1886;6372
290400;201712;3666;10342;2999;9292;170;608;2201;6697;2371;7305
290405;201712;4703;14151;3970;12857;289;998;2739;9009;3028;10007
290410;201712;5609;16059;4535;14297;192;824;3443;10477;3635;11301
290420;201712;3019;8605;2525;7832;161;518;1940;6012;2101;6530
290430;201712;3141;9241;2623;8370;392;1297;1607;5177;1999;6474
290440;201712;2931;7470;2234;6460;89;304;1629;4753;1718;5057
290450;201712;3239;9082;2701;8285;132;495;2081;6240;2213;6735
290460;201712;12038;34081;10568;31362;2957;9082;3932;11542;6889;20624
290470;201712;4354;11730;3270;10088;572;1921;1601;5090;2173;7011
290475;201712;6015;18322;5230;16899;120;609;4163;13180;4283;13789
290480;201712;2032;5357;1803;5026;154;460;1187;3317;1341;3777
290485;201712;4653;14144;4032;13207;166;842;3394;10877;3560;11719
290490;201712;8605;21382;7957;20544;577;1571;6356;16474;6933;18045
290500;201712;3926;12086;3094;10361;400;1418;1641;5459;2041;6877
290510;201712;3232;8704;2796;8106;102;376;2384;6824;2486;7200
290515;201712;3710;9982;3094;9191;93;245;2691;8175;2784;8420
290520;201712;11367;34189;9096;29723;429;1795;6114;19627;6543;21422
290530;201712;4993;14518;4366;13519;212;666;3587;11118;3799;11784
290540;201712;3654;10103;3283;9613;94;302;2912;8484;3006;8786
290550;201712;4373;11409;3874;10847;49;157;3598;10142;3647;10299
290560;201712;6701;18056;5422;16178;584;1937;3738;10977;4322;12914
290570;201712;42577;111222;38855;106426;2881;8208;30186;82342;33067;90550
290580;201712;7469;23533;6791;22515;662;2153;5102;17298;5764;19451
290590;201712;7006;22096;6054;20376;178;766;4983;16786;5161;17552
290600;201712;17889;51951;16340;49650;961;3030;13080;40207;14041;43237
290610;201712;2467;8121;2009;7206;109;482;1387;4908;1496;5390
290620;201712;6258;18124;5636;17135;247;812;4757;14361;5004;15173
290630;201712;8889;22093;7264;20061;578;1623;5742;15960;6320;17583
290640;201712;2653;7337;2052;6342;86;285;1611;4904;1697;5189
290650;201712;11147;31159;10350;30113;2720;7644;5691;17487;8411;25131
290660;201712;3607;9685;3072;8880;109;282;2285;6950;2394;7232
290670;201712;6798;19786;5959;18427;520;1621;4439;13891;4959;15512
290680;201712;10274;29798;8905;27779;287;1436;7125;21588;7412;23024
290682;201712;4663;12763;4082;11921;143;440;3430;9986;3573;10426
290685;201712;3633;8331;2397;6615;221;577;1559;4447;1780;5024
290687;201712;6836;19524;5485;17274;895;2816;3109;10176;4004;12992
290689;201712;2957;8471;2470;7647;163;574;1797;5606;1960;6180
290690;201712;5565;15024;4643;13807;589;1728;3118;9321;3707;11049
290700;201712;2560;7263;2325;6939;78;286;2011;6017;2089;6303
290710;201712;8310;24251;7288;22847;297;1076;6241;19547;6538;20623
290720;201712;18611;51976;17142;50047;906;2713;14418;42419;15324;45132
290730;201712;7070;18488;6143;17348;298;844;4734;13378;5032;14222
290740;201712;994;2825;751;2381;40;158;562;1761;602;1919
290750;201712;10348;27672;9015;25384;1104;3312;5863;16096;6967;19408
290755;201712;2244;6306;1752;5404;97;349;1228;3721;1325;4070
290760;201712;3989;11869;3174;10276;413;1229;1857;6305;2270;7534
290770;201712;2529;8576;2358;8350;72;345;1957;6977;2029;7322
290780;201712;8398;21254;7272;19652;494;1064;5629;15558;6123;16622
290790;201712;4490;12745;4033;12137;154;419;3469;10518;3623;10937
290800;201712;7231;15123;5422;13085;329;669;4218;10438;4547;11107
290810;201712;5672;15946;4545;14154;128;494;3519;10999;3647;11493
290820;201712;5120;13977;4619;13306;283;924;3514;10162;3797;11086
290830;201712;4555;10977;4082;10356;133;419;3341;8353;3474;8772
290840;201712;16752;46848;14714;43746;1795;4850;9725;30297;11520;35147
290850;201712;6218;16574;5720;16005;521;1284;4479;12934;5000;14218
290860;201712;5605;17443;4942;16666;241;891;4123;14133;4364;15024
290870;201712;4687;13297;3703;11586;149;573;2703;8396;2852;8969
290880;201712;1407;3625;1112;3191;83;206;774;2266;857;2472
290890;201712;7494;17609;6546;16541;200;564;5965;15014;6165;15578
290900;201712;2306;6344;1757;5381;123;405;1123;3407;1246;3812
290910;201712;4991;13020;4016;11539;61;269;3359;9565;3420;9834
290920;201712;5069;12858;4690;12374;101;245;4317;11390;4418;11635
290930;201712;8166;23283;6833;21061;224;994;5487;16473;5711;17467
290940;201712;3761;11031;3234;10273;186;627;2428;7796;2614;8423
290950;201712;1527;4066;1301;3717;93;271;939;2692;1032;2963
290960;201712;5310;14858;4830;14228;159;507;4074;12019;4233;12526
290970;201712;3640;10796;3084;9887;189;583;2265;7307;2454;7890
290980;201712;10695;28551;9056;25726;1475;4473;4430;12320;5905;16793
290990;201712;8929;25544;7743;23556;421;1562;6152;18297;6573;19859
291000;201712;3320;9151;2676;8336;268;751;2067;6596;2335;7347
291005;201712;14519;35961;12926;34004;758;2066;10650;28135;11408;30201
291010;201712;3191;9644;2515;8267;170;571;1661;5425;1831;5996
291020;201712;1270;3282;1018;2821;45;148;676;1769;721;1917
291030;201712;2404;6229;1693;4875;107;321;1062;2962;1169;3283
291040;201712;5428;15674;4698;14612;225;931;3729;11482;3954;12413
291050;201712;7573;22924;6737;21601;1216;4275;4073;12859;5289;17134
291060;201712;5997;20619;5385;19720;542;2379;3718;13401;4260;15780
291070;201712;15613;43861;13558;40744;632;2332;10795;32157;11427;34489
291072;201712;23547;65300;17931;54787;3983;12916;6501;20178;10484;33094
291075;201712;4879;13564;4357;12675;219;653;3425;9851;3644;10504
291077;201712;1544;4209;1248;3698;57;150;918;2750;975;2900
291080;201712;79949;234753;68826;215905;25574;81878;10893;35910;36467;117788
291085;201712;5698;14718;4783;13436;205;633;4046;11324;4251;11957
291090;201712;1845;3853;1485;3438;137;182;1199;2899;1336;3081
291100;201712;2965;6831;2088;5792;101;365;1593;4330;1694;4695
291110;201712;5431;17710;4763;16581;532;2036;3381;11539;3913;13575
291120;201712;7594;19417;6658;18135;422;1267;5110;13877;5532;15144
291125;201712;1971;3721;1526;3235;75;156;1233;2657;1308;2813
291130;201712;2895;8781;2346;7749;81;387;1755;5603;1836;5990
291140;201712;4326;12372;3421;10619;492;1346;2154;6826;2646;8172
291150;201712;2161;5094;1876;4756;33;86;1652;4162;1685;4248
291160;201712;4820;14695;4238;13711;466;1658;2782;8883;3248;10541
291165;201712;2333;6600;1823;5652;25;108;1343;4091;1368;4199
291170;201712;20280;52988;17259;48186;1176;3551;10998;30754;12174;34305
291180;201712;6180;15513;4807;13514;413;1195;3445;9689;3858;10884
291185;201712;3363;9349;2934;8600;120;403;2378;6870;2498;7273
291190;201712;7483;19251;6340;17690;396;1224;5030;14018;5426;15242
291200;201712;2900;8385;2191;7052;97;336;1431;4578;1528;4914
291210;201712;6744;15594;5319;13880;209;699;4041;10411;4250;11110
291220;201712;4043;11902;3635;11266;339;1161;2599;7978;2938;9139
291230;201712;4321;10057;3442;9075;78;136;3179;8510;3257;8646
291240;201712;4343;11458;3775;10490;76;254;3224;8817;3300;9071
291250;201712;3365;10192;2699;8947;176;564;1832;6166;2008;6730
291260;201712;1202;3090;1041;2873;45;176;878;2357;923;2533
291270;201712;4973;14574;4095;13100;836;2807;2307;7466;3143;10273
291280;201712;2323;6351;1805;5501;220;706;1005;3009;1225;3715
291290;201712;5949;16108;4844;14457;590;1797;3112;9397;3702;11194
291300;201712;4041;11366;3089;9723;137;452;2236;6987;2373;7439
291310;201712;5242;14571;4481;13178;180;606;3583;10394;3763;11000
291320;201712;6047;18061;4761;15493;1137;3532;2183;7435;3320;10967
291330;201712;1663;4576;1429;4194;81;262;1053;3029;1134;3291
291340;201712;4003;10769;3376;9799;80;294;2716;7789;2796;8083
291345;201712;3109;9796;2881;9482;156;553;2328;7718;2484;8271
291350;201712;6390;17068;5003;15135;180;536;4103;12609;4283;13145
291360;201712;32943;84609;27232;77019;5351;15416;14287;41675;19638;57091
291370;201712;7902;21992;7286;21172;463;1529;5616;16225;6079;17754
291380;201712;3471;10191;3051;9512;125;509;2426;7469;2551;7978
291390;201712;12038;28875;9868;26361;572;1735;7817;20805;8389;22540
291400;201712;14078;37497;11936;34306;1908;5027;7352;22354;9260;27381
291410;201712;2914;7817;2260;6722;72;322;1716;4966;1788;5288
291420;201712;1945;5011;1621;4595;46;182;1375;3858;1421;4040
291430;201712;3109;8746;2728;8179;96;449;2230;6495;2326;6944
291440;201712;6395;18854;5588;17484;424;1382;4336;13702;4760;15084
291450;201712;8482;23072;7142;21393;174;433;6124;18877;6298;19310
291460;201712;13607;39168;12165;37020;1071;3528;8663;26498;9734;30026
291465;201712;8201;22150;6764;20428;327;1383;5488;16375;5815;17758
291470;201712;15504;39007;13339;36509;631;1683;10221;28704;10852;30387
291480;201712;38069;88808;28983;76783;3900;11091;15713;41887;19613;52978
291490;201712;4752;13467;4264;12832;329;1022;3457;10474;3786;11496
291500;201712;4676;12332;3881;11219;103;420;3374;9711;3477;10131
291510;201712;3782;10677;3172;9799;82;386;2602;8031;2684;8417
291520;201712;4267;10620;3380;9422;233;706;2379;6658;2612;7364
291530;201712;2182;5524;1636;4755;319;864;932;2967;1251;3831
291535;201712;3264;10060;2998;9629;219;699;2256;7353;2475;8052
291540;201712;2207;5075;1622;4435;85;268;1403;3795;1488;4063
291550;201712;5409;13287;4352;11861;582;1481;2632;7347;3214;8828
291560;201712;19231;43618;13178;36462;936;2468;9056;26379;9992;28847
291570;201712;2263;5527;1880;5063;110;232;1566;4341;1676;4573
291580;201712;5897;16556;4895;15179;404;1454;3494;10748;3898;12202
291590;201712;1720;5191;1578;4972;155;552;1213;3814;1368;4366
291600;201712;5156;13529;3891;11493;678;2098;2096;6089;2774;8187
291610;201712;4831;14554;4601;14299;83;285;4314;13485;4397;13770
291620;201712;3119;7105;2239;6139;112;361;1730;4812;1842;5173
291630;201712;3238;7606;2477;6631;153;445;1955;5180;2108;5625
291640;201712;15667;41382;12136;36088;2568;7834;4167;13285;6735;21119
291650;201712;8474;23492;7582;22396;467;1198;6416;19256;6883;20454
291660;201712;2239;5524;1642;4594;124;455;1087;2852;1211;3307
291670;201712;1973;5267;1720;4920;123;315;1340;3900;1463;4215
291680;201712;3930;10722;3332;9730;387;1197;2334;6803;2721;8000
291685;201712;4751;11617;3822;10417;366;847;2761;7820;3127;8667
291690;201712;3995;9544;2903;7953;110;309;2340;6352;2450;6661
291700;201712;8867;26521;7840;24668;593;1929;6089;19144;6682;21073
291710;201712;5162;13017;3960;11372;375;1210;2655;7484;3030;8694
291720;201712;4616;14495;3816;12848;315;1199;2579;8473;2894;9672
291730;201712;6292;17360;5471;16277;322;1084;4413;13175;4735;14259
291733;201712;2920;7755;2416;7046;104;327;1781;5371;1885;5698
291735;201712;2991;8002;2523;7314;93;302;2136;6170;2229;6472
291740;201712;3868;10235;3106;9080;153;495;2415;6977;2568;7472
291750;201712;19963;50098;15923;44021;2265;6378;9380;26490;11645;32868
291760;201712;10610;32228;8583;28851;3033;11435;1921;6543;4954;17978
291770;201712;7101;20146;5927;18025;603;1993;4077;12151;4680;14144
291780;201712;4684;13247;4229;12533;138;454;3626;10704;3764;11158
291790;201712;2655;7789;2475;7530;191;555;1939;5943;2130;6498
291800;201712;30376;79171;24380;70513;3132;9014;14654;43405;17786;52419
291810;201712;10775;27216;8908;24875;259;884;7540;20881;7799;21765
291820;201712;3785;10548;3309;9872;146;508;2557;7641;2703;8149
291830;201712;4209;10522;3663;9790;265;735;2926;7854;3191;8589
291835;201712;6281;19193;5089;16925;892;3069;2873;9804;3765;12873
291840;201712;46001;128158;39975;120567;4989;15095;27444;85091;32433;100186
291845;201712;2424;7006;2169;6669;135;401;1801;5593;1936;5994
291850;201712;4203;12161;3457;10927;322;930;2478;8094;2800;9024
291855;201712;1961;4321;1567;3836;83;258;1295;3107;1378;3365
291860;201712;2268;6062;1640;4837;32;112;1135;3226;1167;3338
291870;201712;1365;3568;919;2762;65;219;593;1720;658;1939
291875;201712;2766;8410;2450;7870;115;436;1810;5687;1925;6123
291880;201712;5066;15470;4509;14371;369;1164;3309;10540;3678;11704
291890;201712;1424;3246;961;2659;184;404;628;1800;812;2204
291900;201712;1220;3151;942;2680;30;121;733;2029;763;2150
291905;201712;2731;7087;2071;5952;77;270;1552;4346;1629;4616
291910;201712;2813;7294;2395;6800;85;277;2058;5846;2143;6123
291915;201712;6904;20623;5781;18685;292;1106;4449;14407;4741;15513
291920;201712;24928;70998;22376;67424;2861;9304;14706;44039;17567;53343
291930;201712;2461;7190;2150;6669;198;722;1493;4498;1691;5220
291940;201712;3368;9230;2357;7426;233;751;1438;4400;1671;5151
291950;201712;8732;27747;7631;25624;1040;3507;4471;15411;5511;18918
291955;201712;12221;33605;11165;32252;1850;5163;7476;22500;9326;27663
291960;201712;3090;8670;2511;7789;146;469;1909;6045;2055;6514
291970;201712;3996;11513;3535;10817;230;902;2563;7795;2793;8697
291980;201712;10531;30287;8431;27141;568;1874;5941;19359;6509;21233
291990;201712;2016;5901;1876;5727;36;132;1747;5362;1783;5494
291992;201712;4086;10223;3023;8746;337;933;2280;6698;2617;7631
291995;201712;2161;5956;1752;5357;54;241;1428;4265;1482;4506
292000;201712;2357;6279;2007;5757;165;550;1405;4010;1570;4560
292010;201712;6172;14663;5042;13102;258;737;4140;10661;4398;11398
292020;201712;4347;13330;3812;12400;337;1159;2864;9224;3201;10383
292030;201712;1742;5608;1639;5445;123;466;984;3172;1107;3638
292040;201712;4244;11301;3528;10365;245;649;2855;8639;3100;9288
292045;201712;3711;10418;2941;9252;74;183;2613;8321;2687;8504
292050;201712;6481;18901;5305;16652;430;1478;3319;10311;3749;11789
292060;201712;12463;29651;11417;28383;730;1788;9614;23647;10344;25435
292070;201712;5366;14964;4754;14228;299;924;4058;12178;4357;13102
292080;201712;3338;8572;2723;7793;150;504;2328;6642;2478;7146
292090;201712;4385;10046;3288;8774;221;647;2613;7063;2834;7710
292100;201712;10378;27003;8746;24826;1759;5028;4488;13157;6247;18185
292105;201712;3042;8755;2726;8240;75;340;2316;6922;2391;7262
292110;201712;6359;16429;4610;13515;1155;3373;2037;6111;3192;9484
292120;201712;6745;18351;5464;16035;633;1881;3587;10583;4220;12464
292130;201712;3092;8032;2605;7398;223;677;1935;5532;2158;6209
292140;201712;4929;12402;4074;11164;290;779;3194;8769;3484;9548
292145;201712;2253;6808;1928;6240;127;417;1385;4533;1512;4950
292150;201712;12871;37146;11679;35386;337;1297;9810;29513;10147;30810
292160;201712;2405;6757;2091;6348;90;274;1835;5587;1925;5861
292170;201712;8314;23253;6925;20886;671;2147;4683;14145;5354;16292
292180;201712;2955;8187;2193;6877;429;1256;1112;3566;1541;4822
292190;201712;2907;8092;2472;7433;318;1015;1553;4715;1871;5730
292200;201712;6889;19219;5529;17100;1170;3743;2656;8414;3826;12157
292205;201712;3658;10687;3283;10113;94;454;2847;8604;2941;9058
292210;201712;6016;15297;5060;14012;117;454;4457;12212;4574;12666
292220;201712;1978;5066;1767;4764;157;426;1283;3413;1440;3839
292225;201712;3162;9564;2832;9065;95;404;2351;7439;2446;7843
292230;201712;7414;19117;6858;18347;167;696;5849;15295;6016;15991
292240;201712;4930;14564;4273;13275;346;1087;2912;9022;3258;10109
292250;201712;5293;15036;4868;14347;689;2015;3142;9396;3831;11411
292260;201712;3292;9139;2964;8694;188;524;2475;7376;2663;7900
292265;201712;3193;9333;2739;8569;83;388;2170;6615;2253;7003
292270;201712;4004;9840;3274;8953;245;719;2646;7243;2891;7962
292273;201712;2495;5711;2052;5162;82;148;1615;4206;1697;4354
292275;201712;1802;5059;1467;4576;84;202;1147;3743;1231;3945
292280;201712;2474;6245;2050;5751;93;224;1681;4898;1774;5122
292285;201712;2485;6401;2000;5704;96;338;1576;4475;1672;4813
292290;201712;6689;19466;5637;17934;263;995;4521;14377;4784;15372
292300;201712;9345;25649;7623;23441;1180;3773;4719;14807;5899;18580
292303;201712;2833;8323;2512;7836;69;249;2164;6729;2233;6978
292305;201712;2574;6937;2383;6653;50;221;2110;5787;2160;6008
292310;201712;6448;17636;5699;16637;255;769;4755;13861;5010;14630
292320;201712;6442;17516;5316;15505;296;942;4100;11714;4396;12656
292330;201712;2436;5942;2147;5584;120;312;1716;4513;1836;4825
292335;201712;4931;12807;4388;12052;304;755;3568;9943;3872;10698
292340;201712;6261;17080;5326;15456;266;785;4037;11658;4303;12443
292350;201712;2324;6556;1948;6037;89;332;1613;5018;1702;5350
292360;201712;4894;13133;4283;12064;340;1095;3129;8628;3469;9723
292370;201712;9892;24205;8623;22562;220;648;7727;19971;7947;20619
292380;201712;6933;19972;6300;18900;539;1582;4721;14237;5260;15819
292390;201712;4156;8662;3067;7380;142;254;2647;6452;2789;6706
292400;201712;20829;62916;18787;59442;2316;7649;12594;39889;14910;47538
292405;201712;4458;10982;3676;9927;192;450;3005;8196;3197;8646
292410;201712;2033;5241;1787;4947;72;201;1548;4323;1620;4524
292420;201712;3623;11311;3386;10944;193;839;2815;8990;3008;9829
292430;201712;5118;14911;3869;13041;339;1206;2539;8639;2878;9845
292440;201712;8274;26890;7649;25986;124;596;7021;23951;7145;24547
292450;201712;3715;11199;3077;9983;164;601;2378;7731;2542;8332
292460;201712;4724;13608;3963;12307;390;1213;2820;8751;3210;9964
292465;201712;2416;6760;2012;6152;111;319;1428;4519;1539;4838
292467;201712;1713;5245;1597;5090;202;638;1134;3711;1336;4349
292470;201712;2944;7508;2354;6568;80;223;1866;5213;1946;5436
292480;201712;6464;15883;5229;14348;99;383;4647;12526;4746;12909
292490;201712;2232;6022;1856;5453;115;350;1408;4162;1523;4512
292500;201712;6402;18240;5283;16236;600;1809;3506;10885;4106;12694
292510;201712;12738;35417;10387;31847;656;2510;7602;23171;8258;25681
292520;201712;6490;16993;5617;15675;925;2543;3619;10312;4544;12855
292525;201712;5492;13747;4546;12651;146;412;3948;11032;4094;11444
292530;201712;26817;74433;22631;68059;5762;17510;9484;29826;15246;47336
292540;201712;3396;7833;2761;7125;187;461;2325;6049;2512;6510
292550;201712;7252;20911;5849;19081;450;1630;4419;14671;4869;16301
292560;201712;4176;11132;3608;10295;127;525;2918;8212;3045;8737
292570;201712;4105;11038;3551;10273;64;230;3223;9301;3287;9531
292575;201712;6698;20586;6303;20044;265;891;5404;17233;5669;18124
292580;201712;7173;19518;6265;18203;203;741;5422;15621;5625;16362
292590;201712;7216;19869;6589;18963;259;886;5693;16058;5952;16944
292593;201712;2834;7155;2398;6448;164;420;1880;5045;2044;5465
292595;201712;5645;15137;4872;14173;222;768;3998;11547;4220;12315
292600;201712;10922;30239;9599;28367;591;1546;7407;22166;7998;23712
292610;201712;4465;11784;3703;10527;205;499;2657;7778;2862;8277
292620;201712;6298;18011;5469;17084;78;217;5189;16386;5267;16603
292630;201712;8710;21985;7202;19573;480;1337;5114;14009;5594;15346
292640;201712;7856;24154;7041;22868;250;1001;5318;17300;5568;18301
292650;201712;4418;11441;4045;10954;201;535;3562;9586;3763;10121
292660;201712;10783;31011;9598;29253;624;2061;7509;22918;8133;24979
292665;201712;2220;6851;2038;6616;46;163;1808;5931;1854;6094
292670;201712;3527;9787;2749;8365;145;532;1866;5579;2011;6111
292680;201712;3891;10803;3257;9651;234;702;2359;6868;2593;7570
292690;201712;2625;7141;1881;5910;151;464;1226;3982;1377;4446
292700;201712;9564;26928;8287;25046;922;2665;5621;17601;6543;20266
292710;201712;2249;7375;2103;7188;56;220;1899;6518;1955;6738
292720;201712;9306;22869;7893;21295;306;911;6672;18201;6978;19112
292730;201712;3996;10577;3821;10341;190;447;3272;8915;3462;9362
292740;201712;323086;837359;298458;799290;53137;147307;174389;462771;227526;610078
292750;201712;6406;17241;5482;15870;250;737;4227;12334;4477;13071
292760;201712;3843;11498;3460;10809;270;908;2522;7851;2792;8759
292770;201712;5869;16710;4997;15375;918;2953;2873;9143;3791;12096
292780;201712;1878;4092;1410;3511;55;168;1117;2702;1172;2870
292790;201712;3989;8737;3265;7948;65;206;3006;7265;3071;7471
292800;201712;10150;27144;8933;25235;399;1193;7256;20316;7655;21509
292805;201712;3333;8574;2671;7642;253;678;1933;5584;2186;6262
292810;201712;9957;27933;7927;24871;407;1497;5783;18073;6190;19570
292820;201712;7725;21145;5642;18038;425;1632;4082;12839;4507;14471
292830;201712;2652;6364;2312;5936;46;171;2110;5362;2156;5533
292840;201712;8667;23616;7937;22637;177;732;7087;19741;7264;20473
292850;201712;2821;7581;2298;6766;172;609;1521;4341;1693;4950
292860;201712;15635;38012;14053;35992;1043;2565;11008;28407;12051;30972
292870;201712;17758;47120;15526;43763;1203;3853;10129;28135;11332;31988
292880;201712;11667;32424;10294;30468;501;1964;7813;22391;8314;24355
292890;201712;5580;17409;4991;16422;385;1428;3838;12551;4223;13979
292895;201712;2955;6694;2192;5552;133;321;1628;4119;1761;4440
292900;201712;2676;7715;2490;7412;88;396;1996;5715;2084;6111
292905;201712;4285;11912;3351;10465;249;780;2299;7258;2548;8038
292910;201712;4967;14150;4492;13336;399;1305;3117;9184;3516;10489
292920;201712;9893;27698;9350;26993;346;1342;8131;23039;8477;24381
292925;201712;5163;15021;4639;14161;247;770;3600;10926;3847;11696
292930;201712;6193;19275;5614;18136;405;1709;3806;11957;4211;13666
292935;201712;2052;5861;1663;5433;43;218;1447;4816;1490;5034
292937;201712;3093;7693;2676;7187;88;259;2309;6221;2397;6480
292940;201712;3135;8368;2531;7403;173;477;1903;5683;2076;6160
292950;201712;9170;24791;8218;23317;374;1182;6340;17684;6714;18866
292960;201712;5326;13003;4529;11939;132;413;3677;9522;3809;9935
292970;201712;4052;11844;3541;11135;132;580;2932;9199;3064;9779
292975;201712;4282;9629;3824;9100;216;424;3366;8121;3582;8545
292980;201712;3176;8150;2541;7174;127;400;1952;5423;2079;5823
292990;201712;11270;31388;9631;28759;456;1547;7673;22951;8129;24498
293000;201712;2620;6595;2398;6313;27;86;1907;5258;1934;5344
293010;201712;17664;46984;14574;41977;1966;5722;8917;25823;10883;31545
293015;201712;7491;24350;6196;21853;608;2534;4172;14591;4780;17125
293020;201712;9164;28849;8476;27922;186;861;7523;24764;7709;25625
293030;201712;5519;15266;4279;13321;150;510;2884;9262;3034;9772
293040;201712;3818;11438;3515;11001;109;422;3094;9650;3203;10072
293050;201712;20737;53813;18469;50681;1934;5458;12318;34391;14252;39849
293060;201712;3523;9299;2904;8303;208;664;2130;5984;2338;6648
293070;201712;24217;62024;19917;56143;3967;11024;10419;30908;14386;41932
293075;201712;3165;10617;2937;10227;198;866;2331;8104;2529;8970
293076;201712;3532;9410;3153;8899;103;287;2614;7479;2717;7766
293077;201712;5189;15276;4422;14197;555;1841;2883;9490;3438;11331
293080;201712;4717;14349;4177;13454;156;670;3393;10720;3549;11390
293090;201712;3066;9549;2499;8610;203;802;1715;5913;1918;6715
293100;201712;5709;16088;4716;14276;359;1088;3558;10842;3917;11930
293105;201712;3728;12051;3271;11154;270;958;2293;7782;2563;8740
293110;201712;2265;5817;1905;5317;66;217;1598;4383;1664;4600
293120;201712;4048;11871;3703;11303;140;434;3107;9448;3247;9882
293130;201712;3702;10726;3337;10270;96;381;2915;8975;3011;9356
293135;201712;30955;75436;22785;64061;4491;14114;9274;26397;13765;40511
293140;201712;2131;5398;1927;5146;88;276;1602;4162;1690;4438
293150;201712;5323;16832;4479;15174;531;1805;2975;10236;3506;12041
293160;201712;3915;9684;3350;9016;294;560;2688;7632;2982;8192
293170;201712;3720;9654;3272;9044;146;485;2574;7098;2720;7583
293180;201712;4908;13504;3967;11950;130;571;3163;9270;3293;9841
293190;201712;13459;38887;12058;36795;372;1653;10258;30905;10630;32558
293200;201712;7789;20064;6528;18274;219;823;5082;14103;5301;14926
293210;201712;5066;13923;4368;12815;228;705;3413;9957;3641;10662
293220;201712;5024;13942;3938;12092;999;3053;1488;4809;2487;7862
293230;201712;3776;10664;3032;9555;364;1247;1982;6316;2346;7563
293240;201712;4313;11817;3469;10392;105;332;2657;8059;2762;8391
293245;201712;4108;11250;3651;10610;168;566;3035;8725;3203;9291
293250;201712;5618;14250;4834;13158;339;924;3709;10071;4048;10995
293260;201712;4355;12521;3615;11360;132;444;2606;8127;2738;8571
293270;201712;6483;15709;5334;14460;435;885;4367;12362;4802;13247
293280;201712;4973;13559;4230;12540;217;636;3227;9648;3444;10284
293290;201712;12928;41740;11953;39993;2964;10015;5538;19507;8502;29522
293300;201712;6303;15109;5386;13918;343;789;4044;10650;4387;11439
293305;201712;4310;10773;3703;9944;80;265;3204;8571;3284;8836
293310;201712;2253;5839;1811;5081;144;419;1271;3518;1415;3937
293315;201712;4171;10341;3448;9223;184;444;2766;7385;2950;7829
293317;201712;2442;6445;2170;5982;121;317;1634;4503;1755;4820
293320;201712;8261;24809;7811;24268;791;2499;6314;19812;7105;22311
293325;201712;1730;4690;1393;4174;224;700;851;2527;1075;3227
293330;201712;44347;142800;39826;134423;8860;30848;18088;61939;26948;92787
293340;201712;2462;6985;1991;6166;162;553;1279;3925;1441;4478
293345;201712;3118;9091;2700;8533;272;615;1967;6688;2239;7303
293350;201712;6784;19400;6131;18658;100;261;5694;17665;5794;17926
293360;201712;14292;39375;12599;37288;583;1928;11065;32640;11648;34568
310010;201712;816;2093;627;1817;73;248;293;795;366;1043
310020;201712;2292;6863;1824;6040;463;1693;250;808;713;2501
310030;201712;2189;6530;1732;5709;278;1055;1026;3269;1304;4324
310040;201712;965;2489;781;2208;58;209;591;1607;649;1816
310050;201712;1623;5353;1482;5080;280;1077;727;2394;1007;3471
310060;201712;3294;9607;2844;9015;153;664;2329;7312;2482;7976
310070;201712;345;872;249;702;5;14;177;483;182;497
310080;201712;740;2048;542;1686;71;261;231;682;302;943
310090;201712;4547;12864;3815;11654;433;1438;2653;8070;3086;9508
310100;201712;3408;9940;2867;9065;138;569;2267;7074;2405;7643
310110;201712;4924;13420;3997;11787;731;2431;1899;5346;2630;7777
310120;201712;647;1742;444;1401;84;321;195;531;279;852
310130;201712;385;1116;324;1011;60;228;176;489;236;717
310140;201712;180;594;144;534;46;208;44;136;90;344
310150;201712;4402;13041;3566;11403;799;2760;1200;3765;1999;6525
310160;201712;6593;19585;5351;17304;1556;5511;1123;3524;2679;9035
310163;201712;1058;3241;870;2896;279;1011;240;744;519;1755
310170;201712;8925;24086;7571;22041;810;2460;5304;15471;6114;17931
310180;201712;1591;4394;1324;3977;130;495;875;2529;1005;3024
310190;201712;2960;9348;2538;8548;671;2472;313;1004;984;3476
310200;201712;1713;5462;1378;4754;276;1045;503;1663;779;2708
310205;201712;1092;3122;834;2729;99;313;493;1672;592;1985
310210;201712;2692;7310;2251;6656;110;373;1700;4995;1810;5368
310220;201712;1013;2886;857;2642;106;381;570;1687;676;2068
310230;201712;2313;6783;1948;6043;251;943;1156;3373;1407;4316
310240;201712;882;3032;786;2851;87;378;523;1862;610;2240
310250;201712;891;2691;784;2500;108;427;485;1454;593;1881
310260;201712;2762;8299;1921;6650;462;1815;295;801;757;2616
310270;201712;2618;6980;2091;6250;139;537;1660;4864;1799;5401
310280;201712;2249;5621;1789;4933;207;688;1109;2942;1316;3630
310285;201712;1920;6546;1696;6172;162;646;1141;4251;1303;4897
310290;201712;1110;3180;995;2975;222;779;529;1428;751;2207
310300;201712;1536;4983;1421;4788;286;1117;710;2248;996;3365
310310;201712;300;786;211;627;35;102;109;325;144;427
310320;201712;501;1344;322;1015;27;113;166;490;193;603
310330;201712;505;1231;317;885;41;126;130;312;171;438
310340;201712;7830;22469;6351;19974;1207;3763;3073;10029;4280;13792
310350;201712;12452;31746;8686;25657;2209;7029;2372;6882;4581;13911
310360;201712;460;1229;393;1141;15;57;307;872;322;929
310370;201712;1358;4434;1165;4057;243;897;451;1577;694;2474
310375;201712;1015;2710;681;2149;112;372;261;823;373;1195
310380;201712;364;889;197;588;39;118;70;191;109;309
310390;201712;437;1428;375;1300;104;379;80;232;184;611
310400;201712;9013;23987;6645;20103;1307;4391;2710;7917;4017;12308
310410;201712;718;2213;491;1801;125;499;110;375;235;874
310420;201712;3995;10907;2636;8127;539;1849;536;1451;1075;3300
310430;201712;1287;3906;891;3115;221;820;171;554;392;1374
310440;201712;550;1476;387;1175;45;173;203;593;248;766
310445;201712;1328;4044;1000;3413;63;239;706;2392;769;2631
310450;201712;4586;12109;3485;10405;265;848;2587;7749;2852;8597
310460;201712;1712;4768;1215;3851;270;924;332;1030;602;1954
310470;201712;3907;8643;3175;7723;263;806;2592;6165;2855;6971
310480;201712;1198;3310;863;2713;171;570;428;1294;599;1864
310490;201712;2947;8946;2402;7906;444;1708;1003;3120;1447;4828
310500;201712;1487;4447;1100;3695;234;848;453;1493;687;2341
310510;201712;1727;5143;1278;4227;329;1189;280;921;609;2110
310520;201712;1409;3547;1033;2953;83;226;669;1920;752;2146
310530;201712;877;2497;457;1492;76;271;63;167;139;438
310540;201712;3190;9667;2683;8761;716;2485;1019;3164;1735;5649
310550;201712;1183;3151;880;2661;118;458;552;1554;670;2012
310560;201712;13835;39762;11194;35153;2646;9262;3799;11047;6445;20309
310570;201712;1140;3252;944;2925;109;428;645;1921;754;2349
310590;201712;4155;11684;3453;10483;420;1428;1995;5919;2415;7347
310600;201712;1459;4523;1208;3967;196;694;558;1724;754;2418
310610;201712;509;1466;354;1194;65;261;158;483;223;744
310620;201712;149392;419787;117298;361378;27101;93454;41365;114388;68466;207842
310630;201712;4419;12674;3783;11546;310;1087;2702;8110;3012;9197
310640;201712;1017;3220;859;2909;231;865;243;772;474;1637
310650;201712;2583;7794;1967;6661;237;847;1085;3607;1322;4454
310660;201712;1276;3672;1100;3448;75;254;850;2636;925;2890
310665;201712;1269;3622;1092;3369;59;201;870;2720;929;2921
310670;201712;44683;126814;37649;113770;7217;23670;18491;53644;25708;77314
310680;201712;666;1743;573;1605;36;104;437;1205;473;1309
310690;201712;1506;4407;1171;3841;157;631;619;1924;776;2555
310700;201712;525;1219;394;1057;48;160;260;669;308;829
310710;201712;5555;17358;4159;15196;950;4056;415;1440;1365;5496
310720;201712;841;2321;716;2148;54;188;548;1622;602;1810
310730;201712;8782;26021;7686;24171;782;2795;4998;15502;5780;18297
310740;201712;4952;14769;3622;12081;754;2704;861;2747;1615;5451
310750;201712;1353;3356;961;2811;168;545;382;1042;550;1587
310760;201712;524;1523;413;1325;51;187;175;571;226;758
310770;201712;1052;3018;728;2514;105;408;351;1160;456;1568
310780;201712;3880;10217;3154;9040;220;670;2222;6296;2442;6966
310790;201712;1871;5907;1677;5572;348;1173;764;2669;1112;3842
310800;201712;2359;7403;1772;6232;508;2082;120;386;628;2468
310810;201712;1110;2998;946;2707;93;308;591;1614;684;1922
310820;201712;1167;3266;792;2548;183;651;211;654;394;1305
310825;201712;2850;9541;2323;8661;100;588;1817;6631;1917;7219
310830;201712;1412;4382;1112;3809;260;958;405;1351;665;2309
310840;201712;2066;5852;1441;4715;296;1029;344;1037;640;2066
310850;201712;1472;4215;1274;3958;82;371;974;2928;1056;3299
310855;201712;3097;8797;2508;7926;266;986;1778;5534;2044;6520
310860;201712;6897;20648;5684;18303;561;1923;3566;11533;4127;13456
310870;201712;1047;2634;791;2240;153;446;480;1353;633;1799
310880;201712;970;2983;788;2620;101;381;473;1546;574;1927
310890;201712;2361;6871;1718;5749;429;1598;285;833;714;2431
310900;201712;4471;13116;3376;10985;629;2297;1440;4362;2069;6659
310910;201712;1793;4877;1093;3512;139;507;136;345;275;852
310920;201712;1835;5148;1418;4464;244;843;747;2324;991;3167
310925;201712;953;2898;818;2676;144;521;512;1626;656;2147
310930;201712;5880;16000;4400;13702;729;2396;2357;7532;3086;9928
310940;201712;6055;16147;4905;14436;479;1571;3255;9431;3734;11002
310945;201712;1210;3351;1045;3117;77;270;704;2048;781;2318
310950;201712;1986;6030;1424;4834;301;1166;475;1490;776;2656
310960;201712;727;1852;436;1328;77;277;142;450;219;727
310970;201712;1138;3593;841;2958;203;767;210;694;413;1461
310980;201712;375;881;229;640;28;91;143;378;171;469
310990;201712;1228;3724;953;3137;211;736;351;1109;562;1845
311000;201712;4063;12025;3207;10592;901;3243;1194;3794;2095;7037
311010;201712;741;2376;637;2134;231;825;221;728;452;1553
311020;201712;966;2666;692;2159;101;359;313;915;414;1274
311030;201712;1626;4359;1088;3381;294;1037;314;875;608;1912
311040;201712;376;1228;307;1061;76;267;67;206;143;473
311050;201712;2262;6457;1869;5826;451;1561;718;2163;1169;3724
311060;201712;2612;7348;1813;5647;287;1051;659;1839;946;2890
311070;201712;1657;4884;1257;4165;203;802;559;1754;762;2556
311080;201712;849;2364;708;2111;112;394;395;1088;507;1482
311090;201712;1954;6629;1572;5921;414;1735;487;1802;901;3537
311100;201712;1993;6166;1402;4964;389;1550;179;554;568;2104
311110;201712;3186;7375;2160;5907;500;1420;914;2568;1414;3988
311115;201712;1197;3369;997;3074;79;311;752;2263;831;2574
311120;201712;6851;18757;5084;15503;982;3354;1599;4380;2581;7734
311130;201712;1933;5602;1564;5029;195;760;762;2345;957;3105
311140;201712;1241;3202;927;2764;66;221;609;1850;675;2071
311150;201712;1452;4933;1269;4583;200;773;744;2678;944;3451
311160;201712;3703;11666;2793;9992;892;3491;641;2220;1533;5711
311170;201712;813;2326;631;2010;48;173;357;1155;405;1328
311180;201712;1189;3011;817;2429;215;704;282;838;497;1542
311190;201712;1040;2963;797;2496;148;534;282;814;430;1348
311200;201712;1677;4927;1275;4090;362;1241;229;694;591;1935
311205;201712;896;2915;763;2649;79;350;424;1449;503;1799
311210;201712;986;3042;889;2920;136;411;635;2155;771;2566
311220;201712;771;2350;633;2071;132;475;261;788;393;1263
311230;201712;7940;24906;6005;20827;1246;4596;1848;6668;3094;11264
311240;201712;914;2684;725;2388;153;551;363;1170;516;1721
311250;201712;829;2501;691;2267;170;594;272;859;442;1453
311260;201712;2157;5597;1567;4625;322;1057;621;1733;943;2790
311265;201712;1197;3257;933;2843;94;322;591;1778;685;2100
311270;201712;3211;9918;2806;9323;231;1069;1979;6269;2210;7338
311280;201712;1167;3209;619;1982;104;373;135;407;239;780
311290;201712;1901;6085;1775;5802;216;694;1204;3967;1420;4661
311300;201712;4457;13495;3820;12493;225;1064;2946;9444;3171;10508
311310;201712;628;1943;535;1758;107;366;177;535;284;901
311320;201712;3225;10421;2864;9610;474;1840;1244;3854;1718;5694
311330;201712;4505;12835;3880;11789;568;1914;2088;6411;2656;8325
311340;201712;10835;33213;8946;29578;2658;9288;2202;7415;4860;16703
311350;201712;2155;5795;1640;4860;205;680;830;2271;1035;2951
311360;201712;844;2400;713;2225;340;1149;118;375;458;1524
311370;201712;4023;11118;3151;9624;316;1217;1755;5048;2071;6265
311380;201712;434;1387;342;1196;99;355;99;363;198;718
311390;201712;1718;5759;1455;5383;613;2602;376;1212;989;3814
311400;201712;1413;4211;1072;3550;176;684;432;1284;608;1968
311410;201712;1555;5124;1369;4882;305;1224;679;2399;984;3623
311420;201712;1767;5570;1192;4231;193;746;131;351;324;1097
311430;201712;3460;9845;2320;7508;381;1316;585;1872;966;3188
311440;201712;2374;7350;1737;6150;504;2003;388;1363;892;3366
311450;201712;1841;5989;1417;5149;384;1529;274;878;658;2407
311455;201712;965;2429;688;1988;188;556;224;635;412;1191
311460;201712;558;1801;404;1501;93;425;106;355;199;780
311470;201712;402;1324;315;1130;75;299;61;202;136;501
311480;201712;872;2202;736;2005;111;305;439;1150;550;1455
311490;201712;212;729;186;656;56;224;70;216;126;440
311500;201712;423;1164;319;987;47;170;163;503;210;673
311510;201712;2684;7883;1935;6472;486;1869;456;1475;942;3344
311520;201712;578;1792;538;1713;138;483;262;794;400;1277
311530;201712;9311;23156;6312;18236;1572;5156;1601;4441;3173;9597
311535;201712;744;2098;487;1613;106;423;117;367;223;790
311540;201712;558;1861;512;1783;140;489;240;857;380;1346
311545;201712;2188;6219;1863;5805;121;496;1372;4182;1493;4678
311547;201712;1478;3996;1281;3688;52;179;990;2832;1042;3011
311550;201712;2766;8320;2219;7236;391;1505;820;2517;1211;4022
311560;201712;256;617;198;550;28;86;113;291;141;377
311570;201712;1930;4777;1452;4103;56;172;1156;3376;1212;3548
311580;201712;2327;4427;1602;3598;225;416;1016;2462;1241;2878
311590;201712;491;1444;407;1318;87;330;192;609;279;939
311600;201712;1308;3613;1081;3315;107;323;816;2521;923;2844
311610;201712;2447;8552;2148;7892;544;1945;900;3415;1444;5360
311615;201712;2991;9126;2453;8258;208;845;1779;5907;1987;6752
311620;201712;386;1136;342;1063;30;111;254;778;284;889
311630;201712;1337;3822;1104;3390;82;283;777;2326;859;2609
311640;201712;583;1859;483;1675;106;405;196;666;302;1071
311650;201712;2000;5554;1732;5136;178;640;1135;3252;1313;3892
311660;201712;2831;8551;2095;7102;414;1488;393;1189;807;2677
311670;201712;1540;4206;1230;3716;236;792;517;1592;753;2384
311680;201712;2048;6245;1646;5498;263;934;1019;3381;1282;4315
311690;201712;549;1284;446;1153;28;75;344;903;372;978
311700;201712;2230;5621;1745;4968;55;193;1399;3910;1454;4103
311710;201712;1533;4593;1075;3692;303;1131;323;1134;626;2265
311720;201712;407;1298;339;1164;44;173;171;566;215;739
311730;201712;4982;12394;2949;8802;940;3120;404;1089;1344;4209
311740;201712;755;2296;706;2234;53;152;617;1987;670;2139
311750;201712;3960;12308;3332;11277;399;1638;2074;6741;2473;8379
311760;201712;634;2033;554;1854;116;449;171;481;287;930
311770;201712;1949;6004;1535;5207;347;1282;530;1728;877;3010
311780;201712;1202;3916;938;3343;216;887;234;708;450;1595
311783;201712;2021;6215;1698;5631;65;307;1377;4479;1442;4786
311787;201712;713;2206;509;1704;86;322;181;515;267;837
311790;201712;1515;4137;1056;3352;223;798;406;1273;629;2071
311800;201712;4850;15624;4131;13948;844;3168;594;1845;1438;5013
311810;201712;981;3174;818;2841;64;253;490;1696;554;1949
311820;201712;682;1923;553;1673;92;345;324;901;416;1246
311830;201712;8165;25191;5960;20297;1578;5846;572;1891;2150;7737
311840;201712;2859;8239;2517;7717;360;1261;1669;5039;2029;6300
311850;201712;294;863;250;792;33;94;157;501;190;595
311860;201712;50865;139260;41395;123615;6778;21559;23036;67532;29814;89091
311870;201712;1955;5544;1372;4421;253;942;497;1433;750;2375
311880;201712;6362;17585;5518;16434;476;1357;4130;12521;4606;13878
311890;201712;1375;3818;1113;3377;203;659;590;1728;793;2387
311900;201712;666;1868;536;1663;61;217;350;1071;411;1288
311910;201712;4243;11534;3289;10270;692;2261;1527;4800;2219;7061
311920;201712;1934;5880;1600;5306;162;603;958;3131;1120;3734
311930;201712;3192;8532;2549;7541;1023;3218;690;1904;1713;5122
311940;201712;13183;37763;10245;32026;1779;6146;4013;11854;5792;18000
311950;201712;2197;6317;1694;5457;128;555;1183;3719;1311;4274
311960;201712;543;1400;461;1264;39;173;313;738;352;911
311970;201712;436;1455;286;1058;54;230;55;185;109;415
311980;201712;460;1300;288;956;42;146;84;273;126;419
311990;201712;514;1297;349;1069;107;375;138;397;245;772
311995;201712;994;2912;560;1876;37;140;55;124;92;264
312000;201712;565;1610;494;1504;33;107;357;1103;390;1210
312010;201712;848;2726;697;2373;77;286;359;1194;436;1480
312015;201712;1302;4030;1164;3783;99;417;832;2615;931;3032
312020;201712;1106;3481;962;3231;200;721;410;1353;610;2074
312030;201712;1913;5101;1688;4834;37;172;1542;4356;1579;4528
312040;201712;758;2531;603;2191;105;444;206;696;311;1140
312050;201712;1226;4118;987;3611;258;1086;233;743;491;1829
312060;201712;832;2316;625;2035;158;538;288;934;446;1472
312070;201712;894;2694;631;2137;88;339;320;1042;408;1381
312080;201712;2714;7032;2009;5953;200;702;1204;3358;1404;4060
312083;201712;945;2575;757;2274;97;324;504;1467;601;1791
312087;201712;2193;6168;1897;5749;113;361;1483;4565;1596;4926
312090;201712;9020;26043;7099;22770;1711;5793;2825;9036;4536;14829
312100;201712;1495;4651;1101;3920;139;609;517;1749;656;2358
312110;201712;994;3315;844;2993;246;987;208;650;454;1637
312120;201712;637;1928;492;1653;119;456;175;516;294;972
312125;201712;1187;3568;1057;3369;162;496;765;2501;927;2997
312130;201712;851;2298;661;1954;77;257;278;782;355;1039
312140;201712;786;2438;656;2148;161;575;230;680;391;1255
312150;201712;477;1388;404;1218;20;84;259;728;279;812
312160;201712;7505;23481;6163;20765;1116;4228;2546;8172;3662;12400
312170;201712;840;2383;677;2090;41;146;463;1377;504;1523
312180;201712;1321;3894;1089;3446;174;611;512;1548;686;2159
312190;201712;535;1677;394;1372;108;408;66;239;174;647
312200;201712;4697;13126;3833;11608;747;2329;2095;6301;2842;8630
312210;201712;1229;3051;907;2604;110;384;590;1634;700;2018
312220;201712;2006;6491;1817;6236;125;380;1428;5033;1553;5413
312230;201712;11174;32302;7977;26278;2469;8952;1033;3110;3502;12062
312235;201712;1569;4507;1350;4202;140;504;967;2945;1107;3449
312240;201712;780;2583;612;2225;151;603;150;536;301;1139
312245;201712;2371;6549;2072;6143;71;260;1733;5128;1804;5388
312247;201712;830;2271;611;1917;155;491;272;903;427;1394
312250;201712;1060;2845;737;2245;139;455;294;858;433;1313
312260;201712;925;2713;746;2426;77;289;511;1601;588;1890
312270;201712;677;1952;532;1657;40;177;274;765;314;942
312280;201712;408;1291;338;1147;113;396;37;131;150;527
312290;201712;742;2421;666;2282;130;499;229;773;359;1272
312300;201712;917;2855;669;2260;170;625;86;227;256;852
312310;201712;782;2727;694;2551;125;511;325;1172;450;1683
312320;201712;1885;5161;1425;4326;413;1357;314;895;727;2252
312330;201712;889;2605;739;2377;86;320;529;1662;615;1982
312340;201712;277;744;210;634;31;104;106;308;137;412
312350;201712;269;636;228;594;28;80;170;435;198;515
312352;201712;1589;4814;1380;4476;175;571;910;3086;1085;3657
312360;201712;2672;8288;2111;7086;483;1759;489;1573;972;3332
312370;201712;1697;4963;1452;4523;318;1093;666;1982;984;3075
312380;201712;2089;5110;1799;4730;39;107;1590;4225;1629;4332
312385;201712;1243;3546;1032;3173;156;549;632;1847;788;2396
312390;201712;1974;6021;1517;5154;322;1194;410;1287;732;2481
312400;201712;2878;8901;2327;7832;870;3026;578;2010;1448;5036
312410;201712;11021;33247;9271;30065;1847;6379;4335;13872;6182;20251
312420;201712;3677;11028;3322;10382;603;1986;1838;5732;2441;7718
312430;201712;7842;21979;6548;19696;698;2264;4332;12976;5030;15240
312440;201712;840;2636;677;2305;301;1102;104;342;405;1444
312450;201712;1150;3660;897;3165;272;1012;317;1167;589;2179
312460;201712;389;1061;287;913;49;172;160;528;209;700
312470;201712;515;1379;330;1044;61;230;111;314;172;544
312480;201712;1198;2994;828;2512;120;418;491;1428;611;1846
312490;201712;1942;4971;1499;4276;253;776;804;2211;1057;2987
312500;201712;769;2041;620;1822;70;247;371;1048;441;1295
312510;201712;3576;10096;2803;8602;424;1369;1306;3877;1730;5246
312520;201712;200;594;162;535;46;152;66;229;112;381
312530;201712;539;1540;476;1451;34;126;384;1165;418;1291
312540;201712;1394;4239;920;3173;198;729;388;1330;586;2059
312550;201712;763;2193;597;1826;61;193;329;930;390;1123
312560;201712;1984;5281;1670;4846;80;306;1354;3882;1434;4188
312570;201712;2266;6244;1791;5527;509;1630;674;2130;1183;3760
312580;201712;525;1643;418;1392;47;194;174;556;221;750
312590;201712;1660;5196;1388;4642;173;745;715;2221;888;2966
312595;201712;1734;5634;1587;5326;289;962;918;3163;1207;4125
312600;201712;890;2471;581;1995;93;380;248;839;341;1219
312610;201712;6257;16782;4310;13243;925;3091;1025;2995;1950;6086
312620;201712;2370;6321;1744;5444;75;307;1317;4221;1392;4528
312630;201712;269;871;227;791;57;229;75;265;132;494
312640;201712;624;1753;418;1385;61;205;132;437;193;642
312650;201712;2034;5611;1418;4387;125;453;899;2647;1024;3100
312660;201712;1358;3465;1065;3033;117;395;703;1940;820;2335
312670;201712;5141;14494;4283;13311;524;2020;2587;7718;3111;9738
312675;201712;1303;3809;1054;3347;92;377;790;2445;882;2822
312680;201712;1342;3965;1154;3695;101;416;842;2635;943;3051
312690;201712;2158;5454;1688;4828;175;531;1163;3256;1338;3787
312695;201712;879;2778;800;2645;95;306;583;1950;678;2256
312700;201712;1892;5407;1438;4564;162;548;825;2574;987;3122
312705;201712;1273;3495;1049;3113;46;169;779;2245;825;2414
312707;201712;1397;4381;1069;3747;91;437;618;2058;709;2495
312710;201712;6362;15093;3809;11195;1185;3839;756;2281;1941;6120
312720;201712;959;2848;727;2430;87;340;356;1142;443;1482
312730;201712;1736;4150;1261;3552;81;257;825;2303;906;2560
312733;201712;1551;4135;1183;3456;46;139;770;2198;816;2337
312735;201712;719;1971;622;1804;99;360;402;1056;501;1416
312737;201712;784;1949;560;1611;120;364;244;694;364;1058
312738;201712;508;1465;344;1141;68;265;139;427;207;692
312740;201712;327;820;186;608;55;191;39;101;94;292
312750;201712;1224;4108;1066;3812;180;750;545;1846;725;2596
312760;201712;1886;5821;1380;4797;275;1002;415;1427;690;2429
312770;201712;39524;103152;27456;82330;6615;21183;8055;23535;14670;44718
312780;201712;2526;8367;2246;7875;290;1160;1362;4736;1652;5896
312790;201712;334;833;197;632;25;99;76;217;101;316
312800;201712;4776;14806;3770;12704;954;3516;1177;3882;2131;7398
312810;201712;1883;5429;1250;4212;313;1162;313;932;626;2094
312820;201712;1897;5268;1570;4686;75;279;1080;3130;1155;3409
312825;201712;1235;3191;1090;3011;44;143;905;2500;949;2643
312830;201712;2403;7192;1639;5671;416;1581;319;1079;735;2660
312840;201712;1151;3602;901;3105;150;590;288;887;438;1477
312850;201712;776;2182;578;1836;89;334;250;750;339;1084
312860;201712;1423;3718;932;2900;234;772;246;739;480;1511
312870;201712;5580;16705;3677;12541;611;2278;925;2919;1536;5197
312880;201712;1358;3718;1128;3383;64;205;699;2190;763;2395
312890;201712;1944;5537;1267;4141;212;725;474;1576;686;2301
312900;201712;1170;3320;983;3066;89;299;632;2023;721;2322
312910;201712;1541;2965;877;2103;129;331;444;1033;573;1364
312920;201712;906;2669;686;2282;134;527;318;984;452;1511
312930;201712;2074;5705;1710;5142;408;1279;764;2262;1172;3541
312940;201712;851;2656;733;2441;167;587;313;1043;480;1630
312950;201712;2564;7091;1964;6149;653;2174;564;1774;1217;3948
312960;201712;1921;5288;1650;4895;115;324;1242;3773;1357;4097
312965;201712;1732;5330;1458;4806;104;376;943;3095;1047;3471
312970;201712;994;3115;767;2729;189;749;258;875;447;1624
312980;201712;20432;61824;17577;56537;3596;12732;8162;25065;11758;37797
312990;201712;441;1261;291;998;77;311;108;358;185;669
313000;201712;431;1382;357;1244;65;301;139;429;204;730
313005;201712;2561;7736;2262;7221;208;750;1597;5037;1805;5787
313010;201712;4238;12808;3507;11518;736;2697;1883;5955;2619;8652
313020;201712;923;2979;639;2289;102;412;78;225;180;637
313030;201712;1289;3277;908;2686;140;487;487;1405;627;1892
313040;201712;765;2453;644;2175;70;284;327;1042;397;1326
313050;201712;1738;5155;1239;4362;273;1134;326;1008;599;2142
313055;201712;1661;4947;1518;4738;36;122;1338;4168;1374;4290
313060;201712;920;2541;663;2082;196;673;139;397;335;1070
313065;201712;1801;5712;1541;5299;130;523;1150;3943;1280;4466
313070;201712;916;2561;733;2249;123;403;367;1107;490;1510
313080;201712;402;1143;290;921;73;274;78;189;151;463
313090;201712;4734;13336;4015;12145;1079;3524;1901;5713;2980;9237
313100;201712;1409;3789;1102;3322;69;231;839;2528;908;2759
313110;201712;1511;4220;1099;3449;128;457;522;1537;650;1994
313115;201712;2425;7674;2166;7151;369;1309;1058;3289;1427;4598
313120;201712;3560;8833;2828;7914;319;979;1857;5257;2176;6236
313130;201712;25655;73799;21156;65103;3484;11885;10012;29239;13496;41124
313140;201712;511;1271;355;1021;21;80;250;693;271;773
313150;201712;1256;3820;1009;3344;314;1094;266;871;580;1965
313160;201712;906;2527;711;2192;93;321;416;1237;509;1558
313170;201712;10996;34858;8059;28401;1642;6081;2571;8796;4213;14877
313180;201712;2290;6280;1691;5158;274;913;794;2344;1068;3257
313190;201712;3973;12446;3021;10349;604;2227;894;2878;1498;5105
313200;201712;1093;3291;940;3009;50;192;746;2330;796;2522
313210;201712;3809;11501;3140;10351;523;1890;1721;5479;2244;7369
313220;201712;1617;4543;1134;3595;207;759;395;1098;602;1857
313230;201712;2496;7974;2282;7694;98;354;1966;6650;2064;7004
313240;201712;8408;23716;5933;19214;1148;4131;2353;7183;3501;11314
313250;201712;6216;19166;5180;17234;575;2086;2722;8956;3297;11042
313260;201712;652;1824;439;1379;58;221;181;550;239;771
313270;201712;5386;15528;4327;13738;851;2835;2368;7545;3219;10380
313280;201712;378;1164;266;923;53;201;66;215;119;416
313290;201712;767;2599;612;2357;252;1045;103;366;355;1411
313300;201712;1674;5126;1318;4404;371;1347;195;564;566;1911
313310;201712;996;3243;848;2942;164;647;179;526;343;1173
313320;201712;2181;6033;1543;5021;307;1122;673;2162;980;3284
313330;201712;4020;11596;3271;10388;258;1119;2162;6604;2420;7723
313340;201712;1445;3425;1053;2846;158;438;649;1769;807;2207
313350;201712;2282;6914;1718;5731;299;1099;523;1636;822;2735
313360;201712;1267;3428;897;2792;171;663;454;1294;625;1957
313370;201712;1208;3859;1082;3605;154;566;591;1915;745;2481
313375;201712;1949;5164;1323;4133;245;896;384;1146;629;2042
313380;201712;5179;14479;4033;12418;930;3201;1562;4379;2492;7580
313390;201712;858;2857;773;2705;57;255;514;1741;571;1996
313400;201712;3424;9165;2878;8484;226;658;2329;6890;2555;7548
313410;201712;1189;3259;979;2925;115;389;721;2125;836;2514
313420;201712;15741;36887;9036;25661;1897;6009;1337;3847;3234;9856
313430;201712;897;2734;670;2272;120;493;263;791;383;1284
313440;201712;5958;13355;4017;10910;316;841;2620;7234;2936;8075
313450;201712;629;1841;467;1517;96;321;138;408;234;729
313460;201712;2081;6610;1717;5999;421;1714;723;2326;1144;4040
313470;201712;3027;7856;2499;7130;254;701;1766;5077;2020;5778
313480;201712;833;2419;568;1887;83;326;175;519;258;845
313490;201712;1529;3728;748;2553;266;1069;69;232;335;1301
313500;201712;400;1297;321;1096;45;174;121;383;166;557
313505;201712;8777;25281;7939;24258;325;1057;7011;21529;7336;22586
313507;201712;1385;3668;1184;3385;64;227;903;2572;967;2799
313510;201712;13085;37526;11196;34252;1461;4892;5886;17684;7347;22576
313520;201712;13322;40353;11044;36284;989;3743;7468;24187;8457;27930
313530;201712;486;1414;405;1285;27;93;191;574;218;667
313535;201712;2467;6983;2168;6440;175;500;1502;4442;1677;4942
313540;201712;862;2680;643;2111;160;545;207;669;367;1214
313545;201712;1172;4085;1017;3781;178;741;562;2000;740;2741
313550;201712;1715;5330;1465;4840;365;1277;714;2282;1079;3559
313560;201712;2404;5135;1821;4446;102;255;1486;3621;1588;3876
313570;201712;949;3053;773;2689;198;759;299;995;497;1754
313580;201712;5513;15396;4319;13514;715;2352;2241;7276;2956;9628
313590;201712;901;2652;697;2336;300;1099;174;580;474;1679
313600;201712;3682;10620;3127;9712;213;812;2386;7337;2599;8149
313610;201712;977;2727;818;2436;124;382;519;1529;643;1911
313620;201712;5458;15796;4580;14219;1005;3343;1988;6074;2993;9417
313630;201712;8090;21230;5695;17687;879;2957;2850;9112;3729;12069
313640;201712;935;2353;597;1864;178;605;194;572;372;1177
313650;201712;1815;5735;1546;5297;133;553;1022;3480;1155;4033
313652;201712;814;2805;754;2686;116;476;461;1568;577;2044
313655;201712;971;2902;793;2626;68;266;529;1717;597;1983
313657;201712;1344;3755;1037;3270;70;304;744;2202;814;2506
313660;201712;850;2639;721;2370;133;540;353;1074;486;1614
313665;201712;4303;12704;3482;11162;544;1954;1859;5793;2403;7747
313670;201712;41789;115696;29408;92549;6045;20730;10245;30982;16290;51712
313680;201712;988;2835;856;2626;84;301;539;1610;623;1911
313690;201712;817;2817;672;2507;139;532;214;820;353;1352
313695;201712;1520;4561;1224;4056;104;408;862;2822;966;3230
313700;201712;3321;11011;2846;10414;312;1178;2188;8119;2500;9297
313710;201712;1359;3489;985;2915;114;357;579;1714;693;2071
313720;201712;5423;16062;4037;13190;731;2684;1461;4379;2192;7063
313730;201712;1243;3125;939;2719;83;243;591;1682;674;1925
313740;201712;1765;6382;1481;5633;373;1557;150;529;523;2086
313750;201712;1948;5639;1519;4790;382;1344;494;1404;876;2748
313753;201712;2010;5164;1447;4253;195;647;778;2246;973;2893
313760;201712;4901;14380;3692;11991;940;3300;1261;3884;2201;7184
313770;201712;3552;10578;2932;9678;333;1167;1872;6218;2205;7385
313780;201712;3874;10680;2951;9184;427;1497;859;2709;1286;4206
313790;201712;437;1434;410;1385;69;250;235;759;304;1009
313800;201712;1238;3129;1026;2823;69;225;787;2193;856;2418
313810;201712;1566;4283;1290;3868;113;384;922;2783;1035;3167
313820;201712;12339;31564;9232;26211;1481;4792;3744;9966;5225;14758
313830;201712;336;1060;300;994;69;248;139;472;208;720
313835;201712;874;2774;759;2570;75;304;427;1389;502;1693
313840;201712;6561;18267;4975;15570;1239;4195;1105;3396;2344;7591
313850;201712;999;2630;842;2371;116;404;468;1195;584;1599
313860;201712;2692;7754;1980;6241;402;1351;654;1932;1056;3283
313862;201712;1391;3323;841;2474;92;292;439;1299;531;1591
313865;201712;2184;6473;1942;6094;177;595;1445;4480;1622;5075
313867;201712;1091;3656;922;3302;300;1113;342;1224;642;2337
313868;201712;1676;5438;1417;4918;117;472;1041;3567;1158;4039
313870;201712;793;2258;621;1966;136;476;206;577;342;1053
313880;201712;1353;3906;1068;3444;239;850;403;1166;642;2016
313890;201712;1989;4844;1471;4172;182;560;875;2558;1057;3118
313900;201712;3601;12126;3036;10940;909;3586;754;2721;1663;6307
313910;201712;652;2081;509;1799;144;535;89;316;233;851
313920;201712;3063;9992;2554;9026;518;1867;1315;4775;1833;6642
313925;201712;1713;4601;1324;3868;241;657;755;2258;996;2915
313930;201712;6101;21087;5166;19451;499;1797;3510;13918;4009;15715
313940;201712;8453;26257;6347;22633;1482;5939;1642;6333;3124;12272
313950;201712;4176;10776;3161;9267;736;2629;1493;4090;2229;6719
313960;201712;5323;13631;3734;11094;865;2775;1132;3191;1997;5966
313970;201712;1305;3865;1157;3622;90;348;704;2234;794;2582
313980;201712;1302;3756;876;3009;143;574;319;1034;462;1608
313990;201712;1624;5780;1350;5108;423;1734;356;1238;779;2972
314000;201712;8689;25250;7537;23100;665;2527;4966;14945;5631;17472
314010;201712;1226;3194;996;2873;49;190;762;2145;811;2335
314015;201712;2053;5899;1614;5202;221;839;874;2743;1095;3582
314020;201712;506;1469;316;1056;62;245;65;212;127;457
314030;201712;811;2551;623;2130;90;335;279;933;369;1268
314040;201712;729;2057;604;1813;117;385;260;746;377;1131
314050;201712;1538;4580;1211;3913;206;775;562;1673;768;2448
314053;201712;1644;5024;1398;4635;180;581;967;3377;1147;3958
314055;201712;2200;6300;1908;5872;51;228;1599;4895;1650;5123
314060;201712;1129;3317;885;2909;57;224;609;1971;666;2195
314070;201712;4248;12427;3329;10727;821;2751;1178;3671;1999;6422
314080;201712;1742;5236;1253;4163;217;861;351;1031;568;1892
314085;201712;2047;6514;1726;6020;418;1601;737;2548;1155;4149
314090;201712;3410;10802;2970;10029;306;1244;1870;6276;2176;7520
314100;201712;3180;7655;2649;6948;80;174;2226;5999;2306;6173
314110;201712;3999;12263;3421;11103;623;2250;1622;4909;2245;7159
314120;201712;889;2105;408;1299;99;362;62;190;161;552
314130;201712;737;2066;372;1263;59;221;107;350;166;571
314140;201712;4678;14098;3659;12025;684;2332;1530;5026;2214;7358
314150;201712;1491;4017;1175;3468;136;426;699;2013;835;2439
314160;201712;2469;6541;1826;5460;261;838;871;2678;1132;3516
314170;201712;1011;2941;825;2561;111;373;476;1398;587;1771
314180;201712;5116;15008;4297;13724;734;2520;2318;7391;3052;9911
314190;201712;725;2120;537;1815;100;362;252;876;352;1238
314200;201712;2866;8462;2434;7679;171;693;1756;5350;1927;6043
314210;201712;1968;5385;1675;4906;150;499;1041;2985;1191;3484
314220;201712;1385;4101;993;3359;287;1084;244;754;531;1838
314225;201712;1231;3549;1089;3348;70;236;816;2518;886;2754
314230;201712;702;2054;615;1924;77;295;386;1181;463;1476
314240;201712;1065;3090;848;2740;208;730;346;1147;554;1877
314250;201712;535;1552;355;1144;69;240;121;352;190;592
314260;201712;944;3160;787;2828;177;762;289;931;466;1693
314270;201712;3068;9176;2495;8185;136;562;1864;5983;2000;6545
314280;201712;3345;8273;2105;6109;382;1234;759;2070;1141;3304
314290;201712;4509;12197;3822;11052;519;1555;2435;6948;2954;8503
314300;201712;1523;4762;1189;4040;320;1141;345;1144;665;2285
314310;201712;5377;14865;4033;12469;1257;4148;996;2861;2253;7009
314315;201712;833;3112;737;2903;58;282;540;2082;598;2364
314320;201712;2795;7796;1921;6346;473;1691;732;2441;1205;4132
314330;201712;48746;142140;39249;126140;11885;40290;9553;31109;21438;71399
314340;201712;2551;6680;1371;4399;271;1000;199;469;470;1469
314345;201712;1283;4105;1137;3850;150;528;743;2471;893;2999
314350;201712;1112;3089;772;2490;183;643;166;510;349;1153
314360;201712;675;2058;412;1457;77;313;91;312;168;625
314370;201712;582;1734;499;1601;51;184;362;1143;413;1327
314380;201712;1162;3421;812;2730;218;802;116;405;334;1207
314390;201712;11763;32669;8107;25816;1842;6300;1929;5558;3771;11858
314400;201712;4244;12536;3463;11303;1016;3444;1189;4019;2205;7463
314410;201712;2714;7925;1961;6473;366;1331;681;2434;1047;3765
314420;201712;733;1967;568;1726;24;129;434;1266;458;1395
314430;201712;6016;16942;4852;14888;1073;3491;1717;5253;2790;8744
314435;201712;1413;4234;1223;3941;63;277;917;2913;980;3190
314437;201712;950;2505;748;2227;24;82;500;1527;524;1609
314440;201712;525;1563;424;1393;123;455;133;381;256;836
314450;201712;1419;4062;1189;3693;179;686;667;1932;846;2618
314460;201712;3616;11678;2707;9635;647;2491;458;1594;1105;4085
314465;201712;2208;6670;1980;6224;72;312;1566;4804;1638;5116
314467;201712;926;2595;778;2350;27;79;601;1806;628;1885
314470;201712;2173;6632;1821;5909;386;1394;734;2195;1120;3589
314480;201712;5733;17995;4074;14054;759;2871;796;2466;1555;5337
314490;201712;859;2465;641;2013;96;341;363;1081;459;1422
314500;201712;1711;4687;1232;3867;244;795;389;1221;633;2016
314505;201712;1872;5019;1621;4683;124;400;1163;3344;1287;3744
314510;201712;1889;4977;1238;4063;286;1018;435;1434;721;2452
314520;201712;3468;11401;2402;8917;471;2011;234;734;705;2745
314530;201712;5490;18686;5093;17940;618;2233;3409;12197;4027;14430
314535;201712;2657;7169;2204;6518;151;478;1671;4910;1822;5388
314537;201712;1077;3202;827;2761;84;329;547;1796;631;2125
314540;201712;374;1057;272;853;45;165;111;326;156;491
314545;201712;1542;4393;1371;4150;63;193;1131;3596;1194;3789
314550;201712;657;1675;467;1410;61;234;207;559;268;793
314560;201712;4032;13171;3293;11523;569;2194;1105;3657;1674;5851
314570;201712;289;837;222;708;29;110;114;356;143;466
314580;201712;481;1568;365;1306;87;341;49;170;136;511
314585;201712;750;2377;549;1929;103;439;218;710;321;1149
314587;201712;1881;5514;1504;4872;250;753;803;2673;1053;3426
314590;201712;2727;8845;2097;7408;407;1566;633;2134;1040;3700
314600;201712;1710;5175;1083;3874;259;1024;112;346;371;1370
314610;201712;7393;22416;5923;19690;1221;4665;2431;7739;3652;12404
314620;201712;1800;4806;1471;4349;88;269;1178;3459;1266;3728
314625;201712;1484;4688;1324;4441;112;533;991;3164;1103;3697
314630;201712;4770;13573;4033;12438;189;809;3175;9674;3364;10483
314640;201712;581;1535;432;1275;94;304;170;449;264;753
314650;201712;989;2619;677;2117;87;334;268;743;355;1077
314655;201712;1552;4474;1109;3602;240;751;449;1464;689;2215
314660;201712;311;792;206;588;13;29;104;284;117;313
314670;201712;1593;4077;1117;3280;98;332;691;1969;789;2301
314675;201712;1775;5051;1536;4642;133;458;1129;3365;1262;3823
314690;201712;2070;6371;1595;5519;503;1911;294;992;797;2903
314700;201712;9215;28854;6255;22396;1556;6182;1119;3903;2675;10085
314710;201712;7981;23394;5682;18518;1134;4077;1127;3309;2261;7386
314720;201712;2211;7037;1688;5915;389;1484;420;1460;809;2944
314730;201712;2088;6087;1599;5201;416;1480;466;1387;882;2867
314740;201712;2712;8068;2200;7138;266;1038;1159;3617;1425;4655
314750;201712;331;1000;261;858;26;103;138;431;164;534
314760;201712;1786;5675;1270;4445;190;766;288;808;478;1574
314770;201712;1023;3111;550;1864;44;162;137;394;181;556
314780;201712;316;793;219;651;47;165;107;296;154;461
314790;201712;10050;29677;7589;25122;2761;10165;890;2570;3651;12735
314795;201712;1436;4097;1247;3782;67;282;968;2823;1035;3105
314800;201712;11333;30747;6944;22114;1570;5403;934;2698;2504;8101
314810;201712;9421;26487;7057;22361;2112;7080;1602;5150;3714;12230
314820;201712;879;2368;652;1983;110;391;335;968;445;1359
314830;201712;1511;4877;1305;4490;290;1090;657;2240;947;3330
314840;201712;891;2989;719;2729;86;437;464;1686;550;2123
314850;201712;1932;5173;1525;4499;109;398;1179;3409;1288;3807
314860;201712;3195;10176;2714;9224;420;1581;1559;5163;1979;6744
314870;201712;5764;16378;4682;14869;433;1488;3429;10951;3862;12439
314875;201712;1704;5374;1570;5193;104;304;1340;4482;1444;4786
314880;201712;878;2245;701;2002;44;103;490;1479;534;1582
314890;201712;463;1375;340;1100;58;214;131;378;189;592
314900;201712;652;1790;514;1556;111;358;185;560;296;918
314910;201712;1687;5227;1319;4616;322;1311;566;1882;888;3193
314915;201712;2291;7124;1967;6532;151;618;1336;4301;1487;4919
314920;201712;460;1209;340;1047;23;72;202;603;225;675
314930;201712;5266;16232;4166;14049;935;3384;1319;4261;2254;7645
314940;201712;386;1092;335;997;41;130;201;564;242;694
314950;201712;375;1047;262;874;34;123;106;341;140;464
314960;201712;711;1988;550;1668;79;285;301;842;380;1127
314970;201712;628;2037;540;1884;114;457;197;660;311;1117
314980;201712;1247;3691;992;3292;292;1082;107;333;399;1415
314990;201712;2288;6922;1608;5376;389;1478;338;977;727;2455
314995;201712;1560;4650;1318;4261;121;514;796;2443;917;2957
315000;201712;1064;2941;834;2572;81;299;525;1582;606;1881
315010;201712;411;1259;308;1043;67;276;113;338;180;614
315015;201712;2058;6171;1859;5906;211;710;1235;4060;1446;4770
315020;201712;800;2429;576;1980;92;369;272;885;364;1254
315030;201712;566;1654;421;1372;111;382;89;265;200;647
315040;201712;859;2546;783;2405;136;447;473;1435;609;1882
315050;201712;1176;3269;910;2875;102;377;472;1472;574;1849
315053;201712;1089;3148;890;2774;115;435;483;1456;598;1891
315057;201712;1610;5348;1420;4960;220;776;815;2853;1035;3629
315060;201712;610;1951;419;1546;97;377;75;280;172;657
315070;201712;658;1908;496;1600;137;473;146;443;283;916
315080;201712;2782;8739;2221;7498;506;1737;951;3223;1457;4960
315090;201712;794;2622;621;2241;129;508;169;569;298;1077
315100;201712;1151;3742;775;2794;159;661;272;905;431;1566
315110;201712;1310;3621;1042;3174;161;519;484;1481;645;2000
315120;201712;12269;29297;8727;24427;1089;3128;4486;13199;5575;16327
315130;201712;1255;3937;1076;3592;223;880;378;1174;601;2054
315140;201712;2770;8175;2200;7072;454;1659;971;2833;1425;4492
315150;201712;4171;10901;3000;8939;460;1503;1259;3706;1719;5209
315160;201712;1403;3767;983;3082;207;691;401;1220;608;1911
315170;201712;1480;4670;1091;3792;235;872;179;610;414;1482
315180;201712;16543;44427;9023;28915;1515;5524;1827;5230;3342;10754
315190;201712;1976;4871;1608;4332;337;924;1033;2758;1370;3682
315200;201712;3801;11850;2864;10035;877;3367;593;2020;1470;5387
315210;201712;7670;21596;5854;17695;827;2773;2467;6902;3294;9675
315213;201712;1116;3175;975;2973;28;91;787;2385;815;2476
315217;201712;2462;8010;1990;7132;155;732;1266;4398;1421;5130
315220;201712;8821;25044;7236;22254;2195;7036;2178;6724;4373;13760
315230;201712;2965;7652;2635;7256;85;139;2371;6839;2456;6978
315240;201712;2766;8444;2348;7760;578;2063;1156;3715;1734;5778
315250;201712;9808;28584;7514;24271;1491;5255;2879;9052;4370;14307
315260;201712;903;2771;564;1961;104;379;58;168;162;547
315270;201712;734;2280;526;1853;95;404;145;451;240;855
315280;201712;2843;7685;1672;5251;378;1261;269;814;647;2075
315290;201712;1218;3248;768;2505;246;856;187;639;433;1495
315300;201712;704;1768;470;1466;237;796;113;375;350;1171
315310;201712;1274;3821;995;3277;97;360;570;1800;667;2160
315320;201712;678;2007;506;1705;60;288;231;711;291;999
315330;201712;709;2540;402;1658;81;364;102;386;183;750
315340;201712;3186;8596;2470;7532;334;1111;1343;4028;1677;5139
315350;201712;1673;4593;1251;3897;106;371;656;2006;762;2377
315360;201712;1667;5254;1240;4306;223;852;409;1328;632;2180
315370;201712;450;1378;377;1221;70;223;173;556;243;779
315380;201712;204;656;149;528;38;149;31;99;69;248
315390;201712;1174;3658;871;3011;176;658;258;835;434;1493
315400;201712;4172;12125;3315;10520;497;1649;1671;5228;2168;6877
315410;201712;2227;5360;1736;4688;381;1083;742;1986;1123;3069
315415;201712;1145;3456;948;3151;303;1112;335;1110;638;2222
315420;201712;1164;3620;840;2975;192;700;114;366;306;1066
315430;201712;3513;9191;2577;7668;666;2288;825;2295;1491;4583
315440;201712;942;2710;794;2462;123;471;404;1128;527;1599
315445;201712;2003;5244;1522;4507;189;592;979;2885;1168;3477
315450;201712;2265;6794;1970;6323;286;910;1228;4024;1514;4934
315460;201712;30359;94304;26494;86921;8466;29639;7216;22662;15682;52301
315470;201712;461;1324;365;1161;27;103;194;592;221;695
315480;201712;1505;4400;1026;3401;231;819;232;769;463;1588
315490;201712;2924;7524;2101;6364;347;1156;712;2061;1059;3217
315500;201712;482;1374;298;960;27;100;133;379;160;479
315510;201712;1265;3607;1089;3326;53;210;894;2683;947;2893
315520;201712;1090;3147;852;2764;57;237;570;1778;627;2015
315530;201712;634;2043;497;1695;170;638;168;523;338;1161
315540;201712;1110;3225;815;2672;132;495;308;991;440;1486
315550;201712;1731;4785;1295;4116;277;1005;467;1439;744;2444
315560;201712;5973;19578;5361;18597;425;1647;3666;12760;4091;14407
315570;201712;1848;5650;1625;5219;150;577;898;2805;1048;3382
315580;201712;2248;5984;1757;5163;415;1376;552;1586;967;2962
315590;201712;898;2491;739;2232;96;334;362;1065;458;1399
315600;201712;2410;8112;1816;6939;270;1048;981;3890;1251;4938
315610;201712;945;2523;729;2118;132;484;317;764;449;1248
315620;201712;300;1030;284;998;63;213;158;602;221;815
315630;201712;828;2489;676;2182;164;551;176;505;340;1056
315640;201712;390;1088;327;992;46;165;165;470;211;635
315645;201712;864;2348;609;1913;182;608;157;461;339;1069
315650;201712;1783;4712;1396;4157;75;297;1048;3065;1123;3362
315660;201712;2532;6369;1944;5382;131;364;1327;3595;1458;3959
315670;201712;11687;35514;9893;32175;2136;7524;4379;13732;6515;21256
315680;201712;2894;9262;2198;7893;591;2304;731;2587;1322;4891
315690;201712;2864;7797;1880;6035;462;1555;437;1518;899;3073
315700;201712;7299;21557;5841;18693;978;3356;2694;8343;3672;11699
315710;201712;1872;5010;1348;4154;87;360;838;2439;925;2799
315720;201712;4036;12242;3501;11262;218;1024;2358;7255;2576;8279
315725;201712;1605;4668;1357;4331;194;631;948;3073;1142;3704
315727;201712;586;1672;445;1405;84;299;193;566;277;865
315730;201712;692;2138;623;1986;83;311;305;917;388;1228
315733;201712;1175;3202;922;2759;210;737;341;950;551;1687
315737;201712;1176;3501;922;3022;44;192;626;2021;670;2213
315740;201712;951;2800;773;2441;125;467;384;1085;509;1552
315750;201712;1190;3381;1014;3096;57;189;751;2305;808;2494
315760;201712;1116;2831;1048;2749;18;37;977;2557;995;2594
315765;201712;1762;4935;1498;4593;35;117;1353;4186;1388;4303
315770;201712;1201;3764;1036;3511;339;1251;339;1129;678;2380
315780;201712;24100;72838;20959;66906;2962;10901;10864;32940;13826;43841
315790;201712;3576;11466;3084;10532;272;939;2041;7153;2313;8092
315800;201712;1221;4729;921;3851;197;911;190;739;387;1650
315810;201712;1289;3358;1111;3094;85;298;850;2258;935;2556
315820;201712;2326;7378;2014;6837;305;1155;1267;4228;1572;5383
315830;201712;1132;3454;849;2935;69;293;377;1242;446;1535
315840;201712;751;1952;473;1406;64;196;172;479;236;675
315850;201712;983;3264;888;3098;206;791;449;1456;655;2247
315860;201712;518;1634;364;1326;80;349;110;360;190;709
315870;201712;447;1258;369;1140;28;98;237;700;265;798
315880;201712;1111;2954;829;2524;76;282;352;1012;428;1294
315890;201712;1471;4787;1283;4442;413;1529;511;1687;924;3216
315895;201712;5676;16560;4588;14305;720;2519;2063;5985;2783;8504
315900;201712;811;2176;714;2039;59;214;566;1534;625;1748
315910;201712;475;1521;422;1433;76;269;269;891;345;1160
315920;201712;1605;4323;823;2640;172;582;184;524;356;1106
315930;201712;1039;2601;724;2079;165;479;277;774;442;1253
315935;201712;819;2674;706;2450;162;622;213;747;375;1369
315940;201712;616;1882;515;1685;79;279;256;837;335;1116
315950;201712;1183;3428;1019;3143;167;519;700;2167;867;2686
315960;201712;3451;10368;2247;8063;755;3168;95;215;850;3383
315970;201712;656;1886;512;1684;59;183;359;1215;418;1398
315980;201712;3746;8768;2166;6148;497;1534;711;1828;1208;3362
315990;201712;3692;9956;2939;8685;368;1227;1640;4760;2008;5987
316000;201712;528;1528;426;1373;85;330;173;521;258;851
316010;201712;667;2089;533;1827;53;230;284;896;337;1126
316020;201712;971;3061;839;2809;84;383;555;1747;639;2130
316030;201712;3019;8652;2214;7210;254;872;1327;4391;1581;5263
316040;201712;2902;9145;2161;7631;351;1367;519;1781;870;3148
316045;201712;1890;5644;1773;5456;151;438;1399;4391;1550;4829
316050;201712;354;1081;268;919;40;162;143;469;183;631
316060;201712;701;1972;526;1690;66;313;309;908;375;1221
316070;201712;5672;16851;4771;15051;884;3094;2127;6463;3011;9557
316080;201712;719;2429;605;2180;167;652;68;236;235;888
316090;201712;485;1496;349;1203;59;243;127;399;186;642
316095;201712;1377;4334;1181;3977;207;730;627;2097;834;2827
316100;201712;2533;8071;1853;6472;380;1460;515;1684;895;3144
316105;201712;871;2428;655;2065;115;388;354;1111;469;1499
316110;201712;11770;37756;10355;35315;1437;5064;6624;22907;8061;27971
316120;201712;1070;3352;781;2632;182;635;197;571;379;1206
316130;201712;1432;3269;857;2397;119;376;390;1062;509;1438
316140;201712;1054;2896;736;2374;138;460;353;1140;491;1600
316150;201712;1466;3810;1247;3441;172;534;665;1749;837;2283
316160;201712;1081;3148;870;2759;100;351;496;1506;596;1857
316165;201712;893;2275;709;2011;126;427;400;1110;526;1537
316170;201712;1170;3188;856;2698;115;410;434;1313;549;1723
316180;201712;1370;4178;938;3231;201;768;129;363;330;1131
316190;201712;2775;8297;1572;5314;289;980;429;1298;718;2278
316200;201712;3474;10673;2594;8970;604;2367;593;1946;1197;4313
316210;201712;4197;12919;3142;10673;1086;3937;333;1134;1419;5071
316220;201712;692;2130;478;1668;97;371;51;206;148;577
316225;201712;1265;3242;1007;2799;82;299;703;1839;785;2138
316230;201712;424;1154;341;1029;45;139;160;513;205;652
316240;201712;6180;18484;5473;17445;602;1975;3999;12771;4601;14746
316245;201712;3089;10552;2807;10101;208;1093;2151;7506;2359;8599
316250;201712;9325;25391;6998;21170;1926;6342;1568;4544;3494;10886
316255;201712;2663;7768;2308;7259;346;1198;1525;4813;1871;6011
316257;201712;1286;3289;908;2672;124;401;406;1158;530;1559
316260;201712;1878;5040;1432;4368;62;223;798;2520;860;2743
316265;201712;1270;3496;931;2894;57;177;598;1839;655;2016
316270;201712;3433;11297;3046;10399;680;2473;1275;4180;1955;6653
316280;201712;3060;9529;2733;8906;381;1398;1514;4765;1895;6163
316290;201712;3214;9609;2615;8469;448;1665;950;3038;1398;4703
316292;201712;4202;12112;3566;11063;374;1321;2537;7717;2911;9038
316294;201712;760;2324;565;1968;109;428;99;344;208;772
316295;201712;2301;6882;2009;6351;107;462;1506;4586;1613;5048
316300;201712;985;3108;819;2797;57;221;529;1825;586;2046
316310;201712;957;2344;541;1706;100;344;214;666;314;1010
316320;201712;561;1683;445;1473;71;270;160;513;231;783
316330;201712;1051;3072;797;2528;69;258;531;1623;600;1881
316340;201712;1064;3152;793;2617;101;409;394;1218;495;1627
316350;201712;1249;3859;1100;3610;139;490;700;2288;839;2778
316360;201712;697;1842;558;1627;64;211;395;1119;459;1330
316370;201712;4448;13208;3604;11581;958;3501;875;2496;1833;5997
316380;201712;1593;4052;1226;3545;46;144;926;2667;972;2811
316390;201712;844;2348;672;2072;170;595;256;772;426;1367
316400;201712;1269;3802;902;3092;150;541;341;1126;491;1667
316410;201712;1022;3171;891;2971;88;305;704;2353;792;2658
316420;201712;1789;5480;1578;5206;115;457;1208;3914;1323;4371
316430;201712;867;2529;578;1928;127;452;135;434;262;886
316440;201712;671;2140;512;1876;148;623;78;276;226;899
316443;201712;580;1711;456;1475;108;388;134;422;242;810
316447;201712;1670;4716;1476;4430;64;231;1227;3650;1291;3881
316450;201712;2156;6926;1746;6090;186;708;1181;4080;1367;4788
316460;201712;843;2467;759;2319;246;799;350;1024;596;1823
316470;201712;6700;20108;5117;16946;1124;4223;1562;4881;2686;9104
316480;201712;193;609;164;547;40;148;58;176;98;324
316490;201712;330;942;243;755;37;121;102;287;139;408
316500;201712;1192;4040;777;2898;160;647;89;307;249;954
316510;201712;659;2431;602;2311;158;665;217;827;375;1492
316520;201712;1038;2941;826;2571;143;516;337;989;480;1505
316530;201712;926;2810;717;2400;129;541;298;891;427;1432
316540;201712;736;2294;644;2125;112;434;220;672;332;1106
316550;201712;1212;3871;1107;3678;142;535;754;2471;896;3006
316553;201712;2835;9055;1989;6992;585;2208;329;1074;914;3282
316555;201712;2756;9011;2430;8579;155;604;1887;6785;2042;7389
316556;201712;649;1595;477;1325;33;109;287;727;320;836
316557;201712;857;2962;761;2775;326;1261;228;785;554;2046
316560;201712;287;950;218;831;65;297;47;162;112;459
316570;201712;1165;3677;1004;3354;329;1122;299;1017;628;2139
316580;201712;366;938;232;679;56;182;77;206;133;388
316590;201712;1364;3687;987;3014;176;592;540;1539;716;2131
316600;201712;1003;3197;891;2987;157;589;456;1496;613;2085
316610;201712;585;2007;497;1842;68;349;307;1076;375;1425
316620;201712;2146;6191;1824;5691;138;500;1286;4008;1424;4508
316630;201712;1502;4648;1198;4046;369;1237;414;1562;783;2799
316640;201712;147;424;120;374;28;105;59;152;87;257
316650;201712;971;3290;799;3032;65;273;534;2081;599;2354
316660;201712;181;460;73;232;6;29;12;31;18;60
316670;201712;1979;5285;1520;4511;467;1468;454;1293;921;2761
316680;201712;1946;5088;1529;4453;150;487;1097;3103;1247;3590
316690;201712;1106;3584;935;3243;236;933;323;1083;559;2016
316695;201712;1013;3061;881;2823;65;257;589;1845;654;2102
316700;201712;373;1028;324;962;21;100;228;617;249;717
316710;201712;2666;9500;2159;8409;681;2728;657;2735;1338;5463
316720;201712;17170;52525;13609;45103;3048;10826;4755;15160;7803;25986
316730;201712;334;1015;282;899;74;269;109;309;183;578
316740;201712;668;2089;596;1981;64;289;418;1354;482;1643
316750;201712;407;1310;322;1128;60;242;115;385;175;627
316760;201712;3575;11495;2984;10510;1300;4858;920;3244;2220;8102
316770;201712;1439;3742;1210;3430;40;142;1022;2924;1062;3066
316780;201712;580;1848;474;1635;141;544;50;134;191;678
316790;201712;713;2012;531;1680;140;472;168;523;308;995
316800;201712;5319;16392;4461;14747;564;2145;2557;8098;3121;10243
316805;201712;879;2088;775;1969;20;32;694;1843;714;1875
316810;201712;544;1583;412;1333;102;366;169;510;271;876
316820;201712;345;866;185;584;28;102;28;92;56;194
316830;201712;619;1933;536;1779;114;429;295;947;409;1376
316840;201712;2690;7835;2301;7116;481;1667;1071;3170;1552;4837
316850;201712;2034;5647;1567;4847;216;784;795;2356;1011;3140
316860;201712;17905;52433;14417;46676;3038;11140;5834;18327;8872;29467
316870;201712;6284;19168;4886;16167;1191;4241;1355;4264;2546;8505
316880;201712;853;2407;726;2209;160;572;303;873;463;1445
316890;201712;1224;2836;812;2274;167;561;462;1172;629;1733
316900;201712;2380;6761;1851;5664;442;1493;576;1577;1018;3070
316905;201712;465;1497;388;1329;106;380;156;536;262;916
316910;201712;876;2571;595;2034;158;628;69;216;227;844
316920;201712;1628;4305;1122;3523;239;831;454;1420;693;2251
316930;201712;7814;25144;5869;21146;1206;4704;1118;3902;2324;8606
316935;201712;4000;11647;2845;9368;695;2420;771;2511;1466;4931
316940;201712;6650;20811;5157;17506;1076;3984;1420;4510;2496;8494
316950;201712;1690;4322;1350;3842;76;251;1048;2920;1124;3171
316960;201712;4698;11551;3572;9964;549;1681;2122;5853;2671;7534
316970;201712;3123;9635;2857;9137;615;2125;1169;3522;1784;5647
316980;201712;797;2416;563;1946;160;603;74;255;234;858
316990;201712;9693;29155;7467;24276;2099;7262;714;2181;2813;9443
317000;201712;2661;8599;2498;8374;188;636;1905;6779;2093;7415
317005;201712;2482;7371;2096;6722;410;1353;1053;3345;1463;4698
317010;201712;23984;58597;14356;43751;3621;12212;2806;9262;6427;21474
317020;201712;61941;160287;36307;111168;7225;24189;7792;21712;15017;45901
317030;201712;688;1962;557;1765;37;152;387;1200;424;1352
317040;201712;10014;27430;7484;22972;1862;6003;2817;8703;4679;14706
317043;201712;763;1959;620;1757;135;420;322;889;457;1309
317047;201712;1185;2973;857;2478;67;204;572;1642;639;1846
317050;201712;1323;4287;958;3436;169;641;322;1081;491;1722
317052;201712;2289;7062;1986;6551;234;837;1343;4351;1577;5188
317057;201712;1662;4314;1224;3573;72;269;817;2312;889;2581
317060;201712;412;1126;232;734;43;158;73;197;116;355
317065;201712;1242;3614;1064;3302;52;238;835;2500;887;2738
317070;201712;8271;24685;5504;18728;1243;4773;788;2514;2031;7287
317075;201712;987;2918;715;2320;146;497;128;385;274;882
317080;201712;5950;15226;4755;13245;1599;4672;1251;3270;2850;7942
317090;201712;4516;14418;4162;13868;364;1275;3080;10322;3444;11597
317100;201712;2669;6807;1863;5493;619;1937;560;1623;1179;3560
317103;201712;1797;6035;1598;5665;187;892;971;3241;1158;4133
317107;201712;1350;3930;1131;3509;72;276;736;2112;808;2388
317110;201712;647;1530;352;1088;56;222;120;383;176;605
317115;201712;1109;3329;931;2951;76;238;658;2086;734;2324
317120;201712;11750;35299;9155;30479;1596;5964;4290;13729;5886;19693
317130;201712;7934;21138;5748;17410;1289;4294;1898;5702;3187;9996
317140;201712;581;1779;502;1637;72;231;292;951;364;1182
317150;201712;1000;2590;806;2353;51;161;642;1856;693;2017
317160;201712;3525;8947;2520;7488;248;769;1621;4838;1869;5607
317170;201712;1973;5184;1410;4200;224;765;492;1288;716;2053
317180;201712;1611;5348;1273;4562;303;1154;305;1061;608;2215
317190;201712;1311;3676;1003;3196;61;217;658;2070;719;2287
317200;201712;4489;13012;3442;10983;870;3009;822;2439;1692;5448
317210;201712;943;2632;783;2396;67;282;557;1689;624;1971
317220;201712;262;881;239;833;57;224;105;360;162;584
320010;201712;4647;14220;3906;12784;528;1874;2305;7378;2833;9252
320013;201712;1823;5469;1264;4205;216;719;524;1811;740;2530
320016;201712;2961;7986;2467;7294;142;412;1960;5794;2102;6206
320020;201712;3641;10825;2903;9426;787;2670;880;2957;1667;5627
320030;201712;1453;4509;1029;3582;304;1127;280;895;584;2022
320035;201712;1694;4900;1446;4492;476;1630;589;1746;1065;3376
320040;201712;3211;9980;2640;8900;503;1818;1178;3948;1681;5766
320050;201712;1640;4200;1435;3860;331;938;721;1894;1052;2832
320060;201712;9725;29449;7175;24105;1639;5982;1847;5988;3486;11970
320070;201712;1387;4219;1067;3548;235;853;326;1038;561;1891
320080;201712;5315;14725;3936;12055;845;2690;1415;4361;2260;7051
320090;201712;7201;20367;5441;16877;1353;4360;2076;6349;3429;10709
320100;201712;2407;7389;1922;6429;552;1894;656;2184;1208;4078
320110;201712;1212;3400;995;3018;255;799;288;881;543;1680
320115;201712;1778;6119;1570;5731;768;2880;432;1623;1200;4503
320120;201712;14152;40365;10639;33903;2441;8495;3143;9736;5584;18231
320130;201712;33864;103449;29566;95667;5233;18845;15310;48229;20543;67074
320140;201712;3108;9553;2249;7680;532;2009;560;1894;1092;3903
320150;201712;12732;35467;9370;28839;2915;9599;1125;3150;4040;12749
320160;201712;4912;14890;3979;13057;842;3002;1741;5608;2583;8610
320170;201712;1613;4955;1240;4175;281;979;511;1696;792;2675
320180;201712;699;2348;577;2095;201;749;134;510;335;1259
320190;201712;3108;10471;2411;8806;611;2330;432;1539;1043;3869
320200;201712;963;2860;744;2466;236;866;190;644;426;1510
320210;201712;4614;12374;3650;10645;620;2002;1823;5081;2443;7083
320220;201712;2608;7409;2054;6484;366;1252;1104;3494;1470;4746
320225;201712;1229;4055;905;3251;324;1214;129;469;453;1683
320230;201712;4195;12788;3341;11306;903;3296;1266;4334;2169;7630
320240;201712;12897;35929;10123;31298;2269;7537;3921;12124;6190;19661
320245;201712;2951;9589;2594;8832;1001;3539;623;2093;1624;5632
320250;201712;1840;5476;1288;4201;324;1188;250;744;574;1932
320255;201712;1629;5520;1439;5186;559;2081;560;2105;1119;4186
320260;201712;976;2920;718;2329;216;778;191;523;407;1301
320265;201712;2404;7612;2045;6930;863;3041;581;1954;1444;4995
320270;201712;2499;7193;1852;5990;356;1212;899;2969;1255;4181
320280;201712;5536;16613;4703;15033;1243;4293;1347;4146;2590;8439
320290;201712;1346;4226;930;3204;279;1064;171;534;450;1598
320300;201712;3875;12677;3260;11295;1073;3914;648;2245;1721;6159
320305;201712;4519;13803;3695;12041;910;3155;1391;4436;2301;7591
320310;201712;1825;5363;1412;4514;322;1076;560;1786;882;2862
320313;201712;2024;5550;1362;4225;315;1093;276;813;591;1906
320316;201712;1530;4514;1208;3864;315;1062;472;1501;787;2563
320320;201712;18786;53697;13966;45092;3739;12956;4652;14752;8391;27708
320330;201712;2791;8110;2259;7156;660;2071;903;3043;1563;5114
320332;201712;5246;16122;4447;14672;1081;3830;2118;6862;3199;10692
320334;201712;1938;5955;1359;4699;325;1273;311;991;636;2264
320335;201712;1958;5784;1249;4115;343;1230;210;632;553;1862
320340;201712;4901;13096;4202;12005;833;2501;2107;6162;2940;8663
320350;201712;4921;12790;3546;10315;593;1802;1610;4602;2203;6404
320360;201712;1547;4059;1134;3289;192;551;485;1375;677;1926
320370;201712;2528;8266;2009;7053;575;2068;633;2208;1208;4276
320380;201712;2130;6183;1828;5663;422;1401;895;2700;1317;4101
320390;201712;6874;19831;5338;16606;1322;4348;1835;5563;3157;9911
320400;201712;3298;9936;2816;9020;674;2296;1217;3856;1891;6152
320405;201712;4361;12205;3536;10816;563;1864;1995;6002;2558;7866
320410;201712;4937;13435;3709;11588;701;2295;1718;5538;2419;7833
320420;201712;2422;7082;1945;6244;577;2028;466;1493;1043;3521
320425;201712;1986;4961;1515;4180;142;447;941;2514;1083;2961
320430;201712;2599;7029;2105;6040;382;1156;1158;3160;1540;4316
320435;201712;2467;7915;1961;6876;766;2804;508;1858;1274;4662
320440;201712;1060;3232;861;2798;177;647;357;1119;534;1766
320450;201712;1694;5159;1363;4516;343;1239;593;1885;936;3124
320455;201712;3672;11825;2680;9504;771;2907;689;2381;1460;5288
320460;201712;2320;7283;1659;5750;402;1462;321;1038;723;2500
320465;201712;1340;4001;1009;3311;135;490;528;1741;663;2231
320470;201712;3874;11233;2729;8791;736;2544;568;1761;1304;4305
320480;201712;1664;5023;1417;4526;294;1038;666;2069;960;3107
320490;201712;14836;43316;12179;38753;2741;9554;4804;15322;7545;24876
320495;201712;1363;3891;898;2927;224;770;203;678;427;1448
320500;201712;44900;128632;37833;116470;7379;24477;19202;57664;26581;82141
320501;201712;4454;13463;3343;11529;995;3876;888;2901;1883;6777
320503;201712;1980;6492;1553;5557;531;2111;444;1438;975;3549
320506;201712;3239;9825;2243;7525;656;2353;92;247;748;2600
320510;201712;8628;25242;7232;22850;1294;4540;3769;11636;5063;16176
320515;201712;1748;4980;1393;4224;412;1309;353;1052;765;2361
320517;201712;2022;6429;1600;5551;579;2158;321;1067;900;3225
320520;201712;30957;89894;24845;79443;5469;19209;9519;30163;14988;49372
320530;201712;26442;75613;21346;66583;3236;11877;11740;34452;14976;46329
330010;201712;19456;57417;16763;52673;3519;11591;8823;27761;12342;39352
330015;201712;1395;3779;1171;3382;201;663;556;1532;757;2195
330020;201712;18336;50108;16270;46954;2651;8550;10586;29712;13237;38262
330022;201712;1853;5258;1490;4682;286;971;867;2682;1153;3653
330023;201712;3212;9317;2604;8370;672;2328;922;2853;1594;5181
330025;201712;4591;12151;3344;9926;1064;3435;1018;2986;2082;6421
330030;201712;8583;26547;7146;23901;1213;4553;3745;11949;4958;16502
330040;201712;11382;32940;9985;30440;1684;5616;5889;17323;7573;22939
330045;201712;78033;200201;66533;184484;8053;22527;47423;130435;55476;152962
330050;201712;2312;6634;1862;5870;476;1597;764;2281;1240;3878
330060;201712;5180;14526;4371;13262;1025;3434;1897;5495;2922;8929
330070;201712;19351;55584;16748;51461;3422;11165;8340;25684;11762;36849
330080;201712;8269;22535;7351;21169;660;2021;5103;14530;5763;16551
330090;201712;2519;6382;2113;5794;299;896;1245;3333;1544;4229
330093;201712;1899;5334;1526;4762;208;667;968;3113;1176;3780
330095;201712;1006;3231;848;2893;125;469;385;1237;510;1706
330100;201712;61017;177031;52723;164377;5611;20390;34911;107451;40522;127841
330110;201712;2116;6524;1862;6085;389;1345;743;2375;1132;3720
330115;201712;1740;4842;1455;4414;276;947;816;2414;1092;3361
330120;201712;2904;7276;2362;6557;265;855;1643;4462;1908;5317
330130;201712;3406;10375;2951;9656;609;2119;1556;5087;2165;7206
330140;201712;3119;9044;2680;8405;495;1782;1553;4729;2048;6511
330150;201712;1970;5698;1587;5027;363;1185;556;1761;919;2946
330160;201712;1116;3331;944;3060;228;808;456;1436;684;2244
330170;201712;89128;257312;79301;242456;14357;45928;46230;140764;60587;186692
330180;201712;2047;5685;1684;5071;82;336;1198;3505;1280;3841
330185;201712;8584;24677;7243;22312;1059;3636;4485;13412;5544;17048
330187;201712;3649;10114;3056;9192;514;1705;1856;5492;2370;7197
330190;201712;26596;70645;23748;66640;2911;8455;17630;49373;20541;57828
330200;201712;13387;39111;11373;36220;2659;8514;6100;19977;8759;28491
330205;201712;1932;5173;1634;4706;125;424;1134;3189;1259;3613
330210;201712;3089;8357;2331;6902;542;1691;820;2303;1362;3994
330220;201712;9472;27392;7727;24000;1881;6318;2125;6098;4006;12416
330225;201712;3408;10137;2876;9207;301;1214;1862;5709;2163;6923
330227;201712;15633;43130;13865;40659;1826;5632;9771;28726;11597;34358
330230;201712;1232;3454;1047;3168;105;371;685;2021;790;2392
330240;201712;17278;49918;14381;44994;3685;12441;5992;18160;9677;30601
330245;201712;1282;3650;912;2987;216;750;219;710;435;1460
330250;201712;33396;94247;29173;87682;7308;22255;13067;40290;20375;62545
330260;201712;4326;12514;3515;11128;628;2173;1689;5119;2317;7292
330270;201712;21635;46742;13991;36206;2867;8191;5504;14164;8371;22355
330280;201712;2173;6193;1769;5455;271;922;911;2681;1182;3603
330285;201712;17770;47828;15097;43969;2183;7023;9677;27536;11860;34559
330290;201712;3221;9038;2724;8220;437;1432;1498;4342;1935;5774
330300;201712;3133;9863;2738;9126;459;1701;1549;5011;2008;6712
330310;201712;2237;6102;1778;5310;164;490;1133;3381;1297;3871
330320;201712;12694;35502;11399;33664;1492;4582;8291;24438;9783;29020
330330;201712;27406;71085;23281;64919;3517;10892;14884;40278;18401;51170
330340;201712;13109;36847;10304;31957;2315;7765;3996;11910;6311;19675
330350;201712;87778;239609;76092;223489;9011;28549;53486;156130;62497;184679
330360;201712;6663;17828;5815;16810;494;1520;4581;13171;5075;14691
330370;201712;3495;11938;3059;11034;945;3519;1073;3883;2018;7402
330380;201712;4826;14786;3878;12995;947;3422;1306;4239;2253;7661
330385;201712;3799;12405;3353;11622;972;3566;1343;4728;2315;8294
330390;201712;21571;67228;17903;59969;4063;14636;7616;24822;11679;39458
330395;201712;3049;8430;2670;7886;208;728;1814;5264;2022;5992
330400;201712;2688;7985;2403;7456;219;842;1656;4828;1875;5670
330410;201712;2684;7925;2046;6740;395;1436;907;2839;1302;4275
330411;201712;2240;6638;1920;6028;200;746;1306;3926;1506;4672
330412;201712;1381;4466;1143;3998;196;744;568;1875;764;2619
330414;201712;22703;61212;19128;56255;3000;8669;12093;35854;15093;44523
330415;201712;3366;9893;2680;8676;518;1670;1212;4075;1730;5745
330420;201712;9537;25646;6313;20075;1176;3999;1858;5638;3034;9637
330430;201712;6988;19723;6131;18227;1005;3374;3527;9985;4532;13359
330440;201712;1557;4922;1336;4535;365;1387;504;1592;869;2979
330450;201712;1304;4135;1099;3762;205;786;543;1806;748;2592
330452;201712;13239;37345;10578;32649;2299;7637;5041;15165;7340;22802
330455;201712;514749;1329974;401613;1154348;74565;229256;218892;618690;293457;847946
330460;201712;1176;3550;943;3171;206;749;431;1406;637;2155
330470;201712;4260;11823;3419;10479;844;2810;1448;4297;2292;7107
330475;201712;8108;23234;6738;21206;1870;6446;2921;8948;4791;15394
330480;201712;5668;15886;4924;14759;700;2318;3118;9099;3818;11417
330490;201712;109692;273695;94200;251427;10727;30894;64854;170066;75581;200960
330500;201712;4904;14384;4559;13862;580;1881;3287;9918;3867;11799
330510;201712;34621;100789;29502;93003;9077;28693;12564;40573;21641;69266
330513;201712;1179;3472;1052;3250;344;1115;422;1292;766;2407
330515;201712;2827;8290;2360;7449;791;2608;743;2313;1534;4921
330520;201712;10498;30734;9080;28283;1774;5988;4312;13049;6086;19037
330530;201712;1507;4087;1201;3570;269;863;528;1516;797;2379
330540;201712;2746;7890;2219;6935;627;2030;785;2401;1412;4431
330550;201712;7439;23819;6479;22053;2531;9005;1467;5100;3998;14105
330555;201712;9797;27305;8613;25629;1539;4809;5326;16021;6865;20830
330560;201712;4110;12020;3545;10976;492;1658;2075;6229;2567;7887
330570;201712;2969;8658;2485;7818;521;1724;1320;4116;1841;5840
330575;201712;5305;14484;4633;13300;515;1695;3298;9124;3813;10819
330580;201712;11939;36195;9735;31940;2673;9225;3717;12063;6390;21288
330590;201712;1531;4445;1378;4239;159;506;1001;3102;1160;3608
330600;201712;10918;31525;8750;27592;1473;4946;4254;13383;5727;18329
330610;201712;8523;25414;7449;23694;1010;3683;4562;14108;5572;17791
330615;201712;1607;5305;1428;5054;494;1868;603;2128;1097;3996
330620;201712;3464;11425;2958;10460;1083;4074;630;2162;1713;6236
330630;201712;22922;63727;18426;55879;2318;8138;11386;33148;13704;41286
350010;201712;1855;5270;1018;3369;262;888;76;207;338;1095
350020;201712;573;1538;324;1035;39;135;152;436;191;571
350030;201712;4171;12551;3122;10440;846;3045;806;2625;1652;5670
350040;201712;513;1659;352;1273;75;308;101;329;176;637
350050;201712;866;2507;652;2092;151;544;185;495;336;1039
350055;201712;666;1856;563;1694;56;200;405;1187;461;1387
350060;201712;103;314;86;287;20;73;36;125;56;198
350070;201712;3829;10781;2386;7841;466;1587;684;2045;1150;3632
350075;201712;587;1905;449;1608;180;668;60;199;240;867
350080;201712;657;1853;404;1295;54;195;176;537;230;732
350090;201712;560;1425;335;985;76;223;103;293;179;516
350100;201712;1998;5736;1341;4500;208;823;560;1752;768;2575
350110;201712;422;1258;315;1027;25;98;189;594;214;692
350115;201712;1254;3762;1048;3306;199;679;511;1479;710;2158
350120;201712;801;2188;489;1540;64;197;255;842;319;1039
350130;201712;3049;8738;2565;7807;312;1047;1451;4173;1763;5220
350140;201712;547;1791;446;1582;38;170;255;872;293;1042
350150;201712;475;1516;410;1388;139;487;113;371;252;858
350160;201712;9563;25380;6095;18978;965;3440;3051;8816;4016;12256
350170;201712;1469;4752;1177;4074;283;1039;308;1017;591;2056
350180;201712;1089;2865;636;1950;119;402;285;845;404;1247
350190;201712;2959;8889;2239;7368;476;1758;888;2503;1364;4261
350200;201712;358;1059;311;976;24;79;223;680;247;759
350210;201712;5181;13002;3455;10133;747;2244;1604;4645;2351;6889
350220;201712;2258;6837;1829;5916;368;1345;774;2306;1142;3651
350230;201712;817;2485;713;2304;171;577;316;1024;487;1601
350240;201712;602;1847;435;1453;72;250;167;542;239;792
350250;201712;2091;6990;1748;6358;623;2437;426;1593;1049;4030
350260;201712;829;2190;551;1662;94;287;265;785;359;1072
350270;201712;4577;13404;3770;11752;672;2310;1781;5194;2453;7504
350275;201712;1999;6062;1680;5494;391;1368;706;2227;1097;3595
350280;201712;20225;47636;12483;34835;2460;7361;3786;10231;6246;17592
350290;201712;2703;8080;1984;6618;392;1465;707;2244;1099;3709
350300;201712;608;1758;425;1350;93;290;125;361;218;651
350310;201712;822;2665;693;2353;93;357;276;882;369;1239
350315;201712;524;1549;375;1244;59;229;125;368;184;597
350320;201712;11017;32173;9094;28705;2546;8583;1958;6274;4504;14857
350330;201712;14075;36796;9590;27369;1450;4206;4838;13081;6288;17287
350335;201712;382;1121;328;1026;18;47;252;802;270;849
350340;201712;995;2793;655;2127;139;496;214;681;353;1177
350350;201712;704;2039;574;1867;121;409;228;719;349;1128
350360;201712;881;2897;740;2567;212;713;287;1004;499;1717
350370;201712;551;1571;382;1195;117;362;53;156;170;518
350380;201712;4424;12631;3105;10058;753;2572;964;3002;1717;5574
350390;201712;9240;27133;7744;24333;2190;7070;2808;8653;4998;15723
350395;201712;393;1043;191;631;20;72;59;170;79;242
350400;201712;7591;20735;5642;17273;1488;4964;1693;4926;3181;9890
350410;201712;8393;26005;6486;22202;1645;6184;1688;5344;3333;11528
350420;201712;570;1751;423;1473;85;351;66;218;151;569
350430;201712;658;1989;556;1814;74;301;333;1025;407;1326
350440;201712;1318;3926;1054;3353;238;770;451;1382;689;2152
350450;201712;6864;20726;5443;17958;1271;4472;1640;5173;2911;9645
350460;201712;1492;3894;831;2581;172;603;247;717;419;1320
350470;201712;222;573;182;501;11;41;125;322;136;363
350480;201712;779;2186;515;1654;95;345;86;238;181;583
350490;201712;1686;4993;1354;4368;308;1071;433;1281;741;2352
350500;201712;572;1666;487;1520;81;288;266;807;347;1095
350510;201712;1044;3023;773;2469;105;383;392;1196;497;1579
350520;201712;1711;5955;1334;5081;274;1145;439;1598;713;2743
350530;201712;2258;6307;1729;5229;475;1522;556;1561;1031;3083
350535;201712;1357;4042;1219;3840;140;531;850;2602;990;3133
350540;201712;1643;4482;1204;3709;259;878;498;1539;757;2417
350550;201712;9131;23233;6154;18322;888;3020;2803;7801;3691;10821
350560;201712;3384;10619;2818;9363;319;1132;1627;5309;1946;6441
350570;201712;18090;55892;15594;51015;4118;14599;6403;19963;10521;34562
350580;201712;1700;5197;1019;3487;205;738;119;334;324;1072
350590;201712;3996;11714;3008;9655;696;2578;1286;3699;1982;6277
350600;201712;38804;95876;25191;70883;3769;11680;11479;29763;15248;41443
350610;201712;6431;18654;4904;15694;1015;3433;2063;6479;3078;9912
350620;201712;377;1029;270;866;32;127;130;392;162;519
350630;201712;1502;4209;1099;3427;141;517;546;1564;687;2081
350635;201712;6650;18551;5168;16041;1081;3709;2406;7128;3487;10837
350640;201712;794;2378;484;1589;74;277;144;417;218;694
350650;201712;7401;21300;4861;15694;1057;3702;1303;3915;2360;7617
350660;201712;4704;13302;3721;11545;739;2431;1738;5375;2477;7806
350670;201712;1442;4387;1289;4115;280;911;650;2080;930;2991
350680;201712;1021;2926;708;2322;151;534;299;987;450;1521
350690;201712;983;2988;740;2493;144;527;304;965;448;1492
350700;201712;4037;11452;2898;9543;615;2305;1249;3828;1864;6133
350710;201712;2610;7814;2239;7110;316;1114;1297;3964;1613;5078
350715;201712;774;2306;682;2115;86;318;382;1094;468;1412
350720;201712;141;392;120;356;22;73;45;131;67;204
350730;201712;397;1380;340;1238;66;263;158;566;224;829
350740;201712;1557;4624;1050;3458;197;688;262;771;459;1459
350745;201712;555;1649;329;1101;46;167;137;408;183;575
350750;201712;8797;25838;7075;22533;1489;5363;2348;6713;3837;12076
350760;201712;12369;34330;9438;29227;2606;8721;2250;6207;4856;14928
350770;201712;660;1818;444;1376;61;201;238;727;299;928
350775;201712;567;1480;442;1271;48;156;213;611;261;767
350780;201712;1837;5295;1400;4503;365;1332;331;1128;696;2460
350790;201712;1741;5168;1204;4071;267;977;198;581;465;1558
350800;201712;2997;9615;2735;9089;503;1837;1399;4489;1902;6326
350810;201712;1942;5275;1650;4875;344;1070;877;2693;1221;3763
350820;201712;711;1818;416;1253;60;184;154;431;214;615
350830;201712;777;2364;482;1669;69;245;129;403;198;648
350840;201712;2476;8052;1926;6923;600;2333;558;1896;1158;4229
350850;201712;5678;17905;4548;15549;1366;4886;1230;4204;2596;9090
350860;201712;3101;9113;2838;8707;101;437;2226;6712;2327;7149
350870;201712;2593;7967;2053;7021;432;1636;1027;3465;1459;5101
350880;201712;1269;4020;1014;3403;226;796;280;887;506;1683
350890;201712;638;1747;396;1236;41;139;121;307;162;446
350900;201712;5595;16633;3878;13016;1251;4584;395;1252;1646;5836
350910;201712;796;2228;691;2019;142;488;404;1128;546;1616
350920;201712;11379;30574;9847;28034;677;2227;7538;20634;8215;22861
350925;201712;4478;13307;3354;11139;817;2814;1104;3281;1921;6095
350930;201712;1353;3737;948;2908;146;469;463;1364;609;1833
350940;201712;1873;5740;1583;5191;239;880;916;2901;1155;3781
350945;201712;902;2711;710;2334;119;426;322;1008;441;1434
350950;201712;74059;211351;59236;180101;10105;33778;31443;90405;41548;124183
350960;201712;4669;14408;3804;12713;760;2906;1914;6056;2674;8962
350970;201712;3661;12075;2960;10437;951;3628;445;1368;1396;4996
350980;201712;568;1809;491;1631;195;673;153;504;348;1177
350990;201712;1747;5465;1348;4724;349;1365;417;1354;766;2719
350995;201712;802;2616;728;2462;73;302;443;1418;516;1720
351000;201712;2539;7217;1963;6121;388;1340;658;1920;1046;3260
351010;201712;306;832;174;555;23;76;81;252;104;328
351015;201712;661;2191;550;1986;110;440;230;802;340;1242
351020;201712;8274;24237;6776;21861;1449;4953;3758;11992;5207;16945
351030;201712;2301;7365;1903;6436;335;1318;905;2858;1240;4176
351040;201712;4069;11292;3513;10388;283;1006;2624;7475;2907;8481
351050;201712;15647;41162;10761;33060;2483;8272;3681;11191;6164;19463
351060;201712;39126;106349;31059;92621;4763;15484;18263;52957;23026;68441
351070;201712;1356;3652;828;2685;245;857;83;237;328;1094
351080;201712;2529;7150;1908;6334;451;1656;857;2654;1308;4310
351090;201712;363;1144;261;944;46;181;52;190;98;371
351100;201712;2529;7280;1650;5253;433;1448;304;1001;737;2449
351110;201712;5406;14455;3511;11009;814;2829;1104;3158;1918;5987
351120;201712;678;1896;471;1490;73;245;189;536;262;781
351130;201712;933;2566;443;1537;81;280;75;253;156;533
351140;201712;1631;5269;1265;4481;364;1404;296;915;660;2319
351150;201712;1497;4767;964;3462;220;836;72;216;292;1052
351160;201712;1107;3776;932;3378;227;887;307;977;534;1864
351170;201712;1391;4217;1164;3730;134;475;662;2002;796;2477
351190;201712;799;2463;603;1972;97;310;194;602;291;912
351200;201712;1646;4389;1275;3779;94;315;744;2107;838;2422
351210;201712;1360;3515;842;2490;105;363;402;1066;507;1429
351220;201712;2888;9072;2563;8433;360;1295;1537;4933;1897;6228
351230;201712;1733;5124;1340;4406;292;1076;608;1834;900;2910
351240;201712;1493;4194;1034;3209;222;725;449;1311;671;2036
351250;201712;1022;2922;604;1951;86;296;207;652;293;948
351260;201712;876;2540;720;2221;259;780;151;460;410;1240
351270;201712;308;974;265;882;60;234;122;341;182;575
351280;201712;4788;13303;3610;11038;656;2224;1472;4284;2128;6508
351290;201712;923;2540;633;1980;135;445;262;779;397;1224
351300;201712;13141;39629;9637;32565;2268;8260;3071;10441;5339;18701
351310;201712;2835;8153;2227;7056;323;1206;1208;3558;1531;4764
351320;201712;890;2842;700;2366;130;464;242;766;372;1230
351330;201712;1039;4199;979;4098;65;182;827;3637;892;3819
351340;201712;5857;18492;4806;16494;1315;4671;1781;6136;3096;10807
351350;201712;9149;25821;7737;23354;1350;4240;4645;13586;5995;17826
351360;201712;3894;11458;3399;10586;864;2941;1080;3109;1944;6050
351370;201712;2192;6564;1585;5242;363;1259;579;1761;942;3020
351380;201712;38347;104208;31565;91904;5993;18452;15476;43856;21469;62308
351385;201712;259;720;168;527;30;90;52;158;82;248
351390;201712;1300;3533;900;2909;208;819;428;1234;636;2053
351400;201712;933;2853;790;2570;213;726;324;1032;537;1758
351410;201712;2326;6935;1845;5996;298;992;945;3014;1243;4006
351420;201712;276;760;175;548;43;124;53;167;96;291
351430;201712;747;2271;684;2154;79;282;499;1545;578;1827
351440;201712;3102;8888;2175;6884;407;1400;417;1138;824;2538
351450;201712;1476;4077;1100;3387;253;818;287;911;540;1729
351460;201712;666;1910;567;1725;221;655;210;651;431;1306
351470;201712;1008;2855;846;2546;94;345;484;1358;578;1703
351480;201712;2564;8106;2215;7494;314;1309;1184;3834;1498;5143
351490;201712;1772;5618;1552;5152;124;525;1046;3307;1170;3832
351492;201712;314;969;264;843;17;61;138;406;155;467
351495;201712;186;593;143;475;23;85;62;194;85;279
351500;201712;31463;83793;23369;69589;5395;17034;10337;29584;15732;46618
351510;201712;10095;28288;7746;23911;1455;4889;4069;12202;5524;17091
351512;201712;473;1336;342;1048;56;171;140;400;196;571
351515;201712;2661;6993;1701;5217;352;1250;403;1213;755;2463
351518;201712;2188;6145;1484;4850;266;1012;698;2057;964;3069
351519;201712;636;1862;433;1405;86;329;81;176;167;505
351520;201712;962;2555;380;1272;54;213;125;363;179;576
351530;201712;338;1002;193;634;29;89;60;161;89;250
351535;201712;2151;5451;1645;4644;149;520;1047;2787;1196;3307
351540;201712;1788;4953;1256;3946;455;1555;201;528;656;2083
351550;201712;5258;14883;3600;11211;581;2016;1582;4551;2163;6567
351560;201712;417;1318;353;1169;83;314;79;256;162;570
351565;201712;153;523;135;477;30;107;54;180;84;287
351570;201712;14761;42007;11873;36356;1894;6318;7081;20858;8975;27176
351580;201712;276;765;166;540;31;93;49;178;80;271
351590;201712;499;1220;280;785;33;112;152;401;185;513
351600;201712;1668;4497;1274;3762;168;555;706;1949;874;2504
351610;201712;635;1658;445;1325;44;166;241;624;285;790
351620;201712;18572;55590;14126;47024;2719;10248;4795;14226;7514;24474
351630;201712;23745;68683;20291;62821;3724;12120;12072;36546;15796;48666
351640;201712;13943;39695;11329;35173;1682;5849;6981;20960;8663;26809
351650;201712;401;1179;177;611;32;119;26;83;58;202
351660;201712;764;2383;510;1732;102;387;92;275;194;662
351670;201712;4374;13069;3321;10647;620;2122;1575;4738;2195;6860
351680;201712;465;1432;280;918;60;188;60;196;120;384
351685;201712;437;1364;360;1213;86;273;134;458;220;731
351690;201712;988;2795;669;2119;122;413;241;680;363;1093
351700;201712;917;2654;777;2383;168;498;314;959;482;1457
351710;201712;588;1848;449;1552;59;246;192;613;251;859
351720;201712;1332;3834;940;3036;172;588;355;1122;527;1710
351730;201712;978;2694;737;2290;99;365;365;1062;464;1427
351740;201712;3837;10195;2999;8568;554;1678;1253;3307;1807;4985
351750;201712;1216;3729;751;2680;129;498;265;943;394;1441
351760;201712;3167;9584;2376;7848;575;2081;666;1978;1241;4059
351770;201712;1987;6162;1650;5465;496;1705;596;1918;1092;3623
351780;201712;1351;3662;705;2246;121;435;169;503;290;938
351790;201712;1136;3080;940;2771;147;402;585;1753;732;2155
351800;201712;567;1253;290;743;38;108;98;222;136;330
351810;201712;982;2767;812;2454;64;168;584;1734;648;1902
351820;201712;2412;7385;1694;5839;359;1320;254;874;613;2194
351830;201712;4260;12348;3262;10405;452;1683;1732;5288;2184;6971
351840;201712;6540;21033;5476;18929;1225;4677;2191;7132;3416;11809
351850;201712;1975;5238;1316;4079;231;836;444;1239;675;2075
351860;201712;2816;8815;2378;7902;516;1837;1130;3691;1646;5528
351870;201712;24333;68281;19513;60043;6261;20051;7016;21792;13277;41843
351880;201712;112996;330586;90162;287491;26877;91856;24338;73492;51215;165348
351885;201712;661;2171;593;2017;151;523;255;851;406;1374
351890;201712;580;1789;470;1571;101;348;75;206;176;554
351900;201712;1122;3335;892;2941;204;699;297;989;501;1688
351905;201712;417;1221;304;978;37;131;140;412;177;543
351907;201712;19806;55366;16134;48640;943;3512;11775;34532;12718;38044
351910;201712;1117;3181;836;2573;167;561;347;974;514;1535
351920;201712;916;2455;706;2085;89;299;353;1004;442;1303
351925;201712;946;2750;755;2370;115;375;363;1064;478;1439
351930;201712;2692;8216;2563;7978;280;1169;2061;6149;2341;7318
351940;201712;1017;2840;769;2421;89;321;423;1310;512;1631
351950;201712;1505;3924;1075;3150;82;269;616;1769;698;2038
351960;201712;4702;12899;3417;10547;810;2682;1370;4102;2180;6784
351970;201712;5435;18621;4786;17350;1068;4270;2169;7438;3237;11708
351980;201712;909;2571;674;2076;108;390;320;896;428;1286
351990;201712;1367;3547;978;2900;153;547;304;821;457;1368
352000;201712;2239;7058;1977;6503;245;946;1157;3603;1402;4549
352010;201712;1845;5672;1507;4996;367;1326;220;787;587;2113
352020;201712;1519;4428;1210;3878;247;870;524;1582;771;2452
352030;201712;4965;14078;4012;12639;774;2713;2173;6743;2947;9456
352040;201712;1980;5877;1343;4542;281;1004;206;633;487;1637
352042;201712;3212;8379;1908;5820;380;1221;791;2399;1171;3620
352044;201712;1900;5542;1125;3940;197;754;245;793;442;1547
352050;201712;11683;33843;7793;25369;1863;6851;1359;3922;3222;10773
352060;201712;715;2104;544;1751;85;303;228;682;313;985
352070;201712;792;1778;573;1465;96;265;251;623;347;888
352080;201712;450;1257;271;860;43;154;84;238;127;392
352090;201712;1338;4418;1046;3701;182;718;299;944;481;1662
352100;201712;3023;8980;2428;7839;544;1901;1071;3315;1615;5216
352110;201712;539;1752;439;1534;106;387;158;514;264;901
352115;201712;481;1471;405;1333;86;293;202;665;288;958
352120;201712;819;2591;666;2270;82;331;342;1059;424;1390
352130;201712;1808;5372;1155;3714;247;848;335;1021;582;1869
352140;201712;1545;4274;932;3014;147;517;367;1115;514;1632
352150;201712;754;2135;581;1821;152;473;271;856;423;1329
352160;201712;894;2411;659;2023;129;447;260;745;389;1192
352170;201712;2664;7854;2229;6904;467;1572;1065;3047;1532;4619
352180;201712;2921;8185;2383;7129;574;1839;887;2479;1461;4318
352190;201712;1145;3276;870;2783;140;522;294;828;434;1350
352200;201712;369;1221;272;1017;43;164;80;299;123;463
352210;201712;16266;42489;13311;38104;1787;5487;8956;25538;10743;31025
352215;201712;501;1444;453;1386;58;198;294;876;352;1074
352220;201712;13579;38762;9957;32020;3001;10169;2485;7909;5486;18078
352230;201712;11958;38676;9643;34035;2726;10600;3010;9890;5736;20490
352240;201712;11524;32037;8582;26727;2107;7456;2968;8327;5075;15783
352250;201712;20093;61230;16914;55477;4710;16177;7333;23725;12043;39902
352260;201712;5480;15619;3760;12089;625;2172;1878;5870;2503;8042
352265;201712;852;2588;734;2391;63;266;494;1541;557;1807
352270;201712;1510;4958;1202;4269;284;1053;343;1186;627;2239
352280;201712;2252;6347;1804;5627;218;852;932;2724;1150;3576
352290;201712;1054;3292;886;2898;158;611;407;1196;565;1807
352300;201712;962;2746;694;2179;108;407;317;871;425;1278
352310;201712;43623;122353;33476;104851;8930;28703;13900;43789;22830;72492
352320;201712;5510;16024;4466;13873;908;3119;1890;5216;2798;8335
352330;201712;1885;5755;1561;5278;430;1601;609;1931;1039;3532
352340;201712;4657;13908;3486;11711;904;3253;1056;3324;1960;6577
352350;201712;1629;5180;1393;4638;261;990;528;1610;789;2600
352360;201712;1019;2954;897;2761;167;626;599;1755;766;2381
352370;201712;917;2958;809;2722;56;252;559;1821;615;2073
352380;201712;838;2517;670;2210;174;634;182;561;356;1195
352390;201712;17547;44681;11590;34148;1890;6193;5829;16182;7719;22375
352400;201712;3376;9554;2629;8163;652;2338;1251;3493;1903;5831
352410;201712;2790;7972;2294;7159;365;1258;1207;3620;1572;4878
352420;201712;899;2293;645;1856;102;318;244;676;346;994
352430;201712;6484;18146;5077;15820;1547;5094;1749;5445;3296;10539
352440;201712;15920;47111;12663;40657;2747;9375;5363;16701;8110;26076
352450;201712;603;1798;356;1236;74;277;93;314;167;591
352460;201712;2490;7535;1884;6357;443;1647;576;1859;1019;3506
352470;201712;3736;9998;2712;8191;321;1102;1409;3971;1730;5073
352480;201712;3729;9612;2649;7654;497;1619;1138;3008;1635;4627
352490;201712;664;2181;509;1813;98;376;171;605;269;981
352500;201712;8895;24138;6967;20864;3516;11385;1175;2625;4691;14010
352510;201712;3034;8925;2365;7702;640;2284;750;2336;1390;4620
352520;201712;2168;6842;1789;6058;450;1618;752;2435;1202;4053
352530;201712;8352;25108;5716;19108;1367;4924;823;2193;2190;7117
352540;201712;510;1563;366;1238;71;255;91;287;162;542
352550;201712;879;2708;625;2179;125;485;151;486;276;971
352560;201712;537;1591;373;1211;71;229;82;237;153;466
352570;201712;1841;5741;1206;4360;320;1269;195;591;515;1860
352580;201712;807;2396;623;2012;106;386;217;642;323;1028
352585;201712;240;739;193;634;21;76;91;282;112;358
352590;201712;12885;37134;9587;30598;3150;10745;3432;10033;6582;20778
352600;201712;1824;5380;1402;4450;263;897;611;1836;874;2733
352610;201712;3212;9650;2517;8388;565;2107;806;2504;1371;4611
352620;201712;5180;14915;4360;13600;1182;3786;1817;5640;2999;9426
352630;201712;744;2012;581;1739;104;380;277;765;381;1145
352640;201712;2562;7131;2017;6231;164;554;1359;4164;1523;4718
352650;201712;632;1905;465;1485;81;282;136;414;217;696
352660;201712;945;3224;802;2923;167;646;306;1077;473;1723
352670;201712;9740;27975;5792;19489;1411;5222;427;1399;1838;6621
352680;201712;2982;9446;2215;7694;428;1677;886;2851;1314;4528
352690;201712;29901;79316;21656;63825;2282;7628;12672;35523;14954;43151
352700;201712;557;1514;422;1322;155;533;126;353;281;886
352710;201712;4952;13898;3603;11244;958;3295;1314;3838;2272;7133
352720;201712;7768;23563;6461;20833;2591;8528;1328;4036;3919;12564
352725;201712;400;1095;201;647;19;76;97;284;116;360
352730;201712;2416;7425;2151;6756;422;1490;1102;3120;1524;4610
352740;201712;2126;5438;1623;4650;199;639;924;2553;1123;3192
352750;201712;417;1138;224;738;43;152;47;133;90;285
352760;201712;1360;4269;1073;3591;199;742;457;1426;656;2168
352770;201712;767;2321;605;1962;130;460;193;589;323;1049
352780;201712;615;2000;474;1660;98;359;160;557;258;916
352790;201712;605;1678;422;1326;60;201;139;405;199;606
352800;201712;1132;3876;837;3080;206;794;191;638;397;1432
352810;201712;1030;2593;631;1822;114;332;247;698;361;1030
352820;201712;564;1466;380;1169;80;257;93;282;173;539
352830;201712;542;1496;271;866;42;142;41;109;83;251
352840;201712;3787;12074;3296;11110;985;3491;1271;4109;2256;7600
352850;201712;10187;27506;7186;22626;1887;6393;2205;6789;4092;13182
352860;201712;815;2638;717;2417;162;580;284;934;446;1514
352870;201712;809;2086;528;1467;48;156;280;708;328;864
352880;201712;1942;5017;1358;3902;216;654;607;1553;823;2207
352885;201712;262;807;212;710;31;99;126;419;157;518
352890;201712;623;1572;403;1095;68;210;164;369;232;579
352900;201712;17845;49879;12726;39740;2432;8366;5145;15069;7577;23435
352910;201712;411;1146;215;699;20;77;44;117;64;194
352920;201712;2453;6855;1774;5550;252;867;906;2659;1158;3526
352930;201712;5399;16096;4207;13629;821;2836;1654;5101;2475;7937
352940;201712;21677;65635;17443;56800;5522;19757;2830;8272;8352;28029
352950;201712;429;1168;230;763;44;160;24;68;68;228
352960;201712;632;1844;365;1216;60;222;114;349;174;571
352965;201712;312;897;186;610;50;172;32;87;82;259
352970;201712;3036;7520;2419;6576;248;686;1636;4466;1884;5152
352980;201712;1247;3737;1021;3352;203;697;515;1686;718;2383
352990;201712;3948;11933;3356;10925;765;2821;1592;4889;2357;7710
353000;201712;446;1227;220;710;41;138;57;168;98;306
353010;201712;2640;7058;1822;5461;422;1379;561;1553;983;2932
353020;201712;3785;10129;2166;6633;316;1045;741;2071;1057;3116
353030;201712;3659;10233;2668;8327;697;2310;516;1591;1213;3901
353040;201712;488;1326;381;1119;84;268;132;349;216;617
353050;201712;4836;15229;3752;12969;948;3518;1405;4625;2353;8143
353060;201712;42909;119640;36293;108771;3444;12304;25536;73565;28980;85869
353070;201712;9457;28277;6769;22606;1538;5494;2016;6603;3554;12097
353080;201712;4518;13544;3155;10735;766;2828;910;2846;1676;5674
353090;201712;524;1742;462;1605;43;169;279;917;322;1086
353100;201712;279;763;108;367;10;35;21;66;31;101
353110;201712;7090;21275;6106;19671;991;3515;3814;12302;4805;15817
353120;201712;528;1511;359;1134;63;225;120;330;183;555
353130;201712;2317;6340;1650;5285;498;1717;492;1549;990;3266
353140;201712;2100;5645;1635;4768;223;719;900;2483;1123;3202
353150;201712;1470;4158;1112;3525;297;951;350;1075;647;2026
353160;201712;626;1692;418;1312;71;235;156;445;227;680
353170;201712;483;1475;410;1372;82;349;195;597;277;946
353180;201712;9014;24026;7186;21075;1061;3383;4582;13220;5643;16603
353190;201712;3408;9850;2732;8411;370;1241;1530;4393;1900;5634
353200;201712;1065;3426;743;2554;168;631;196;625;364;1256
353205;201712;332;1106;293;1006;74;296;144;476;218;772
353210;201712;954;2384;613;1764;36;130;374;1037;410;1167
353215;201712;418;1240;343;1081;53;192;132;341;185;533
353220;201712;577;1693;430;1397;112;373;92;286;204;659
353230;201712;788;2391;676;2210;165;591;245;708;410;1299
353240;201712;2070;6247;1747;5623;231;870;1069;3318;1300;4188
353250;201712;1055;2691;734;2096;123;366;323;898;446;1264
353260;201712;891;2407;559;1758;121;410;155;452;276;862
353270;201712;604;1739;502;1525;70;210;233;679;303;889
353280;201712;661;1955;468;1518;86;288;137;428;223;716
353282;201712;1777;5393;1580;4997;219;756;911;2779;1130;3535
353284;201712;396;1016;208;630;37;131;64;170;101;301
353286;201712;127;379;91;305;24;80;22;59;46;139
353290;201712;1082;3099;798;2545;82;333;461;1342;543;1675
353300;201712;1509;4446;1160;3706;199;711;466;1344;665;2055
353310;201712;285;768;202;620;34;119;96;274;130;393
353320;201712;570;1589;472;1397;34;102;317;922;351;1024
353325;201712;595;1862;417;1449;76;272;125;432;201;704
353330;201712;525;1437;350;1052;42;146;190;532;232;678
353340;201712;2920;8157;1961;6371;543;1892;599;1940;1142;3832
353350;201712;3148;9195;2181;7034;549;1892;417;1209;966;3101
353360;201712;463;1501;402;1373;56;220;241;805;297;1025
353370;201712;572;1873;492;1704;47;180;296;992;343;1172
353380;201712;283;921;230;798;42;157;83;277;125;434
353390;201712;5525;14720;4023;12005;779;2444;1571;4467;2350;6911
353400;201712;424;1280;338;1096;69;247;68;173;137;420
353410;201712;565;1617;461;1417;87;299;229;679;316;978
353420;201712;512;1403;296;906;70;212;34;89;104;301
353430;201712;2061;6452;1538;5283;417;1565;373;1201;790;2766
353440;201712;55545;165798;41204;135816;9766;33529;16906;54022;26672;87551
353450;201712;384;1054;259;797;42;152;103;290;145;442
353460;201712;3310;9311;2416;7514;274;975;1074;3344;1348;4319
353470;201712;6733;19378;4906;15778;1062;3699;1512;4568;2574;8267
353475;201712;1365;3783;1006;3012;146;481;396;1072;542;1553
353480;201712;1372;4061;1209;3747;90;295;870;2648;960;2943
353490;201712;923;2630;664;2071;144;452;261;778;405;1230
353500;201712;927;2388;752;2110;195;545;393;1118;588;1663
353510;201712;836;2623;607;2030;161;549;99;297;260;846
353520;201712;1109;3033;776;2429;96;338;361;1067;457;1405
353530;201712;2251;6344;1827;5518;246;848;976;2764;1222;3612
353540;201712;1891;5658;1594;5125;334;1133;782;2457;1116;3590
353550;201712;5671;15986;4561;13991;819;2733;2282;6643;3101;9376
353560;201712;2060;6439;1624;5672;547;2066;376;1251;923;3317
353570;201712;488;1428;350;1147;78;248;157;509;235;757
353580;201712;2165;6082;1756;5327;389;1239;873;2562;1262;3801
353590;201712;664;1929;423;1367;89;297;152;505;241;802
353600;201712;1642;4478;1385;3976;166;525;751;2056;917;2581
353610;201712;587;1970;447;1653;100;396;97;325;197;721
353620;201712;2333;7071;1793;5990;435;1548;451;1410;886;2958
353625;201712;485;1287;285;884;33;124;148;432;181;556
353630;201712;1235;4189;944;3445;191;734;183;616;374;1350
353640;201712;1344;3722;1028;3108;121;437;589;1735;710;2172
353650;201712;8654;24724;6465;20081;1040;3459;3139;9216;4179;12675
353657;201712;302;892;247;792;34;110;96;277;130;387
353660;201712;1032;2398;705;1869;132;406;351;821;483;1227
353670;201712;3306;10261;2745;9118;752;2732;1133;3551;1885;6283
353680;201712;692;2048;537;1792;132;476;221;706;353;1182
353690;201712;496;1299;219;699;26;81;30;84;56;165
353700;201712;1931;5681;1648;5124;238;805;949;2811;1187;3616
353710;201712;3450;7948;1741;5057;318;917;727;1957;1045;2874
353715;201712;535;1517;369;1181;24;96;102;290;126;386
353720;201712;1829;5412;1495;4903;277;1017;793;2486;1070;3503
353730;201712;4140;12089;3129;9926;564;1972;1289;3730;1853;5702
353740;201712;1740;4956;1251;4008;321;1120;323;968;644;2088
353750;201712;857;2792;598;2213;154;611;109;393;263;1004
353760;201712;11058;28299;8876;25248;1311;4171;5609;15651;6920;19822
353770;201712;657;2026;327;1155;70;266;35;76;105;342
353780;201712;4298;13704;3472;12008;998;3779;848;2763;1846;6542
353790;201712;2138;7077;1676;6099;484;2015;396;1303;880;3318
353800;201712;15931;46841;12533;40748;2726;9539;5359;17172;8085;26711
353810;201712;1024;3050;722;2413;132;514;259;823;391;1337
353820;201712;1500;4691;1197;3986;219;843;513;1630;732;2473
353830;201712;592;1590;459;1357;60;187;244;679;304;866
353850;201712;1650;4902;1322;4224;360;1140;425;1396;785;2536
353860;201712;2503;7737;2009;6663;537;1863;679;2189;1216;4052
353870;201712;26835;75530;18549;58734;3163;11055;7516;21696;10679;32751
353880;201712;2743;8256;2230;7284;262;961;1244;3991;1506;4952
353890;201712;2259;5444;1619;4434;200;629;976;2506;1176;3135
353900;201712;724;2189;538;1821;114;412;183;588;297;1000
353910;201712;1929;6463;1741;6151;238;850;1192;4338;1430;5188
353920;201712;2267;6531;1531;5007;340;1243;290;820;630;2063
353930;201712;4232;12257;2921;9806;763;2819;548;1694;1311;4513
353940;201712;1086;3435;791;2750;156;573;219;715;375;1288
353950;201712;2925;8916;2417;7840;481;1743;1181;3525;1662;5268
353960;201712;586;1767;405;1366;96;306;114;377;210;683
353970;201712;577;1581;463;1379;48;153;287;827;335;980
353980;201712;12911;36279;10497;32020;1784;5739;5886;17504;7670;23243
353990;201712;661;1776;441;1348;46;149;264;772;310;921
354000;201712;2194;5831;1323;4116;266;896;211;641;477;1537
354010;201712;344;993;266;837;38;123;160;486;198;609
354020;201712;3714;11290;3060;9859;805;2829;977;2848;1782;5677
354025;201712;773;2168;539;1728;120;399;149;493;269;892
354030;201712;468;1156;270;770;47;140;105;277;152;417
354040;201712;738;1906;476;1409;42;143;278;763;320;906
354050;201712;944;2898;684;2349;168;641;153;501;321;1142
354060;201712;4345;13078;2967;10016;798;2787;734;2304;1532;5091
354070;201712;2883;8980;2203;7521;543;2019;464;1394;1007;3413
354075;201712;2016;6751;1642;5990;295;1227;828;2948;1123;4175
354080;201712;1444;4234;954;3181;179;654;274;802;453;1456
354085;201712;385;854;327;784;5;25;230;518;235;543
354090;201712;1437;4129;1288;3838;138;471;891;2609;1029;3080
354100;201712;14524;45241;11319;39411;2779;10444;4512;15411;7291;25855
354105;201712;938;2617;804;2419;144;431;488;1483;632;1914
354110;201712;505;1384;388;1208;106;373;113;316;219;689
354120;201712;1621;4528;1123;3433;194;626;397;1100;591;1726
354130;201712;5644;15782;3893;12306;1284;4376;198;431;1482;4807
354140;201712;21463;53777;13808;40022;3013;9339;4441;11883;7454;21222
354150;201712;3400;8845;2535;7282;506;1556;1079;2973;1585;4529
354160;201712;3244;10180;2480;8459;737;2612;704;2350;1441;4962
354165;201712;526;1664;437;1485;95;386;216;686;311;1072
354170;201712;1360;4193;1092;3560;116;423;581;1780;697;2203
354180;201712;450;1365;348;1142;62;232;129;367;191;599
354190;201712;1423;4314;1110;3663;186;685;380;1240;566;1925
354200;201712;900;2488;721;2158;87;282;346;953;433;1235
354210;201712;644;1943;512;1698;60;241;292;890;352;1131
354220;201712;2956;8405;2331;7199;423;1387;1154;3457;1577;4844
354230;201712;692;1994;555;1780;75;300;295;859;370;1159
354240;201712;1291;4011;903;3129;175;659;216;658;391;1317
354250;201712;516;1389;329;1071;97;330;85;282;182;612
354260;201712;7553;21776;5996;19038;1533;5143;1928;6180;3461;11323
354270;201712;1088;3491;869;3039;170;633;318;1106;488;1739
354280;201712;691;1937;596;1780;98;369;346;945;444;1314
354290;201712;850;2927;744;2670;157;589;313;1109;470;1698
354300;201712;3712;11561;3328;10840;1053;3553;1156;3637;2209;7190
354310;201712;762;2339;613;2015;124;430;280;883;404;1313
354320;201712;820;2273;540;1722;114;414;187;550;301;964
354323;201712;484;1273;343;1000;39;110;138;376;177;486
354325;201712;1193;3804;876;3071;155;569;320;1066;475;1635
354330;201712;6291;17596;4880;14974;862;3108;2565;7219;3427;10327
354340;201712;23931;67536;17593;56562;4627;16147;6348;19594;10975;35741
354350;201712;1085;3056;907;2700;152;508;528;1442;680;1950
354360;201712;494;1470;289;1023;51;174;38;131;89;305
354370;201712;1030;3378;870;3049;122;491;470;1608;592;2099
354380;201712;776;2204;539;1763;127;486;99;268;226;754
354390;201712;13065;35232;8486;26695;1664;5585;2149;6389;3813;11974
354400;201712;1559;5280;1229;4461;229;897;398;1416;627;2313
354410;201712;4966;14792;4034;13023;977;3415;1626;5052;2603;8467
354420;201712;1370;3884;981;3042;151;496;503;1479;654;1975
354425;201712;2076;5774;1672;4997;429;1330;570;1750;999;3080
354430;201712;1416;4266;1156;3827;203;760;557;1758;760;2518
354440;201712;522;1499;347;1120;37;130;148;446;185;576
354450;201712;366;1026;211;688;32;116;46;132;78;248
354460;201712;942;2571;655;2003;112;368;275;826;387;1194
354470;201712;535;1354;379;1041;31;98;192;472;223;570
354480;201712;839;2150;629;1805;68;214;374;1025;442;1239
354490;201712;748;2410;591;2048;102;381;249;833;351;1214
354500;201712;2017;6139;1715;5679;573;2094;412;1337;985;3431
354510;201712;795;2190;677;1953;100;291;367;995;467;1286
354515;201712;263;828;205;709;40;165;84;284;124;449
354520;201712;6943;21196;4189;13900;714;2650;1977;6072;2691;8722
354530;201712;3485;11075;2825;9679;696;2526;1103;3742;1799;6268
354540;201712;1238;3566;911;2950;246;841;252;828;498;1669
354550;201712;527;1443;394;1194;66;209;217;628;283;837
354560;201712;1814;4823;1018;3095;138;434;481;1404;619;1838
354570;201712;1105;3053;473;1491;96;342;65;184;161;526
354580;201712;10007;27429;6606;20912;1188;4094;2733;8149;3921;12243
354600;201712;1613;4871;1289;4256;220;795;677;2152;897;2947
354610;201712;364;1006;200;629;39;135;62;179;101;314
354620;201712;434;1306;305;1060;57;242;111;326;168;568
354625;201712;311;936;188;658;28;106;45;132;73;238
354630;201712;1982;6310;1659;5627;683;2466;166;539;849;3005
354640;201712;2996;9517;2214;7729;459;1765;477;1509;936;3274
354650;201712;863;2447;717;2170;93;288;447;1386;540;1674
354660;201712;2445;6492;1703;5259;120;451;1169;3555;1289;4006
354670;201712;1004;2981;718;2307;164;578;203;582;367;1160
354680;201712;4361;13092;3754;12039;985;3311;1816;5815;2801;9126
354690;201712;699;2217;469;1675;105;397;103;349;208;746
354700;201712;1036;2864;713;2179;139;470;298;797;437;1267
354710;201712;508;1491;368;1180;41;145;169;491;210;636
354720;201712;260;684;136;420;39;120;22;65;61;185
354730;201712;9238;27393;6809;22702;1168;4280;3444;10988;4612;15268
354740;201712;323;913;127;456;17;77;22;77;39;154
354750;201712;2470;7007;1690;5535;328;1233;661;2007;989;3240
354760;201712;1784;5393;1333;4472;423;1514;214;727;637;2241
354765;201712;308;846;144;472;19;69;32;97;51;166
354770;201712;2154;5773;1546;4673;416;1359;509;1482;925;2841
354780;201712;53637;143758;42841;122184;6559;20827;23283;62254;29842;83081
354790;201712;853;2629;708;2349;102;356;372;1205;474;1561
354800;201712;2417;6758;1959;6034;400;1352;943;2791;1343;4143
354805;201712;961;2765;709;2231;83;287;263;734;346;1021
354810;201712;569;1763;341;1245;62;247;80;267;142;514
354820;201712;895;2876;698;2472;135;532;162;505;297;1037
354830;201712;452;1169;313;912;106;307;107;307;213;614
354840;201712;740;2118;482;1512;80;247;224;675;304;922
354850;201712;18743;53804;13381;43314;2279;8490;6788;20382;9067;28872
354860;201712;1335;4026;1010;3402;216;810;324;979;540;1789
354870;201712;44598;121522;36295;106180;6450;20545;18861;52936;25311;73481
354880;201712;4876;12785;2402;7375;347;1224;820;2079;1167;3303
354890;201712;14809;41026;12152;36351;2150;7007;6175;17817;8325;24824
354900;201712;448;1275;283;924;33;111;79;250;112;361
354910;201712;5590;15820;3095;10691;641;2404;238;777;879;3181
354920;201712;329;933;184;614;27;116;28;72;55;188
354925;201712;262;788;133;472;29;104;27;85;56;189
354930;201712;337;863;198;618;29;96;89;263;118;359
354940;201712;1635;5617;1307;4792;453;1772;133;443;586;2215
354950;201712;1429;4230;1160;3792;109;468;717;2218;826;2686
354960;201712;775;2232;618;1985;126;447;271;843;397;1290
354970;201712;3701;11560;3085;10348;506;1895;1735;5613;2241;7508
354980;201712;26164;67710;17804;52434;2591;8879;8581;23284;11172;32163
354990;201712;56455;154397;42331;127976;5864;19412;22556;65413;28420;84825
354995;201712;2097;5689;1588;4935;328;1108;842;2523;1170;3631
355000;201712;1396;4148;1152;3720;260;957;256;703;516;1660
355010;201712;3078;9326;2184;7191;757;2653;225;749;982;3402
355020;201712;3024;9396;2257;7839;767;2953;604;1991;1371;4944
355030;201712;1196509;3084397;935346;2589958;183540;554075;431265;1120626;614805;1674701
355040;201712;2674;7738;2277;7105;387;1228;1415;4429;1802;5657
355050;201712;995;2823;758;2382;227;709;169;494;396;1203
355060;201712;4644;14060;3586;11917;702;2647;1518;4554;2220;7201
355070;201712;7184;20589;5883;18352;914;3298;3261;9493;4175;12791
355080;201712;847;2754;564;2108;104;443;45;141;149;584
355090;201712;1107;3501;883;3041;193;675;282;991;475;1666
355100;201712;17948;52187;14610;46797;3139;10833;8011;25069;11150;35902
355110;201712;1052;3177;811;2750;313;1140;150;500;463;1640
355120;201712;605;1796;456;1518;81;312;174;547;255;859
355130;201712;601;1471;268;759;35;102;99;253;134;355
355140;201712;1201;3594;1102;3421;168;594;749;2291;917;2885
355150;201712;3707;10558;2973;9247;539;1795;1415;4354;1954;6149
355160;201712;1715;5145;1323;4430;367;1370;319;1023;686;2393
355170;201712;8556;23369;6592;20213;1972;6360;2445;7558;4417;13918
355180;201712;2682;7987;2019;6757;461;1827;649;1946;1110;3773
355190;201712;1541;4550;1272;4049;361;1264;506;1677;867;2941
355200;201712;782;2609;675;2406;291;1121;152;495;443;1616
355210;201712;2855;8359;2467;7576;276;996;1608;4698;1884;5694
355220;201712;39296;112829;31501;97433;9240;30314;9991;28267;19231;58581
355230;201712;1246;3252;707;2141;144;424;167;486;311;910
355240;201712;22630;62756;15439;48227;3151;10283;5861;18029;9012;28312
355250;201712;31971;92333;24786;79153;6703;22764;8361;26048;15064;48812
355255;201712;822;2187;442;1389;80;243;143;457;223;700
355260;201712;1179;3291;893;2802;139;535;515;1499;654;2034
355270;201712;1484;4605;1165;3859;280;985;408;1270;688;2255
355280;201712;26223;73059;19828;60650;3636;11964;8403;24503;12039;36467
355290;201712;793;2464;601;1993;150;471;175;545;325;1016
355300;201712;1265;3917;1031;3417;220;761;318;1043;538;1804
355310;201712;1003;2907;768;2498;95;348;400;1301;495;1649
355320;201712;530;1515;427;1316;86;317;167;432;253;749
355330;201712;1950;5639;1441;4679;222;793;789;2444;1011;3237
355340;201712;2945;7079;2537;6489;296;788;1752;4412;2048;5200
355350;201712;1305;4180;977;3445;217;834;292;1010;509;1844
355360;201712;1182;3439;1032;3113;108;329;739;2282;847;2611
355365;201712;357;999;188;654;39;120;25;87;64;207
355370;201712;6107;15786;4760;13945;1111;3390;2114;6623;3225;10013
355380;201712;2966;8536;2262;7061;454;1516;619;1674;1073;3190
355385;201712;1128;3430;987;3169;207;737;439;1310;646;2047
355390;201712;740;2139;566;1779;116;382;209;598;325;980
355395;201712;1903;5681;1386;4495;221;762;564;1702;785;2464
355400;201712;8637;27520;7252;24591;2204;8105;1925;6042;4129;14147
355410;201712;20594;60451;14645;48946;3850;14067;2932;9831;6782;23898
355420;201712;691;2429;603;2236;156;677;135;508;291;1185
355430;201712;3600;9577;2843;8257;653;1931;1299;3767;1952;5698
355440;201712;826;2394;571;1838;118;397;161;481;279;878
355450;201712;3607;10079;2223;7132;446;1498;708;2100;1154;3598
355460;201712;551;1447;349;1080;55;203;143;379;198;582
355465;201712;364;1106;265;875;58;204;61;182;119;386
355470;201712;1126;3076;616;1987;172;572;175;543;347;1115
355475;201712;232;631;214;592;19;63;165;442;184;505
355480;201712;3332;10512;2865;9675;536;2065;1598;5195;2134;7260
355490;201712;939;2676;534;1764;77;270;170;540;247;810
355495;201712;769;2391;604;2058;110;409;172;553;282;962
355500;201712;6549;18582;4058;13098;676;2350;958;2884;1634;5234
355510;201712;1692;4317;847;2675;125;436;244;675;369;1111
355520;201712;407;936;199;543;21;63;103;260;124;323
355530;201712;457;1039;161;463;18;60;50;110;68;170
355535;201712;561;1628;434;1400;123;456;140;396;263;852
355540;201712;8253;24145;7202;22493;1451;4853;4144;12597;5595;17450
355550;201712;676;2072;533;1774;74;243;224;757;298;1000
355560;201712;1073;3138;590;2019;116;417;31;100;147;517
355570;201712;236;702;122;417;22;80;19;66;41;146
355580;201712;1192;3149;796;2432;113;424;371;1084;484;1508
355590;201712;191;511;145;435;22;75;78;227;100;302
355600;201712;1425;3856;998;3030;245;816;350;987;595;1803
355610;201712;1622;4392;1160;3491;179;575;539;1547;718;2122
355620;201712;4439;13132;3445;10958;488;1812;1711;4972;2199;6784
355630;201712;2235;6556;1576;5263;352;1219;557;1874;909;3093
355635;201712;914;2822;761;2557;94;330;490;1698;584;2028
355640;201712;2694;8294;1875;6621;455;1703;351;1234;806;2937
355645;201712;3960;12268;3276;11135;408;1654;2023;6753;2431;8407
355650;201712;6700;19258;5656;17314;1317;4398;3028;8664;4345;13062
355660;201712;1255;3657;931;2999;135;544;383;1191;518;1735
355670;201712;3211;9582;2206;7167;380;1421;947;2703;1327;4124
355680;201712;2478;7363;1150;3996;324;1221;95;275;419;1496
355690;201712;569;1808;379;1392;109;432;13;28;122;460
355695;201712;234;766;133;479;11;44;16;47;27;91
355700;201712;5814;18165;4883;16036;1244;4157;1957;6231;3201;10388
355710;201712;8589;21104;5233;14956;1020;3093;1689;4439;2709;7532
355715;201712;383;1139;235;782;56;207;52;159;108;366
355720;201712;1438;4561;1169;3984;244;879;463;1432;707;2311
355730;201712;828;2581;688;2272;188;618;213;660;401;1278
410010;201712;1292;3805;1008;3170;233;808;200;615;433;1423
410020;201712;1081;3483;913;3095;293;979;281;945;574;1924
410030;201712;1269;4005;1064;3570;240;875;397;1323;637;2198
410040;201712;10172;31336;8409;28017;1845;6720;2760;8889;4605;15609
410045;201712;1013;2762;688;2144;108;384;207;591;315;975
410050;201712;2624;6829;1622;4961;400;1315;246;650;646;1965
410060;201712;2113;6360;1728;5556;412;1376;610;1938;1022;3314
410070;201712;1635;4477;1216;3647;270;891;398;1132;668;2023
410080;201712;1350;3729;1018;3125;179;595;413;1242;592;1837
410090;201712;968;2853;899;2718;129;399;471;1494;600;1893
410100;201712;2273;6926;1629;5333;257;974;269;841;526;1815
410105;201712;354;1065;219;731;47;191;44;126;91;317
410110;201712;3051;8403;2211;6681;327;1064;787;2312;1114;3376
410115;201712;510;1342;372;1088;76;246;127;345;203;591
410120;201712;2409;7929;2156;7458;853;3084;500;1712;1353;4796
410130;201712;1061;3126;966;2948;339;1164;298;774;637;1938
410140;201712;15395;39421;9717;29052;2033;6602;2040;5688;4073;12290
410150;201712;16136;40298;7798;22955;1517;4776;1274;3596;2791;8372
410160;201712;2877;8480;2463;7712;532;1840;926;2963;1458;4803
410165;201712;645;1871;535;1617;71;236;300;852;371;1088
410170;201712;2166;6045;1600;4782;460;1499;178;507;638;2006
410180;201712;12001;36221;9815;31314;1824;6239;4504;13408;6328;19647
410185;201712;509;1424;369;1154;70;226;106;306;176;532
410190;201712;1959;5473;1524;4601;340;1085;313;893;653;1978
410200;201712;3943;10319;2535;7633;538;1857;479;1417;1017;3274
410210;201712;2536;7238;1734;5474;293;1043;442;1174;735;2217
410220;201712;605;1600;417;1235;52;177;110;333;162;510
410230;201712;1409;4225;1199;3795;246;884;536;1590;782;2474
410240;201712;4162;12110;3501;10796;1054;3624;449;1352;1503;4976
410250;201712;2625;6884;1820;5364;394;1289;510;1432;904;2721
410260;201712;1644;4410;1157;3541;229;787;510;1519;739;2306
410270;201712;504;1356;385;1128;33;115;194;554;227;669
410275;201712;736;2207;483;1610;66;240;199;649;265;889
410280;201712;2067;5890;1400;4486;308;1087;402;1174;710;2261
410290;201712;3233;9576;2481;8000;575;1837;900;2931;1475;4768
410300;201712;675;1796;531;1520;90;281;228;599;318;880
410302;201712;420;1101;216;695;22;70;107;348;129;418
410304;201712;1133;3414;986;3094;201;678;482;1504;683;2182
410305;201712;1692;4432;1259;3718;319;968;547;1616;866;2584
410310;201712;2295;7036;1937;6379;418;1512;614;2024;1032;3536
410315;201712;787;2094;425;1424;102;353;100;326;202;679
410320;201712;1130;3322;729;2406;101;377;110;338;211;715
410322;201712;527;1501;279;903;28;92;90;283;118;375
410330;201712;1384;3693;1049;3037;229;725;265;749;494;1474
410335;201712;857;2460;703;2150;116;416;308;860;424;1276
410337;201712;751;1949;531;1528;66;202;212;571;278;773
410340;201712;503;1405;337;993;46;161;142;351;188;512
410345;201712;2007;5481;1177;3698;263;855;284;841;547;1696
410347;201712;705;1809;506;1454;55;188;154;419;209;607
410350;201712;1167;3373;876;2788;131;465;266;767;397;1232
410360;201712;3940;10138;3061;8627;281;931;1848;5052;2129;5983
410370;201712;11014;30911;7676;23341;1211;4133;2640;7062;3851;11195
410380;201712;1320;3696;1085;3221;131;479;420;1160;551;1639
410390;201712;2474;7049;1699;5429;488;1684;325;926;813;2610
410395;201712;893;2765;723;2389;156;572;324;1080;480;1652
410400;201712;4627;13709;3657;11680;698;2401;1366;4191;2064;6592
410405;201712;793;2118;643;1874;143;445;285;814;428;1259
410410;201712;1116;3341;1087;3303;220;833;620;1851;840;2684
410420;201712;6877;21477;5397;18191;1184;4401;1145;3498;2329;7899
410425;201712;2710;8237;1989;6742;379;1377;533;1695;912;3072
410430;201712;12653;33314;8942;26418;1592;5124;2734;7628;4326;12752
410440;201712;2887;9694;2554;9041;450;1660;1328;4919;1778;6579
410442;201712;2371;7708;2076;7065;631;2285;618;2057;1249;4342
410445;201712;2261;6970;1831;6108;427;1564;533;1821;960;3385
410450;201712;1737;4853;1305;3967;258;857;261;675;519;1532
410460;201712;1641;4566;1273;3926;270;897;389;1132;659;2029
410465;201712;2304;7254;1876;6319;447;1508;572;1872;1019;3380
410470;201712;1752;5416;1310;4411;326;1194;244;846;570;2040
410480;201712;30065;81147;17412;55554;2765;9697;1680;4669;4445;14366
410490;201712;10845;32076;7875;25663;1669;5828;2350;7171;4019;12999
410500;201712;1558;4683;1182;3861;333;1212;197;543;530;1755
410510;201712;2211;5787;1449;4220;271;793;477;1355;748;2148
410520;201712;2959;9902;2715;9406;742;2634;1203;4224;1945;6858
410530;201712;1481;4029;797;2414;140;437;87;211;227;648
410540;201712;2661;7662;1895;6077;319;1080;813;2589;1132;3669
410550;201712;6268;17551;4142;12896;828;2827;735;2025;1563;4852
410560;201712;1304;3667;1016;3109;237;804;393;1087;630;1891
410570;201712;2557;7797;2079;6885;563;2081;329;1158;892;3239
410580;201712;22188;62693;17323;53333;3685;12635;6604;18822;10289;31457
410590;201712;1378;4190;913;2972;162;557;201;585;363;1142
410600;201712;1711;4918;1346;4189;321;993;446;1422;767;2415
410610;201712;738;2075;546;1697;63;215;189;553;252;768
410620;201712;1855;5935;1239;4411;294;1125;126;379;420;1504
410630;201712;2241;6555;1458;4765;292;1055;144;366;436;1421
410640;201712;4016;10439;2792;8270;745;2493;415;1169;1160;3662
410645;201712;1095;3581;984;3399;407;1442;257;945;664;2387
410650;201712;1954;5799;1474;4777;401;1400;361;1056;762;2456
410655;201712;1355;4474;1101;3974;55;199;743;2870;798;3069
410657;201712;695;1861;443;1340;86;273;168;456;254;729
410660;201712;3011;8236;1621;5107;332;1076;233;715;565;1791
410670;201712;889;2327;592;1725;102;302;271;761;373;1063
410680;201712;2873;9033;2113;7138;552;1815;478;1719;1030;3534
410685;201712;581;1635;483;1451;80;273;255;728;335;1001
410690;201712;115911;314918;78094;238908;14405;49064;22448;60257;36853;109321
410700;201712;2151;6005;1851;5476;395;1244;847;2374;1242;3618
410710;201712;872;2493;589;1915;90;302;242;751;332;1053
410712;201712;702;2072;607;1899;186;632;220;642;406;1274
410715;201712;838;2681;569;2015;114;417;150;513;264;930
410720;201712;2828;8113;2198;6777;353;1271;416;1161;769;2432
410725;201712;1049;2841;676;2109;117;398;103;285;220;683
410730;201712;538;1482;390;1207;99;349;65;190;164;539
410740;201712;912;2653;640;2108;118;425;251;826;369;1251
410750;201712;1719;4788;1397;4146;274;897;508;1429;782;2326
410752;201712;312;813;144;443;23;79;47;123;70;202
410753;201712;252;754;168;564;19;65;29;85;48;150
410754;201712;1085;3022;923;2762;53;132;605;1984;658;2116
410755;201712;714;1786;506;1418;46;144;279;738;325;882
410760;201712;2701;7716;2196;6801;611;2031;604;1868;1215;3899
410765;201712;12687;37857;9804;32141;1656;6050;1126;3531;2782;9581
410770;201712;913;2405;631;1887;111;358;220;643;331;1001
410773;201712;1281;3597;1146;3399;164;562;833;2421;997;2983
410775;201712;1393;3845;1234;3586;219;698;486;1375;705;2073
410780;201712;589;1541;352;1051;76;232;82;264;158;496
410785;201712;754;2243;617;1968;159;553;186;558;345;1111
410790;201712;536;1667;440;1442;130;455;37;94;167;549
410800;201712;2856;6779;2255;5852;207;603;1054;2682;1261;3285
410810;201712;322;935;257;807;41;154;107;317;148;471
410820;201712;794;2392;502;1600;114;375;73;219;187;594
410830;201712;28243;76579;21419;64590;5686;19033;6803;19518;12489;38551
410832;201712;1000;2741;845;2447;111;412;470;1264;581;1676
410840;201712;6908;19104;4306;13803;1020;3627;498;1239;1518;4866
410845;201712;1121;3238;924;2865;199;674;303;901;502;1575
410850;201712;2443;7299;2135;6746;463;1611;834;2640;1297;4251
410855;201712;587;1595;428;1271;44;149;188;519;232;668
410860;201712;3886;10605;3017;8938;539;1690;985;2827;1524;4517
410865;201712;1393;4507;1260;4227;280;1000;692;2398;972;3398
410870;201712;1207;3462;1058;3235;102;320;712;2199;814;2519
410880;201712;3864;11550;2976;9787;557;2023;425;1461;982;3484
410890;201712;895;2790;681;2325;152;559;162;533;314;1092
410895;201712;935;3133;807;2839;313;1195;132;430;445;1625
410900;201712;860;2353;577;1774;95;316;154;397;249;713
410910;201712;365;907;223;621;13;37;117;307;130;344
410920;201712;750;2034;592;1765;134;453;225;650;359;1103
410930;201712;1481;4336;1195;3738;335;1203;270;802;605;2005
410940;201712;20609;62515;16371;54368;4747;17038;3120;10591;7867;27629
410950;201712;1844;5743;1683;5486;83;333;1378;4432;1461;4765
410960;201712;7519;20189;4708;14948;1248;4389;1279;3935;2527;8324
410965;201712;1001;2875;764;2384;149;491;327;970;476;1461
410970;201712;3976;11301;2923;9259;734;2732;436;1230;1170;3962
410975;201712;1363;3801;1054;3198;206;734;357;1058;563;1792
410980;201712;6542;17779;4321;13460;642;2172;1595;4769;2237;6941
410990;201712;1068;2982;700;2231;213;762;145;388;358;1150
411000;201712;456;1341;326;1069;43;158;75;205;118;363
411005;201712;447;1278;280;902;61;199;44;132;105;331
411007;201712;2182;6673;1885;6097;482;1682;577;1843;1059;3525
411010;201712;4074;13035;3427;11630;983;3550;356;1120;1339;4670
411020;201712;2339;6982;1978;6339;610;2072;569;1766;1179;3838
411030;201712;675;1796;444;1258;85;252;136;347;221;599
411040;201712;739;2047;327;1027;58;194;56;155;114;349
411050;201712;1858;6221;1595;5607;475;1790;239;740;714;2530
411060;201712;1563;4462;1096;3479;224;841;199;552;423;1393
411065;201712;328;936;246;776;43;135;103;324;146;459
411070;201712;6231;17530;4898;15005;1073;3620;1632;4737;2705;8357
411080;201712;1988;5689;1702;5175;480;1555;405;1256;885;2811
411090;201712;797;2106;532;1613;43;141;95;262;138;403
411095;201712;1421;3645;1019;2945;149;482;373;1021;522;1503
411100;201712;1143;3245;815;2577;110;429;213;668;323;1097
411110;201712;561;1585;258;875;28;89;16;39;44;128
411120;201712;1403;4173;1068;3450;347;1283;198;535;545;1818
411125;201712;4468;13907;4155;13327;1030;3416;1819;5994;2849;9410
411130;201712;660;1870;470;1455;95;293;159;528;254;821
411140;201712;2206;7133;1844;6304;431;1535;741;2583;1172;4118
411150;201712;3779;10356;2721;8239;581;1975;229;566;810;2541
411155;201712;953;2552;617;1909;72;234;265;766;337;1000
411160;201712;294;772;210;620;31;88;52;156;83;244
411170;201712;734;2247;567;1859;131;448;169;552;300;1000
411180;201712;5302;15101;4178;12975;827;2822;1574;4754;2401;7576
411190;201712;1311;3653;1023;3074;239;774;271;722;510;1496
411200;201712;4352;12458;3325;10563;897;3047;915;2830;1812;5877
411210;201712;1989;5282;1548;4547;456;1501;166;435;622;1936
411220;201712;853;2365;674;2012;155;505;228;648;383;1153
411230;201712;1070;2955;692;2212;148;503;186;591;334;1094
411240;201712;1592;3758;905;2591;121;364;407;1118;528;1482
411250;201712;1937;5563;1542;4837;365;1303;475;1464;840;2767
411260;201712;347;892;215;643;34;106;85;231;119;337
411270;201712;1773;5255;1469;4640;250;881;665;2044;915;2925
411275;201712;1274;3454;943;2784;192;624;295;801;487;1425
411280;201712;1435;4053;901;2875;167;588;141;388;308;976
411290;201712;708;2012;508;1618;85;278;201;643;286;921
411295;201712;1046;2725;868;2395;133;404;356;942;489;1346
411300;201712;1114;2814;724;2078;70;212;260;668;330;880
411310;201712;850;2181;658;1878;49;151;246;693;295;844
411320;201712;5104;14427;3695;11729;878;2869;892;2634;1770;5503
411325;201712;1511;4573;1322;4195;248;812;675;2191;923;3003
411330;201712;3115;9232;2416;7829;648;2279;593;1956;1241;4235
411340;201712;765;2219;490;1557;60;239;214;644;274;883
411342;201712;733;1915;539;1543;123;371;208;565;331;936
411345;201712;978;2814;811;2496;128;460;468;1428;596;1888
411350;201712;2585;7472;1861;5988;492;1753;171;555;663;2308
411360;201712;610;1534;424;1238;54;183;148;392;202;575
411370;201712;44985;119938;34085;100531;4005;13759;17547;48298;21552;62057
411373;201712;1332;3743;1096;3349;154;507;471;1455;625;1962
411375;201712;1042;2800;770;2293;137;442;256;699;393;1141
411380;201712;1004;2635;663;1871;85;281;287;714;372;995
411390;201712;1693;4951;1343;4103;242;796;438;1213;680;2009
411400;201712;2071;5582;1657;4759;306;1013;632;1718;938;2731
411410;201712;2012;5926;1510;4840;357;1253;321;907;678;2160
411420;201712;3904;10397;2385;7327;375;1312;379;914;754;2226
411430;201712;3164;9203;2608;8242;578;1938;1105;3384;1683;5322
411435;201712;456;1370;328;1095;69;217;124;394;193;611
411440;201712;2572;7987;2177;7158;540;1873;589;2021;1129;3894
411450;201712;2588;7189;2031;6254;350;1083;1052;3315;1402;4398
411460;201712;3717;10407;2047;6750;348;1351;286;848;634;2199
411470;201712;739;2160;498;1613;87;310;91;274;178;584
411480;201712;4227;12397;2986;9897;595;2146;594;1872;1189;4018
411490;201712;1452;4152;1140;3573;200;735;344;940;544;1675
411500;201712;1600;4236;1106;3345;173;610;331;969;504;1579
411510;201712;1945;5584;1611;4907;414;1400;331;1006;745;2406
411520;201712;24815;64752;14452;43796;2279;7635;3920;10574;6199;18209
411530;201712;912;2511;600;1910;119;420;180;528;299;948
411535;201712;462;1388;207;741;19;76;22;59;41;135
411540;201712;2883;7599;2077;5949;439;1380;613;1613;1052;2993
411545;201712;994;3058;847;2765;92;315;533;1768;625;2083
411550;201712;685;1830;535;1571;104;342;92;253;196;595
411560;201712;1980;5673;1279;4143;193;725;78;181;271;906
411570;201712;7185;18098;5043;14681;1084;3573;1235;3567;2319;7140
411573;201712;809;2279;713;2120;75;236;434;1281;509;1517
411575;201712;1592;4724;1316;4175;313;1053;364;1151;677;2204
411580;201712;4035;10455;2353;7516;265;1034;314;915;579;1949
411585;201712;755;2339;358;1245;72;264;62;181;134;445
411590;201712;353;1021;277;877;37;131;126;359;163;490
411600;201712;287;810;197;649;42;154;71;231;113;385
411605;201712;1466;4002;982;2957;149;530;384;1087;533;1617
411610;201712;2144;5839;1564;4630;287;942;639;1821;926;2763
411620;201712;2786;8191;2442;7650;443;1535;1386;4292;1829;5827
411630;201712;534;1447;358;1114;80;289;64;157;144;446
411640;201712;468;1393;330;1050;45;141;109;338;154;479
411650;201712;191;571;134;450;25;87;19;69;44;156
411660;201712;873;2318;612;1820;45;139;313;903;358;1042
411670;201712;1099;2970;838;2414;140;407;292;809;432;1216
411680;201712;1529;4364;1247;3839;190;668;613;1870;803;2538
411690;201712;3262;9220;2451;7694;496;1639;673;2186;1169;3825
411695;201712;658;2085;493;1681;75;283;155;546;230;829
411700;201712;1486;4180;1011;3226;224;786;139;391;363;1177
411705;201712;1627;5651;1452;5292;320;1133;786;3023;1106;4156
411710;201712;1707;4736;1290;3928;361;1160;180;557;541;1717
411720;201712;898;2433;696;2024;99;311;241;654;340;965
411721;201712;817;2302;634;1906;134;422;124;372;258;794
411722;201712;637;1828;394;1278;71;276;134;356;205;632
411725;201712;1281;3977;808;2822;193;710;152;535;345;1245
411727;201712;1557;4590;1079;3540;306;1027;141;426;447;1453
411729;201712;647;1668;431;1249;95;290;112;277;207;567
411730;201712;4842;13934;3917;12036;1171;3733;1125;3414;2296;7147
411740;201712;578;1613;320;1025;60;216;57;154;117;370
411745;201712;846;2473;610;1917;104;342;133;362;237;704
411750;201712;4849;13957;3655;11354;530;1813;1569;4647;2099;6460
411760;201712;7172;20342;5783;17812;2008;6539;1137;3687;3145;10226
411770;201712;3271;10245;2509;8462;699;2485;322;1046;1021;3531
411780;201712;2889;8550;2534;7884;650;2167;1035;3255;1685;5422
411790;201712;2964;8049;1828;5696;444;1527;285;815;729;2342
411800;201712;1043;3000;689;2177;93;314;117;352;210;666
411810;201712;1661;4523;1297;3821;238;768;581;1607;819;2375
411820;201712;11557;36346;9535;32176;3173;11144;2602;8849;5775;19993
411830;201712;563;1414;382;1105;97;317;46;147;143;464
411840;201712;10304;28567;7147;22069;1451;4912;1679;4980;3130;9892
411845;201712;441;1297;239;784;43;169;16;41;59;210
411850;201712;7315;20664;5635;17442;1647;5503;1006;2980;2653;8483
411860;201712;800;2388;612;1992;111;401;162;489;273;890
411870;201712;749;2366;503;1714;99;371;99;299;198;670
411880;201712;2080;5856;1528;4826;382;1329;248;758;630;2087
411885;201712;798;2141;621;1838;105;377;221;630;326;1007
411890;201712;1142;3331;766;2493;118;423;51;136;169;559
411900;201712;861;2631;535;1808;136;469;53;184;189;653
411910;201712;1081;3430;799;2782;225;819;200;674;425;1493
411915;201712;16536;42894;10175;30727;1923;6318;2537;6946;4460;13264
411920;201712;906;2942;771;2616;221;827;132;418;353;1245
411925;201712;587;1598;387;1215;94;306;93;280;187;586
411930;201712;5420;17742;4709;16328;2235;8448;307;1111;2542;9559
411940;201712;3087;9954;2516;8608;626;2196;543;1729;1169;3925
411950;201712;12471;37044;10375;33255;2218;7638;4776;14954;6994;22592
411960;201712;5408;15408;4682;14038;953;3120;1785;5112;2738;8232
411965;201712;497;1366;346;1102;68;250;91;286;159;536
411970;201712;840;2201;690;1983;130;342;373;1198;503;1540
411980;201712;1471;4164;1210;3663;315;999;363;1071;678;2070
411990;201712;33881;99339;24201;79236;5400;19510;7212;22435;12612;41945
411995;201712;2583;7152;2053;6281;572;1964;597;1688;1169;3652
412000;201712;2173;5146;1587;4166;136;437;930;2246;1066;2683
412010;201712;670;2189;485;1728;68;283;106;326;174;609
412015;201712;595;1734;493;1535;80;251;242;768;322;1019
412020;201712;425;1236;264;863;45;162;97;288;142;450
412030;201712;705;2096;496;1666;78;288;176;566;254;854
412033;201712;899;2604;635;2017;84;271;228;755;312;1026
412035;201712;876;2345;551;1764;86;308;241;748;327;1056
412040;201712;587;1688;408;1309;73;239;71;217;144;456
412050;201712;1642;4536;1211;3697;229;786;301;917;530;1703
412060;201712;7064;22985;6159;21093;1889;6987;1407;4662;3296;11649
412065;201712;689;2020;517;1671;102;360;154;474;256;834
412070;201712;1228;3209;904;2557;131;399;386;1088;517;1487
412080;201712;1601;4827;988;3372;135;521;48;137;183;658
412085;201712;329;921;108;372;11;41;11;31;22;72
412090;201712;5079;14134;4393;12921;1111;3311;2045;6206;3156;9517
412100;201712;1726;5194;1387;4523;428;1513;266;869;694;2382
412110;201712;916;2534;632;1922;132;438;144;438;276;876
412120;201712;1696;5507;1408;4854;337;1260;387;1130;724;2390
412125;201712;619;1941;516;1701;117;407;159;503;276;910
412130;201712;609;1754;443;1381;75;257;100;329;175;586
412135;201712;564;1596;280;869;49;147;84;246;133;393
412140;201712;1554;4250;1101;3372;235;803;175;489;410;1292
412150;201712;2972;8170;2494;7250;289;977;1566;4405;1855;5382
412160;201712;1063;3413;660;2343;164;633;80;271;244;904
412170;201712;4295;12768;3579;11404;832;2871;1442;4317;2274;7188
412175;201712;1348;4270;1139;3855;252;857;449;1526;701;2383
412180;201712;1654;4790;1243;4023;225;860;493;1423;718;2283
412190;201712;3238;8737;2423;7230;379;1216;918;2854;1297;4070
412200;201712;1937;6025;1388;4629;332;1174;277;916;609;2090
412210;201712;633;1687;365;1126;70;263;70;174;140;437
412215;201712;3841;10704;3251;9567;878;2616;1360;4391;2238;7007
412217;201712;1043;2879;901;2625;79;275;615;1710;694;1985
412220;201712;5517;16598;4847;15326;1173;3662;1952;6559;3125;10221
412230;201712;2746;8718;2265;7679;422;1600;627;1938;1049;3538
412240;201712;7456;19366;4644;14078;881;2972;1101;3127;1982;6099
412250;201712;1925;5369;1503;4505;381;1200;237;636;618;1836
412260;201712;1225;3416;846;2588;121;396;284;797;405;1193
412265;201712;888;2666;764;2417;190;638;289;910;479;1548
412270;201712;782;2386;538;1799;86;324;194;610;280;934
412280;201712;543;1651;420;1407;121;425;78;248;199;673
412290;201712;1018;2735;701;2137;119;411;219;618;338;1029
412300;201712;1541;4541;1278;4017;334;1133;276;822;610;1955
412310;201712;816;2398;673;2144;80;347;332;1044;412;1391
412320;201712;815;2186;577;1713;89;340;182;525;271;865
412330;201712;1423;3979;1009;3131;189;610;378;1153;567;1763
412340;201712;960;2857;607;1991;94;326;133;404;227;730
412350;201712;2577;7297;1691;5417;326;1160;164;462;490;1622
412360;201712;256;744;162;524;23;84;55;162;78;246
412370;201712;803;2409;597;2008;127;476;60;199;187;675
412380;201712;1538;4606;1147;3707;297;986;213;724;510;1710
412382;201712;598;1612;402;1216;68;216;106;275;174;491
412385;201712;2196;6485;1871;5798;685;2143;472;1564;1157;3707
412390;201712;2202;5912;1840;5323;387;1205;843;2457;1230;3662
412395;201712;735;2120;528;1685;60;198;261;802;321;1000
412400;201712;895;2652;682;2181;163;546;153;517;316;1063
412402;201712;1753;4800;1328;4037;306;1050;169;474;475;1524
412405;201712;3168;9048;1984;6442;369;1364;64;192;433;1556
412410;201712;5074;14545;3906;12376;930;3353;884;2650;1814;6003
412420;201712;425;1194;241;760;31;102;95;265;126;367
412430;201712;524;1430;352;1085;43;145;129;392;172;537
412440;201712;2822;8278;2001;6665;507;1857;375;1248;882;3105
412450;201712;285;917;210;725;27;88;14;36;41;124
412460;201712;803;2398;677;2140;145;485;213;644;358;1129
412470;201712;1767;5854;1423;4997;381;1400;292;1075;673;2475
412480;201712;997;2905;630;2009;113;395;84;202;197;597
412490;201712;965;2707;801;2377;149;424;315;900;464;1324
412500;201712;1830;5012;1441;4246;252;795;372;980;624;1775
412510;201712;2026;6463;1490;5080;392;1425;198;629;590;2054
412520;201712;1322;3737;914;2842;222;689;107;308;329;997
412530;201712;581;1661;447;1375;71;231;104;314;175;545
412535;201712;757;2143;531;1662;107;357;91;278;198;635
412540;201712;1222;3373;857;2581;125;466;243;736;368;1202
412545;201712;713;1942;475;1421;88;268;109;283;197;551
412550;201712;30223;87399;20729;66865;4344;14945;5646;16995;9990;31940
412555;201712;231;669;146;469;22;81;40;100;62;181
412560;201712;5090;15328;3777;12312;819;2944;796;2497;1615;5441
412570;201712;4002;11134;2546;8074;544;1873;349;1161;893;3034
412575;201712;920;2655;741;2243;101;343;328;925;429;1268
412580;201712;1328;3562;930;2783;155;514;370;1050;525;1564
412590;201712;481;1346;260;877;54;183;27;84;81;267
412600;201712;1366;4041;1009;3228;192;689;324;987;516;1676
412610;201712;719;2074;453;1423;91;289;163;481;254;770
412620;201712;1234;3623;946;3086;222;853;273;804;495;1657
412625;201712;8137;23309;5654;18264;938;3294;576;1966;1514;5260
412627;201712;940;2779;642;2127;180;661;171;549;351;1210
412630;201712;2964;9172;2215;7444;427;1402;665;2134;1092;3536
412635;201712;405;1145;279;863;54;176;43;106;97;282
412640;201712;987;2801;571;1832;87;301;111;319;198;620
412650;201712;1532;4493;1270;3984;236;857;419;1176;655;2033
412660;201712;2589;7133;1822;5559;323;1089;493;1374;816;2463
412665;201712;565;1448;315;972;64;212;91;256;155;468
412667;201712;1650;4587;1268;3801;213;734;474;1345;687;2079
412670;201712;543;1601;430;1387;101;364;128;404;229;768
412680;201712;1421;4125;878;2961;157;611;257;752;414;1363
412690;201712;781;2268;583;1845;122;389;134;419;256;808
412700;201712;1960;5438;1573;4826;343;1226;609;1797;952;3023
412710;201712;5990;18583;4946;16435;1040;3733;1362;4189;2402;7922
412720;201712;1299;3970;943;3092;161;571;188;520;349;1091
412730;201712;2085;6115;1181;3977;263;937;165;523;428;1460
412740;201712;1650;4938;1113;3713;211;778;143;511;354;1289
412750;201712;3965;11488;3460;10664;469;1690;2156;6458;2625;8148
412760;201712;2656;7764;2342;7240;353;1206;1381;4154;1734;5360
412770;201712;10243;27482;5535;17455;767;2528;1041;2941;1808;5469
412780;201712;1238;3658;1041;3277;200;687;425;1301;625;1988
412785;201712;2075;5624;1520;4561;363;1103;629;1868;992;2971
412788;201712;1329;4048;1110;3586;285;1005;412;1255;697;2260
412790;201712;1037;3026;677;2233;139;510;172;490;311;1000
412795;201712;1076;2977;653;2009;119;392;174;503;293;895
412796;201712;2347;7189;1989;6379;389;1320;707;2108;1096;3428
412800;201712;3162;8534;2213;6549;340;1137;830;2259;1170;3396
412810;201712;11110;29545;6453;19535;901;3120;1762;4491;2663;7611
412820;201712;6814;19545;4946;15789;1067;3622;1475;4725;2542;8347
412830;201712;322;950;235;766;35;126;51;160;86;286
412840;201712;1773;4922;1374;4113;219;697;401;1185;620;1882
412850;201712;2974;8342;2256;7025;404;1380;778;2297;1182;3677
412853;201712;1795;4958;1491;4278;151;487;790;2058;941;2545
412855;201712;1232;3537;888;2727;170;595;189;478;359;1073
412860;201712;982;2863;767;2408;170;568;263;788;433;1356
412862;201712;742;1822;466;1335;76;239;163;458;239;697
412863;201712;1152;3742;1116;3683;110;384;850;2783;960;3167
412865;201712;729;2095;526;1698;93;306;179;592;272;898
412870;201712;887;2495;686;2153;231;806;130;429;361;1235
412880;201712;864;2501;589;1880;114;407;86;246;200;653
420005;201712;455;1352;263;900;38;134;98;327;136;461
420010;201712;3544;9218;2377;7157;243;785;1599;4868;1842;5653
420020;201712;573;1840;341;1239;52;230;49;150;101;380
420030;201712;272;712;142;483;33;132;17;60;50;192
420040;201712;614;1931;335;1272;54;230;16;43;70;273
420050;201712;686;1817;431;1324;68;225;223;657;291;882
420055;201712;170;519;92;327;19;83;24;79;43;162
420060;201712;150;493;105;373;19;84;19;46;38;130
420070;201712;1070;3411;797;2748;170;622;270;944;440;1566
420075;201712;142;380;74;230;12;35;12;26;24;61
420080;201712;482;1470;372;1247;110;374;97;316;207;690
420090;201712;393;1364;271;1028;62;238;54;210;116;448
420100;201712;1117;3341;995;3165;110;372;716;2271;826;2643
420110;201712;274;906;251;854;75;267;77;240;152;507
420120;201712;297;946;222;764;58;243;72;205;130;448
420125;201712;304;1043;262;958;69;286;120;419;189;705
420127;201712;318;899;110;391;22;89;17;50;39;139
420130;201712;1847;5968;1385;4984;349;1390;368;1205;717;2595
420140;201712;3535;10288;2537;8395;641;2395;354;1067;995;3462
420150;201712;518;1382;333;1077;54;199;144;424;198;623
420160;201712;237;636;119;396;18;67;37;120;55;187
420165;201712;184;551;105;350;22;82;32;98;54;180
420170;201712;212;673;136;500;32;130;15;55;47;185
420180;201712;276;827;147;522;22;75;37;127;59;202
420190;201712;167;554;100;380;29;113;14;51;43;164
420195;201712;1246;3560;966;3065;260;931;153;458;413;1389
420200;201712;2732;7890;1564;5404;281;1152;393;1175;674;2327
420205;201712;1199;3614;906;3051;153;563;488;1656;641;2219
420207;201712;1467;4171;964;3151;235;874;260;790;495;1664
420208;201712;486;1295;260;904;47;194;111;402;158;596
420209;201712;191;614;119;435;31;120;42;147;73;267
420210;201712;2074;5839;1311;4544;299;1180;524;1731;823;2911
420213;201712;738;2538;683;2426;185;715;316;1118;501;1833
420215;201712;274;869;175;639;58;204;10;44;68;248
420220;201712;172;605;139;539;42;183;36;131;78;314
420230;201712;3659;10607;2736;8966;470;1805;1235;3862;1705;5667
420240;201712;10954;30170;7045;22487;962;3674;3516;10127;4478;13801
420243;201712;518;1522;398;1292;76;254;145;470;221;724
420245;201712;1249;3506;857;2752;97;382;443;1313;540;1695
420250;201712;455;1419;397;1299;89;315;178;559;267;874
420253;201712;498;1306;367;1111;31;86;200;609;231;695
420257;201712;251;679;145;480;29;98;62;207;91;305
420260;201712;1054;3237;809;2806;146;570;376;1284;522;1854
420270;201712;557;1542;240;767;24;88;78;224;102;312
420280;201712;1674;4527;980;3242;184;664;260;828;444;1492
420285;201712;106;290;49;182;10;38;4;8;14;46
420287;201712;420;1106;293;904;101;324;88;266;189;590
420290;201712;4489;13598;3272;10740;624;2236;1111;3301;1735;5537
420300;201712;6453;18840;3817;12799;800;3062;841;2495;1641;5557
420310;201712;774;1942;459;1291;58;172;311;854;369;1026
420315;201712;881;2747;652;2267;173;640;226;773;399;1413
420320;201712;3880;11847;3139;10456;1008;3712;744;2303;1752;6015
420325;201712;216;694;158;566;43;152;43;159;86;311
420330;201712;866;2791;608;2159;126;489;190;622;316;1111
420340;201712;1189;3568;840;2797;158;556;57;181;215;737
420350;201712;1418;4028;992;3182;157;549;540;1711;697;2260
420360;201712;2650;7893;1493;5267;293;1140;137;491;430;1631
420370;201712;1417;3940;1117;3446;139;512;769;2294;908;2806
420380;201712;5000;14323;3243;10646;746;2638;912;2927;1658;5565
420390;201712;1074;2833;683;2015;117;389;237;503;354;892
420395;201712;1089;3298;717;2476;113;426;74;226;187;652
420400;201712;996;2981;660;2254;129;502;145;457;274;959
420410;201712;589;1610;424;1297;37;142;307;919;344;1061
420415;201712;365;1124;272;918;84;304;74;241;158;545
420417;201712;683;2136;544;1808;115;410;208;674;323;1084
420419;201712;250;845;175;663;55;239;10;34;65;273
420420;201712;9904;28399;7295;23631;2634;9236;1473;4406;4107;13642
420425;201712;892;2347;616;1839;66;250;267;737;333;987
420430;201712;3130;9245;1964;6510;459;1630;543;1646;1002;3276
420435;201712;256;750;133;475;29;130;42;128;71;258
420440;201712;737;2175;408;1352;135;505;112;324;247;829
420445;201712;334;956;206;668;44;150;61;184;105;334
420450;201712;692;2105;491;1652;101;371;136;399;237;770
420455;201712;1885;5203;1467;4501;215;763;736;2159;951;2922
420460;201712;8288;23334;6176;19595;1200;4357;2541;7611;3741;11968
420470;201712;825;2207;444;1434;86;310;103;293;189;603
420475;201712;63;193;43;152;13;43;6;21;19;64
420480;201712;4551;12523;3114;9928;686;2360;918;2864;1604;5224
420490;201712;570;1510;301;1036;71;265;68;245;139;510
420500;201712;1344;4050;917;3192;231;872;285;975;516;1847
420510;201712;111;385;81;299;16;69;43;145;59;214
420515;201712;50;143;38;124;7;29;13;39;20;68
420517;201712;767;2210;693;2085;42;132;549;1642;591;1774
420519;201712;381;985;245;759;40;144;71;208;111;352
420520;201712;501;1320;230;782;29;94;27;72;56;166
420530;201712;1030;3122;737;2489;155;580;210;637;365;1217
420535;201712;256;724;113;379;28;99;11;37;39;136
420540;201712;21873;57594;14563;43340;2963;9782;4530;11586;7493;21368
420543;201712;299;792;234;671;49;117;115;328;164;445
420545;201712;1334;4157;1062;3576;248;888;352;1150;600;2038
420550;201712;3463;10332;2352;8147;575;2263;658;2311;1233;4574
420555;201712;321;966;241;799;44;149;92;292;136;441
420560;201712;441;1228;321;1012;58;183;180;557;238;740
420570;201712;2081;6336;1611;5340;342;1293;637;1964;979;3257
420580;201712;1686;4653;1294;4022;272;971;631;1878;903;2849
420590;201712;2950;8559;1809;5995;359;1309;326;869;685;2178
420600;201712;928;2937;792;2655;148;521;412;1382;560;1903
420610;201712;447;1338;244;871;56;215;52;174;108;389
420620;201712;487;1442;408;1299;124;417;126;391;250;808
420630;201712;813;2473;613;2004;138;500;257;779;395;1279
420640;201712;677;1955;312;1117;83;339;24;70;107;409
420650;201712;2465;7070;1572;5205;276;973;469;1360;745;2333
420660;201712;411;1189;278;908;57;206;66;203;123;409
420665;201712;547;1512;379;1228;61;248;159;461;220;709
420670;201712;1532;4371;1046;3383;181;724;336;950;517;1674
420675;201712;157;515;116;407;33;143;21;53;54;196
420680;201712;336;838;198;631;36;124;83;250;119;374
420690;201712;773;2616;536;1963;88;335;89;260;177;595
420700;201712;2858;8269;2227;7051;396;1401;889;2705;1285;4106
420710;201712;618;1954;462;1617;95;410;186;578;281;988
420720;201712;1418;4017;1068;3511;298;1022;444;1446;742;2468
420730;201712;2794;7938;2203;6977;425;1471;1070;3272;1495;4743
420740;201712;753;2275;525;1805;144;540;114;363;258;903
420750;201712;1853;5751;1299;4500;212;823;432;1348;644;2171
420757;201712;84;197;26;101;5;25;10;34;15;59
420760;201712;381;1164;178;595;39;128;21;64;60;192
420765;201712;485;1539;252;924;46;183;58;215;104;398
420768;201712;1153;3783;969;3413;272;976;528;1883;800;2859
420770;201712;513;1393;248;889;54;224;56;197;110;421
420775;201712;564;1648;309;1053;66;243;43;123;109;366
420780;201712;1096;3244;645;2224;122;442;138;448;260;890
420785;201712;184;526;136;417;26;78;41;110;67;188
420790;201712;1037;3427;808;2968;208;829;329;1149;537;1978
420800;201712;756;2056;354;1176;80;293;101;318;181;611
420810;201712;1686;5664;1365;4944;440;1801;318;1012;758;2813
420820;201712;8651;23902;5857;19318;1375;5039;1929;5959;3304;10998
420830;201712;2810;8409;2229;7313;566;2040;767;2431;1333;4471
420840;201712;837;2405;382;1345;76;296;60;188;136;484
420845;201712;1611;4471;1006;3340;231;876;297;962;528;1838
420850;201712;1215;3965;758;2821;180;741;89;275;269;1016
420860;201712;309;838;190;626;44;171;43;134;87;305
420870;201712;885;2486;675;2140;243;860;204;607;447;1467
420880;201712;926;3034;712;2513;163;640;153;463;316;1103
420890;201712;7687;20952;4149;13618;740;2671;1058;3046;1798;5717
420895;201712;173;518;99;325;28;97;33;100;61;197
420900;201712;1504;4082;922;3005;173;685;291;805;464;1490
420910;201712;23252;66294;15633;51463;2759;10304;5291;15903;8050;26207
420915;201712;508;1984;353;1518;72;329;150;602;222;931
420917;201712;353;1040;189;586;28;97;82;236;110;333
420920;201712;128;374;51;187;4;16;5;15;9;31
420930;201712;17190;47613;12662;39662;2387;8182;5434;16332;7821;24514
420940;201712;2482;6984;1714;5516;450;1593;121;333;571;1926
420945;201712;150;468;110;374;28;110;36;114;64;224
420950;201712;433;1224;238;814;29;122;77;254;106;376
420960;201712;866;2401;625;1940;122;431;210;588;332;1019
420970;201712;2597;7736;1843;6255;521;1857;315;1117;836;2974
420980;201712;379;1139;295;1013;123;441;96;359;219;800
420985;201712;393;1145;189;681;34;138;61;204;95;342
420990;201712;535;1595;304;1090;60;232;43;129;103;361
421000;201712;457;1580;311;1188;66;279;57;162;123;441
421003;201712;510;1335;191;632;25;84;24;60;49;144
421005;201712;118;372;88;316;21;84;40;154;61;238
421010;201712;4015;11290;2811;9166;654;2354;612;1815;1266;4169
421020;201712;417;1237;313;1059;25;97;206;697;231;794
421030;201712;722;2429;594;2131;191;750;127;425;318;1175
421040;201712;814;1972;502;1482;63;223;279;801;342;1024
421050;201712;1364;3812;771;2530;153;541;221;677;374;1218
421055;201712;170;469;85;280;23;78;22;66;45;144
421060;201712;521;1639;362;1242;76;302;132;434;208;736
421070;201712;572;1787;352;1225;78;294;46;146;124;440
421080;201712;676;2779;614;2679;74;244;464;2191;538;2435
421085;201712;439;1242;197;682;31;114;35;110;66;224
421090;201712;365;977;173;547;19;61;42;126;61;187
421100;201712;921;2402;459;1409;108;360;50;138;158;498
421105;201712;1359;3983;1080;3548;180;615;517;1779;697;2394
421110;201712;909;2913;791;2698;138;514;436;1461;574;1975
421120;201712;1086;3465;736;2675;107;443;191;594;298;1037
421125;201712;344;923;247;768;73;247;72;184;145;431
421130;201712;3145;10113;2714;9289;743;2768;1220;4119;1963;6887
421140;201712;295;856;214;687;41;133;85;251;126;384
421145;201712;469;1355;266;853;53;183;106;312;159;495
421150;201712;511;1445;341;1145;62;245;121;381;183;626
421160;201712;833;2232;454;1458;74;273;204;636;278;909
421165;201712;200;655;157;557;21;69;79;297;100;366
421170;201712;1170;3228;904;2810;142;446;550;1735;692;2181
421175;201712;1118;3113;748;2445;148;575;263;748;411;1323
421180;201712;418;1102;200;655;44;166;38;116;82;282
421185;201712;343;907;225;684;41;127;114;354;155;481
421187;201712;344;1022;224;733;34;115;85;254;119;369
421189;201712;369;1139;278;927;49;174;87;261;136;435
421190;201712;9867;27377;5995;20106;1241;4656;994;3122;2235;7778
421200;201712;775;2453;634;2178;133;482;244;813;377;1295
421205;201712;199;569;147;468;35;133;57;170;92;303
421210;201712;1065;3131;777;2535;192;664;266;845;458;1509
421220;201712;1495;4956;1273;4448;340;1305;201;628;541;1933
421223;201712;426;1312;293;1043;58;220;106;373;164;593
421225;201712;1003;3201;851;2870;191;709;413;1408;604;2117
421227;201712;944;2602;610;1951;117;419;311;975;428;1394
421230;201712;524;1508;377;1241;109;385;126;409;235;794
421240;201712;331;1035;160;592;19;88;24;92;43;180
421250;201712;1429;3949;888;3015;223;821;221;752;444;1573
421260;201712;281;785;58;209;10;32;8;31;18;63
421265;201712;715;2140;644;2029;71;263;467;1448;538;1711
421270;201712;482;1341;248;868;49;165;70;239;119;404
421280;201712;1499;4669;1188;4079;257;988;537;1822;794;2810
421290;201712;807;2235;462;1476;88;292;78;224;166;516
421300;201712;236;702;163;546;40;159;54;167;94;326
421310;201712;182;569;140;461;28;106;47;144;75;250
421315;201712;259;783;153;547;28;102;17;65;45;167
421320;201712;650;1978;381;1296;74;262;63;156;137;418
421330;201712;565;1770;420;1482;106;391;110;392;216;783
421335;201712;399;1310;325;1157;77;318;75;264;152;582
421340;201712;1435;4039;1095;3453;186;651;529;1623;715;2274
421350;201712;1044;3252;820;2815;136;576;406;1320;542;1896
421360;201712;2460;6995;1522;5116;337;1342;507;1513;844;2855
421370;201712;487;1652;328;1235;84;331;77;290;161;621
421380;201712;790;2299;679;2098;106;347;358;1066;464;1413
421390;201712;165;454;67;222;16;59;18;50;34;109
421400;201712;252;842;181;708;56;240;70;257;126;497
421410;201712;228;667;119;434;17;73;49;179;66;252
421415;201712;342;1058;155;529;39;138;30;86;69;224
421420;201712;640;1871;497;1590;72;245;240;730;312;975
421430;201712;159;517;122;432;20;75;32;108;52;183
421440;201712;679;1935;469;1570;89;334;219;723;308;1057
421450;201712;398;1230;230;821;36;154;33;121;69;275
421460;201712;490;1414;285;1016;57;215;76;260;133;475
421470;201712;282;902;212;758;49;216;61;196;110;412
421480;201712;2779;7623;1791;5898;583;2214;324;897;907;3111
421490;201712;212;617;98;360;16;61;18;54;34;115
421500;201712;1980;6459;1444;5295;407;1678;189;631;596;2309
421505;201712;300;951;266;892;46;155;145;488;191;643
421507;201712;440;1305;288;993;70;263;79;263;149;526
421510;201712;223;679;153;517;36;118;65;190;101;308
421520;201712;619;1716;381;1183;53;194;171;483;224;677
421530;201712;312;971;177;630;37;160;37;105;74;265
421535;201712;505;1479;311;1086;37;147;148;479;185;626
421540;201712;226;605;155;484;31;106;63;184;94;290
421545;201712;695;2119;500;1735;116;460;183;606;299;1066
421550;201712;1955;5915;1669;5440;436;1568;706;2219;1142;3787
421555;201712;221;638;63;226;15;65;8;19;23;84
421560;201712;118;364;60;224;11;44;7;29;18;73
421565;201712;743;2042;549;1738;139;494;222;710;361;1204
421567;201712;516;1833;390;1486;194;760;68;266;262;1026
421568;201712;482;1451;320;1079;59;220;101;320;160;540
421569;201712;250;730;101;360;21;71;20;78;41;149
421570;201712;1130;3250;704;2326;174;611;125;375;299;986
421575;201712;339;1051;296;933;46;158;161;480;207;638
421580;201712;2727;8468;2022;6957;457;1795;632;1913;1089;3708
421590;201712;165;516;129;444;17;63;71;234;88;297
421600;201712;470;1390;336;1085;79;261;85;257;164;518
421605;201712;745;2153;500;1687;94;340;140;454;234;794
421610;201712;1230;3369;801;2538;151;538;217;653;368;1191
421620;201712;3822;11148;2346;8164;672;2514;529;1803;1201;4317
421625;201712;320;865;118;396;23;74;17;51;40;125
421630;201712;2712;7718;1492;4941;270;1037;288;858;558;1895
421635;201712;195;571;105;345;16;63;30;77;46;140
421640;201712;856;2452;585;1948;125;441;194;629;319;1070
421650;201712;2092;6386;1422;4936;326;1306;220;602;546;1908
421660;201712;6923;21817;5667;19309;1112;4194;2024;6383;3136;10577
421670;201712;895;2609;614;2000;147;553;208;642;355;1195
421680;201712;973;3080;783;2675;263;946;205;667;468;1613
421690;201712;1244;3962;903;3149;218;857;181;587;399;1444
421700;201712;459;1482;248;927;47;202;59;188;106;390
421710;201712;189;612;77;270;16;65;25;81;41;146
421715;201712;185;465;89;280;16;52;47;146;63;198
421720;201712;1810;5269;1080;3751;260;982;250;809;510;1791
421725;201712;163;445;105;336;28;102;35;94;63;196
421730;201712;419;1233;215;694;36;130;68;197;104;327
421740;201712;626;1955;431;1478;104;399;104;325;208;724
421750;201712;910;2272;495;1491;68;217;187;517;255;734
421755;201712;270;741;142;440;18;74;53;144;71;218
421760;201712;959;2803;509;1743;87;319;111;336;198;655
421770;201712;2504;7169;1837;5932;453;1507;617;2143;1070;3650
421775;201712;275;808;200;654;35;121;89;272;124;393
421780;201712;855;2873;610;2296;136;567;163;556;299;1123
421790;201712;669;1756;390;1314;145;532;118;365;263;897
421795;201712;295;863;179;565;27;98;58;168;85;266
421800;201712;2419;7093;1773;5874;404;1461;725;2284;1129;3745
421810;201712;652;1848;463;1484;102;380;165;474;267;854
421820;201712;854;2484;457;1573;97;362;61;174;158;536
421825;201712;1301;3971;1207;3818;168;597;834;2569;1002;3166
421830;201712;2256;7441;1958;6841;501;1939;657;2138;1158;4077
421835;201712;206;562;127;424;26;109;63;187;89;296
421840;201712;238;748;163;586;37;141;56;194;93;335
421850;201712;401;1226;223;785;40;156;53;162;93;318
421860;201712;274;869;180;659;33;145;52;159;85;304
421870;201712;3353;9250;2315;7212;552;1915;726;2128;1278;4043
421875;201712;368;1058;161;574;27;97;17;53;44;150
421880;201712;637;1912;470;1561;131;469;80;259;211;728
421885;201712;252;760;199;678;63;232;49;150;112;382
421890;201712;758;2528;618;2242;182;746;220;725;402;1471
421895;201712;343;1054;306;996;48;174;202;653;250;827
421900;201712;876;2392;600;1845;122;414;243;701;365;1115
421910;201712;385;1222;278;973;55;230;58;172;113;402
421915;201712;436;1301;264;884;54;178;43;133;97;311
421917;201712;569;1578;370;1286;128;494;84;290;212;784
421920;201712;582;1684;380;1370;178;647;113;444;291;1091
421930;201712;2456;6538;1226;4165;349;1273;151;477;500;1750
421935;201712;508;1653;387;1401;88;358;165;559;253;917
421940;201712;224;719;124;434;23;100;41;130;64;230
421950;201712;3163;8349;1467;4876;326;1213;217;681;543;1894
421960;201712;159;442;111;364;20;82;24;80;44;162
421970;201712;2107;5670;1129;3653;264;884;252;731;516;1615
421985;201712;347;869;182;548;28;99;49;157;77;256
422000;201712;1502;4335;1249;3879;218;794;681;2065;899;2859
430003;201712;553;1681;414;1437;106;419;128;406;234;825
430005;201712;299;842;195;638;54;179;83;270;137;449
430010;201712;1833;4874;1413;4150;276;901;709;2034;985;2935
430020;201712;611;1484;488;1326;78;243;292;759;370;1002
430030;201712;1024;2594;625;1843;179;544;175;521;354;1065
430040;201712;10114;26376;6375;19234;1641;5537;332;1059;1973;6596
430045;201712;602;1614;421;1233;48;154;210;585;258;739
430047;201712;283;657;124;371;24;74;32;90;56;164
430050;201712;942;2540;541;1667;118;367;127;373;245;740
430055;201712;292;755;132;404;13;45;68;193;81;238
430057;201712;78;189;34;102;8;29;6;12;14;41
430060;201712;16352;49344;13510;44618;3655;13009;5166;17294;8821;30303
430063;201712;880;2557;691;2136;164;497;365;1131;529;1628
430064;201712;1073;3162;801;2569;228;783;201;627;429;1410
430066;201712;132;310;89;240;6;21;55;140;61;161
430070;201712;663;1765;133;447;11;38;10;22;21;60
430080;201712;748;2022;441;1392;83;282;164;462;247;744
430085;201712;920;2299;542;1610;96;312;187;565;283;877
430087;201712;649;2010;544;1822;103;390;271;861;374;1251
430090;201712;657;1731;220;723;22;87;55;180;77;267
430100;201712;749;1898;375;1182;76;248;113;320;189;568
430105;201712;995;2784;661;2179;120;465;287;928;407;1393
430107;201712;197;618;138;465;21;71;31;92;52;163
430110;201712;2072;5421;1534;4605;287;894;765;2221;1052;3115
430120;201712;1434;4393;934;3149;211;722;370;1315;581;2037
430130;201712;3955;10700;3178;9525;996;2754;1087;3923;2083;6677
430140;201712;1009;3037;644;2192;168;577;209;714;377;1291
430150;201712;688;1784;378;1178;83;282;93;290;176;572
430155;201712;297;813;164;530;23;82;37;106;60;188
430160;201712;16208;45111;13833;41233;3513;10954;5021;15660;8534;26614
430163;201712;2194;5834;1609;4885;205;711;947;2838;1152;3549
430165;201712;435;1012;96;308;10;28;9;25;19;53
430170;201712;904;2538;333;1199;69;253;59;195;128;448
430175;201712;734;2322;612;2021;158;503;282;948;440;1451
430180;201712;732;1976;594;1730;101;343;337;932;438;1275
430185;201712;476;1189;290;837;54;165;120;304;174;469
430187;201712;627;1715;465;1428;88;295;191;567;279;862
430190;201712;1478;4346;1257;3898;299;990;545;1647;844;2637
430192;201712;143;435;60;188;9;29;9;23;18;52
430195;201712;376;1143;77;256;10;32;6;15;16;47
430200;201712;1206;3798;1005;3387;304;1061;297;989;601;2050
430205;201712;508;1455;404;1241;21;82;313;933;334;1015
430210;201712;5496;14136;3613;10324;528;1703;1454;3392;1982;5095
430215;201712;322;876;223;668;36;122;89;255;125;377
430220;201712;644;1625;191;625;35;117;38;111;73;228
430222;201712;221;681;179;590;26;94;74;224;100;318
430223;201712;293;827;244;735;45;138;112;338;157;476
430225;201712;35;85;14;39;3;7;5;8;8;15
430230;201712;1512;4490;1422;4369;257;723;1050;3337;1307;4060
430235;201712;227;709;178;591;23;90;68;217;91;307
430237;201712;532;1356;382;1101;32;104;234;641;266;745
430240;201712;1132;2653;695;1959;74;240;401;1100;475;1340
430245;201712;782;2365;597;1994;199;662;243;846;442;1508
430250;201712;1057;2934;858;2619;251;823;56;149;307;972
430258;201712;129;347;92;286;8;29;47;147;55;176
430260;201712;633;1783;462;1437;91;284;218;706;309;990
430265;201712;228;675;169;569;33;118;38;128;71;246
430270;201712;2698;7315;2284;6656;267;862;1516;4329;1783;5191
430280;201712;4670;12052;3575;10112;833;2408;1468;4178;2301;6586
430290;201712;2292;5897;2059;5572;95;304;1770;4731;1865;5035
430300;201712;8505;23929;6890;20925;1442;4686;3164;9586;4606;14272
430310;201712;7106;19723;5109;15996;951;3401;2222;6551;3173;9952
430320;201712;848;2436;493;1643;96;289;228;825;324;1114
430330;201712;639;1631;437;1239;112;335;183;457;295;792
430340;201712;723;1708;368;1109;70;226;179;526;249;752
430350;201712;5801;17001;4741;14768;1442;4673;1712;5150;3154;9823
430355;201712;356;889;123;388;25;88;11;36;36;124
430360;201712;819;2173;614;1794;125;376;218;616;343;992
430367;201712;336;837;176;531;51;176;50;145;101;321
430370;201712;524;1466;275;916;64;228;60;177;124;405
430380;201712;694;1782;381;1204;120;427;97;305;217;732
430390;201712;3265;8651;1842;5772;300;1032;139;353;439;1385
430400;201712;1154;2724;865;2263;162;442;502;1274;664;1716
430410;201712;597;1529;415;1217;53;185;244;695;297;880
430420;201712;3106;8863;2371;7198;712;2279;761;2228;1473;4507
430430;201712;613;1646;341;1076;89;297;65;194;154;491
430435;201712;1728;4643;1259;3808;339;1064;345;1070;684;2134
430440;201712;3676;11060;2776;9113;583;2040;1284;4306;1867;6346
430450;201712;6467;17876;5314;15698;1246;3922;2119;6260;3365;10182
430460;201712;25654;72728;18999;61451;4593;16357;6684;20908;11277;37265
430461;201712;465;1208;139;445;17;56;33;97;50;153
430462;201712;262;707;166;538;29;109;34;125;63;234
430463;201712;4286;13017;3544;11658;725;2589;1708;5634;2433;8223
430465;201712;506;1371;418;1204;79;241;250;706;329;947
430466;201712;3572;9364;2985;8425;711;2121;1481;3976;2192;6097
430467;201712;483;1312;377;1120;62;201;174;494;236;695
430468;201712;1312;3512;1055;3113;182;588;578;1684;760;2272
430469;201712;553;1578;60;208;7;17;9;22;16;39
430470;201712;6530;17708;4655;14476;1487;4865;871;2774;2358;7639
430471;201712;505;1649;449;1523;99;345;178;595;277;940
430480;201712;935;2496;476;1532;74;272;70;196;144;468
430485;201712;146;428;63;210;11;43;11;29;22;72
430490;201712;340;954;194;635;30;105;83;281;113;386
430495;201712;381;1087;247;811;36;135;96;280;132;415
430500;201712;1113;3004;837;2539;211;707;329;939;540;1646
430510;201712;22302;62229;16515;50610;4202;14020;5464;15573;9666;29593
430511;201712;347;1052;140;493;23;72;14;42;37;114
430512;201712;945;2383;782;2121;208;578;240;676;448;1254
430513;201712;797;2065;410;1209;108;341;147;399;255;740
430515;201712;408;1168;280;911;51;146;129;438;180;584
430517;201712;1055;3296;852;2879;156;540;403;1402;559;1942
430520;201712;1396;3772;775;2456;146;486;138;398;284;884
430530;201712;1100;2879;416;1291;88;273;97;293;185;566
430535;201712;2789;7886;2001;6359;371;1243;842;2654;1213;3897
430537;201712;396;1342;328;1161;46;166;224;795;270;961
430540;201712;605;1401;370;1046;70;199;194;534;264;733
430543;201712;578;1222;399;1023;68;152;263;707;331;859
430544;201712;620;1946;481;1619;116;417;222;713;338;1130
430545;201712;1564;4661;1235;4160;351;1242;520;1790;871;3032
430550;201712;544;1525;299;982;63;215;53;150;116;365
430558;201712;74;231;47;163;13;45;13;38;26;83
430560;201712;406;956;174;528;16;58;45;129;61;187
430570;201712;974;2382;639;1789;95;329;334;838;429;1167
430580;201712;1172;2866;725;2134;120;406;337;942;457;1348
430583;201712;179;466;36;113;4;13;6;21;10;34
430585;201712;257;641;146;423;26;89;61;154;87;243
430587;201712;178;556;136;453;32;118;51;174;83;292
430590;201712;1374;3477;1193;3174;66;214;1022;2670;1088;2884
430593;201712;16;58;14;51;3;13;7;25;10;38
430595;201712;280;804;78;277;9;39;12;40;21;79
430597;201712;321;927;216;672;20;75;85;223;105;298
430600;201712;1822;4926;887;2747;155;478;220;652;375;1130
430605;201712;1193;3504;924;2941;155;592;357;1116;512;1708
430607;201712;695;1601;506;1318;38;111;329;878;367;989
430610;201712;6503;16900;4747;14172;1416;4609;778;2392;2194;7001
430613;201712;285;673;93;285;6;23;27;65;33;88
430620;201712;605;1663;490;1438;125;410;215;601;340;1011
430630;201712;462;1343;140;458;26;85;26;74;52;159
430632;201712;597;1657;282;877;34;115;109;316;143;431
430635;201712;543;1540;409;1253;73;246;242;720;315;966
430637;201712;451;1239;378;1119;57;195;210;588;267;783
430640;201712;1364;3622;705;2235;99;321;179;507;278;828
430642;201712;414;1117;269;822;42;131;118;355;160;486
430645;201712;277;626;106;292;20;58;28;75;48;133
430650;201712;1637;5188;1364;4617;342;1208;674;2307;1016;3515
430655;201712;161;393;122;342;29;85;51;133;80;218
430660;201712;5055;13878;3939;11916;906;2916;1690;5069;2596;7985
430670;201712;500;1376;397;1178;37;133;265;777;302;910
430673;201712;674;1598;274;817;53;162;87;255;140;417
430675;201712;225;666;56;200;11;49;13;41;24;90
430676;201712;3911;10807;3020;9259;603;1953;1347;4117;1950;6070
430680;201712;1032;2847;614;1995;136;439;130;398;266;837
430690;201712;3456;9881;2830;8682;832;2674;730;2255;1562;4929
430692;201712;224;715;171;620;9;34;118;435;127;469
430693;201712;1094;2902;618;1919;139;479;116;318;255;797
430695;201712;554;1390;342;988;43;135;193;530;236;665
430697;201712;424;1129;305;922;55;165;144;457;199;622
430700;201712;7971;20340;4173;13314;925;3245;350;1146;1275;4391
430705;201712;277;778;167;539;24;82;60;182;84;264
430710;201712;1603;3971;1217;3329;230;707;565;1506;795;2213
430720;201712;678;1717;413;1284;101;311;139;445;240;756
430730;201712;1438;3764;917;2863;160;510;415;1340;575;1850
430740;201712;621;1773;346;1187;61;214;86;320;147;534
430745;201712;484;1370;244;792;37;126;52;160;89;286
430750;201712;1436;3869;1057;3220;221;738;518;1536;739;2274
430755;201712;479;1222;302;868;23;74;164;427;187;501
430760;201712;2291;5794;1687;4861;385;1214;676;2007;1061;3221
430770;201712;5916;16231;4527;13944;814;2726;2447;7372;3261;10098
430780;201712;2300;6005;1407;4418;266;871;464;1533;730;2404
430781;201712;412;1199;260;853;55;185;52;173;107;358
430783;201712;506;1219;289;846;37;122;136;374;173;496
430786;201712;60;205;42;158;7;25;9;35;16;60
430790;201712;4282;11435;2872;8662;547;1813;1326;3799;1873;5612
430800;201712;823;2209;566;1675;78;267;298;839;376;1106
430805;201712;531;1473;315;970;38;120;161;471;199;591
430807;201712;416;1101;275;829;35;126;115;324;150;450
430810;201712;798;2103;273;927;43;142;68;215;111;357
430820;201712;1301;3630;716;2393;161;549;140;463;301;1012
430825;201712;313;845;118;355;29;74;24;66;53;140
430830;201712;1591;4859;1397;4525;148;540;957;3101;1105;3641
430840;201712;915;2684;788;2452;167;509;420;1312;587;1821
430843;201712;111;278;36;107;6;16;12;34;18;50
430845;201712;313;830;216;650;88;285;33;82;121;367
430850;201712;2269;6432;1856;5682;432;1453;857;2593;1289;4046
430860;201712;953;2433;476;1482;88;331;183;518;271;849
430865;201712;558;1477;482;1346;149;449;209;548;358;997
430870;201712;711;1919;325;1071;63;224;85;251;148;475
430880;201712;1193;3008;786;2338;211;656;290;875;501;1531
430885;201712;239;577;122;396;10;38;87;275;97;313
430890;201712;1361;3632;890;2704;65;286;123;331;188;617
430900;201712;2781;6867;1952;5551;301;992;993;2675;1294;3667
430905;201712;892;2459;569;1798;116;409;155;459;271;868
430910;201712;1477;4174;977;3128;199;757;383;1091;582;1848
430912;201712;482;1363;338;1103;38;133;208;689;246;822
430915;201712;538;1676;396;1421;108;382;135;530;243;912
430920;201712;20141;55494;16200;48853;2675;8918;9149;26910;11824;35828
430925;201712;140;313;62;170;11;27;22;65;33;92
430930;201712;9499;24260;5940;18340;1576;5182;1504;4888;3080;10070
430940;201712;1275;3804;691;2326;178;621;101;301;279;922
430950;201712;787;2081;524;1553;95;308;234;639;329;947
430955;201712;168;458;59;193;12;33;10;35;22;68
430957;201712;210;723;182;657;34;129;85;307;119;436
430960;201712;1367;3394;953;2691;200;626;466;1315;666;1941
430965;201712;1525;4019;1222;3497;77;265;956;2647;1033;2912
430970;201712;383;1029;200;631;23;79;93;284;116;363
430975;201712;508;1660;389;1366;90;343;147;512;237;855
430980;201712;373;941;224;675;47;150;84;251;131;401
430990;201712;541;1619;326;1073;54;206;128;407;182;613
430995;201712;620;1710;444;1383;86;271;199;600;285;871
431000;201712;1472;3625;649;1957;110;354;35;96;145;450
431010;201712;2332;6395;1352;4517;213;798;107;310;320;1108
431020;201712;9312;21884;5883;16309;1403;4169;1642;4301;3045;8470
431030;201712;326;915;140;491;37;125;14;56;51;181
431033;201712;2708;7751;2076;6752;549;1879;739;2518;1288;4397
431036;201712;245;617;63;202;6;13;15;44;21;57
431040;201712;909;2452;611;1898;114;420;281;799;395;1219
431041;201712;472;1144;375;994;63;174;208;547;271;721
431043;201712;449;1160;228;747;81;264;60;196;141;460
431046;201712;130;347;64;187;7;21;13;37;20;58
431050;201712;1565;3925;1103;3171;236;697;526;1510;762;2207
431053;201712;501;1544;378;1282;114;415;87;290;201;705
431055;201712;650;1686;572;1563;53;151;421;1136;474;1287
431057;201712;285;842;143;479;29;106;41;123;70;229
431060;201712;5035;14609;4076;12853;1292;4457;829;2721;2121;7178
431065;201712;498;1369;336;1062;64;208;86;269;150;477
431070;201712;573;1680;319;1071;88;315;45;117;133;432
431075;201712;214;660;158;544;32;123;51;175;83;298
431080;201712;656;1896;455;1456;87;290;145;454;232;744
431085;201712;700;1941;530;1564;83;237;311;909;394;1146
431087;201712;485;1394;406;1222;28;84;278;850;306;934
431090;201712;471;1152;183;577;37;123;41;131;78;254
431100;201712;3258;8223;2469;7065;534;1654;922;2603;1456;4257
431110;201712;1457;3581;1019;2777;259;739;393;1006;652;1745
431112;201712;522;1644;456;1515;97;337;236;760;333;1097
431113;201712;405;1165;329;1021;105;345;113;357;218;702
431115;201712;1220;3473;967;3029;168;598;529;1597;697;2195
431120;201712;2518;7438;1814;5970;587;2187;447;1336;1034;3523
431123;201712;407;1165;262;858;61;192;117;396;178;588
431125;201712;1234;3690;864;2883;283;942;224;829;507;1771
431127;201712;272;749;60;201;8;20;12;32;20;52
431130;201712;3231;9194;2218;7160;496;1698;702;2282;1198;3980
431140;201712;4789;11712;2637;7724;382;1208;901;2321;1283;3529
431142;201712;485;1389;380;1199;60;198;226;708;286;906
431150;201712;978;2831;711;2278;171;568;263;830;434;1398
431160;201712;733;2075;566;1742;121;355;205;691;326;1046
431162;201712;510;1251;225;710;29;106;56;159;85;265
431164;201712;207;515;52;177;11;46;7;21;18;67
431170;201712;631;1716;412;1286;117;385;106;322;223;707
431171;201712;698;1873;582;1683;92;284;325;917;417;1201
431173;201712;425;1207;322;1022;125;420;67;213;192;633
431175;201712;929;2520;660;2026;174;540;138;424;312;964
431177;201712;714;2217;522;1847;160;600;186;650;346;1250
431179;201712;341;711;73;199;11;32;16;33;27;65
431180;201712;2130;5730;1345;4194;326;1095;251;780;577;1875
431190;201712;511;1386;280;889;44;146;57;149;101;295
431198;201712;342;1107;300;1025;107;378;91;339;198;717
431200;201712;388;1057;96;325;10;25;1;3;11;28
431205;201712;236;681;101;364;24;89;41;149;65;238
431210;201712;672;1778;558;1605;154;421;264;800;418;1221
431213;201712;232;709;178;609;21;85;100;338;121;423
431215;201712;278;858;195;648;22;84;76;231;98;315
431217;201712;162;463;100;335;17;60;46;147;63;207
431220;201712;720;1956;408;1304;38;142;180;526;218;668
431225;201712;1301;3526;999;2965;181;545;487;1456;668;2001
431230;201712;706;2100;521;1636;89;299;247;760;336;1059
431235;201712;132;367;29;89;7;22;2;4;9;26
431237;201712;423;1258;336;1111;61;234;169;537;230;771
431238;201712;26;78;21;64;7;23;5;12;12;35
431240;201712;3745;10336;3013;9118;718;2425;1266;3664;1984;6089
431242;201712;356;1050;294;927;69;214;121;392;190;606
431244;201712;327;788;168;482;24;86;56;123;80;209
431245;201712;1105;2894;750;2181;147;471;315;874;462;1345
431247;201712;214;602;120;389;21;66;29;90;50;156
431250;201712;1364;4158;1126;3788;259;892;501;1762;760;2654
431260;201712;298;807;145;501;14;64;42;132;56;196
431261;201712;270;885;222;770;42;156;86;286;128;442
431262;201712;408;1171;171;598;18;61;87;307;105;368
431265;201712;1369;3376;595;1794;98;320;175;439;273;759
431267;201712;280;776;157;464;6;23;101;273;107;296
431270;201712;2655;6420;1453;4334;405;1299;378;1162;783;2461
431275;201712;199;586;103;367;24;91;13;37;37;128
431280;201712;264;734;76;265;7;24;10;19;17;43
431290;201712;304;905;219;733;27;107;76;223;103;330
431295;201712;79;218;28;92;4;17;7;19;11;36
431300;201712;355;850;52;186;2;6;7;19;9;25
431301;201712;245;754;65;235;7;20;4;7;11;27
431303;201712;650;1692;354;1080;43;158;124;368;167;526
431306;201712;2109;5249;1260;3747;163;553;458;1246;621;1799
431308;201712;31;101;27;88;15;51;6;19;21;70
431310;201712;626;1817;362;1192;60;204;116;392;176;596
431320;201712;646;1800;318;1089;64;236;49;157;113;393
431330;201712;2068;5070;1027;3159;255;894;160;426;415;1320
431333;201712;352;952;130;393;16;43;33;91;49;134
431335;201712;37;109;23;82;8;28;3;3;11;31
431337;201712;2623;7450;1780;5897;512;1864;330;1040;842;2904
431339;201712;492;1327;338;1013;70;228;170;498;240;726
431340;201712;20741;54155;14805;43839;3287;10638;4291;12210;7578;22848
431342;201712;516;1222;379;1010;60;197;267;674;327;871
431344;201712;362;980;236;733;12;43;154;471;166;514
431346;201712;275;694;99;308;14;43;22;71;36;114
431349;201712;742;2049;417;1282;68;217;140;399;208;616
431350;201712;3906;10999;2966;9271;726;2471;1001;3049;1727;5520
431360;201712;647;1583;381;1119;77;240;155;438;232;678
431365;201712;1685;4596;1390;4130;156;509;925;2766;1081;3275
431370;201712;4386;11946;3334;10130;793;2561;1356;4303;2149;6864
431380;201712;758;2277;666;2117;82;288;408;1298;490;1586
431390;201712;2356;6157;1363;4248;249;870;422;1194;671;2064
431395;201712;1267;3562;936;3016;237;773;370;1226;607;1999
431400;201712;395;1187;189;627;30;95;42;142;72;237
431402;201712;998;2413;653;1804;111;323;358;942;469;1265
431403;201712;167;477;137;424;21;88;85;240;106;328
431405;201712;4007;11166;3324;10123;467;1634;1982;5920;2449;7554
431406;201712;520;1599;421;1416;102;339;217;743;319;1082
431407;201712;469;1327;315;1010;65;209;119;376;184;585
431410;201712;14023;38891;9209;29530;2103;7614;2538;7710;4641;15324
431413;201712;180;449;48;151;3;11;9;19;12;30
431415;201712;678;1823;432;1387;97;362;138;383;235;745
431417;201712;481;1216;382;1062;64;190;223;603;287;793
431420;201712;1265;3331;1079;3032;221;635;477;1406;698;2041
431430;201712;522;1359;294;894;56;185;79;219;135;404
431440;201712;21638;56961;16451;48396;4326;13534;4652;14240;8978;27774
431442;201712;103;314;61;212;12;39;3;9;15;48
431445;201712;474;1356;161;534;27;83;35;112;62;195
431446;201712;389;1130;264;840;76;242;65;202;141;444
431447;201712;613;1699;411;1293;90;290;173;538;263;828
431449;201712;732;1974;509;1514;51;165;253;743;304;908
431450;201712;2061;4684;1743;4254;147;398;1323;3121;1470;3519
431454;201712;58;182;50;161;10;33;19;67;29;100
431455;201712;658;1652;332;938;49;153;135;330;184;483
431460;201712;2861;7723;2272;6581;613;1808;739;2195;1352;4003
431470;201712;1632;4649;1165;3638;234;761;427;1332;661;2093
431475;201712;217;635;30;116;4;18;1;1;5;19
431477;201712;581;1489;355;1021;46;135;167;435;213;570
431478;201712;277;726;75;224;14;48;7;17;21;65
431480;201712;3124;8158;2422;7049;346;1126;1385;3965;1731;5091
431490;201712;96585;252032;81183;228897;8827;28608;56757;156154;65584;184762
431500;201712;503;1353;380;1108;81;230;200;573;281;803
431505;201712;443;1084;281;813;25;69;163;468;188;537
431507;201712;342;817;145;414;32;106;56;139;88;245
431510;201712;1691;4651;1218;3708;246;803;460;1387;706;2190
431513;201712;308;771;150;448;19;52;84;249;103;301
431514;201712;89;253;43;146;8;33;14;38;22;71
431515;201712;571;1519;368;1116;73;243;165;463;238;706
431517;201712;76;238;54;177;8;24;13;40;21;64
431520;201712;484;1203;195;624;41;147;45;136;86;283
431530;201712;4195;9446;2549;7086;714;2037;380;1068;1094;3105
431531;201712;209;598;149;478;16;59;47;149;63;208
431532;201712;519;1371;377;1085;85;244;138;404;223;648
431535;201712;258;628;110;336;26;88;42;114;68;202
431540;201712;1938;6343;1781;6080;109;420;1323;4567;1432;4987
431545;201712;372;1014;68;219;6;29;16;44;22;73
431550;201712;2001;5687;1660;5032;373;1205;685;1995;1058;3200
431555;201712;661;1565;432;1181;43;120;266;725;309;845
431560;201712;19630;54144;13429;43251;2879;10126;3441;11828;6320;21954
431570;201712;5418;13254;4200;11627;839;2507;2272;6172;3111;8679
431575;201712;175;545;140;463;24;79;18;53;42;132
431580;201712;523;1435;271;912;46;189;97;315;143;504
431590;201712;856;2242;545;1636;108;334;187;567;295;901
431595;201712;377;1058;252;779;37;106;125;380;162;486
431600;201712;1714;4508;1232;3714;329;1105;302;899;631;2004
431610;201712;1363;3767;970;2992;125;375;470;1486;595;1861
431620;201712;516;1446;226;695;45;135;105;308;150;443
431630;201712;1250;3336;633;1998;178;579;162;471;340;1050
431640;201712;6063;16339;5427;15430;857;2478;3545;10196;4402;12674
431642;201712;513;1337;340;987;37;100;154;432;191;532
431643;201712;355;908;151;438;20;56;48;122;68;178
431645;201712;1645;4434;1326;3898;207;647;818;2407;1025;3054
431647;201712;160;447;96;304;13;48;23;60;36;108
431650;201712;249;751;175;587;29;109;50;156;79;265
431660;201712;975;2657;543;1779;91;331;121;332;212;663
431670;201712;1149;2908;828;2365;147;491;375;993;522;1484
431673;201712;250;677;95;342;23;79;9;29;32;108
431675;201712;673;1705;136;453;13;51;41;122;54;173
431680;201712;8052;21923;6073;18104;1618;5028;1965;5937;3583;10965
431690;201712;19362;52657;14640;44284;3852;12184;4544;14286;8396;26470
431695;201712;139;382;92;296;21;71;31;78;52;149
431697;201712;479;1233;394;1090;79;213;192;556;271;769
431700;201712;1438;3948;1228;3565;197;570;669;1922;866;2492
431710;201712;11338;31317;9058;27816;2549;8285;3148;10399;5697;18684
431720;201712;6207;16747;4271;12808;1051;3332;812;2265;1863;5597
431725;201712;29;86;19;66;3;12;6;19;9;31
431730;201712;3535;9601;2597;8019;709;2382;768;2515;1477;4897
431740;201712;4732;12437;3462;10201;1094;3581;601;1532;1695;5113
431750;201712;7526;20967;6432;19216;1384;4456;3031;9146;4415;13602
431755;201712;325;890;69;252;11;44;14;50;25;94
431760;201712;4515;11528;3285;9483;446;1476;1855;5074;2301;6550
431770;201712;1854;4790;1494;4261;206;626;963;2712;1169;3338
431775;201712;200;541;99;311;24;79;8;20;32;99
431780;201712;1944;5208;1383;4128;298;932;442;1273;740;2205
431790;201712;1021;2912;747;2333;149;495;267;802;416;1297
431795;201712;297;794;169;512;35;104;45;131;80;235
431800;201712;7326;20501;5538;17262;1808;6137;651;2091;2459;8228
431805;201712;322;768;95;314;8;30;35;111;43;141
431810;201712;3142;8033;2130;6113;429;1364;855;2309;1284;3673
431820;201712;2246;6647;1902;6031;393;1336;825;2619;1218;3955
431830;201712;9723;22709;7304;19197;1727;4932;2959;7821;4686;12753
431840;201712;2387;6943;1992;6241;405;1316;1055;3341;1460;4657
431842;201712;709;1782;244;770;32;115;67;191;99;306
431843;201712;319;897;251;760;31;97;114;332;145;429
431844;201712;269;726;76;246;19;70;14;34;33;104
431845;201712;488;1349;348;1046;18;51;218;651;236;702
431846;201712;270;794;224;726;19;89;173;544;192;633
431848;201712;192;511;100;320;7;26;14;35;21;61
431849;201712;444;1057;72;206;9;28;13;28;22;56
431850;201712;4165;12006;3391;10350;785;2568;1100;3269;1885;5837
431860;201712;724;1908;473;1406;93;286;221;624;314;910
431861;201712;115;316;50;173;6;23;13;39;19;62
431862;201712;478;1568;388;1399;76;298;187;679;263;977
431870;201712;17010;48066;13722;42162;2721;9308;6000;17922;8721;27230
431880;201712;3757;10659;2984;9212;619;2148;1208;3577;1827;5725
431890;201712;4515;12055;2960;9034;887;2914;459;1458;1346;4372
431900;201712;1060;2812;633;1952;142;495;276;794;418;1289
431910;201712;829;2025;343;997;54;159;91;240;145;399
431912;201712;445;1310;370;1165;74;234;200;638;274;872
431915;201712;1032;2806;793;2391;151;503;418;1223;569;1726
431920;201712;1199;3177;991;2852;86;256;758;2181;844;2437
431930;201712;819;2294;559;1832;143;439;261;897;404;1336
431935;201712;55;179;45;159;12;42;11;39;23;81
431936;201712;300;893;175;590;46;160;44;144;90;304
431937;201712;227;607;133;406;35;114;22;55;57;169
431940;201712;2316;6126;1451;4363;303;1003;467;1291;770;2294
431950;201712;1555;4521;1318;4125;265;876;651;2016;916;2892
431960;201712;2684;7363;2184;6372;583;1771;636;1821;1219;3592
431970;201712;408;1108;180;602;47;157;43;138;90;295
431971;201712;84;230;49;166;8;24;8;24;16;48
431973;201712;463;1535;392;1395;36;124;276;996;312;1120
431975;201712;109;246;23;79;4;15;3;7;7;22
431980;201712;1198;3379;938;2909;215;698;366;1109;581;1807
431990;201712;6026;15830;3967;12551;772;2707;1132;3538;1904;6245
432000;201712;9835;26480;7653;22719;2243;6831;2821;8459;5064;15290
432010;201712;1921;5261;1510;4503;202;675;803;2303;1005;2978
432020;201712;1980;4799;1416;3912;349;1036;675;1774;1024;2810
432023;201712;494;1286;281;856;43;163;134;353;177;516
432026;201712;1032;3106;766;2535;163;522;380;1257;543;1779
432030;201712;340;927;216;660;46;142;102;295;148;437
432032;201712;471;1253;311;927;31;106;150;414;181;520
432035;201712;770;2285;677;2130;214;735;224;700;438;1435
432040;201712;936;2256;432;1332;75;249;139;413;214;662
432045;201712;244;673;128;429;28;103;36;127;64;230
432050;201712;537;1468;438;1289;115;344;177;528;292;872
432055;201712;833;2228;545;1678;146;496;196;580;342;1076
432057;201712;345;860;240;669;38;87;118;316;156;403
432060;201712;484;1198;158;518;27;110;51;144;78;254
432065;201712;243;674;168;520;41;132;54;160;95;292
432067;201712;803;2414;642;2051;108;340;346;1093;454;1433
432070;201712;2172;5825;1329;4112;266;887;272;790;538;1677
432080;201712;3641;9856;2973;8683;800;2587;1131;3209;1931;5796
432085;201712;363;959;235;748;79;231;94;316;173;547
432090;201712;1360;3756;1026;3125;259;860;409;1201;668;2061
432100;201712;1192;3361;505;1723;86;324;38;91;124;415
432110;201712;2306;6617;1582;5173;357;1376;122;357;479;1733
432120;201712;3420;10004;2791;8860;951;3221;599;1891;1550;5112
432130;201712;2666;7097;2163;6434;777;2469;758;2286;1535;4755
432132;201712;284;795;139;476;26;89;39;126;65;215
432135;201712;769;2135;579;1737;82;268;373;1084;455;1352
432140;201712;1668;5220;1260;4414;243;876;585;2115;828;2991
432143;201712;1326;3749;1058;3306;159;539;588;1843;747;2382
432145;201712;1342;3949;835;2749;139;501;144;413;283;914
432146;201712;142;435;93;320;29;104;16;52;45;156
432147;201712;386;1284;312;1131;96;367;60;219;156;586
432149;201712;384;1039;231;689;27;87;103;295;130;382
432150;201712;3361;9330;2455;7561;578;1984;655;1938;1233;3922
432160;201712;4322;12941;3553;11656;1071;3746;1051;3446;2122;7192
432162;201712;354;839;52;156;9;25;6;18;15;43
432163;201712;258;701;55;176;5;16;3;11;8;27
432166;201712;584;1728;462;1472;86;315;148;402;234;717
432170;201712;1254;3637;824;2782;180;661;178;585;358;1246
432180;201712;2397;6320;1314;4099;269;910;283;782;552;1692
432183;201712;346;1090;254;867;81;297;47;160;128;457
432185;201712;801;2186;534;1654;48;156;329;985;377;1141
432190;201712;2442;6445;1554;4646;368;1190;531;1503;899;2693
432195;201712;1015;2664;681;2083;182;519;205;652;387;1171
432200;201712;2774;7969;2124;6851;519;1776;903;2967;1422;4743
432210;201712;380;1056;258;830;49;179;104;313;153;492
432215;201712;733;2243;643;2088;90;290;405;1367;495;1657
432218;201712;249;639;139;399;21;58;48;127;69;185
432220;201712;3954;10039;3018;8509;474;1537;1676;4487;2150;6024
432225;201712;103;302;75;247;14;43;31;101;45;144
432230;201712;821;2135;463;1390;79;260;127;341;206;601
432232;201712;460;1188;339;980;54;182;170;488;224;670
432234;201712;290;762;148;454;37;107;22;55;59;162
432235;201712;105;301;40;134;8;28;4;12;12;40
432237;201712;409;1094;356;1003;17;56;243;654;260;710
432240;201712;13254;38854;10923;35532;1154;4477;6713;22674;7867;27151
432250;201712;4229;14072;3758;13120;1169;4268;1273;4604;2442;8872
432252;201712;432;1080;281;819;46;156;127;347;173;503
432253;201712;1209;3800;669;2352;157;621;32;91;189;712
432254;201712;850;2218;194;637;34;132;18;45;52;177
432255;201712;188;457;87;268;11;37;32;82;43;119
432260;201712;6283;15947;4466;12811;1099;3283;1597;4745;2696;8028
432270;201712;2191;6434;1818;5722;557;1856;307;967;864;2823
432280;201712;1243;3285;634;1990;103;334;207;615;310;949
432285;201712;189;585;21;75;2;5;1;1;3;6
432290;201712;407;1224;247;843;61;209;61;190;122;399
432300;201712;23002;65318;19258;59095;3055;10334;11336;34095;14391;44429
432310;201712;707;2078;551;1800;117;384;276;912;393;1296
432320;201712;229;551;77;241;9;35;15;46;24;81
432330;201712;276;699;93;304;14;39;16;57;30;96
432335;201712;173;492;69;250;15;62;12;34;27;96
432340;201712;328;785;156;480;30;109;44;120;74;229
432345;201712;613;1556;557;1480;45;164;393;991;438;1155
432350;201712;353;954;173;568;33;107;49;147;82;254
432360;201712;201;608;36;125;7;31;7;18;14;49
432370;201712;381;1021;253;769;20;69;159;482;179;551
432375;201712;603;1533;445;1255;62;170;254;714;316;884
432377;201712;229;754;29;108;3;14;8;19;11;33
432380;201712;1285;3772;820;2750;188;721;345;1087;533;1808
500020;201712;2177;6039;1668;5196;374;1318;735;2200;1109;3518
500025;201712;1292;2985;774;2108;64;183;456;1204;520;1387
500060;201712;6513;19287;5034;16642;741;2481;2957;10270;3698;12751
500070;201712;4160;11556;3120;9738;669;2282;1212;3912;1881;6194
500080;201712;1328;3742;927;3019;221;815;338;1068;559;1883
500085;201712;1987;4948;1352;3991;197;608;752;2181;949;2789
500090;201712;2032;5667;1390;4515;273;931;524;1802;797;2733
500100;201712;3151;8494;2415;7268;372;1273;1062;3000;1434;4273
500110;201712;7065;20251;5245;17437;1103;3946;1974;7223;3077;11169
500124;201712;2056;6555;1753;6043;419;1399;875;3327;1294;4726
500150;201712;1329;3245;837;2450;183;578;279;754;462;1332
500190;201712;4640;11612;3496;10088;717;2180;1811;5404;2528;7584
500200;201712;2223;5552;1650;4550;323;960;785;2013;1108;2973
500210;201712;4492;12828;3553;11378;864;2860;1561;5094;2425;7954
500215;201712;1210;3641;885;2979;117;446;413;1340;530;1786
500220;201712;2924;8515;2240;7306;362;1276;940;3081;1302;4357
500230;201712;2570;6333;1817;5164;260;771;968;2745;1228;3516
500240;201712;3937;12115;2742;9668;502;2042;732;2734;1234;4776
500260;201712;3018;6893;1855;5178;212;616;962;2623;1174;3239
500270;201712;113133;287577;69475;209152;15525;50219;17356;51109;32881;101328
500280;201712;1295;3326;981;2877;101;330;665;1923;766;2253
500290;201712;4083;9173;2252;6502;352;1130;779;2163;1131;3293
500295;201712;2569;6985;1481;4660;224;767;442;1198;666;1965
500310;201712;858;2072;649;1806;107;286;363;1045;470;1331
500315;201712;3250;9847;2645;8840;353;1180;1642;5726;1995;6906
500320;201712;17324;53040;12810;44769;3627;13663;3576;13330;7203;26993
500325;201712;3827;9287;2602;7480;353;1065;1528;4470;1881;5535
500330;201712;6890;16895;4470;12866;443;1420;2265;6656;2708;8076
500345;201712;1883;4743;1346;3969;351;1048;494;1447;845;2495
500348;201712;2563;6857;2049;6036;232;744;1255;3737;1487;4481
500350;201712;1251;3592;663;2212;74;261;225;769;299;1030
500370;201712;21074;60077;14892;49297;2980;11216;5391;17905;8371;29121
500375;201712;2574;7043;1783;5452;358;1193;532;1604;890;2797
500380;201712;3417;8814;2456;7256;627;1946;912;2755;1539;4701
500390;201712;547;1190;316;849;42;127;167;437;209;564
500400;201712;1223;3537;845;2680;205;682;223;682;428;1364
500410;201712;2275;6272;1794;5541;284;870;1079;3437;1363;4307
500430;201712;2634;6984;1864;5856;344;1218;712;2388;1056;3606
500440;201712;1286;3225;798;2395;131;398;298;946;429;1344
500450;201712;1289;3456;738;2367;148;490;99;272;247;762
500460;201712;3793;10792;2508;8245;574;2063;529;1783;1103;3846
500470;201712;2478;7066;1683;5391;498;1748;330;947;828;2695
500480;201712;2167;6506;1959;6226;149;424;1505;5119;1654;5543
500490;201712;877;2288;586;1819;151;529;153;491;304;1020
500500;201712;4005;11198;2829;9444;971;3730;669;2287;1640;6017
500510;201712;812;2075;507;1519;43;146;262;741;305;887
500515;201712;1970;4978;1587;4443;131;366;1093;3192;1224;3558
500520;201712;3189;10745;2660;9691;517;2087;1336;4839;1853;6926
500525;201712;998;3063;792;2717;137;543;385;1358;522;1901
500540;201712;5407;14349;3073;10075;769;3027;294;865;1063;3892
500560;201712;5121;15624;4332;14471;363;1299;3228;10986;3591;12285
500568;201712;4222;9831;2630;7445;632;2067;746;1993;1378;4060
500570;201712;7036;17676;4089;12309;1022;3314;738;2111;1760;5425
500580;201712;3355;9425;2638;8212;377;1196;1585;4977;1962;6173
500600;201712;3529;8991;2281;6918;472;1587;717;2165;1189;3752
500620;201712;7408;20707;5259;16534;788;2651;2443;7771;3231;10422
500625;201712;523;1494;283;951;53;195;110;358;163;553
500627;201712;738;1949;456;1423;90;270;109;362;199;632
500630;201712;5781;14824;3668;11179;867;2827;1020;3152;1887;5979
500635;201712;2620;9349;2113;8567;197;827;1496;6508;1693;7335
500640;201712;1723;3981;1160;3182;60;189;782;2080;842;2269
500660;201712;17892;50705;13246;43186;4223;15250;3031;10017;7254;25267
500690;201712;2424;6940;1731;5823;805;2999;171;534;976;3533
500710;201712;3203;9192;2470;7847;649;2212;734;2320;1383;4532
500720;201712;5368;13827;3235;10281;887;3160;607;1872;1494;5032
500730;201712;918;2520;582;1863;124;413;171;556;295;969
500740;201712;4527;11520;3328;9425;263;875;1844;5281;2107;6156
500750;201712;961;2560;731;2150;122;416;332;910;454;1326
500755;201712;1023;2899;646;2154;126;438;105;300;231;738
500769;201712;5108;13132;2724;8389;514;1781;478;1178;992;2959
500770;201712;1667;4615;1068;3481;192;663;333;1096;525;1759
500780;201712;1296;3408;877;2628;209;650;230;665;439;1315
500790;201712;8669;23083;6990;20440;1336;4289;3673;10788;5009;15077
500793;201712;1988;5479;1413;4479;470;1557;205;576;675;2133
500795;201712;2367;6617;1981;6085;192;492;1494;4911;1686;5403
500797;201712;778;2083;518;1593;102;338;179;530;281;868
500800;201712;2826;7117;1985;5872;684;2288;341;1056;1025;3344
500830;201712;18125;46778;12460;36388;2086;6639;5296;14890;7382;21529
500840;201712;1177;3167;746;2319;91;300;287;839;378;1139
510010;201712;1391;3881;1071;3352;252;767;532;1738;784;2505
510020;201712;3407;9128;1946;6211;416;1384;424;1250;840;2634
510025;201712;6962;19134;4503;14452;878;3067;1288;3952;2166;7019
510030;201712;1962;4724;1399;3935;328;935;573;1652;901;2587
510035;201712;1096;2938;701;2335;118;400;394;1395;512;1795
510040;201712;2061;5018;1516;4229;148;420;914;2566;1062;2986
510050;201712;1824;4867;1241;3878;307;1086;542;1564;849;2650
510060;201712;1396;3716;1040;3143;154;501;512;1508;666;2009
510080;201712;1121;3325;832;2785;235;910;177;483;412;1393
510100;201712;698;1760;472;1344;59;175;216;588;275;763
510120;201712;280;554;159;405;8;24;109;277;117;301
510125;201712;2553;6487;1892;5393;313;1100;760;1977;1073;3077
510130;201712;1553;4166;1195;3569;313;992;328;971;641;1963
510140;201712;2821;8354;2121;7401;838;3335;628;1966;1466;5301
510160;201712;1286;4061;1091;3770;215;762;691;2421;906;3183
510170;201712;4811;13778;3666;11813;759;2634;1538;4912;2297;7546
510180;201712;12217;30518;7935;23636;2141;6866;2181;7246;4322;14112
510185;201712;1660;4443;1144;3704;333;1071;478;1847;811;2918
510190;201712;2359;6482;1578;5257;439;1626;524;1776;963;3402
510250;201712;13476;38579;11585;35900;2742;9010;5848;18802;8590;27812
510260;201712;2071;8607;1690;7851;257;1165;977;5154;1234;6319
510263;201712;3368;9411;2185;7178;478;1701;327;1016;805;2717
510267;201712;5462;15753;3457;11341;775;2662;670;2216;1445;4878
510268;201712;1352;3547;942;2813;129;400;530;1550;659;1950
510269;201712;1073;3131;698;2382;238;900;150;449;388;1349
510270;201712;2807;8813;2154;7555;471;1698;780;2681;1251;4379
510279;201712;1744;5103;1333;4291;290;1047;576;1743;866;2790
510285;201712;1181;3275;853;2714;233;788;240;760;473;1548
510300;201712;3506;9388;2745;8347;279;815;1858;5854;2137;6669
510305;201712;1371;4169;983;3404;224;799;314;1174;538;1973
510310;201712;801;2233;595;1882;211;687;176;589;387;1276
510320;201712;3746;10203;2773;8492;494;1685;913;2762;1407;4447
510325;201712;4786;14617;3889;13282;1085;3843;1871;6678;2956;10521
510330;201712;2811;8868;2050;7499;486;1854;702;2851;1188;4705
510335;201712;4913;14425;3772;12856;417;1503;2378;8645;2795;10148
510336;201712;515;1532;394;1320;71;245;186;642;257;887
510337;201712;1779;5579;1303;4701;511;1958;237;879;748;2837
510340;201712;72399;182351;47668;143545;15220;52005;9155;26992;24375;78997
510343;201712;1030;2990;723;2369;145;495;250;785;395;1280
510345;201712;1422;4182;1063;3471;190;632;431;1386;621;2018
510350;201712;2855;7663;1971;6318;497;1691;733;2427;1230;4118
510360;201712;1663;3908;1081;3169;61;243;784;2304;845;2547
510370;201712;1611;4990;1212;4296;205;771;656;2432;861;3203
510380;201712;505;1398;271;914;72;265;35;117;107;382
510385;201712;982;3641;710;3050;83;415;384;1778;467;2193
510390;201712;1081;3319;860;2988;229;798;384;1423;613;2221
510395;201712;744;1779;512;1423;55;168;262;781;317;949
510410;201712;3897;12102;3158;10683;793;2712;1493;5341;2286;8053
510420;201712;2212;5251;1591;4338;160;534;912;2443;1072;2977
510450;201712;599;1532;359;1100;86;280;58;172;144;452
510452;201712;655;2012;463;1608;84;281;227;798;311;1079
510454;201712;839;2514;655;2177;91;329;366;1233;457;1562
510455;201712;936;2794;668;2201;120;441;233;709;353;1150
510460;201712;2120;5415;1522;4562;169;614;876;2506;1045;3120
510480;201712;4194;10456;2942;8272;461;1365;1361;3643;1822;5008
510490;201712;1513;4539;1218;4119;272;968;602;2035;874;3003
510500;201712;1544;4314;981;3250;171;670;393;1267;564;1937
510510;201712;2978;9747;2407;8609;746;2907;606;2319;1352;5226
510515;201712;5954;16425;3885;12454;888;3109;956;2768;1844;5877
510517;201712;1362;3965;1062;3418;317;1103;183;553;500;1656
510520;201712;2042;4396;1285;3445;50;153;791;2262;841;2415
510523;201712;957;2626;773;2307;92;282;493;1490;585;1772
510525;201712;5103;15214;3964;12887;797;2841;1393;4097;2190;6938
510530;201712;528;1370;389;1160;25;117;285;799;310;916
510550;201712;2815;8813;2074;7408;533;1995;677;2473;1210;4468
510558;201712;1902;5390;1587;4944;95;326;1010;3346;1105;3672
510560;201712;1664;4864;1005;3655;235;944;244;946;479;1890
510562;201712;5209;14685;3790;11954;975;3330;1104;3611;2079;6941
510590;201712;3155;8040;2327;6950;492;1387;1287;4092;1779;5479
510600;201712;1558;3804;999;2899;243;721;332;978;575;1699
510610;201712;2722;7320;2040;6342;211;749;1232;3780;1443;4529
510615;201712;1918;5515;1529;4912;407;1324;701;2393;1108;3717
510617;201712;814;2423;664;2186;39;107;539;1859;578;1966
510618;201712;1346;3786;969;3063;193;711;453;1337;646;2048
510619;201712;729;1953;413;1361;82;311;64;193;146;504
510620;201712;1317;3248;698;2205;179;636;104;302;283;938
510621;201712;1036;3145;811;2726;178;655;249;819;427;1474
510622;201712;3798;11236;2765;8971;888;3133;578;1752;1466;4885
510623;201712;3118;8185;2244;6720;472;1660;721;2060;1193;3720
510624;201712;1663;4463;738;2521;121;470;99;281;220;751
510625;201712;2107;5561;1415;4343;370;1300;230;695;600;1995
510626;201712;1546;3892;957;3027;271;945;196;646;467;1591
510627;201712;596;1620;399;1229;112;363;97;300;209;663
510628;201712;1614;3740;1039;2953;204;570;558;1677;762;2247
510629;201712;1603;5006;1232;4207;328;1209;399;1409;727;2618
510630;201712;2890;8976;1866;6858;428;1689;304;1214;732;2903
510631;201712;435;1171;329;1001;3;6;248;772;251;778
510637;201712;2959;7842;2274;6753;664;2186;746;2169;1410;4355
510642;201712;4888;15268;3978;13901;1138;4306;1594;5823;2732;10129
510645;201712;895;1970;554;1525;155;428;170;490;325;918
510650;201712;6276;18983;5490;18056;894;3018;3891;13312;4785;16330
510665;201712;1737;4351;1042;3126;202;657;364;1122;566;1779
510670;201712;394;848;213;583;21;68;116;326;137;394
510675;201712;6025;17821;4521;14957;1265;4521;944;3122;2209;7643
510677;201712;2036;5324;1485;4545;196;640;902;2834;1098;3474
510680;201712;670;1960;459;1536;109;367;58;188;167;555
510682;201712;1851;5818;1368;4907;383;1495;293;1065;676;2560
510685;201712;881;2399;654;2002;91;305;319;918;410;1223
510700;201712;3949;10078;2631;8171;617;1954;1215;3941;1832;5895
510704;201712;9589;24592;6512;19110;1285;4112;2300;6439;3585;10551
510706;201712;1984;5689;1281;4615;252;976;616;2416;868;3392
510710;201712;2742;7438;1872;5684;385;1202;647;1873;1032;3075
510715;201712;715;1693;489;1324;70;186;195;536;265;722
510718;201712;2535;5661;1418;4331;600;1888;246;981;846;2869
510719;201712;380;858;234;661;31;111;124;343;155;454
510720;201712;1029;2600;694;2077;179;596;202;559;381;1155
510724;201712;719;2056;508;1669;98;358;213;659;311;1017
510726;201712;733;1600;468;1216;60;177;316;785;376;962
510729;201712;701;1705;346;1039;62;206;90;263;152;469
510730;201712;2995;7933;2059;6314;536;1727;634;1974;1170;3701
510735;201712;949;2902;723;2580;92;361;463;1680;555;2041
510740;201712;1273;3492;908;2906;91;260;581;2013;672;2273
510757;201712;632;2077;517;1864;211;793;173;619;384;1412
510760;201712;34944;82049;21216;61219;6165;19922;4342;11632;10507;31554
510770;201712;4597;10534;3520;9310;353;827;2261;6701;2614;7528
510774;201712;366;1026;280;839;55;157;135;432;190;589
510775;201712;616;1788;459;1513;113;439;81;238;194;677
510776;201712;460;1281;354;1060;86;255;138;426;224;681
510777;201712;1679;4727;1219;4107;101;365;946;3212;1047;3577
510779;201712;584;1692;465;1488;56;156;281;935;337;1091
510780;201712;3507;10085;2771;8934;724;2398;1065;3796;1789;6194
510785;201712;1996;5394;1205;3937;293;1072;174;570;467;1642
510787;201712;2350;6728;1746;5634;798;2707;196;592;994;3299
510788;201712;657;1634;453;1325;78;216;180;633;258;849
510790;201712;14366;40105;9145;30029;2158;8146;1103;3272;3261;11418
510792;201712;8535;23687;5507;17987;1158;4127;1111;3554;2269;7681
510794;201712;1181;3527;848;2884;253;956;189;573;442;1529
510795;201712;7930;22615;5589;18315;1501;5383;1085;3675;2586;9058
510800;201712;1560;4146;1126;3500;235;757;511;1539;746;2296
510805;201712;1873;5148;1274;4051;259;878;477;1407;736;2285
510810;201712;646;1494;464;1252;114;327;234;608;348;935
510820;201712;814;1686;454;1217;64;211;190;486;254;697
510830;201712;733;1972;541;1682;111;339;267;882;378;1221
510835;201712;604;1641;419;1323;62;207;196;597;258;804
510840;201712;41741;102607;32343;90261;7139;19943;15866;46853;23005;66796
510850;201712;1695;4344;1009;3181;323;1163;181;502;504;1665
510860;201712;2711;7867;1816;6233;608;2367;184;614;792;2981
510880;201712;592;1892;489;1696;131;485;215;758;346;1243
510885;201712;583;1569;424;1337;79;284;155;463;234;747
510890;201712;717;2166;589;1986;115;423;321;1097;436;1520
510895;201712;1234;3456;898;2864;227;809;303;879;530;1688
520005;201712;1886;5381;1542;4940;457;1393;691;2493;1148;3886
520010;201712;2121;6587;1531;5338;516;2026;265;798;781;2824
520013;201712;2841;7881;2058;6328;480;1532;592;1922;1072;3454
520015;201712;525;1432;404;1264;113;376;110;372;223;748
520017;201712;1057;3023;843;2683;195;663;398;1253;593;1916
520020;201712;385;964;306;856;74;223;167;454;241;677
520025;201712;31394;91265;27928;86800;3327;11081;20234;62930;23561;74011
520030;201712;4955;14190;3977;12616;554;1883;2238;7197;2792;9080
520050;201712;444;1101;272;781;23;58;154;463;177;521
520055;201712;878;2563;725;2275;95;290;398;1259;493;1549
520060;201712;1402;4150;1108;3603;278;1003;299;948;577;1951
520080;201712;1881;5053;1463;4479;264;784;719;2401;983;3185
520082;201712;1049;2686;908;2456;109;239;571;1601;680;1840
520085;201712;715;2121;601;1929;147;465;196;605;343;1070
520090;201712;865;1923;605;1601;114;269;348;992;462;1261
520110;201712;39115;109660;28634;93123;10218;37856;1997;5955;12215;43811
520120;201712;188;466;106;328;9;29;41;128;50;157
520130;201712;3582;9570;3047;8716;644;1941;1551;4575;2195;6516
520140;201712;34380;104391;27586;91982;10022;36399;3059;10425;13081;46824
520145;201712;436;1136;299;910;68;218;95;274;163;492
520150;201712;536;1334;415;1183;70;202;236;679;306;881
520160;201712;836;2101;648;1826;119;337;281;814;400;1151
520170;201712;4869;10395;3601;8979;227;604;2996;7531;3223;8135
520180;201712;2110;6002;1739;5445;419;1420;751;2316;1170;3736
520215;201712;1937;4785;1474;4070;289;906;732;1955;1021;2861
520235;201712;657;1613;440;1283;62;194;168;469;230;663
520250;201712;1549;4163;1103;3462;297;1019;192;615;489;1634
520260;201712;800;1974;495;1431;82;245;199;577;281;822
520280;201712;611;1673;496;1464;160;460;187;607;347;1067
520310;201712;1242;2878;827;2224;222;609;287;844;509;1453
520320;201712;1912;5584;1532;4921;159;547;865;2835;1024;3382
520330;201712;3163;9414;2308;7906;553;2123;739;2515;1292;4638
520340;201712;2117;5022;1487;4132;171;416;989;2884;1160;3300
520350;201712;3104;8027;2288;6615;666;2074;753;2096;1419;4170
520355;201712;1621;4597;1297;4071;335;1147;535;1672;870;2819
520357;201712;823;2101;644;1829;46;141;446;1279;492;1420
520360;201712;707;1939;552;1680;171;548;161;504;332;1052
520380;201712;1335;3491;818;2483;117;400;362;994;479;1394
520390;201712;979;2275;569;1733;183;631;140;403;323;1034
520393;201712;542;1303;387;1054;43;118;192;492;235;610
520396;201712;774;2249;657;2043;101;320;428;1323;529;1643
520400;201712;1470;4066;1213;3699;239;750;714;2195;953;2945
520410;201712;1654;3698;1082;2910;139;398;655;1768;794;2166
520420;201712;359;933;262;732;26;85;177;462;203;547
520425;201712;1363;3373;925;2640;246;724;388;1115;634;1839
520430;201712;2136;5255;1150;3564;214;724;72;225;286;949
520440;201712;3504;8738;2248;6537;615;1916;531;1510;1146;3426
520450;201712;11140;28993;7492;22799;2284;7605;478;1494;2762;9099
520455;201712;688;1954;517;1691;183;652;128;427;311;1079
520460;201712;934;2608;782;2384;107;323;535;1663;642;1986
520465;201712;842;2278;698;2045;112;371;438;1217;550;1588
520470;201712;1825;5518;1562;5152;341;1126;949;3316;1290;4442
520480;201712;821;2384;523;1843;118;459;88;294;206;753
520485;201712;1492;4315;1237;3962;166;584;847;2710;1013;3294
520490;201712;3809;11354;2975;10056;717;2404;1484;5198;2201;7602
520495;201712;1423;3495;1143;3128;79;230;852;2399;931;2629
520500;201712;1330;3668;1038;3199;242;840;414;1233;656;2073
520505;201712;724;1850;527;1577;119;347;260;785;379;1132
520510;201712;6933;19070;5082;16173;1216;4306;1392;4529;2608;8835
520520;201712;1081;2798;817;2424;244;723;262;862;506;1585
520530;201712;1834;5946;1463;5296;546;1955;338;1438;884;3393
520540;201712;2740;7442;1829;5700;452;1444;371;1214;823;2658
520545;201712;1012;2849;786;2468;155;515;265;811;420;1326
520547;201712;685;2055;551;1810;160;533;201;643;361;1176
520549;201712;10502;30398;8615;27465;1965;6452;4312;14074;6277;20526
520551;201712;4047;11728;3496;10919;543;1928;2293;7029;2836;8957
520552;201712;742;2130;661;2032;91;267;469;1499;560;1766
520570;201712;597;1538;425;1273;111;347;145;441;256;788
520580;201712;2825;6521;1959;5405;249;734;1213;3393;1462;4127
520590;201712;1329;3747;975;3105;217;717;198;645;415;1362
520620;201712;8029;22593;6586;20595;1832;5965;2826;9025;4658;14990
520630;201712;1019;2544;655;1946;104;316;228;654;332;970
520640;201712;2569;6749;2031;5857;459;1345;844;2483;1303;3828
520650;201712;882;2242;612;1768;99;298;326;949;425;1247
520660;201712;445;1081;257;775;66;219;52;171;118;390
520670;201712;981;2820;831;2602;66;223;617;1906;683;2129
520680;201712;755;1954;566;1654;125;364;252;756;377;1120
520690;201712;355;854;233;679;69;207;73;228;142;435
520710;201712;567;1425;359;1040;12;33;229;647;241;680
520725;201712;1588;3885;1142;3152;140;445;734;1977;874;2422
520735;201712;803;2088;552;1635;112;341;186;557;298;898
520740;201712;1801;4507;1446;4066;234;650;856;2477;1090;3127
520750;201712;696;1748;520;1484;103;271;238;731;341;1002
520753;201712;1465;3791;1250;3440;173;450;717;2042;890;2492
520760;201712;1001;2358;895;2220;93;184;711;1855;804;2039
520780;201712;1766;4326;1317;3678;146;427;731;1985;877;2412
520790;201712;3102;7623;2261;6359;181;477;1528;4494;1709;4971
520800;201712;15532;42104;12962;38884;2453;7161;7949;25308;10402;32469
520810;201712;1271;2844;915;2436;152;454;512;1430;664;1884
520815;201712;646;1975;467;1592;140;520;68;254;208;774
520830;201712;1684;4050;1269;3563;72;151;1002;2829;1074;2980
520840;201712;1972;5806;1628;5332;667;2288;419;1494;1086;3782
520850;201712;644;1795;440;1474;121;460;105;353;226;813
520860;201712;6365;18168;4869;15773;1136;3976;1751;5811;2887;9787
520870;201712;87834;223229;62580;184754;18371;59173;15136;43613;33507;102786
520880;201712;6392;18296;5004;16173;1699;5942;1062;3414;2761;9356
520890;201712;3909;10218;2863;8511;637;2145;1207;3495;1844;5640
520910;201712;3966;10451;2617;8099;825;2789;447;1383;1272;4172
520915;201712;649;1851;481;1505;91;307;189;579;280;886
520920;201712;3980;9891;2695;8042;410;1362;1279;3863;1689;5225
520929;201712;661;1713;503;1432;92;217;259;819;351;1036
520940;201712;1130;3076;879;2723;69;227;658;2051;727;2278
520945;201712;565;1294;439;1087;49;110;287;693;336;803
520960;201712;996;2733;782;2369;139;447;394;1174;533;1621
520970;201712;2451;7340;2063;6636;592;2086;479;1589;1071;3675
520980;201712;757;2049;625;1850;153;497;266;776;419;1273
520990;201712;2906;9032;2628;8607;367;1253;1614;5432;1981;6685
520993;201712;964;2371;686;1929;38;106;487;1383;525;1489
520995;201712;2205;5832;1815;5310;423;1250;847;2508;1270;3758
521000;201712;7482;21469;5680;18056;1703;5760;1356;4304;3059;10064
521010;201712;4004;10816;3017;9105;493;1459;1513;4599;2006;6058
521015;201712;660;1738;564;1584;76;214;400;1120;476;1334
521020;201712;2932;8051;1856;5860;518;1760;197;590;715;2350
521030;201712;598;1443;430;1179;60;147;205;598;265;745
521040;201712;6850;17501;5373;15243;1593;4749;1889;5579;3482;10328
521056;201712;830;2343;652;2047;203;666;176;606;379;1272
521060;201712;1030;2641;792;2270;73;214;449;1327;522;1541
521080;201712;1102;2610;593;1750;73;226;219;573;292;799
521090;201712;3054;7994;2252;6766;704;2243;464;1428;1168;3671
521100;201712;1836;4313;1343;3623;235;617;757;2102;992;2719
521120;201712;4813;11541;3494;9891;541;1518;1563;4934;2104;6452
521130;201712;1019;2560;687;1944;45;158;388;1077;433;1235
521140;201712;1147;3171;861;2650;163;532;307;954;470;1486
521150;201712;11671;28053;7492;21477;2181;6816;2353;6921;4534;13737
521160;201712;724;1642;481;1267;87;253;225;554;312;807
521170;201712;1107;2672;793;2190;87;249;500;1323;587;1572
521180;201712;6235;19055;5293;17300;1236;4294;1959;6443;3195;10737
521190;201712;9670;26051;5799;19022;1462;5199;1035;3501;2497;8700
521200;201712;772;2021;566;1669;64;211;306;888;370;1099
521205;201712;620;1643;472;1398;34;107;331;956;365;1063
521210;201712;818;2224;465;1462;112;393;62;151;174;544
521220;201712;4188;10270;2897;8396;605;1870;1074;3069;1679;4939
521225;201712;349;846;279;767;25;54;210;612;235;666
521230;201712;1279;3683;1172;3511;439;1311;564;1741;1003;3052
521250;201712;30639;88586;24964;80330;10455;34623;6786;23542;17241;58165
521260;201712;710;1666;542;1427;92;274;301;779;393;1053
521270;201712;1787;4831;1561;4553;130;286;1223;3715;1353;4001
521280;201712;1903;5417;1459;4606;460;1564;438;1388;898;2952
521290;201712;446;1179;335;1029;66;245;180;532;246;777
521295;201712;1180;2688;940;2390;89;202;710;1895;799;2097
521300;201712;1862;4881;1507;4387;205;590;1017;3041;1222;3631
521305;201712;738;1940;549;1626;85;242;287;864;372;1106
521308;201712;4442;12722;3364;10625;655;2109;1595;5092;2250;7201
521310;201712;8321;22854;5576;17677;1436;4886;1413;4354;2849;9240
521340;201712;367;903;306;819;22;60;242;650;264;710
521350;201712;2123;5430;1652;4726;225;669;1097;3093;1322;3762
521370;201712;1043;2815;655;2119;195;711;62;199;257;910
521375;201712;1428;3874;1071;3361;272;918;397;1298;669;2216
521377;201712;1269;2952;1023;2646;52;136;893;2312;945;2448
521380;201712;6097;16534;4145;12985;494;1621;1060;3464;1554;5085
521385;201712;594;1486;475;1347;118;336;206;630;324;966
521390;201712;752;1973;557;1689;177;596;170;525;347;1121
521400;201712;2164;5452;1756;4990;218;702;1263;3565;1481;4267
521405;201712;1353;3612;1026;3051;235;718;447;1357;682;2075
521410;201712;741;2081;626;1917;142;393;319;1061;461;1454
521440;201712;1434;3929;1087;3274;281;891;270;759;551;1650
521450;201712;3796;11830;2924;10040;823;2944;685;2449;1508;5393
521460;201712;6541;18152;5091;15566;1592;5174;1523;4509;3115;9683
521470;201712;612;1751;412;1305;78;239;95;289;173;528
521480;201712;371;1043;218;726;44;155;61;197;105;352
521483;201712;2562;6550;1873;5371;488;1459;537;1523;1025;2982
521486;201712;1672;4063;1308;3567;85;215;996;2708;1081;2923
521487;201712;484;1240;337;1020;76;243;134;412;210;655
521490;201712;826;2288;622;1930;39;151;422;1272;461;1423
521500;201712;1581;4264;1111;3468;159;578;563;1656;722;2234
521520;201712;809;1850;565;1503;101;273;256;710;357;983
521523;201712;13634;45950;11882;42444;3780;14443;2504;9602;6284;24045
521525;201712;1036;2540;819;2228;84;247;534;1419;618;1666
521530;201712;2123;5604;1287;3967;285;937;296;939;581;1876
521540;201712;877;2293;566;1757;91;350;250;764;341;1114
521550;201712;1452;3660;901;2553;184;564;347;993;531;1557
521560;201712;3673;11007;2776;9787;732;2914;1289;4689;2021;7603
521565;201712;607;1495;496;1352;80;211;321;868;401;1079
521570;201712;4051;11033;2634;8263;585;1989;355;1142;940;3131
521580;201712;560;1341;307;929;45;146;62;186;107;332
521590;201712;613;1615;467;1364;122;406;190;515;312;921
521600;201712;414;1175;267;855;61;188;58;182;119;370
521630;201712;1422;3363;919;2633;222;714;269;734;491;1448
521640;201712;2063;5067;1544;4353;373;1045;685;1985;1058;3030
521645;201712;588;1650;383;1256;89;310;98;307;187;617
521680;201712;1207;3816;968;3322;312;1130;110;386;422;1516
521690;201712;479;1367;430;1284;102;315;218;639;320;954
521710;201712;3006;8232;2141;6699;440;1455;433;1335;873;2790
521720;201712;2009;5394;1527;4546;224;706;821;2368;1045;3074
521730;201712;3758;11514;3035;10138;1071;3936;479;1383;1550;5319
521740;201712;3771;10321;2951;9102;758;2579;1123;3655;1881;6234
521760;201712;14084;42771;11733;38945;3467;12571;3862;13194;7329;25765
521770;201712;2787;7518;2024;6102;669;2174;469;1358;1138;3532
521800;201712;6015;17692;5009;15983;1499;5019;1614;5553;3113;10572
521805;201712;861;1906;588;1524;199;488;217;622;416;1110
521810;201712;732;1761;504;1428;97;296;217;647;314;943
521830;201712;5179;15373;4362;14160;526;1890;2878;9265;3404;11155
521839;201712;683;1816;489;1464;106;345;187;533;293;878
521850;201712;5689;14990;4174;12520;1157;3756;716;2063;1873;5819
521860;201712;1848;4765;1347;3988;239;783;461;1349;700;2132
521870;201712;527;1623;412;1415;98;349;122;401;220;750
521878;201712;700;1954;496;1548;83;295;179;509;262;804
521880;201712;20407;50933;13749;40598;3519;10940;4205;12994;7724;23934
521890;201712;3196;9103;2248;7170;570;1946;305;905;875;2851
521900;201712;1477;3688;962;2922;219;676;312;935;531;1611
521910;201712;1184;2727;816;2289;87;253;494;1460;581;1713
521920;201712;369;1093;278;912;63;233;80;270;143;503
521925;201712;629;1838;486;1576;102;332;143;450;245;782
521930;201712;3865;10942;3039;9669;999;3208;868;2928;1867;6136
521935;201712;662;1809;528;1558;133;377;222;659;355;1036
521940;201712;1216;2976;868;2499;215;698;388;1087;603;1785
521945;201712;583;1757;485;1583;89;298;233;811;322;1109
521950;201712;637;1568;513;1409;39;111;400;1107;439;1218
521960;201712;685;1946;484;1544;82;280;213;652;295;932
521970;201712;2662;6906;2229;6388;144;371;1821;5409;1965;5780
521971;201712;905;2335;611;1846;132;416;151;454;283;870
521973;201712;1049;3010;868;2727;123;434;496;1540;619;1974
521975;201712;12376;33503;10708;31342;1796;5454;6840;20111;8636;25565
521980;201712;2384;6059;1931;5469;207;527;1455;4209;1662;4736
521990;201712;1168;3264;924;2879;127;398;542;1747;669;2145
522000;201712;2809;8501;2193;7707;207;687;1415;5385;1622;6072
522005;201712;346;840;247;690;74;189;86;262;160;451
522010;201712;3553;9458;2747;8160;893;2760;648;1917;1541;4677
522015;201712;972;2680;735;2312;164;548;286;898;450;1446
522020;201712;5092;12782;3596;10378;887;2668;1498;4350;2385;7018
522026;201712;708;1932;534;1703;84;278;287;967;371;1245
522028;201712;514;1410;376;1115;67;201;160;445;227;646
522040;201712;2580;5945;1841;5022;284;797;1217;3334;1501;4131
522045;201712;15807;48585;12288;41602;3218;11800;2337;7822;5555;19622
522050;201712;1110;3049;746;2374;163;537;239;695;402;1232
522060;201712;2436;6955;1972;6250;335;1102;1084;3531;1419;4633
522068;201712;1705;4959;1452;4659;189;546;1023;3463;1212;4009
522070;201712;631;1756;524;1588;54;220;360;1042;414;1262
522100;201712;554;1529;426;1343;84;278;214;679;298;957
522108;201712;825;2472;684;2243;50;233;517;1627;567;1860
522119;201712;1549;4235;1237;3803;215;677;642;2043;857;2720
522130;201712;371;987;276;857;68;225;132;422;200;647
522140;201712;16194;45200;12391;38465;3932;13052;1952;5938;5884;18990
522145;201712;814;2086;612;1790;148;392;326;1038;474;1430
522150;201712;954;2388;743;2076;217;598;270;785;487;1383
522155;201712;882;2452;735;2219;153;416;372;1194;525;1610
522157;201712;584;1595;489;1456;30;115;357;1039;387;1154
522160;201712;6276;16933;4227;13199;1201;4070;387;1321;1588;5391
522170;201712;2328;6582;1699;5428;568;1919;324;1047;892;2966
522180;201712;431;1147;274;873;65;214;45;163;110;377
522185;201712;15670;41668;12188;37183;4372;14156;4080;13458;8452;27614
522190;201712;844;2019;638;1723;123;313;283;819;406;1132
522200;201712;1709;5263;1223;4198;261;944;194;665;455;1609
522205;201712;1414;3602;1100;3138;103;324;773;2222;876;2546
522220;201712;1497;3729;1117;3205;170;455;615;1876;785;2331
522230;201712;1233;3261;1012;2932;172;553;577;1679;749;2232
530010;201712;174051;519223;150405;479650;34320;121415;69601;216380;103921;337795
110001;201711;3225;10134;2657;9163;708;2581;1147;4002;1855;6583
110002;201711;11390;31743;8522;26879;2697;9147;2693;8381;5390;17528
110003;201711;680;2066;518;1734;161;575;98;304;259;879
110004;201711;8053;24645;6329;21219;1930;6807;1261;4597;3191;11404
110005;201711;2007;5696;1426;4645;350;1204;536;1796;886;3000
110006;201711;1633;4797;1052;3574;315;1135;121;410;436;1545
110007;201711;1239;3571;1003;3159;322;1061;342;1254;664;2315
110008;201711;2369;7757;2160;7468;274;881;1665;6006;1939;6887
110009;201711;4085;12132;3005;10343;915;3271;903;3265;1818;6536
110010;201711;5876;20037;5036;18634;1534;5555;2151;8920;3685;14475
110011;201711;6313;18838;5070;16448;1710;5786;1219;4017;2929;9803
110012;201711;13806;38015;10212;31854;2737;8945;2000;6366;4737;15311
110013;201711;5211;16149;4336;14476;1761;6061;862;3127;2623;9188
110014;201711;3586;9981;2804;8673;849;2723;1146;3482;1995;6205
110015;201711;4670;13504;3080;10307;835;2958;418;1406;1253;4364
110018;201711;3410;9313;2310;7492;570;2088;656;2041;1226;4129
110020;201711;64274;169219;46330;144235;10452;34421;18140;59926;28592;94347
110025;201711;4142;11334;3162;9650;523;1703;1850;5540;2373;7243
110026;201711;510;1552;447;1445;132;468;189;606;321;1074
110028;201711;5875;17012;4234;13803;1268;4446;517;1659;1785;6105
110029;201711;1197;3199;866;2699;225;717;369;1164;594;1881
110030;201711;9864;26336;7371;22690;1646;5700;2912;8911;4558;14611
110032;201711;3197;9791;2479;8290;868;2938;596;2015;1464;4953
110033;201711;4346;14073;3655;12770;1318;4650;1025;3956;2343;8606
110034;201711;3278;8691;2507;7589;836;2671;1119;3409;1955;6080
110037;201711;1662;5485;1394;4932;346;1276;645;2260;991;3536
110040;201711;2962;8967;2316;7756;747;2670;636;2049;1383;4719
110045;201711;4583;14448;3941;13551;1305;4835;1571;5390;2876;10225
110050;201711;1595;4917;1268;4285;539;1878;310;1052;849;2930
110060;201711;785;2515;590;2097;212;799;68;263;280;1062
110070;201711;1901;6270;1572;5508;571;2089;392;1329;963;3418
110080;201711;4654;12397;3713;11244;1020;3236;1769;5552;2789;8788
110090;201711;624;1765;443;1431;118;414;186;574;304;988
110092;201711;1155;3611;976;3335;171;647;540;1877;711;2524
110094;201711;3085;9123;2485;8161;852;2888;820;2766;1672;5654
110100;201711;1898;5922;1654;5468;363;1287;853;2807;1216;4094
110110;201711;1563;4739;1225;4215;439;1579;275;1015;714;2594
110120;201711;1471;4546;1109;3781;332;1196;236;805;568;2001
110130;201711;2362;6358;1605;5079;420;1482;494;1538;914;3020
110140;201711;2183;7009;1669;5945;456;1716;398;1387;854;3103
110143;201711;1387;3911;1007;3192;343;1121;278;883;621;2004
110145;201711;1004;2824;668;2178;166;585;223;718;389;1303
110146;201711;402;1164;300;1010;59;191;143;507;202;698
110147;201711;628;1778;431;1394;108;359;157;484;265;843
110148;201711;1010;3059;611;2116;110;410;74;261;184;671
110149;201711;2921;8589;2158;7338;849;2843;640;2359;1489;5202
110150;201711;2114;6057;1682;5405;720;2558;381;1155;1101;3713
110155;201711;706;2203;595;1954;134;470;237;752;371;1222
110160;201711;1612;5162;1276;4454;473;1635;294;1085;767;2720
110170;201711;2218;6234;1606;5095;350;1168;772;2422;1122;3590
110175;201711;1438;4311;1133;3863;181;665;585;2099;766;2764
110180;201711;1126;3237;899;2852;272;839;387;1275;659;2114
120001;201711;2737;8938;2407;8439;501;1765;1405;5195;1906;6960
120005;201711;1684;6748;1555;6524;177;802;1150;5004;1327;5806
120010;201711;4792;15933;4499;15465;619;2058;3237;11494;3856;13552
120013;201711;2012;7951;1909;7806;508;2008;1094;4817;1602;6825
120017;201711;1955;6907;1785;6610;399;1503;984;3897;1383;5400
120020;201711;13824;60199;13210;58997;1561;7422;9781;44780;11342;52202
120025;201711;2407;8002;2211;7735;461;1640;1338;4814;1799;6454
120030;201711;6328;25071;6160;24818;343;1714;5263;21255;5606;22969
120032;201711;1573;7442;1497;7261;116;689;1163;5636;1279;6325
120033;201711;3780;14760;3588;14427;167;860;3128;12554;3295;13414
120034;201711;2209;8745;1985;8357;143;855;1571;6494;1714;7349
120035;201711;3219;14201;3111;13999;265;1367;2497;11362;2762;12729
120038;201711;2562;8914;2386;8601;589;2177;1289;4787;1878;6964
120039;201711;1810;8444;1754;8341;178;1086;1320;6280;1498;7366
120040;201711;40200;140416;36769;134533;7586;29549;20743;77249;28329;106798
120042;201711;3063;12317;2868;11885;176;924;2280;9420;2456;10344
120043;201711;1132;5143;1081;5030;62;367;934;4359;996;4726
120045;201711;4833;15285;4524;14949;217;830;4113;13559;4330;14389
120050;201711;8074;32177;7671;31394;852;3863;5690;23760;6542;27623
120060;201711;8054;34674;7764;34155;593;3168;6385;28259;6978;31427
120070;201711;2686;9600;2549;9349;360;1299;1762;6682;2122;7981
120080;201711;3758;13823;3530;13428;609;2421;2406;9324;3015;11745
130002;201711;3114;12829;2892;12514;120;659;2591;11245;2711;11904
130006;201711;2190;8921;1889;8363;140;740;1440;6370;1580;7110
130008;201711;2345;8823;2131;8448;92;480;1777;7055;1869;7535
130010;201711;3611;10784;3213;10328;91;357;2968;9545;3059;9902
130014;201711;3049;9670;2570;8867;422;1539;1655;5787;2077;7326
130020;201711;2663;10368;2505;10100;136;789;2048;8179;2184;8968
130030;201711;8640;30818;8135;30263;174;465;7677;29091;7851;29556
130040;201711;3818;11548;3269;10827;228;779;2599;8746;2827;9525
130050;201711;6361;25579;5938;25020;228;940;5339;22969;5567;23909
130060;201711;6587;28552;5940;27593;531;3108;4611;21381;5142;24489
130063;201711;4734;18686;4369;18250;151;762;4015;16880;4166;17642
130068;201711;3256;13187;2919;12494;228;1193;2218;9493;2446;10686
130070;201711;8109;26253;7121;25148;374;1235;6210;22467;6584;23702
130080;201711;5741;24254;5268;23607;457;2563;4148;18663;4605;21226
130083;201711;2380;8930;2192;8655;221;1022;1693;6661;1914;7683
130090;201711;2967;9972;2755;9683;64;279;2471;8819;2535;9098
130100;201711;6249;21836;5869;21420;108;376;5606;20643;5714;21019
130110;201711;6863;21474;6275;20762;555;1592;5273;17994;5828;19586
130115;201711;4967;16795;4630;16317;127;470;4073;14501;4200;14971
130120;201711;14659;54848;13679;53569;1384;5632;11028;44085;12412;49717
130130;201711;4437;16364;3941;15706;472;2164;2973;11773;3445;13937
130140;201711;6314;24407;6151;24220;231;1003;5708;22562;5939;23565
130150;201711;3441;13699;3333;13554;118;701;3032;12274;3150;12975
130160;201711;4476;17735;4141;17299;337;1688;3428;14472;3765;16160
130165;201711;3002;12097;2862;11853;123;697;2504;10342;2627;11039
130170;201711;10326;33511;8635;31474;710;2828;7042;26184;7752;29012
130180;201711;3898;12503;3717;12286;51;230;3538;11685;3589;11915
130185;201711;13908;39776;11792;37483;518;1196;10344;34354;10862;35550
130190;201711;16703;57527;14522;54543;1900;7156;10468;40764;12368;47920
130195;201711;2104;8502;1902;8238;91;406;1699;7468;1790;7874
130200;201711;2063;6711;1828;6379;171;588;1414;5085;1585;5673
130210;201711;1396;5361;1265;5206;115;653;998;4033;1113;4686
130220;201711;1998;7891;1836;7603;144;715;1394;5828;1538;6543
130230;201711;3813;17449;3525;17010;347;1941;2826;13837;3173;15778
130240;201711;9657;33354;8400;31554;235;1366;7387;27809;7622;29175
130250;201711;22156;72682;20344;70562;1635;5526;16903;60284;18538;65810
130255;201711;4083;14533;3753;13988;268;1187;3039;11361;3307;12548
130260;201711;230848;733314;204005;689421;61975;223247;83908;287238;145883;510485
130270;201711;7441;30228;6762;29144;811;3706;4983;22148;5794;25854
130280;201711;3401;14076;3244;13897;84;379;3045;13209;3129;13588
130290;201711;11711;41294;10781;40241;225;552;10228;39001;10453;39553
130300;201711;4540;16985;4268;16577;238;1184;3680;14290;3918;15474
130310;201711;5434;20078;4927;19400;387;1578;4071;16326;4458;17904
130320;201711;3035;10862;2764;10490;341;1261;2007;7887;2348;9148
130330;201711;4004;13939;3505;13299;154;783;3047;11540;3201;12323
130340;201711;19394;70504;17650;68410;1560;5965;14708;58646;16268;64611
130350;201711;3614;14155;3422;13877;192;1117;2925;11740;3117;12857
130353;201711;6125;18638;5352;17650;886;2782;3704;13003;4590;15785
130356;201711;4690;16600;4288;15951;504;1977;3066;11689;3570;13666
130360;201711;3284;9591;2857;9140;91;235;2663;8661;2754;8896
130370;201711;5611;22018;5085;21321;201;1153;4385;18421;4586;19574
130380;201711;7490;31434;7211;31012;476;2527;6203;26529;6679;29056
130390;201711;5253;23316;4928;22704;523;2797;3700;17033;4223;19830
130395;201711;2320;7842;2046;7353;238;889;1459;5282;1697;6171
130400;201711;2229;8052;2050;7799;114;469;1810;6941;1924;7410
130406;201711;10789;40410;9660;38879;1777;7413;6601;27107;8378;34520
130410;201711;3983;14719;3500;13879;1033;4292;1677;6867;2710;11159
130420;201711;11235;45206;10431;44137;1180;5412;8233;35386;9413;40798
130423;201711;3683;13264;3383;12870;178;923;2939;11060;3117;11983
130426;201711;2550;10466;2467;10330;91;425;2257;9555;2348;9980
130430;201711;3794;12414;3534;12054;428;1432;2747;9541;3175;10973
130440;201711;3980;13590;3643;13196;112;419;3370;12318;3482;12737
140002;201711;1780;5716;1613;5502;114;481;1270;4277;1384;4758
140005;201711;3354;9289;3199;9124;87;275;3046;8686;3133;8961
140010;201711;48887;138299;39342;124437;9780;32569;15544;52354;25324;84923
140015;201711;3205;10101;2900;9745;179;558;2517;8660;2696;9218
140017;201711;3359;10765;3008;10304;291;987;2249;8062;2540;9049
140020;201711;4755;15178;4178;14401;403;1664;3152;10838;3555;12502
140023;201711;2177;7065;1857;6573;249;920;1293;4673;1542;5593
140028;201711;2053;5566;1812;5247;208;683;1360;3836;1568;4519
140030;201711;3819;11625;3489;11201;396;1156;2728;8999;3124;10155
140040;201711;1876;8323;1792;8206;87;512;1630;7439;1717;7951
140045;201711;2558;9546;2204;9043;404;1610;1441;6286;1845;7896
140047;201711;5879;17763;5063;16485;1110;3643;2665;9214;3775;12857
140050;201711;1419;4327;1217;4029;169;540;814;2776;983;3316
140060;201711;1377;4020;1228;3800;119;365;971;3040;1090;3405
140070;201711;1720;9383;1663;9226;150;1046;1295;7156;1445;8202
150010;201711;38978;106448;36327;102887;1579;5189;31340;88211;32919;93400
150013;201711;1762;4993;1513;4709;136;374;1145;3712;1281;4086
150020;201711;12655;41603;12197;40970;1334;3584;10034;35088;11368;38672
150030;201711;8181;32726;7702;32112;446;1904;6710;28379;7156;30283
150034;201711;4049;11108;3535;10383;267;827;2878;8495;3145;9322
150040;201711;12840;39075;11417;37412;1122;2878;9298;32349;10420;35227
150050;201711;6211;23300;5839;22736;173;880;5260;20526;5433;21406
150060;201711;18215;54973;16092;51623;3750;11859;8885;29892;12635;41751
150070;201711;6267;24851;5635;24151;179;959;5177;22417;5356;23376
150080;201711;79643;199211;68056;183925;15705;43724;28306;84449;44011;128173
150085;201711;5830;19056;5483;18632;263;762;4974;17231;5237;17993
150090;201711;10085;38482;9563;37655;764;3287;7642;30361;8406;33648
150095;201711;5374;17150;4866;16447;293;924;3999;13886;4292;14810
150100;201711;3118;11306;2842;10806;223;919;2177;8281;2400;9200
150110;201711;3703;17256;3657;17192;224;1062;3260;15522;3484;16584
150120;201711;6885;23981;6696;23702;341;1002;5861;21419;6202;22421
150125;201711;736;2052;614;1904;113;397;373;1134;486;1531
150130;201711;22157;66295;19972;63175;2547;7317;14433;47378;16980;54695
150140;201711;181707;480050;165072;458127;25196;68630;109776;314304;134972;382934
150145;201711;4566;13965;4051;13266;602;1755;3029;10331;3631;12086
150150;201711;12740;36745;11689;35297;1304;4091;8668;26542;9972;30633
150157;201711;3120;9182;2666;8572;315;1110;1841;6043;2156;7153
150160;201711;2958;9285;2782;9001;683;2194;1553;5187;2236;7381
150170;201711;23668;80347;21056;76366;3593;12672;13358;51442;16951;64114
150172;201711;3516;10999;2969;10163;294;965;2222;7848;2516;8813
150175;201711;1764;5406;1602;5170;145;533;1237;4054;1382;4587
150178;201711;9876;28993;8337;27153;606;2024;6651;22219;7257;24243
150180;201711;19581;76242;18653;75017;1041;4473;16189;65943;17230;70416
150190;201711;6877;23642;6613;23292;206;875;6022;21297;6228;22172
150195;201711;5440;17456;5191;17060;109;390;4776;15734;4885;16124
150200;201711;5405;16630;5031;16207;68;190;4774;15533;4842;15723
150210;201711;24564;91098;23593;89775;1865;7099;19375;75875;21240;82974
150215;201711;7305;22538;6416;21155;2098;6991;2561;8917;4659;15908
150220;201711;10787;33068;9732;31467;1931;6162;5510;18599;7441;24761
150230;201711;12190;36521;10636;34422;1635;5082;7046;24077;8681;29159
150240;201711;32544;95436;27509;86407;9320;30032;7169;23447;16489;53479
150250;201711;4128;16960;3986;16755;634;2671;2904;12571;3538;15242
150260;201711;2229;8212;2107;8017;258;981;1519;5894;1777;6875
150270;201711;8030;23693;6048;21031;1804;6413;2570;9479;4374;15892
150275;201711;5982;20922;5604;20346;445;1635;4481;16475;4926;18110
150276;201711;2217;6393;1930;6045;277;871;1429;4625;1706;5496
150277;201711;4853;13962;4140;13102;459;1376;3147;10473;3606;11849
150280;201711;6023;26369;5857;26027;568;2504;4699;21224;5267;23728
150285;201711;3088;11530;2813;11106;323;1408;1956;7850;2279;9258
150290;201711;10348;28775;9639;27997;586;1311;8469;25450;9055;26761
150293;201711;9695;24593;7004;20991;1967;5995;2758;9182;4725;15177
150295;201711;7416;20863;5924;19085;1759;5630;2815;10314;4574;15944
150300;201711;1997;6517;1852;6316;71;350;1563;5306;1634;5656
150304;201711;4076;12934;3571;12107;634;2108;2269;8016;2903;10124
150307;201711;6368;20958;6000;20432;350;1156;5107;17586;5457;18742
150309;201711;5884;19358;5139;18201;1290;4501;2585;9831;3875;14332
150310;201711;6521;27094;6185;26639;357;1796;5280;22928;5637;24724
150320;201711;9328;24778;8559;23828;543;1458;6933;19557;7476;21015
150330;201711;14121;46820;13157;45367;1776;6225;9607;33950;11383;40175
150340;201711;2627;7918;2397;7574;245;738;1785;5747;2030;6485
150345;201711;7133;22506;6558;21726;516;1812;5352;17969;5868;19781
150350;201711;8233;23880;7675;23198;942;2275;6059;19128;7001;21403
150360;201711;21927;65114;18427;60767;2592;8127;12615;43524;15207;51651
150370;201711;9456;33127;8498;31808;833;3058;6435;24969;7268;28027
150375;201711;3060;13163;2791;12742;335;1573;2192;10145;2527;11718
150380;201711;9456;26930;8220;25195;426;1319;6922;21529;7348;22848
150390;201711;7616;32805;7120;31887;1201;5117;4833;22608;6034;27725
150400;201711;5996;22872;5742;22387;363;1434;4726;18630;5089;20064
150405;201711;8310;24101;7441;23052;530;1281;5951;19334;6481;20615
150410;201711;1700;6053;1533;5738;234;894;967;3697;1201;4591
150420;201711;33159;106822;27321;97559;9514;35547;7416;30397;16930;65944
150430;201711;7630;24562;7224;23969;767;2396;5621;19196;6388;21592
150440;201711;5455;18318;5196;17949;372;1223;4324;15208;4696;16431
150442;201711;21831;60479;19029;56352;2953;8630;11723;36110;14676;44740
150445;201711;5565;18580;5070;17778;345;1226;4127;14676;4472;15902
150450;201711;4547;21045;4350;20738;387;1973;3601;17372;3988;19345
150460;201711;7677;26489;7065;25720;264;1170;6075;22848;6339;24018
150470;201711;17612;52929;16774;51921;1203;3182;14538;45949;15741;49131
150475;201711;4073;13798;3712;13266;250;926;3023;11023;3273;11949
150480;201711;13757;47034;12534;45062;1910;6833;8860;32963;10770;39796
150490;201711;7538;27889;7228;27464;229;1102;6469;24649;6698;25751
150495;201711;4956;18041;4812;17856;142;591;4459;16630;4601;17221
150497;201711;2453;8731;2170;8196;616;2397;1014;4013;1630;6410
150500;201711;3198;8633;2895;8181;317;843;2253;6413;2570;7256
150503;201711;3883;11527;3020;10282;959;3314;1279;4710;2238;8024
150506;201711;10107;34073;9135;32696;2000;6660;5725;22056;7725;28716
150510;201711;9793;37234;8744;35119;1372;5285;5690;24160;7062;29445
150520;201711;6870;26847;6777;26726;176;775;6390;25326;6566;26101
150530;201711;12363;42438;11021;40329;1358;4254;8148;31166;9506;35420
150540;201711;4610;13655;4023;12786;194;628;3397;10825;3591;11453
150543;201711;6276;18116;5358;16878;932;2977;3558;11716;4490;14693
150548;201711;9643;30533;8901;29613;308;902;8162;27444;8470;28346
150549;201711;1997;6324;1812;6113;58;239;1630;5510;1688;5749
150550;201711;19047;59804;16544;55538;4759;16195;6651;23656;11410;39851
150553;201711;21802;71387;17707;63617;6214;23321;4917;19196;11131;42517
150555;201711;1719;4981;1418;4499;86;277;1030;3272;1116;3549
150560;201711;1802;5848;1641;5526;313;1008;907;3170;1220;4178
150563;201711;2433;8006;2206;7604;475;1754;1193;4137;1668;5891
150565;201711;3944;13413;3608;12862;117;564;3052;10944;3169;11508
150570;201711;5901;20856;5717;20542;392;1475;4641;16735;5033;18210
150580;201711;9619;41038;9241;40563;612;2882;7867;35214;8479;38096
150590;201711;6402;24634;6089;24215;174;874;5631;22427;5805;23301
150600;201711;8316;30926;7870;30312;226;1006;7145;27740;7371;28746
150610;201711;2435;7978;2243;7598;165;627;1770;5939;1935;6566
150611;201711;2791;9052;2609;8746;126;464;2220;7441;2346;7905
150613;201711;12262;35287;9583;30955;2265;7583;4209;14130;6474;21713
150616;201711;2995;8816;2253;7550;557;2062;658;2121;1215;4183
150618;201711;6412;20751;5555;19252;1079;3748;3175;11470;4254;15218
150619;201711;5141;16743;4588;15874;378;1447;3543;12195;3921;13642
150620;201711;6311;21921;5607;21015;758;2859;4084;15636;4842;18495
150630;201711;6126;17233;5775;16828;349;1030;5030;14818;5379;15848
150635;201711;3889;12218;3483;11466;811;2726;1667;5633;2478;8359
150640;201711;2094;6131;1940;5962;43;130;1807;5654;1850;5784
150650;201711;11203;33359;10119;31452;3029;9239;4259;14147;7288;23386
150655;201711;5370;16514;4998;15911;333;1056;4131;13230;4464;14286
150658;201711;4351;12770;3702;11884;744;2605;2238;7398;2982;10003
150660;201711;5591;16693;5055;15941;660;2041;3402;10952;4062;12993
150670;201711;7503;19219;6085;17543;600;1602;4795;14292;5395;15894
150680;201711;61651;197245;49640;178388;13299;47849;21224;85602;34523;133451
150690;201711;2182;6235;1949;5904;133;395;1594;4889;1727;5284
150700;201711;5961;18720;5491;18099;594;1896;4110;13972;4704;15868
150710;201711;4148;13865;3734;13205;335;1293;2744;9827;3079;11120
150715;201711;5015;15984;4431;15070;338;1176;3497;12081;3835;13257
150720;201711;6312;24664;5967;24051;509;2247;4751;19399;5260;21646
150730;201711;10395;34549;9487;33098;1128;4054;7099;25326;8227;29380
150740;201711;3616;11105;3191;10369;489;1581;2035;6723;2524;8304
150745;201711;4716;14708;4131;13893;837;3018;2669;9033;3506;12051
150746;201711;1341;4387;1267;4249;97;290;1012;3476;1109;3766
150747;201711;5121;16268;4561;15513;857;2620;2890;10572;3747;13192
150750;201711;3402;11103;3069;10615;199;771;2443;8588;2642;9359
150760;201711;11457;35279;10613;34219;1252;3887;7924;26206;9176;30093
150770;201711;5921;22228;5721;21928;162;522;5209;20772;5371;21294
150775;201711;956;2852;800;2590;142;545;463;1462;605;2007
150780;201711;3758;12019;3597;11832;95;378;3341;11024;3436;11402
150790;201711;5028;15883;4556;15342;262;773;3755;13638;4017;14411
150795;201711;14069;45732;12819;43741;3033;9962;7334;26531;10367;36493
150796;201711;3231;9097;2880;8679;217;687;2336;7158;2553;7845
150797;201711;3818;12549;3360;11808;127;431;2809;9972;2936;10403
150800;201711;13195;42526;12161;41267;2146;6631;8519;30672;10665;37303
150803;201711;6560;23087;6137;22408;557;2154;4860;17880;5417;20034
150805;201711;2845;9740;2543;9226;312;1095;1893;7020;2205;8115
150808;201711;5668;17769;4391;15430;1650;6346;470;1830;2120;8176
150810;201711;19138;55942;15235;51069;2822;9268;8920;32184;11742;41452
150812;201711;5223;15753;4724;14903;515;1784;3478;10771;3993;12555
150815;201711;8265;27048;7346;25869;745;2596;5742;20726;6487;23322
150820;201711;11134;32171;10006;30871;867;2375;7905;25319;8772;27694
150830;201711;12033;45715;11445;44975;477;2475;9777;39210;10254;41685
150835;201711;2198;7681;2037;7384;464;1695;1053;3947;1517;5642
150840;201711;7227;21562;5821;19127;1303;4553;2608;8711;3911;13264
160005;201711;909;2884;847;2736;29;127;754;2408;783;2535
160010;201711;1577;4987;1575;4985;12;19;1553;4937;1565;4956
160015;201711;1935;6885;1845;6765;100;360;1663;6183;1763;6543
160020;201711;1870;6761;1700;6508;242;1003;1251;4796;1493;5799
160021;201711;1056;4375;1003;4296;95;537;804;3381;899;3918
160023;201711;1083;4315;1023;4217;73;287;848;3564;921;3851
160025;201711;1572;4679;1550;4655;33;81;1498;4531;1531;4612
160027;201711;8026;23466;7487;22860;775;2140;6049;19112;6824;21252
160030;201711;51854;169846;45501;160214;11063;37754;23412;90040;34475;127794
160040;201711;4583;16970;4314;16594;142;758;3981;15173;4123;15931
160050;201711;3576;12579;3094;11897;1515;5585;971;4369;2486;9954
160053;201711;3147;11141;2987;10937;555;1924;2084;7908;2639;9832
160055;201711;570;2243;563;2234;22;111;521;2049;543;2160
160060;201711;17165;55648;15993;54281;1386;4544;13126;45476;14512;50020
160070;201711;2865;11076;2661;10732;181;821;2167;8887;2348;9708
160080;201711;2699;9756;2597;9629;81;350;2383;8864;2464;9214
170025;201711;592;1746;481;1593;136;436;214;742;350;1178
170030;201711;1124;3661;929;3272;175;660;464;1660;639;2320
170035;201711;1413;3812;1094;3300;104;345;646;1975;750;2320
170040;201711;1757;5382;1495;5039;150;539;812;2944;962;3483
170070;201711;1585;4081;1189;3565;168;531;686;2104;854;2635
170100;201711;2356;6890;1990;6314;187;596;1425;4587;1612;5183
170105;201711;733;2275;535;1839;142;486;204;712;346;1198
170110;201711;851;2791;700;2500;140;532;324;1187;464;1719
170130;201711;1313;4082;1004;3478;207;742;479;1741;686;2483
170190;201711;1458;4241;1042;3572;338;1101;236;1032;574;2133
170200;201711;1520;4062;947;2992;273;943;186;545;459;1488
170210;201711;27885;78178;21873;68556;7516;25676;3221;11052;10737;36728
170215;201711;1229;3637;1030;3345;77;311;754;2425;831;2736
170220;201711;5495;18114;4918;16994;1257;4265;2428;8849;3685;13114
170230;201711;1263;3984;1006;3476;240;846;335;1184;575;2030
170240;201711;2661;7822;2114;6931;193;773;1426;4620;1619;5393
170255;201711;3513;10963;2718;9444;728;2592;1110;3956;1838;6548
170270;201711;1033;2511;674;2011;33;105;455;1342;488;1447
170290;201711;2879;8272;2494;7837;189;412;2057;6892;2246;7304
170300;201711;1870;5504;1529;4956;189;610;979;3274;1168;3884
170305;201711;726;2131;569;1828;79;288;280;869;359;1157
170307;201711;985;3467;810;3110;163;617;404;1614;567;2231
170310;201711;1431;4006;1085;3392;226;777;524;1618;750;2395
170320;201711;1035;2901;772;2471;131;436;390;1291;521;1727
170330;201711;796;2586;723;2468;46;200;555;1851;601;2051
170360;201711;457;1381;358;1214;53;211;212;685;265;896
170370;201711;1279;3589;985;3097;156;507;481;1539;637;2046
170380;201711;1772;5562;1385;4922;159;642;784;2858;943;3500
170382;201711;575;1763;478;1594;79;274;284;947;363;1221
170384;201711;1508;5902;1308;5496;366;1630;536;2272;902;3902
170386;201711;782;2233;500;1668;85;312;101;313;186;625
170388;201711;575;1719;422;1442;70;256;190;640;260;896
170389;201711;896;2948;780;2752;52;220;583;2038;635;2258
170390;201711;1433;3749;1099;3329;90;285;850;2615;940;2900
170410;201711;520;1656;411;1459;25;110;264;930;289;1040
170460;201711;401;1116;305;951;41;149;174;537;215;686
170510;201711;810;2598;622;2233;83;337;314;1108;397;1445
170550;201711;6216;17412;4557;14544;1431;5017;725;2383;2156;7400
170555;201711;1299;3706;1030;3288;112;380;548;1801;660;2181
170560;201711;1121;3320;849;2947;128;504;448;1717;576;2221
170600;201711;1328;3810;1106;3495;290;836;595;1997;885;2833
170610;201711;1658;4798;1266;4131;112;418;821;2648;933;3066
170625;201711;401;1157;277;880;35;116;94;278;129;394
170650;201711;1238;3819;952;3306;217;775;373;1396;590;2171
170700;201711;3515;10728;2793;9469;602;2215;1212;4236;1814;6451
170710;201711;1590;4568;1252;3954;278;967;552;1655;830;2622
170720;201711;1818;4779;1546;4391;83;169;1315;3878;1398;4047
170730;201711;936;2823;730;2467;174;599;333;1173;507;1772
170740;201711;2039;7251;1744;6692;242;956;1111;4308;1353;5264
170755;201711;853;2555;630;2113;83;332;295;977;378;1309
170765;201711;1182;3207;843;2664;215;703;332;1123;547;1826
170770;201711;1694;5495;1483;5134;222;770;943;3316;1165;4086
170820;201711;3875;13517;3446;12756;519;1871;2048;8078;2567;9949
170825;201711;968;2362;783;2111;67;148;549;1543;616;1691
170830;201711;1384;3945;1131;3540;39;103;930;2958;969;3061
170900;201711;2429;8499;2235;8178;180;722;1809;6661;1989;7383
170930;201711;3527;10249;2938;9260;673;2306;1335;4317;2008;6623
170950;201711;12065;34530;8773;28835;2627;9733;1267;4320;3894;14053
170980;201711;479;1318;363;1135;42;155;203;600;245;755
171050;201711;1538;5024;1374;4733;83;386;1063;3609;1146;3995
171070;201711;1363;4141;1205;3910;304;883;684;2461;988;3344
171090;201711;1084;2762;892;2500;66;175;653;1830;719;2005
171110;201711;567;1657;419;1388;111;414;166;481;277;895
171150;201711;1014;2717;640;2038;70;252;398;1267;468;1519
171180;201711;705;2085;477;1624;90;326;203;711;293;1037
171190;201711;1513;5602;1352;5296;257;1046;734;2986;991;4032
171195;201711;834;2876;709;2659;128;542;422;1594;550;2136
171200;201711;564;1693;433;1451;120;426;147;481;267;907
171215;201711;440;1273;332;1067;72;256;136;420;208;676
171240;201711;720;2576;619;2359;65;312;392;1509;457;1821
171245;201711;578;1903;462;1646;93;361;209;723;302;1084
171250;201711;991;2827;763;2448;189;618;366;1203;555;1821
171270;201711;400;1558;345;1419;95;362;150;704;245;1066
171280;201711;833;2614;667;2308;162;540;290;1106;452;1646
171320;201711;3826;11156;3060;9804;701;2261;1353;4604;2054;6865
171330;201711;2663;7633;2094;6658;506;1673;993;3246;1499;4919
171360;201711;1398;4358;1219;4117;95;362;973;3306;1068;3668
171370;201711;672;1811;539;1628;60;198;366;1118;426;1316
171380;201711;1320;4025;1055;3577;222;817;511;1764;733;2581
171395;201711;914;2671;658;2175;105;407;326;1054;431;1461
171420;201711;1791;5611;1339;4688;245;953;595;2068;840;3021
171430;201711;1016;3069;843;2759;103;356;558;1786;661;2142
171488;201711;2396;7328;1975;6657;375;1283;1076;3788;1451;5071
171500;201711;890;2474;699;2167;69;228;481;1501;550;1729
171510;201711;786;2754;704;2604;51;223;488;1830;539;2053
171515;201711;459;1295;344;1094;27;90;208;653;235;743
171525;201711;585;1858;495;1692;36;164;322;1046;358;1210
171550;201711;336;1049;244;891;44;177;114;426;158;603
171570;201711;1221;3743;1050;3431;198;602;636;2174;834;2776
171575;201711;1848;5046;1241;3934;200;673;546;1712;746;2385
171610;201711;5246;15752;4117;13780;1033;3802;1146;3995;2179;7797
171620;201711;2767;7801;2322;7195;123;437;1901;5966;2024;6403
171630;201711;922;2710;760;2474;175;618;434;1429;609;2047
171650;201711;2019;6099;1495;5073;375;1293;499;1786;874;3079
171660;201711;2281;6168;1618;4970;268;842;866;2667;1134;3509
171665;201711;1366;3952;1047;3447;200;708;485;1656;685;2364
171670;201711;1809;4972;1415;4333;279;968;711;2127;990;3095
171700;201711;1150;3505;884;3025;142;480;462;1625;604;2105
171720;201711;753;2142;629;1926;77;261;424;1279;501;1540
171750;201711;1194;3557;858;2918;235;802;204;779;439;1581
171780;201711;1250;3304;902;2795;86;280;584;1795;670;2075
171790;201711;1439;5066;1158;4402;285;1107;510;2040;795;3147
171800;201711;675;2007;541;1804;59;204;342;1164;401;1368
171820;201711;10091;29805;8020;26282;1944;6759;2971;10184;4915;16943
171830;201711;1394;5010;1219;4639;237;950;647;2497;884;3447
171840;201711;676;1864;555;1684;36;115;406;1214;442;1329
171845;201711;622;1720;492;1513;74;267;271;850;345;1117
171850;201711;849;3048;734;2803;76;333;492;1873;568;2206
171855;201711;1080;3373;956;3157;82;278;656;2150;738;2428
171865;201711;390;1320;336;1233;67;272;162;586;229;858
171870;201711;743;2167;552;1797;90;307;263;933;353;1240
171875;201711;1179;3673;964;3311;69;290;719;2443;788;2733
171880;201711;953;3276;890;3201;63;209;734;2727;797;2936
171884;201711;923;2490;671;2119;136;484;212;758;348;1242
171886;201711;1304;3998;973;3362;288;1061;178;653;466;1714
171888;201711;750;2194;517;1740;50;178;321;1070;371;1248
171889;201711;486;1503;420;1377;75;274;189;641;264;915
171890;201711;1129;3254;877;2855;158;513;510;1687;668;2200
171900;201711;479;1754;374;1492;88;350;141;594;229;944
172000;201711;573;1823;472;1617;76;294;247;815;323;1109
172010;201711;1054;3722;943;3493;94;442;614;2205;708;2647
172015;201711;328;1272;270;1150;52;212;131;569;183;781
172020;201711;2206;7270;2054;7021;187;742;1535;5245;1722;5987
172025;201711;727;2087;529;1751;74;280;297;997;371;1277
172030;201711;1195;3661;1042;3404;33;138;842;2740;875;2878
172049;201711;1300;3268;874;2604;332;1044;373;1125;705;2169
172065;201711;1359;3557;1111;3267;65;169;996;2970;1061;3139
172080;201711;2358;7301;1946;6531;146;569;1336;4480;1482;5049
172085;201711;467;1329;316;1010;59;171;103;323;162;494
172090;201711;3954;10531;3174;9425;116;353;2674;8032;2790;8385
172093;201711;481;1473;367;1262;75;297;193;623;268;920
172097;201711;614;1740;466;1497;89;304;195;637;284;941
172100;201711;37758;101896;26905;84090;6830;23596;7565;24802;14395;48398
172110;201711;1601;6031;1393;5695;155;673;1023;4328;1178;5001
172120;201711;4747;14861;3849;13462;708;2470;2073;7558;2781;10028
172125;201711;269;824;207;714;30;115;106;372;136;487
172130;201711;644;1904;502;1671;25;92;347;1180;372;1272
172208;201711;2227;6145;1864;5609;241;732;1165;3540;1406;4272
172210;201711;2512;7279;2079;6646;446;1470;1149;3695;1595;5165
210005;201711;19865;60557;16421;55146;5000;17480;6349;22375;11349;39855
210010;201711;1670;5733;1529;5483;51;218;1321;4771;1372;4989
210015;201711;3247;10212;2920;9708;164;435;2481;8482;2645;8917
210020;201711;7216;16746;6540;15988;118;306;6089;14837;6207;15143
210030;201711;4943;16613;4687;16267;246;1188;4033;13857;4279;15045
210040;201711;2119;6203;1924;5978;35;75;1789;5661;1824;5736
210043;201711;6586;18027;5596;16859;746;2075;3916;12612;4662;14687
210047;201711;6359;22264;5807;21485;329;1514;4932;18219;5261;19733
210050;201711;2197;7919;1798;7148;328;1379;1038;4249;1366;5628
210055;201711;1741;5899;1595;5664;75;298;1284;4569;1359;4867
210060;201711;6720;26366;6182;25321;880;3704;4281;17949;5161;21653
210070;201711;7268;21001;6773;20407;55;159;6424;19537;6479;19696
210080;201711;3701;13057;3628;12967;16;64;3540;12703;3556;12767
210083;201711;4690;15755;4176;15195;73;345;3950;14437;4023;14782
210087;201711;2864;8366;2591;8003;198;596;2128;6710;2326;7306
210090;201711;9934;30783;9442;30011;320;1149;8521;27046;8841;28195
210095;201711;5984;20828;5632;20380;294;1188;4905;17924;5199;19112
210100;201711;6933;20856;6399;20123;223;857;5495;17264;5718;18121
210110;201711;2673;9063;2558;8916;54;226;2388;8325;2442;8551
210120;201711;24291;67317;20996;63297;2684;6932;14615;47042;17299;53974
210125;201711;3758;11339;3556;11114;562;1357;2771;9184;3333;10541
210130;201711;4147;11871;3701;11273;203;634;3079;9388;3282;10022
210135;201711;1514;4611;1346;4361;60;205;1116;3645;1176;3850
210140;201711;16345;50207;13736;46622;3003;10501;7573;26570;10576;37071
210150;201711;4571;11307;4068;10666;67;264;3689;9542;3756;9806
210160;201711;16550;51389;15336;49580;1359;4233;11793;39293;13152;43526
210170;201711;13742;47078;13267;46478;623;2254;11959;42202;12582;44456
210173;201711;2483;9513;2345;9289;43;253;2196;8707;2239;8960
210177;201711;3015;9116;2853;8924;56;135;2715;8586;2771;8721
210180;201711;1468;4236;1353;4083;39;138;1202;3604;1241;3742
210190;201711;4759;14795;4348;14036;137;671;3526;11140;3663;11811
210193;201711;1233;3883;1125;3717;50;190;926;3076;976;3266
210197;201711;1946;6594;1801;6417;209;679;1373;5108;1582;5787
210200;201711;7663;25594;7112;24806;750;2614;5612;20004;6362;22618
210203;201711;6935;21455;6503;20886;386;1171;5692;18594;6078;19765
210207;201711;3211;10209;3010;9866;147;451;2532;8480;2679;8931
210210;201711;8139;27307;7761;26802;89;451;7205;25140;7294;25591
210215;201711;1652;6000;1543;5847;70;324;1337;5089;1407;5413
210220;201711;5793;21374;5489;20850;262;1317;4728;17801;4990;19118
210230;201711;5073;16103;4681;15527;235;686;4129;13878;4364;14564
210232;201711;12308;38931;10220;36190;1526;5501;6548;25117;8074;30618
210235;201711;3605;10983;3198;10476;120;483;2817;9297;2937;9780
210237;201711;2254;8570;2171;8463;22;101;2096;8214;2118;8315
210240;201711;2772;8801;2582;8500;111;414;2222;7295;2333;7709
210250;201711;5308;16898;4946;16432;122;634;4460;14705;4582;15339
210255;201711;2589;8155;2313;7663;316;1104;1609;5304;1925;6408
210260;201711;5122;16328;4685;15646;341;1169;3834;12910;4175;14079
210270;201711;4856;14024;4444;13454;101;504;3944;11813;4045;12317
210275;201711;3499;8730;3249;8441;74;128;3070;8104;3144;8232
210280;201711;5453;16410;4613;15181;251;1183;3443;11130;3694;12313
210290;201711;5885;18757;5465;18247;161;630;4882;16356;5043;16986
210300;201711;35033;96430;29225;89219;2021;6405;22063;70149;24084;76554
210310;201711;2867;7824;2627;7496;69;143;2362;6809;2431;6952
210312;201711;2407;7057;2199;6803;48;238;1994;6137;2042;6375
210315;201711;2780;8344;2404;7878;77;237;2115;7109;2192;7346
210317;201711;3888;12553;3674;12300;131;508;3364;11304;3495;11812
210320;201711;18517;60237;17379;58778;585;2567;15609;52838;16194;55405
210325;201711;3448;10485;3090;9952;110;404;2688;8743;2798;9147
210330;201711;29401;80127;24477;74216;5645;16077;13217;45799;18862;61876
210340;201711;10708;32532;9727;31153;1028;3072;7134;24021;8162;27093
210350;201711;9443;28407;8464;27078;320;1128;7193;23209;7513;24337
210355;201711;3901;14113;3507;13501;140;726;2950;11475;3090;12201
210360;201711;14844;44062;13426;42099;716;2701;11153;34810;11869;37511
210370;201711;9663;22815;7964;21000;303;628;7070;19244;7373;19872
210375;201711;2973;8774;2408;8023;667;2252;1161;4110;1828;6362
210380;201711;5541;15167;5017;14499;309;808;4277;12599;4586;13407
210390;201711;2749;9992;2547;9655;136;669;2131;8070;2267;8739
210400;201711;4736;14855;4399;14437;109;282;4098;13621;4207;13903
210405;201711;7305;20464;5925;18461;1292;3938;3077;10210;4369;14148
210407;201711;1893;6695;1608;6143;145;616;1235;4677;1380;5293
210408;201711;2345;9200;2233;9045;168;823;1822;7486;1990;8309
210409;201711;3603;12865;3355;12508;119;642;2915;10841;3034;11483
210410;201711;3456;11074;3171;10640;239;720;2535;8768;2774;9488
210420;201711;3939;12973;3609;12392;180;644;3038;10502;3218;11146
210430;201711;2200;6531;2084;6400;122;329;1819;5653;1941;5982
210440;201711;4039;11711;3850;11478;74;215;3657;10947;3731;11162
210450;201711;2536;8062;2283;7671;117;414;1845;6189;1962;6603
210455;201711;3691;10452;3208;9870;681;1985;2135;6861;2816;8846
210460;201711;3360;10704;3063;10270;131;551;2578;8617;2709;9168
210462;201711;1334;4739;1223;4526;61;292;999;3663;1060;3955
210465;201711;2581;8094;2318;7725;100;306;2047;6933;2147;7239
210467;201711;5987;19818;5536;19293;316;1178;4840;17080;5156;18258
210470;201711;2073;5515;1461;4619;76;229;1112;3593;1188;3822
210480;201711;14813;46455;12870;43975;1732;5588;9079;33198;10811;38786
210490;201711;3682;9829;3115;9022;80;276;2724;7885;2804;8161
210500;201711;6051;25063;5769;24502;472;2331;4592;19461;5064;21792
210510;201711;6278;21236;5842;20716;269;817;5106;18644;5375;19461
210515;201711;3471;10856;3271;10639;119;317;3009;9999;3128;10316
210520;201711;2551;7577;2286;7226;119;412;1995;6352;2114;6764
210530;201711;48245;129770;40725;118485;6909;25404;11890;42011;18799;67415
210535;201711;3175;10897;3030;10703;85;314;2733;9746;2818;10060
210540;201711;13379;43137;11898;41122;1645;5529;8269;30007;9914;35536
210542;201711;5663;15246;4972;14488;237;505;4475;13404;4712;13909
210545;201711;2287;7211;2145;6998;48;216;1920;6206;1968;6422
210547;201711;3580;12843;3272;12279;369;1350;2353;9133;2722;10483
210550;201711;5823;17553;5131;16762;297;916;4457;14860;4754;15776
210560;201711;3729;11575;3331;10919;115;459;2867;9315;2982;9774
210565;201711;1418;5080;1220;4762;46;230;1010;4024;1056;4254
210570;201711;11235;31494;10335;30468;378;937;9412;28188;9790;29125
210580;201711;2967;8470;2663;8101;245;494;2157;6910;2402;7404
210590;201711;3923;12495;3577;12031;161;729;3147;10493;3308;11222
210592;201711;2482;7656;2356;7454;33;173;2106;6613;2139;6786
210594;201711;2693;7458;2129;6594;106;301;1573;5028;1679;5329
210596;201711;2432;9073;2282;8759;170;758;1780;6862;1950;7620
210598;201711;1725;5243;1612;5106;45;168;1488;4728;1533;4896
210600;201711;2938;8350;2514;7779;89;282;2063;6415;2152;6697
210610;201711;2430;7719;2211;7440;95;449;1962;6503;2057;6952
210620;201711;2132;6758;1911;6487;39;101;1763;6109;1802;6210
210630;201711;3105;10965;2831;10559;199;953;2264;8300;2463;9253
210632;201711;4313;14669;3931;14101;386;1555;3031;10871;3417;12426
210635;201711;1852;6532;1739;6338;127;401;1460;5475;1587;5876
210637;201711;2478;8532;2259;8198;131;583;1787;6540;1918;7123
210640;201711;4667;18289;4591;18209;32;133;4500;17910;4532;18043
210650;201711;6971;20638;6708;20296;80;239;6469;19621;6549;19860
210660;201711;8453;24768;7640;23547;311;1144;6614;20186;6925;21330
210663;201711;2640;8120;2508;7961;118;376;2155;7020;2273;7396
210667;201711;1886;6274;1767;6087;68;276;1567;5446;1635;5722
210670;201711;4421;15812;4175;15416;186;878;3627;13358;3813;14236
210675;201711;5021;13917;4525;13269;354;867;3746;11367;4100;12234
210680;201711;3954;10470;3372;9773;121;282;2982;8778;3103;9060
210690;201711;7383;24672;6936;24193;268;1004;6149;21979;6417;22983
210700;201711;2693;7668;2332;7233;208;497;1826;6216;2034;6713
210710;201711;4692;15483;4377;15014;162;759;3813;13032;3975;13791
210720;201711;2653;9226;2500;9024;63;322;2292;8229;2355;8551
210725;201711;1152;4276;1044;4070;39;146;800;3261;839;3407
210730;201711;1200;3410;1029;3177;75;233;820;2552;895;2785
210735;201711;4345;13985;3884;13270;335;1211;3163;10942;3498;12153
210740;201711;5007;14485;4625;14095;148;688;4141;12430;4289;13118
210745;201711;4214;11604;3955;11283;183;430;3520;10153;3703;10583
210750;201711;19154;51256;16798;48545;1759;5053;12557;37258;14316;42311
210760;201711;5519;16236;5135;15819;27;70;5000;15486;5027;15556
210770;201711;5773;15746;4976;14831;60;261;4574;13655;4634;13916
210780;201711;7187;24207;6569;23139;694;2315;4901;17755;5595;20070
210790;201711;4683;14838;4340;14416;170;428;3529;12462;3699;12890
210800;201711;4775;13240;4246;12578;78;291;3865;11433;3943;11724
210805;201711;3790;14855;3659;14656;142;712;3216;12939;3358;13651
210810;201711;4964;15113;4615;14659;250;502;4080;13416;4330;13918
210820;201711;7180;20828;6301;19451;756;2251;4247;13377;5003;15628
210825;201711;5992;19862;5688;19480;363;1156;4894;17141;5257;18297
210830;201711;8122;23228;7641;22640;544;1267;6531;19994;7075;21261
210840;201711;3385;9216;3080;8785;96;293;2668;7572;2764;7865
210845;201711;5784;16856;5588;16648;38;79;5504;16483;5542;16562
210850;201711;5819;20287;5231;19347;442;1929;3970;14653;4412;16582
210860;201711;17296;50561;15331;47811;988;2978;12385;39481;13373;42459
210870;201711;5881;18810;5241;18030;395;1281;4361;15325;4756;16606
210880;201711;4202;13551;3969;13262;269;989;3319;11123;3588;12112
210890;201711;4480;13612;4108;13173;247;629;3492;11701;3739;12330
210900;201711;4751;14124;3748;12360;1458;5149;780;2867;2238;8016
210905;201711;1848;5526;1606;5189;75;189;1371;4546;1446;4735
210910;201711;7538;24001;6625;22462;873;3065;4441;15170;5314;18235
210920;201711;2805;10176;2593;9855;104;551;2241;8498;2345;9049
210923;201711;1385;4643;1271;4458;99;392;930;3289;1029;3681
210927;201711;4839;15652;4486;15270;108;340;4179;14428;4287;14768
210930;201711;2460;8703;2269;8412;128;654;1856;6758;1984;7412
210940;201711;3282;11113;3125;10876;139;641;2726;9360;2865;10001
210945;201711;5691;17526;5443;17242;260;700;4876;15647;5136;16347
210950;201711;5067;15281;4087;13796;513;1582;2835;9972;3348;11554
210955;201711;1702;5383;1501;5073;147;477;1067;3719;1214;4196
210960;201711;8771;27698;8006;26634;1598;4941;4965;17740;6563;22681
210970;201711;1291;4363;1112;4052;98;433;833;2944;931;3377
210975;201711;1681;5613;1589;5440;126;459;1208;4137;1334;4596
210980;201711;10114;23155;9541;22573;279;491;8978;21558;9257;22049
210990;201711;15606;47298;12937;43549;2047;7050;7918;27677;9965;34727
211000;201711;14394;45135;12789;43311;655;2704;10763;37105;11418;39809
211003;201711;4869;16874;4362;16235;201;931;3636;13768;3837;14699
211010;201711;6367;23691;5943;23121;77;451;5508;21601;5585;22052
211020;201711;7684;24476;7369;24011;426;1587;6296;20532;6722;22119
211023;201711;2059;6921;1962;6774;112;429;1636;5637;1748;6066
211027;201711;2669;9683;2609;9579;229;904;2177;8004;2406;8908
211030;201711;3733;11045;3418;10704;302;664;2893;9499;3195;10163
211040;201711;4459;16498;4276;16225;162;876;3753;14227;3915;15103
211050;201711;9680;24757;9067;24051;217;562;8508;22597;8725;23159
211060;201711;5766;19940;5493;19513;289;1177;4825;17143;5114;18320
211065;201711;2003;6148;1778;5833;49;131;1600;5320;1649;5451
211070;201711;7661;25991;6941;24809;425;1565;5624;20395;6049;21960
211080;201711;1285;3734;1078;3421;59;305;850;2543;909;2848
211085;201711;1936;6233;1776;5985;149;499;1447;4928;1596;5427
211090;201711;3249;9249;2993;8906;73;349;2665;7812;2738;8161
211100;201711;6374;16968;6154;16686;35;142;5946;16061;5981;16203
211102;201711;2890;10806;2696;10532;158;692;2336;9197;2494;9889
211105;201711;2392;7868;2011;7210;242;893;1359;4905;1601;5798
211107;201711;4350;13948;3865;13267;210;715;3144;11144;3354;11859
211110;201711;6049;17407;4744;15454;633;1924;3274;11123;3907;13047
211120;201711;34034;96337;31562;93410;4381;12123;23309;71372;27690;83495
211125;201711;1979;6227;1729;5811;86;323;1458;4925;1544;5248
211130;201711;171874;450605;161497;437468;23829;66720;76952;231548;100781;298268
211140;201711;4972;15866;4576;15288;225;777;3889;13028;4114;13805
211150;201711;9474;27065;8458;25819;289;1083;7310;22355;7599;23438
211153;201711;2529;7925;2230;7540;429;1524;1471;5169;1900;6693
211157;201711;1075;3498;918;3249;55;295;636;2245;691;2540
211160;201711;3921;12452;3292;11399;208;996;2377;7984;2585;8980
211163;201711;1681;5650;1598;5533;27;82;1496;5264;1523;5346
211167;201711;1499;4881;1419;4760;32;144;1335;4464;1367;4608
211170;201711;5924;15493;5671;15181;68;223;5394;14387;5462;14610
211172;201711;2401;6934;2166;6573;84;315;1830;5438;1914;5753
211174;201711;2660;8123;2486;7888;73;352;2239;7040;2312;7392
211176;201711;4063;12629;3446;11791;280;1112;2629;9022;2909;10134
211178;201711;4449;10677;3988;10160;29;101;3784;9558;3813;9659
211180;201711;4060;13986;3823;13628;260;988;3241;11664;3501;12652
211190;201711;2971;9296;2637;8787;61;305;2280;7525;2341;7830
211195;201711;1408;4165;1186;3871;68;207;981;3299;1049;3506
211200;201711;1981;6314;1711;5941;203;728;1133;4062;1336;4790
211210;201711;6561;20109;6126;19516;306;1045;5330;17076;5636;18121
211220;201711;33094;92552;28878;87164;3995;12108;19869;61991;23864;74099
211223;201711;4842;14658;4392;13958;443;1301;3305;10751;3748;12052
211227;201711;1677;5859;1532;5645;43;203;1339;4986;1382;5189
211230;201711;7317;23387;6649;22268;619;2122;5117;17229;5736;19351
211240;201711;7900;26740;7520;26246;205;1071;6852;23633;7057;24704
211245;201711;5656;16424;5601;16369;37;67;5543;16258;5580;16325
211250;201711;13756;41100;12820;39973;648;2062;11215;35250;11863;37312
211260;201711;7905;25205;7376;24511;255;971;6690;22336;6945;23307
211270;201711;9973;33489;8850;32057;418;1947;7270;26688;7688;28635
211280;201711;13087;38175;11942;36731;807;2032;9902;31491;10709;33523
211285;201711;1625;5950;1447;5608;254;1057;712;2840;966;3897
211290;201711;6876;22331;6546;21874;267;986;5760;19359;6027;20345
211300;201711;7963;23518;7397;22776;81;208;7020;21770;7101;21978
211400;201711;11258;34671;9575;32166;1924;6546;5435;19699;7359;26245
220005;201711;1805;5069;1620;4782;47;199;1328;3804;1375;4003
220010;201711;1430;4166;1247;3864;26;109;998;3042;1024;3151
220020;201711;3141;9815;2916;9435;411;1354;2010;6517;2421;7871
220025;201711;2235;5347;1962;4955;36;110;1620;4000;1656;4110
220027;201711;1255;3372;1100;3160;41;144;896;2556;937;2700
220030;201711;3090;8163;2956;7948;116;344;2544;6709;2660;7053
220040;201711;7045;21566;6429;20443;1193;3732;4087;13177;5280;16909
220045;201711;1339;4399;1207;4144;52;263;928;3097;980;3360
220050;201711;4352;12933;3747;11970;159;668;3132;9905;3291;10573
220060;201711;2147;5076;1833;4712;28;65;1673;4304;1701;4369
220070;201711;2377;6644;2101;6209;102;285;1692;4980;1794;5265
220080;201711;652;1967;599;1883;30;122;499;1504;529;1626
220090;201711;1727;4312;1422;3888;23;82;1252;3397;1275;3479
220095;201711;680;1793;639;1738;8;22;599;1625;607;1647
220100;201711;1319;3866;1078;3420;49;212;868;2695;917;2907
220105;201711;2077;6559;1820;6052;144;497;1302;4361;1446;4858
220110;201711;3321;9458;3128;9126;63;258;2760;7930;2823;8188
220115;201711;2545;8196;2411;7969;103;434;2129;6925;2232;7359
220117;201711;1273;3295;1022;2910;25;83;871;2457;896;2540
220120;201711;11336;33565;10476;32492;128;564;9864;30537;9992;31101
220130;201711;917;2873;803;2704;19;130;712;2354;731;2484
220140;201711;1625;4261;1434;4030;100;221;1222;3494;1322;3715
220150;201711;6641;19997;6230;19410;144;690;5473;16810;5617;17500
220155;201711;1091;3267;864;2846;27;106;600;1945;627;2051
220157;201711;1062;2681;904;2414;16;63;743;1927;759;1990
220160;201711;2559;7626;2236;7020;63;319;1829;5615;1892;5934
220170;201711;1356;3921;1147;3583;27;140;995;3038;1022;3178
220173;201711;2001;5908;1608;5145;48;228;1312;4056;1360;4284
220177;201711;1782;5338;1739;5281;14;52;1689;5130;1703;5182
220180;201711;1152;2968;896;2500;11;45;673;1784;684;1829
220190;201711;4985;14996;4503;14362;440;1491;3469;11134;3909;12625
220191;201711;1357;4478;1271;4326;92;398;933;3083;1025;3481
220192;201711;1809;5080;1448;4433;38;145;1139;3424;1177;3569
220194;201711;1721;5085;1531;4782;71;279;1255;3844;1326;4123
220196;201711;1987;5577;1809;5275;68;278;1528;4357;1596;4635
220198;201711;1244;3638;1004;3316;8;27;952;3186;960;3213
220200;201711;4529;14441;4146;13942;294;1053;3376;11382;3670;12435
220202;201711;2144;6219;1844;5683;29;145;1582;4783;1611;4928
220205;201711;2582;7001;2298;6593;40;150;2018;5707;2058;5857
220207;201711;826;2522;707;2312;58;225;485;1570;543;1795
220208;201711;1713;5422;1425;4869;317;1204;660;2258;977;3462
220209;201711;1598;4693;1371;4299;32;140;1112;3473;1144;3613
220210;201711;1591;4267;1376;3899;32;136;1123;3082;1155;3218
220211;201711;1482;4113;1404;4001;19;85;1249;3550;1268;3635
220213;201711;1647;4627;1483;4296;32;126;1223;3467;1255;3593
220217;201711;1940;6160;1850;6050;29;118;1744;5735;1773;5853
220220;201711;10214;27698;8836;25592;555;1471;6612;19556;7167;21027
220225;201711;1118;3138;914;2857;23;93;764;2363;787;2456
220230;201711;5497;14262;4867;13431;180;495;4248;11762;4428;12257
220240;201711;2860;8682;2631;8251;93;354;2178;6796;2271;7150
220245;201711;1505;3936;1231;3579;13;48;1082;3209;1095;3257
220250;201711;2656;8134;2418;7776;56;239;2134;6861;2190;7100
220253;201711;1613;4610;1355;4148;150;439;1024;3124;1174;3563
220255;201711;1737;4614;1478;4202;25;130;1225;3349;1250;3479
220260;201711;4230;13535;3743;12660;219;798;2936;9968;3155;10766
220265;201711;1237;4209;1128;4034;71;299;843;3000;914;3299
220270;201711;6579;21121;6220;20481;409;1677;5044;16143;5453;17820
220271;201711;1490;4007;1284;3690;46;138;1082;3133;1128;3271
220272;201711;1684;4998;1513;4687;33;120;1197;3653;1230;3773
220273;201711;1183;3426;1010;3104;42;156;787;2399;829;2555
220275;201711;2117;5267;1683;4724;42;157;1450;4040;1492;4197
220277;201711;2119;5709;1827;5236;34;122;1517;4274;1551;4396
220280;201711;1491;3978;1289;3642;60;203;1053;2882;1113;3085
220285;201711;1485;3941;1263;3654;18;75;1182;3403;1200;3478
220290;201711;5647;18275;4769;16987;455;1797;3406;12164;3861;13961
220300;201711;1796;5808;1557;5456;58;337;1276;4360;1334;4697
220310;201711;2521;7909;2163;7486;58;316;1867;6375;1925;6691
220320;201711;2771;8422;2303;7539;163;631;1742;5616;1905;6247
220323;201711;1466;4985;1261;4659;87;354;1016;3755;1103;4109
220325;201711;1182;3690;1010;3353;47;198;793;2613;840;2811
220327;201711;1326;4136;1192;3903;43;221;990;3140;1033;3361
220330;201711;3703;9984;3235;9333;174;536;2665;7646;2839;8182
220335;201711;1732;5296;1547;5077;15;53;1459;4808;1474;4861
220340;201711;1804;4904;1476;4361;56;202;1083;3104;1139;3306
220342;201711;1138;3560;1037;3404;44;181;847;2791;891;2972
220345;201711;2917;7071;2436;6401;17;41;2311;6069;2328;6110
220350;201711;3487;9250;2881;8261;146;491;2198;6205;2344;6696
220360;201711;1144;3100;963;2819;34;117;787;2240;821;2357
220370;201711;9065;25818;8215;24668;225;892;7320;21798;7545;22690
220375;201711;1408;4406;1317;4289;8;24;1285;4198;1293;4222
220380;201711;1446;3690;1200;3343;36;119;1028;2818;1064;2937
220385;201711;791;1964;628;1687;10;38;528;1372;538;1410
220390;201711;8344;24806;7255;22907;1896;5991;2983;9907;4879;15898
220400;201711;1492;3739;1152;3194;26;100;910;2435;936;2535
220410;201711;1131;3262;952;2955;58;177;764;2339;822;2516
220415;201711;808;2221;701;2047;24;83;531;1520;555;1603
220420;201711;2043;5867;1675;5159;85;278;1246;3787;1331;4065
220430;201711;2387;6593;2326;6513;99;293;2085;5796;2184;6089
220435;201711;1677;4726;1505;4449;55;187;1181;3452;1236;3639
220440;201711;2401;7764;2155;7375;142;520;1776;5994;1918;6514
220450;201711;2038;6021;1730;5592;258;944;1209;3874;1467;4818
220455;201711;1302;4126;1233;4029;31;131;1104;3586;1135;3717
220460;201711;910;2440;827;2340;45;145;713;1971;758;2116
220465;201711;2321;7509;2104;7178;164;609;1597;5469;1761;6078
220470;201711;3519;10256;3182;9703;118;403;2572;7724;2690;8127
220480;201711;2343;6586;1962;5933;123;318;1477;4437;1600;4755
220490;201711;2306;6259;2102;6009;43;160;1869;5291;1912;5451
220500;201711;2775;7533;2442;6984;63;271;1968;5451;2031;5722
220510;201711;2713;7944;2197;7030;90;295;1686;5410;1776;5705
220515;201711;1669;4103;1495;3869;54;139;1325;3410;1379;3549
220520;201711;4956;13291;4540;12717;85;250;4123;11551;4208;11801
220525;201711;1207;3377;1121;3254;21;82;972;2787;993;2869
220527;201711;1298;3846;1146;3567;46;148;933;2942;979;3090
220530;201711;1191;3376;1060;3183;40;163;952;2803;992;2966
220535;201711;806;2330;748;2254;51;157;596;1797;647;1954
220540;201711;3339;10646;3169;10376;89;396;2790;9084;2879;9480
220545;201711;1368;4438;1283;4278;94;387;1037;3394;1131;3781
220550;201711;8797;27723;8020;26376;552;2059;6150;19948;6702;22007
220551;201711;1405;4300;1238;4027;56;239;985;3119;1041;3358
220552;201711;1505;4580;1298;4183;46;238;1045;3239;1091;3477
220553;201711;1556;4409;1330;4049;56;188;1045;3247;1101;3435
220554;201711;775;2197;650;2002;43;109;511;1582;554;1691
220555;201711;2029;6611;1892;6401;47;252;1604;5353;1651;5605
220556;201711;1273;3858;1125;3568;41;193;869;2635;910;2828
220557;201711;1513;4722;1317;4327;87;321;955;3077;1042;3398
220558;201711;1117;3333;972;3124;36;163;792;2490;828;2653
220559;201711;1606;4335;1394;3991;15;50;1170;3357;1185;3407
220560;201711;1611;3925;1307;3507;41;101;1132;3019;1173;3120
220570;201711;7063;22382;6561;21544;637;2175;4929;16355;5566;18530
220580;201711;6436;19113;6186;18710;177;583;5558;16698;5735;17281
220585;201711;1963;6502;1782;6168;79;329;1439;4926;1518;5255
220590;201711;1275;3672;1095;3399;117;372;744;2330;861;2702
220595;201711;2377;6772;2226;6574;21;115;2091;6103;2112;6218
220600;201711;1323;3121;1074;2793;77;116;885;2372;962;2488
220605;201711;1731;5105;1479;4675;35;156;1168;3606;1203;3762
220610;201711;2771;8274;2615;8049;45;204;2395;7327;2440;7531
220620;201711;7404;24305;7072;23839;229;1023;6374;21338;6603;22361
220630;201711;380;1163;305;1031;41;165;176;601;217;766
220635;201711;1645;5371;1457;4975;71;297;1108;3729;1179;4026
220640;201711;2679;7511;2317;6968;78;280;1945;5802;2023;6082
220650;201711;2044;5966;1783;5503;68;230;1360;4179;1428;4409
220660;201711;2755;8145;2472;7800;94;420;2142;6627;2236;7047
220665;201711;1261;3985;1121;3750;26;145;953;3136;979;3281
220667;201711;1612;5327;1460;5049;77;288;1181;4094;1258;4382
220669;201711;1713;5488;1637;5347;98;437;1337;4286;1435;4723
220670;201711;1970;5626;1711;5306;53;161;1527;4744;1580;4905
220672;201711;2563;7124;2279;6770;109;328;2008;6006;2117;6334
220675;201711;1237;3487;1143;3320;60;154;894;2608;954;2762
220680;201711;2512;7342;2392;7184;124;364;2099;6315;2223;6679
220690;201711;1606;4400;1405;4067;127;317;1048;3101;1175;3418
220695;201711;937;2672;851;2505;27;92;700;2042;727;2134
220700;201711;8164;22431;6925;20588;366;1233;5353;15778;5719;17011
220710;201711;840;2436;655;2058;51;143;464;1447;515;1590
220720;201711;1946;4940;1790;4707;39;130;1557;4056;1596;4186
220730;201711;1324;3837;1115;3500;28;121;914;2824;942;2945
220735;201711;986;2409;771;2052;25;64;643;1694;668;1758
220740;201711;1399;4101;1148;3774;36;136;974;3208;1010;3344
220750;201711;3701;10343;3360;9844;183;536;2853;8352;3036;8888
220755;201711;1114;3056;986;2845;35;122;792;2227;827;2349
220760;201711;2833;8794;2544;8401;89;357;2226;7328;2315;7685
220770;201711;19782;64540;17574;60425;6327;22565;5460;19745;11787;42310
220775;201711;1110;3014;1057;2955;18;68;1029;2866;1047;2934
220777;201711;1552;4146;1236;3617;40;113;949;2756;989;2869
220779;201711;1330;3305;1208;3134;29;106;1065;2724;1094;2830
220780;201711;5376;14438;4714;13387;262;903;3823;10653;4085;11556
220785;201711;1408;3258;1294;3094;25;34;1223;2929;1248;2963
220790;201711;10039;29451;9103;28060;349;1436;7689;23364;8038;24800
220793;201711;783;2229;687;2068;26;96;570;1704;596;1800
220795;201711;1406;3835;1277;3663;36;132;1137;3252;1173;3384
220800;201711;15674;40573;13473;37296;846;2478;9571;25972;10417;28450
220810;201711;2914;8465;2549;7812;65;250;2115;6363;2180;6613
220820;201711;5231;13982;4626;13110;441;1162;3551;10120;3992;11282
220830;201711;6964;19595;6419;18780;357;1120;5284;15389;5641;16509
220840;201711;12519;39327;10936;36108;2116;6830;6019;20275;8135;27105
220850;201711;2934;9519;2700;9234;75;379;2428;8248;2503;8627
220855;201711;595;1750;515;1611;21;94;416;1271;437;1365
220860;201711;963;2497;843;2316;20;70;750;2039;770;2109
220865;201711;2555;6925;2020;6009;63;257;1605;4641;1668;4898
220870;201711;2368;7569;2043;7132;37;200;1868;6479;1905;6679
220880;201711;4870;12606;4395;12040;46;147;4134;11316;4180;11463
220885;201711;1212;4268;1061;3986;64;329;821;3067;885;3396
220887;201711;1307;3147;1166;2953;11;40;1096;2754;1107;2794
220890;201711;1561;5187;1343;4767;102;351;994;3584;1096;3935
220900;201711;1932;5042;1651;4646;35;100;1444;4035;1479;4135
220910;201711;1476;4390;1282;4095;33;111;1132;3634;1165;3745
220915;201711;950;2649;799;2355;21;93;634;1812;655;1905
220920;201711;1322;4633;1143;4366;78;381;891;3331;969;3712
220930;201711;1491;4556;1344;4328;32;149;1207;3818;1239;3967
220935;201711;1048;3068;858;2658;32;128;599;1751;631;1879
220937;201711;1362;3717;1179;3432;31;116;960;2744;991;2860
220940;201711;1362;4121;1166;3721;46;203;867;2688;913;2891
220945;201711;401;1475;363;1394;21;113;263;986;284;1099
220950;201711;1347;3229;899;2496;18;82;701;1874;719;1956
220955;201711;1493;4097;1306;3774;47;130;1083;3137;1130;3267
220960;201711;881;2240;692;1934;19;72;549;1512;568;1584
220965;201711;1689;4835;1535;4589;27;166;1324;3829;1351;3995
220970;201711;1847;4907;1444;4251;63;178;1127;3336;1190;3514
220975;201711;710;2227;635;2133;25;162;563;1798;588;1960
220980;201711;1168;3430;1055;3231;35;136;873;2640;908;2776
220985;201711;1167;3352;1066;3198;52;211;823;2361;875;2572
220987;201711;1449;4487;1273;4175;61;270;1038;3351;1099;3621
220990;201711;1716;4959;1473;4558;40;194;1169;3520;1209;3714
220995;201711;1189;3518;917;3077;66;268;653;2203;719;2471
220997;201711;2362;6966;2236;6785;47;181;2073;6251;2120;6432
221000;201711;4022;11870;3742;11418;174;726;3074;9202;3248;9928
221005;201711;1386;4071;1263;3838;110;328;955;2853;1065;3181
221010;201711;1195;3005;1005;2767;23;83;880;2384;903;2467
221020;201711;1578;4952;1460;4710;40;184;1099;3493;1139;3677
221030;201711;1475;4225;1303;3956;43;190;1068;3176;1111;3366
221035;201711;1335;3721;1235;3588;23;51;1151;3403;1174;3454
221037;201711;596;1750;513;1601;12;57;359;1064;371;1121
221038;201711;546;1537;423;1320;19;69;283;877;302;946
221039;201711;885;2404;778;2243;19;71;659;1855;678;1926
221040;201711;4258;13133;3899;12537;158;555;3127;10082;3285;10637
221050;201711;3462;9965;3182;9609;55;236;2896;8668;2951;8904
221060;201711;8158;23277;6988;21347;340;1131;5302;16580;5642;17711
221062;201711;1211;4128;1061;3828;48;261;831;2941;879;3202
221063;201711;1132;3462;990;3235;76;271;713;2315;789;2586
221065;201711;2639;6971;2337;6486;51;173;2032;5550;2083;5723
221070;201711;3493;11101;3001;10165;172;643;2253;7607;2425;8250
221080;201711;3449;8618;2790;7641;78;293;2253;6085;2331;6378
221090;201711;1360;3713;1157;3365;19;79;990;2816;1009;2895
221093;201711;1460;4295;1366;4103;167;529;881;2549;1048;3078
221095;201711;887;2378;762;2174;5;20;632;1758;637;1778
221097;201711;799;2175;631;1863;21;78;462;1312;483;1390
221100;201711;96313;278758;87063;262688;16253;50466;50072;149509;66325;199975
221110;201711;10075;30788;9292;29817;288;1323;8101;25695;8389;27018
221120;201711;4019;12363;3761;11917;355;1179;2967;9401;3322;10580
221130;201711;4520;12526;3581;10630;997;2880;1474;4470;2471;7350
221135;201711;1504;4349;1380;4172;44;170;1214;3634;1258;3804
221140;201711;1278;3130;1138;2928;11;37;1019;2582;1030;2619
221150;201711;1134;2868;896;2448;24;93;696;1815;720;1908
221160;201711;767;1979;704;1894;22;57;584;1562;606;1619
221170;201711;1086;3208;982;3034;28;99;799;2452;827;2551
230010;201711;3230;8710;2606;7596;188;620;1963;5625;2151;6245
230015;201711;2872;9724;2661;9313;262;1077;1816;6253;2078;7330
230020;201711;13192;42381;12738;41646;485;1993;10909;35282;11394;37275
230030;201711;11887;32468;10493;30427;293;1052;9098;26208;9391;27260
230040;201711;4148;11312;3552;10302;146;560;2822;8038;2968;8598
230050;201711;2673;8738;1965;6912;452;1534;652;2328;1104;3862
230060;201711;2277;6442;1894;5739;63;255;1526;4517;1589;4772
230070;201711;3966;11330;3374;10178;194;683;2333;7124;2527;7807
230075;201711;8939;30048;8312;28887;455;2256;6674;22610;7129;24866
230080;201711;2422;5904;1971;5235;48;192;1681;4389;1729;4581
230090;201711;3904;10602;3444;9858;212;683;2613;7363;2825;8046
230100;201711;17115;48113;15467;45610;2052;6385;9670;28667;11722;35052
230110;201711;11482;35923;10365;33589;1986;6557;5586;18238;7572;24795
230120;201711;7439;20627;6500;19152;621;1707;4740;14318;5361;16025
230125;201711;2956;8262;2448;7387;106;385;1876;5627;1982;6012
230130;201711;5664;18105;4752;16163;518;1882;3067;10257;3585;12139
230140;201711;3475;10701;2932;9739;162;653;2098;6923;2260;7576
230150;201711;1579;4823;1371;4363;272;849;713;2331;985;3180
230160;201711;6207;17324;5439;16167;246;946;4436;13003;4682;13949
230170;201711;5946;17996;5191;16550;250;974;3857;12055;4107;13029
230180;201711;1646;4704;1405;4230;45;199;1071;3087;1116;3286
230185;201711;3871;12142;3407;11295;345;1240;2417;8074;2762;9314
230190;201711;12307;37931;10719;34833;1695;5732;5619;18333;7314;24065
230195;201711;5119;15474;4556;14490;320;1155;3541;11088;3861;12243
230200;201711;4844;13626;4296;12572;205;632;3364;9645;3569;10277
230205;201711;3963;12696;3588;12024;207;875;2638;8712;2845;9587
230210;201711;9216;24789;7899;22797;586;1845;5675;16326;6261;18171
230220;201711;13095;35648;11762;33443;618;1994;9372;26260;9990;28254
230230;201711;6900;21552;6251;20266;536;1781;4523;14653;5059;16434
230240;201711;12979;35216;11459;32762;539;1500;9138;26053;9677;27553
230250;201711;9046;27048;8965;26908;428;1555;7057;20699;7485;22254
230260;201711;14235;45709;12889;42919;1766;6227;7502;25169;9268;31396
230270;201711;7425;21027;6041;18447;646;2036;3907;12028;4553;14064
230280;201711;19764;56464;17032;51705;874;3398;13170;38913;14044;42311
230290;201711;4660;13705;4023;12381;458;1309;2800;8745;3258;10054
230300;201711;4271;12316;4044;11995;155;639;3469;10059;3624;10698
230310;201711;4760;13878;4083;12685;128;526;2974;9044;3102;9570
230320;201711;7393;21834;6530;20258;369;1427;4968;15163;5337;16590
230330;201711;4686;13302;3913;11819;230;729;2857;8533;3087;9262
230340;201711;3480;11248;3051;10350;274;1007;2101;7042;2375;8049
230350;201711;18171;52570;16335;49448;1152;4170;10609;32462;11761;36632
230360;201711;2967;8332;2356;7194;147;520;1635;4915;1782;5435
230365;201711;2995;7741;2557;7032;68;290;2176;5879;2244;6169
230370;201711;51900;157987;45916;148254;10677;35480;21582;72622;32259;108102
230380;201711;6353;18171;5181;15957;186;702;3715;11240;3901;11942
230390;201711;3276;10198;2912;9567;149;653;2202;7074;2351;7727
230393;201711;2974;9532;2538;8639;114;606;1892;6187;2006;6793
230395;201711;5534;15553;4919;14473;545;1593;3287;9822;3832;11415
230400;201711;5536;16126;4944;15117;183;816;3942;11722;4125;12538
230410;201711;14413;44340;11982;39385;1518;5126;7236;23958;8754;29084
230420;201711;23937;72989;21092;67401;3366;11416;11076;35258;14442;46674
230423;201711;4381;13632;3884;12646;151;636;3099;9945;3250;10581
230425;201711;5473;17734;5018;16757;572;1981;3354;11216;3926;13197
230426;201711;2532;6979;1963;5884;53;231;1469;4313;1522;4544
230427;201711;1805;5262;1294;4094;76;257;867;2638;943;2895
230428;201711;9042;26161;8212;24794;1387;4463;4555;13639;5942;18102
230430;201711;4378;13398;3836;12394;242;949;2845;8927;3087;9876
230435;201711;5322;15519;4629;14285;612;1965;2782;8614;3394;10579
230440;201711;373131;1017214;320613;933128;57962;176479;164811;482128;222773;658607
230445;201711;4389;11891;3718;10718;209;566;2660;7606;2869;8172
230450;201711;3472;10616;3054;9879;227;943;2213;7027;2440;7970
230460;201711;1886;5874;1657;5449;102;401;1288;4219;1390;4620
230465;201711;3991;11554;3317;10329;119;524;2401;7225;2520;7749
230470;201711;11026;38439;10155;36703;975;4209;7279;25899;8254;30108
230480;201711;1395;4267;1191;3856;109;426;860;2709;969;3135
230490;201711;2296;6825;2010;6286;232;747;1133;3436;1365;4183
230495;201711;5589;17536;5035;16497;450;1819;3319;10728;3769;12547
230500;201711;8351;29167;7901;28268;428;1898;6071;21667;6499;23565
230510;201711;1585;5289;1184;4293;232;897;460;1669;692;2566
230520;201711;4267;12840;3868;12068;318;1095;2715;8354;3033;9449
230523;201711;14858;45833;12498;40681;3005;10047;3189;10876;6194;20923
230526;201711;3905;11427;3340;10422;151;665;2604;7893;2755;8558
230530;201711;5165;16318;4541;15282;511;1833;3181;10809;3692;12642
230533;201711;3956;10649;3441;9711;258;689;2615;7431;2873;8120
230535;201711;5402;15471;4615;14045;320;979;3213;9966;3533;10945
230540;201711;16294;46721;14682;44217;387;1618;12521;37197;12908;38815
230550;201711;19059;54180;16345;49235;2290;7372;9316;27795;11606;35167
230560;201711;7187;19418;5922;17072;132;520;4825;13633;4957;14153
230565;201711;3330;9110;2694;7963;95;355;1997;5848;2092;6203
230570;201711;3474;9154;3014;8524;87;273;2516;7068;2603;7341
230580;201711;9511;27677;8623;26354;437;1657;7171;21695;7608;23352
230590;201711;8899;26608;7492;23951;558;2009;5193;16180;5751;18189
230600;201711;3734;10097;2830;8313;98;324;1847;5473;1945;5797
230610;201711;6236;18617;5611;17613;475;1524;4224;13286;4699;14810
230620;201711;2095;5853;1628;4882;165;532;948;2778;1113;3310
230625;201711;7850;24240;6980;22384;2092;7013;1851;6142;3943;13155
230630;201711;10379;32200;9332;30100;2526;7672;4044;14114;6570;21786
230640;201711;26381;82634;24103;79024;1871;6977;18769;61194;20640;68171
230650;201711;4578;13690;4082;12720;294;999;3041;9338;3335;10337
230655;201711;9254;33065;8841;32325;603;2551;6983;25640;7586;28191
230660;201711;6002;18296;5078;16487;203;1042;4083;12945;4286;13987
230670;201711;5865;15046;4566;12785;174;542;3564;9745;3738;10287
230680;201711;2514;7313;2182;6667;252;781;1422;4351;1674;5132
230690;201711;6382;19962;5922;18967;596;2114;3648;11477;4244;13591
230700;201711;9259;25285;8149;23206;395;1370;6077;16769;6472;18139
230710;201711;7097;22604;6175;20863;562;2028;4501;15183;5063;17211
230720;201711;1816;5638;1543;5040;176;593;992;3209;1168;3802
230725;201711;3528;11660;3055;10470;767;2680;999;3445;1766;6125
230730;201711;53326;155466;45115;141933;11556;39652;14372;47567;25928;87219
230740;201711;6060;17537;5403;16418;164;640;4300;12941;4464;13581
230750;201711;8080;22639;6888;20647;252;932;5349;15651;5601;16583
230760;201711;11081;31512;10017;29623;843;2870;7134;20556;7977;23426
230763;201711;4272;12652;3712;11575;214;856;2811;8449;3025;9305
230765;201711;38791;115518;33830;106492;7949;26311;11893;38176;19842;64487
230770;201711;25428;67790;22018;62935;2890;8702;13771;39474;16661;48176
230780;201711;5765;21165;5482;20553;961;3571;3142;12251;4103;15822
230790;201711;2813;8587;2630;8288;159;551;2082;6567;2241;7118
230800;201711;7597;25582;6905;24112;991;3787;3870;13392;4861;17179
230810;201711;11411;35758;10523;34236;526;2072;8221;26328;8747;28400
230820;201711;3140;10543;2725;9635;293;1223;1658;5710;1951;6933
230830;201711;7337;21611;6420;19907;254;1066;5063;15381;5317;16447
230835;201711;3913;9968;3140;8739;124;434;2528;6874;2652;7308
230837;201711;3054;10045;2660;9248;161;736;1974;6686;2135;7422
230840;201711;8635;26957;7731;25376;566;2018;6000;19763;6566;21781
230850;201711;9025;27451;8131;25817;597;2070;5799;18372;6396;20442
230860;201711;4906;13515;4205;12446;171;620;3517;10282;3688;10902
230870;201711;17086;43662;14815;40223;602;1772;11663;31510;12265;33282
230880;201711;1964;6398;1825;6140;85;419;1385;4525;1470;4944
230890;201711;4271;14592;3956;13956;380;1478;2757;9660;3137;11138
230900;201711;2904;9178;2453;8207;341;1145;1462;4851;1803;5996
230910;201711;2978;8568;2444;7626;106;493;1909;5827;2015;6320
230920;201711;4389;12575;3998;12027;146;558;3440;10259;3586;10817
230930;201711;6564;19390;5657;17619;463;1559;3768;11635;4231;13194
230940;201711;7510;20926;6696;19573;198;683;5575;16180;5773;16863
230945;201711;6367;18854;5591;17361;458;1544;3788;11868;4246;13412
230950;201711;6281;16400;5715;15699;132;322;5099;14286;5231;14608
230960;201711;13375;40885;12175;38535;1968;6517;6128;19618;8096;26135
230970;201711;13109;38007;11361;35061;2099;6845;5479;17005;7578;23850
230980;201711;2689;8160;2343;7538;514;1594;1303;4358;1817;5952
230990;201711;1737;4996;1429;4419;98;408;959;2848;1057;3256
231000;201711;2521;6825;2102;5987;95;292;1477;4131;1572;4423
231010;201711;2950;7893;2428;7010;174;575;1792;5088;1966;5663
231020;201711;7913;25938;7372;24719;1286;4119;4356;15128;5642;19247
231025;201711;7238;21740;6602;20621;1108;3521;4067;12904;5175;16425
231030;201711;6834;21676;5713;19260;1032;3546;3001;10166;4033;13712
231040;201711;3085;9300;2710;8594;102;422;2076;6473;2178;6895
231050;201711;11432;31302;9528;27900;593;1790;7208;20926;7801;22716
231060;201711;2478;7700;2248;7320;96;454;1732;5558;1828;6012
231070;201711;7968;24566;7035;22713;1187;3883;3856;12631;5043;16514
231080;201711;3900;11785;3538;11151;136;697;2761;8366;2897;9063
231085;201711;5434;15349;4877;14645;400;1152;3648;11256;4048;12408
231090;201711;4165;11395;3265;9598;119;435;2303;6598;2422;7033
231095;201711;2041;6407;1754;5762;155;569;1202;3910;1357;4479
231100;201711;2957;9066;2541;8288;210;699;1831;5957;2041;6656
231110;201711;3339;10655;3282;10552;229;900;2373;7480;2602;8380
231120;201711;1893;6171;1719;5812;166;580;1140;3852;1306;4432
231123;201711;1942;5178;1647;4640;87;267;1222;3379;1309;3646
231126;201711;5847;16597;4750;14496;204;745;3421;10206;3625;10951
231130;201711;18242;53755;16349;50728;1914;6507;10873;34213;12787;40720
231135;201711;4079;11800;3462;10669;176;645;2509;7617;2685;8262
231140;201711;17027;51136;14391;46167;965;4017;9840;30717;10805;34734
231150;201711;5133;14853;4447;13540;708;2172;2275;7062;2983;9234
231160;201711;5492;17815;5103;17048;988;3145;2844;9825;3832;12970
231170;201711;4165;12892;3548;11598;231;892;2481;7902;2712;8794
231180;201711;13855;40478;11960;36544;2501;7743;5419;16427;7920;24170
231190;201711;4021;11595;3488;10697;186;771;2628;7781;2814;8552
231195;201711;4488;14681;3888;13410;273;1189;2762;9270;3035;10459
231200;201711;7890;25695;6858;23541;305;1520;5093;16969;5398;18489
231210;201711;4681;14611;4096;13615;199;874;3107;10088;3306;10962
231220;201711;11486;31428;9541;27775;533;1669;7024;19974;7557;21643
231230;201711;8839;28744;8004;27411;595;2352;6022;20689;6617;23041
231240;201711;11295;34525;10278;32510;1838;5914;5842;18706;7680;24620
231250;201711;1937;5279;1357;3939;126;356;730;2084;856;2440
231260;201711;3154;9453;2826;8913;356;1049;1854;6022;2210;7071
231270;201711;6669;18055;5735;16563;204;836;4440;12561;4644;13397
231280;201711;1668;5374;1557;5161;143;481;1106;3677;1249;4158
231290;201711;35330;111023;31223;102414;5564;19091;14375;46745;19939;65836
231300;201711;3952;11437;3262;10021;267;873;2135;6455;2402;7328
231310;201711;7322;20221;5973;17485;719;2113;3652;10558;4371;12671
231320;201711;7071;20817;5746;18153;163;736;4409;13699;4572;14435
231325;201711;2545;7309;2160;6672;429;1290;1143;3630;1572;4920
231330;201711;10125;32109;8754;29223;1744;5779;4473;15299;6217;21078
231335;201711;5391;14872;4615;13544;124;559;3900;11228;4024;11787
231340;201711;17243;55221;15751;52731;1258;4291;11849;40173;13107;44464
231350;201711;14766;41930;13757;40558;361;1111;12453;36886;12814;37997
231355;201711;4443;13795;4006;13023;230;886;3040;9824;3270;10710
231360;201711;7371;23062;6517;21567;674;2300;4579;15339;5253;17639
231370;201711;2322;6344;1834;5497;55;163;1380;4118;1435;4281
231375;201711;4159;13621;3851;13043;152;700;3157;10532;3309;11232
231380;201711;5527;15764;5207;15349;172;440;4522;13642;4694;14082
231390;201711;3314;10081;2992;9522;224;835;2136;6650;2360;7485
231395;201711;3823;12024;3327;11157;640;2155;1801;6143;2441;8298
231400;201711;8857;26630;8010;24967;408;1586;6147;18810;6555;20396
231410;201711;14586;46812;13155;44525;1039;3687;9977;33615;11016;37302
240010;201711;2432;6945;1936;5986;199;718;1179;3547;1378;4265
240020;201711;10556;31901;9333;29550;1177;4019;5750;18167;6927;22186
240030;201711;2527;6914;2434;6782;119;377;2142;5916;2261;6293
240040;201711;851;2439;698;2131;16;76;517;1508;533;1584
240050;201711;3295;8885;2747;7914;70;236;2154;6088;2224;6324
240060;201711;1368;3824;1188;3480;44;151;937;2679;981;2830
240070;201711;2233;6760;2064;6408;243;791;1475;4517;1718;5308
240080;201711;2795;7603;2378;6952;106;386;1793;5177;1899;5563
240090;201711;2199;5756;1828;5106;33;121;1468;4015;1501;4136
240100;201711;8278;22433;6978;19958;495;1497;5115;14297;5610;15794
240110;201711;4490;13651;3940;12600;413;1486;2484;7827;2897;9313
240120;201711;2519;8684;2384;8403;278;1129;1570;5459;1848;6588
240130;201711;2898;7112;2537;6556;88;282;2202;5592;2290;5874
240140;201711;2148;6421;1812;5762;208;765;1164;3642;1372;4407
240145;201711;5883;17682;5126;16370;827;2763;3137;10183;3964;12946
240150;201711;860;2669;761;2460;50;202;582;1815;632;2017
240160;201711;1366;4263;1195;3945;84;324;829;2758;913;3082
240165;201711;828;2526;723;2300;103;321;474;1515;577;1836
240170;201711;2243;6578;1921;5989;260;900;1168;3536;1428;4436
240180;201711;2695;8350;2357;7648;428;1419;1362;4488;1790;5907
240185;201711;1276;4252;1169;4072;66;284;959;3319;1025;3603
240190;201711;947;2958;841;2778;26;125;682;2228;708;2353
240200;201711;11098;30009;9490;27369;1660;4926;4444;13016;6104;17942
240210;201711;2747;7550;2486;7116;70;288;2081;5790;2151;6078
240220;201711;7195;23609;6551;22654;592;2506;4737;16365;5329;18871
240230;201711;5669;14874;4753;13378;293;809;3710;10449;4003;11258
240240;201711;1768;5370;1066;3583;174;600;224;710;398;1310
240250;201711;2612;7528;2433;7280;206;560;1916;5792;2122;6352
240260;201711;11762;38257;10996;36974;1463;5169;7203;24570;8666;29739
240270;201711;2242;6883;2059;6588;122;381;1672;5420;1794;5801
240280;201711;1575;4263;1378;3982;51;170;1139;3239;1190;3409
240290;201711;1177;3600;1005;3244;44;209;664;1977;708;2186
240300;201711;2230;5968;1661;4837;124;400;943;2690;1067;3090
240310;201711;9035;24982;7867;23013;1019;3174;4353;12716;5372;15890
240320;201711;1979;5600;1433;4446;35;167;1133;3319;1168;3486
240325;201711;28972;82210;23524;72835;6745;21990;6176;20356;12921;42346
240330;201711;1440;4271;1211;3792;60;235;815;2448;875;2683
240340;201711;1932;4833;1592;4305;94;246;1220;3246;1314;3492
240350;201711;2018;5496;1865;5311;47;159;1642;4677;1689;4836
240360;201711;6676;20300;5992;19210;1400;4368;3124;10592;4524;14960
240370;201711;1992;5463;1574;4642;134;396;1012;2960;1146;3356
240375;201711;854;2257;753;2072;36;141;566;1475;602;1616
240380;201711;2305;6749;1700;5366;158;523;947;2935;1105;3458
240390;201711;894;2418;695;2012;12;39;480;1308;492;1347
240400;201711;1313;3469;1013;2897;33;117;694;1902;727;2019
240410;201711;492;1579;439;1457;62;249;260;835;322;1084
240420;201711;4415;16746;4067;15928;645;3053;2212;8483;2857;11536
240430;201711;3222;8948;2837;8209;197;704;2130;5939;2327;6643
240440;201711;2455;5976;2136;5529;241;642;1494;3837;1735;4479
240450;201711;3918;11297;3244;10021;374;1242;1918;5797;2292;7039
240460;201711;2961;8739;2755;8443;262;873;2164;6615;2426;7488
240470;201711;3589;11075;2811;9426;358;1197;1604;5411;1962;6608
240480;201711;540;1468;397;1190;38;117;192;568;230;685
240485;201711;2065;6225;1764;5633;173;563;1172;3801;1345;4364
240490;201711;1710;4273;1412;3775;25;66;1198;3188;1223;3254
240500;201711;2197;6005;1926;5621;66;222;1610;4677;1676;4899
240510;201711;1620;4598;1508;4432;120;365;1236;3583;1356;3948
240520;201711;1263;3415;1080;3146;43;183;910;2567;953;2750
240530;201711;1877;6023;1742;5802;156;569;1313;4338;1469;4907
240540;201711;1988;5374;1797;5085;66;240;1558;4319;1624;4559
240550;201711;715;2009;618;1840;37;116;464;1371;501;1487
240560;201711;3212;8903;2892;8448;311;795;2179;6505;2490;7300
240570;201711;2916;7901;2076;6010;285;889;983;2602;1268;3491
240580;201711;7478;22627;6922;21670;523;1813;5523;17189;6046;19002
240590;201711;699;1934;603;1757;19;70;474;1353;493;1423
240600;201711;1649;4667;1240;3803;102;366;761;2248;863;2614
240610;201711;4367;12367;3776;11273;257;840;2649;7781;2906;8621
240615;201711;1019;2953;815;2525;101;357;523;1547;624;1904
240620;201711;1805;5253;1569;4847;131;366;1226;3787;1357;4153
240630;201711;2012;5991;1835;5694;153;404;1264;4030;1417;4434
240640;201711;908;2514;736;2236;60;234;512;1497;572;1731
240650;201711;3890;11182;3485;10521;175;557;2763;8306;2938;8863
240660;201711;2502;7365;2348;7137;107;390;2008;6001;2115;6391
240670;201711;2450;7236;2048;6373;185;657;1284;3860;1469;4517
240680;201711;1527;4343;1233;3824;59;221;875;2657;934;2878
240690;201711;869;2324;726;2069;27;97;593;1630;620;1727
240700;201711;2408;7089;2021;6377;68;289;1583;4876;1651;5165
240710;201711;15507;42665;13689;39414;2697;7578;7340;21688;10037;29266
240720;201711;5045;13772;4466;12818;877;2617;2488;7016;3365;9633
240725;201711;1040;3117;817;2601;49;169;523;1629;572;1798
240730;201711;2068;6051;1781;5481;114;371;1335;4062;1449;4433
240740;201711;1821;5084;1574;4623;73;302;1155;3226;1228;3528
240750;201711;2015;7391;1847;7043;360;1501;965;3722;1325;5223
240760;201711;1335;3529;998;3001;57;153;761;2320;818;2473
240770;201711;3035;8634;2705;8170;133;518;2263;6697;2396;7215
240780;201711;5382;14933;4435;13401;539;1651;2731;8402;3270;10053
240790;201711;854;2527;707;2243;21;86;537;1699;558;1785
240800;201711;34168;94989;29703;87445;5471;16703;13678;40706;19149;57409
240810;201711;78517;222155;71165;209211;17210;50467;33627;101117;50837;151584
240820;201711;5202;16649;4682;15781;979;3374;2430;8546;3409;11920
240830;201711;8506;25585;7898;24655;329;1395;6566;20212;6895;21607
240840;201711;1114;2997;926;2667;78;236;633;1777;711;2013
240850;201711;1239;3601;924;2893;68;221;511;1588;579;1809
240860;201711;1237;3461;976;2967;31;138;732;2114;763;2252
240870;201711;1143;2994;898;2574;62;184;614;1722;676;1906
240880;201711;1234;4032;1167;3897;91;342;933;3082;1024;3424
240890;201711;4673;13001;3724;11172;663;2076;1717;5099;2380;7175
240895;201711;2549;8721;2374;8433;243;929;1774;6362;2017;7291
240910;201711;3018;8710;2632;7960;78;291;2134;6379;2212;6670
240920;201711;782;2439;672;2214;81;286;360;1178;441;1464
240930;201711;3435;8533;2971;7967;75;179;2410;6564;2485;6743
240933;201711;1685;4322;1447;3937;46;165;1190;3163;1236;3328
240940;201711;6107;15743;4929;13797;398;1149;3447;9450;3845;10599
240950;201711;935;2969;846;2789;42;184;635;2043;677;2227
240960;201711;783;2383;683;2179;50;171;492;1543;542;1714
240970;201711;1797;4910;1519;4415;59;221;1228;3455;1287;3676
240980;201711;2817;9139;2596;8735;276;1062;1866;6174;2142;7236
240990;201711;2483;7376;2330;7071;328;1054;1609;4813;1937;5867
241000;201711;951;2610;804;2341;35;116;565;1626;600;1742
241010;201711;2640;8834;2494;8559;276;1159;1792;5929;2068;7088
241020;201711;2025;5558;1539;4550;193;531;896;2640;1089;3171
241025;201711;1674;4957;1414;4470;89;308;934;2955;1023;3263
241030;201711;2395;7796;2053;7079;201;778;1372;4691;1573;5469
241040;201711;2244;7355;2012;6955;133;559;1545;5335;1678;5894
241050;201711;1252;3632;1057;3270;57;200;767;2324;824;2524
241060;201711;765;2195;676;2022;55;156;461;1375;516;1531
241070;201711;636;1833;569;1717;41;162;436;1237;477;1399
241080;201711;1124;3259;870;2754;22;102;647;1997;669;2099
241090;201711;1884;5724;1621;5256;72;329;1246;3985;1318;4314
241100;201711;1112;3250;927;2833;54;190;647;1922;701;2112
241105;201711;1097;3307;931;3005;246;781;376;1252;622;2033
241110;201711;853;2569;682;2181;34;132;455;1398;489;1530
241120;201711;7015;21078;6245;19679;1396;4169;3259;10951;4655;15120
241140;201711;3254;8633;2750;7662;178;490;2021;5511;2199;6001
241142;201711;753;2104;569;1745;47;164;331;977;378;1141
241150;201711;5430;15399;4867;14460;253;943;3749;10923;4002;11866
241160;201711;1346;3825;1197;3562;155;453;797;2341;952;2794
241170;201711;1168;3199;1051;3006;59;189;857;2385;916;2574
241180;201711;953;2600;709;2106;77;229;378;1110;455;1339
241190;201711;1096;2991;893;2580;35;131;643;1772;678;1903
241200;201711;17624;49556;15557;46427;3563;10930;7366;22638;10929;33568
241210;201711;1427;3945;1111;3313;107;334;672;1971;779;2305
241220;201711;7903;25320;7198;24025;2200;7399;3024;10584;5224;17983
241230;201711;2960;8303;2678;7850;109;416;2237;6369;2346;6785
241240;201711;1191;3468;704;2300;54;203;357;1167;411;1370
241250;201711;5855;17583;4816;15572;191;958;3577;11123;3768;12081
241255;201711;1815;6437;1622;5997;211;910;998;3643;1209;4553
241260;201711;4968;13293;3941;11636;120;537;2933;8454;3053;8991
241270;201711;1786;5371;1543;4890;111;441;1116;3468;1227;3909
241280;201711;1816;5088;1649;4792;110;339;1314;3761;1424;4100
241290;201711;3018;8060;2449;7098;110;395;1872;5313;1982;5708
241300;201711;1442;4034;1222;3633;43;135;832;2425;875;2560
241310;201711;1782;4934;1599;4634;53;202;1345;3837;1398;4039
241320;201711;887;3083;797;2866;95;392;520;1842;615;2234
241330;201711;1373;4117;1280;3995;51;217;1113;3423;1164;3640
241335;201711;2856;8346;2583;7859;116;416;2138;6416;2254;6832
241340;201711;1720;5201;1406;4488;300;984;618;1937;918;2921
241350;201711;1853;5704;1679;5375;97;368;1273;3984;1370;4352
241355;201711;1324;3686;1071;3219;38;153;826;2449;864;2602
241360;201711;2052;5425;1658;4650;67;203;1230;3374;1297;3577
241370;201711;1343;3888;1076;3362;90;327;697;2088;787;2415
241380;201711;637;1778;511;1528;62;211;308;889;370;1100
241390;201711;2572;8236;2389;7941;178;668;1872;6213;2050;6881
241400;201711;3563;10156;3210;9639;253;819;2511;7525;2764;8344
241410;201711;2337;7075;2030;6551;406;1371;1104;3562;1510;4933
241415;201711;1597;4771;1380;4380;120;421;1035;3227;1155;3648
241420;201711;2033;7032;1812;6624;558;2175;573;2135;1131;4310
241430;201711;517;1501;397;1249;34;123;245;749;279;872
241440;201711;6655;22516;6086;21510;512;2145;4606;16113;5118;18258
241445;201711;940;2683;895;2630;29;64;817;2461;846;2525
241450;201711;2833;7390;2526;6950;258;670;1878;5189;2136;5859
241460;201711;3366;9539;2936;8650;208;709;2109;6051;2317;6760
241470;201711;1347;3682;1105;3342;58;213;889;2664;947;2877
241475;201711;1213;3593;956;3073;33;183;702;2122;735;2305
241480;201711;2615;8516;2335;7992;881;3022;629;2487;1510;5509
241490;201711;677;1739;546;1522;24;72;380;1027;404;1099
241500;201711;744;2312;640;2184;16;63;553;1882;569;1945
250010;201711;2714;8312;2254;7316;83;360;1666;5275;1749;5635
250020;201711;1557;4363;1174;3611;63;199;810;2439;873;2638
250030;201711;6697;18993;6098;18123;348;1139;4946;14494;5294;15633
250040;201711;3848;12656;3529;11995;331;1246;2499;8383;2830;9629
250050;201711;3263;9850;3012;9457;322;1072;2203;6818;2525;7890
250053;201711;1190;3548;1092;3398;110;365;782;2457;892;2822
250057;201711;633;2512;615;2489;4;16;589;2421;593;2437
250060;201711;5088;14479;4691;13930;430;1316;3662;10935;4092;12251
250070;201711;3799;11429;3477;10826;66;340;2695;8082;2761;8422
250073;201711;753;2177;648;1997;17;67;498;1478;515;1545
250077;201711;2143;6064;1667;5236;94;307;1204;3757;1298;4064
250080;201711;4196;11686;3887;11209;132;492;3277;9258;3409;9750
250090;201711;2633;7174;2431;6849;135;344;2009;5632;2144;5976
250100;201711;3756;11903;3497;11424;176;726;2851;9065;3027;9791
250110;201711;4730;13795;4411;13328;430;1552;3452;10153;3882;11705
250115;201711;496;1516;449;1440;17;92;336;1031;353;1123
250120;201711;1667;5207;1460;4827;61;280;1164;3831;1225;4111
250130;201711;5176;15685;4605;14669;129;688;3677;11441;3806;12129
250135;201711;1038;3106;967;2983;23;94;811;2474;834;2568
250140;201711;2054;6543;1989;6438;100;434;1655;5307;1755;5741
250150;201711;4783;15855;4412;15132;189;915;3417;11455;3606;12370
250153;201711;1452;3824;1193;3444;27;116;991;2801;1018;2917
250157;201711;1753;5528;1596;5199;199;612;1105;3656;1304;4268
250160;201711;3442;9535;3081;9031;59;206;2803;8202;2862;8408
250170;201711;1617;4553;1457;4309;68;257;1191;3478;1259;3735
250180;201711;15909;44340;14661;42529;1060;3598;11044;31282;12104;34880
250190;201711;3951;11296;3571;10675;532;1510;2303;6922;2835;8432
250200;201711;1833;5369;1555;4925;55;225;1272;4000;1327;4225
250205;201711;772;2652;724;2543;23;128;584;2019;607;2147
250210;201711;1478;4717;1366;4530;59;298;1080;3493;1139;3791
250215;201711;1363;4130;1212;3900;70;267;801;2557;871;2824
250220;201711;704;2035;565;1823;25;85;426;1370;451;1455
250230;201711;1615;3913;1234;3292;37;126;976;2510;1013;2636
250240;201711;2206;7094;2036;6785;74;289;1671;5521;1745;5810
250250;201711;4367;12846;3944;12255;128;456;3295;10191;3423;10647
250260;201711;1640;4782;1417;4398;41;139;1135;3520;1176;3659
250270;201711;1243;3791;1105;3618;82;264;827;2830;909;3094
250280;201711;3329;9753;2913;9080;155;538;2283;7075;2438;7613
250290;201711;1704;4639;1459;4294;17;45;1226;3612;1243;3657
250300;201711;5048;14738;4797;14419;269;1132;4094;11975;4363;13107
250310;201711;1072;3200;952;2983;33;136;748;2270;781;2406
250320;201711;8408;23084;7775;22228;662;2099;6133;17301;6795;19400
250330;201711;2352;7086;2002;6562;128;463;1553;5026;1681;5489
250340;201711;1069;3015;937;2803;15;57;795;2339;810;2396
250350;201711;4056;11269;3702;10796;136;375;3216;9455;3352;9830
250355;201711;1915;5992;1768;5807;26;142;1610;5262;1636;5404
250360;201711;1763;5113;1645;4917;34;116;1371;4086;1405;4202
250370;201711;11341;31986;9953;30214;534;1843;8305;25059;8839;26902
250375;201711;1018;2992;918;2850;17;66;822;2575;839;2641
250380;201711;1597;4431;1507;4312;52;192;1245;3439;1297;3631
250390;201711;1748;4725;1461;4240;188;526;969;2831;1157;3357
250400;201711;68429;177967;52226;152187;13825;42158;18072;54404;31897;96562
250403;201711;1545;4917;1424;4751;157;668;995;3214;1152;3882
250407;201711;1192;3197;1021;2942;76;176;746;2156;822;2332
250410;201711;534;1636;482;1541;12;62;396;1215;408;1277
250415;201711;1894;5548;1682;5175;66;225;1328;4079;1394;4304
250420;201711;1197;3464;1095;3319;18;66;1002;3040;1020;3106
250430;201711;6093;15938;5413;14932;197;634;4467;12072;4664;12706
250435;201711;1345;3994;1181;3715;44;177;903;2796;947;2973
250440;201711;4400;12365;3940;11725;103;391;3365;9902;3468;10293
250450;201711;1824;5064;1567;4710;38;146;1305;3866;1343;4012
250460;201711;6339;18505;5970;18041;289;913;5238;15974;5527;16887
250470;201711;1489;3978;1243;3622;65;237;934;2640;999;2877
250480;201711;3652;10833;3339;10423;47;202;3005;9433;3052;9635
250485;201711;678;1606;496;1336;26;75;401;1045;427;1120
250490;201711;4154;11725;3865;11360;291;954;3136;9178;3427;10132
250500;201711;1853;5377;1659;5053;88;292;1338;4069;1426;4361
250510;201711;5012;13462;4394;12617;83;253;3938;11335;4021;11588
250520;201711;1718;4999;1559;4764;194;657;1027;3065;1221;3722
250523;201711;1897;5199;1771;5041;78;338;1534;4242;1612;4580
250527;201711;1571;4370;1469;4248;30;112;1361;3904;1391;4016
250530;201711;579;1741;513;1650;17;73;454;1447;471;1520
250535;201711;1338;4085;1230;3875;40;197;967;2966;1007;3163
250540;201711;2439;6485;2183;6183;56;164;1951;5516;2007;5680
250550;201711;838;2807;762;2679;31;157;617;2113;648;2270
250560;201711;1626;4869;1513;4694;48;188;1255;3792;1303;3980
250570;201711;2506;7759;2204;7196;92;410;1763;5606;1855;6016
250580;201711;1040;2756;938;2604;49;187;776;2100;825;2287
250590;201711;803;2424;721;2292;23;113;591;1819;614;1932
250600;201711;7111;20165;6542;19299;519;1399;5250;15648;5769;17047
250610;201711;2931;8492;2717;8166;162;560;2217;6590;2379;7150
250620;201711;674;1928;597;1777;45;172;434;1250;479;1422
250625;201711;2485;7546;2319;7281;42;178;2044;6322;2086;6500
250630;201711;9125;27378;8110;25306;1337;4312;4840;14868;6177;19180
250640;201711;3324;9965;3114;9669;126;572;2628;7956;2754;8528
250650;201711;849;2221;725;2057;36;117;577;1585;613;1702
250660;201711;1660;4276;1496;4063;28;74;1370;3707;1398;3781
250670;201711;2244;7379;2117;7155;64;348;1803;5937;1867;6285
250680;201711;4876;12886;4566;12530;150;527;4120;11170;4270;11697
250690;201711;6116;15071;5778;14670;210;505;5307;13464;5517;13969
250700;201711;4295;12503;3880;11854;417;1305;2813;8540;3230;9845
250710;201711;4307;13021;3815;12349;358;1264;2722;8884;3080;10148
250720;201711;2685;7389;2455;7026;40;185;2219;6278;2259;6463
250730;201711;3689;10437;3327;9934;198;708;2727;7936;2925;8644
250740;201711;1845;5043;1568;4634;139;446;1212;3495;1351;3941
250750;201711;92975;253729;84124;240781;9300;28780;57009;160435;66309;189215
250760;201711;2285;6203;2003;5766;128;397;1565;4427;1693;4824
250770;201711;3744;12174;3473;11811;301;1189;2554;8617;2855;9806
250780;201711;1682;4816;1440;4341;132;450;995;2926;1127;3376
250790;201711;2266;7160;2089;6871;328;1106;1305;4345;1633;5451
250800;201711;2447;6767;2134;6252;84;217;1747;5101;1831;5318
250810;201711;1224;3486;1039;3209;37;146;844;2577;881;2723
250820;201711;1775;5585;1719;5516;77;323;1537;4877;1614;5200
250830;201711;5176;16293;4725;15331;376;1466;3332;10550;3708;12016
250840;201711;845;2706;731;2472;21;93;507;1727;528;1820
250850;201711;1891;5699;1688;5364;53;284;1365;4202;1418;4486
250855;201711;1038;3060;899;2815;34;152;687;2094;721;2246
250860;201711;3131;9853;2634;8957;484;1758;1311;4511;1795;6269
250870;201711;1052;2986;908;2710;34;120;728;2153;762;2273
250880;201711;1504;4051;1234;3650;157;451;804;2441;961;2892
250890;201711;9117;26262;8630;25599;710;2683;6818;19633;7528;22316
250900;201711;2639;8220;2321;7608;102;377;1870;6016;1972;6393
250905;201711;2065;6280;1980;6169;94;365;1718;5303;1812;5668
250910;201711;4911;13776;4564;13275;147;538;3942;11398;4089;11936
250915;201711;1579;4381;1375;4160;28;56;1272;3934;1300;3990
250920;201711;3116;8671;2906;8337;322;873;2131;6079;2453;6952
250930;201711;1948;5685;1842;5516;95;344;1519;4464;1614;4808
250933;201711;1099;3517;985;3282;46;229;698;2239;744;2468
250937;201711;683;1988;573;1785;34;124;429;1312;463;1436
250939;201711;1615;4579;1406;4248;53;218;1140;3336;1193;3554
250940;201711;3663;10583;3417;10189;53;212;3064;9144;3117;9356
250950;201711;1417;4056;1199;3766;37;160;1036;3238;1073;3398
250960;201711;1048;3254;964;3112;31;134;789;2499;820;2633
250970;201711;8275;22493;7152;20690;456;1521;5367;15276;5823;16797
250980;201711;2478;7090;2260;6679;65;274;1813;5190;1878;5464
250990;201711;1889;6195;1669;5712;105;467;1223;4079;1328;4546
251000;201711;2034;5847;1723;5361;45;210;1444;4430;1489;4640
251010;201711;2593;7517;2342;7114;43;168;2100;6376;2143;6544
251020;201711;1634;4491;1505;4329;55;172;1369;3924;1424;4096
251030;201711;982;2768;870;2544;46;166;613;1735;659;1901
251040;201711;1744;5293;1534;4924;57;276;1241;3870;1298;4146
251050;201711;1064;3017;876;2658;98;307;600;1769;698;2076
251060;201711;1019;2271;749;1918;18;84;604;1497;622;1581
251065;201711;452;1289;368;1172;17;76;249;736;266;812
251070;201711;718;2108;641;2006;18;70;546;1693;564;1763
251080;201711;17995;49162;15794;45796;2755;8386;9125;26749;11880;35135
251090;201711;2793;8340;2407;7595;83;321;1887;5859;1970;6180
251100;201711;871;2719;771;2544;34;162;547;1722;581;1884
251110;201711;1732;4939;1512;4515;61;182;1145;3377;1206;3559
251120;201711;6217;20114;5811;19397;380;1566;4477;14768;4857;16334
251130;201711;3629;9039;3292;8661;306;811;2826;7430;3132;8241
251140;201711;4239;12429;3904;11939;115;471;3237;9826;3352;10297
251150;201711;2622;7982;2411;7656;143;613;1907;5889;2050;6502
251160;201711;1872;6007;1756;5827;73;251;1559;5209;1632;5460
251170;201711;1475;4290;1368;4164;36;138;1241;3777;1277;3915
251180;201711;2436;7200;2169;6786;234;802;1429;4423;1663;5225
251190;201711;4371;11846;4148;11568;81;304;3765;10318;3846;10622
251200;201711;3969;12549;3713;12225;85;350;3343;11063;3428;11413
251203;201711;930;3107;883;3007;38;174;671;2223;709;2397
251207;201711;1007;3044;831;2715;22;122;581;1842;603;1964
251210;201711;7435;20304;6221;18744;333;1026;4980;15141;5313;16167
251220;201711;1155;2970;932;2668;44;110;734;2123;778;2233
251230;201711;4560;12791;4066;12114;170;618;3451;10078;3621;10696
251240;201711;3359;9712;2922;9086;222;728;2183;6665;2405;7393
251250;201711;9776;27962;8998;26808;867;2807;6484;18846;7351;21653
251260;201711;455;1426;410;1346;14;62;312;1006;326;1068
251270;201711;4102;13154;3718;12659;130;587;3164;10782;3294;11369
251272;201711;1273;3571;1188;3449;36;142;1059;3045;1095;3187
251274;201711;888;2639;740;2371;51;222;498;1503;549;1725
251275;201711;1212;3501;1097;3307;45;190;829;2370;874;2560
251276;201711;1109;3282;1053;3195;55;239;873;2595;928;2834
251278;201711;593;1784;522;1646;47;178;356;1113;403;1291
251280;201711;2218;6407;2034;6098;58;262;1634;4727;1692;4989
251290;201711;5534;14678;5221;14276;337;1226;4333;11452;4670;12678
251300;201711;746;2410;703;2338;13;57;586;1929;599;1986
251310;201711;2761;8157;2536;7816;93;444;2047;6124;2140;6568
251315;201711;1618;5300;1507;5112;100;360;1167;3916;1267;4276
251320;201711;1711;4615;1232;3812;56;204;871;2676;927;2880
251330;201711;1828;4668;1506;4261;45;174;1355;3791;1400;3965
251335;201711;1006;3206;911;3055;54;228;697;2266;751;2494
251340;201711;3436;9378;2917;8678;127;428;2224;6527;2351;6955
251350;201711;1094;3392;1015;3259;36;160;826;2568;862;2728
251360;201711;1752;5326;1453;4909;26;115;1257;4283;1283;4398
251365;201711;712;2103;581;1816;12;53;451;1394;463;1447
251370;201711;22301;66246;21278;64811;2062;6913;16019;48315;18081;55228
251380;201711;1266;3814;1096;3532;26;127;925;2880;951;3007
251385;201711;707;1875;559;1618;21;70;404;1113;425;1183
251390;201711;5759;18468;5032;17091;1083;3878;2568;8639;3651;12517
251392;201711;989;2818;856;2598;43;167;630;1854;673;2021
251394;201711;618;2007;535;1862;27;122;406;1389;433;1511
251396;201711;746;2086;640;1910;42;111;438;1292;480;1403
251398;201711;905;2487;696;2120;27;111;500;1465;527;1576
251400;201711;1096;3042;926;2794;52;184;665;1932;717;2116
251410;201711;1579;3921;1305;3502;26;96;1091;2842;1117;2938
251420;201711;1844;5178;1561;4842;67;280;1218;3681;1285;3961
251430;201711;1529;4998;1383;4753;42;220;1192;4031;1234;4251
251440;201711;1123;3331;919;2929;29;111;728;2307;757;2418
251445;201711;1509;4486;1420;4366;90;351;1129;3373;1219;3724
251450;201711;4337;13447;3954;12898;91;415;3312;10711;3403;11126
251455;201711;991;3106;880;2887;56;246;654;2091;710;2337
251460;201711;825;2495;749;2374;28;114;623;1993;651;2107
251465;201711;428;1339;360;1184;14;65;272;881;286;946
251470;201711;1119;3178;874;2659;81;263;547;1620;628;1883
251480;201711;908;2498;788;2303;28;118;581;1633;609;1751
251490;201711;1785;5091;1517;4704;122;411;1026;3133;1148;3544
251500;201711;1748;5385;1652;5207;79;320;1391;4300;1470;4620
251510;201711;2438;7876;2180;7343;231;893;1354;4460;1585;5353
251520;201711;939;2558;735;2147;84;224;464;1343;548;1567
251530;201711;12113;32449;11201;31194;193;873;9896;27031;10089;27904
251540;201711;2769;8564;2535;8116;121;473;2017;6353;2138;6826
251550;201711;3473;8852;2838;8022;82;285;2358;6610;2440;6895
251560;201711;605;1892;546;1794;96;341;323;1015;419;1356
251570;201711;936;2742;769;2409;26;103;548;1650;574;1753
251580;201711;1799;4786;1627;4549;164;431;1271;3561;1435;3992
251590;201711;1509;4236;1361;4048;59;180;1105;3270;1164;3450
251593;201711;961;2909;886;2797;118;384;536;1652;654;2036
251597;201711;1944;5804;1865;5701;26;101;1707;5182;1733;5283
251600;201711;6347;18047;5784;17174;223;745;4815;14142;5038;14887
251610;201711;3256;9484;2854;8733;321;926;1964;6096;2285;7022
251615;201711;1125;3065;912;2703;27;125;674;1919;701;2044
251620;201711;15741;40131;13797;37877;315;785;11590;33426;11905;34211
251630;201711;4507;11265;3733;10185;223;626;2819;7626;3042;8252
251640;201711;2055;6119;1882;5784;74;314;1583;4762;1657;5076
251650;201711;3966;11016;3572;10493;176;591;3028;8848;3204;9439
251660;201711;3401;10611;3036;9956;93;461;2517;8071;2610;8532
251670;201711;4273;12434;3791;11804;34;162;3509;10966;3543;11128
251675;201711;687;2091;633;2020;101;348;403;1266;504;1614
251680;201711;2627;7433;2160;6724;60;229;1757;5427;1817;5656
251690;201711;3264;9464;2867;8699;87;290;2090;6205;2177;6495
251700;201711;1842;5865;1723;5709;80;380;1439;4654;1519;5034
251710;201711;817;2182;555;1632;62;223;279;788;341;1011
251720;201711;1376;4067;1146;3634;35;153;874;2682;909;2835
251740;201711;670;1895;539;1660;43;140;358;1073;401;1213
260005;201711;25317;58976;21602;53831;2952;7262;14295;35548;17247;42810
260010;201711;9513;25500;8009;23372;603;1785;5023;15010;5626;16795
260020;201711;6385;16330;5407;14914;138;555;4524;12335;4662;12890
260030;201711;6098;16905;5333;15711;254;891;4236;12435;4490;13326
260040;201711;8282;22199;6970;20422;716;2041;4886;14598;5602;16639
260050;201711;11172;33583;10361;32614;380;1420;9046;28730;9426;30150
260060;201711;3747;10309;3297;9520;264;724;2496;7288;2760;8012
260070;201711;9602;26639;8672;25193;707;2344;6361;18183;7068;20527
260080;201711;6247;15332;5572;14353;221;662;4591;11579;4812;12241
260090;201711;5096;13438;4702;12904;571;1523;3491;9715;4062;11238
260100;201711;3195;8700;2739;8050;131;468;2241;6556;2372;7024
260105;201711;5020;13775;4663;13234;131;550;3999;11108;4130;11658
260110;201711;21867;58862;19947;56471;1001;2973;17252;48848;18253;51821
260120;201711;13093;37452;11469;34811;1905;5867;6721;21013;8626;26880
260130;201711;3019;8302;2795;7947;270;816;2083;5824;2353;6640
260140;201711;12388;30204;10881;28315;609;1759;8972;23392;9581;25151
260150;201711;3270;8446;2851;7916;168;555;2348;6453;2516;7008
260160;201711;5706;16943;4901;15864;131;602;4185;13649;4316;14251
260170;201711;16497;44595;15384;43056;1217;3339;12299;34563;13516;37902
260180;201711;3245;9451;2941;9000;156;560;2486;7527;2642;8087
260190;201711;16416;36476;14607;34301;257;764;12821;29598;13078;30362
260200;201711;11039;27442;9832;25920;381;1106;8703;22827;9084;23933
260210;201711;11774;34511;10231;32015;390;1535;8299;25893;8689;27428
260220;201711;9549;25440;9107;24878;267;934;8246;22284;8513;23218
260230;201711;9768;26438;8744;25037;390;1324;7029;19976;7419;21300
260240;201711;2799;8304;2456;7778;210;709;1891;6002;2101;6711
260250;201711;2145;5938;1878;5549;83;297;1521;4407;1604;4704
260260;201711;11877;33202;10641;31342;585;2046;8409;24520;8994;26566
260270;201711;3536;10003;3245;9573;196;842;2504;7128;2700;7970
260280;201711;12743;40168;11789;38756;518;1976;10144;33343;10662;35319
260290;201711;33744;95512;31161;91257;4596;14002;19935;57993;24531;71995
260300;201711;8880;25997;7844;24474;282;1239;6329;19657;6611;20896
260310;201711;4297;12309;3879;11705;567;1588;2646;8264;3213;9852
260320;201711;7262;22241;6606;21070;294;1079;5403;17109;5697;18188
260330;201711;2489;7877;2296;7506;110;426;1811;5786;1921;6212
260340;201711;1920;5367;1721;5083;31;124;1521;4459;1552;4583
260345;201711;21918;64296;20096;61132;4466;14679;8942;26308;13408;40987
260350;201711;4894;12762;4491;12210;153;518;3897;10480;4050;10998
260360;201711;2446;6736;2213;6326;83;367;1538;4308;1621;4675
260370;201711;5381;16286;4748;15136;261;1058;3609;11347;3870;12405
260380;201711;4759;15096;4235;14222;228;916;3136;10442;3364;11358
260390;201711;4157;13028;3602;11892;261;941;2480;8077;2741;9018
260392;201711;3410;11009;3108;10606;161;796;2599;8738;2760;9534
260400;201711;13950;37222;12937;35668;1123;3415;9701;26262;10824;29677
260410;201711;57854;159620;49317;146479;11768;36984;20368;62143;32136;99127
260415;201711;3678;11093;3228;10207;151;698;2307;7014;2458;7712
260420;201711;12116;27175;10780;25701;185;572;9891;23415;10076;23987
260430;201711;2861;9014;2475;8271;166;631;1716;5689;1882;6320
260440;201711;3365;9640;2993;8949;205;753;2266;6589;2471;7342
260450;201711;5072;14021;4827;13688;166;496;4310;12248;4476;12744
260460;201711;5225;16542;4755;15629;658;2436;2805;8989;3463;11425
260470;201711;4719;13171;4106;12466;107;301;3662;11411;3769;11712
260480;201711;4137;11276;3526;10409;378;1254;2333;7015;2711;8269
260490;201711;4924;12455;4344;11474;113;412;3755;9658;3868;10070
260500;201711;5826;15919;5021;14703;580;1640;3328;9895;3908;11535
260510;201711;9099;22939;8029;21528;243;779;7137;18971;7380;19750
260515;201711;4482;13083;3438;11010;174;622;2271;7190;2445;7812
260520;201711;16556;41162;15540;39799;1159;3017;12572;31995;13731;35012
260530;201711;9164;27822;8058;26058;252;1106;6805;21888;7057;22994
260540;201711;5873;14410;5325;13788;588;1210;4351;11660;4939;12870
260545;201711;48;146;23;87;7;24;4;17;11;41
260550;201711;2747;8530;2335;7644;227;898;1386;4459;1613;5357
260560;201711;6141;15941;5367;14868;131;546;4631;12661;4762;13207
260570;201711;6851;20861;6236;19943;606;2005;4771;15306;5377;17311
260580;201711;3830;10162;3459;9598;53;222;3105;8497;3158;8719
260590;201711;6303;15581;5766;14967;255;695;5005;13039;5260;13734
260600;201711;28745;80097;24860;73907;1464;5181;18361;53843;19825;59024
260610;201711;6293;18116;5915;17543;514;1637;4475;13173;4989;14810
260620;201711;14498;42681;13757;41437;2059;6896;8911;26244;10970;33140
260630;201711;2307;6387;1944;5839;51;214;1618;4823;1669;5037
260640;201711;17716;45853;16229;43952;1300;3908;12310;33042;13610;36950
260650;201711;5279;15946;4609;14842;189;806;3800;12164;3989;12970
260660;201711;7374;20007;6511;18906;187;766;5552;15878;5739;16644
260670;201711;2248;5928;1867;5370;104;316;1346;3838;1450;4154
260680;201711;21893;59205;19576;55307;2820;8093;11233;31657;14053;39750
260690;201711;3570;9516;2984;8577;124;398;2399;6860;2523;7258
260700;201711;5653;17056;5497;16882;23;38;5389;16713;5412;16751
260710;201711;1291;3598;1219;3501;71;247;910;2679;981;2926
260720;201711;18571;55250;17181;52827;3023;9486;10077;31003;13100;40489
260730;201711;6778;21342;6193;20465;429;1666;4976;16169;5405;17835
260740;201711;1296;3802;1151;3563;32;109;951;2946;983;3055
260750;201711;6858;19759;5986;18652;151;445;5385;17075;5536;17520
260760;201711;5037;12864;4565;12299;225;679;3800;10282;4025;10961
260765;201711;7247;23946;6772;23164;829;3472;4570;15184;5399;18656
260770;201711;3716;9937;3276;9211;105;344;2586;7217;2691;7561
260775;201711;4884;13964;4569;13485;314;1213;3412;9762;3726;10975
260780;201711;3542;11008;3291;10541;475;1670;2080;6507;2555;8177
260790;201711;105935;259893;96410;246111;17808;45582;56656;144346;74464;189928
260795;201711;3023;8501;2663;7949;151;516;2006;6011;2157;6527
260800;201711;5350;13029;4889;12383;114;381;4382;10768;4496;11149
260805;201711;3565;10703;3041;9791;239;911;2115;6736;2354;7647
260810;201711;6286;17709;5891;16980;539;1584;4469;12751;5008;14335
260820;201711;4099;10845;3634;10152;351;1214;2570;6936;2921;8150
260825;201711;2812;8804;2496;8269;135;553;1873;6150;2008;6703
260830;201711;3959;12152;3399;11094;474;1467;2247;7482;2721;8949
260840;201711;4113;11565;3645;10865;209;657;2961;8775;3170;9432
260845;201711;3980;11239;3748;10820;321;931;2779;8028;3100;8959
260850;201711;4846;14814;4263;13603;569;1941;2460;7706;3029;9647
260860;201711;3503;10334;2994;9341;127;499;2349;7194;2476;7693
260870;201711;4226;10877;3720;10229;126;476;3216;8682;3342;9158
260875;201711;6340;17295;5457;15884;710;2094;3559;10492;4269;12586
260880;201711;9689;28004;8678;26361;404;1296;7009;21407;7413;22703
260890;201711;12663;35406;11717;33966;926;3039;8497;24211;9423;27250
260900;201711;5417;16416;4679;15053;340;1355;3144;9922;3484;11277
260910;201711;3066;8964;2733;8402;121;438;2097;6411;2218;6849
260915;201711;4594;14774;4261;14306;64;348;3918;13107;3982;13455
260920;201711;3192;9389;2909;9014;122;428;2446;7696;2568;8124
260930;201711;3640;11873;3261;11211;228;876;2454;8421;2682;9297
260940;201711;13842;35344;12630;33406;1157;3355;9107;23672;10264;27027
260950;201711;6254;18597;5296;16692;764;2601;2675;8064;3439;10665
260960;201711;56408;145860;50029;135967;8250;23867;28183;75467;36433;99334
260970;201711;4832;14083;4419;13542;183;612;3512;10851;3695;11463
260980;201711;4143;12852;3803;12427;83;351;3426;11188;3509;11539
260990;201711;16856;50280;15108;47839;919;3300;11789;37288;12708;40588
261000;201711;15259;39769;12762;36129;1120;3462;8525;24407;9645;27869
261010;201711;2462;6683;2227;6387;73;180;2011;5814;2084;5994
261020;201711;6253;17716;5443;16255;440;1439;4069;11830;4509;13269
261030;201711;3777;11261;3325;10522;133;524;2669;8343;2802;8867
261040;201711;5039;15806;4249;14132;294;1129;3046;9932;3340;11061
261050;201711;7276;20584;6745;19699;688;1977;4663;13682;5351;15659
261060;201711;12237;34020;11299;32518;817;2582;8843;25165;9660;27747
261070;201711;52576;123984;45952;114654;4112;10391;33118;82010;37230;92401
261080;201711;5657;15597;5362;15170;229;647;4784;13615;5013;14262
261090;201711;16331;43143;14965;41265;595;1915;12743;34923;13338;36838
261100;201711;7932;24038;7018;22532;874;2897;4626;15132;5500;18029
261110;201711;57462;169708;50677;158959;12380;40554;22925;73883;35305;114437
261120;201711;3746;9710;3265;9119;73;234;2931;8209;3004;8443
261130;201711;7204;17895;6570;17160;162;479;5868;15280;6030;15759
261140;201711;3212;8339;2932;7925;273;808;2169;5807;2442;6615
261150;201711;5156;14394;4661;13621;166;605;3976;11521;4142;12126
261153;201711;1957;5880;1684;5428;86;346;1188;3796;1274;4142
261160;201711;191491;488916;173364;462163;44478;123646;72859;197752;117337;321398
261170;201711;5656;14867;5155;14159;285;773;4169;11422;4454;12195
261180;201711;9426;25345;8682;24342;717;2198;6233;17329;6950;19527
261190;201711;4763;14563;4418;14109;394;1543;3219;10059;3613;11602
261200;201711;3439;8256;3065;7802;259;680;2422;6116;2681;6796
261210;201711;1831;4727;1674;4510;73;220;1474;3962;1547;4182
261220;201711;13129;39453;11165;35541;1592;5471;6280;19850;7872;25321
261230;201711;4554;13608;3958;12856;95;408;3351;10998;3446;11406
261240;201711;4857;13369;4360;12577;345;950;3394;9817;3739;10767
261245;201711;3437;10329;2967;9497;123;564;2325;7218;2448;7782
261247;201711;2957;9070;2536;8298;157;601;1828;5956;1985;6557
261250;201711;18376;47079;16635;44869;2999;7793;10561;29646;13560;37439
261255;201711;3972;12126;3505;11262;184;806;2742;8569;2926;9375
261260;201711;12358;34256;10875;32425;388;1426;9239;27639;9627;29065
261270;201711;3754;10744;3391;10155;240;839;2595;7569;2835;8408
261280;201711;2533;7448;2290;7035;88;374;1851;5554;1939;5928
261290;201711;2879;8049;2553;7616;129;478;2016;6033;2145;6511
261300;201711;11051;33596;9603;30958;797;3070;6628;20891;7425;23961
261310;201711;6852;20327;6293;19403;1317;4116;3660;11291;4977;15407
261320;201711;5734;17031;5150;16016;134;545;4272;13077;4406;13622
261330;201711;5604;15094;5236;14613;204;810;4552;12422;4756;13232
261340;201711;3882;12362;3558;11846;249;1061;2634;8686;2883;9747
261350;201711;8062;25094;7512;24179;177;924;6227;19623;6404;20547
261360;201711;8158;20806;7075;19282;395;1152;5671;15170;6066;16322
261370;201711;18498;53063;17221;51035;3337;10201;9907;29474;13244;39675
261380;201711;3892;12792;3622;12234;545;2032;2243;7443;2788;9475
261390;201711;15910;47454;14115;44389;1683;5707;8734;27453;10417;33160
261400;201711;4566;15324;4060;14243;202;896;2971;10254;3173;11150
261410;201711;8994;24083;7799;22179;564;1691;6210;17618;6774;19309
261420;201711;6861;22631;6543;22209;1166;4485;4154;13962;5320;18447
261430;201711;3454;10237;2941;9443;134;454;2373;7649;2507;8103
261440;201711;1502;4651;1342;4348;47;234;964;3029;1011;3263
261450;201711;13445;38364;12816;37505;355;1304;11032;32141;11387;33445
261460;201711;6917;19949;6423;19241;270;901;5599;16712;5869;17613
261470;201711;4035;10750;3668;10266;60;278;3080;8631;3140;8909
261480;201711;4253;14057;3793;13275;227;961;2909;9970;3136;10931
261485;201711;4898;14567;4312;13578;447;1614;2886;8935;3333;10549
261500;201711;5413;14865;4814;14041;415;1182;3508;10504;3923;11686
261510;201711;1807;5691;1595;5319;97;382;1196;4006;1293;4388
261520;201711;2573;8018;2420;7724;95;370;1656;5435;1751;5805
261530;201711;10351;32937;9198;30649;1510;5667;4317;14234;5827;19901
261540;201711;7204;22192;6628;21238;1217;3953;3859;12649;5076;16602
261550;201711;3452;9484;3155;9033;258;859;2364;6646;2622;7505
261560;201711;7208;22697;6470;21684;514;2090;4885;16313;5399;18403
261570;201711;3358;9654;2869;8857;253;913;1921;5811;2174;6724
261580;201711;6168;17425;5637;16611;167;731;4976;14459;5143;15190
261590;201711;2595;6970;2154;6302;99;296;1668;4925;1767;5221
261600;201711;5126;13562;4339;12409;372;1075;3002;8715;3374;9790
261610;201711;2453;6678;2085;6134;75;264;1650;4850;1725;5114
261618;201711;2437;6542;2206;6230;99;301;1822;5083;1921;5384
261620;201711;3872;11875;3635;11485;826;2473;2143;7082;2969;9555
261630;201711;6895;19842;5903;18010;526;1939;3669;10774;4195;12713
261640;201711;33635;81083;31267;78237;1833;4085;25719;66582;27552;70667
261650;201711;3882;10765;3553;10328;159;625;2681;7815;2840;8440
270010;201711;4220;15268;3854;14565;204;1075;3028;11248;3232;12323
270020;201711;3746;10066;3420;9609;242;830;2807;7651;3049;8481
270030;201711;33833;98647;30842;93700;4988;15349;19212;58919;24200;74268
270040;201711;10392;30307;9440;29086;653;2342;7552;23239;8205;25581
270050;201711;4590;11873;4120;11327;249;668;3557;9896;3806;10564
270060;201711;1849;5186;1682;4970;196;597;1210;3645;1406;4242
270070;201711;4347;13060;3926;12456;163;753;3296;10190;3459;10943
270080;201711;1285;3906;1097;3552;98;350;783;2469;881;2819
270090;201711;1985;6203;1773;5783;83;388;1392;4381;1475;4769
270100;201711;5248;15463;4911;14941;374;1345;3874;11604;4248;12949
270110;201711;2875;7781;2494;7351;209;649;1940;5868;2149;6517
270120;201711;2989;8219;2643;7787;77;298;2360;6930;2437;7228
270130;201711;5173;14540;4546;13830;324;1077;3671;11311;3995;12388
270135;201711;1847;4800;1627;4535;90;205;1442;4080;1532;4285
270140;201711;10195;23554;8498;21326;455;1770;6960;16554;7415;18324
270150;201711;2603;8195;2519;8091;21;68;2475;7960;2496;8028
270160;201711;4910;15834;4481;15295;123;614;3914;13251;4037;13865
270170;201711;3516;10962;3141;10424;333;1397;2202;7096;2535;8493
270180;201711;2229;7117;2059;6877;70;334;1756;5755;1826;6089
270190;201711;1691;5311;1591;5179;67;243;1353;4434;1420;4677
270200;201711;2478;7861;2212;7497;161;694;1641;5396;1802;6090
270210;201711;4977;13474;4545;12923;207;672;4023;11371;4230;12043
270220;201711;1218;3804;1113;3642;223;825;631;2013;854;2838
270230;201711;9495;29216;8386;27374;896;3557;5367;16929;6263;20486
270235;201711;5782;18630;5379;17989;280;1170;4375;14496;4655;15666
270240;201711;10126;28642;8546;26641;1311;4467;5709;17712;7020;22179
270250;201711;2879;7610;2609;7265;316;818;1971;5561;2287;6379
270255;201711;4629;13732;3648;11938;206;851;2628;8379;2834;9230
270260;201711;5516;17110;5246;16703;185;831;4574;14190;4759;15021
270270;201711;1080;2993;993;2875;163;496;631;1790;794;2286
270280;201711;3626;9647;3053;8868;395;833;2149;6546;2544;7379
270290;201711;7657;25543;7127;24632;375;1745;5868;19944;6243;21689
270300;201711;3931;11260;3206;10460;274;977;2360;7740;2634;8717
270310;201711;7039;20826;6220;19561;201;1041;5183;15796;5384;16837
270320;201711;5671;17192;5196;16372;699;2366;3578;11088;4277;13454
270330;201711;3853;13107;3548;12691;321;1236;2755;9933;3076;11169
270340;201711;1592;4702;1390;4424;82;322;1126;3510;1208;3832
270350;201711;1842;4772;1627;4490;163;480;1184;3293;1347;3773
270360;201711;2193;6274;2028;6074;113;315;1801;5482;1914;5797
270370;201711;1396;4561;1284;4360;67;301;995;3350;1062;3651
270375;201711;2930;7546;2541;7063;51;152;2312;6451;2363;6603
270380;201711;5536;16791;5012;16073;420;1399;3775;12298;4195;13697
270390;201711;1213;3280;1032;3015;32;118;821;2356;853;2474
270400;201711;6132;17584;5398;16461;247;966;4137;12240;4384;13206
270410;201711;4547;14119;4130;13384;306;1163;3067;9786;3373;10949
270420;201711;5610;17355;5293;16939;220;987;4387;13772;4607;14759
270430;201711;129180;351771;109956;324628;29025;90353;41247;126059;70272;216412
270440;201711;4661;13472;4175;12843;136;575;3447;10556;3583;11131
270450;201711;6328;18588;5876;18004;344;1278;4823;14656;5167;15934
270460;201711;3326;8350;2965;7922;85;258;2644;6977;2729;7235
270470;201711;10288;31661;9382;30262;1051;3723;6544;21354;7595;25077
270480;201711;2818;8219;2434;7595;235;875;1795;5422;2030;6297
270490;201711;978;2938;876;2810;52;201;688;2190;740;2391
270500;201711;4794;15451;4427;14981;193;948;3701;12323;3894;13271
270510;201711;5759;16378;5123;15498;558;2118;3704;10714;4262;12832
270520;201711;3533;10878;3051;10008;964;3353;976;3415;1940;6768
270530;201711;1193;3675;1097;3533;71;233;824;2670;895;2903
270540;201711;2052;6447;1855;6182;88;440;1552;5021;1640;5461
270550;201711;6360;18403;5684;17592;557;1724;4327;13727;4884;15451
270560;201711;3083;8821;2793;8394;165;573;2187;6504;2352;7077
270570;201711;3728;11593;3319;10923;177;745;2673;8652;2850;9397
270580;201711;2113;6269;1993;6104;77;241;1769;5455;1846;5696
270590;201711;1443;4543;1365;4450;6;25;1343;4382;1349;4407
270600;201711;2758;8856;2483;8396;111;571;2087;6873;2198;7444
270610;201711;3313;9610;2970;9139;124;480;2563;7764;2687;8244
270620;201711;1315;4216;1218;4044;58;269;1018;3266;1076;3535
270630;201711;14436;41927;13150;39891;1350;4330;9647;29433;10997;33763
270640;201711;5475;16449;4873;15517;233;991;3940;12233;4173;13224
270642;201711;2276;7801;2127;7578;141;722;1691;5842;1832;6564
270644;201711;2942;8190;2522;7631;254;800;1861;5737;2115;6537
270650;201711;3400;10449;3189;10154;427;1767;2267;6868;2694;8635
270660;201711;2125;5373;1688;4770;83;275;1249;3519;1332;3794
270670;201711;15558;39129;13592;36858;1178;3168;10655;29278;11833;32446
270680;201711;4469;12357;4195;12056;71;158;3996;11578;4067;11736
270690;201711;9215;23779;8072;22513;1541;3962;5543;16161;7084;20123
270700;201711;549;1722;480;1602;57;245;325;1039;382;1284
270710;201711;5777;17713;5407;17240;302;1294;4551;14226;4853;15520
270720;201711;3307;10649;2964;10061;113;668;2478;8182;2591;8850
270730;201711;6608;17744;6148;17240;404;1019;5320;15270;5724;16289
270740;201711;2260;6261;2096;6034;108;403;1764;4996;1872;5399
270750;201711;5047;14874;4601;14196;403;1452;3559;10902;3962;12354
270760;201711;3446;9931;3053;9345;93;395;2578;7780;2671;8175
270770;201711;19231;49117;15882;45049;3021;8195;9233;28070;12254;36265
270780;201711;1772;5410;1671;5266;123;423;1346;4259;1469;4682
270790;201711;1476;4525;1350;4342;195;648;882;2848;1077;3496
270800;201711;10633;30971;9828;29859;468;2016;8390;24891;8858;26907
270810;201711;3032;9219;2476;8215;204;830;1707;5573;1911;6403
270820;201711;1709;5338;1487;4959;151;568;1060;3490;1211;4058
270830;201711;5562;13795;4772;12813;309;899;3877;10528;4186;11427
270840;201711;7962;24375;7264;23419;232;1266;6342;19877;6574;21143
270850;201711;7772;21818;7217;21088;586;2213;5728;16046;6314;18259
270860;201711;10512;28331;9025;26495;772;2600;6802;19639;7574;22239
270870;201711;2050;6082;1778;5561;205;691;1231;3804;1436;4495
270880;201711;8021;24821;7377;23900;340;1467;6099;19424;6439;20891
270890;201711;2369;7026;2151;6676;173;631;1605;4849;1778;5480
270895;201711;2855;9856;2740;9683;95;515;2436;8429;2531;8944
270900;201711;1787;4763;1428;4197;58;195;1132;3255;1190;3450
270910;201711;3474;10901;3140;10299;163;719;2408;7728;2571;8447
270915;201711;8745;27985;7634;25970;1024;4012;4792;15962;5816;19974
270920;201711;5856;18179;5541;17737;247;1183;4748;14747;4995;15930
270930;201711;15593;40872;13218;38009;2356;6392;8534;25523;10890;31915
270940;201711;5576;17469;5134;16929;339;1593;3961;12742;4300;14335
280010;201711;655;1823;566;1670;30;139;402;1085;432;1224
280020;201711;4713;13026;4108;12056;531;1593;2709;7940;3240;9533
280030;201711;68462;174771;57294;158455;15864;45289;21322;61818;37186;107107
280040;201711;3051;8831;2723;8317;282;932;1926;5830;2208;6762
280050;201711;3509;10874;3235;10412;630;2117;1890;6072;2520;8189
280060;201711;4946;14582;4127;13234;725;2457;2114;6920;2839;9377
280067;201711;6708;18335;5758;16792;653;1919;3788;11025;4441;12944
280070;201711;1925;6110;1850;5987;126;412;1549;5001;1675;5413
280100;201711;3618;10758;3227;10112;392;1357;2220;6959;2612;8316
280110;201711;1295;3891;1197;3731;53;206;999;3047;1052;3253
280120;201711;7665;23346;6956;22157;957;2810;4963;16288;5920;19098
280130;201711;8007;20820;7349;19860;742;2122;5540;14996;6282;17118
280140;201711;5592;14255;5086;13557;344;935;4163;11083;4507;12018
280150;201711;3603;9957;3335;9582;171;620;2766;7821;2937;8441
280160;201711;1241;3660;1038;3301;151;508;642;2003;793;2511
280170;201711;4910;13805;4506;13214;302;872;3648;10824;3950;11696
280190;201711;1195;2884;1003;2602;66;199;801;2011;867;2210
280200;201711;1129;3297;1009;3113;104;381;735;2199;839;2580
280210;201711;14379;39439;12733;37184;2274;6862;7261;21680;9535;28542
280220;201711;1756;4875;1566;4609;53;231;1291;3789;1344;4020
280230;201711;3313;9394;2999;8924;235;810;2267;6633;2502;7443
280240;201711;3412;9387;3100;8902;93;370;2629;7410;2722;7780
280250;201711;833;2172;658;1887;88;274;349;973;437;1247
280260;201711;2032;5271;1887;5099;55;156;1753;4745;1808;4901
280270;201711;2172;6524;1983;6222;104;385;1672;5171;1776;5556
280280;201711;4076;13158;3700;12565;593;1735;2393;8642;2986;10377
280290;201711;16677;48194;15021;45728;1725;5929;9825;29920;11550;35849
280300;201711;9868;27678;8856;26517;514;1748;6806;21280;7320;23028
280310;201711;1326;3653;1133;3313;40;149;840;2381;880;2530
280320;201711;8383;24992;7585;23729;1072;3597;4687;14526;5759;18123
280330;201711;4457;11798;3963;11069;274;871;3141;8589;3415;9460
280340;201711;4384;10616;3936;10089;274;654;3322;8724;3596;9378
280350;201711;21691;58229;19047;54316;2329;6813;12934;37074;15263;43887
280360;201711;5439;16370;5010;15637;815;2678;2980;9310;3795;11988
280370;201711;1964;5083;1658;4603;115;303;1260;3483;1375;3786
280380;201711;987;2921;879;2753;98;361;604;1851;702;2212
280390;201711;3001;8519;2603;7777;153;530;1950;5752;2103;6282
280400;201711;3740;10397;3378;9847;726;2027;1861;5686;2587;7713
280410;201711;2086;6415;1747;5735;189;663;1045;3343;1234;4006
280420;201711;4168;11668;3825;11168;140;444;3359;9794;3499;10238
280430;201711;2071;5303;1852;4990;72;260;1480;3892;1552;4152
280440;201711;4614;12785;4085;12065;287;914;3218;9381;3505;10295
280445;201711;2364;6243;2119;5813;48;167;1628;4313;1676;4480
280450;201711;9644;23367;8766;22247;407;858;7672;19780;8079;20638
280460;201711;6480;16570;5966;15834;592;1570;4700;12534;5292;14104
280470;201711;1784;5229;1593;4889;74;245;1216;3732;1290;3977
280480;201711;32915;89816;30188;85942;3436;10926;21072;59045;24508;69971
280490;201711;3767;11119;3261;10254;132;560;2476;7583;2608;8143
280500;201711;895;2311;798;2175;38;119;661;1793;699;1912
280510;201711;2497;7136;2224;6741;121;476;1634;4903;1755;5379
280520;201711;1698;4483;1525;4260;105;281;1250;3500;1355;3781
280530;201711;2424;6275;2200;5993;117;337;1822;4943;1939;5280
280540;201711;9062;24736;8314;23677;199;911;7338;20367;7537;21278
280550;201711;6702;16702;5518;14917;331;877;4184;11186;4515;12063
280560;201711;7132;20723;6734;20161;222;880;5841;17189;6063;18069
280570;201711;6178;16212;5210;14933;336;1101;3773;10725;4109;11826
280580;201711;5202;15603;4551;14444;622;1913;2957;9601;3579;11514
280590;201711;2622;6999;2291;6578;172;705;1614;4458;1786;5163
280600;201711;3324;9698;3019;9253;235;815;2254;6864;2489;7679
280610;201711;2442;6372;2229;6083;162;465;1797;4846;1959;5311
280620;201711;5234;14247;4573;13232;421;1089;3293;9875;3714;10964
280630;201711;3547;11226;3275;10811;231;819;2590;8669;2821;9488
280640;201711;2276;6646;2105;6457;55;166;1966;6094;2021;6260
280650;201711;1058;3070;914;2866;96;331;658;2023;754;2354
280660;201711;2724;7188;2532;6960;155;408;2172;6003;2327;6411
280670;201711;17031;42164;15386;40020;1354;3730;11536;30034;12890;33764
280680;201711;2752;7099;2340;6428;162;417;1749;4749;1911;5166
280690;201711;947;2522;825;2354;52;153;626;1761;678;1914
280700;201711;1028;2866;931;2695;27;95;717;2043;744;2138
280710;201711;13294;32159;11676;30262;598;1054;10188;27287;10786;28341
280720;201711;2504;5978;2184;5615;150;407;1509;4161;1659;4568
280730;201711;1069;2768;978;2634;56;193;798;2108;854;2301
280740;201711;13208;34444;11386;31601;1246;3463;7523;20965;8769;24428
280750;201711;3397;10051;3099;9540;199;738;2260;6851;2459;7589
280760;201711;5681;16620;5135;15775;706;2187;3256;10306;3962;12493
290010;201711;2889;6370;2068;5095;17;63;1697;3986;1714;4049
290020;201711;4665;14096;4454;13812;234;659;3894;12150;4128;12809
290030;201711;3608;9820;3208;9327;203;590;2687;7815;2890;8405
290035;201711;4879;11477;4078;10425;241;558;3245;8539;3486;9097
290040;201711;4302;10687;3618;9913;179;563;2868;8019;3047;8582
290050;201711;2212;7224;1920;6688;141;580;1345;4642;1486;5222
290060;201711;1291;3250;1040;2888;110;386;727;1933;837;2319
290070;201711;32539;79170;28430;73830;3508;9236;18022;47855;21530;57091
290080;201711;5540;16489;4729;15350;657;2200;3092;10225;3749;12425
290090;201711;2221;4354;1717;3817;50;101;1571;3508;1621;3609
290100;201711;8933;25034;7758;23201;1049;3009;4832;14952;5881;17961
290110;201711;4864;13797;4533;13216;529;1625;3103;8964;3632;10589
290115;201711;4337;12688;3855;12044;167;555;3230;10195;3397;10750
290120;201711;6816;17071;5616;15626;173;609;4771;13080;4944;13689
290130;201711;4537;11548;3654;10451;132;558;2934;8189;3066;8747
290135;201711;4449;10753;3689;9537;247;706;2763;6942;3010;7648
290140;201711;4417;12670;3711;11751;141;506;3224;10222;3365;10728
290150;201711;2224;6449;2104;6273;195;597;1599;4671;1794;5268
290160;201711;3210;7911;2986;7634;371;772;2306;6039;2677;6811
290170;201711;2616;8033;2445;7812;91;385;2171;6857;2262;7242
290180;201711;2857;8063;2391;7323;113;402;1878;5711;1991;6113
290190;201711;3849;12143;3590;11774;185;827;2865;9253;3050;10080
290195;201711;2285;6036;1863;5384;64;291;1497;4248;1561;4539
290200;201711;3909;11522;3372;10696;205;703;2662;8399;2867;9102
290205;201711;3331;9031;2978;8486;138;536;2352;6503;2490;7039
290210;201711;13365;38848;12006;36979;1154;3203;9113;29007;10267;32210
290220;201711;2555;6934;2388;6705;170;537;1959;5433;2129;5970
290225;201711;3301;7361;2777;6791;43;97;2601;6383;2644;6480
290230;201711;2285;6922;2101;6704;96;368;1787;5698;1883;6066
290240;201711;3606;9543;3085;8864;151;514;2461;6954;2612;7468
290250;201711;3843;11711;3519;11290;105;275;3035;10155;3140;10430
290260;201711;5163;13846;4231;12449;244;889;3318;9656;3562;10545
290265;201711;3503;10474;2939;9439;134;575;2260;7170;2394;7745
290270;201711;11713;41126;11160;40227;843;3548;8744;31255;9587;34803
290280;201711;5681;17377;5125;16478;371;1283;3821;12287;4192;13570
290290;201711;9819;29636;8423;27169;844;2798;5876;19017;6720;21815
290300;201711;4480;12414;3248;10080;202;713;2241;6963;2443;7676
290310;201711;1484;4125;1256;3787;129;470;861;2527;990;2997
290320;201711;24990;69234;21299;64407;5242;16248;10331;32568;15573;48816
290323;201711;3530;9835;3180;9372;86;291;2662;7748;2748;8039
290327;201711;4269;12478;3703;11431;317;976;2656;8213;2973;9189
290330;201711;1905;4422;1680;4179;49;105;1527;3846;1576;3951
290340;201711;5555;15498;4612;14312;810;2674;2995;9373;3805;12047
290350;201711;4578;13750;3940;12646;345;1169;2801;9090;3146;10259
290360;201711;4779;13550;4154;12711;113;437;3598;11030;3711;11467
290370;201711;4893;12776;3949;11497;224;607;3084;9105;3308;9712
290380;201711;5448;15333;4757;14328;165;550;4036;12249;4201;12799
290390;201711;14616;43016;12876;40391;1472;4744;8616;27660;10088;32404
290395;201711;2660;8364;2297;7670;90;412;1793;5939;1883;6351
290400;201711;3642;10289;2986;9257;175;623;2190;6670;2365;7293
290405;201711;4669;14085;3940;12796;287;1015;2710;8909;2997;9924
290410;201711;5567;15996;4526;14285;209;885;3434;10462;3643;11347
290420;201711;2970;8523;2513;7803;173;544;1934;5996;2107;6540
290430;201711;3067;9167;2618;8367;409;1339;1598;5155;2007;6494
290440;201711;2905;7431;2230;6454;91;315;1634;4763;1725;5078
290450;201711;3198;9028;2690;8268;128;493;2077;6220;2205;6713
290460;201711;11900;33796;10521;31254;2962;9109;3931;11561;6893;20670
290470;201711;4172;11495;3230;10023;583;1963;1578;5054;2161;7017
290475;201711;5947;18194;5196;16825;128;646;4118;13053;4246;13699
290480;201711;2014;5344;1817;5051;155;455;1195;3350;1350;3805
290485;201711;4639;14147;4028;13228;167;850;3397;10911;3564;11761
290490;201711;8490;21214;7911;20477;580;1600;6352;16488;6932;18088
290500;201711;3885;12002;3082;10332;396;1407;1643;5475;2039;6882
290510;201711;3188;8646;2782;8097;104;389;2375;6835;2479;7224
290515;201711;3693;9947;3082;9168;96;246;2676;8138;2772;8384
290520;201711;11242;33991;9048;29618;434;1818;6065;19520;6499;21338
290530;201711;4940;14435;4347;13483;220;693;3565;11085;3785;11778
290540;201711;3598;10039;3268;9598;101;331;2896;8464;2997;8795
290550;201711;4343;11370;3864;10828;52;162;3593;10132;3645;10294
290560;201711;6562;17853;5378;16109;589;1942;3737;11057;4326;12999
290570;201711;41484;109242;38292;105096;2949;8378;29661;81153;32610;89531
290580;201711;7342;23309;6735;22384;660;2143;5072;17248;5732;19391
290590;201711;6959;22047;6053;20404;180;777;4993;16845;5173;17622
290600;201711;17558;51295;16208;49330;983;3119;13069;40322;14052;43441
290610;201711;2451;8075;1999;7178;109;492;1381;4881;1490;5373
290620;201711;6202;18052;5614;17106;253;850;4742;14341;4995;15191
290630;201711;8582;21602;7196;19897;584;1630;5750;16017;6334;17647
290640;201711;2591;7253;2041;6308;88;286;1613;4906;1701;5192
290650;201711;10780;30658;10246;29900;2623;7381;5750;17703;8373;25084
290660;201711;3584;9657;3065;8884;109;290;2287;6966;2396;7256
290670;201711;6752;19727;5944;18414;523;1626;4414;13852;4937;15478
290680;201711;10168;29677;8858;27754;291;1448;7104;21649;7395;23097
290682;201711;4607;12705;4057;11897;140;448;3420;9990;3560;10438
290685;201711;3589;8271;2376;6584;222;589;1553;4434;1775;5023
290687;201711;6778;19433;5463;17221;920;2896;3072;10075;3992;12971
290689;201711;2886;8314;2452;7607;152;554;1798;5619;1950;6173
290690;201711;5398;14767;4580;13665;614;1794;3053;9170;3667;10964
290700;201711;2531;7233;2314;6934;77;286;2005;6019;2082;6305
290710;201711;8145;24029;7207;22733;291;1047;6186;19520;6477;20567
290720;201711;18376;51608;16991;49815;921;2737;14309;42329;15230;45066
290730;201711;7055;18474;6149;17362;303;855;4731;13365;5034;14220
290740;201711;978;2803;742;2374;42;177;565;1782;607;1959
290750;201711;10202;27405;8954;25224;1097;3304;5831;16005;6928;19309
290755;201711;2235;6294;1749;5407;98;353;1216;3696;1314;4049
290760;201711;3962;11805;3177;10281;424;1261;1855;6301;2279;7562
290770;201711;2521;8571;2358;8356;73;349;1959;6986;2032;7335
290780;201711;8359;21189;7258;19619;509;1100;5621;15546;6130;16646
290790;201711;4436;12647;4007;12076;154;428;3456;10486;3610;10914
290800;201711;7075;14881;5388;12976;353;718;4203;10391;4556;11109
290810;201711;5548;15810;4516;14122;130;506;3506;10999;3636;11505
290820;201711;5056;13922;4599;13298;286;934;3510;10182;3796;11116
290830;201711;4478;10902;4025;10302;137;437;3295;8306;3432;8743
290840;201711;16565;46543;14623;43552;1802;4890;9681;30194;11483;35084
290850;201711;6016;16392;5699;16007;518;1271;4505;13038;5023;14309
290860;201711;5441;17189;4910;16579;245;912;4130;14183;4375;15095
290870;201711;4647;13209;3688;11553;155;599;2690;8364;2845;8963
290880;201711;1397;3616;1113;3194;85;212;774;2272;859;2484
290890;201711;7338;17452;6412;16411;208;556;5832;14923;6040;15479
290900;201711;2292;6324;1754;5380;129;430;1119;3401;1248;3831
290910;201711;4934;12921;3982;11476;62;276;3335;9526;3397;9802
290920;201711;5011;12752;4653;12288;106;263;4276;11290;4382;11553
290930;201711;8065;23110;6805;21023;225;996;5480;16530;5705;17526
290940;201711;3724;10977;3217;10248;189;635;2414;7778;2603;8413
290950;201711;1507;4045;1300;3721;100;299;933;2684;1033;2983
290960;201711;5241;14759;4795;14171;157;513;4063;12011;4220;12524
290970;201711;3612;10740;3066;9849;190;586;2252;7291;2442;7877
290980;201711;10445;28083;8893;25377;1568;4738;4196;11787;5764;16525
290990;201711;8894;25478;7737;23537;434;1586;6120;18222;6554;19808
291000;201711;3187;8984;2692;8367;273;751;2092;6675;2365;7426
291005;201711;14309;35611;12821;33773;761;2051;10551;27952;11312;30003
291010;201711;3167;9600;2502;8241;177;596;1644;5400;1821;5996
291020;201711;1257;3265;1014;2817;48;157;672;1764;720;1921
291030;201711;2363;6181;1679;4861;109;338;1057;2968;1166;3306
291040;201711;5336;15530;4667;14557;229;958;3722;11494;3951;12452
291050;201711;7407;22696;6729;21580;1239;4353;4080;12879;5319;17232
291060;201711;5789;20377;5346;19682;568;2497;3692;13367;4260;15864
291070;201711;15496;43693;13492;40654;634;2353;10740;32077;11374;34430
291072;201711;22726;63913;17697;54351;3959;12946;6443;20077;10402;33023
291075;201711;4844;13580;4339;12711;224;675;3403;9860;3627;10535
291077;201711;1520;4174;1238;3680;55;145;917;2753;972;2898
291080;201711;78954;232967;68358;214875;25282;80971;10775;35571;36057;116542
291085;201711;5620;14591;4758;13385;207;642;4028;11297;4235;11939
291090;201711;1796;3794;1478;3426;133;175;1198;2900;1331;3075
291100;201711;2813;6719;2076;5798;107;384;1595;4359;1702;4743
291110;201711;5399;17658;4744;16554;537;2030;3379;11578;3916;13608
291120;201711;7447;19216;6662;18119;439;1281;5135;13948;5574;15229
291125;201711;1943;3703;1507;3226;71;158;1224;2656;1295;2814
291130;201711;2868;8733;2337;7733;79;380;1754;5625;1833;6005
291140;201711;4227;12188;3405;10567;493;1365;2143;6789;2636;8154
291150;201711;2133;5058;1864;4740;33;90;1636;4127;1669;4217
291160;201711;4741;14584;4198;13649;468;1690;2752;8837;3220;10527
291165;201711;2319;6730;1815;5797;26;111;1331;4219;1357;4330
291170;201711;20023;52554;17174;48005;1205;3632;10939;30676;12144;34308
291180;201711;6102;15425;4798;13501;402;1167;3458;9732;3860;10899
291185;201711;3335;9290;2913;8551;118;384;2367;6859;2485;7243
291190;201711;7370;19082;6293;17593;397;1227;5015;14008;5412;15235
291200;201711;2881;8354;2187;7049;87;298;1445;4641;1532;4939
291210;201711;6420;15236;5332;13912;218;732;4079;10502;4297;11234
291220;201711;3990;11819;3603;11208;353;1223;2553;7863;2906;9086
291230;201711;4185;9901;3455;9085;81;146;3203;8541;3284;8687
291240;201711;4311;11409;3755;10461;77;265;3201;8770;3278;9035
291250;201711;3331;10125;2684;8910;176;568;1831;6161;2007;6729
291260;201711;1163;3044;1019;2856;45;178;859;2337;904;2515
291270;201711;4816;14330;4089;13067;845;2832;2323;7500;3168;10332
291280;201711;2285;6289;1790;5462;223;714;1002;3014;1225;3728
291290;201711;5872;15947;4822;14396;602;1826;3086;9344;3688;11170
291300;201711;3997;11281;3068;9674;145;478;2211;6935;2356;7413
291310;201711;5214;14529;4460;13149;182;607;3563;10374;3745;10981
291320;201711;5939;17846;4731;15440;1130;3540;2189;7453;3319;10993
291330;201711;1615;4508;1403;4155;84;265;1042;3035;1126;3300
291340;201711;3969;10685;3348;9738;84;312;2711;7806;2795;8118
291345;201711;3076;9739;2863;9445;159;563;2315;7687;2474;8250
291350;201711;6121;16731;4970;15079;191;566;4109;12670;4300;13236
291360;201711;32152;83407;26958;76407;5238;15144;14311;41833;19549;56977
291370;201711;7809;21884;7280;21182;457;1526;5623;16265;6080;17791
291380;201711;3389;10078;2999;9450;123;518;2382;7409;2505;7927
291390;201711;11322;27997;9730;26118;578;1762;7803;20849;8381;22611
291400;201711;13938;37262;11909;34219;1908;5032;7373;22412;9281;27444
291410;201711;2896;7776;2250;6690;79;359;1703;4905;1782;5264
291420;201711;1920;5001;1610;4607;49;192;1361;3855;1410;4047
291430;201711;3099;8740;2727;8194;99;463;2235;6528;2334;6991
291440;201711;6364;18811;5572;17461;428;1404;4329;13688;4757;15092
291450;201711;8314;22865;7071;21288;182;453;6052;18772;6234;19225
291460;201711;13324;38669;11997;36698;1105;3649;8489;26141;9594;29790
291465;201711;7948;21914;6727;20414;337;1437;5455;16301;5792;17738
291470;201711;15188;38693;13226;36392;645;1751;10176;28714;10821;30465
291480;201711;35834;85479;28640;75821;3934;11143;15773;42077;19707;53220
291490;201711;4491;13133;4154;12683;354;1108;3316;10206;3670;11314
291500;201711;4557;12182;3810;11125;107;439;3290;9558;3397;9997
291510;201711;3705;10569;3165;9784;80;378;2613;8065;2693;8443
291520;201711;4059;10342;3354;9372;242;723;2365;6653;2607;7376
291530;201711;2154;5475;1631;4742;323;871;924;2953;1247;3824
291535;201711;3250;10043;3000;9639;220;701;2260;7387;2480;8088
291540;201711;2143;5011;1625;4436;85;278;1393;3745;1478;4023
291550;201711;5151;12933;4340;11832;606;1537;2675;7465;3281;9002
291560;201711;18815;43002;13016;36128;941;2478;8951;26164;9892;28642
291570;201711;2206;5436;1869;5030;112;232;1557;4314;1669;4546
291580;201711;5772;16404;4856;15128;413;1493;3460;10713;3873;12206
291590;201711;1689;5169;1569;4971;150;530;1212;3841;1362;4371
291600;201711;5053;13363;3862;11439;699;2171;2050;5991;2749;8162
291610;201711;4748;14402;4543;14174;88;313;4253;13341;4341;13654
291620;201711;3087;7075;2238;6145;115;366;1725;4806;1840;5172
291630;201711;3179;7504;2482;6617;156;444;1978;5250;2134;5694
291640;201711;15312;40874;12083;35976;2652;8129;4091;13089;6743;21218
291650;201711;8349;23321;7535;22317;468;1174;6387;19246;6855;20420
291660;201711;2183;5395;1626;4538;126;469;1076;2813;1202;3282
291670;201711;1894;5148;1700;4867;129;333;1317;3839;1446;4172
291680;201711;3841;10570;3287;9647;391;1209;2294;6744;2685;7953
291685;201711;4690;11537;3806;10384;380;896;2727;7727;3107;8623
291690;201711;3786;9286;2885;7943;119;334;2318;6345;2437;6679
291700;201711;8764;26386;7792;24617;616;2006;6034;19081;6650;21087
291710;201711;5030;12848;3950;11331;386;1221;2650;7479;3036;8700
291720;201711;4583;14422;3808;12814;319;1213;2569;8442;2888;9655
291730;201711;6195;17262;5445;16267;330;1103;4393;13191;4723;14294
291733;201711;2889;7714;2398;7024;108;342;1752;5300;1860;5642
291735;201711;2950;7856;2495;7187;91;304;2122;6068;2213;6372
291740;201711;3814;10140;3104;9094;147;488;2437;7053;2584;7541
291750;201711;19671;49678;15766;43780;2287;6482;9249;26277;11536;32759
291760;201711;10145;31563;8577;28802;3082;11623;1929;6543;5011;18166
291770;201711;7004;19929;5901;17915;606;1996;4079;12140;4685;14136
291780;201711;4601;13107;4194;12446;148;483;3599;10638;3747;11121
291790;201711;2625;7751;2465;7523;183;545;1945;5961;2128;6506
291800;201711;29295;77180;24214;69921;3150;9053;14809;43827;17959;52880
291810;201711;10588;27014;8867;24844;261;888;7511;20899;7772;21787
291820;201711;3752;10497;3294;9841;144;503;2554;7647;2698;8150
291830;201711;4066;10358;3658;9783;278;760;2908;7821;3186;8581
291835;201711;6222;19088;5061;16898;893;3086;2858;9789;3751;12875
291840;201711;45436;126878;39701;119766;4994;15082;27334;84860;32328;99942
291845;201711;2421;7027;2180;6707;139;419;1806;5604;1945;6023
291850;201711;4200;12172;3471;10972;324;927;2494;8155;2818;9082
291855;201711;1866;4220;1565;3840;83;252;1294;3117;1377;3369
291860;201711;2260;6060;1643;4849;33;115;1134;3220;1167;3335
291870;201711;1321;3464;910;2706;63;219;580;1644;643;1863
291875;201711;2752;8392;2442;7864;121;450;1791;5657;1912;6107
291880;201711;5028;15417;4501;14362;392;1231;3302;10535;3694;11766
291890;201711;1359;3164;968;2664;196;427;624;1790;820;2217
291900;201711;1211;3147;936;2680;28;114;724;2018;752;2132
291905;201711;2709;7064;2065;5939;78;271;1544;4329;1622;4600
291910;201711;2773;7219;2376;6750;83;270;2048;5830;2131;6100
291915;201711;6852;20523;5744;18605;297;1144;4395;14242;4692;15386
291920;201711;24380;69931;22136;66780;2833;9225;14634;43870;17467;53095
291930;201711;2454;7187;2151;6680;188;691;1502;4528;1690;5219
291940;201711;3310;9117;2338;7382;238;779;1440;4410;1678;5189
291950;201711;8618;27520;7574;25492;1061;3553;4422;15310;5483;18863
291955;201711;11952;33028;10976;31803;1897;5305;7263;21993;9160;27298
291960;201711;3076;8676;2506;7807;148;480;1901;6047;2049;6527
291970;201711;3937;11436;3521;10787;235;920;2560;7782;2795;8702
291980;201711;10469;30197;8426;27130;567;1875;5932;19319;6499;21194
291990;201711;1996;5893;1862;5726;37;133;1731;5353;1768;5486
291992;201711;4011;10053;2963;8606;337;930;2235;6601;2572;7531
291995;201711;2137;5910;1739;5326;60;268;1410;4209;1470;4477
292000;201711;2337;6270;2000;5765;173;574;1386;3987;1559;4561
292010;201711;6078;14559;4985;13040;262;748;4081;10604;4343;11352
292020;201711;4287;13221;3784;12349;341;1176;2854;9230;3195;10406
292030;201711;1744;5630;1641;5465;137;522;996;3230;1133;3752
292040;201711;4098;11045;3511;10310;246;637;2859;8664;3105;9301
292045;201711;3592;10259;2935;9261;77;193;2628;8398;2705;8591
292050;201711;6350;18737;5273;16603;413;1429;3337;10385;3750;11814
292060;201711;12419;29629;11418;28408;731;1792;9615;23674;10346;25466
292070;201711;5281;14883;4718;14204;310;967;4003;12096;4313;13063
292080;201711;3285;8510;2694;7758;148;504;2308;6628;2456;7132
292090;201711;4186;9815;3276;8753;219;636;2638;7140;2857;7776
292100;201711;9912;26150;8584;24342;1660;4780;4584;13395;6244;18175
292105;201711;2998;8722;2695;8223;78;348;2288;6903;2366;7251
292110;201711;6212;16179;4616;13529;1159;3385;2073;6222;3232;9607
292120;201711;6667;18257;5435;16030;656;1956;3545;10522;4201;12478
292130;201711;3020;7951;2577;7363;240;724;1895;5462;2135;6186
292140;201711;4832;12284;4008;11081;294;795;3137;8698;3431;9493
292145;201711;2197;6684;1905;6174;135;439;1361;4464;1496;4903
292150;201711;12743;37003;11661;35372;344;1329;9826;29622;10170;30951
292160;201711;2371;6715;2080;6336;70;270;1860;5618;1930;5888
292170;201711;8210;23066;6892;20803;671;2135;4667;14118;5338;16253
292180;201711;2918;8118;2185;6853;433;1275;1111;3564;1544;4839
292190;201711;2846;8005;2446;7381;331;1068;1507;4595;1838;5663
292200;201711;6544;18704;5463;16948;1180;3779;2613;8339;3793;12118
292205;201711;3628;10663;3271;10123;99;470;2824;8574;2923;9044
292210;201711;5978;15249;5047;13994;122;472;4440;12172;4562;12644
292220;201711;1921;4990;1728;4697;184;483;1222;3287;1406;3770
292225;201711;3142;9545;2823;9057;96;413;2345;7429;2441;7842
292230;201711;7252;18921;6751;18209;168;704;5747;15127;5915;15831
292240;201711;4891;14491;4253;13228;342;1082;2903;9011;3245;10093
292250;201711;5236;14940;4854;14316;692;2015;3138;9389;3830;11404
292260;201711;3253;9069;2946;8652;202;556;2449;7309;2651;7865
292265;201711;3167;9300;2729;8556;83;386;2162;6604;2245;6990
292270;201711;3926;9756;3246;8923;246;736;2626;7218;2872;7954
292273;201711;2465;5668;2037;5135;83;149;1612;4206;1695;4355
292275;201711;1786;5035;1470;4575;84;197;1154;3759;1238;3956
292280;201711;2443;6261;2038;5786;94;231;1667;4920;1761;5151
292285;201711;2437;6347;1981;5686;108;371;1540;4403;1648;4774
292290;201711;6544;19231;5582;17822;264;1016;4470;14253;4734;15269
292300;201711;9082;25288;7534;23282;1217;3916;4626;14611;5843;18527
292303;201711;2792;8269;2503;7829;73;262;2156;6715;2229;6977
292305;201711;2553;6903;2370;6630;50;223;2102;5775;2152;5998
292310;201711;6275;17414;5645;16540;258;761;4724;13822;4982;14583
292320;201711;6407;17431;5329;15528;298;945;4130;11806;4428;12751
292330;201711;2404;5896;2153;5581;122;315;1721;4520;1843;4835
292335;201711;4885;12727;4373;12014;305;763;3563;9934;3868;10697
292340;201711;6238;17004;5342;15478;270;800;4060;11703;4330;12503
292350;201711;2275;6484;1938;6018;89;333;1604;4991;1693;5324
292360;201711;4857;13014;4287;12017;344;1102;3157;8688;3501;9790
292370;201711;9640;23862;8437;22303;228;644;7541;19739;7769;20383
292380;201711;6884;19891;6272;18851;532;1569;4721;14252;5253;15821
292390;201711;4094;8540;3050;7328;144;253;2637;6425;2781;6678
292400;201711;20594;62460;18657;59145;2386;7886;12413;39424;14799;47310
292405;201711;4439;10930;3670;9897;196;464;3009;8191;3205;8655
292410;201711;2012;5214;1789;4947;77;212;1542;4300;1619;4512
292420;201711;3598;11296;3381;10951;195;844;2811;9006;3006;9850
292430;201711;5066;14806;3842;12986;338;1223;2513;8567;2851;9790
292440;201711;8261;26858;7654;25981;125;600;7033;23961;7158;24561
292450;201711;3697;11156;3077;9973;175;637;2370;7704;2545;8341
292460;201711;4643;13463;3929;12242;375;1181;2814;8767;3189;9948
292465;201711;2379;6707;1988;6116;118;356;1420;4503;1538;4859
292467;201711;1715;5274;1616;5143;211;662;1140;3728;1351;4390
292470;201711;2915;7452;2342;6540;79;221;1851;5180;1930;5401
292480;201711;6367;15759;5188;14284;108;403;4613;12506;4721;12909
292490;201711;2209;5994;1851;5451;116;354;1413;4191;1529;4545
292500;201711;6342;18115;5259;16171;605;1808;3515;10939;4120;12747
292510;201711;12478;35069;10371;31820;666;2575;7653;23327;8319;25902
292520;201711;6323;16690;5563;15542;928;2558;3591;10246;4519;12804
292525;201711;5352;13569;4501;12576;153;430;3893;10938;4046;11368
292530;201711;26397;73754;22570;67949;5706;17410;9639;30291;15345;47701
292540;201711;3281;7740;2725;7112;200;481;2275;6011;2475;6492
292550;201711;6925;20385;5753;18861;443;1639;4415;14736;4858;16375
292560;201711;4143;11107;3578;10267;131;541;2889;8176;3020;8717
292570;201711;4076;10998;3547;10282;64;221;3240;9388;3304;9609
292575;201711;6567;20373;6237;19906;262;878;5360;17144;5622;18022
292580;201711;7046;19350;6210;18126;213;760;5373;15569;5586;16329
292590;201711;7184;19845;6579;18972;265;903;5692;16083;5957;16986
292593;201711;2782;7081;2369;6416;168;436;1853;4990;2021;5426
292595;201711;5522;15002;4872;14164;226;788;3990;11504;4216;12292
292600;201711;10813;30075;9531;28265;598;1575;7369;22141;7967;23716
292610;201711;4416;11709;3676;10484;208;511;2626;7720;2834;8231
292620;201711;6233;17925;5430;17029;79;230;5149;16320;5228;16550
292630;201711;8599;21783;7170;19487;483;1352;5102;13970;5585;15322
292640;201711;7757;24011;7019;22835;256;1004;5320;17340;5576;18344
292650;201711;4351;11370;4011;10925;207;550;3525;9548;3732;10098
292660;201711;10727;30955;9566;29232;636;2088;7481;22921;8117;25009
292665;201711;2190;6819;2021;6598;39;141;1801;5941;1840;6082
292670;201711;3498;9738;2734;8336;145;534;1859;5565;2004;6099
292680;201711;3861;10750;3249;9646;236;716;2365;6894;2601;7610
292690;201711;2604;7093;1875;5888;151;457;1227;3991;1378;4448
292700;201711;9382;26598;8203;24873;932;2702;5560;17478;6492;20180
292710;201711;2237;7340;2090;7148;53;213;1894;6498;1947;6711
292720;201711;9179;22695;7872;21238;308;928;6679;18210;6987;19138
292730;201711;3895;10471;3736;10252;181;443;3197;8824;3378;9267
292740;201711;318860;829624;296292;794416;53084;147441;173349;460604;226433;608045
292750;201711;6376;17192;5481;15852;252;747;4241;12355;4493;13102
292760;201711;3807;11453;3441;10788;272;922;2511;7842;2783;8764
292770;201711;5808;16589;4987;15338;923;2973;2868;9124;3791;12097
292780;201711;1825;4037;1380;3484;53;171;1088;2669;1141;2840
292790;201711;3907;8645;3250;7931;66;202;3005;7308;3071;7510
292800;201711;9848;26750;8786;25055;401;1228;7133;20191;7534;21419
292805;201711;3243;8457;2657;7620;256;693;1916;5558;2172;6251
292810;201711;9744;27487;7814;24564;416;1516;5717;17954;6133;19470
292820;201711;7602;20902;5616;17950;428;1631;4100;12945;4528;14576
292830;201711;2623;6302;2302;5895;50;189;2107;5339;2157;5528
292840;201711;8505;23421;7847;22530;172;718;7020;19698;7192;20416
292850;201711;2779;7525;2292;6753;174;622;1520;4332;1694;4954
292860;201711;15325;37536;13906;35698;1028;2532;10925;28249;11953;30781
292870;201711;17491;46644;15417;43491;1221;3893;10072;27993;11293;31886
292880;201711;11494;32138;10253;30359;506;1975;7805;22389;8311;24364
292890;201711;5469;17189;4907;16243;409;1507;3739;12324;4148;13831
292895;201711;2923;6658;2174;5537;134;320;1608;4104;1742;4424
292900;201711;2670;7707;2496;7430;90;403;1992;5707;2082;6110
292905;201711;4208;11796;3323;10422;257;776;2285;7286;2542;8062
292910;201711;4886;14014;4461;13265;403;1315;3087;9116;3490;10431
292920;201711;9745;27451;9281;26846;338;1303;8103;23024;8441;24327
292925;201711;5119;14968;4611;14131;249;761;3592;10960;3841;11721
292930;201711;6146;19177;5605;18108;394;1663;3823;12031;4217;13694
292935;201711;2019;5844;1655;5442;48;251;1437;4795;1485;5046
292937;201711;3059;7661;2652;7165;89;261;2286;6200;2375;6461
292940;201711;3109;8311;2521;7373;171;474;1900;5680;2071;6154
292950;201711;8977;24437;8129;23106;370;1193;6299;17610;6669;18803
292960;201711;5233;12853;4483;11852;136;430;3642;9463;3778;9893
292970;201711;4013;11774;3534;11118;132;567;2937;9233;3069;9800
292975;201711;4224;9587;3791;9083;211;431;3341;8087;3552;8518
292980;201711;3132;8078;2514;7128;122;383;1932;5401;2054;5784
292990;201711;11241;31348;9623;28772;449;1528;7680;23001;8129;24529
293000;201711;2621;6596;2399;6314;27;86;1907;5258;1934;5344
293010;201711;17294;46444;14431;41767;1936;5717;8889;25828;10825;31545
293015;201711;7324;24034;6095;21650;615;2570;4096;14441;4711;17011
293020;201711;8978;28615;8348;27753;183;845;7472;24716;7655;25561
293030;201711;5426;15154;4253;13270;160;539;2895;9332;3055;9871
293040;201711;3733;11348;3477;10963;109;409;3062;9630;3171;10039
293050;201711;20410;53390;18276;50467;1965;5572;12113;34105;14078;39677
293060;201711;3483;9214;2886;8257;205;660;2125;5973;2330;6633
293070;201711;23819;61269;19654;55561;4016;11142;10137;30262;14153;41404
293075;201711;3147;10582;2932;10209;198;863;2333;8115;2531;8978
293076;201711;3510;9366;3134;8860;106;290;2588;7429;2694;7719
293077;201711;5154;15212;4403;14157;562;1865;2880;9509;3442;11374
293080;201711;4668;14255;4148;13394;157;663;3391;10764;3548;11427
293090;201711;3032;9496;2487;8588;203;795;1721;5968;1924;6763
293100;201711;5650;15965;4703;14261;361;1099;3551;10860;3912;11959
293105;201711;3682;11982;3245;11119;279;1008;2260;7705;2539;8713
293110;201711;2213;5737;1871;5261;63;200;1573;4363;1636;4563
293120;201711;3960;11753;3648;11241;137;418;3069;9443;3206;9861
293130;201711;3665;10670;3316;10236;97;388;2896;8948;2993;9336
293135;201711;30259;74439;22662;63750;4519;14219;9197;26209;13716;40428
293140;201711;2091;5353;1916;5131;89;277;1596;4166;1685;4443
293150;201711;5293;16776;4463;15155;523;1786;2977;10244;3500;12030
293160;201711;3879;9626;3377;9026;319;590;2702;7654;3021;8244
293170;201711;3674;9594;3247;9017;149;496;2566;7125;2715;7621
293180;201711;4857;13414;3953;11909;128;546;3161;9287;3289;9833
293190;201711;13371;38771;12013;36729;380;1694;10206;30805;10586;32499
293200;201711;7697;19923;6517;18279;213;792;5090;14187;5303;14979
293210;201711;5015;13831;4359;12792;247;773;3396;9902;3643;10675
293220;201711;4910;13776;3930;12088;1002;3074;1493;4835;2495;7909
293230;201711;3548;10406;3052;9605;373;1267;2035;6451;2408;7718
293240;201711;4269;11731;3458;10362;106;339;2645;8017;2751;8356
293245;201711;4084;11212;3633;10580;174;586;3020;8706;3194;9292
293250;201711;5458;14043;4780;13064;334;928;3677;10009;4011;10937
293260;201711;4311;12442;3590;11308;135;471;2587;8067;2722;8538
293270;201711;6300;15503;5284;14398;431;894;4356;12355;4787;13249
293280;201711;4963;13542;4225;12526;218;636;3233;9667;3451;10303
293290;201711;12861;41673;11934;39982;2966;10032;5522;19493;8488;29525
293300;201711;6194;14926;5351;13840;343;786;4037;10651;4380;11437
293305;201711;4283;10725;3699;9934;79;264;3209;8587;3288;8851
293310;201711;2246;5831;1812;5084;146;426;1273;3518;1419;3944
293315;201711;4138;10267;3442;9204;185;442;2771;7402;2956;7844
293317;201711;2411;6431;2148;5973;130;339;1606;4485;1736;4824
293320;201711;8045;24411;7654;23934;818;2592;6163;19486;6981;22078
293325;201711;1705;4672;1388;4171;232;728;848;2531;1080;3259
293330;201711;43495;141278;39535;133752;8840;30878;18074;61992;26914;92870
293340;201711;2449;6969;1986;6164;172;598;1267;3892;1439;4490
293345;201711;3101;9065;2695;8526;273;621;1969;6705;2242;7326
293350;201711;6681;19250;6123;18611;108;279;5692;17643;5800;17922
293360;201711;13907;38914;12511;37196;588;1899;11048;32816;11636;34715
310010;201711;803;2072;624;1813;72;246;298;810;370;1056
310020;201711;2260;6847;1825;6072;471;1743;254;823;725;2566
310030;201711;2160;6470;1710;5661;278;1048;1011;3248;1289;4296
310040;201711;956;2465;783;2215;58;203;594;1620;652;1823
310050;201711;1596;5293;1479;5064;281;1075;726;2382;1007;3457
310060;201711;3270;9574;2833;8994;159;684;2317;7285;2476;7969
310070;201711;339;862;244;693;6;18;171;469;177;487
310080;201711;730;2038;547;1708;65;237;240;720;305;957
310090;201711;4492;12776;3794;11621;444;1474;2623;7993;3067;9467
310100;201711;3395;9934;2861;9066;137;555;2264;7089;2401;7644
310110;201711;4805;13227;3950;11700;707;2347;1915;5406;2622;7753
310120;201711;636;1727;445;1400;85;327;196;529;281;856
310130;201711;374;1099;326;1011;62;236;181;497;243;733
310140;201711;180;588;147;534;47;205;42;122;89;327
310150;201711;4324;12889;3547;11354;816;2804;1179;3698;1995;6502
310160;201711;6359;19136;5234;17035;1544;5478;1056;3362;2600;8840
310163;201711;1043;3223;862;2884;284;1041;233;725;517;1766
310170;201711;8810;23824;7560;21994;787;2389;5344;15597;6131;17986
310180;201711;1596;4407;1328;3989;130;495;879;2541;1009;3036
310190;201711;2952;9340;2545;8588;675;2486;314;1005;989;3491
310200;201711;1682;5417;1376;4744;273;1028;499;1656;772;2684
310205;201711;1081;3086;823;2698;102;323;484;1643;586;1966
310210;201711;2670;7277;2243;6645;111;369;1693;4982;1804;5351
310220;201711;993;2858;848;2632;105;383;568;1686;673;2069
310230;201711;2277;6714;1946;6023;247;923;1163;3403;1410;4326
310240;201711;859;2990;776;2828;85;364;519;1866;604;2230
310250;201711;879;2670;777;2487;113;450;473;1418;586;1868
310260;201711;2656;8136;1913;6651;461;1817;288;794;749;2611
310270;201711;2604;6966;2087;6249;140;542;1652;4849;1792;5391
310280;201711;2226;5603;1773;4923;194;663;1112;2965;1306;3628
310285;201711;1882;6478;1690;6160;167;666;1149;4284;1316;4950
310290;201711;1081;3125;990;2964;218;764;531;1432;749;2196
310300;201711;1521;4959;1411;4771;290;1131;695;2212;985;3343
310310;201711;294;776;209;623;34;96;111;337;145;433
310320;201711;496;1337;322;1020;29;118;169;499;198;617
310330;201711;495;1211;316;881;37;114;129;311;166;425
310340;201711;7751;22361;6333;19959;1212;3793;3060;10022;4272;13815
310350;201711;12232;31356;8546;25347;2207;7052;2264;6627;4471;13679
310360;201711;454;1226;394;1146;16;61;310;883;326;944
310370;201711;1350;4421;1164;4052;245;903;452;1580;697;2483
310375;201711;1013;2706;679;2149;111;376;261;821;372;1197
310380;201711;363;891;195;588;40;121;65;179;105;300
310390;201711;431;1419;371;1292;102;372;79;229;181;601
310400;201711;8750;23527;6570;19904;1332;4479;2639;7727;3971;12206
310410;201711;699;2161;480;1769;121;482;101;351;222;833
310420;201711;3954;10815;2624;8096;538;1848;526;1428;1064;3276
310430;201711;1267;3869;883;3096;217;814;167;544;384;1358
310440;201711;542;1469;385;1173;44;167;202;597;246;764
310445;201711;1316;4025;1000;3421;65;246;702;2383;767;2629
310450;201711;4480;11936;3447;10345;271;865;2563;7730;2834;8595
310460;201711;1671;4699;1209;3846;272;937;328;1020;600;1957
310470;201711;3876;8603;3165;7707;263;808;2586;6156;2849;6964
310480;201711;1171;3272;864;2712;169;557;434;1315;603;1872
310490;201711;2904;8873;2393;7897;447;1730;1002;3130;1449;4860
310500;201711;1464;4407;1094;3684;235;854;447;1474;682;2328
310510;201711;1684;5077;1264;4214;329;1198;279;930;608;2128
310520;201711;1404;3534;1032;2948;83;224;672;1927;755;2151
310530;201711;870;2484;453;1481;73;262;63;168;136;430
310540;201711;3157;9587;2660;8688;712;2479;1011;3145;1723;5624
310550;201711;1155;3109;867;2641;120;469;546;1545;666;2014
310560;201711;13468;39115;11090;34877;2651;9297;3744;10938;6395;20235
310570;201711;1122;3222;937;2907;113;441;641;1908;754;2349
310590;201711;4105;11567;3432;10421;424;1436;1979;5885;2403;7321
310600;201711;1439;4480;1200;3941;201;708;543;1670;744;2378
310610;201711;504;1455;353;1193;65;267;157;480;222;747
310620;201711;144951;411138;115810;357793;26973;93342;40715;112899;67688;206241
310630;201711;4348;12530;3761;11489;311;1082;2706;8144;3017;9226
310640;201711;1009;3210;855;2903;229;864;243;774;472;1638
310650;201711;2568;7771;1960;6655;238;852;1079;3598;1317;4450
310660;201711;1272;3665;1100;3447;76;252;851;2643;927;2895
310665;201711;1256;3601;1089;3367;65;221;863;2706;928;2927
310670;201711;43479;124084;36855;111734;7253;23748;17845;52047;25098;75795
310680;201711;655;1738;571;1610;39;120;433;1201;472;1321
310690;201711;1444;4311;1148;3808;159;636;594;1880;753;2516
310700;201711;515;1203;392;1049;49;161;260;668;309;829
310710;201711;5510;17264;4129;15123;949;4073;412;1423;1361;5496
310720;201711;827;2299;715;2143;54;191;541;1599;595;1790
310730;201711;8692;25847;7646;24095;803;2866;4943;15376;5746;18242
310740;201711;4818;14536;3603;12049;754;2691;853;2750;1607;5441
310750;201711;1338;3330;957;2798;172;551;368;999;540;1550
310760;201711;518;1516;412;1324;52;195;175;572;227;767
310770;201711;1033;2995;726;2513;106;411;350;1158;456;1569
310780;201711;3850;10178;3142;9026;230;703;2222;6304;2452;7007
310790;201711;1861;5882;1672;5556;347;1169;760;2659;1107;3828
310800;201711;2321;7324;1768;6226;507;2080;120;385;627;2465
310810;201711;1086;2956;934;2682;96;316;578;1584;674;1900
310820;201711;1158;3255;788;2538;182;648;212;655;394;1303
310825;201711;2836;9507;2322;8643;102;595;1819;6623;1921;7218
310830;201711;1380;4286;1102;3759;255;942;399;1309;654;2251
310840;201711;2047;5819;1436;4706;282;971;344;1043;626;2014
310850;201711;1457;4192;1267;3944;78;347;969;2934;1047;3281
310855;201711;3034;8691;2491;7892;270;981;1780;5566;2050;6547
310860;201711;6813;20463;5662;18243;559;1903;3553;11525;4112;13428
310870;201711;1034;2624;785;2238;153;449;474;1351;627;1800
310880;201711;972;2990;790;2626;101;381;476;1553;577;1934
310890;201711;2337;6818;1711;5732;433;1618;286;835;719;2453
310900;201711;4367;12908;3333;10882;635;2321;1420;4329;2055;6650
310910;201711;1774;4860;1082;3506;141;519;127;328;268;847
310920;201711;1806;5104;1411;4447;242;844;749;2327;991;3171
310925;201711;931;2856;810;2655;155;560;496;1574;651;2134
310930;201711;5824;15898;4422;13756;729;2400;2409;7685;3138;10085
310940;201711;5980;15993;4854;14320;493;1611;3201;9295;3694;10906
310945;201711;1182;3316;1035;3104;75;263;700;2045;775;2308
310950;201711;1974;5995;1413;4805;310;1203;466;1465;776;2668
310960;201711;692;1781;423;1298;76;276;141;450;217;726
310970;201711;1124;3553;831;2925;201;754;212;705;413;1459
310980;201711;371;876;235;651;29;95;148;388;177;483
310990;201711;1218;3700;949;3130;210;733;342;1081;552;1814
311000;201711;4011;11909;3182;10539;894;3240;1183;3753;2077;6993
311010;201711;728;2350;632;2125;228;821;221;729;449;1550
311020;201711;962;2667;696;2176;100;359;318;934;418;1293
311030;201711;1603;4314;1084;3371;292;1030;319;894;611;1924
311040;201711;373;1218;308;1065;74;259;68;209;142;468
311050;201711;2222;6367;1846;5764;442;1532;705;2131;1147;3663
311060;201711;2525;7152;1804;5624;286;1044;651;1820;937;2864
311070;201711;1596;4749;1231;4092;203;792;553;1748;756;2540
311080;201711;836;2359;698;2110;119;419;374;1044;493;1463
311090;201711;1940;6608;1568;5927;415;1761;495;1821;910;3582
311100;201711;1923;6031;1381;4917;380;1514;178;565;558;2079
311110;201711;3135;7293;2150;5880;510;1451;897;2506;1407;3957
311115;201711;1183;3362;994;3076;77;293;753;2287;830;2580
311120;201711;6808;18664;5082;15504;995;3393;1597;4389;2592;7782
311130;201711;1903;5535;1557;5002;196;767;752;2310;948;3077
311140;201711;1217;3154;918;2742;68;224;604;1840;672;2064
311150;201711;1433;4892;1262;4576;203;780;740;2687;943;3467
311160;201711;3641;11547;2770;9948;904;3539;613;2140;1517;5679
311170;201711;784;2294;628;2010;48;175;354;1149;402;1324
311180;201711;1120;2918;810;2423;224;728;275;821;499;1549
311190;201711;1031;2951;792;2490;151;547;280;817;431;1364
311200;201711;1647;4864;1266;4065;354;1216;234;714;588;1930
311205;201711;892;2908;764;2656;78;344;425;1453;503;1797
311210;201711;985;3047;889;2925;136;414;635;2157;771;2571
311220;201711;766;2339;630;2066;137;489;251;765;388;1254
311230;201711;7847;24690;5986;20787;1252;4627;1852;6692;3104;11319
311240;201711;908;2667;720;2372;147;532;357;1148;504;1680
311250;201711;812;2468;683;2247;171;601;263;830;434;1431
311260;201711;2109;5520;1557;4602;324;1057;611;1713;935;2770
311265;201711;1171;3220;920;2819;95;326;584;1772;679;2098
311270;201711;3181;9886;2802;9333;231;1082;1978;6284;2209;7366
311280;201711;1124;3104;610;1955;104;374;131;402;235;776
311290;201711;1889;6073;1768;5801;216;698;1201;3974;1417;4672
311300;201711;4361;13373;3793;12458;230;1082;2930;9429;3160;10511
311310;201711;627;1943;536;1766;111;378;172;526;283;904
311320;201711;3198;10359;2853;9577;475;1842;1225;3799;1700;5641
311330;201711;4414;12656;3828;11662;569;1916;2062;6329;2631;8245
311340;201711;10693;32868;8917;29458;2660;9302;2223;7496;4883;16798
311350;201711;2138;5793;1640;4885;212;719;825;2267;1037;2986
311360;201711;827;2372;700;2202;344;1154;110;362;454;1516
311370;201711;3968;11038;3137;9621;319;1236;1738;5011;2057;6247
311380;201711;432;1380;343;1196;101;359;98;359;199;718
311390;201711;1697;5735;1443;5373;606;2587;379;1245;985;3832
311400;201711;1411;4213;1069;3549;178;695;432;1282;610;1977
311410;201711;1515;5066;1359;4857;309;1240;674;2389;983;3629
311420;201711;1744;5536;1176;4203;196;767;129;355;325;1122
311430;201711;3418;9741;2300;7447;374;1294;573;1838;947;3132
311440;201711;2347;7286;1714;6095;506;2008;373;1330;879;3338
311450;201711;1829;5960;1414;5143;383;1526;277;884;660;2410
311455;201711;939;2383;694;1995;194;574;223;629;417;1203
311460;201711;556;1791;404;1496;94;429;105;343;199;772
311470;201711;396;1316;313;1133;73;295;59;199;132;494
311480;201711;839;2163;737;2007;109;302;436;1143;545;1445
311490;201711;206;715;181;643;57;228;67;208;124;436
311500;201711;409;1138;310;968;47;170;158;494;205;664
311510;201711;2660;7838;1926;6469;487;1870;443;1453;930;3323
311520;201711;578;1798;539;1723;141;499;261;793;402;1292
311530;201711;9124;22819;6318;18242;1578;5205;1601;4417;3179;9622
311535;201711;735;2080;486;1614;110;434;115;363;225;797
311540;201711;555;1852;511;1781;141;491;241;859;382;1350
311545;201711;2132;6129;1844;5762;119;480;1377;4214;1496;4694
311547;201711;1469;3985;1275;3682;57;206;985;2815;1042;3021
311550;201711;2747;8287;2217;7241;380;1467;827;2554;1207;4021
311560;201711;254;612;197;546;29;89;111;283;140;372
311570;201711;1931;4788;1456;4122;57;170;1161;3401;1218;3571
311580;201711;2302;4408;1593;3592;222;409;1021;2484;1243;2893
311590;201711;485;1433;401;1307;86;331;190;606;276;937
311600;201711;1264;3552;1046;3262;109;330;774;2447;883;2777
311610;201711;2429;8542;2152;7923;547;1944;910;3478;1457;5422
311615;201711;2973;9107;2448;8256;215;869;1767;5881;1982;6750
311620;201711;387;1137;343;1064;30;111;256;783;286;894
311630;201711;1328;3796;1098;3373;84;295;782;2347;866;2642
311640;201711;568;1835;475;1660;108;408;192;661;300;1069
311650;201711;1984;5531;1723;5128;179;642;1130;3254;1309;3896
311660;201711;2800;8485;2088;7082;416;1484;392;1188;808;2672
311670;201711;1533;4199;1225;3716;236;793;517;1593;753;2386
311680;201711;2002;6183;1642;5489;265;942;1016;3381;1281;4323
311690;201711;535;1257;437;1133;27;71;341;897;368;968
311700;201711;2214;5607;1734;4958;60;205;1385;3890;1445;4095
311710;201711;1514;4555;1068;3677;302;1134;313;1104;615;2238
311720;201711;401;1292;339;1168;46;184;172;575;218;759
311730;201711;4918;12231;2932;8763;934;3107;401;1078;1335;4185
311740;201711;756;2299;707;2237;53;152;617;1988;670;2140
311750;201711;3915;12225;3310;11233;402;1648;2045;6668;2447;8316
311760;201711;634;2033;554;1854;116;449;171;481;287;930
311770;201711;1931;5966;1528;5193;348;1273;529;1742;877;3015
311780;201711;1189;3876;932;3325;214;886;231;699;445;1585
311783;201711;1994;6179;1682;5605;62;294;1362;4460;1424;4754
311787;201711;700;2195;501;1691;87;322;176;504;263;826
311790;201711;1449;4034;1039;3320;221;802;398;1245;619;2047
311800;201711;4781;15469;4117;13905;844;3174;594;1847;1438;5021
311810;201711;982;3174;832;2869;67;268;497;1702;564;1970
311820;201711;632;1811;527;1604;92;344;310;866;402;1210
311830;201711;8004;24813;5925;20200;1581;5854;564;1873;2145;7727
311840;201711;2787;8107;2479;7632;368;1297;1648;4993;2016;6290
311850;201711;291;859;250;792;34;101;158;502;192;603
311860;201711;49700;137286;40983;122786;6764;21598;22830;67157;29594;88755
311870;201711;1951;5542;1372;4426;253;935;494;1437;747;2372
311880;201711;6276;17467;5493;16392;481;1382;4123;12516;4604;13898
311890;201711;1361;3812;1106;3377;209;686;580;1716;789;2402
311900;201711;654;1855;531;1657;63;228;343;1051;406;1279
311910;201711;3934;11155;3275;10249;701;2297;1528;4809;2229;7106
311920;201711;1907;5846;1589;5288;171;634;954;3130;1125;3764
311930;201711;3133;8432;2524;7479;1019;3212;683;1888;1702;5100
311940;201711;12942;37220;10131;31716;1770;6122;3935;11660;5705;17782
311950;201711;2176;6291;1697;5467;119;506;1203;3805;1322;4311
311960;201711;456;1260;398;1154;46;194;244;606;290;800
311970;201711;433;1444;282;1044;52;222;55;185;107;407
311980;201711;454;1289;292;966;43;154;92;301;135;455
311990;201711;501;1270;343;1052;105;364;137;399;242;763
311995;201711;993;2914;563;1886;34;128;56;126;90;254
312000;201711;562;1604;491;1498;37;120;354;1095;391;1215
312010;201711;846;2732;695;2376;79;296;356;1185;435;1481
312015;201711;1292;4030;1160;3789;100;418;823;2606;923;3024
312020;201711;1094;3437;952;3193;197;710;410;1349;607;2059
312030;201711;1884;5060;1668;4801;36;168;1521;4324;1557;4492
312040;201711;742;2507;597;2174;106;447;204;694;310;1141
312050;201711;1216;4129;988;3642;266;1117;226;749;492;1866
312060;201711;811;2291;617;2023;152;518;297;969;449;1487
312070;201711;886;2675;623;2115;89;343;312;1020;401;1363
312080;201711;2688;6987;2014;5954;209;742;1203;3339;1412;4081
312083;201711;940;2571;757;2279;99;326;506;1483;605;1809
312087;201711;2165;6127;1888;5739;118;367;1480;4587;1598;4954
312090;201711;8859;25657;7039;22604;1714;5821;2808;8979;4522;14800
312100;201711;1478;4627;1124;4013;156;684;527;1782;683;2466
312110;201711;984;3303;842;3000;246;990;204;645;450;1635
312120;201711;625;1901;486;1634;118;453;169;497;287;950
312125;201711;1163;3536;1040;3345;166;509;744;2458;910;2967
312130;201711;840;2271;651;1927;78;264;274;768;352;1032
312140;201711;780;2420;651;2131;158;560;223;667;381;1227
312150;201711;474;1381;403;1217;20;84;259;731;279;815
312160;201711;7366;23252;6108;20680;1117;4248;2534;8168;3651;12416
312170;201711;838;2383;679;2101;43;151;459;1374;502;1525
312180;201711;1302;3882;1094;3470;173;619;508;1533;681;2152
312190;201711;527;1656;387;1352;110;417;67;241;177;658
312200;201711;4649;13038;3812;11565;698;2174;2173;6581;2871;8755
312210;201711;1198;2998;892;2571;112;388;589;1628;701;2016
312220;201711;1986;6469;1819;6241;116;337;1471;5200;1587;5537
312230;201711;10868;31749;7923;26150;2458;8924;1027;3087;3485;12011
312235;201711;1553;4485;1343;4191;144;518;963;2942;1107;3460
312240;201711;763;2542;609;2218;149;603;152;546;301;1149
312245;201711;2352;6528;2062;6131;69;259;1734;5139;1803;5398
312247;201711;814;2246;602;1900;152;481;268;897;420;1378
312250;201711;1059;2837;742;2262;138;459;300;876;438;1335
312260;201711;912;2690;737;2407;77;288;502;1582;579;1870
312270;201711;654;1904;528;1650;39;169;274;780;313;949
312280;201711;404;1285;340;1153;113;396;38;133;151;529
312290;201711;726;2378;659;2263;132;506;221;750;353;1256
312300;201711;907;2828;664;2244;168;615;84;222;252;837
312310;201711;775;2724;698;2565;131;546;328;1173;459;1719
312320;201711;1858;5112;1420;4313;406;1335;311;892;717;2227
312330;201711;881;2589;738;2379;86;325;532;1672;618;1997
312340;201711;272;730;206;624;30;102;104;302;134;404
312350;201711;265;633;228;595;27;80;175;446;202;526
312352;201711;1556;4741;1364;4442;177;589;910;3094;1087;3683
312360;201711;2644;8224;2103;7071;479;1749;503;1631;982;3380
312370;201711;1673;4913;1433;4478;326;1120;654;1953;980;3073
312380;201711;2047;5062;1800;4737;42;108;1590;4239;1632;4347
312385;201711;1237;3527;1028;3156;151;534;636;1853;787;2387
312390;201711;1979;6059;1525;5189;337;1253;404;1263;741;2516
312400;201711;2873;8929;2331;7874;878;3057;570;1996;1448;5053
312410;201711;10803;32843;9204;29918;1854;6417;4291;13772;6145;20189
312420;201711;3639;10960;3306;10352;596;1975;1853;5798;2449;7773
312430;201711;7776;21850;6526;19644;721;2346;4297;12881;5018;15227
312440;201711;829;2602;672;2293;293;1074;111;372;404;1446
312450;201711;1113;3586;885;3135;270;1005;315;1164;585;2169
312460;201711;354;1007;285;907;48;171;164;539;212;710
312470;201711;517;1384;332;1051;62;233;111;313;173;546
312480;201711;1154;2891;811;2464;115;411;488;1417;603;1828
312490;201711;1918;4937;1493;4267;253;780;812;2239;1065;3019
312500;201711;752;2008;611;1801;64;221;360;1029;424;1250
312510;201711;3521;9979;2781;8539;416;1362;1306;3870;1722;5232
312520;201711;200;594;163;536;47;153;66;228;113;381
312530;201711;542;1557;479;1468;35;132;386;1176;421;1308
312540;201711;1381;4212;927;3209;202;753;391;1339;593;2092
312550;201711;741;2135;587;1801;64;208;321;908;385;1116
312560;201711;1962;5227;1666;4832;78;303;1363;3914;1441;4217
312570;201711;2217;6179;1785;5515;509;1636;670;2116;1179;3752
312580;201711;525;1643;421;1398;50;200;173;554;223;754
312590;201711;1649;5178;1386;4652;177;760;711;2211;888;2971
312595;201711;1724;5603;1579;5300;291;967;911;3140;1202;4107
312600;201711;863;2435;580;1997;94;387;249;842;343;1229
312610;201711;6120;16498;4284;13159;935;3124;990;2883;1925;6007
312620;201711;2334;6253;1736;5432;79;323;1315;4229;1394;4552
312630;201711;266;865;226;788;57;226;74;264;131;490
312640;201711;618;1738;419;1383;64;217;130;424;194;641
312650;201711;2011;5576;1425;4398;130;477;906;2647;1036;3124
312660;201711;1342;3441;1057;3022;120;405;696;1932;816;2337
312670;201711;5055;14397;4255;13280;547;2107;2548;7651;3095;9758
312675;201711;1296;3811;1051;3353;95;381;783;2438;878;2819
312680;201711;1328;3952;1156;3706;107;441;840;2632;947;3073
312690;201711;2134;5427;1675;4814;179;534;1153;3254;1332;3788
312695;201711;864;2758;791;2634;100;325;573;1927;673;2252
312700;201711;1866;5353;1435;4550;165;573;818;2547;983;3120
312705;201711;1267;3492;1044;3110;45;165;776;2245;821;2410
312707;201711;1385;4367;1074;3763;91;436;619;2062;710;2498
312710;201711;6096;14701;3810;11196;1191;3873;758;2264;1949;6137
312720;201711;952;2840;731;2437;87;341;360;1149;447;1490
312730;201711;1728;4145;1250;3540;81;257;825;2325;906;2582
312733;201711;1537;4118;1176;3452;47;141;760;2189;807;2330
312735;201711;717;1966;623;1807;99;360;401;1053;500;1413
312737;201711;782;1946;558;1610;122;372;239;684;361;1056
312738;201711;501;1455;344;1142;73;288;135;411;208;699
312740;201711;317;797;180;591;54;188;40;105;94;293
312750;201711;1209;4082;1071;3834;179;747;547;1858;726;2605
312760;201711;1875;5791;1379;4785;277;1007;409;1405;686;2412
312770;201711;38826;101731;27299;81956;6585;21115;8000;23414;14585;44529
312780;201711;2501;8340;2240;7870;294;1189;1360;4735;1654;5924
312790;201711;333;834;199;637;26;103;75;215;101;318
312800;201711;4693;14614;3728;12591;967;3547;1119;3726;2086;7273
312810;201711;1871;5408;1239;4191;312;1167;305;910;617;2077
312820;201711;1891;5268;1569;4702;76;279;1084;3154;1160;3433
312825;201711;1222;3175;1078;2993;46;149;895;2489;941;2638
312830;201711;2386;7151;1629;5637;417;1575;312;1062;729;2637
312840;201711;1133;3571;898;3098;149;584;286;887;435;1471
312850;201711;767;2176;577;1836;93;350;252;762;345;1112
312860;201711;1410;3704;928;2896;235;766;244;741;479;1507
312870;201711;5533;16596;3649;12475;610;2261;910;2908;1520;5169
312880;201711;1339;3680;1123;3363;62;197;700;2192;762;2389
312890;201711;1930;5517;1254;4106;213;731;469;1557;682;2288
312900;201711;1154;3288;973;3041;89;296;628;2012;717;2308
312910;201711;1510;2920;874;2098;130;335;446;1035;576;1370
312920;201711;889;2631;684;2278;139;548;324;1004;463;1552
312930;201711;2060;5695;1711;5156;401;1255;773;2302;1174;3557
312940;201711;852;2660;734;2445;168;590;313;1044;481;1634
312950;201711;2529;7032;1951;6137;655;2202;551;1739;1206;3941
312960;201711;1897;5251;1643;4883;112;313;1249;3792;1361;4105
312965;201711;1727;5316;1454;4792;105;381;941;3092;1046;3473
312970;201711;967;3061;755;2698;185;739;253;868;438;1607
312980;201711;19698;60056;17135;55291;3537;12563;7956;24490;11493;37053
312990;201711;423;1231;283;975;77;308;105;351;182;659
313000;201711;432;1385;358;1247;65;301;140;432;205;733
313005;201711;2539;7695;2252;7199;210;761;1597;5047;1807;5808
313010;201711;4067;12352;3394;11161;713;2611;1807;5738;2520;8349
313020;201711;911;2953;636;2285;103;420;77;231;180;651
313030;201711;1277;3256;899;2667;139;487;487;1410;626;1897
313040;201711;757;2431;637;2157;67;276;327;1037;394;1313
313050;201711;1713;5102;1227;4332;277;1151;321;998;598;2149
313055;201711;1632;4898;1495;4698;34;120;1320;4136;1354;4256
313060;201711;903;2503;652;2054;192;665;134;382;326;1047
313065;201711;1785;5681;1529;5273;132;529;1145;3935;1277;4464
313070;201711;906;2544;724;2233;130;424;358;1089;488;1513
313080;201711;399;1146;293;932;71;267;83;209;154;476
313090;201711;4665;13216;3990;12093;1091;3573;1868;5638;2959;9211
313100;201711;1373;3750;1098;3322;73;242;833;2520;906;2762
313110;201711;1498;4183;1096;3431;137;490;520;1527;657;2017
313115;201711;2376;7559;2142;7072;374;1331;1036;3216;1410;4547
313120;201711;3494;8696;2815;7866;319;973;1870;5282;2189;6255
313130;201711;25277;72973;20985;64675;3496;11938;9861;28823;13357;40761
313140;201711;509;1268;354;1018;21;80;249;691;270;771
313150;201711;1233;3768;1006;3331;333;1159;264;880;597;2039
313160;201711;895;2509;702;2177;97;340;405;1207;502;1547
313170;201711;10697;34388;7984;28231;1645;6118;2545;8733;4190;14851
313180;201711;2232;6087;1670;5090;284;954;787;2321;1071;3275
313190;201711;3902;12333;3008;10341;608;2260;886;2842;1494;5102
313200;201711;1085;3270;938;2999;51;196;744;2319;795;2515
313210;201711;3744;11356;3139;10343;525;1906;1740;5529;2265;7435
313220;201711;1595;4497;1121;3566;216;802;385;1073;601;1875
313230;201711;2438;7890;2240;7625;106;381;1927;6570;2033;6951
313240;201711;8175;23259;5908;19120;1140;4089;2359;7218;3499;11307
313250;201711;6172;19063;5174;17221;566;2056;2739;9018;3305;11074
313260;201711;636;1786;435;1367;58;218;176;542;234;760
313270;201711;5187;15210;4290;13650;834;2811;2387;7634;3221;10445
313280;201711;369;1149;263;919;56;216;59;191;115;407
313290;201711;735;2561;610;2354;252;1049;101;355;353;1404
313300;201711;1650;5074;1309;4380;373;1351;192;558;565;1909
313310;201711;969;3169;838;2915;162;641;178;524;340;1165
313320;201711;2163;5996;1533;4994;309;1133;660;2122;969;3255
313330;201711;3987;11538;3257;10361;249;1080;2176;6665;2425;7745
313340;201711;1433;3400;1051;2839;162;445;650;1775;812;2220
313350;201711;2271;6909;1722;5750;299;1100;516;1602;815;2702
313360;201711;1252;3400;890;2782;167;643;453;1303;620;1946
313370;201711;1185;3815;1063;3568;151;560;578;1891;729;2451
313375;201711;1928;5117;1335;4159;243;890;397;1179;640;2069
313380;201711;4999;14103;3969;12241;924;3181;1531;4292;2455;7473
313390;201711;850;2839;772;2700;54;239;523;1787;577;2026
313400;201711;3379;9079;2852;8428;226;656;2310;6864;2536;7520
313410;201711;1182;3243;975;2915;116;393;716;2108;832;2501
313420;201711;15469;36401;9033;25620;1908;6028;1322;3796;3230;9824
313430;201711;887;2713;662;2256;121;506;257;780;378;1286
313440;201711;5908;13273;4011;10889;313;840;2620;7217;2933;8057
313450;201711;619;1818;462;1504;93;310;135;406;228;716
313460;201711;2025;6527;1701;5974;421;1725;716;2304;1137;4029
313470;201711;2967;7797;2485;7131;271;754;1739;5038;2010;5792
313480;201711;814;2359;560;1855;81;323;175;512;256;835
313490;201711;1495;3655;733;2509;261;1050;64;221;325;1271
313500;201711;396;1278;317;1083;45;174;119;375;164;549
313505;201711;8634;24968;7850;24023;323;1066;6961;21379;7284;22445
313507;201711;1367;3641;1172;3365;70;241;879;2512;949;2753
313510;201711;12964;37288;11179;34194;1462;4908;5872;17640;7334;22548
313520;201711;13178;40094;10986;36187;998;3787;7414;24087;8412;27874
313530;201711;470;1382;395;1261;30;109;177;528;207;637
313535;201711;2456;6981;2166;6452;172;497;1510;4476;1682;4973
313540;201711;857;2670;640;2110;161;553;204;658;365;1211
313545;201711;1164;4075;1010;3776;177;742;557;1991;734;2733
313550;201711;1678;5250;1455;4817;367;1279;713;2287;1080;3566
313560;201711;2338;5063;1823;4467;102;244;1489;3650;1591;3894
313570;201711;924;2993;757;2648;194;742;291;974;485;1716
313580;201711;5451;15288;4297;13478;716;2343;2241;7316;2957;9659
313590;201711;882;2614;692;2321;296;1088;169;566;465;1654
313600;201711;3620;10548;3115;9707;222;836;2383;7355;2605;8191
313610;201711;963;2702;813;2425;131;399;516;1531;647;1930
313620;201711;5296;15436;4515;14056;1000;3323;1952;5987;2952;9310
313630;201711;7988;21042;5663;17620;883;2975;2822;9064;3705;12039
313640;201711;914;2323;603;1876;180;609;196;575;376;1184
313650;201711;1808;5726;1545;5298;132;547;1025;3495;1157;4042
313652;201711;810;2794;751;2676;112;461;464;1577;576;2038
313655;201711;935;2836;773;2582;77;301;506;1661;583;1962
313657;201711;1322;3724;1042;3291;76;328;746;2210;822;2538
313660;201711;835;2605;709;2345;131;529;349;1073;480;1602
313665;201711;4212;12514;3431;11046;537;1935;1829;5722;2366;7657
313670;201711;40964;114237;29201;92135;6066;20805;10100;30676;16166;51481
313680;201711;985;2817;855;2611;85;299;541;1613;626;1912
313690;201711;805;2793;663;2486;138;532;212;814;350;1346
313695;201711;1500;4518;1214;4027;104;414;850;2787;954;3201
313700;201711;3300;10992;2843;10419;314;1185;2191;8139;2505;9324
313710;201711;1329;3475;987;2934;117;367;573;1710;690;2077
313720;201711;5347;15903;4018;13153;742;2728;1445;4354;2187;7082
313730;201711;1206;3060;920;2679;82;243;580;1673;662;1916
313740;201711;1745;6330;1474;5604;375;1569;144;512;519;2081
313750;201711;1930;5610;1510;4776;390;1381;493;1400;883;2781
313753;201711;1935;5063;1430;4212;192;639;764;2201;956;2840
313760;201711;4769;14073;3620;11802;923;3257;1224;3793;2147;7050
313770;201711;3473;10416;2897;9597;335;1174;1866;6240;2201;7414
313780;201711;3816;10526;2925;9086;438;1536;858;2706;1296;4242
313790;201711;430;1419;406;1375;67;242;235;766;302;1008
313800;201711;1208;3079;1013;2796;69;228;780;2182;849;2410
313810;201711;1554;4263;1290;3875;115;391;921;2780;1036;3171
313820;201711;12114;31149;9135;26024;1463;4766;3730;9951;5193;14717
313830;201711;334;1056;300;994;70;252;142;478;212;730
313835;201711;861;2762;751;2559;74;301;429;1405;503;1706
313840;201711;6465;18065;4939;15482;1230;4165;1095;3389;2325;7554
313850;201711;980;2602;837;2367;120;420;464;1189;584;1609
313860;201711;2680;7745;1979;6250;400;1355;650;1920;1050;3275
313862;201711;1279;3172;831;2443;91;289;437;1286;528;1575
313865;201711;2151;6418;1929;6068;177;605;1444;4488;1621;5093
313867;201711;1088;3650;919;3295;301;1113;340;1222;641;2335
313868;201711;1658;5411;1414;4916;114;457;1042;3581;1156;4038
313870;201711;781;2234;613;1949;134;468;204;578;338;1046
313880;201711;1324;3860;1061;3434;244;866;395;1153;639;2019
313890;201711;1969;4817;1460;4159;187;579;865;2547;1052;3126
313900;201711;3521;11949;3012;10879;911;3599;756;2745;1667;6344
313910;201711;636;2057;512;1812;147;557;89;312;236;869
313920;201711;3035;9916;2540;8982;512;1846;1309;4778;1821;6624
313925;201711;1709;4598;1325;3877;222;606;775;2312;997;2918
313930;201711;6089;21127;5164;19516;509;1830;3492;13929;4001;15759
313940;201711;8344;26029;6316;22544;1491;5983;1642;6339;3133;12322
313950;201711;4065;10625;3112;9185;760;2709;1434;3950;2194;6659
313960;201711;5255;13492;3716;11043;863;2770;1110;3134;1973;5904
313970;201711;1310;3881;1162;3638;90;348;709;2250;799;2598
313980;201711;1276;3711;864;2985;145;574;317;1034;462;1608
313990;201711;1597;5731;1337;5092;430;1765;346;1223;776;2988
314000;201711;8531;24981;7448;22933;686;2631;4881;14729;5567;17360
314010;201711;1205;3170;980;2854;49;190;748;2129;797;2319
314015;201711;1995;5771;1581;5112;215;822;861;2714;1076;3536
314020;201711;504;1463;315;1053;63;249;66;213;129;462
314030;201711;799;2523;620;2114;94;346;272;911;366;1257
314040;201711;727;2058;605;1819;118;388;258;741;376;1129
314050;201711;1524;4541;1203;3885;202;763;563;1687;765;2450
314053;201711;1623;4974;1385;4604;176;575;970;3389;1146;3964
314055;201711;2174;6243;1894;5831;52;233;1582;4851;1634;5084
314060;201711;1099;3288;882;2912;57;226;609;1975;666;2201
314070;201711;4215;12388;3328;10753;846;2850;1164;3639;2010;6489
314080;201711;1728;5212;1247;4151;216;852;353;1043;569;1895
314085;201711;2020;6468;1713;5996;424;1634;725;2521;1149;4155
314090;201711;3343;10684;2921;9941;326;1342;1793;6072;2119;7414
314100;201711;3097;7524;2631;6896;82;178;2252;6090;2334;6268
314110;201711;3924;12057;3378;10972;623;2260;1603;4839;2226;7099
314120;201711;882;2087;405;1289;97;354;64;198;161;552
314130;201711;728;2060;370;1267;61;235;101;335;162;570
314140;201711;4596;13954;3655;12020;687;2345;1551;5106;2238;7451
314150;201711;1468;3977;1166;3452;139;433;688;1993;827;2426
314160;201711;2446;6485;1818;5431;262;835;870;2680;1132;3515
314170;201711;997;2909;824;2554;115;384;465;1364;580;1748
314180;201711;4910;14661;4222;13583;777;2686;2264;7277;3041;9963
314190;201711;722;2121;535;1817;101;365;251;877;352;1242
314200;201711;2815;8393;2419;7650;178;725;1753;5348;1931;6073
314210;201711;1936;5338;1663;4883;150;494;1035;2976;1185;3470
314220;201711;1363;4058;977;3317;294;1113;233;726;527;1839
314225;201711;1228;3541;1089;3345;69;234;818;2520;887;2754
314230;201711;689;2041;608;1918;78;296;375;1158;453;1454
314240;201711;1057;3069;843;2728;201;710;353;1169;554;1879
314250;201711;533;1554;357;1152;69;240;120;350;189;590
314260;201711;939;3150;784;2817;167;723;288;933;455;1656
314270;201711;3020;9104;2477;8160;142;578;1844;5950;1986;6528
314280;201711;3245;8103;2069;6015;381;1240;747;2036;1128;3276
314290;201711;4468;12109;3804;11001;529;1587;2415;6895;2944;8482
314300;201711;1507;4732;1186;4038;320;1139;342;1139;662;2278
314310;201711;5279;14683;4044;12495;1247;4090;1030;2973;2277;7063
314315;201711;817;3074;725;2873;58;287;532;2061;590;2348
314320;201711;2761;7735;1908;6326;477;1702;729;2450;1206;4152
314330;201711;47925;140398;39053;125463;11866;40155;9564;31162;21430;71317
314340;201711;2530;6642;1364;4393;271;999;188;449;459;1448
314345;201711;1272;4081;1130;3835;150;528;738;2462;888;2990
314350;201711;1098;3050;762;2457;182;642;169;517;351;1159
314360;201711;671;2061;414;1471;77;319;90;309;167;628
314370;201711;574;1719;500;1606;60;218;355;1114;415;1332
314380;201711;1158;3411;812;2729;221;814;118;417;339;1231
314390;201711;11491;31992;8018;25537;1858;6361;1928;5589;3786;11950
314400;201711;4142;12324;3451;11246;1019;3450;1192;4023;2211;7473
314410;201711;2684;7843;1952;6445;377;1373;685;2443;1062;3816
314420;201711;721;1952;562;1718;24;129;431;1264;455;1393
314430;201711;5941;16831;4838;14888;1080;3510;1705;5249;2785;8759
314435;201711;1390;4203;1220;3937;63;278;914;2919;977;3197
314437;201711;949;2509;749;2233;23;77;502;1540;525;1617
314440;201711;521;1553;423;1390;123;452;134;386;257;838
314450;201711;1413;4054;1190;3698;182;701;661;1912;843;2613
314460;201711;3553;11573;2708;9671;652;2512;462;1615;1114;4127
314465;201711;2203;6669;1985;6243;72;312;1573;4829;1645;5141
314467;201711;927;2600;779;2354;27;79;602;1810;629;1889
314470;201711;2143;6555;1805;5867;390;1410;726;2185;1116;3595
314480;201711;5606;17730;4013;13911;743;2833;768;2387;1511;5220
314490;201711;856;2457;642;2015;99;347;364;1084;463;1431
314500;201711;1693;4646;1224;3843;232;763;406;1273;638;2036
314505;201711;1847;4979;1623;4685;124;401;1162;3347;1286;3748
314510;201711;1864;4916;1222;4017;284;1014;426;1412;710;2426
314520;201711;3360;11097;2321;8665;461;1969;222;709;683;2678
314530;201711;5446;18634;5061;17910;652;2345;3369;12154;4021;14499
314535;201711;2626;7121;2191;6500;146;469;1667;4917;1813;5386
314537;201711;1064;3171;828;2760;85;328;551;1805;636;2133
314540;201711;354;1027;271;858;45;164;109;326;154;490
314545;201711;1523;4353;1368;4136;64;195;1129;3595;1193;3790
314550;201711;650;1661;462;1400;59;227;207;560;266;787
314560;201711;3977;13036;3261;11424;565;2188;1094;3621;1659;5809
314570;201711;288;835;220;704;28;108;115;359;143;467
314580;201711;479;1566;366;1311;84;329;50;177;134;506
314585;201711;742;2349;541;1896;106;446;215;701;321;1147
314587;201711;1867;5483;1497;4850;249;753;800;2663;1049;3416
314590;201711;2662;8688;2057;7297;408;1563;617;2096;1025;3659
314600;201711;1699;5164;1091;3902;262;1040;112;346;374;1386
314610;201711;7096;21888;5839;19488;1207;4611;2408;7675;3615;12286
314620;201711;1747;4737;1470;4342;86;263;1187;3479;1273;3742
314625;201711;1467;4656;1319;4430;114;535;992;3184;1106;3719
314630;201711;4661;13392;4004;12354;198;837;3156;9626;3354;10463
314640;201711;571;1520;427;1265;96;312;163;430;259;742
314650;201711;976;2599;676;2112;88;334;269;745;357;1079
314655;201711;1544;4468;1105;3602;236;748;442;1451;678;2199
314660;201711;308;789;204;586;13;29;103;284;116;313
314670;201711;1579;4063;1106;3262;103;347;689;1965;792;2312
314675;201711;1758;5026;1530;4633;131;457;1128;3365;1259;3822
314690;201711;2014;6315;1595;5542;520;1990;283;958;803;2948
314700;201711;9054;28486;6194;22231;1549;6159;1090;3810;2639;9969
314710;201711;7792;22984;5600;18326;1112;4011;1077;3201;2189;7212
314720;201711;2186;6978;1685;5903;388;1477;424;1474;812;2951
314730;201711;2069;6029;1591;5169;411;1457;470;1405;881;2862
314740;201711;2648;7926;2169;7052;257;1009;1150;3587;1407;4596
314750;201711;331;998;262;860;28;112;138;429;166;541
314760;201711;1778;5662;1268;4443;186;744;286;821;472;1565
314770;201711;1021;3108;561;1898;44;162;135;385;179;547
314780;201711;306;784;220;661;50;178;104;294;154;472
314790;201711;9985;29522;7558;25025;2784;10247;838;2394;3622;12641
314795;201711;1421;4070;1242;3779;69;287;961;2814;1030;3101
314800;201711;11161;30384;6899;21982;1599;5522;916;2660;2515;8182
314810;201711;9297;26210;7014;22224;2109;7075;1589;5108;3698;12183
314820;201711;861;2330;637;1945;114;402;323;940;437;1342
314830;201711;1484;4819;1302;4486;285;1082;656;2237;941;3319
314840;201711;882;2968;712;2714;85;434;461;1680;546;2114
314850;201711;1911;5172;1521;4519;113;412;1167;3393;1280;3805
314860;201711;3139;10071;2703;9212;428;1648;1569;5218;1997;6866
314870;201711;5681;16241;4676;14853;434;1505;3447;11036;3881;12541
314875;201711;1696;5359;1569;5183;105;303;1339;4479;1444;4782
314880;201711;880;2253;702;2009;44;103;491;1486;535;1589
314890;201711;463;1375;340;1100;58;214;131;378;189;592
314900;201711;644;1772;512;1553;112;368;188;571;300;939
314910;201711;1659;5171;1314;4606;318;1293;562;1885;880;3178
314915;201711;2296;7157;1980;6585;153;630;1350;4348;1503;4978
314920;201711;451;1201;337;1048;23;72;200;605;223;677
314930;201711;4886;15413;3993;13568;904;3304;1290;4194;2194;7498
314940;201711;384;1089;336;1002;41;129;202;564;243;693
314950;201711;367;1024;256;854;34;123;99;320;133;443
314960;201711;704;1985;547;1675;83;299;289;818;372;1117
314970;201711;620;2015;534;1867;116;462;190;647;306;1109
314980;201711;1225;3646;981;3265;292;1089;91;280;383;1369
314990;201711;2239;6817;1590;5326;383;1459;338;987;721;2446
314995;201711;1546;4615;1308;4233;120;512;795;2450;915;2962
315000;201711;1043;2920;822;2562;73;276;526;1609;599;1885
315010;201711;402;1236;305;1031;67;277;111;329;178;606
315015;201711;2021;6088;1844;5864;214;718;1230;4071;1444;4789
315020;201711;792;2401;571;1951;91;362;270;876;361;1238
315030;201711;563;1652;420;1375;111;380;89;266;200;646
315040;201711;861;2550;785;2409;136;447;474;1437;610;1884
315050;201711;1181;3281;914;2886;102;377;475;1481;577;1858
315053;201711;1058;3088;878;2740;109;415;480;1451;589;1866
315057;201711;1598;5323;1412;4934;221;778;807;2824;1028;3602
315060;201711;606;1947;419;1549;100;391;76;284;176;675
315070;201711;649;1902;494;1602;139;481;149;459;288;940
315080;201711;2739;8643;2215;7483;501;1726;952;3220;1453;4946
315090;201711;776;2584;613;2224;127;495;169;582;296;1077
315100;201711;1110;3625;769;2776;161;677;263;872;424;1549
315110;201711;1284;3589;1026;3146;158;519;475;1460;633;1979
315120;201711;12089;28905;8666;24274;1085;3132;4463;13137;5548;16269
315130;201711;1244;3907;1071;3578;226;887;376;1168;602;2055
315140;201711;2742;8134;2185;7050;450;1643;960;2817;1410;4460
315150;201711;4124;10803;3000;8955;460;1503;1262;3721;1722;5224
315160;201711;1369;3733;972;3080;203;680;403;1255;606;1935
315170;201711;1437;4558;1083;3757;239;885;176;603;415;1488
315180;201711;16322;44025;8954;28781;1543;5636;1786;5169;3329;10805
315190;201711;1948;4842;1600;4329;350;954;1013;2718;1363;3672
315200;201711;3708;11646;2831;9949;885;3413;578;1971;1463;5384
315210;201711;7465;21087;5771;17493;823;2775;2419;6798;3242;9573
315213;201711;1107;3168;974;2974;29;86;793;2412;822;2498
315217;201711;2429;7961;1972;7104;159;742;1250;4373;1409;5115
315220;201711;8778;24991;7243;22295;2224;7113;2164;6719;4388;13832
315230;201711;2924;7589;2603;7206;83;133;2353;6815;2436;6948
315240;201711;2765;8438;2347;7756;576;2061;1161;3725;1737;5786
315250;201711;9560;28004;7417;23970;1473;5201;2841;8960;4314;14161
315260;201711;886;2733;555;1944;107;391;53;160;160;551
315270;201711;722;2240;524;1841;93;392;143;446;236;838
315280;201711;2769;7528;1650;5194;364;1225;261;799;625;2024
315290;201711;1190;3191;764;2484;246;861;185;627;431;1488
315300;201711;682;1721;461;1433;227;766;116;375;343;1141
315310;201711;1266;3813;993;3284;98;359;566;1796;664;2155
315320;201711;673;1995;504;1700;60;288;230;707;290;995
315330;201711;707;2527;403;1655;83;370;103;392;186;762
315340;201711;3102;8484;2431;7480;345;1157;1289;3884;1634;5041
315350;201711;1675;4608;1271;3957;98;340;709;2178;807;2518
315360;201711;1654;5239;1238;4321;221;839;419;1388;640;2227
315370;201711;447;1377;379;1235;72;235;171;549;243;784
315380;201711;205;653;149;522;38;149;30;90;68;239
315390;201711;1157;3597;861;2970;175;657;251;803;426;1460
315400;201711;4118;12008;3299;10481;498;1654;1658;5195;2156;6849
315410;201711;2199;5321;1732;4685;375;1068;752;2012;1127;3080
315415;201711;1113;3376;929;3090;299;1099;324;1076;623;2175
315420;201711;1135;3553;834;2946;193;703;111;353;304;1056
315430;201711;3473;9105;2554;7611;675;2301;796;2231;1471;4532
315440;201711;928;2703;796;2474;130;500;399;1112;529;1612
315445;201711;1972;5198;1508;4486;193;614;967;2863;1160;3477
315450;201711;2256;6806;1975;6351;289;908;1238;4084;1527;4992
315460;201711;29603;92582;26064;85741;8456;29643;6982;22052;15438;51695
315470;201711;458;1320;363;1158;29;114;193;592;222;706
315480;201711;1480;4341;1018;3381;228;815;227;759;455;1574
315490;201711;2905;7488;2093;6339;352;1170;710;2047;1062;3217
315500;201711;481;1379;303;979;33;127;132;372;165;499
315510;201711;1257;3594;1088;3322;55;213;891;2677;946;2890
315520;201711;1091;3155;856;2779;57;237;572;1784;629;2021
315530;201711;625;2031;489;1684;169;641;162;505;331;1146
315540;201711;1078;3160;809;2663;127;477;311;1013;438;1490
315550;201711;1696;4684;1277;4059;272;979;463;1432;735;2411
315560;201711;5899;19383;5319;18474;428;1689;3674;12789;4102;14478
315570;201711;1818;5602;1619;5208;156;596;884;2770;1040;3366
315580;201711;2203;5931;1730;5129;419;1395;541;1564;960;2959
315590;201711;893;2479;739;2240;99;341;368;1091;467;1432
315600;201711;2394;8091;1809;6936;267;1032;986;3934;1253;4966
315610;201711;914;2460;721;2097;127;471;309;746;436;1217
315620;201711;298;1034;282;1002;62;214;159;605;221;819
315630;201711;816;2472;665;2166;163;543;161;471;324;1014
315640;201711;377;1068;321;980;48;172;157;451;205;623
315645;201711;828;2284;601;1889;185;618;157;464;342;1082
315650;201711;1772;4701;1392;4154;74;295;1046;3066;1120;3361
315660;201711;2531;6355;1958;5409;137;385;1357;3679;1494;4064
315670;201711;11072;34189;9564;31315;2090;7404;4232;13367;6322;20771
315680;201711;2855;9195;2180;7858;596;2337;721;2558;1317;4895
315690;201711;2834;7745;1874;6018;459;1558;433;1504;892;3062
315700;201711;7104;21138;5795;18573;977;3363;2695;8375;3672;11738
315710;201711;1872;5016;1355;4179;84;353;844;2459;928;2812
315720;201711;3966;12107;3474;11209;222;1036;2326;7181;2548;8217
315725;201711;1588;4649;1356;4335;193;623;968;3147;1161;3770
315727;201711;584;1668;447;1410;85;303;192;560;277;863
315730;201711;680;2106;625;1984;80;296;309;928;389;1224
315733;201711;1103;3054;896;2697;212;751;334;933;546;1684
315737;201711;1172;3493;921;3024;46;198;628;2029;674;2227
315740;201711;946;2794;775;2448;126;471;383;1078;509;1549
315750;201711;1178;3370;1010;3090;55;192;754;2322;809;2514
315760;201711;1080;2774;1021;2702;16;30;960;2545;976;2575
315765;201711;1725;4872;1479;4552;36;120;1331;4135;1367;4255
315770;201711;1186;3735;1026;3486;341;1263;330;1102;671;2365
315780;201711;23567;71655;20622;66043;3035;11136;10527;32078;13562;43214
315790;201711;3555;11435;3070;10509;271;938;2040;7169;2311;8107
315800;201711;1211;4704;922;3853;193;880;184;731;377;1611
315810;201711;1274;3333;1098;3070;85;298;839;2237;924;2535
315820;201711;2288;7327;1988;6801;312;1194;1235;4157;1547;5351
315830;201711;1091;3376;844;2912;70;298;378;1238;448;1536
315840;201711;757;1971;472;1403;68;208;166;464;234;672
315850;201711;962;3213;879;3065;203;772;454;1484;657;2256
315860;201711;509;1612;360;1316;80;347;105;348;185;695
315870;201711;445;1258;372;1147;27;94;238;703;265;797
315880;201711;1085;2891;830;2514;83;308;355;1021;438;1329
315890;201711;1449;4754;1271;4413;416;1546;503;1667;919;3213
315895;201711;5572;16348;4558;14252;718;2523;2049;5983;2767;8506
315900;201711;807;2165;719;2041;64;233;563;1512;627;1745
315910;201711;475;1518;424;1435;78;277;269;887;347;1164
315920;201711;1593;4302;824;2646;172;587;178;496;350;1083
315930;201711;1022;2587;724;2085;170;501;266;756;436;1257
315935;201711;803;2629;700;2425;162;631;206;717;368;1348
315940;201711;606;1873;511;1683;81;294;250;820;331;1114
315950;201711;1171;3417;1014;3146;166;523;696;2159;862;2682
315960;201711;3429;10325;2237;8045;756;3161;92;210;848;3371
315970;201711;657;1888;513;1686;59;183;360;1217;419;1400
315980;201711;3586;8344;2133;6043;494;1542;698;1797;1192;3339
315990;201711;3655;9904;2917;8644;374;1252;1619;4718;1993;5970
316000;201711;519;1513;424;1371;87;337;172;521;259;858
316010;201711;667;2092;533;1832;53;230;283;895;336;1125
316020;201711;967;3055;836;2806;86;392;554;1748;640;2140
316030;201711;3016;8653;2223;7231;255;885;1331;4392;1586;5277
316040;201711;2875;9067;2149;7588;351;1379;506;1716;857;3095
316045;201711;1878;5625;1765;5441;154;453;1389;4369;1543;4822
316050;201711;355;1093;269;931;44;184;143;472;187;656
316060;201711;693;1970;527;1701;65;306;309;915;374;1221
316070;201711;5529;16576;4719;14911;886;3114;2109;6422;2995;9536
316080;201711;703;2390;588;2131;163;641;67;233;230;874
316090;201711;485;1497;347;1201;60;242;127;410;187;652
316095;201711;1374;4312;1182;3965;201;707;634;2114;835;2821
316100;201711;2522;8058;1845;6462;386;1488;507;1667;893;3155
316105;201711;856;2402;649;2052;116;394;349;1098;465;1492
316110;201711;11620;37526;10294;35238;1443;5114;6627;23014;8070;28128
316120;201711;1064;3331;789;2660;188;661;194;556;382;1217
316130;201711;1418;3254;853;2403;122;393;381;1038;503;1431
316140;201711;1050;2875;730;2352;130;436;370;1201;500;1637
316150;201711;1455;3792;1242;3432;174;547;666;1750;840;2297
316160;201711;1071;3128;866;2748;100;351;490;1488;590;1839
316165;201711;891;2278;710;2019;129;434;397;1112;526;1546
316170;201711;1146;3149;844;2662;117;414;423;1276;540;1690
316180;201711;1360;4150;930;3207;202;774;133;379;335;1153
316190;201711;2765;8274;1571;5305;288;977;427;1291;715;2268
316200;201711;3384;10472;2566;8886;607;2377;586;1928;1193;4305
316210;201711;4059;12532;3104;10544;1082;3930;325;1106;1407;5036
316220;201711;692;2111;485;1676;99;376;56;214;155;590
316225;201711;1254;3228;1000;2799;86;307;689;1823;775;2130
316230;201711;401;1121;338;1023;47;148;157;503;204;651
316240;201711;6131;18386;5452;17402;604;1965;3986;12769;4590;14734
316245;201711;3078;10524;2799;10079;209;1094;2154;7522;2363;8616
316250;201711;9159;25150;6943;21104;1919;6351;1537;4474;3456;10825
316255;201711;2611;7655;2274;7178;350;1200;1499;4766;1849;5966
316257;201711;1264;3249;906;2668;123;395;406;1160;529;1555
316260;201711;1860;5002;1427;4355;65;235;792;2510;857;2745
316265;201711;1270;3509;933;2909;61;193;598;1848;659;2041
316270;201711;3406;11231;3051;10424;694;2532;1271;4158;1965;6690
316280;201711;3030;9466;2724;8883;371;1385;1521;4781;1892;6166
316290;201711;3140;9456;2587;8390;449;1660;946;3039;1395;4699
316292;201711;4109;11906;3501;10905;368;1316;2488;7605;2856;8921
316294;201711;768;2361;569;1996;116;461;97;344;213;805
316295;201711;2248;6771;1979;6276;112;478;1488;4546;1600;5024
316300;201711;987;3114;821;2803;57;221;531;1831;588;2052
316310;201711;936;2301;534;1682;101;353;209;641;310;994
316320;201711;554;1672;443;1469;74;282;157;507;231;789
316330;201711;1045;3063;795;2522;68;256;528;1613;596;1869
316340;201711;1062;3155;794;2620;103;418;394;1214;497;1632
316350;201711;1236;3840;1091;3594;138;491;693;2270;831;2761
316360;201711;697;1840;557;1623;63;207;394;1115;457;1322
316370;201711;4356;13050;3570;11528;955;3508;843;2420;1798;5928
316380;201711;1576;4024;1219;3527;46;151;926;2657;972;2808
316390;201711;834;2338;672;2072;162;566;273;832;435;1398
316400;201711;1244;3755;902;3098;148;534;345;1139;493;1673
316410;201711;989;3115;879;2951;91;320;694;2324;785;2644
316420;201711;1785;5477;1578;5205;120;465;1206;3906;1326;4371
316430;201711;838;2478;569;1905;131;470;133;426;264;896
316440;201711;661;2107;504;1845;145;608;80;287;225;895
316443;201711;579;1718;456;1484;106;383;135;428;241;811
316447;201711;1631;4638;1450;4368;70;245;1202;3592;1272;3837
316450;201711;2133;6910;1744;6113;181;696;1191;4135;1372;4831
316460;201711;829;2448;752;2310;245;789;345;1024;590;1813
316470;201711;6562;19844;5093;16939;1133;4253;1525;4804;2658;9057
316480;201711;193;609;164;547;42;154;56;171;98;325
316490;201711;326;931;244;759;37;122;102;287;139;409
316500;201711;1186;4029;782;2910;166;673;86;292;252;965
316510;201711;646;2395;597;2299;163;684;208;795;371;1479
316520;201711;1010;2889;816;2547;141;509;337;990;478;1499
316530;201711;901;2763;698;2362;125;538;290;868;415;1406
316540;201711;729;2286;642;2126;110;432;214;660;324;1092
316550;201711;1202;3852;1101;3668;141;524;750;2473;891;2997
316553;201711;2755;8835;1950;6850;579;2181;316;1053;895;3234
316555;201711;2747;9006;2431;8582;158;605;1890;6803;2048;7408
316556;201711;647;1595;475;1322;35;115;283;714;318;829
316557;201711;845;2934;755;2755;327;1268;225;776;552;2044
316560;201711;265;919;213;820;64;291;44;156;108;447
316570;201711;1157;3671;1001;3360;324;1112;298;1023;622;2135
316580;201711;364;936;231;681;56;183;76;205;132;388
316590;201711;1360;3683;985;3016;173;591;538;1529;711;2120
316600;201711;994;3176;885;2972;159;596;447;1474;606;2070
316610;201711;568;1969;489;1814;65;338;303;1062;368;1400
316620;201711;2127;6175;1822;5695;134;487;1287;4027;1421;4514
316630;201711;1496;4640;1196;4051;376;1263;412;1561;788;2824
316640;201711;145;422;118;372;27;101;58;154;85;255
316650;201711;961;3275;792;3019;63;268;533;2087;596;2355
316660;201711;172;432;72;227;7;33;13;33;20;66
316670;201711;1976;5284;1530;4532;470;1472;462;1315;932;2787
316680;201711;1914;5019;1513;4406;153;489;1083;3075;1236;3564
316690;201711;1071;3519;923;3217;238;944;315;1063;553;2007
316695;201711;1010;3058;884;2833;67;264;587;1844;654;2108
316700;201711;368;1018;320;953;21;97;226;616;247;713
316710;201711;2628;9429;2155;8419;689;2764;657;2749;1346;5513
316720;201711;16528;51265;13443;44686;3053;10833;4656;14919;7709;25752
316730;201711;326;998;280;893;76;276;105;296;181;572
316740;201711;657;2065;591;1964;66;301;414;1338;480;1639
316750;201711;403;1307;321;1131;56;222;115;388;171;610
316760;201711;3500;11331;2949;10424;1309;4894;895;3194;2204;8088
316770;201711;1426;3720;1203;3415;41;145;1017;2906;1058;3051
316780;201711;568;1840;472;1640;141;549;47;123;188;672
316790;201711;704;1990;536;1698;145;496;168;521;313;1017
316800;201711;5264;16277;4431;14671;585;2214;2528;8009;3113;10223
316805;201711;838;2037;765;1950;20;32;688;1835;708;1867
316810;201711;540;1576;409;1326;104;375;166;499;270;874
316820;201711;344;867;187;589;29;103;27;91;56;194
316830;201711;608;1912;534;1774;111;421;291;934;402;1355
316840;201711;2667;7813;2293;7134;472;1649;1067;3178;1539;4827
316850;201711;2011;5582;1558;4809;209;762;836;2496;1045;3258
316860;201711;17466;51769;14287;46430;3036;11163;5766;18170;8802;29333
316870;201711;6157;18890;4821;15994;1185;4240;1304;4123;2489;8363
316880;201711;839;2383;721;2199;158;559;296;861;454;1420
316890;201711;1207;2805;811;2267;172;579;463;1170;635;1749
316900;201711;2353;6702;1833;5625;433;1474;578;1583;1011;3057
316905;201711;465;1494;390;1328;108;385;157;536;265;921
316910;201711;879;2577;597;2039;159;630;69;216;228;846
316920;201711;1618;4263;1120;3503;241;835;453;1404;694;2239
316930;201711;7702;24893;5821;21009;1200;4689;1090;3811;2290;8500
316935;201711;3940;11568;2859;9409;701;2448;764;2499;1465;4947
316940;201711;6596;20747;5125;17490;1098;4069;1376;4413;2474;8482
316950;201711;1673;4277;1348;3826;76;257;1048;2911;1124;3168
316960;201711;4615;11408;3540;9905;554;1699;2109;5849;2663;7548
316970;201711;3080;9552;2845;9106;600;2097;1188;3579;1788;5676
316980;201711;800;2433;565;1959;166;624;74;260;240;884
316990;201711;9561;28885;7421;24176;2099;7295;712;2189;2811;9484
317000;201711;2624;8578;2482;8381;186;640;1911;6853;2097;7493
317005;201711;2446;7290;2076;6665;406;1345;1053;3340;1459;4685
317010;201711;23551;57940;14264;43546;3611;12194;2770;9178;6381;21372
317020;201711;60876;158235;35943;110281;7168;24059;7620;21312;14788;45371
317030;201711;687;1954;559;1761;37;152;390;1201;427;1353
317040;201711;9812;27015;7405;22780;1855;5983;2779;8605;4634;14588
317043;201711;759;1950;615;1748;130;401;319;892;449;1293
317047;201711;1159;2945;858;2476;64;199;582;1668;646;1867
317050;201711;1312;4270;956;3442;170;654;317;1070;487;1724
317052;201711;2242;6975;1974;6530;220;791;1365;4441;1585;5232
317057;201711;1629;4270;1218;3570;73;271;829;2346;902;2617
317060;201711;402;1111;233;745;49;190;69;187;118;377
317065;201711;1232;3589;1063;3289;48;215;838;2510;886;2725
317070;201711;8117;24416;5463;18637;1221;4708;759;2440;1980;7148
317075;201711;966;2872;715;2316;147;496;133;404;280;900
317080;201711;5904;15160;4753;13249;1596;4661;1257;3292;2853;7953
317090;201711;4502;14401;4154;13868;360;1268;3072;10302;3432;11570
317100;201711;2638;6752;1850;5469;631;1987;548;1598;1179;3585
317103;201711;1782;6004;1588;5641;180;862;973;3265;1153;4127
317107;201711;1347;3921;1132;3511;74;279;751;2169;825;2448
317110;201711;615;1487;351;1086;56;220;122;392;178;612
317115;201711;1112;3335;934;2957;76;238;660;2091;736;2329
317120;201711;11437;34589;8952;29933;1595;5983;4172;13430;5767;19413
317130;201711;7641;20695;5696;17333;1270;4247;1904;5728;3174;9975
317140;201711;572;1761;495;1622;69;226;290;947;359;1173
317150;201711;982;2547;798;2331;50;158;636;1838;686;1996
317160;201711;3463;8823;2518;7471;245;760;1638;4882;1883;5642
317170;201711;1942;5083;1401;4166;223;761;490;1283;713;2044
317180;201711;1593;5307;1271;4554;306;1162;307;1075;613;2237
317190;201711;1306;3681;1005;3214;61;226;657;2070;718;2296
317200;201711;4398;12835;3412;10889;853;2969;860;2561;1713;5530
317210;201711;917;2580;766;2360;66;276;551;1677;617;1953
317220;201711;262;882;239;834;57;224;105;361;162;585
320010;201711;4624;14195;3896;12783;539;1905;2293;7375;2832;9280
320013;201711;1808;5447;1260;4208;220;732;522;1809;742;2541
320016;201711;2923;7940;2458;7290;146;431;1955;5783;2101;6214
320020;201711;3529;10614;2852;9320;781;2655;868;2938;1649;5593
320030;201711;1462;4538;1039;3614;308;1137;289;934;597;2071
320035;201711;1683;4878;1437;4473;469;1611;584;1729;1053;3340
320040;201711;3117;9747;2588;8729;504;1827;1144;3838;1648;5665
320050;201711;1617;4183;1422;3854;335;950;705;1875;1040;2825
320060;201711;9577;29151;7103;23925;1648;6022;1771;5759;3419;11781
320070;201711;1359;4145;1052;3506;234;847;312;1004;546;1851
320080;201711;5330;14845;3981;12228;850;2700;1447;4495;2297;7195
320090;201711;7076;20069;5398;16764;1379;4436;2057;6311;3436;10747
320100;201711;2340;7247;1896;6370;568;1935;614;2092;1182;4027
320110;201711;1192;3370;987;3004;252;792;282;867;534;1659
320115;201711;1773;6115;1569;5736;768;2876;432;1628;1200;4504
320120;201711;13828;39724;10535;33623;2427;8458;3085;9570;5512;18028
320130;201711;32217;99501;28614;92861;5160;18710;14836;46806;19996;65516
320140;201711;3077;9479;2228;7627;535;2013;541;1852;1076;3865
320150;201711;12539;35120;9366;28837;2929;9642;1114;3123;4043;12765
320160;201711;4867;14805;3971;13026;851;3044;1734;5571;2585;8615
320170;201711;1603;4924;1239;4166;277;976;519;1710;796;2686
320180;201711;702;2362;580;2109;203;755;135;513;338;1268
320190;201711;3130;10532;2434;8882;642;2452;433;1535;1075;3987
320200;201711;950;2837;739;2455;236;869;179;610;415;1479
320210;201711;4503;12227;3632;10638;627;2041;1805;5029;2432;7070
320220;201711;2522;7202;1997;6314;369;1277;1057;3344;1426;4621
320225;201711;1220;4047;907;3268;331;1234;130;479;461;1713
320230;201711;4101;12632;3314;11239;908;3324;1270;4350;2178;7674
320240;201711;12713;35561;10062;31133;2298;7660;3852;11924;6150;19584
320245;201711;2870;9445;2563;8755;980;3476;623;2105;1603;5581
320250;201711;1783;5307;1266;4141;328;1208;236;698;564;1906
320255;201711;1621;5504;1437;5180;558;2078;560;2107;1118;4185
320260;201711;968;2906;720;2342;222;795;194;542;416;1337
320265;201711;2378;7543;2027;6881;848;2994;589;1982;1437;4976
320270;201711;2491;7187;1850;5994;353;1205;904;2992;1257;4197
320280;201711;5360;16262;4585;14765;1239;4309;1235;3827;2474;8136
320290;201711;1336;4204;931;3213;280;1070;166;524;446;1594
320300;201711;3828;12564;3251;11281;1070;3919;657;2290;1727;6209
320305;201711;4430;13588;3662;11937;905;3133;1370;4381;2275;7514
320310;201711;1803;5327;1417;4531;330;1103;561;1779;891;2882
320313;201711;1984;5452;1352;4186;320;1114;268;781;588;1895
320316;201711;1517;4487;1200;3844;321;1080;455;1450;776;2530
320320;201711;18179;52733;13863;44873;3730;12949;4612;14697;8342;27646
320330;201711;2770;8071;2243;7127;658;2071;903;3053;1561;5124
320332;201711;5141;15899;4386;14514;1104;3907;2059;6696;3163;10603
320334;201711;1932;5967;1354;4707;329;1287;315;1021;644;2308
320335;201711;1946;5773;1253;4136;344;1238;210;641;554;1879
320340;201711;4866;13026;4196;11981;836;2518;2099;6142;2935;8660
320350;201711;4843;12619;3538;10272;600;1821;1613;4613;2213;6434
320360;201711;1519;4009;1132;3288;191;547;479;1370;670;1917
320370;201711;2518;8249;2005;7050;571;2065;635;2224;1206;4289
320380;201711;2089;6083;1798;5578;415;1373;869;2639;1284;4012
320390;201711;6740;19538;5300;16518;1358;4482;1782;5383;3140;9865
320400;201711;3268;9843;2798;8962;659;2244;1224;3894;1883;6138
320405;201711;4204;11993;3551;10824;573;1883;2038;6095;2611;7978
320410;201711;4882;13333;3692;11549;724;2378;1687;5449;2411;7827
320420;201711;2427;7099;1951;6262;579;2034;468;1501;1047;3535
320425;201711;1955;4927;1503;4175;144;449;936;2517;1080;2966
320430;201711;2557;6957;2103;6040;387;1181;1166;3183;1553;4364
320435;201711;2463;7911;1972;6905;777;2840;505;1849;1282;4689
320440;201711;1011;3112;837;2726;172;633;354;1113;526;1746
320450;201711;1685;5149;1356;4506;345;1252;587;1869;932;3121
320455;201711;3662;11809;2691;9544;772;2909;686;2371;1458;5280
320460;201711;2298;7217;1647;5717;401;1460;310;1002;711;2462
320465;201711;1333;3989;1010;3315;136;493;524;1731;660;2224
320470;201711;3832;11129;2719;8750;744;2570;564;1744;1308;4314
320480;201711;1643;4991;1406;4509;299;1059;658;2062;957;3121
320490;201711;14338;42376;12022;38304;2791;9704;4699;15025;7490;24729
320495;201711;1340;3830;878;2878;224;784;190;639;414;1423
320500;201711;43757;126092;37194;114745;7350;24410;18844;56751;26194;81161
320501;201711;4396;13337;3330;11479;979;3805;904;2967;1883;6772
320503;201711;1976;6485;1550;5554;537;2127;440;1436;977;3563
320506;201711;3252;9847;2260;7563;661;2372;93;252;754;2624
320510;201711;8360;24688;7101;22531;1299;4562;3691;11460;4990;16022
320515;201711;1736;4970;1393;4240;421;1338;346;1045;767;2383
320517;201711;1978;6315;1571;5474;575;2145;311;1046;886;3191
320520;201711;30536;89295;24895;79577;5550;19467;9532;30232;15082;49699
320530;201711;25488;73457;20772;65011;3198;11796;11353;33421;14551;45217
330010;201711;19135;56818;16630;52356;3507;11581;8762;27644;12269;39225
330015;201711;1358;3717;1160;3356;195;649;551;1523;746;2172
330020;201711;17840;49340;16052;46524;2638;8513;10439;29444;13077;37957
330022;201711;1826;5197;1479;4642;293;982;850;2639;1143;3621
330023;201711;3063;9080;2557;8248;664;2317;888;2760;1552;5077
330025;201711;4534;12074;3320;9893;1055;3412;1014;2997;2069;6409
330030;201711;8418;26251;7083;23787;1221;4573;3696;11848;4917;16421
330040;201711;11071;32296;9836;30041;1694;5666;5794;17077;7488;22743
330045;201711;76187;197290;65548;182549;8017;22583;46517;128510;54534;151093
330050;201711;2253;6531;1848;5834;473;1587;758;2272;1231;3859
330060;201711;5117;14412;4345;13199;1029;3440;1896;5519;2925;8959
330070;201711;18897;54870;16566;51103;3415;11168;8258;25549;11673;36717
330080;201711;7937;21923;7237;20843;617;1876;5146;14643;5763;16519
330090;201711;2430;6250;2086;5742;300;908;1228;3292;1528;4200
330093;201711;1845;5235;1498;4701;208;668;931;3034;1139;3702
330095;201711;993;3213;841;2885;128;482;379;1222;507;1704
330100;201711;60003;174988;52130;162938;5733;20779;34332;106013;40065;126792
330110;201711;2099;6493;1860;6082;382;1329;745;2387;1127;3716
330115;201711;1675;4747;1442;4392;280;967;803;2379;1083;3346
330120;201711;2786;7097;2331;6481;268;878;1628;4417;1896;5295
330130;201711;3298;10158;2904;9514;611;2125;1520;4978;2131;7103
330140;201711;3024;8874;2633;8314;507;1826;1517;4663;2024;6489
330150;201711;1912;5569;1554;4935;369;1216;527;1672;896;2888
330160;201711;1089;3273;928;3014;228;818;453;1424;681;2242
330170;201711;87414;254943;78804;241492;14475;46486;45728;139405;60203;185891
330180;201711;1995;5606;1668;5039;81;331;1196;3517;1277;3848
330185;201711;8369;24236;7109;21997;1057;3628;4368;13142;5425;16770
330187;201711;3569;9989;3032;9143;516;1721;1841;5456;2357;7177
330190;201711;25407;68425;23088;65067;2915;8441;17145;48275;20060;56716
330200;201711;12978;38497;11246;35917;2658;8535;5995;19680;8653;28215
330205;201711;1885;5106;1624;4683;128;431;1122;3160;1250;3591
330210;201711;3098;8412;2369;7027;554;1721;857;2424;1411;4145
330220;201711;9218;26909;7649;23783;1873;6296;2113;6063;3986;12359
330225;201711;3393;10128;2877;9221;308;1249;1850;5664;2158;6913
330227;201711;15296;42592;13670;40287;1924;5951;9456;27976;11380;33927
330230;201711;1203;3378;1042;3141;109;385;687;2015;796;2400
330240;201711;16733;48762;14072;44145;3682;12442;5743;17468;9425;29910
330245;201711;1274;3645;909;2995;213;748;214;698;427;1446
330250;201711;32635;92897;28815;86891;7343;22387;12803;39716;20146;62103
330260;201711;4181;12287;3453;10974;628;2171;1645;5009;2273;7180
330270;201711;21187;45914;13809;35776;2866;8207;5384;13910;8250;22117
330280;201711;2154;6173;1764;5456;279;962;904;2663;1183;3625
330285;201711;17050;46568;14697;43131;2150;6959;9391;26976;11541;33935
330290;201711;3153;8925;2711;8193;440;1436;1490;4317;1930;5753
330300;201711;3080;9747;2722;9064;468;1728;1528;4921;1996;6649
330310;201711;2174;5987;1753;5248;166;494;1115;3331;1281;3825
330320;201711;12131;34733;11126;33207;1403;4477;8203;24298;9606;28775
330330;201711;26662;69875;22912;64191;3535;10953;14561;39605;18096;50558
330340;201711;12870;36443;10208;31761;2333;7835;3904;11688;6237;19523
330350;201711;84560;234140;74388;219855;9067;28929;52199;153297;61266;182226
330360;201711;6308;17389;5728;16656;531;1647;4491;12966;5022;14613
330370;201711;3412;11759;3016;10929;939;3497;1054;3859;1993;7356
330380;201711;4680;14521;3821;12875;945;3423;1273;4166;2218;7589
330385;201711;3734;12295;3309;11540;952;3516;1330;4709;2282;8225
330390;201711;20898;65830;17600;59199;4049;14608;7445;24405;11494;39013
330395;201711;2973;8323;2642;7834;200;704;1817;5303;2017;6007
330400;201711;2643;7891;2372;7388;218;842;1628;4760;1846;5602
330410;201711;2644;7857;2046;6738;400;1451;917;2875;1317;4326
330411;201711;2213;6579;1903;5984;200;738;1286;3878;1486;4616
330412;201711;1364;4457;1140;4008;193;737;566;1878;759;2615
330414;201711;22415;60710;18996;55948;3050;8804;11964;35558;15014;44362
330415;201711;3303;9772;2642;8598;528;1697;1165;3941;1693;5638
330420;201711;9333;25229;6222;19819;1182;4027;1774;5406;2956;9433
330430;201711;6850;19504;6058;18089;1038;3483;3411;9708;4449;13191
330440;201711;1522;4831;1313;4461;359;1369;495;1555;854;2924
330450;201711;1285;4100;1094;3752;200;773;545;1822;745;2595
330452;201711;12861;36579;10369;32091;2286;7612;4882;14728;7168;22340
330455;201711;503318;1310689;396659;1143474;74263;228966;216005;612384;290268;841350
330460;201711;1148;3514;939;3168;205;740;428;1403;633;2143
330470;201711;4015;11365;3373;10344;840;2803;1473;4371;2313;7174
330475;201711;7925;22966;6688;21104;1887;6513;2877;8822;4764;15335
330480;201711;5576;15726;4876;14666;703;2326;3071;9009;3774;11335
330490;201711;107246;269490;92836;248548;10606;30534;63802;167981;74408;198515
330500;201711;4828;14235;4529;13765;531;1733;3331;10085;3862;11818
330510;201711;33540;99340;29258;92522;9173;29041;12349;40049;21522;69090
330513;201711;1175;3472;1054;3259;343;1107;432;1330;775;2437
330515;201711;2779;8224;2351;7430;795;2619;725;2268;1520;4887
330520;201711;10196;30139;8945;27922;1767;5962;4228;12833;5995;18795
330530;201711;1473;4064;1202;3591;270;877;538;1548;808;2425
330540;201711;2706;7824;2213;6917;622;2011;784;2407;1406;4418
330550;201711;7259;23470;6397;21835;2543;9065;1398;4890;3941;13955
330555;201711;9498;26878;8460;25370;1531;4786;5212;15834;6743;20620
330560;201711;4060;11910;3520;10914;494;1655;2055;6199;2549;7854
330570;201711;2949;8623;2475;7805;540;1789;1293;4035;1833;5824
330575;201711;5174;14241;4587;13170;516;1703;3267;9035;3783;10738
330580;201711;11737;35814;9637;31700;2648;9165;3663;11923;6311;21088
330590;201711;1492;4395;1371;4221;161;511;999;3104;1160;3615
330600;201711;10798;31278;8689;27448;1467;4946;4207;13268;5674;18214
330610;201711;8379;25149;7365;23506;1025;3734;4468;13880;5493;17614
330615;201711;1569;5251;1413;5025;510;1924;587;2089;1097;4013
330620;201711;3394;11302;2921;10377;1078;4078;622;2147;1700;6225
330630;201711;22390;62597;18082;55062;2329;8238;11089;32415;13418;40653
350010;201711;1790;5096;1005;3346;259;882;76;210;335;1092
350020;201711;553;1498;321;1029;35;117;155;455;190;572
350030;201711;4133;12480;3112;10416;841;3024;809;2646;1650;5670
350040;201711;485;1584;339;1233;67;273;103;341;170;614
350050;201711;853;2476;647;2077;147;530;188;503;335;1033
350055;201711;649;1825;555;1679;59;203;397;1182;456;1385
350060;201711;101;306;84;279;17;62;37;128;54;190
350070;201711;3793;10726;2377;7832;464;1608;676;2019;1140;3627
350075;201711;581;1881;447;1598;178;652;66;225;244;877
350080;201711;635;1808;393;1281;55;190;167;534;222;724
350090;201711;556;1421;336;985;77;229;101;284;178;513
350100;201711;1956;5662;1322;4455;214;845;539;1686;753;2531
350110;201711;409;1222;306;998;26;103;183;573;209;676
350115;201711;1224;3638;1027;3223;200;678;503;1452;703;2130
350120;201711;802;2196;490;1548;66;207;254;840;320;1047
350130;201711;3020;8672;2555;7777;305;1018;1455;4185;1760;5203
350140;201711;545;1787;443;1577;38;172;255;872;293;1044
350150;201711;467;1493;405;1370;140;493;107;348;247;841
350160;201711;9291;24724;5925;18525;947;3378;2918;8476;3865;11854
350170;201711;1444;4677;1160;4018;275;1013;300;995;575;2008
350180;201711;1066;2815;630;1927;114;385;287;855;401;1240
350190;201711;2927;8811;2223;7322;470;1753;884;2482;1354;4235
350200;201711;358;1059;311;976;24;79;223;680;247;759
350210;201711;4955;12609;3364;9916;730;2222;1539;4478;2269;6700
350220;201711;2205;6729;1802;5850;366;1348;774;2318;1140;3666
350230;201711;790;2409;695;2239;166;560;305;983;471;1543
350240;201711;585;1800;432;1439;73;255;165;534;238;789
350250;201711;2059;6929;1739;6335;627;2460;429;1603;1056;4063
350260;201711;823;2176;549;1653;96;290;262;778;358;1068
350270;201711;4544;13386;3770;11791;677;2327;1772;5193;2449;7520
350275;201711;1947;5973;1654;5450;391;1369;679;2175;1070;3544
350280;201711;19972;47235;12412;34702;2454;7360;3744;10116;6198;17476
350290;201711;2605;7802;1941;6475;385;1441;688;2184;1073;3625
350300;201711;600;1746;422;1350;90;279;125;367;215;646
350310;201711;818;2656;689;2341;93;358;274;875;367;1233
350315;201711;513;1527;368;1226;62;236;123;367;185;603
350320;201711;10773;31617;8977;28373;2527;8514;1902;6128;4429;14642
350330;201711;13848;36339;9487;27125;1476;4295;4686;12680;6162;16975
350335;201711;380;1119;327;1025;18;47;251;801;269;848
350340;201711;982;2770;653;2126;136;483;211;682;347;1165
350350;201711;692;2022;571;1860;124;423;225;706;349;1129
350360;201711;872;2874;736;2559;206;698;290;1015;496;1713
350370;201711;543;1543;374;1166;115;359;52;151;167;510
350380;201711;4347;12453;3061;9943;732;2551;970;3000;1702;5551
350390;201711;9126;26914;7678;24193;2196;7103;2767;8542;4963;15645
350395;201711;392;1050;192;639;24;88;61;178;85;266
350400;201711;7480;20512;5598;17157;1456;4860;1691;4928;3147;9788
350410;201711;8109;25541;6353;21932;1637;6193;1611;5158;3248;11351
350420;201711;558;1702;414;1437;84;341;65;218;149;559
350430;201711;653;1988;552;1813;79;316;323;1004;402;1320
350440;201711;1295;3887;1038;3324;236;772;441;1364;677;2136
350450;201711;6767;20497;5396;17816;1260;4444;1612;5078;2872;9522
350460;201711;1460;3845;826;2587;164;574;246;725;410;1299
350470;201711;220;567;180;495;11;41;127;331;138;372
350480;201711;744;2111;508;1633;90;328;89;247;179;575
350490;201711;1665;4945;1352;4358;310;1071;430;1266;740;2337
350500;201711;572;1668;490;1526;77;271;274;833;351;1104
350510;201711;1041;3024;774;2474;106;388;389;1192;495;1580
350520;201711;1688;5875;1318;5022;279;1161;430;1566;709;2727
350530;201711;2210;6214;1709;5193;485;1555;515;1461;1000;3016
350535;201711;1336;3998;1206;3805;135;514;845;2591;980;3105
350540;201711;1632;4475;1200;3717;266;908;488;1514;754;2422
350550;201711;8964;22944;6075;18169;888;3025;2737;7663;3625;10688
350560;201711;3320;10523;2788;9304;319;1134;1596;5250;1915;6384
350570;201711;17836;55280;15441;50613;4092;14531;6339;19792;10431;34323
350580;201711;1680;5161;1011;3478;206;748;111;312;317;1060
350590;201711;3912;11520;2978;9608;700;2602;1260;3648;1960;6250
350600;201711;38272;94768;24967;70391;3769;11695;11292;29328;15061;41023
350610;201711;6354;18474;4858;15568;1001;3390;2061;6491;3062;9881
350620;201711;372;1015;266;853;33;135;124;377;157;512
350630;201711;1488;4184;1091;3407;143;523;537;1541;680;2064
350635;201711;6493;18275;5104;15884;1081;3722;2350;6995;3431;10717
350640;201711;784;2351;484;1589;76;280;139;403;215;683
350650;201711;7286;21045;4772;15483;1042;3661;1259;3840;2301;7501
350660;201711;4676;13246;3700;11497;730;2423;1737;5350;2467;7773
350670;201711;1405;4317;1269;4064;283;912;641;2059;924;2971
350680;201711;1008;2902;698;2304;149;523;292;977;441;1500
350690;201711;960;2936;725;2455;139;505;295;942;434;1447
350700;201711;3996;11390;2859;9476;625;2335;1212;3744;1837;6079
350710;201711;2573;7761;2220;7088;312;1108;1283;3951;1595;5059
350715;201711;772;2303;681;2114;86;315;379;1090;465;1405
350720;201711;141;392;120;356;23;76;45;131;68;207
350730;201711;397;1378;342;1241;66;263;159;572;225;835
350740;201711;1536;4573;1048;3454;194;680;255;763;449;1443
350745;201711;539;1628;325;1095;47;172;135;409;182;581
350750;201711;8616;25416;6979;22283;1489;5361;2293;6589;3782;11950
350760;201711;12003;33572;9318;28900;2575;8631;2221;6146;4796;14777
350770;201711;643;1789;435;1362;65;218;222;686;287;904
350775;201711;555;1448;430;1237;47;152;210;597;257;749
350780;201711;1804;5237;1384;4469;368;1345;324;1112;692;2457
350790;201711;1735;5143;1204;4058;269;987;203;585;472;1572
350800;201711;2960;9526;2707;9012;496;1813;1380;4432;1876;6245
350810;201711;1902;5198;1624;4814;335;1031;875;2700;1210;3731
350820;201711;710;1819;419;1261;63;198;150;414;213;612
350830;201711;762;2356;479;1683;67;242;129;407;196;649
350840;201711;2426;7979;1901;6895;600;2353;530;1819;1130;4172
350850;201711;5540;17594;4480;15366;1353;4843;1192;4114;2545;8957
350860;201711;3032;9008;2817;8655;106;458;2211;6674;2317;7132
350870;201711;2598;7990;2056;7039;434;1647;1028;3470;1462;5117
350880;201711;1247;3989;1000;3382;225;795;271;872;496;1667
350890;201711;631;1739;392;1225;40;135;122;311;162;446
350900;201711;5504;16448;3843;12925;1243;4567;384;1235;1627;5802
350910;201711;784;2196;681;1990;144;494;392;1091;536;1585
350920;201711;11208;30260;9755;27841;677;2249;7443;20401;8120;22650
350925;201711;4399;13143;3317;11048;815;2812;1078;3208;1893;6020
350930;201711;1338;3701;936;2875;144;460;457;1353;601;1813
350940;201711;1804;5607;1556;5132;236;869;901;2874;1137;3743
350945;201711;886;2682;704;2334;117;428;325;1016;442;1444
350950;201711;72381;207912;58379;178060;10063;33741;30848;88953;40911;122694
350960;201711;4564;14185;3743;12570;757;2894;1881;5995;2638;8889
350970;201711;3577;11894;2929;10351;946;3625;440;1359;1386;4984
350980;201711;571;1818;494;1640;196;676;155;510;351;1186
350990;201711;1728;5430;1344;4724;348;1365;419;1364;767;2729
350995;201711;787;2592;729;2470;74;308;447;1440;521;1748
351000;201711;2507;7132;1946;6070;391;1352;666;1943;1057;3295
351010;201711;285;796;168;538;22;73;77;245;99;318
351015;201711;642;2151;544;1965;110;444;230;808;340;1252
351020;201711;8152;24010;6710;21726;1458;4977;3705;11883;5163;16860
351030;201711;2249;7229;1874;6333;344;1342;877;2763;1221;4105
351040;201711;3975;11101;3447;10237;291;1027;2560;7333;2851;8360
351050;201711;15296;40537;10610;32702;2460;8235;3625;11055;6085;19290
351060;201711;38583;105264;30794;91996;4802;15675;18080;52477;22882;68152
351070;201711;1302;3552;823;2665;244;859;83;232;327;1091
351080;201711;2499;7073;1891;6276;455;1670;850;2633;1305;4303
351090;201711;355;1127;254;928;46;184;50;184;96;368
351100;201711;2490;7209;1638;5225;437;1458;296;983;733;2441
351110;201711;5440;14534;3499;11023;796;2771;1079;3122;1875;5893
351120;201711;661;1852;463;1466;73;240;184;524;257;764
351130;201711;923;2540;440;1527;78;268;79;262;157;530
351140;201711;1614;5244;1253;4468;367;1430;284;888;651;2318
351150;201711;1437;4640;934;3392;205;793;69;208;274;1001
351160;201711;1098;3738;931;3358;228;890;312;992;540;1882
351170;201711;1356;4141;1138;3666;133;469;644;1971;777;2440
351190;201711;792;2446;605;1978;99;320;197;613;296;933
351200;201711;1630;4357;1264;3754;94;317;734;2084;828;2401
351210;201711;1341;3477;832;2470;108;379;393;1043;501;1422
351220;201711;2831;8962;2522;8348;340;1243;1531;4926;1871;6169
351230;201711;1713;5078;1332;4392;293;1085;602;1826;895;2911
351240;201711;1448;4100;1008;3158;217;714;431;1267;648;1981
351250;201711;1011;2887;595;1919;85;293;205;640;290;933
351260;201711;873;2534;720;2221;259;779;149;454;408;1233
351270;201711;301;957;262;873;62;244;119;332;181;576
351280;201711;4746;13225;3597;11017;666;2256;1449;4232;2115;6488
351290;201711;912;2521;624;1961;136;446;256;769;392;1215
351300;201711;12770;38848;9479;32152;2256;8259;3007;10251;5263;18510
351310;201711;2752;7986;2181;6949;328;1225;1162;3443;1490;4668
351320;201711;873;2792;694;2345;131;474;239;754;370;1228
351330;201711;870;3393;814;3299;66;183;662;2842;728;3025
351340;201711;5699;18195;4730;16317;1299;4645;1769;6095;3068;10740
351350;201711;8635;24595;7301;22248;1324;4162;4259;12596;5583;16758
351360;201711;3833;11357;3379;10542;856;2919;1071;3088;1927;6007
351370;201711;2141;6458;1576;5219;360;1260;579;1760;939;3020
351380;201711;37376;102244;31184;90917;5966;18422;15229;43199;21195;61621
351385;201711;255;707;167;521;26;79;50;148;76;227
351390;201711;1167;3385;882;2871;206;814;421;1226;627;2040
351400;201711;924;2833;792;2574;215;737;327;1040;542;1777
351410;201711;2288;6833;1843;5970;289;955;962;3078;1251;4033
351420;201711;274;755;174;545;43;124;53;167;96;291
351430;201711;740;2258;677;2140;79;279;492;1530;571;1809
351440;201711;3050;8764;2160;6849;412;1412;391;1071;803;2483
351450;201711;1442;4007;1088;3353;251;817;292;930;543;1747
351460;201711;656;1887;561;1705;225;667;204;632;429;1299
351470;201711;981;2797;827;2500;97;357;469;1322;566;1679
351480;201711;2559;8095;2216;7501;313;1292;1195;3884;1508;5176
351490;201711;1739;5524;1527;5080;126;525;1021;3236;1147;3761
351492;201711;312;966;263;841;20;75;136;394;156;469
351495;201711;186;593;142;473;23;85;61;192;84;277
351500;201711;30953;82780;23075;68921;5388;17004;10097;29042;15485;46046
351510;201711;9752;27692;7668;23689;1471;4956;4029;12045;5500;17001
351512;201711;467;1331;337;1046;53;167;142;411;195;578
351515;201711;2587;6851;1673;5156;351;1246;394;1186;745;2432
351518;201711;2133;6027;1443;4763;259;995;671;2009;930;3004
351519;201711;620;1814;422;1373;78;301;82;180;160;481
351520;201711;890;2432;374;1266;54;214;124;363;178;577
351530;201711;331;987;194;631;28;88;58;153;86;241
351535;201711;2119;5405;1623;4605;144;508;1042;2795;1186;3303
351540;201711;1777;4948;1253;3953;460;1578;194;506;654;2084
351550;201711;5227;14868;3596;11246;596;2080;1563;4505;2159;6585
351560;201711;418;1325;354;1176;83;314;80;262;163;576
351565;201711;155;528;136;481;31;110;55;186;86;296
351570;201711;14367;41043;11604;35604;1894;6328;6890;20314;8784;26642
351580;201711;276;765;166;540;31;93;49;178;80;271
351590;201711;491;1196;270;755;34;113;140;368;174;481
351600;201711;1655;4477;1266;3753;171;567;700;1945;871;2512
351610;201711;630;1647;443;1318;45;165;234;609;279;774
351620;201711;18399;55285;14062;46920;2716;10261;4733;14083;7449;24344
351630;201711;23334;67761;20033;62163;3736;12184;11879;36044;15615;48228
351640;201711;13747;39250;11209;34871;1679;5821;6895;20776;8574;26597
351650;201711;391;1140;178;610;33;128;24;72;57;200
351660;201711;748;2340;500;1702;104;399;88;262;192;661
351670;201711;4260;12816;3272;10520;610;2109;1553;4678;2163;6787
351680;201711;457;1421;275;906;59;188;58;193;117;381
351685;201711;436;1358;361;1209;88;282;135;453;223;735
351690;201711;975;2771;663;2111;121;414;238;679;359;1093
351700;201711;915;2650;775;2379;168;499;313;958;481;1457
351710;201711;578;1822;447;1542;58;243;189;603;247;846
351720;201711;1316;3794;935;3018;172;586;350;1106;522;1692
351730;201711;972;2676;733;2274;100;369;365;1062;465;1431
351740;201711;3828;10181;2997;8561;552;1669;1255;3314;1807;4983
351750;201711;1202;3704;747;2668;131;509;258;920;389;1429
351760;201711;3129;9503;2366;7837;576;2091;657;1955;1233;4046
351770;201711;1963;6108;1639;5438;498;1710;581;1893;1079;3603
351780;201711;1323;3615;706;2246;124;447;165;490;289;937
351790;201711;1104;3028;924;2736;139;382;582;1751;721;2133
351800;201711;571;1255;291;749;39;113;99;227;138;340
351810;201711;969;2745;802;2438;69;184;567;1696;636;1880
351820;201711;2394;7350;1682;5819;355;1318;239;827;594;2145
351830;201711;4227;12286;3246;10364;450;1683;1728;5285;2178;6968
351840;201711;6453;20939;5440;18911;1217;4669;2176;7145;3393;11814
351850;201711;1948;5180;1307;4049;228;821;455;1275;683;2096
351860;201711;2764;8682;2349;7821;516;1841;1103;3604;1619;5445
351870;201711;24129;67917;19401;59817;6226;19963;6991;21760;13217;41723
351880;201711;110397;325614;89379;285395;26724;91498;24033;72560;50757;164058
351885;201711;663;2179;595;2025;152;529;256;853;408;1382
351890;201711;576;1776;467;1561;102;355;72;197;174;552
351900;201711;1115;3329;888;2939;211;727;290;969;501;1696
351905;201711;417;1221;310;994;37;131;141;411;178;542
351907;201711;19269;54222;15801;47846;910;3400;11516;33931;12426;37331
351910;201711;1074;3122;830;2564;167;561;339;954;506;1515
351920;201711;901;2400;696;2050;86;291;351;995;437;1286
351925;201711;932;2731;744;2352;115;374;353;1049;468;1423
351930;201711;2658;8124;2537;7899;282;1174;2037;6075;2319;7249
351940;201711;972;2759;756;2388;88;319;416;1297;504;1616
351950;201711;1497;3914;1073;3144;85;282;608;1741;693;2023
351960;201711;4638;12796;3394;10511;789;2627;1380;4157;2169;6784
351970;201711;5360;18430;4746;17223;1067;4277;2131;7314;3198;11591
351980;201711;892;2539;664;2044;111;398;309;860;420;1258
351990;201711;1319;3470;972;2886;159;561;295;804;454;1365
352000;201711;2208;6996;1955;6454;246;951;1126;3515;1372;4466
352010;201711;1812;5606;1483;4935;360;1307;218;775;578;2082
352020;201711;1457;4330;1187;3824;248;877;514;1557;762;2434
352030;201711;4886;13917;3957;12528;772;2720;2140;6679;2912;9399
352040;201711;1925;5769;1352;4570;282;1002;202;628;484;1630
352042;201711;3172;8328;1912;5820;382;1225;796;2410;1178;3635
352044;201711;1881;5510;1121;3934;197;754;241;787;438;1541
352050;201711;11494;33415;7695;25124;1849;6830;1342;3888;3191;10718
352060;201711;698;2067;535;1730;86;309;228;687;314;996
352070;201711;755;1717;559;1439;92;257;246;621;338;878
352080;201711;442;1237;267;844;44;157;83;233;127;390
352090;201711;1332;4411;1047;3704;180;703;301;949;481;1652
352100;201711;2979;8873;2403;7786;552;1944;1052;3263;1604;5207
352110;201711;528;1726;431;1514;104;380;155;506;259;886
352115;201711;474;1466;408;1343;81;274;208;690;289;964
352120;201711;815;2582;661;2263;85;349;339;1051;424;1400
352130;201711;1785;5315;1144;3687;247;843;326;1002;573;1845
352140;201711;1530;4231;925;2985;147;508;359;1087;506;1595
352150;201711;745;2108;578;1803;150;467;270;851;420;1318
352160;201711;862;2374;647;2010;135;468;249;734;384;1202
352170;201711;2635;7792;2225;6879;460;1533;1071;3066;1531;4599
352180;201711;2898;8102;2374;7083;566;1803;899;2515;1465;4318
352190;201711;1065;3149;845;2720;140;524;292;814;432;1338
352200;201711;366;1211;271;1011;42;162;80;297;122;459
352210;201711;15826;41745;13067;37618;1799;5545;8738;25098;10537;30643
352215;201711;515;1479;465;1416;58;202;295;869;353;1071
352220;201711;13228;37970;9755;31478;2961;10115;2410;7706;5371;17821
352230;201711;11762;38156;9563;33790;2712;10536;2966;9750;5678;20286
352240;201711;11307;31558;8484;26454;2099;7412;2913;8217;5012;15629
352250;201711;19870;60873;16792;55231;4778;16433;7151;23232;11929;39665
352260;201711;5406;15470;3720;12005;625;2180;1848;5810;2473;7990
352265;201711;853;2595;736;2399;62;263;496;1548;558;1811
352270;201711;1499;4932;1197;4261;282;1052;339;1182;621;2234
352280;201711;2232;6320;1797;5610;220;859;923;2696;1143;3555
352290;201711;1050;3273;885;2889;159;617;405;1186;564;1803
352300;201711;964;2748;697;2185;108;406;320;880;428;1286
352310;201711;43182;121617;33318;104569;8919;28692;13848;43782;22767;72474
352320;201711;5401;15792;4415;13748;897;3083;1852;5125;2749;8208
352330;201711;1867;5738;1556;5281;434;1616;600;1922;1034;3538
352340;201711;4552;13615;3416;11507;904;3271;1011;3195;1915;6466
352350;201711;1611;5123;1383;4608;251;955;539;1649;790;2604
352360;201711;995;2909;884;2732;170;630;581;1711;751;2341
352370;201711;891;2912;801;2692;59;261;544;1764;603;2025
352380;201711;832;2502;670;2208;177;648;179;551;356;1199
352390;201711;17307;44144;11466;33811;1850;6080;5757;15994;7607;22074
352400;201711;3301;9387;2578;8028;646;2300;1208;3404;1854;5704
352410;201711;2742;7857;2261;7072;373;1283;1174;3530;1547;4813
352420;201711;881;2268;642;1852;105;329;242;673;347;1002
352430;201711;6392;17946;5023;15686;1524;5017;1738;5428;3262;10445
352440;201711;15425;45943;12355;39848;2654;9100;5264;16485;7918;25585
352450;201711;585;1755;348;1210;76;292;92;307;168;599
352460;201711;2447;7426;1867;6294;441;1636;578;1846;1019;3482
352470;201711;3723;9960;2702;8159;315;1086;1399;3934;1714;5020
352480;201711;3698;9552;2636;7630;495;1612;1121;2963;1616;4575
352490;201711;652;2148;500;1785;93;360;169;603;262;963
352500;201711;8729;23806;6898;20692;3491;11300;1188;2676;4679;13976
352510;201711;2923;8679;2290;7519;623;2232;715;2275;1338;4507
352520;201711;2076;6633;1737;5925;435;1569;735;2410;1170;3979
352530;201711;8078;24548;5648;18940;1371;4963;809;2165;2180;7128
352540;201711;507;1560;363;1235;73;264;90;289;163;553
352550;201711;871;2709;620;2180;131;509;142;457;273;966
352560;201711;533;1582;369;1201;71;235;80;230;151;465
352570;201711;1806;5628;1210;4340;312;1222;194;592;506;1814
352580;201711;800;2383;617;2000;104;378;210;623;314;1001
352585;201711;238;735;193;634;21;77;91;283;112;360
352590;201711;12350;36039;9363;30040;3135;10726;3312;9731;6447;20457
352600;201711;1809;5344;1393;4423;264;901;606;1823;870;2724
352610;201711;3182;9599;2496;8352;570;2135;805;2509;1375;4644
352620;201711;5114;14836;4349;13598;1185;3783;1816;5680;3001;9463
352630;201711;705;1949;564;1698;101;371;270;751;371;1122
352640;201711;2491;6988;1991;6176;162;545;1350;4164;1512;4709
352650;201711;633;1910;466;1490;81;282;136;415;217;697
352660;201711;929;3203;791;2909;164;645;298;1066;462;1711
352670;201711;9503;27524;5738;19350;1389;5176;419;1380;1808;6556
352680;201711;2944;9365;2186;7634;426;1687;886;2866;1312;4553
352690;201711;29323;78163;21409;63255;2288;7667;12492;35134;14780;42801
352700;201711;547;1504;419;1319;150;518;129;370;279;888
352710;201711;4910;13796;3580;11183;947;3247;1302;3816;2249;7063
352720;201711;7603;23216;6373;20629;2595;8575;1290;3941;3885;12516
352725;201711;400;1095;201;647;19;76;97;284;116;360
352730;201711;2362;7301;2110;6659;425;1499;1073;3059;1498;4558
352740;201711;2108;5413;1615;4646;202;652;922;2556;1124;3208
352750;201711;416;1135;223;736;41;144;50;140;91;284
352760;201711;1318;4178;1045;3518;198;740;439;1374;637;2114
352770;201711;762;2310;602;1954;133;471;189;583;322;1054
352780;201711;597;1966;469;1646;99;362;160;556;259;918
352790;201711;606;1684;424;1335;62;209;137;399;199;608
352800;201711;1112;3812;821;3028;201;776;188;623;389;1399
352810;201711;1012;2562;634;1834;122;354;239;681;361;1035
352820;201711;566;1471;381;1173;81;261;93;282;174;543
352830;201711;534;1485;271;872;42;142;41;113;83;255
352840;201711;3714;11924;3261;11017;987;3505;1266;4100;2253;7605
352850;201711;10045;27241;7115;22505;1891;6412;2169;6736;4060;13148
352860;201711;799;2615;704;2395;157;568;277;918;434;1486
352870;201711;803;2063;524;1449;44;146;288;727;332;873
352880;201711;1905;4948;1337;3862;214;650;590;1522;804;2172
352885;201711;262;809;213;713;30;96;127;422;157;518
352890;201711;618;1563;401;1090;66;207;161;359;227;566
352900;201711;17536;49280;12577;39418;2440;8443;5013;14708;7453;23151
352910;201711;397;1111;212;695;19;74;42;113;61;187
352920;201711;2397;6767;1755;5512;256;890;887;2603;1143;3493
352930;201711;5318;15883;4169;13513;804;2771;1631;5049;2435;7820
352940;201711;21346;64939;17232;56293;5563;19913;2621;7724;8184;27637
352950;201711;420;1159;224;758;46;170;22;64;68;234
352960;201711;625;1825;364;1212;61;232;124;379;185;611
352965;201711;310;902;185;616;50;172;31;90;81;262
352970;201711;2993;7408;2385;6481;243;673;1615;4407;1858;5080
352980;201711;1213;3679;1002;3314;204;705;498;1643;702;2348
352990;201711;3882;11819;3339;10892;761;2820;1582;4861;2343;7681
353000;201711;445;1233;219;708;38;131;58;174;96;305
353010;201711;2598;7002;1814;5447;415;1366;563;1564;978;2930
353020;201711;3762;10088;2155;6609;326;1072;739;2058;1065;3130
353030;201711;3567;10058;2634;8246;715;2372;510;1581;1225;3953
353040;201711;470;1283;369;1079;81;254;130;342;211;596
353050;201711;4776;15109;3742;12957;938;3486;1399;4628;2337;8114
353060;201711;42341;118567;35993;108151;3474;12436;25218;72835;28692;85271
353070;201711;9282;27875;6677;22368;1526;5452;1969;6484;3495;11936
353080;201711;4452;13368;3131;10661;766;2846;896;2794;1662;5640
353090;201711;520;1730;460;1597;41;164;280;915;321;1079
353100;201711;279;769;112;377;11;36;20;62;31;98
353110;201711;6966;21010;6030;19479;976;3490;3780;12213;4756;15703
353120;201711;520;1489;352;1115;65;232;113;307;178;539
353130;201711;2287;6270;1624;5220;491;1685;490;1558;981;3243
353140;201711;2046;5541;1618;4734;221;715;884;2449;1105;3164
353150;201711;1433;4095;1092;3490;293;945;341;1060;634;2005
353160;201711;625;1690;414;1302;73;249;151;428;224;677
353170;201711;475;1451;406;1356;81;348;193;591;274;939
353180;201711;8841;23710;7082;20855;1037;3329;4505;13067;5542;16396
353190;201711;3376;9768;2707;8345;370;1238;1501;4316;1871;5554
353200;201711;1044;3370;728;2506;167;620;188;607;355;1227
353205;201711;321;1082;287;990;79;311;138;456;217;767
353210;201711;950;2379;614;1762;36;130;374;1033;410;1163
353215;201711;422;1258;347;1097;53;192;136;359;189;551
353220;201711;544;1616;413;1354;110;366;93;296;203;662
353230;201711;761;2321;662;2163;160;571;240;700;400;1271
353240;201711;2050;6192;1735;5582;234;881;1062;3292;1296;4173
353250;201711;1021;2632;730;2080;122;361;321;891;443;1252
353260;201711;852;2325;546;1725;119;405;151;443;270;848
353270;201711;595;1723;497;1518;70;212;234;684;304;896
353280;201711;633;1895;454;1482;80;273;130;411;210;684
353282;201711;1744;5327;1572;4978;216;743;912;2793;1128;3536
353284;201711;383;993;206;627;37;130;64;169;101;299
353286;201711;126;376;91;305;24;80;22;59;46;139
353290;201711;1062;3065;792;2531;80;325;463;1354;543;1679
353300;201711;1469;4350;1143;3644;198;721;450;1285;648;2006
353310;201711;274;753;199;611;33;117;96;275;129;392
353320;201711;563;1580;466;1389;37;113;309;906;346;1019
353325;201711;595;1862;419;1455;71;254;126;437;197;691
353330;201711;517;1419;351;1064;41;140;190;540;231;680
353340;201711;2824;7946;1901;6216;540;1878;556;1833;1096;3711
353350;201711;3097;9089;2165;6996;551;1895;399;1163;950;3058
353360;201711;447;1447;389;1325;50;195;239;800;289;995
353370;201711;557;1831;484;1675;49;188;288;961;337;1149
353380;201711;282;917;230;796;41;153;82;273;123;426
353390;201711;5444;14590;3978;11917;778;2446;1536;4380;2314;6826
353400;201711;422;1276;336;1092;68;244;70;179;138;423
353410;201711;565;1617;461;1417;87;299;229;679;316;978
353420;201711;506;1387;296;900;69;211;35;92;104;303
353430;201711;2021;6385;1517;5244;418;1575;360;1171;778;2746
353440;201711;54325;163076;40590;134108;9797;33673;16488;52827;26285;86500
353450;201711;381;1051;260;799;41;148;103;289;144;437
353460;201711;3254;9226;2411;7496;271;957;1085;3384;1356;4341
353470;201711;6586;19087;4882;15724;1061;3710;1488;4489;2549;8199
353475;201711;1352;3758;1000;2997;146;480;388;1043;534;1523
353480;201711;1349;4005;1197;3718;93;303;859;2620;952;2923
353490;201711;915;2625;665;2081;140;438;263;795;403;1233
353500;201711;915;2362;745;2089;192;535;391;1112;583;1647
353510;201711;826;2599;605;2025;162;558;91;263;253;821
353520;201711;1105;3027;774;2425;97;339;360;1066;457;1405
353530;201711;2258;6377;1844;5569;248;850;975;2759;1223;3609
353540;201711;1893;5671;1596;5138;335;1140;784;2465;1119;3605
353550;201711;5613;15859;4527;13911;803;2691;2292;6674;3095;9365
353560;201711;1972;6279;1596;5600;543;2052;366;1231;909;3283
353570;201711;484;1420;347;1140;78;248;156;507;234;755
353580;201711;2136;6000;1752;5301;394;1248;877;2576;1271;3824
353590;201711;653;1898;420;1357;87;293;149;492;236;785
353600;201711;1630;4449;1379;3957;166;524;740;2026;906;2550
353610;201711;580;1953;441;1637;97;388;95;318;192;706
353620;201711;2302;7007;1777;5956;436;1555;445;1410;881;2965
353625;201711;459;1221;269;829;33;121;141;407;174;528
353630;201711;1218;4153;938;3431;188;722;179;605;367;1327
353640;201711;1336;3702;1021;3089;118;426;580;1707;698;2133
353650;201711;8504;24335;6377;19844;1025;3412;3081;9068;4106;12480
353657;201711;296;877;242;778;38;120;93;269;131;389
353660;201711;1016;2372;698;1852;136;418;335;783;471;1201
353670;201711;3256;10107;2718;9029;746;2712;1123;3522;1869;6234
353680;201711;685;2040;535;1790;134;490;216;687;350;1177
353690;201711;499;1292;225;708;29;87;30;83;59;170
353700;201711;1887;5575;1615;5037;235;797;932;2764;1167;3561
353710;201711;3335;7756;1666;4917;321;925;660;1825;981;2750
353715;201711;531;1507;367;1173;24;96;99;281;123;377
353720;201711;1800;5371;1480;4879;275;1018;790;2489;1065;3507
353730;201711;4060;11929;3096;9843;555;1935;1275;3711;1830;5646
353740;201711;1696;4858;1225;3941;317;1101;318;964;635;2065
353750;201711;853;2778;596;2206;154;611;109;388;263;999
353760;201711;10792;27855;8741;24990;1278;4085;5573;15618;6851;19703
353770;201711;655;2017;330;1164;67;257;36;77;103;334
353780;201711;4169;13428;3428;11893;979;3705;846;2785;1825;6490
353790;201711;2165;7193;1718;6246;493;2053;419;1365;912;3418
353800;201711;15653;46366;12412;40503;2743;9680;5257;16893;8000;26573
353810;201711;990;2976;707;2373;135;525;245;781;380;1306
353820;201711;1475;4620;1186;3942;213;824;517;1640;730;2464
353830;201711;593;1591;460;1358;60;187;245;680;305;867
353850;201711;1616;4840;1308;4204;353;1133;422;1389;775;2522
353860;201711;2472;7663;1996;6619;540;1877;664;2138;1204;4015
353870;201711;26395;74564;18318;58207;3126;11016;7364;21377;10490;32393
353880;201711;2679;8105;2195;7187;255;947;1228;3941;1483;4888
353890;201711;2232;5390;1602;4396;201;628;950;2449;1151;3077
353900;201711;721;2184;537;1821;116;418;178;576;294;994
353910;201711;1894;6397;1721;6103;237;848;1187;4331;1424;5179
353920;201711;2253;6490;1521;4977;340;1244;287;809;627;2053
353930;201711;4175;12145;2911;9780;771;2846;529;1645;1300;4491
353940;201711;1068;3404;782;2739;156;578;212;703;368;1281
353950;201711;2900;8832;2410;7798;470;1694;1184;3518;1654;5212
353960;201711;576;1745;401;1357;94;299;111;371;205;670
353970;201711;572;1575;459;1374;47;151;284;823;331;974
353980;201711;12649;35860;10380;31766;1800;5809;5745;17150;7545;22959
353990;201711;633;1729;436;1335;45;146;261;766;306;912
354000;201711;2166;5771;1304;4070;261;887;201;610;462;1497
354010;201711;333;974;267;838;39;125;161;488;200;613
354020;201711;3670;11165;3041;9795;809;2840;961;2798;1770;5638
354025;201711;770;2166;539;1732;117;388;158;530;275;918
354030;201711;460;1138;264;754;46;140;106;281;152;421
354040;201711;722;1880;470;1391;42;142;274;751;316;893
354050;201711;937;2879;679;2335;170;651;150;487;320;1138
354060;201711;4277;12944;2940;9973;789;2765;716;2277;1505;5042
354070;201711;2802;8808;2172;7452;541;2023;460;1406;1001;3429
354075;201711;1939;6608;1617;5928;297;1248;810;2891;1107;4139
354080;201711;1423;4160;940;3125;179;659;273;799;452;1458
354085;201711;377;837;324;772;5;25;229;512;234;537
354090;201711;1422;4091;1281;3812;137;468;890;2611;1027;3079
354100;201711;13978;44110;11081;38781;2729;10287;4446;15266;7175;25553
354105;201711;925;2575;790;2376;140;415;486;1482;626;1897
354110;201711;499;1385;385;1213;107;378;112;319;219;697
354120;201711;1614;4524;1122;3440;191;620;401;1118;592;1738
354130;201711;5519;15473;3859;12228;1302;4433;195;432;1497;4865
354140;201711;21255;53317;13691;39744;3012;9332;4344;11659;7356;20991
354150;201711;3360;8766;2518;7241;511;1569;1060;2932;1571;4501
354160;201711;3202;10093;2458;8415;719;2557;703;2356;1422;4913
354165;201711;517;1636;426;1460;89;361;213;692;302;1053
354170;201711;1350;4164;1079;3521;119;431;564;1724;683;2155
354180;201711;440;1339;343;1126;61;227;128;367;189;594
354190;201711;1383;4257;1099;3652;188;689;376;1245;564;1934
354200;201711;892;2474;714;2144;88;283;342;950;430;1233
354210;201711;631;1918;504;1681;63;248;282;871;345;1119
354220;201711;2902;8279;2307;7144;417;1370;1149;3443;1566;4813
354230;201711;689;1993;555;1783;77;306;293;858;370;1164
354240;201711;1261;3943;884;3084;169;642;209;649;378;1291
354250;201711;510;1382;330;1073;96;329;86;280;182;609
354260;201711;7471;21593;5947;18908;1532;5135;1895;6130;3427;11265
354270;201711;1078;3463;862;3017;168;628;315;1094;483;1722
354280;201711;691;1938;596;1781;97;367;347;948;444;1315
354290;201711;836;2891;736;2646;157;593;309;1094;466;1687
354300;201711;3674;11463;3311;10783;1032;3497;1167;3651;2199;7148
354310;201711;752;2311;609;2005;124;429;290;921;414;1350
354320;201711;814;2263;538;1715;114;416;187;546;301;962
354323;201711;481;1261;339;984;42;116;131;358;173;474
354325;201711;1187;3794;872;3061;155;576;317;1053;472;1629
354330;201711;6118;17281;4781;14750;871;3132;2482;7035;3353;10167
354340;201711;23351;66276;17311;55836;4557;15948;6213;19295;10770;35243
354350;201711;1076;3042;906;2703;154;524;532;1460;686;1984
354360;201711;486;1455;285;1014;51;174;36;126;87;300
354370;201711;1020;3362;868;3048;117;480;468;1599;585;2079
354380;201711;735;2142;530;1744;130;498;96;262;226;760
354390;201711;12800;34772;8398;26505;1647;5553;2095;6299;3742;11852
354400;201711;1535;5215;1214;4421;227;890;390;1405;617;2295
354410;201711;4882;14644;3994;12917;983;3442;1597;4965;2580;8407
354420;201711;1348;3830;958;2976;153;509;484;1422;637;1931
354425;201711;2022;5668;1649;4936;433;1345;542;1675;975;3020
354430;201711;1361;4181;1141;3787;200;754;552;1743;752;2497
354440;201711;521;1502;350;1131;38;136;147;440;185;576
354450;201711;365;1027;213;694;31;115;46;133;77;248
354460;201711;937;2568;649;1997;111;362;276;834;387;1196
354470;201711;534;1341;382;1037;32;97;193;466;225;563
354480;201711;810;2111;622;1794;68;213;370;1018;438;1231
354490;201711;743;2389;587;2028;101;379;249;831;350;1210
354500;201711;1996;6125;1709;5684;567;2076;413;1353;980;3429
354510;201711;785;2172;682;1960;105;302;370;1012;475;1314
354515;201711;258;823;203;708;40;167;81;278;121;445
354520;201711;6735;20711;4081;13609;690;2590;1931;5971;2621;8561
354530;201711;3426;10943;2798;9615;702;2560;1081;3670;1783;6230
354540;201711;1193;3481;901;2937;248;853;243;807;491;1660
354550;201711;511;1411;393;1188;68;217;213;616;281;833
354560;201711;1790;4781;1008;3080;139;439;473;1382;612;1821
354570;201711;1092;3011;472;1482;93;323;69;197;162;520
354580;201711;9922;27238;6568;20810;1191;4097;2699;8074;3890;12171
354600;201711;1586;4806;1272;4214;220;800;671;2141;891;2941
354610;201711;360;991;196;618;38;134;58;163;96;297
354620;201711;426;1281;303;1050;57;254;118;342;175;596
354625;201711;305;923;187;654;26;96;44;131;70;227
354630;201711;1965;6261;1646;5591;670;2427;167;549;837;2976
354640;201711;2947;9434;2204;7722;460;1782;463;1477;923;3259
354650;201711;843;2413;706;2146;90;285;445;1375;535;1660
354660;201711;2365;6392;1691;5237;120;451;1158;3532;1278;3983
354670;201711;982;2939;708;2287;164;580;193;555;357;1135
354680;201711;4242;12865;3702;11914;982;3308;1797;5763;2779;9071
354690;201711;700;2223;472;1683;105;403;106;360;211;763
354700;201711;1033;2861;713;2179;137;462;298;798;435;1260
354710;201711;507;1488;369;1182;42;149;167;486;209;635
354720;201711;259;688;136;421;41;130;21;60;62;190
354730;201711;9074;26967;6717;22437;1162;4286;3384;10786;4546;15072
354740;201711;317;900;123;448;17;80;21;72;38;152
354750;201711;2424;6910;1669;5473;335;1257;648;1965;983;3222
354760;201711;1762;5328;1318;4424;423;1503;208;715;631;2218
354765;201711;303;838;141;469;16;58;33;104;49;162
354770;201711;2143;5744;1540;4658;419;1374;507;1472;926;2846
354780;201711;52425;141343;42585;121544;6553;20805;23158;61968;29711;82773
354790;201711;847;2623;706;2348;100;349;371;1192;471;1541
354800;201711;2365;6642;1937;5985;398;1349;937;2779;1335;4128
354805;201711;948;2734;701;2203;83;289;258;720;341;1009
354810;201711;567;1749;338;1230;62;243;79;266;141;509
354820;201711;891;2872;699;2479;133;533;161;497;294;1030
354830;201711;444;1150;307;896;106;306;104;297;210;603
354840;201711;733;2092;482;1509;81;244;228;694;309;938
354850;201711;18272;52815;13107;42658;2268;8469;6591;19917;8859;28386
354860;201711;1298;3929;1000;3377;218;817;323;979;541;1796
354870;201711;42469;117263;35550;104205;6451;20561;18509;52077;24960;72638
354880;201711;4740;12512;2412;7402;353;1250;816;2072;1169;3322
354890;201711;14468;40373;11982;35984;2154;7059;6038;17480;8192;24539
354900;201711;447;1276;285;931;33;108;76;241;109;349
354910;201711;5647;16127;3208;11110;649;2446;223;724;872;3170
354920;201711;329;933;184;614;27;116;28;72;55;188
354925;201711;258;781;132;471;30;108;26;82;56;190
354930;201711;332;853;193;608;28;94;88;264;116;358
354940;201711;1606;5567;1288;4762;449;1766;127;428;576;2194
354950;201711;1412;4214;1150;3781;113;478;707;2208;820;2686
354960;201711;766;2214;617;1980;125;433;272;856;397;1289
354970;201711;3655;11450;3065;10286;503;1882;1716;5561;2219;7443
354980;201711;25437;66352;17613;51964;2594;8877;8456;23003;11050;31880
354990;201711;55385;152262;41771;126710;5837;19375;22108;64369;27945;83744
354995;201711;1944;5499;1562;4890;333;1126;821;2478;1154;3604
355000;201711;1339;4063;1134;3685;267;985;240;664;507;1649
355010;201711;3054;9294;2178;7184;750;2629;234;778;984;3407
355020;201711;3018;9397;2273;7894;774;2960;621;2056;1395;5016
355030;201711;1167342;3029930;924478;2564590;183022;553127;424275;1105142;607297;1658269
355040;201711;2593;7611;2246;7035;384;1236;1403;4384;1787;5620
355050;201711;989;2811;754;2373;222;696;168;494;390;1190
355060;201711;4488;13746;3517;11742;689;2616;1463;4424;2152;7040
355070;201711;7039;20278;5790;18126;911;3291;3196;9362;4107;12653
355080;201711;838;2736;561;2098;103;441;45;135;148;576
355090;201711;1096;3486;877;3034;190;671;284;1001;474;1672
355100;201711;17340;50932;14259;45874;3099;10732;7808;24554;10907;35286
355110;201711;1049;3181;815;2769;316;1148;149;501;465;1649
355120;201711;592;1765;446;1487;78;301;169;532;247;833
355130;201711;595;1463;265;755;37;109;95;244;132;353
355140;201711;1185;3562;1090;3395;178;626;724;2233;902;2859
355150;201711;3597;10314;2902;9067;541;1793;1365;4237;1906;6030
355160;201711;1667;5039;1295;4362;363;1363;316;1023;679;2386
355170;201711;8387;22991;6469;19906;1961;6354;2357;7330;4318;13684
355180;201711;2671;7982;2020;6770;457;1826;654;1961;1111;3787
355190;201711;1500;4448;1252;3993;361;1266;495;1649;856;2915
355200;201711;775;2592;672;2394;296;1140;150;484;446;1624
355210;201711;2790;8222;2429;7486;274;996;1588;4650;1862;5646
355220;201711;38203;110493;30814;95799;9145;30108;9532;27152;18677;57260
355230;201711;1242;3240;709;2136;144;421;165;474;309;895
355240;201711;22243;61771;15176;47522;3133;10271;5663;17485;8796;27756
355250;201711;30795;89754;24029;77302;6516;22293;8058;25437;14574;47730
355255;201711;796;2122;443;1388;86;269;143;451;229;720
355260;201711;1151;3250;881;2783;143;550;504;1476;647;2026
355270;201711;1471;4570;1157;3834;275;968;405;1258;680;2226
355280;201711;25806;72173;19679;60250;3633;11992;8362;24454;11995;36446
355290;201711;781;2424;595;1971;148;467;172;534;320;1001
355300;201711;1255;3889;1024;3397;220;774;310;1019;530;1793
355310;201711;1004;2916;769;2507;96;351;400;1307;496;1658
355320;201711;516;1498;423;1316;82;305;167;439;249;744
355330;201711;1918;5572;1422;4631;224;792;768;2389;992;3181
355340;201711;2877;6946;2494;6385;298;793;1716;4327;2014;5120
355350;201711;1279;4119;966;3426;216;835;288;1001;504;1836
355360;201711;1167;3424;1029;3115;109;332;735;2279;844;2611
355365;201711;354;1003;191;669;43;133;29;105;72;238
355370;201711;6081;15741;4753;13932;1108;3383;2112;6616;3220;9999
355380;201711;2959;8523;2270;7090;469;1568;622;1694;1091;3262
355385;201711;1092;3368;964;3121;215;770;414;1246;629;2016
355390;201711;738;2136;567;1777;111;365;210;601;321;966
355395;201711;1893;5661;1382;4492;216;732;554;1679;770;2411
355400;201711;8523;27270;7182;24438;2186;8055;1894;6000;4080;14055
355410;201711;19786;58811;14457;48427;3833;14008;2891;9740;6724;23748
355420;201711;682;2403;597;2213;153;656;138;522;291;1178
355430;201711;3558;9519;2833;8244;641;1906;1308;3794;1949;5700
355440;201711;818;2386;571;1844;119;400;163;489;282;889
355450;201711;3552;9949;2191;7048;440;1475;692;2061;1132;3536
355460;201711;544;1432;342;1065;55;207;139;369;194;576
355465;201711;362;1107;264;876;57;202;60;179;117;381
355470;201711;1089;3003;607;1964;175;572;171;536;346;1108
355475;201711;219;613;205;578;21;74;155;422;176;496
355480;201711;3272;10391;2833;9597;535;2065;1572;5119;2107;7184
355490;201711;921;2645;526;1755;79;284;165;524;244;808
355495;201711;754;2356;597;2047;111;417;166;539;277;956
355500;201711;6350;18222;4026;13035;677;2360;941;2877;1618;5237
355510;201711;1679;4287;846;2669;124;425;243;678;367;1103
355520;201711;405;938;200;552;21;64;102;261;123;325
355530;201711;453;1038;163;470;18;60;49;108;67;168
355535;201711;550;1607;429;1389;123;456;140;396;263;852
355540;201711;8042;23689;7079;22179;1433;4806;4063;12411;5496;17217
355550;201711;668;2048;530;1757;77;253;219;729;296;982
355560;201711;1062;3110;584;1996;113;406;30;98;143;504
355570;201711;232;703;120;425;22;87;20;75;42;162
355580;201711;1184;3130;792;2415;115;430;365;1065;480;1495
355590;201711;189;503;144;428;22;75;80;232;102;307
355600;201711;1401;3808;988;3001;241;809;343;968;584;1777
355610;201711;1609;4374;1157;3496;181;578;529;1539;710;2117
355620;201711;4349;12929;3375;10784;481;1801;1671;4886;2152;6687
355630;201711;2208;6512;1561;5233;352;1228;540;1822;892;3050
355635;201711;894;2781;752;2534;89;324;493;1715;582;2039
355640;201711;2675;8260;1873;6617;453;1697;350;1228;803;2925
355645;201711;3887;12092;3240;11026;410;1665;1989;6649;2399;8314
355650;201711;6567;18953;5577;17087;1283;4307;3018;8642;4301;12949
355660;201711;1230;3624;919;2985;132;542;389;1214;521;1756
355670;201711;3137;9396;2162;7048;378;1412;921;2643;1299;4055
355680;201711;2193;6585;1097;3829;310;1168;87;265;397;1433
355690;201711;558;1776;371;1361;106;422;13;29;119;451
355695;201711;234;770;134;487;13;52;14;42;27;94
355700;201711;5592;17570;4715;15567;1232;4121;1860;5978;3092;10099
355710;201711;8428;20837;5191;14884;1032;3132;1649;4373;2681;7505
355715;201711;375;1123;232;776;53;197;50;154;103;351
355720;201711;1421;4536;1170;3988;247;896;460;1419;707;2315
355730;201711;806;2536;672;2241;185;611;214;667;399;1278
410010;201711;1244;3707;984;3101;226;781;190;592;416;1373
410020;201711;1075;3461;915;3095;289;962;284;955;573;1917
410030;201711;1237;3939;1031;3494;244;883;357;1208;601;2091
410040;201711;9504;29780;8012;26960;1787;6553;2632;8627;4419;15180
410045;201711;1017;2769;693;2156;109;390;209;591;318;981
410050;201711;2593;6787;1613;4961;404;1332;236;635;640;1967
410060;201711;2098;6336;1730;5561;400;1330;646;2061;1046;3391
410070;201711;1613;4434;1210;3634;265;868;400;1152;665;2020
410080;201711;1343;3720;1021;3130;181;600;419;1257;600;1857
410090;201711;962;2847;894;2713;128;395;470;1499;598;1894
410100;201711;2253;6884;1630;5330;264;1003;273;854;537;1857
410105;201711;346;1039;217;718;43;177;42;119;85;296
410110;201711;3025;8351;2193;6643;332;1096;766;2249;1098;3345
410115;201711;512;1352;373;1097;74;240;131;360;205;600
410120;201711;2368;7847;2135;7402;862;3109;478;1650;1340;4759
410130;201711;1042;3100;954;2934;343;1190;289;752;632;1942
410140;201711;15223;38986;9690;28932;2033;6597;2040;5703;4073;12300
410150;201711;15720;39255;7682;22632;1508;4754;1233;3477;2741;8231
410160;201711;2796;8358;2448;7675;531;1836;924;2949;1455;4785
410165;201711;659;1934;543;1652;76;254;296;842;372;1096
410170;201711;2130;5967;1579;4737;451;1479;179;512;630;1991
410180;201711;11481;34917;9498;30451;1796;6179;4370;13072;6166;19251
410185;201711;502;1404;366;1142;69;224;104;297;173;521
410190;201711;1923;5421;1511;4586;325;1044;310;899;635;1943
410200;201711;3900;10243;2529;7643;533;1853;472;1390;1005;3243
410210;201711;2508;7190;1739;5502;289;1033;447;1199;736;2232
410220;201711;596;1582;417;1238;50;168;113;341;163;509
410230;201711;1388;4182;1183;3760;238;865;525;1573;763;2438
410240;201711;4106;11998;3486;10766;1061;3649;445;1353;1506;5002
410250;201711;2611;6900;1815;5384;422;1379;465;1326;887;2705
410260;201711;1612;4347;1149;3526;230;795;512;1529;742;2324
410270;201711;505;1364;386;1136;33;115;196;566;229;681
410275;201711;730;2213;481;1617;66;244;202;668;268;912
410280;201711;2037;5812;1396;4465;309;1102;401;1166;710;2268
410290;201711;3217;9532;2480;7995;578;1851;907;2951;1485;4802
410300;201711;667;1790;527;1522;89;280;229;607;318;887
410302;201711;415;1091;214;691;21;69;108;352;129;421
410304;201711;1110;3358;979;3082;207;707;475;1480;682;2187
410305;201711;1653;4347;1236;3651;315;960;531;1560;846;2520
410310;201711;2259;6969;1919;6353;416;1519;611;2021;1027;3540
410315;201711;786;2092;427;1427;100;348;104;336;204;684
410320;201711;1132;3330;734;2419;98;371;112;340;210;711
410322;201711;519;1494;278;909;31;105;86;272;117;377
410330;201711;1365;3657;1038;3013;231;732;258;730;489;1462
410335;201711;849;2445;700;2139;118;427;310;865;428;1292
410337;201711;739;1919;523;1508;68;211;209;562;277;773
410340;201711;499;1399;337;995;46;163;143;352;189;515
410345;201711;1948;5320;1154;3625;258;839;272;801;530;1640
410347;201711;697;1804;506;1462;50;170;156;428;206;598
410350;201711;1148;3344;857;2751;135;473;247;718;382;1191
410360;201711;3892;10048;3039;8586;285;952;1822;4999;2107;5951
410370;201711;10825;30512;7603;23152;1218;4153;2603;7010;3821;11163
410380;201711;1303;3659;1082;3212;132;485;410;1133;542;1618
410390;201711;2452;7024;1696;5438;491;1701;323;922;814;2623
410395;201711;884;2749;721;2385;161;587;324;1080;485;1667
410400;201711;4474;13387;3572;11487;696;2402;1314;4065;2010;6467
410405;201711;779;2095;631;1850;149;459;274;793;423;1252
410410;201711;1092;3313;1064;3277;220;842;615;1841;835;2683
410420;201711;6633;20820;5247;17701;1167;4335;1062;3243;2229;7578
410425;201711;2656;8140;1966;6691;383;1389;505;1606;888;2995
410430;201711;12444;32872;8889;26300;1600;5143;2696;7561;4296;12704
410440;201711;2864;9657;2538;9008;446;1659;1329;4934;1775;6593
410442;201711;2357;7681;2071;7061;630;2284;617;2064;1247;4348
410445;201711;2239;6945;1831;6127;423;1537;547;1891;970;3428
410450;201711;1724;4835;1305;3975;259;867;254;653;513;1520
410460;201711;1624;4541;1260;3906;270;910;382;1105;652;2015
410465;201711;2258;7123;1837;6203;440;1479;567;1867;1007;3346
410470;201711;1712;5327;1296;4365;320;1173;243;838;563;2011
410480;201711;29623;80256;17156;54957;2700;9578;1550;4282;4250;13860
410490;201711;10684;31724;7814;25507;1661;5816;2317;7075;3978;12891
410500;201711;1526;4623;1166;3825;341;1242;186;515;527;1757
410510;201711;2203;5768;1454;4240;273;802;482;1369;755;2171
410520;201711;2950;9886;2716;9417;737;2626;1221;4297;1958;6923
410530;201711;1443;3950;796;2416;139;437;82;199;221;636
410540;201711;2643;7631;1890;6071;320;1094;807;2573;1127;3667
410550;201711;6058;17089;4073;12747;826;2814;695;1950;1521;4764
410560;201711;1283;3644;1007;3105;232;790;385;1073;617;1863
410570;201711;2520;7734;2074;6894;564;2098;339;1200;903;3298
410580;201711;21530;61298;16963;52474;3637;12540;6401;18358;10038;30898
410590;201711;1358;4127;902;2928;161;555;197;564;358;1119
410600;201711;1694;4873;1344;4176;318;975;444;1417;762;2392
410610;201711;731;2071;544;1702;64;220;187;557;251;777
410620;201711;1832;5865;1238;4395;298;1132;121;359;419;1491
410630;201711;2206;6471;1440;4718;293;1061;129;332;422;1393
410640;201711;3903;10211;2747;8149;741;2470;409;1148;1150;3618
410645;201711;1074;3557;978;3391;416;1470;251;934;667;2404
410650;201711;1898;5682;1455;4734;404;1406;347;1024;751;2430
410655;201711;1337;4452;1098;3977;53;193;740;2870;793;3063
410657;201711;683;1830;437;1316;86;278;164;445;250;723
410660;201711;2968;8155;1608;5081;331;1076;224;692;555;1768
410670;201711;886;2333;595;1741;104;307;270;768;374;1075
410680;201711;2848;8975;2103;7112;549;1819;477;1716;1026;3535
410685;201711;579;1639;484;1460;80;273;256;736;336;1009
410690;201711;112795;308645;76829;235985;14212;48551;21923;59120;36135;107671
410700;201711;2106;5931;1826;5428;390;1228;835;2348;1225;3576
410710;201711;860;2473;582;1900;94;319;232;719;326;1038
410712;201711;691;2056;604;1895;193;657;222;654;415;1311
410715;201711;824;2643;560;1987;112;410;143;494;255;904
410720;201711;2772;8005;2168;6717;355;1280;411;1145;766;2425
410725;201711;1040;2826;676;2116;115;391;105;291;220;682
410730;201711;520;1452;381;1184;100;347;60;181;160;528
410740;201711;911;2651;639;2106;117;422;250;824;367;1246
410750;201711;1697;4760;1386;4133;280;916;509;1439;789;2355
410752;201711;312;813;144;443;23;79;47;123;70;202
410753;201711;249;752;168;565;20;69;29;85;49;154
410754;201711;1067;3006;911;2753;49;127;607;2000;656;2127
410755;201711;708;1770;504;1410;47;147;279;736;326;883
410760;201711;2545;7383;2150;6696;598;2008;604;1882;1202;3890
410765;201711;12496;37422;9700;31890;1653;6065;1087;3441;2740;9506
410770;201711;898;2387;625;1879;108;352;218;637;326;989
410773;201711;1274;3587;1149;3401;169;580;835;2421;1004;3001
410775;201711;1374;3802;1221;3556;226;717;473;1345;699;2062
410780;201711;580;1522;349;1045;74;225;82;264;156;489
410785;201711;746;2224;612;1953;156;539;186;562;342;1101
410790;201711;522;1634;432;1420;125;439;37;94;162;533
410800;201711;2799;6674;2213;5774;204;583;1006;2593;1210;3176
410810;201711;318;925;250;788;37;139;105;318;142;457
410820;201711;757;2268;496;1578;114;379;70;209;184;588
410830;201711;27611;75359;21208;64078;5685;19056;6740;19398;12425;38454
410832;201711;988;2710;836;2420;109;398;467;1260;576;1658
410840;201711;6831;18981;4308;13835;1028;3636;466;1163;1494;4799
410845;201711;1108;3209;915;2842;196;670;307;910;503;1580
410850;201711;2431;7264;2130;6727;455;1570;833;2652;1288;4222
410855;201711;576;1573;423;1262;45;155;186;515;231;670
410860;201711;3844;10541;3011;8934;544;1728;985;2813;1529;4541
410865;201711;1360;4402;1249;4188;287;1020;684;2374;971;3394
410870;201711;1167;3395;1053;3220;86;274;721;2235;807;2509
410880;201711;3770;11358;2953;9746;564;2052;418;1435;982;3487
410890;201711;886;2775;677;2324;149;553;158;522;307;1075
410895;201711;922;3099;803;2827;314;1204;132;430;446;1634
410900;201711;854;2341;575;1772;94;313;153;395;247;708
410910;201711;363;902;225;626;12;34;117;308;129;342
410920;201711;731;1989;579;1734;138;472;214;621;352;1093
410930;201711;1462;4290;1188;3720;339;1213;268;803;607;2016
410940;201711;20259;61812;16247;54043;4774;17157;3044;10403;7818;27560
410950;201711;1832;5712;1679;5464;84;337;1367;4388;1451;4725
410960;201711;7428;19975;4648;14779;1258;4421;1240;3810;2498;8231
410965;201711;1000;2870;767;2391;148;492;323;948;471;1440
410970;201711;3875;11111;2889;9163;720;2690;433;1216;1153;3906
410975;201711;1352;3785;1049;3190;213;759;348;1032;561;1791
410980;201711;6467;17584;4268;13312;641;2170;1573;4718;2214;6888
410990;201711;1048;2938;685;2189;212;754;139;378;351;1132
411000;201711;454;1333;326;1066;45;165;75;205;120;370
411005;201711;439;1257;278;890;57;183;47;144;104;327
411007;201711;2150;6628;1880;6083;483;1691;577;1840;1060;3531
411010;201711;4010;12878;3398;11551;987;3557;350;1112;1337;4669
411020;201711;2322;6931;1969;6305;610;2082;575;1780;1185;3862
411030;201711;669;1772;443;1254;84;254;136;341;220;595
411040;201711;733;2032;326;1019;56;180;54;149;110;329
411050;201711;1825;6143;1579;5567;469;1774;236;733;705;2507
411060;201711;1538;4410;1089;3458;227;852;202;564;429;1416
411065;201711;328;937;249;783;46;142;101;319;147;461
411070;201711;6085;17295;4843;14895;1074;3633;1600;4666;2674;8299
411080;201711;1957;5613;1679;5113;482;1557;390;1218;872;2775
411090;201711;778;2067;530;1607;48;160;94;257;142;417
411095;201711;1404;3606;1007;2912;156;501;360;987;516;1488
411100;201711;1115;3205;809;2568;109;418;211;666;320;1084
411110;201711;558;1585;255;876;27;88;15;38;42;126
411120;201711;1389;4120;1053;3392;340;1257;200;538;540;1795
411125;201711;4369;13661;4080;13122;1007;3349;1781;5876;2788;9225
411130;201711;654;1864;469;1455;99;311;155;519;254;830
411140;201711;2180;7064;1824;6248;428;1535;737;2571;1165;4106
411150;201711;3729;10278;2704;8223;582;1977;221;555;803;2532
411155;201711;940;2511;618;1899;69;225;272;780;341;1005
411160;201711;284;758;208;616;31;90;54;168;85;258
411170;201711;722;2212;558;1834;126;434;171;562;297;996
411180;201711;5208;14906;4122;12850;823;2829;1542;4700;2365;7529
411190;201711;1277;3584;1014;3037;241;779;260;684;501;1463
411200;201711;4269;12283;3313;10526;902;3062;926;2877;1828;5939
411210;201711;1947;5229;1528;4516;458;1509;164;433;622;1942
411220;201711;835;2339;666;2001;153;501;226;643;379;1144
411230;201711;1065;2948;690;2208;150;511;187;591;337;1102
411240;201711;1581;3733;899;2574;121;368;400;1089;521;1457
411250;201711;1895;5468;1525;4788;365;1299;470;1453;835;2752
411260;201711;342;880;212;634;32;101;86;234;118;335
411270;201711;1718;5150;1439;4581;246;885;653;2006;899;2891
411275;201711;1264;3452;940;2797;191;620;286;791;477;1411
411280;201711;1416;4012;895;2856;168;596;144;399;312;995
411290;201711;699;1990;505;1610;90;295;194;623;284;918
411295;201711;1023;2688;849;2363;134;409;344;918;478;1327
411300;201711;1111;2819;729;2096;71;223;262;668;333;891
411310;201711;823;2160;656;1879;46;138;247;705;293;843
411320;201711;5042;14323;3661;11672;876;2883;856;2535;1732;5418
411325;201711;1487;4523;1304;4156;241;792;666;2179;907;2971
411330;201711;3040;9055;2371;7708;651;2301;568;1879;1219;4180
411340;201711;751;2176;486;1551;58;230;210;642;268;872
411342;201711;700;1837;525;1505;116;356;206;549;322;905
411345;201711;963;2780;802;2472;135;479;453;1385;588;1864
411350;201711;2574;7454;1864;5993;491;1742;168;551;659;2293
411360;201711;605;1513;420;1219;57;197;148;380;205;577
411370;201711;44180;118322;33736;99660;4019;13787;17270;47631;21289;61418
411373;201711;1309;3698;1079;3309;151;499;470;1458;621;1957
411375;201711;1025;2754;755;2253;133;433;251;686;384;1119
411380;201711;999;2655;658;1883;90;295;270;687;360;982
411390;201711;1680;4932;1330;4087;243;804;426;1179;669;1983
411400;201711;2048;5520;1642;4718;319;1049;606;1643;925;2692
411410;201711;1959;5808;1484;4772;354;1248;311;882;665;2130
411420;201711;3818;10220;2373;7284;367;1280;384;925;751;2205
411430;201711;3107;9064;2572;8132;577;1942;1100;3382;1677;5324
411435;201711;451;1355;331;1098;71;228;125;390;196;618
411440;201711;2558;7974;2170;7156;555;1922;583;2008;1138;3930
411450;201711;2565;7163;2021;6251;359;1121;1038;3289;1397;4410
411460;201711;3549;9983;1974;6521;342;1315;267;788;609;2103
411470;201711;740;2164;505;1631;89;313;91;275;180;588
411480;201711;4172;12244;2994;9892;634;2283;611;1910;1245;4193
411490;201711;1443;4134;1140;3566;203;742;342;931;545;1673
411500;201711;1586;4193;1101;3316;173;611;331;968;504;1579
411510;201711;1930;5565;1604;4902;412;1391;329;1011;741;2402
411520;201711;23718;62744;14238;43320;2261;7553;3835;10418;6096;17971
411530;201711;917;2510;608;1924;121;421;185;549;306;970
411535;201711;456;1375;206;736;18;76;20;52;38;128
411540;201711;2849;7517;2057;5907;453;1422;573;1511;1026;2933
411545;201711;976;3037;847;2773;93;315;535;1788;628;2103
411550;201711;680;1812;534;1563;106;351;90;246;196;597
411560;201711;1967;5633;1277;4131;195;722;81;191;276;913
411570;201711;7076;17920;4989;14591;1094;3622;1188;3458;2282;7080
411573;201711;798;2253;709;2107;74;231;438;1290;512;1521
411575;201711;1572;4680;1305;4151;306;1031;375;1186;681;2217
411580;201711;3942;10313;2326;7469;267;1043;310;898;577;1941
411585;201711;740;2304;358;1260;67;243;59;174;126;417
411590;201711;341;996;273;866;37;130;120;340;157;470
411600;201711;286;802;197;645;41;147;70;224;111;371
411605;201711;1459;4004;981;2967;149;533;386;1100;535;1633
411610;201711;2105;5772;1546;4591;297;970;604;1730;901;2700
411620;201711;2753;8140;2424;7619;434;1509;1387;4311;1821;5820
411630;201711;518;1398;349;1078;76;274;66;158;142;432
411640;201711;469;1398;337;1068;43;135;111;347;154;482
411650;201711;190;574;135;457;27;95;19;69;46;164
411660;201711;867;2304;616;1833;43;131;321;933;364;1064
411670;201711;1079;2931;834;2420;142;416;291;818;433;1234
411680;201711;1514;4333;1240;3826;198;689;608;1863;806;2552
411690;201711;3229;9148;2439;7661;490;1614;677;2208;1167;3822
411695;201711;653;2071;487;1665;76;286;156;554;232;840
411700;201711;1477;4155;1009;3223;218;766;142;402;360;1168
411705;201711;1605;5601;1435;5246;321;1128;781;3027;1102;4155
411710;201711;1677;4676;1275;3890;355;1149;183;564;538;1713
411720;201711;893;2422;699;2030;97;304;244;668;341;972
411721;201711;806;2269;630;1885;134;416;123;362;257;778
411722;201711;621;1797;387;1269;71;278;126;335;197;613
411725;201711;1262;3934;793;2783;196;717;151;540;347;1257
411727;201711;1555;4582;1081;3538;310;1038;139;413;449;1451
411729;201711;635;1641;430;1246;93;281;110;271;203;552
411730;201711;4747;13757;3892;11976;1184;3776;1116;3385;2300;7161
411740;201711;573;1595;317;1014;62;222;57;155;119;377
411745;201711;833;2440;617;1941;111;370;138;381;249;751
411750;201711;4753;13743;3612;11251;532;1826;1538;4581;2070;6407
411760;201711;7016;20032;5727;17716;1978;6478;1130;3685;3108;10163
411770;201711;3225;10129;2501;8433;704;2501;324;1053;1028;3554
411780;201711;2859;8501;2513;7852;650;2169;1025;3242;1675;5411
411790;201711;2926;7972;1820;5658;449;1543;286;820;735;2363
411800;201711;1030;2972;682;2166;95;328;115;342;210;670
411810;201711;1632;4457;1291;3791;241;782;581;1600;822;2382
411820;201711;11372;35947;9434;31909;3152;11070;2560;8771;5712;19841
411830;201711;565;1418;384;1109;97;317;46;147;143;464
411840;201711;9992;27665;7025;21645;1451;4887;1635;4886;3086;9773
411845;201711;432;1274;240;784;43;168;18;50;61;218
411850;201711;7237;20550;5593;17375;1631;5467;1021;3038;2652;8505
411860;201711;796;2386;609;1989;110;396;164;494;274;890
411870;201711;743;2355;501;1716;100;375;96;294;196;669
411880;201711;2078;5862;1539;4872;388;1358;248;765;636;2123
411885;201711;788;2112;620;1828;104;367;227;642;331;1009
411890;201711;1125;3303;755;2466;121;438;53;149;174;587
411900;201711;856;2618;528;1787;131;447;54;188;185;635
411910;201711;1075;3395;797;2754;223;809;207;684;430;1493
411915;201711;16252;42347;10032;30428;1892;6241;2480;6857;4372;13098
411920;201711;892;2902;771;2617;227;853;126;391;353;1244
411925;201711;585;1603;387;1220;97;325;89;267;186;592
411930;201711;5388;17637;4688;16237;2225;8399;311;1125;2536;9524
411940;201711;3041;9836;2509;8587;627;2224;548;1722;1175;3946
411950;201711;12409;37142;10374;33409;2242;7757;4710;14825;6952;22582
411960;201711;5302;15225;4652;13975;954;3138;1767;5064;2721;8202
411965;201711;490;1351;348;1105;67;246;91;283;158;529
411970;201711;826;2165;680;1954;129;340;370;1181;499;1521
411980;201711;1456;4121;1205;3635;320;1010;359;1055;679;2065
411990;201711;33099;97607;23852;78341;5340;19322;7075;22102;12415;41424
411995;201711;2525;7031;2012;6182;560;1934;582;1660;1142;3594
412000;201711;2135;5088;1566;4136;137;440;911;2212;1048;2652
412010;201711;657;2152;488;1732;67;277;111;339;178;616
412015;201711;589;1725;489;1529;79;250;242;772;321;1022
412020;201711;423;1241;264;871;43;160;96;288;139;448
412030;201711;704;2101;500;1682;78;285;174;560;252;845
412033;201711;889;2587;632;2011;86;284;221;739;307;1023
412035;201711;860;2324;546;1760;87;311;237;750;324;1061
412040;201711;580;1676;404;1305;73;241;70;216;143;457
412050;201711;1621;4494;1202;3684;224;776;296;906;520;1682
412060;201711;7004;22869;6133;21050;1878;6966;1416;4688;3294;11654
412065;201711;686;2009;514;1659;100;349;153;473;253;822
412070;201711;1212;3171;894;2536;132;404;383;1081;515;1485
412080;201711;1585;4795;979;3351;131;511;46;130;177;641
412085;201711;330;923;109;374;11;41;12;34;23;75
412090;201711;4974;13915;4342;12793;1107;3303;2040;6208;3147;9511
412100;201711;1708;5145;1372;4481;423;1484;261;861;684;2345
412110;201711;910;2524;633;1924;133;440;146;448;279;888
412120;201711;1674;5465;1398;4836;339;1280;386;1129;725;2409
412125;201711;606;1911;509;1679;115;405;158;500;273;905
412130;201711;598;1728;430;1346;71;245;98;323;169;568
412135;201711;546;1546;279;859;48;146;88;253;136;399
412140;201711;1527;4186;1086;3331;233;798;175;480;408;1278
412150;201711;2950;8125;2488;7236;281;949;1571;4429;1852;5378
412160;201711;1059;3411;658;2334;169;652;77;259;246;911
412170;201711;4253;12662;3547;11327;817;2832;1431;4295;2248;7127
412175;201711;1334;4252;1145;3867;248;856;469;1594;717;2450
412180;201711;1629;4725;1222;3970;222;863;493;1432;715;2295
412190;201711;3206;8672;2408;7202;383;1224;906;2833;1289;4057
412200;201711;1931;6015;1392;4640;328;1167;284;935;612;2102
412210;201711;625;1679;367;1136;72;270;67;166;139;436
412215;201711;3784;10543;3232;9492;858;2547;1375;4431;2233;6978
412217;201711;1029;2842;895;2600;78;268;613;1698;691;1966
412220;201711;5485;16537;4830;15298;1173;3666;1953;6568;3126;10234
412230;201711;2720;8657;2256;7662;427;1623;622;1932;1049;3555
412240;201711;7309;18984;4582;13875;881;2975;1057;3004;1938;5979
412250;201711;1897;5312;1484;4473;376;1200;232;625;608;1825
412260;201711;1212;3375;840;2564;119;393;284;791;403;1184
412265;201711;884;2658;761;2416;192;653;288;911;480;1564
412270;201711;778;2375;538;1798;85;318;191;598;276;916
412280;201711;539;1645;415;1399;126;443;70;219;196;662
412290;201711;1009;2723;705;2155;121;415;218;614;339;1029
412300;201711;1514;4495;1263;3989;330;1125;271;808;601;1933
412310;201711;812;2400;675;2155;82;354;332;1056;414;1410
412320;201711;796;2125;570;1687;85;326;182;523;267;849
412330;201711;1407;3941;1000;3106;184;590;389;1183;573;1773
412340;201711;961;2889;632;2067;99;341;138;415;237;756
412350;201711;2538;7222;1666;5366;326;1177;147;404;473;1581
412360;201711;256;746;162;523;23;84;55;161;78;245
412370;201711;798;2388;592;1987;124;464;61;201;185;665
412380;201711;1534;4609;1141;3707;300;1004;217;745;517;1749
412382;201711;593;1597;400;1208;65;208;107;278;172;486
412385;201711;2165;6414;1858;5769;685;2151;467;1553;1152;3704
412390;201711;2156;5828;1820;5277;383;1205;845;2473;1228;3678
412395;201711;719;2093;526;1689;58;189;258;809;316;998
412400;201711;879;2619;678;2165;159;528;155;524;314;1052
412402;201711;1744;4783;1315;4006;296;1024;175;495;471;1519
412405;201711;3113;8943;1961;6378;356;1304;63;184;419;1488
412410;201711;4988;14364;3873;12278;927;3355;872;2615;1799;5970
412420;201711;416;1170;235;746;31;98;90;250;121;348
412430;201711;518;1414;349;1076;42;148;127;383;169;531
412440;201711;2784;8212;1988;6645;499;1843;372;1231;871;3074
412450;201711;275;889;202;701;25;80;15;42;40;122
412460;201711;787;2360;664;2105;141;469;202;611;343;1080
412470;201711;1750;5820;1414;4976;388;1422;281;1037;669;2459
412480;201711;987;2892;626;2003;114;406;82;197;196;603
412490;201711;948;2686;785;2360;150;436;301;875;451;1311
412500;201711;1814;4980;1436;4232;253;815;375;983;628;1798
412510;201711;2016;6442;1486;5081;401;1448;200;636;601;2084
412520;201711;1300;3701;922;2871;229;723;109;322;338;1045
412530;201711;566;1627;443;1362;66;217;106;318;172;535
412535;201711;881;2636;659;2162;105;347;227;796;332;1143
412540;201711;1214;3380;859;2607;121;456;245;761;366;1217
412545;201711;712;1939;475;1416;89;272;109;278;198;550
412550;201711;29407;85635;20331;65831;4291;14810;5451;16496;9742;31306
412555;201711;232;672;150;480;22;81;42;107;64;188
412560;201711;5024;15168;3751;12237;802;2897;808;2543;1610;5440
412570;201711;3971;11108;2541;8080;530;1833;341;1129;871;2962
412575;201711;894;2600;723;2203;108;361;303;855;411;1216
412580;201711;1306;3506;920;2744;159;533;366;1028;525;1561
412590;201711;473;1327;260;875;55;186;27;84;82;270
412600;201711;1352;4019;1006;3229;184;663;321;987;505;1650
412610;201711;700;2020;438;1378;93;294;149;445;242;739
412620;201711;1212;3566;932;3043;233;892;257;750;490;1642
412625;201711;7922;22841;5581;18048;949;3321;582;2018;1531;5339
412627;201711;933;2760;641;2116;179;652;173;552;352;1204
412630;201711;2917;9081;2205;7428;434;1437;658;2122;1092;3559
412635;201711;397;1118;274;847;57;183;40;99;97;282
412640;201711;976;2782;568;1828;86;299;109;318;195;617
412650;201711;1506;4436;1259;3961;231;847;419;1183;650;2030
412660;201711;2545;7029;1820;5574;330;1121;485;1353;815;2474
412665;201711;557;1427;310;955;65;217;89;247;154;464
412667;201711;1631;4545;1265;3789;212;736;476;1345;688;2081
412670;201711;532;1576;420;1363;99;360;122;382;221;742
412680;201711;1392;4060;867;2919;152;570;248;733;400;1303
412690;201711;772;2249;581;1844;121;387;135;427;256;814
412700;201711;1912;5340;1551;4774;352;1257;590;1753;942;3010
412710;201711;5871;18308;4890;16255;1029;3700;1336;4118;2365;7818
412720;201711;1284;3935;934;3071;155;548;194;541;349;1089
412730;201711;2069;6094;1180;3982;263;943;164;520;427;1463
412740;201711;1609;4836;1098;3674;209;770;139;504;348;1274
412750;201711;3926;11425;3443;10632;478;1724;2129;6373;2607;8097
412760;201711;2568;7597;2295;7137;348;1203;1353;4085;1701;5288
412770;201711;10066;27094;5487;17355;755;2506;1035;2947;1790;5453
412780;201711;1219;3598;1026;3220;194;671;424;1281;618;1952
412785;201711;2054;5585;1515;4556;370;1126;622;1858;992;2984
412788;201711;1311;4001;1097;3544;288;1006;398;1212;686;2218
412790;201711;1023;2985;676;2229;135;492;170;486;305;978
412795;201711;1019;2773;645;1951;119;388;183;528;302;916
412796;201711;2307;7083;1990;6364;378;1274;752;2258;1130;3532
412800;201711;3098;8417;2199;6519;337;1126;825;2254;1162;3380
412810;201711;10899;29046;6360;19303;873;3018;1734;4454;2607;7472
412820;201711;6690;19216;4897;15673;1067;3620;1468;4734;2535;8354
412830;201711;320;944;233;762;35;126;51;160;86;286
412840;201711;1747;4868;1364;4091;219;693;389;1155;608;1848
412850;201711;2942;8270;2243;6994;415;1401;764;2274;1179;3675
412853;201711;1774;4922;1482;4269;155;503;784;2052;939;2555
412855;201711;1222;3513;883;2708;169;590;189;482;358;1072
412860;201711;971;2841;761;2400;173;586;259;778;432;1364
412862;201711;731;1810;459;1333;68;219;158;454;226;673
412863;201711;1136;3712;1103;3656;104;367;842;2768;946;3135
412865;201711;724;2078;522;1681;97;318;172;570;269;888
412870;201711;877;2482;683;2154;232;818;128;425;360;1243
412880;201711;848;2464;592;1877;116;409;86;246;202;655
420005;201711;450;1332;261;885;38;132;95;314;133;446
420010;201711;3030;8103;2290;6994;239;776;1596;4888;1835;5664
420020;201711;567;1829;338;1240;52;234;47;145;99;379
420030;201711;271;714;142;486;33;132;17;60;50;192
420040;201711;611;1916;337;1279;52;224;15;41;67;265
420050;201711;676;1800;430;1319;72;235;219;646;291;881
420055;201711;171;528;94;337;18;79;24;81;42;160
420060;201711;150;489;108;380;19;84;21;48;40;132
420070;201711;1068;3408;798;2754;171;632;273;952;444;1584
420075;201711;139;365;72;218;13;35;11;23;24;58
420080;201711;484;1474;374;1251;110;375;99;319;209;694
420090;201711;387;1346;270;1023;63;240;53;209;116;449
420100;201711;1102;3310;987;3141;117;398;703;2228;820;2626
420110;201711;273;904;251;854;74;262;77;240;151;502
420120;201711;288;924;216;747;57;241;70;199;127;440
420125;201711;299;1026;261;949;65;265;122;427;187;692
420127;201711;312;874;106;370;22;89;15;40;37;129
420130;201711;1798;5827;1371;4927;348;1375;359;1164;707;2539
420140;201711;3449;10128;2511;8332;629;2337;353;1063;982;3400
420150;201711;499;1325;321;1032;40;148;155;461;195;609
420160;201711;235;633;117;391;17;66;35;114;52;180
420165;201711;182;546;105;350;22;83;32;98;54;181
420170;201711;206;655;133;490;34;150;15;54;49;204
420180;201711;278;827;147;519;22;77;37;124;59;201
420190;201711;165;550;100;379;30;117;15;50;45;167
420195;201711;1220;3524;960;3059;259;935;152;459;411;1394
420200;201711;2726;7919;1568;5445;283;1152;361;1108;644;2260
420205;201711;1174;3572;887;3018;151;567;476;1629;627;2196
420207;201711;1439;4114;948;3110;230;853;254;782;484;1635
420208;201711;486;1293;259;901;48;199;110;395;158;594
420209;201711;191;613;122;444;32;127;48;167;80;294
420210;201711;2051;5776;1301;4503;298;1174;519;1712;817;2886
420213;201711;728;2514;677;2404;184;710;317;1123;501;1833
420215;201711;268;846;175;637;55;193;15;64;70;257
420220;201711;172;605;139;539;42;183;36;131;78;314
420230;201711;3460;10162;2642;8698;469;1801;1178;3704;1647;5505
420240;201711;10767;29698;6938;22212;958;3653;3457;10008;4415;13661
420243;201711;518;1527;399;1298;77;260;146;474;223;734
420245;201711;1227;3458;845;2718;95;376;432;1282;527;1658
420250;201711;450;1408;392;1290;88;315;179;569;267;884
420253;201711;496;1309;366;1115;33;93;197;605;230;698
420257;201711;247;669;143;474;27;90;63;211;90;301
420260;201711;1035;3222;809;2811;143;555;376;1293;519;1848
420270;201711;547;1521;231;750;24;92;71;208;95;300
420280;201711;1675;4532;988;3269;186;673;267;846;453;1519
420285;201711;107;293;49;183;10;39;4;8;14;47
420287;201711;420;1109;292;904;97;312;88;267;185;579
420290;201711;4420;13459;3258;10722;626;2244;1087;3231;1713;5475
420300;201711;6349;18570;3793;12755;807;3080;823;2456;1630;5536
420310;201711;757;1909;458;1286;57;171;311;849;368;1020
420315;201711;847;2667;636;2224;174;649;223;758;397;1407
420320;201711;3859;11818;3140;10482;1014;3742;753;2335;1767;6077
420325;201711;200;649;152;545;42;151;41;151;83;302
420330;201711;852;2755;605;2149;124;484;189;618;313;1102
420340;201711;1182;3556;839;2796;162;570;54;176;216;746
420350;201711;1412;4010;992;3180;163;572;542;1708;705;2280
420360;201711;2595;7749;1495;5272;302;1185;138;494;440;1679
420370;201711;1399;3913;1113;3448;137;509;777;2329;914;2838
420380;201711;4979;14287;3234;10634;748;2645;907;2908;1655;5553
420390;201711;1073;2823;684;2008;116;385;239;504;355;889
420395;201711;1079;3268;714;2464;110;418;74;223;184;641
420400;201711;987;2961;657;2250;129;506;143;451;272;957
420410;201711;569;1542;415;1266;37;142;303;908;340;1050
420415;201711;362;1126;274;929;84;305;75;246;159;551
420417;201711;675;2132;538;1807;119;431;202;665;321;1096
420419;201711;251;849;176;667;57;245;10;34;67;279
420420;201711;9680;27982;7220;23456;2641;9276;1456;4365;4097;13641
420425;201711;896;2355;620;1847;61;227;277;766;338;993
420430;201711;3065;9112;1952;6496;450;1616;547;1677;997;3293
420435;201711;237;714;133;477;32;144;41;127;73;271
420440;201711;728;2152;403;1337;131;487;114;336;245;823
420445;201711;332;954;207;671;47;160;60;183;107;343
420450;201711;689;2082;486;1626;103;380;138;397;241;777
420455;201711;1861;5185;1464;4510;220;786;732;2150;952;2936
420460;201711;8203;23172;6146;19531;1209;4391;2511;7550;3720;11941
420470;201711;827;2204;451;1451;88;315;104;292;192;607
420475;201711;62;191;42;149;13;43;6;21;19;64
420480;201711;4487;12434;3087;9894;679;2351;889;2801;1568;5152
420490;201711;567;1499;299;1027;70;256;64;232;134;488
420500;201711;1322;4015;911;3187;238;897;276;948;514;1845
420510;201711;110;381;80;295;16;68;42;142;58;210
420515;201711;49;142;38;124;7;29;13;39;20;68
420517;201711;764;2214;690;2089;44;146;545;1635;589;1781
420519;201711;382;988;245;760;44;155;68;199;112;354
420520;201711;498;1310;227;770;29;94;26;66;55;160
420530;201711;1012;3077;728;2458;151;564;203;616;354;1180
420535;201711;256;733;115;394;29;100;11;37;40;137
420540;201711;20956;55770;14140;42295;2889;9582;4380;11207;7269;20789
420543;201711;296;782;232;662;49;117;113;316;162;433
420545;201711;1313;4092;1052;3535;246;879;346;1130;592;2009
420550;201711;3371;10101;2308;8023;572;2275;611;2159;1183;4434
420555;201711;319;957;238;790;46;154;89;284;135;438
420560;201711;438;1227;320;1013;55;172;181;563;236;735
420570;201711;2047;6277;1596;5311;341;1299;626;1927;967;3226
420580;201711;1657;4597;1279;3996;272;977;615;1843;887;2820
420590;201711;2923;8507;1792;5965;368;1351;312;832;680;2183
420600;201711;907;2879;777;2607;148;523;407;1369;555;1892
420610;201711;447;1342;245;876;58;222;52;175;110;397
420620;201711;479;1432;406;1296;126;424;124;383;250;807
420630;201711;788;2413;608;1986;136;489;256;781;392;1270
420640;201711;676;1950;313;1122;86;351;23;66;109;417
420650;201711;2428;6973;1554;5151;274;982;459;1346;733;2328
420660;201711;405;1179;275;909;57;206;63;194;120;400
420665;201711;534;1476;372;1206;62;246;151;441;213;687
420670;201711;1513;4332;1043;3378;182;725;331;937;513;1662
420675;201711;156;511;116;406;33;143;21;52;54;195
420680;201711;328;821;196;627;35;119;81;242;116;361
420690;201711;756;2573;529;1938;89;336;89;259;178;595
420700;201711;2825;8205;2209;7002;398;1407;874;2667;1272;4074
420710;201711;607;1928;455;1599;95;413;180;561;275;974
420720;201711;1409;3999;1064;3500;298;1021;442;1446;740;2467
420730;201711;2739;7836;2167;6901;417;1441;1053;3252;1470;4693
420740;201711;752;2270;527;1808;142;530;115;367;257;897
420750;201711;1814;5652;1287;4470;215;831;425;1327;640;2158
420757;201711;84;197;26;101;5;25;10;34;15;59
420760;201711;375;1152;174;586;39;128;19;58;58;186
420765;201711;485;1543;252;928;47;191;57;211;104;402
420768;201711;1117;3707;941;3354;287;1021;491;1803;778;2824
420770;201711;515;1406;251;907;49;203;56;199;105;402
420775;201711;561;1641;307;1046;68;249;40;115;108;364
420780;201711;1090;3221;639;2203;123;447;141;457;264;904
420785;201711;181;526;135;420;27;85;40;109;67;194
420790;201711;1032;3429;808;2980;211;842;328;1150;539;1992
420800;201711;750;2033;355;1173;81;304;106;326;187;630
420810;201711;1657;5591;1342;4889;443;1818;302;969;745;2787
420820;201711;8482;23530;5751;19051;1353;4978;1855;5784;3208;10762
420830;201711;2745;8271;2194;7225;564;2028;750;2389;1314;4417
420840;201711;836;2405;382;1346;76;295;60;188;136;483
420845;201711;1557;4363;986;3291;230;882;278;910;508;1792
420850;201711;1216;3951;755;2806;182;756;87;262;269;1018
420860;201711;301;822;185;612;44;171;40;123;84;294
420870;201711;868;2460;669;2129;248;881;198;583;446;1464
420880;201711;907;2982;703;2483;164;642;143;433;307;1075
420890;201711;7774;21275;4192;13846;748;2703;1064;3087;1812;5790
420895;201711;173;516;99;323;30;107;32;92;62;199
420900;201711;1459;4004;911;2984;175;682;287;818;462;1500
420910;201711;22452;64322;15281;50437;2709;10145;5160;15586;7869;25731
420915;201711;493;1937;346;1488;70;324;149;593;219;917
420917;201711;345;1026;186;580;27;94;84;247;111;341
420920;201711;126;368;50;182;4;16;5;15;9;31
420930;201711;17034;47230;12600;39451;2399;8226;5383;16150;7782;24376
420940;201711;2441;6907;1709;5515;450;1587;119;333;569;1920
420945;201711;149;463;109;369;28;110;35;109;63;219
420950;201711;426;1215;234;810;30;128;70;229;100;357
420960;201711;854;2376;625;1949;121;433;218;619;339;1052
420970;201711;2553;7621;1843;6241;536;1910;315;1112;851;3022
420980;201711;374;1131;291;1007;123;446;94;354;217;800
420985;201711;390;1141;189;685;35;141;62;209;97;350
420990;201711;530;1576;301;1078;58;221;42;124;100;345
421000;201711;444;1533;300;1145;59;249;55;155;114;404
421003;201711;511;1337;191;633;25;84;24;61;49;145
421005;201711;114;357;84;301;20;81;40;154;60;235
421010;201711;3953;11156;2800;9123;664;2403;608;1786;1272;4189
421020;201711;410;1231;307;1054;26;100;197;683;223;783
421030;201711;710;2413;592;2132;191;762;127;417;318;1179
421040;201711;809;1964;498;1477;63;223;275;797;338;1020
421050;201711;1335;3764;762;2506;154;544;212;649;366;1193
421055;201711;174;474;85;280;22;75;22;66;44;141
421060;201711;512;1608;358;1224;76;300;130;425;206;725
421070;201711;560;1763;352;1230;78;294;47;153;125;447
421080;201711;672;2772;612;2675;74;244;464;2191;538;2435
421085;201711;438;1232;195;669;34;125;38;120;72;245
421090;201711;361;967;170;542;18;60;39;114;57;174
421100;201711;907;2359;458;1408;108;358;50;136;158;494
421105;201711;1331;3918;1061;3494;183;630;497;1714;680;2344
421110;201711;890;2865;770;2638;137;511;430;1444;567;1955
421120;201711;1072;3422;729;2647;108;450;186;580;294;1030
421125;201711;344;921;247;766;72;246;73;185;145;431
421130;201711;3085;9972;2671;9172;729;2712;1200;4089;1929;6801
421140;201711;290;840;213;681;39;125;87;257;126;382
421145;201711;480;1388;273;877;50;176;110;331;160;507
421150;201711;503;1420;337;1127;60;239;122;382;182;621
421160;201711;821;2204;444;1434;76;281;195;614;271;895
421165;201711;196;645;155;551;19;60;80;301;99;361
421170;201711;1163;3216;898;2799;139;443;547;1726;686;2169
421175;201711;1101;3086;742;2429;145;565;264;755;409;1320
421180;201711;423;1116;203;666;44;159;39;119;83;278
421185;201711;340;899;226;683;43;129;114;353;157;482
421187;201711;346;1030;226;741;34;115;87;262;121;377
421189;201711;363;1127;277;929;50;179;85;257;135;436
421190;201711;9459;26624;5882;19852;1230;4635;977;3093;2207;7728
421200;201711;772;2449;637;2186;139;510;242;796;381;1306
421205;201711;191;543;141;445;35;135;54;155;89;290
421210;201711;1053;3113;769;2523;195;676;260;840;455;1516
421220;201711;1482;4936;1270;4445;347;1352;193;593;540;1945
421223;201711;427;1320;294;1051;58;221;108;387;166;608
421225;201711;998;3191;849;2868;187;693;406;1391;593;2084
421227;201711;860;2408;584;1893;114;410;308;968;422;1378
421230;201711;469;1405;359;1206;107;383;119;395;226;778
421240;201711;330;1029;158;582;18;83;22;80;40;163
421250;201711;1412;3905;882;2995;220;806;219;742;439;1548
421260;201711;281;785;59;211;10;32;8;31;18;63
421265;201711;706;2119;635;2008;75;278;455;1414;530;1692
421270;201711;471;1325;247;867;49;165;68;234;117;399
421280;201711;1480;4616;1176;4038;262;1005;523;1769;785;2774
421290;201711;814;2264;467;1495;85;286;81;231;166;517
421300;201711;231;682;158;526;39;157;52;156;91;313
421310;201711;181;567;140;461;28;106;48;148;76;254
421315;201711;258;782;153;548;27;99;18;70;45;169
421320;201711;641;1957;377;1290;73;255;63;161;136;416
421330;201711;561;1765;417;1482;105;389;109;388;214;777
421335;201711;398;1323;325;1173;77;318;73;269;150;587
421340;201711;1400;3983;1086;3449;182;641;531;1644;713;2285
421350;201711;1002;3158;802;2761;130;560;403;1310;533;1870
421360;201711;2428;6893;1502;5044;323;1296;505;1506;828;2802
421370;201711;470;1604;326;1229;86;338;76;291;162;629
421380;201711;787;2292;676;2091;107;354;357;1061;464;1415
421390;201711;166;457;69;230;19;73;19;53;38;126
421400;201711;248;833;179;702;58;245;69;251;127;496
421410;201711;224;660;119;436;16;71;51;188;67;259
421415;201711;342;1064;156;538;39;143;30;87;69;230
421420;201711;636;1862;492;1580;73;255;236;719;309;974
421430;201711;156;510;119;425;19;73;31;105;50;178
421440;201711;674;1936;467;1576;89;338;218;723;307;1061
421450;201711;390;1201;227;810;37;160;26;91;63;251
421460;201711;481;1397;281;1009;58;220;76;264;134;484
421470;201711;281;899;210;754;49;216;59;188;108;404
421480;201711;2710;7483;1776;5856;599;2266;303;849;902;3115
421490;201711;213;621;101;366;17;65;18;54;35;119
421500;201711;1885;6225;1398;5165;404;1660;167;567;571;2227
421505;201711;300;951;266;892;46;155;145;488;191;643
421507;201711;437;1293;288;990;72;268;78;258;150;526
421510;201711;201;639;153;523;35;120;68;203;103;323
421520;201711;618;1720;381;1188;53;199;168;474;221;673
421530;201711;313;975;178;639;39;170;38;113;77;283
421535;201711;505;1489;315;1101;37;147;150;485;187;632
421540;201711;226;605;155;484;31;106;63;184;94;290
421545;201711;686;2101;498;1729;113;448;181;601;294;1049
421550;201711;1934;5879;1653;5410;424;1541;703;2214;1127;3755
421555;201711;245;709;73;262;16;67;10;23;26;90
421560;201711;119;365;61;225;12;45;9;36;21;81
421565;201711;704;1968;536;1699;136;489;230;741;366;1230
421567;201711;512;1819;393;1497;196;772;71;278;267;1050
421568;201711;486;1460;320;1079;61;228;100;318;161;546
421569;201711;248;725;101;360;21;71;18;70;39;141
421570;201711;1114;3209;700;2313;174;601;120;364;294;965
421575;201711;337;1052;294;934;48;165;156;470;204;635
421580;201711;2692;8394;2004;6916;458;1801;627;1908;1085;3709
421590;201711;163;509;127;436;17;63;71;234;88;297
421600;201711;463;1384;332;1083;82;272;80;242;162;514
421605;201711;669;1957;448;1540;88;331;129;424;217;755
421610;201711;1218;3330;800;2528;146;517;222;667;368;1184
421620;201711;3769;11031;2323;8105;673;2521;522;1802;1195;4323
421625;201711;319;863;118;397;23;75;18;56;41;131
421630;201711;2669;7648;1470;4890;274;1053;281;831;555;1884
421635;201711;176;525;99;331;16;63;28;75;44;138
421640;201711;881;2532;607;2017;131;462;197;640;328;1102
421650;201711;2073;6352;1421;4926;322;1292;225;616;547;1908
421660;201711;6787;21538;5597;19142;1113;4202;1990;6306;3103;10508
421670;201711;892;2601;614;2002;144;543;209;647;353;1190
421680;201711;972;3080;785;2682;262;946;209;682;471;1628
421690;201711;1236;3941;905;3155;217;854;179;580;396;1434
421700;201711;454;1470;247;926;48;206;59;186;107;392
421710;201711;188;608;77;270;17;68;24;78;41;146
421715;201711;180;455;87;274;17;55;44;137;61;192
421720;201711;1810;5263;1077;3743;262;992;243;784;505;1776
421725;201711;158;434;103;331;28;104;34;93;62;197
421730;201711;414;1211;214;689;34;127;65;182;99;309
421740;201711;593;1862;415;1436;98;390;97;307;195;697
421750;201711;893;2243;490;1487;65;209;181;504;246;713
421755;201711;264;735;140;439;17;64;55;161;72;225
421760;201711;939;2751;496;1708;82;303;107;329;189;632
421770;201711;2466;7079;1819;5882;453;1509;616;2136;1069;3645
421775;201711;275;817;201;666;35;126;91;283;126;409
421780;201711;848;2855;612;2306;131;552;167;568;298;1120
421790;201711;657;1727;383;1295;147;535;114;356;261;891
421795;201711;294;866;178;568;27;98;59;175;86;273
421800;201711;2377;7035;1770;5893;411;1502;716;2266;1127;3768
421810;201711;643;1837;457;1478;102;386;159;459;261;845
421820;201711;837;2436;456;1567;95;349;60;172;155;521
421825;201711;1285;3942;1201;3802;162;578;837;2585;999;3163
421830;201711;2238;7433;1954;6851;501;1947;647;2113;1148;4060
421835;201711;205;563;128;429;25;106;65;191;90;297
421840;201711;236;740;163;583;38;146;54;184;92;330
421850;201711;402;1229;224;788;41;159;53;162;94;321
421860;201711;272;858;178;646;32;136;52;155;84;291
421870;201711;3292;9092;2281;7096;547;1901;705;2064;1252;3965
421875;201711;368;1061;163;582;28;102;17;53;45;155
421880;201711;637;1916;472;1570;124;447;83;273;207;720
421885;201711;251;751;197;666;61;225;51;151;112;376
421890;201711;750;2519;615;2243;187;765;213;704;400;1469
421895;201711;335;1032;303;982;49;176;200;647;249;823
421900;201711;868;2370;594;1826;117;391;239;695;356;1086
421910;201711;387;1231;280;984;54;227;60;182;114;409
421915;201711;434;1299;263;883;54;178;43;133;97;311
421917;201711;561;1564;366;1277;127;491;82;283;209;774
421920;201711;574;1670;376;1362;179;651;113;443;292;1094
421930;201711;2445;6522;1237;4203;345;1266;152;484;497;1750
421935;201711;507;1652;387;1405;88;360;165;559;253;919
421940;201711;209;681;120;427;21;94;39;123;60;217
421950;201711;3104;8207;1446;4801;328;1222;203;635;531;1857
421960;201711;157;437;109;359;19;78;23;79;42;157
421970;201711;2067;5545;1120;3596;269;902;253;728;522;1630
421985;201711;351;881;185;558;29;104;48;154;77;258
422000;201711;1464;4259;1222;3820;217;786;660;2021;877;2807
430003;201711;498;1587;413;1435;106;419;128;408;234;827
430005;201711;299;841;194;633;53;174;84;272;137;446
430010;201711;1819;4855;1409;4151;271;886;712;2052;983;2938
430020;201711;606;1476;488;1323;78;240;292;759;370;999
430030;201711;1016;2583;635;1869;184;558;171;509;355;1067
430040;201711;9983;26160;6343;19175;1619;5480;334;1070;1953;6550
430045;201711;601;1623;424;1248;50;157;209;592;259;749
430047;201711;284;662;125;377;24;74;34;99;58;173
430050;201711;939;2538;543;1676;118;367;126;369;244;736
430055;201711;291;751;133;405;12;41;69;195;81;236
430057;201711;61;152;31;92;9;31;5;9;14;40
430060;201711;15821;48319;13280;44053;3640;12992;5064;17029;8704;30021
430063;201711;874;2544;689;2129;161;491;364;1126;525;1617
430064;201711;1063;3152;795;2565;227;782;201;631;428;1413
430066;201711;132;311;89;241;6;21;55;141;61;162
430070;201711;659;1750;135;457;14;49;9;18;23;67
430080;201711;734;1992;431;1368;81;284;165;460;246;744
430085;201711;912;2283;539;1607;94;301;184;565;278;866
430087;201711;638;1988;541;1811;100;382;268;853;368;1235
430090;201711;653;1719;222;728;22;87;57;188;79;275
430100;201711;735;1871;373;1181;77;254;114;323;191;577
430105;201711;986;2783;666;2202;126;487;286;927;412;1414
430107;201711;195;615;137;464;20;70;32;96;52;166
430110;201711;2018;5357;1525;4610;285;901;762;2220;1047;3121
430120;201711;1390;4245;929;3131;211;727;376;1329;587;2056
430130;201711;3910;10676;3178;9550;988;2748;1105;3988;2093;6736
430140;201711;1008;3038;645;2198;165;572;214;725;379;1297
430150;201711;683;1769;377;1171;82;279;94;290;176;569
430155;201711;294;807;163;525;23;82;38;110;61;192
430160;201711;16012;44744;13736;41016;3500;10937;4965;15556;8465;26493
430163;201711;2028;5538;1555;4774;204;710;926;2811;1130;3521
430165;201711;429;1001;94;306;10;28;9;25;19;53
430170;201711;894;2517;335;1199;70;258;58;187;128;445
430175;201711;727;2302;609;2007;155;495;278;936;433;1431
430180;201711;733;1974;596;1730;100;340;340;934;440;1274
430185;201711;462;1160;284;825;48;147;121;310;169;457
430187;201711;613;1699;463;1422;86;291;190;564;276;855
430190;201711;1451;4311;1240;3886;289;958;542;1668;831;2626
430192;201711;143;435;60;188;9;29;9;23;18;52
430195;201711;372;1135;78;258;10;32;6;15;16;47
430200;201711;1200;3785;1002;3380;304;1060;297;990;601;2050
430205;201711;504;1444;402;1232;25;98;310;921;335;1019
430210;201711;5361;13904;3548;10181;532;1748;1415;3310;1947;5058
430215;201711;321;875;221;665;39;133;88;248;127;381
430220;201711;646;1620;197;633;35;114;40;116;75;230
430222;201711;221;682;179;590;26;94;75;228;101;322
430223;201711;291;825;243;734;44;137;113;342;157;479
430225;201711;33;83;12;37;3;7;3;6;6;13
430230;201711;1486;4443;1404;4335;268;755;1017;3261;1285;4016
430235;201711;220;699;177;590;23;90;68;220;91;310
430237;201711;528;1340;379;1084;34;114;231;624;265;738
430240;201711;1073;2547;677;1916;73;236;392;1079;465;1315
430245;201711;770;2335;591;1978;196;650;241;844;437;1494
430250;201711;1035;2909;858;2620;257;842;56;149;313;991
430258;201711;126;342;91;283;8;29;46;144;54;173
430260;201711;630;1778;462;1439;88;274;221;713;309;987
430265;201711;226;672;167;566;35;125;37;126;72;251
430270;201711;2634;7198;2257;6589;268;856;1487;4262;1755;5118
430280;201711;4562;11831;3529;10006;828;2401;1467;4174;2295;6575
430290;201711;2261;5865;2056;5572;95;305;1766;4727;1861;5032
430300;201711;8327;23551;6814;20737;1434;4658;3138;9569;4572;14227
430310;201711;6732;19107;4979;15761;945;3392;2161;6439;3106;9831
430320;201711;846;2432;492;1642;104;312;223;811;327;1123
430330;201711;635;1626;437;1241;116;338;179;449;295;787
430340;201711;725;1713;369;1113;70;226;180;530;250;756
430350;201711;5728;16836;4718;14717;1469;4770;1680;5056;3149;9826
430355;201711;357;897;125;396;25;90;11;32;36;122
430360;201711;808;2143;606;1773;128;394;210;578;338;972
430367;201711;329;822;177;532;52;177;50;145;102;322
430370;201711;509;1421;273;911;65;229;60;179;125;408
430380;201711;687;1753;376;1180;119;417;96;298;215;715
430390;201711;3142;8418;1797;5667;286;993;132;335;418;1328
430400;201711;1146;2705;863;2257;169;456;496;1259;665;1715
430410;201711;597;1530;416;1219;55;195;241;684;296;879
430420;201711;3068;8782;2356;7166;715;2281;757;2229;1472;4510
430430;201711;610;1643;343;1081;88;296;65;190;153;486
430435;201711;1708;4600;1248;3774;334;1045;343;1059;677;2104
430440;201711;3513;10685;2718;8957;586;2069;1257;4220;1843;6289
430450;201711;6372;17709;5273;15604;1287;4037;2026;6016;3313;10053
430460;201711;24400;70557;18633;60595;4595;16455;6467;20401;11062;36856
430461;201711;465;1208;139;445;17;56;33;97;50;153
430462;201711;270;737;175;572;29;109;36;132;65;241
430463;201711;4197;12812;3502;11544;715;2560;1697;5617;2412;8177
430465;201711;506;1366;418;1198;81;245;249;700;330;945
430466;201711;3504;9218;2960;8355;706;2106;1483;3989;2189;6095
430467;201711;475;1299;379;1122;61;203;176;490;237;693
430468;201711;1239;3391;1028;3054;182;587;556;1628;738;2215
430469;201711;548;1556;59;205;7;17;9;22;16;39
430470;201711;6472;17559;4629;14398;1486;4863;864;2753;2350;7616
430471;201711;495;1634;443;1515;99;355;175;585;274;940
430480;201711;920;2472;473;1527;77;280;70;199;147;479
430485;201711;146;429;63;211;10;40;12;32;22;72
430490;201711;332;935;192;631;31;111;83;282;114;393
430495;201711;373;1074;240;800;34;130;91;271;125;401
430500;201711;1090;2951;835;2527;209;702;332;948;541;1650
430510;201711;21786;61090;16296;50095;4188;14025;5324;15220;9512;29245
430511;201711;347;1057;141;499;22;72;14;41;36;113
430512;201711;933;2365;785;2124;213;595;239;675;452;1270
430513;201711;793;2062;414;1219;109;338;148;404;257;742
430515;201711;411;1175;283;918;54;154;131;449;185;603
430517;201711;1058;3313;857;2901;154;535;408;1419;562;1954
430520;201711;1376;3710;770;2428;144;480;142;415;286;895
430530;201711;1097;2872;416;1294;86;265;97;296;183;561
430535;201711;2669;7599;1945;6194;359;1212;823;2587;1182;3799
430537;201711;397;1337;329;1157;46;167;227;799;273;966
430540;201711;601;1379;371;1040;69;190;198;549;267;739
430543;201711;509;1147;402;1027;72;160;265;712;337;872
430544;201711;616;1945;480;1625;117;421;218;711;335;1132
430545;201711;1473;4502;1202;4080;342;1215;518;1806;860;3021
430550;201711;542;1516;300;983;64;218;53;148;117;366
430558;201711;73;230;46;161;12;43;13;38;25;81
430560;201711;407;959;176;531;15;56;49;137;64;193
430570;201711;969;2369;635;1775;94;327;331;827;425;1154
430580;201711;1171;2858;728;2133;118;396;347;973;465;1369
430583;201711;178;465;36;113;4;13;6;21;10;34
430585;201711;257;641;145;422;26;88;60;154;86;242
430587;201711;173;549;132;445;31;114;47;167;78;281
430590;201711;1317;3392;1168;3141;67;217;991;2617;1058;2834
430593;201711;16;58;14;51;3;13;7;25;10;38
430595;201711;280;805;78;278;9;39;12;41;21;80
430597;201711;316;914;213;659;20;75;81;210;101;285
430600;201711;1796;4841;886;2745;153;475;222;653;375;1128
430605;201711;1183;3482;919;2929;150;570;361;1134;511;1704
430607;201711;692;1598;503;1315;38;112;328;878;366;990
430610;201711;6392;16747;4734;14183;1424;4651;791;2448;2215;7099
430613;201711;287;682;95;294;6;23;29;74;35;97
430620;201711;594;1635;484;1423;125;409;212;597;337;1006
430630;201711;458;1329;142;464;26;85;27;77;53;162
430632;201711;596;1650;280;867;34;115;108;307;142;422
430635;201711;538;1531;406;1247;71;242;242;720;313;962
430637;201711;448;1234;380;1119;57;197;213;590;270;787
430640;201711;1340;3553;690;2188;93;299;168;479;261;778
430642;201711;408;1101;268;819;43;132;112;337;155;469
430645;201711;277;626;106;292;20;58;28;75;48;133
430650;201711;1626;5172;1363;4619;337;1193;682;2333;1019;3526
430655;201711;159;395;121;345;29;85;50;132;79;217
430660;201711;4939;13616;3887;11770;904;2914;1665;5013;2569;7927
430670;201711;491;1348;399;1180;37;132;269;791;306;923
430673;201711;670;1587;274;818;55;165;86;253;141;418
430675;201711;224;663;56;201;10;44;13;43;23;87
430676;201711;3643;10306;2882;8955;580;1893;1259;3907;1839;5800
430680;201711;1013;2805;606;1976;134;437;119;368;253;805
430690;201711;3414;9800;2820;8655;835;2695;734;2261;1569;4956
430692;201711;227;730;174;635;10;36;118;439;128;475
430693;201711;1078;2879;617;1916;138;472;118;325;256;797
430695;201711;553;1393;342;991;49;157;189;528;238;685
430697;201711;423;1131;306;928;56;172;142;451;198;623
430700;201711;7855;20051;4139;13201;881;3064;416;1380;1297;4444
430705;201711;259;757;164;536;27;95;53;166;80;261
430710;201711;1581;3938;1210;3312;225;693;561;1490;786;2183
430720;201711;690;1741;425;1310;109;334;141;450;250;784
430730;201711;1431;3746;915;2855;159;508;415;1338;574;1846
430740;201711;617;1757;344;1172;61;212;84;310;145;522
430745;201711;484;1371;243;791;37;126;51;159;88;285
430750;201711;1424;3840;1054;3207;221;738;517;1529;738;2267
430755;201711;479;1222;303;871;23;74;166;431;189;505
430760;201711;2256;5738;1665;4817;378;1189;664;1986;1042;3175
430770;201711;5676;15840;4430;13722;805;2711;2384;7225;3189;9936
430780;201711;2220;5867;1384;4377;259;853;469;1569;728;2422
430781;201711;406;1194;261;861;55;189;53;176;108;365
430783;201711;506;1218;290;849;40;133;136;371;176;504
430786;201711;60;204;42;157;8;29;9;34;17;63
430790;201711;4126;11136;2813;8498;543;1809;1296;3720;1839;5529
430800;201711;816;2208;562;1678;79;276;289;816;368;1092
430805;201711;528;1459;313;958;39;117;157;459;196;576
430807;201711;406;1078;270;816;34;121;107;306;141;427
430810;201711;755;2028;267;919;46;153;65;208;111;361
430820;201711;1278;3569;700;2346;154;529;134;444;288;973
430825;201711;311;840;116;349;28;70;23;63;51;133
430830;201711;1566;4808;1378;4484;150;549;946;3088;1096;3637
430840;201711;893;2640;775;2423;172;519;406;1287;578;1806
430843;201711;111;278;36;107;6;16;12;34;18;50
430845;201711;310;825;216;653;89;287;33;82;122;369
430850;201711;2228;6357;1847;5671;437;1467;850;2586;1287;4053
430860;201711;939;2403;470;1461;84;318;187;526;271;844
430865;201711;553;1463;481;1339;149;443;208;548;357;991
430870;201711;709;1922;328;1086;61;218;88;263;149;481
430880;201711;1098;2876;756;2282;203;636;277;846;480;1482
430885;201711;238;572;121;391;10;38;86;270;96;308
430890;201711;1363;3645;895;2722;66;288;124;329;190;617
430900;201711;2706;6742;1934;5519;318;1031;959;2601;1277;3632
430905;201711;854;2398;563;1791;115;404;152;460;267;864
430910;201711;1447;4103;962;3073;197;753;381;1085;578;1838
430912;201711;486;1382;348;1134;40;140;216;712;256;852
430915;201711;539;1674;398;1422;106;371;138;539;244;910
430920;201711;18834;53077;15637;47539;2606;8737;8886;26321;11492;35058
430925;201711;137;306;60;164;9;21;21;62;30;83
430930;201711;8961;23336;5740;17857;1538;5086;1411;4626;2949;9712
430940;201711;1239;3704;684;2310;172;605;105;313;277;918
430950;201711;782;2061;525;1550;99;318;231;622;330;940
430955;201711;168;458;59;193;12;33;10;35;22;68
430957;201711;210;724;183;660;33;125;87;314;120;439
430960;201711;1365;3390;953;2688;202;638;467;1313;669;1951
430965;201711;1510;3993;1213;3477;77;270;949;2624;1026;2894
430970;201711;377;1018;197;627;24;82;89;274;113;356
430975;201711;503;1648;388;1366;90;340;148;518;238;858
430980;201711;368;930;221;670;48;155;80;241;128;396
430990;201711;533;1601;324;1071;53;203;129;412;182;615
430995;201711;621;1727;446;1398;91;285;195;594;286;879
431000;201711;1434;3538;648;1951;109;355;32;83;141;438
431010;201711;2288;6293;1327;4452;213;794;104;302;317;1096
431020;201711;9145;21602;5828;16207;1399;4161;1615;4268;3014;8429
431030;201711;322;907;138;481;33;110;15;59;48;169
431033;201711;2530;7451;2042;6670;535;1827;754;2585;1289;4412
431036;201711;212;556;63;201;5;9;16;47;21;56
431040;201711;900;2435;612;1910;115;426;280;804;395;1230
431041;201711;470;1135;377;996;64;176;207;542;271;718
431043;201711;436;1139;222;737;77;251;59;195;136;446
431046;201711;130;347;65;189;7;21;14;38;21;59
431050;201711;1559;3917;1102;3171;237;694;524;1513;761;2207
431053;201711;498;1535;379;1286;114;407;87;300;201;707
431055;201711;641;1670;570;1560;53;150;416;1130;469;1280
431057;201711;282;826;146;484;29;106;43;126;72;232
431060;201711;4957;14480;4071;12837;1318;4519;826;2737;2144;7256
431065;201711;496;1371;336;1066;64;210;85;267;149;477
431070;201711;574;1680;320;1072;88;316;45;116;133;432
431075;201711;212;665;156;548;31;118;52;189;83;307
431080;201711;654;1889;452;1446;87;287;145;456;232;743
431085;201711;690;1914;523;1541;82;238;307;897;389;1135
431087;201711;479;1380;404;1219;29;87;276;845;305;932
431090;201711;473;1158;184;580;36;125;42;129;78;254
431100;201711;3085;8049;2433;7015;570;1798;906;2557;1476;4355
431110;201711;1426;3546;1018;2779;263;741;384;996;647;1737
431112;201711;513;1638;452;1516;100;341;230;758;330;1099
431113;201711;398;1152;325;1012;104;337;109;352;213;689
431115;201711;1220;3477;967;3033;168;594;529;1602;697;2196
431120;201711;2477;7371;1814;5989;584;2182;458;1369;1042;3551
431123;201711;406;1163;264;861;64;202;114;385;178;587
431125;201711;1225;3673;856;2867;285;961;211;785;496;1746
431127;201711;272;749;60;201;8;20;12;32;20;52
431130;201711;3169;9053;2178;7057;491;1683;678;2219;1169;3902
431140;201711;4691;11498;2586;7598;371;1179;883;2301;1254;3480
431142;201711;481;1379;379;1193;60;199;225;702;285;901
431150;201711;985;2871;728;2334;174;575;267;855;441;1430
431160;201711;731;2066;573;1751;125;369;211;699;336;1068
431162;201711;504;1227;223;698;30;107;50;141;80;248
431164;201711;172;460;48;166;10;41;6;20;16;61
431170;201711;628;1700;416;1293;118;383;108;328;226;711
431171;201711;688;1866;583;1687;94;287;319;903;413;1190
431173;201711;426;1211;323;1026;126;425;67;212;193;637
431175;201711;907;2475;662;2025;178;555;136;402;314;957
431177;201711;710;2218;518;1850;157;591;181;641;338;1232
431179;201711;341;707;72;195;11;32;16;33;27;65
431180;201711;2063;5573;1319;4126;314;1059;252;789;566;1848
431190;201711;506;1381;281;903;44;148;57;148;101;296
431198;201711;332;1072;293;995;100;352;91;335;191;687
431200;201711;388;1058;99;331;11;28;1;3;12;31
431205;201711;236;681;101;364;24;89;41;149;65;238
431210;201711;669;1778;560;1613;153;420;267;809;420;1229
431213;201711;228;705;178;610;21;83;100;342;121;425
431215;201711;281;864;190;636;22;83;72;224;94;307
431217;201711;156;455;98;333;17;60;44;145;61;205
431220;201711;714;1949;401;1294;36;137;171;503;207;640
431225;201711;1273;3459;983;2929;180;540;467;1412;647;1952
431230;201711;699;2075;519;1625;90;302;244;749;334;1051
431235;201711;131;361;30;92;7;22;2;4;9;26
431237;201711;421;1243;336;1105;61;234;169;536;230;770
431238;201711;21;65;17;55;6;21;5;12;11;33
431240;201711;3586;10109;2943;9005;707;2405;1226;3613;1933;6018
431242;201711;354;1044;292;921;71;217;118;387;189;604
431244;201711;324;785;170;486;25;89;57;124;82;213
431245;201711;1087;2868;741;2167;147;475;309;869;456;1344
431247;201711;211;597;118;387;22;71;28;89;50;160
431250;201711;1337;4122;1110;3774;253;880;492;1755;745;2635
431260;201711;298;804;144;495;15;68;42;129;57;197
431261;201711;267;877;222;773;42;156;88;298;130;454
431262;201711;405;1159;167;585;17;57;85;301;102;358
431265;201711;1335;3277;590;1773;93;299;178;444;271;743
431267;201711;277;770;156;460;6;23;101;274;107;297
431270;201711;2613;6329;1445;4309;402;1294;390;1199;792;2493
431275;201711;195;578;101;363;24;91;13;37;37;128
431280;201711;266;740;81;281;7;24;11;20;18;44
431290;201711;300;898;216;725;24;98;77;228;101;326
431295;201711;76;213;28;94;3;14;7;19;10;33
431300;201711;355;850;52;186;2;6;7;19;9;25
431301;201711;248;764;66;238;7;20;5;11;12;31
431303;201711;641;1658;360;1090;41;145;130;388;171;533
431306;201711;2091;5213;1245;3713;163;552;447;1231;610;1783
431308;201711;29;99;26;87;14;50;6;19;20;69
431310;201711;625;1808;364;1194;61;208;116;390;177;598
431320;201711;625;1776;313;1092;61;228;51;167;112;395
431330;201711;2056;5050;1030;3172;254;892;154;410;408;1302
431333;201711;352;954;129;392;15;42;34;93;49;135
431335;201711;37;110;24;84;9;30;3;3;12;33
431337;201711;2505;7193;1723;5734;491;1790;306;975;797;2765
431339;201711;493;1331;339;1017;69;224;173;510;242;734
431340;201711;20171;53139;14523;43243;3231;10522;4152;11929;7383;22451
431342;201711;509;1213;380;1011;61;200;267;672;328;872
431344;201711;360;978;236;737;12;43;154;477;166;520
431346;201711;274;689;98;303;14;43;21;66;35;109
431349;201711;739;2036;418;1280;65;208;143;405;208;613
431350;201711;3818;10847;2937;9211;733;2503;981;2992;1714;5495
431360;201711;646;1582;380;1120;77;240;152;431;229;671
431365;201711;1608;4469;1344;4048;150;497;893;2706;1043;3203
431370;201711;4267;11704;3315;10087;812;2629;1369;4344;2181;6973
431380;201711;749;2270;662;2116;82;287;405;1298;487;1585
431390;201711;2370;6212;1377;4304;252;893;424;1200;676;2093
431395;201711;1249;3526;932;3001;237;772;367;1218;604;1990
431400;201711;384;1159;187;618;29;91;45;150;74;241
431402;201711;995;2405;653;1800;112;327;361;948;473;1275
431403;201711;165;479;136;429;25;100;81;235;106;335
431405;201711;3899;10915;3248;9918;480;1663;1901;5714;2381;7377
431406;201711;519;1595;420;1412;102;340;218;744;320;1084
431407;201711;465;1320;312;1007;66;218;118;372;184;590
431410;201711;13596;37970;9007;28979;2115;7667;2363;7228;4478;14895
431413;201711;175;442;55;174;3;11;9;19;12;30
431415;201711;643;1772;421;1374;98;365;131;369;229;734
431417;201711;477;1205;380;1055;65;192;223;606;288;798
431420;201711;1245;3296;1066;3009;221;632;473;1404;694;2036
431430;201711;516;1345;295;900;53;177;79;220;132;397
431440;201711;21082;55820;16180;47761;4315;13548;4510;13966;8825;27514
431442;201711;103;314;61;212;12;39;3;9;15;48
431445;201711;475;1349;162;531;27;83;35;110;62;193
431446;201711;380;1115;261;832;80;256;60;190;140;446
431447;201711;611;1692;414;1294;90;287;178;546;268;833
431449;201711;728;1964;506;1505;51;162;249;737;300;899
431450;201711;2024;4643;1722;4229;152;414;1305;3104;1457;3518
431454;201711;56;178;48;157;9;30;19;67;28;97
431455;201711;660;1657;334;943;49;153;137;335;186;488
431460;201711;2855;7723;2280;6611;617;1822;735;2178;1352;4000
431470;201711;1626;4634;1171;3649;235;763;433;1346;668;2109
431475;201711;211;614;29;113;3;14;1;1;4;15
431477;201711;578;1489;358;1033;45;132;171;447;216;579
431478;201711;277;727;76;230;14;49;7;17;21;66
431480;201711;3022;7965;2367;6924;349;1146;1348;3877;1697;5023
431490;201711;94081;247488;79812;225953;8774;28528;55721;154035;64495;182563
431500;201711;497;1335;374;1090;80;227;195;559;275;786
431505;201711;438;1080;283;823;28;79;164;475;192;554
431507;201711;342;813;144;409;33;110;56;139;89;249
431510;201711;1677;4644;1221;3726;250;824;458;1377;708;2201
431513;201711;306;767;150;448;19;52;85;252;104;304
431514;201711;87;244;42;139;7;28;13;34;20;62
431515;201711;571;1520;369;1120;74;247;165;461;239;708
431517;201711;75;243;56;187;9;26;13;42;22;68
431520;201711;480;1186;199;640;41;147;46;140;87;287
431530;201711;4090;9266;2517;7010;711;2033;381;1076;1092;3109
431531;201711;208;596;148;476;17;61;47;149;64;210
431532;201711;509;1358;379;1086;85;245;137;397;222;642
431535;201711;255;616;108;328;24;83;44;118;68;201
431540;201711;1926;6306;1779;6071;104;430;1322;4554;1426;4984
431545;201711;373;1022;69;226;6;28;18;53;24;81
431550;201711;1975;5649;1654;5032;382;1241;675;1976;1057;3217
431555;201711;659;1564;442;1205;45;128;273;751;318;879
431560;201711;19237;53452;13242;42828;2824;10001;3394;11714;6218;21715
431570;201711;5381;13160;4174;11548;859;2562;2226;6044;3085;8606
431575;201711;161;504;134;441;25;81;16;45;41;126
431580;201711;508;1394;263;886;46;189;90;292;136;481
431590;201711;853;2242;544;1639;113;353;187;569;300;922
431595;201711;369;1034;250;770;37;103;123;370;160;473
431600;201711;1686;4466;1212;3689;332;1120;288;876;620;1996
431610;201711;1348;3727;960;2961;125;382;465;1468;590;1850
431620;201711;518;1454;227;699;46;139;107;315;153;454
431630;201711;1242;3324;637;2013;177;572;162;475;339;1047
431640;201711;6016;16251;5409;15390;876;2540;3503;10086;4379;12626
431642;201711;500;1313;332;974;36;102;146;418;182;520
431643;201711;353;908;152;444;21;58;47;122;68;180
431645;201711;1629;4408;1320;3887;213;667;809;2392;1022;3059
431647;201711;157;441;95;301;13;48;22;57;35;105
431650;201711;249;752;175;588;30;112;50;157;80;269
431660;201711;967;2635;541;1772;88;324;122;331;210;655
431670;201711;1124;2853;827;2349;143;475;382;1014;525;1489
431673;201711;250;675;96;341;24;81;10;31;34;112
431675;201711;667;1695;131;446;13;51;36;110;49;161
431680;201711;7941;21692;6028;18000;1607;4999;1917;5821;3524;10820
431690;201711;18903;51681;14428;43780;3826;12152;4483;14186;8309;26338
431695;201711;137;374;91;290;22;74;30;73;52;147
431697;201711;468;1216;389;1084;77;212;189;551;266;763
431700;201711;1426;3930;1219;3553;199;574;661;1913;860;2487
431710;201711;10897;30623;8944;27630;2578;8390;3038;10137;5616;18527
431720;201711;6040;16427;4265;12806;1052;3334;816;2273;1868;5607
431725;201711;32;93;20;68;3;12;7;23;10;35
431730;201711;3441;9426;2581;7981;705;2373;771;2535;1476;4908
431740;201711;4700;12388;3447;10171;1093;3585;594;1520;1687;5105
431750;201711;7457;20873;6404;19176;1402;4530;2982;9024;4384;13554
431755;201711;323;888;69;252;11;44;14;50;25;94
431760;201711;4195;10987;3197;9307;442;1482;1801;4962;2243;6444
431770;201711;1818;4731;1485;4235;212;645;950;2668;1162;3313
431775;201711;200;545;103;327;26;89;8;20;34;109
431780;201711;1929;5201;1386;4144;307;956;442;1272;749;2228
431790;201711;1005;2891;738;2327;148;501;261;791;409;1292
431795;201711;297;794;169;512;35;104;45;131;80;235
431800;201711;7181;20313;5517;17231;1837;6249;638;2063;2475;8312
431805;201711;321;767;97;317;8;30;32;105;40;135
431810;201711;3067;7924;2122;6115;425;1356;868;2361;1293;3717
431820;201711;2207;6571;1889;6004;382;1299;828;2634;1210;3933
431830;201711;9592;22481;7252;19103;1727;4936;2962;7853;4689;12789
431840;201711;2326;6830;1971;6190;403;1313;1037;3300;1440;4613
431842;201711;706;1773;243;765;31;114;65;182;96;296
431843;201711;311;882;245;750;30;99;114;333;144;432
431844;201711;267;720;76;246;19;70;14;34;33;104
431845;201711;482;1344;345;1047;19;54;217;650;236;704
431846;201711;271;801;228;737;19;89;176;554;195;643
431848;201711;190;504;98;313;7;26;14;35;21;61
431849;201711;445;1063;73;209;9;28;12;27;21;55
431850;201711;4126;11927;3403;10393;790;2589;1105;3294;1895;5883
431860;201711;721;1898;474;1404;96;294;219;614;315;908
431861;201711;115;316;50;172;7;28;12;34;19;62
431862;201711;472;1544;384;1380;75;294;185;669;260;963
431870;201711;16669;47314;13528;41631;2699;9227;5852;17559;8551;26786
431880;201711;3709;10564;2957;9154;631;2198;1182;3511;1813;5709
431890;201711;4416;11793;2953;9005;896;2933;460;1464;1356;4397
431900;201711;1045;2779;632;1957;137;479;279;806;416;1285
431910;201711;821;2018;344;1008;50;139;93;255;143;394
431912;201711;440;1304;369;1167;75;237;198;637;273;874
431915;201711;1021;2797;787;2390;160;534;393;1159;553;1693
431920;201711;1182;3157;988;2848;89;265;753;2172;842;2437
431930;201711;815;2289;558;1832;140;429;261;897;401;1326
431935;201711;55;180;44;157;11;40;10;33;21;73
431936;201711;306;903;182;608;48;168;47;152;95;320
431937;201711;227;607;133;406;35;114;22;55;57;169
431940;201711;2292;6083;1433;4326;303;994;439;1226;742;2220
431950;201711;1515;4435;1294;4066;256;842;653;2037;909;2879
431960;201711;2658;7302;2170;6330;585;1784;628;1793;1213;3577
431970;201711;398;1074;175;584;43;149;43;131;86;280
431971;201711;83;229;48;165;8;24;7;23;15;47
431973;201711;456;1518;388;1385;35;123;274;991;309;1114
431975;201711;104;238;23;79;4;15;3;7;7;22
431980;201711;1183;3361;932;2900;218;708;352;1070;570;1778
431990;201711;5954;15693;3915;12436;753;2655;1105;3490;1858;6145
432000;201711;9472;25887;7487;22378;2225;6783;2712;8212;4937;14995
432010;201711;1898;5216;1499;4489;192;646;801;2313;993;2959
432020;201711;1944;4722;1413;3904;355;1061;686;1806;1041;2867
432023;201711;487;1279;281;861;41;155;137;362;178;517
432026;201711;1028;3097;764;2529;164;523;379;1253;543;1776
432030;201711;335;909;212;646;44;134;99;287;143;421
432032;201711;469;1249;309;923;33;113;147;406;180;519
432035;201711;760;2258;670;2109;218;743;218;685;436;1428
432040;201711;895;2151;421;1295;72;237;137;411;209;648
432045;201711;241;670;131;442;29;107;36;125;65;232
432050;201711;533;1468;440;1300;114;343;180;544;294;887
432055;201711;835;2232;547;1682;148;501;195;578;343;1079
432057;201711;346;860;242;671;39;89;119;316;158;405
432060;201711;485;1200;159;520;27;110;52;146;79;256
432065;201711;236;658;164;509;42;140;52;152;94;292
432067;201711;788;2389;627;2026;111;338;327;1061;438;1399
432070;201711;2175;5833;1335;4141;261;870;282;827;543;1697
432080;201711;3593;9754;2942;8624;793;2558;1121;3224;1914;5782
432085;201711;332;907;223;727;74;224;94;318;168;542
432090;201711;1335;3699;1011;3085;260;864;403;1183;663;2047
432100;201711;1197;3381;505;1727;87;326;37;95;124;421
432110;201711;2261;6561;1572;5163;365;1411;119;348;484;1759
432120;201711;3404;9986;2793;8877;955;3242;606;1933;1561;5175
432130;201711;2605;6972;2125;6358;757;2418;756;2299;1513;4717
432132;201711;284;792;139;473;22;75;42;134;64;209
432135;201711;758;2109;573;1723;85;277;366;1067;451;1344
432140;201711;1625;5134;1260;4430;241;874;583;2114;824;2988
432143;201711;1295;3697;1046;3279;161;549;575;1803;736;2352
432145;201711;1275;3800;801;2675;136;495;126;369;262;864
432146;201711;142;437;95;325;30;106;17;55;47;161
432147;201711;382;1278;310;1125;96;368;63;229;159;597
432149;201711;382;1036;233;696;30;94;102;292;132;386
432150;201711;3269;9072;2399;7405;571;1976;653;1936;1224;3912
432160;201711;4201;12764;3510;11582;1060;3721;1047;3457;2107;7178
432162;201711;354;839;52;156;9;25;6;18;15;43
432163;201711;256;696;55;175;5;16;3;11;8;27
432166;201711;576;1710;459;1457;86;315;146;393;232;708
432170;201711;1205;3562;810;2755;181;675;172;561;353;1236
432180;201711;2411;6353;1330;4140;276;933;276;748;552;1681
432183;201711;345;1087;253;864;81;297;47;160;128;457
432185;201711;829;2216;550;1693;51;162;327;979;378;1141
432190;201711;2431;6450;1559;4679;366;1181;532;1509;898;2690
432195;201711;1004;2643;672;2065;179;514;206;650;385;1164
432200;201711;2664;7729;2082;6731;506;1737;895;2945;1401;4682
432210;201711;375;1042;257;828;51;187;103;312;154;499
432215;201711;730;2239;640;2084;91;295;400;1351;491;1646
432218;201711;246;634;139;401;19;53;48;128;67;181
432220;201711;3925;9990;3008;8489;467;1520;1685;4521;2152;6041
432225;201711;102;304;73;246;14;43;30;102;44;145
432230;201711;814;2114;459;1376;81;262;123;329;204;591
432232;201711;456;1164;337;968;53;177;169;481;222;658
432234;201711;287;754;149;458;36;103;23;58;59;161
432235;201711;102;295;38;132;6;22;3;9;9;31
432237;201711;406;1086;354;996;14;49;243;650;257;699
432240;201711;13056;38579;10837;35436;1143;4484;6674;22675;7817;27159
432250;201711;4156;13917;3712;13014;1156;4231;1256;4588;2412;8819
432252;201711;423;1067;276;811;45;153;123;338;168;491
432253;201711;1202;3772;667;2341;158;625;29;78;187;703
432254;201711;787;2082;192;630;34;132;18;49;52;181
432255;201711;186;452;86;266;10;34;31;81;41;115
432260;201711;6206;15781;4435;12731;1079;3232;1619;4815;2698;8047
432270;201711;2178;6413;1815;5721;559;1864;309;986;868;2850
432280;201711;1230;3244;630;1977;103;325;202;608;305;933
432285;201711;189;586;21;75;2;5;1;1;3;6
432290;201711;407;1226;247;844;60;206;63;196;123;402
432300;201711;22186;63922;19018;58494;3033;10253;11216;33848;14249;44101
432310;201711;698;2060;546;1792;121;395;271;900;392;1295
432320;201711;227;548;78;243;10;38;15;45;25;83
432330;201711;272;693;90;294;12;31;17;60;29;91
432335;201711;171;489;69;251;16;64;11;33;27;97
432340;201711;312;753;154;473;29;105;45;122;74;227
432345;201711;604;1537;549;1461;45;158;389;987;434;1145
432350;201711;357;965;182;599;32;96;52;165;84;261
432360;201711;199;606;37;132;8;35;7;18;15;53
432370;201711;376;1011;254;768;20;69;159;477;179;546
432375;201711;602;1533;445;1256;67;190;253;707;320;897
432377;201711;226;743;29;108;3;14;8;19;11;33
432380;201711;1220;3610;788;2665;178;689;336;1071;514;1760
500020;201711;2153;6000;1661;5188;369;1308;731;2197;1100;3505
500025;201711;1290;2983;772;2108;64;179;448;1194;512;1373
500060;201711;6357;19023;4993;16569;721;2430;2968;10319;3689;12749
500070;201711;4078;11409;3110;9716;676;2310;1207;3903;1883;6213
500080;201711;1306;3702;919;3005;218;808;340;1080;558;1888
500085;201711;1958;4904;1351;4000;174;535;785;2308;959;2843
500090;201711;2017;5641;1385;4504;269;923;527;1815;796;2738
500100;201711;3059;8315;2398;7209;382;1301;1051;2973;1433;4274
500110;201711;6904;19990;5246;17431;1102;3948;1988;7246;3090;11194
500124;201711;2034;6514;1739;6015;421;1407;863;3306;1284;4713
500150;201711;1313;3221;835;2443;180;579;278;739;458;1318
500190;201711;4616;11593;3492;10093;724;2198;1812;5420;2536;7618
500200;201711;2265;5622;1676;4611;329;973;791;2026;1120;2999
500210;201711;4443;12786;3551;11389;880;2950;1553;5070;2433;8020
500215;201711;1231;3710;902;3045;130;489;410;1337;540;1826
500220;201711;2903;8506;2238;7332;375;1319;954;3153;1329;4472
500230;201711;2544;6318;1805;5161;269;807;942;2693;1211;3500
500240;201711;3901;12018;2731;9641;496;2021;722;2717;1218;4738
500260;201711;2969;6838;1838;5157;210;613;952;2606;1162;3219
500270;201711;110403;282564;68831;207580;15488;50194;17102;50600;32590;100794
500280;201711;1283;3302;972;2857;99;325;666;1937;765;2262
500290;201711;4039;9043;2231;6440;352;1123;776;2173;1128;3296
500295;201711;2517;6892;1462;4614;216;735;430;1169;646;1904
500310;201711;825;2038;648;1810;104;282;364;1045;468;1327
500315;201711;3205;9758;2611;8775;348;1176;1615;5684;1963;6860
500320;201711;17081;52587;12726;44537;3611;13670;3549;13227;7160;26897
500325;201711;3777;9162;2582;7388;364;1106;1503;4371;1867;5477
500330;201711;6731;16678;4441;12808;466;1483;2235;6566;2701;8049
500345;201711;1832;4633;1324;3911;349;1043;499;1474;848;2517
500348;201711;2361;6458;1929;5773;204;689;1224;3661;1428;4350
500350;201711;1247;3595;663;2224;74;260;222;768;296;1028
500370;201711;20312;58702;14704;48841;2978;11206;5283;17609;8261;28815
500375;201711;2547;6960;1787;5443;358;1192;530;1598;888;2790
500380;201711;3349;8693;2451;7231;637;1983;913;2747;1550;4730
500390;201711;526;1164;301;826;42;128;152;412;194;540
500400;201711;1203;3514;846;2695;202;673;231;698;433;1371
500410;201711;2218;6172;1771;5496;280;877;1076;3433;1356;4310
500430;201711;2601;6970;1866;5887;339;1212;722;2421;1061;3633
500440;201711;1277;3217;799;2404;134;408;299;950;433;1358
500450;201711;1199;3318;729;2363;152;515;96;256;248;771
500460;201711;3725;10637;2489;8213;588;2126;512;1722;1100;3848
500470;201711;2451;6987;1671;5361;496;1732;325;946;821;2678
500480;201711;2156;6504;1959;6236;144;416;1510;5142;1654;5558
500490;201711;824;2211;578;1805;157;553;146;467;303;1020
500500;201711;3860;11013;2839;9498;976;3745;679;2324;1655;6069
500510;201711;810;2076;506;1523;43;146;259;736;302;882
500515;201711;1964;4964;1579;4424;136;391;1078;3140;1214;3531
500520;201711;3161;10689;2645;9665;512;2077;1333;4828;1845;6905
500525;201711;995;3070;797;2739;139;544;391;1384;530;1928
500540;201711;5357;14249;3074;10050;779;3040;296;868;1075;3908
500560;201711;5053;15549;4326;14452;361;1285;3235;11019;3596;12304
500568;201711;4159;9725;2616;7408;613;2032;746;1970;1359;4002
500570;201711;6941;17511;4046;12226;1022;3310;723;2098;1745;5408
500580;201711;3251;9197;2610;8133;361;1138;1611;5049;1972;6187
500600;201711;3456;8847;2256;6833;467;1565;704;2105;1171;3670
500620;201711;7300;20482;5219;16429;792;2668;2426;7742;3218;10410
500625;201711;543;1556;296;991;60;227;114;362;174;589
500627;201711;729;1921;453;1407;88;259;106;354;194;613
500630;201711;5668;14622;3655;11148;866;2817;1011;3131;1877;5948
500635;201711;2590;9308;2122;8607;205;856;1502;6550;1707;7406
500640;201711;1671;3914;1165;3185;60;188;808;2143;868;2331
500660;201711;17626;50251;13256;43185;4231;15259;3084;10188;7315;25447
500690;201711;2371;6855;1739;5841;825;3047;179;573;1004;3620
500710;201711;3159;9101;2450;7787;641;2190;740;2334;1381;4524
500720;201711;5284;13673;3237;10285;885;3157;598;1869;1483;5026
500730;201711;909;2497;578;1853;121;405;173;559;294;964
500740;201711;4358;11173;3271;9256;258;857;1790;5139;2048;5996
500750;201711;919;2502;724;2140;126;424;324;900;450;1324
500755;201711;1006;2860;641;2134;127;442;106;301;233;743
500769;201711;5066;13053;2691;8323;496;1734;480;1181;976;2915
500770;201711;1641;4552;1059;3450;194;669;335;1103;529;1772
500780;201711;1256;3357;870;2613;213;661;224;649;437;1310
500790;201711;8526;22831;6964;20383;1349;4338;3665;10729;5014;15067
500793;201711;1974;5458;1409;4464;470;1551;207;589;677;2140
500795;201711;2310;6508;1954;6013;189;489;1474;4851;1663;5340
500797;201711;749;1987;504;1547;100;338;177;528;277;866
500800;201711;2777;7054;1965;5851;681;2288;346;1083;1027;3371
500830;201711;17829;46061;12313;36016;2091;6642;5197;14638;7288;21280
500840;201711;1156;3127;738;2302;91;302;285;836;376;1138
510010;201711;1392;3891;1077;3371;255;780;536;1753;791;2533
510020;201711;3363;9037;1924;6151;415;1385;417;1239;832;2624
510025;201711;6855;18941;4486;14413;889;3122;1280;3908;2169;7030
510030;201711;1915;4640;1387;3909;320;914;583;1682;903;2596
510035;201711;1035;2848;678;2290;113;394;388;1380;501;1774
510040;201711;1934;4802;1462;4121;145;414;885;2511;1030;2925
510050;201711;1786;4812;1234;3864;300;1069;539;1556;839;2625
510060;201711;1359;3646;1021;3094;153;498;509;1511;662;2009
510080;201711;1081;3261;830;2777;239;921;176;477;415;1398
510100;201711;679;1726;459;1313;56;166;214;586;270;752
510120;201711;279;549;159;402;8;23;108;273;116;296
510125;201711;2541;6479;1889;5395;313;1109;763;1997;1076;3106
510130;201711;1504;4074;1177;3530;312;995;327;968;639;1963
510140;201711;2780;8279;2107;7368;843;3366;617;1919;1460;5285
510160;201711;1270;4026;1084;3744;217;765;680;2382;897;3147
510170;201711;4630;13451;3553;11569;734;2567;1508;4861;2242;7428
510180;201711;11900;29966;7813;23378;2141;6876;2133;7163;4274;14039
510185;201711;1599;4336;1133;3657;320;1021;490;1889;810;2910
510190;201711;2348;6459;1580;5252;437;1614;540;1822;977;3436
510250;201711;13259;38205;11481;35671;2762;9116;5746;18519;8508;27635
510260;201711;2056;8560;1678;7808;257;1171;969;5117;1226;6288
510263;201711;3352;9308;2208;7186;486;1722;343;1065;829;2787
510267;201711;5406;15590;3443;11287;779;2683;663;2179;1442;4862
510268;201711;1343;3514;935;2784;131;405;522;1514;653;1919
510269;201711;1063;3105;696;2370;238;897;147;441;385;1338
510270;201711;2770;8777;2138;7548;470;1701;778;2695;1248;4396
510279;201711;1729;5077;1330;4284;295;1063;573;1731;868;2794
510285;201711;1178;3282;856;2736;235;799;242;767;477;1566
510300;201711;3489;9367;2740;8341;280;826;1860;5855;2140;6681
510305;201711;1347;4129;979;3406;222;790;319;1202;541;1992
510310;201711;798;2226;597;1886;215;696;172;575;387;1271
510320;201711;3723;10168;2778;8512;481;1646;934;2822;1415;4468
510325;201711;4726;14485;3862;13208;1090;3882;1873;6697;2963;10579
510330;201711;2726;8665;2027;7411;487;1853;709;2871;1196;4724
510335;201711;4900;14411;3777;12875;413;1492;2399;8713;2812;10205
510336;201711;507;1513;389;1306;68;238;185;639;253;877
510337;201711;1760;5552;1298;4697;506;1945;248;934;754;2879
510340;201711;70418;178710;46913;141878;15072;51667;8946;26681;24018;78348
510343;201711;1019;2967;719;2356;143;483;250;786;393;1269
510345;201711;1421;4193;1066;3490;195;647;429;1388;624;2035
510350;201711;2818;7577;1965;6287;499;1683;731;2420;1230;4103
510360;201711;1622;3831;1067;3137;62;242;780;2302;842;2544
510370;201711;1595;4955;1199;4264;205;776;650;2426;855;3202
510380;201711;505;1399;272;917;73;271;35;114;108;385
510385;201711;962;3599;698;3020;80;401;373;1753;453;2154
510390;201711;1066;3298;852;2970;229;808;382;1406;611;2214
510395;201711;735;1759;506;1407;55;165;257;770;312;935
510410;201711;3860;12034;3147;10678;800;2740;1487;5337;2287;8077
510420;201711;2172;5204;1590;4340;165;548;904;2423;1069;2971
510450;201711;596;1529;359;1101;87;284;57;172;144;456
510452;201711;643;1984;458;1589;85;278;223;783;308;1061
510454;201711;832;2515;659;2195;93;334;367;1240;460;1574
510455;201711;932;2787;671;2212;127;473;228;688;355;1161
510460;201711;2105;5371;1512;4524;168;614;868;2479;1036;3093
510480;201711;4144;10354;2923;8229;460;1367;1344;3602;1804;4969
510490;201711;1495;4504;1216;4103;274;973;593;2003;867;2976
510500;201711;1526;4278;971;3226;171;667;393;1277;564;1944
510510;201711;2942;9650;2394;8567;737;2879;603;2298;1340;5177
510515;201711;5909;16297;3858;12378;881;3082;943;2730;1824;5812
510517;201711;1359;3962;1064;3425;316;1094;185;558;501;1652
510520;201711;2020;4374;1283;3445;50;155;790;2260;840;2415
510523;201711;909;2534;757;2268;87;264;498;1520;585;1784
510525;201711;5002;14944;3880;12648;793;2824;1323;3891;2116;6715
510530;201711;530;1388;390;1174;26;121;287;814;313;935
510550;201711;2789;8771;2070;7403;535;2018;666;2426;1201;4444
510558;201711;1892;5358;1582;4921;96;326;1011;3347;1107;3673
510560;201711;1648;4814;995;3621;240;963;234;907;474;1870
510562;201711;5178;14622;3773;11913;994;3401;1064;3481;2058;6882
510590;201711;3140;7987;2325;6922;480;1336;1310;4162;1790;5498
510600;201711;1511;3713;974;2843;240;717;323;966;563;1683
510610;201711;2607;7200;2026;6328;211;751;1232;3797;1443;4548
510615;201711;1912;5513;1532;4924;409;1332;700;2391;1109;3723
510617;201711;791;2376;656;2164;34;94;543;1864;577;1958
510618;201711;1350;3806;972;3081;193;710;457;1355;650;2065
510619;201711;730;1959;415;1368;85;324;63;189;148;513
510620;201711;1312;3246;696;2206;179;639;107;311;286;950
510621;201711;1011;3092;801;2698;179;661;241;792;420;1453
510622;201711;3735;11100;2742;8922;877;3093;588;1801;1465;4894
510623;201711;3117;8181;2251;6734;482;1688;733;2084;1215;3772
510624;201711;1652;4431;733;2503;121;467;101;292;222;759
510625;201711;1948;5204;1373;4236;371;1313;228;688;599;2001
510626;201711;1540;3890;955;3031;271;958;194;638;465;1596
510627;201711;592;1614;398;1229;111;363;98;303;209;666
510628;201711;1525;3601;1005;2890;190;542;558;1673;748;2215
510629;201711;1565;4942;1222;4196;331;1229;400;1418;731;2647
510630;201711;2877;8942;1860;6834;431;1710;307;1214;738;2924
510631;201711;421;1149;324;989;4;8;245;768;249;776
510637;201711;2910;7780;2255;6727;679;2264;728;2109;1407;4373
510642;201711;4827;15103;3945;13789;1139;4310;1584;5788;2723;10098
510645;201711;898;1979;555;1530;155;428;171;494;326;922
510650;201711;6163;18859;5459;18023;919;3107;3857;13254;4776;16361
510665;201711;1727;4358;1045;3145;203;665;363;1121;566;1786
510670;201711;387;836;208;570;21;70;113;317;134;387
510675;201711;5901;17570;4484;14864;1250;4457;952;3152;2202;7609
510677;201711;1989;5209;1468;4494;198;646;904;2846;1102;3492
510680;201711;667;1952;460;1535;111;371;62;204;173;575
510682;201711;1845;5805;1368;4904;384;1493;295;1072;679;2565
510685;201711;873;2374;652;1995;94;321;318;910;412;1231
510700;201711;3874;9938;2577;8061;623;1971;1168;3839;1791;5810
510704;201711;9471;24372;6461;18996;1271;4079;2332;6548;3603;10627
510706;201711;1958;5627;1267;4577;253;975;613;2411;866;3386
510710;201711;2713;7370;1861;5660;382;1186;647;1877;1029;3063
510715;201711;707;1680;487;1316;73;198;189;515;262;713
510718;201711;2489;5591;1400;4291;593;1882;246;978;839;2860
510719;201711;378;855;232;658;34;117;120;334;154;451
510720;201711;1019;2563;690;2060;180;601;198;546;378;1147
510724;201711;707;2036;502;1658;101;363;203;633;304;996
510726;201711;728;1593;465;1211;60;177;311;776;371;953
510729;201711;692;1686;343;1033;64;215;89;257;153;472
510730;201711;2930;7814;2037;6266;541;1746;608;1918;1149;3664
510735;201711;929;2862;713;2551;91;360;456;1658;547;2018
510740;201711;1271;3494;912;2922;94;271;582;2025;676;2296
510757;201711;630;2073;516;1860;210;789;173;619;383;1408
510760;201711;33335;79732;20870;60410;6164;19925;4254;11420;10418;31345
510770;201711;4540;10455;3502;9275;355;841;2247;6666;2602;7507
510774;201711;366;1026;280;839;55;157;135;432;190;589
510775;201711;606;1774;462;1521;111;433;82;240;193;673
510776;201711;461;1287;356;1066;85;245;137;427;222;672
510777;201711;1654;4702;1220;4109;101;362;949;3229;1050;3591
510779;201711;582;1687;465;1488;56;156;279;931;335;1087
510780;201711;3479;10016;2760;8900;698;2321;1078;3849;1776;6170
510785;201711;1968;5359;1203;3951;297;1093;171;567;468;1660
510787;201711;2325;6669;1735;5605;790;2679;195;594;985;3273
510788;201711;654;1632;453;1329;79;219;180;636;259;855
510790;201711;14097;39556;9066;29847;2144;8134;1083;3203;3227;11337
510792;201711;8454;23533;5483;17951;1168;4185;1075;3435;2243;7620
510794;201711;1167;3509;840;2881;252;957;186;574;438;1531
510795;201711;7841;22435;5575;18281;1505;5401;1087;3687;2592;9088
510800;201711;1539;4107;1126;3496;234;755;510;1531;744;2286
510805;201711;1870;5144;1281;4076;256;873;484;1414;740;2287
510810;201711;639;1469;459;1230;109;304;233;601;342;905
510820;201711;796;1665;448;1205;63;208;187;480;250;688
510830;201711;719;1941;532;1658;109;332;266;880;375;1212
510835;201711;598;1644;419;1333;65;223;192;584;257;807
510840;201711;40837;101182;32034;89616;7099;19963;15712;46458;22811;66421
510850;201711;1677;4316;1001;3160;316;1133;187;529;503;1662
510860;201711;2670;7803;1803;6214;609;2373;179;603;788;2976
510880;201711;577;1860;477;1670;125;470;213;755;338;1225
510885;201711;572;1539;425;1326;79;291;157;461;236;752
510890;201711;710;2153;586;1979;110;408;325;1111;435;1519
510895;201711;1221;3431;895;2856;226;805;302;877;528;1682
520005;201711;1852;5322;1524;4898;454;1391;681;2452;1135;3843
520010;201711;2092;6547;1521;5325;520;2057;263;802;783;2859
520013;201711;2814;7832;2053;6312;476;1523;600;1948;1076;3471
520015;201711;518;1418;402;1255;114;376;114;385;228;761
520017;201711;1036;3003;840;2677;197;671;398;1247;595;1918
520020;201711;372;941;298;839;77;236;155;418;232;654
520025;201711;31028;90292;27725;86136;3317;11062;20166;62711;23483;73773
520030;201711;4845;13995;3935;12514;541;1846;2225;7154;2766;9000
520050;201711;441;1097;271;779;21;50;153;461;174;511
520055;201711;862;2538;712;2255;100;306;382;1231;482;1537
520060;201711;1379;4106;1100;3585;277;1006;297;934;574;1940
520080;201711;1817;4953;1437;4440;262;777;729;2455;991;3232
520082;201711;1047;2684;907;2453;110;242;571;1603;681;1845
520085;201711;707;2107;601;1930;149;465;198;620;347;1085
520090;201711;843;1892;600;1586;112;264;349;994;461;1258
520110;201711;38124;107607;28328;92197;10168;37630;1991;5948;12159;43578
520120;201711;185;465;106;330;10;33;40;124;50;157
520130;201711;3453;9337;3019;8660;656;1996;1558;4594;2214;6590
520140;201711;34013;104164;27633;92382;10115;36807;3080;10497;13195;47304
520145;201711;417;1098;288;880;68;221;93;262;161;483
520150;201711;509;1277;401;1147;69;201;230;658;299;859
520160;201711;817;2079;647;1823;125;354;277;800;402;1154
520170;201711;4767;10273;3578;8941;229;612;2980;7520;3209;8132
520180;201711;2092;5949;1734;5419;414;1412;754;2318;1168;3730
520215;201711;1916;4754;1469;4058;294;920;726;1938;1020;2858
520235;201711;655;1609;441;1287;59;188;172;482;231;670
520250;201711;1540;4156;1099;3458;298;1028;192;613;490;1641
520260;201711;798;1972;498;1436;79;237;200;578;279;815
520280;201711;599;1662;493;1465;152;438;193;626;345;1064
520310;201711;1227;2849;822;2211;216;599;283;829;499;1428
520320;201711;1855;5486;1521;4883;162;546;863;2833;1025;3379
520330;201711;3037;9159;2270;7802;550;2108;718;2453;1268;4561
520340;201711;2023;4901;1470;4103;175;437;978;2862;1153;3299
520350;201711;3055;7955;2267;6579;659;2067;736;2052;1395;4119
520355;201711;1597;4532;1290;4047;332;1139;540;1689;872;2828
520357;201711;811;2082;641;1827;48;145;442;1275;490;1420
520360;201711;696;1914;549;1668;178;570;162;506;340;1076
520380;201711;1317;3447;819;2479;112;377;357;981;469;1358
520390;201711;963;2258;563;1724;185;643;138;396;323;1039
520393;201711;532;1272;393;1063;46;124;194;492;240;616
520396;201711;756;2222;642;2018;109;346;411;1287;520;1633
520400;201711;1453;4026;1210;3685;241;761;705;2166;946;2927
520410;201711;1630;3665;1077;2903;139;402;655;1762;794;2164
520420;201711;358;931;263;734;26;85;177;461;203;546
520425;201711;1296;3283;898;2605;240;712;378;1114;618;1826
520430;201711;2065;5150;1142;3528;210;706;77;239;287;945
520440;201711;3422;8589;2237;6511;624;1946;529;1524;1153;3470
520450;201711;10946;28735;7439;22696;2264;7532;462;1458;2726;8990
520455;201711;678;1939;519;1688;184;653;135;442;319;1095
520460;201711;911;2573;771;2365;109;333;526;1650;635;1983
520465;201711;836;2264;696;2038;111;369;438;1219;549;1588
520470;201711;1780;5457;1539;5115;332;1120;946;3312;1278;4432
520480;201711;799;2324;516;1807;113;445;86;276;199;721
520485;201711;1457;4275;1227;3955;167;592;838;2696;1005;3288
520490;201711;3758;11275;2957;10016;699;2350;1504;5277;2203;7627
520495;201711;1394;3445;1139;3113;76;221;851;2401;927;2622
520500;201711;1281;3576;1026;3182;244;849;420;1254;664;2103
520505;201711;711;1830;520;1564;120;348;250;757;370;1105
520510;201711;6753;18758;5014;16014;1217;4330;1407;4566;2624;8896
520520;201711;1063;2773;812;2417;249;734;259;859;508;1593
520530;201711;1825;5928;1459;5287;549;1971;336;1430;885;3401
520540;201711;2651;7196;1788;5559;451;1433;357;1173;808;2606
520545;201711;987;2816;780;2457;154;511;262;806;416;1317
520547;201711;666;2009;542;1782;155;518;195;622;350;1140
520549;201711;10341;30070;8533;27275;1969;6486;4242;13903;6211;20389
520551;201711;3973;11573;3458;10811;556;1977;2258;6925;2814;8902
520552;201711;723;2099;648;2005;88;264;461;1472;549;1736
520570;201711;584;1521;420;1265;110;343;143;441;253;784
520580;201711;2786;6463;1958;5388;255;737;1204;3377;1459;4114
520590;201711;1321;3731;975;3102;216;714;206;673;422;1387
520620;201711;7962;22446;6545;20497;1823;5954;2819;8997;4642;14951
520630;201711;1006;2523;655;1943;104;313;236;676;340;989
520640;201711;2510;6641;1997;5782;450;1322;832;2458;1282;3780
520650;201711;876;2226;613;1765;98;297;324;945;422;1242
520660;201711;441;1070;252;762;67;222;51;170;118;392
520670;201711;951;2779;825;2585;65;219;625;1931;690;2150
520680;201711;746;1940;562;1648;123;355;250;755;373;1110
520690;201711;338;829;228;668;68;206;71;221;139;427
520710;201711;561;1416;357;1038;13;34;226;642;239;676
520725;201711;1529;3792;1121;3119;138;456;729;1972;867;2428
520735;201711;795;2077;550;1635;108;327;190;574;298;901
520740;201711;1788;4501;1448;4078;240;669;852;2466;1092;3135
520750;201711;681;1727;517;1483;102;271;235;724;337;995
520753;201711;1447;3744;1256;3451;163;415;752;2150;915;2565
520760;201711;984;2334;882;2203;98;195;692;1827;790;2022
520780;201711;1746;4288;1311;3655;148;432;723;1955;871;2387
520790;201711;3073;7583;2255;6348;176;462;1541;4545;1717;5007
520800;201711;15345;41678;12878;38644;2460;7146;7936;25308;10396;32454
520810;201711;1239;2810;914;2437;151;451;515;1436;666;1887
520815;201711;628;1922;452;1544;141;533;66;242;207;775
520830;201711;1668;4022;1258;3543;67;140;997;2822;1064;2962
520840;201711;1880;5683;1599;5269;639;2223;417;1492;1056;3715
520850;201711;630;1758;433;1450;115;438;106;354;221;792
520860;201711;6249;17956;4831;15662;1136;3986;1736;5771;2872;9757
520870;201711;85377;219028;61562;182526;18275;59036;14745;42864;33020;101900
520880;201711;6278;17994;4927;15953;1705;5993;1014;3263;2719;9256
520890;201711;3823;10071;2842;8476;628;2110;1211;3530;1839;5640
520910;201711;3892;10310;2583;8030;821;2784;453;1388;1274;4172
520915;201711;649;1853;482;1508;93;316;189;579;282;895
520920;201711;3904;9817;2661;8004;409;1376;1242;3791;1651;5167
520929;201711;655;1696;497;1412;87;202;259;815;346;1017
520940;201711;1116;3060;879;2723;70;233;662;2064;732;2297
520945;201711;570;1313;444;1106;51;115;290;707;341;822
520960;201711;983;2724;779;2373;144;465;383;1148;527;1613
520970;201711;2424;7287;2054;6615;596;2104;471;1556;1067;3660
520980;201711;744;2038;622;1849;154;505;262;769;416;1274
520990;201711;2886;9020;2640;8653;345;1208;1679;5667;2024;6875
520993;201711;944;2344;689;1928;36;101;488;1376;524;1477
520995;201711;2175;5793;1806;5299;425;1259;847;2525;1272;3784
521000;201711;7167;20733;5557;17675;1708;5778;1335;4253;3043;10031
521010;201711;3892;10626;2957;9000;499;1505;1482;4524;1981;6029
521015;201711;658;1736;567;1592;78;222;400;1118;478;1340
521020;201711;2861;7903;1854;5848;516;1758;200;602;716;2360
521030;201711;596;1439;429;1176;61;148;203;596;264;744
521040;201711;6752;17304;5329;15120;1611;4802;1845;5439;3456;10241
521056;201711;816;2321;642;2028;195;649;177;608;372;1257
521060;201711;996;2570;782;2243;71;210;449;1325;520;1535
521080;201711;1090;2587;589;1752;75;233;218;577;293;810
521090;201711;2959;7796;2220;6689;707;2254;468;1447;1175;3701
521100;201711;1821;4274;1332;3589;235;613;753;2093;988;2706
521120;201711;4661;11377;3479;9869;545;1563;1586;4987;2131;6550
521130;201711;1013;2554;690;1961;47;163;386;1086;433;1249
521140;201711;1118;3116;854;2631;165;538;296;921;461;1459
521150;201711;11380;27589;7385;21236;2205;6887;2285;6748;4490;13635
521160;201711;717;1635;477;1261;88;262;226;559;314;821
521170;201711;1085;2640;792;2183;85;248;502;1328;587;1576
521180;201711;5963;18412;5181;16994;1243;4330;1914;6376;3157;10706
521190;201711;9350;25455;5734;18866;1456;5178;1042;3532;2498;8710
521200;201711;760;1998;567;1676;63;211;310;903;373;1114
521205;201711;610;1632;468;1396;36;116;321;934;357;1050
521210;201711;815;2217;470;1475;114;400;66;164;180;564
521220;201711;4151;10219;2876;8361;610;1879;1071;3081;1681;4960
521225;201711;344;833;275;755;23;51;208;607;231;658
521230;201711;1249;3586;1143;3410;432;1299;550;1664;982;2963
521250;201711;30046;87722;24766;80008;10414;34634;6759;23614;17173;58248
521260;201711;712;1673;543;1433;93;276;301;787;394;1063
521270;201711;1762;4805;1557;4546;140;305;1212;3698;1352;4003
521280;201711;1855;5336;1446;4581;453;1549;440;1402;893;2951
521290;201711;438;1159;332;1014;62;220;182;543;244;763
521295;201711;1169;2674;936;2382;86;197;710;1895;796;2092
521300;201711;1818;4832;1502;4380;202;584;1013;3028;1215;3612
521305;201711;734;1939;550;1630;88;247;289;875;377;1122
521308;201711;4299;12420;3329;10545;661;2122;1563;5013;2224;7135
521310;201711;8194;22622;5516;17553;1422;4856;1388;4309;2810;9165
521340;201711;357;884;310;822;23;61;248;658;271;719
521350;201711;2081;5369;1644;4716;233;686;1087;3084;1320;3770
521370;201711;1006;2737;638;2078;196;700;64;213;260;913
521375;201711;1395;3828;1063;3342;270;911;396;1290;666;2201
521377;201711;1243;2916;1013;2631;51;135;886;2301;937;2436
521380;201711;5979;16297;4112;12895;509;1667;1050;3438;1559;5105
521385;201711;588;1472;471;1333;114;324;205;625;319;949
521390;201711;720;1935;566;1716;179;603;175;541;354;1144
521400;201711;2069;5296;1694;4868;222;724;1195;3408;1417;4132
521405;201711;1339;3577;1024;3035;234;719;453;1376;687;2095
521410;201711;699;2014;622;1904;148;410;313;1045;461;1455
521440;201711;1411;3886;1079;3248;283;894;264;737;547;1631
521450;201711;3707;11620;2882;9929;811;2916;681;2436;1492;5352
521460;201711;6467;18014;5085;15565;1583;5166;1559;4638;3142;9804
521470;201711;610;1754;413;1314;83;259;89;273;172;532
521480;201711;372;1048;219;730;42;148;64;207;106;355
521483;201711;2539;6531;1870;5369;480;1433;532;1511;1012;2944
521486;201711;1663;4061;1309;3578;85;217;999;2726;1084;2943
521487;201711;461;1212;333;1015;73;231;132;409;205;640
521490;201711;826;2296;624;1943;37;139;423;1285;460;1424
521500;201711;1514;4114;1074;3375;162;606;534;1576;696;2182
521520;201711;797;1827;559;1487;99;269;257;714;356;983
521523;201711;13388;45470;11798;42186;3774;14401;2468;9491;6242;23892
521525;201711;1013;2512;809;2214;88;264;515;1376;603;1640
521530;201711;2101;5546;1276;3933;287;945;290;921;577;1866
521540;201711;876;2294;569;1763;93;358;250;764;343;1122
521550;201711;1434;3624;893;2533;184;567;349;997;533;1564
521560;201711;3591;10867;2738;9699;738;2944;1278;4655;2016;7599
521565;201711;590;1471;490;1342;78;204;317;866;395;1070
521570;201711;4020;10988;2627;8254;587;1997;357;1149;944;3146
521580;201711;550;1320;309;931;48;152;62;190;110;342
521590;201711;611;1611;465;1359;122;413;190;514;312;927
521600;201711;406;1163;262;844;63;198;55;169;118;367
521630;201711;1391;3318;914;2622;222;720;267;722;489;1442
521640;201711;2010;4989;1529;4315;376;1055;679;1971;1055;3026
521645;201711;555;1590;373;1230;85;285;103;329;188;614
521680;201711;1196;3789;957;3289;308;1117;104;361;412;1478
521690;201711;479;1368;432;1289;102;319;221;649;323;968
521710;201711;2905;8038;2110;6619;440;1444;423;1304;863;2748
521720;201711;1971;5348;1519;4538;230;727;808;2337;1038;3064
521730;201711;3699;11392;3006;10057;1072;3946;476;1373;1548;5319
521740;201711;3640;10032;2883;8918;748;2554;1097;3568;1845;6122
521760;201711;13994;42584;11705;38877;3463;12580;3865;13206;7328;25786
521770;201711;2679;7341;1989;6016;666;2171;466;1349;1132;3520
521800;201711;5948;17569;4971;15895;1493;5007;1610;5542;3103;10549
521805;201711;866;1922;593;1540;201;494;218;626;419;1120
521810;201711;725;1751;506;1431;94;288;219;650;313;938
521830;201711;5105;15241;4326;14081;531;1903;2862;9247;3393;11150
521839;201711;682;1826;490;1474;109;360;187;529;296;889
521850;201711;5605;14834;4146;12451;1157;3762;733;2112;1890;5874
521860;201711;1817;4707;1345;3978;244;803;460;1336;704;2139
521870;201711;505;1590;404;1397;94;341;123;403;217;744
521878;201711;685;1919;490;1529;84;296;172;490;256;786
521880;201711;20007;50285;13634;40341;3501;10902;4174;12950;7675;23852
521890;201711;3138;8997;2235;7143;573;1963;310;924;883;2887
521900;201711;1456;3656;954;2904;221;687;312;930;533;1617
521910;201711;1180;2726;816;2293;92;269;496;1469;588;1738
521920;201711;361;1081;274;904;62;234;77;259;139;493
521925;201711;611;1791;480;1552;103;334;138;430;241;764
521930;201711;3691;10657;3009;9587;1012;3271;852;2858;1864;6129
521935;201711;645;1772;520;1530;133;380;219;647;352;1027
521940;201711;1126;2811;834;2418;210;687;384;1078;594;1765
521945;201711;578;1752;483;1583;86;288;237;830;323;1118
521950;201711;611;1525;504;1381;41;116;394;1087;435;1203
521960;201711;670;1920;481;1537;77;258;218;673;295;931
521970;201711;2648;6867;2218;6359;146;374;1815;5397;1961;5771
521971;201711;899;2323;606;1835;134;418;149;447;283;865
521973;201711;1028;2966;854;2688;125;442;480;1492;605;1934
521975;201711;12148;33093;10656;31183;1818;5527;6816;20005;8634;25532
521980;201711;2358;6026;1919;5455;208;523;1444;4194;1652;4717
521990;201711;1160;3256;926;2882;129;405;541;1743;670;2148
522000;201711;2555;7556;1946;6778;200;654;1176;4488;1376;5142
522005;201711;348;847;252;702;76;195;88;264;164;459
522010;201711;3458;9254;2681;8003;889;2770;617;1831;1506;4601
522015;201711;903;2578;718;2266;166;555;280;874;446;1429
522020;201711;5029;12660;3581;10340;886;2671;1488;4316;2374;6987
522026;201711;703;1934;532;1710;85;284;288;978;373;1262
522028;201711;509;1400;374;1110;60;183;164;462;224;645
522040;201711;2518;5808;1808;4921;298;826;1193;3267;1491;4093
522045;201711;15259;47221;11969;40711;3150;11642;2239;7540;5389;19182
522050;201711;1078;3002;749;2380;161;529;240;698;401;1227
522060;201711;2334;6776;1937;6157;337;1118;1083;3518;1420;4636
522068;201711;1665;4915;1440;4643;190;552;1012;3446;1202;3998
522070;201711;615;1745;524;1595;57;232;361;1050;418;1282
522100;201711;547;1520;425;1341;89;300;209;661;298;961
522108;201711;826;2478;685;2248;50;233;518;1632;568;1865
522119;201711;1512;4186;1220;3776;216;676;641;2048;857;2724
522130;201711;353;953;269;838;66;216;132;424;198;640
522140;201711;15810;44382;12229;38037;3929;13063;1915;5831;5844;18894
522145;201711;815;2086;613;1790;148;392;327;1038;475;1430
522150;201711;942;2377;737;2069;212;584;275;808;487;1392
522155;201711;867;2430;731;2218;154;420;369;1191;523;1611
522157;201711;582;1592;490;1456;30;115;358;1038;388;1153
522160;201711;6091;16519;4203;13122;1207;4093;391;1332;1598;5425
522170;201711;2285;6514;1691;5405;577;1959;300;969;877;2928
522180;201711;426;1144;271;872;64;209;49;179;113;388
522185;201711;15307;40969;11962;36665;4244;13799;4093;13503;8337;27302
522190;201711;834;2000;636;1725;121;312;286;829;407;1141
522200;201711;1691;5228;1224;4199;265;951;195;667;460;1618
522205;201711;1394;3564;1086;3115;101;321;764;2204;865;2525
522220;201711;1487;3706;1110;3186;166;440;618;1889;784;2329
522230;201711;1232;3259;1012;2929;169;547;580;1683;749;2230
530010;201711;171359;513168;148641;475052;34258;121510;68477;213320;102735;334830
110001;201710;3173;9998;2640;9103;685;2499;1166;4058;1851;6557
110002;201710;11117;31239;8381;26563;2679;9109;2622;8224;5301;17333
110003;201710;670;2036;510;1711;162;576;93;292;255;868
110004;201710;7805;24063;6212;20905;1916;6807;1210;4445;3126;11252
110005;201710;1944;5565;1405;4593;350;1202;536;1805;886;3007
110006;201710;1610;4753;1046;3552;319;1149;118;397;437;1546
110007;201710;1237;3569;1004;3157;322;1057;343;1262;665;2319
110008;201710;2356;7724;2149;7436;274;877;1655;5981;1929;6858
110009;201710;4058;12072;2985;10297;917;3285;894;3240;1811;6525
110010;201710;5772;19688;4985;18398;1528;5503;2133;8831;3661;14334
110011;201710;6228;18673;5030;16375;1703;5813;1211;3995;2914;9808
110012;201710;13650;37664;10148;31680;2716;8880;2021;6455;4737;15335
110013;201710;5085;15847;4267;14286;1739;5979;871;3176;2610;9155
110014;201710;3556;9920;2795;8649;852;2738;1142;3472;1994;6210
110015;201710;4611;13363;3046;10221;812;2887;413;1387;1225;4274
110018;201710;3375;9252;2289;7470;570;2094;653;2054;1223;4148
110020;201710;63073;167051;45845;143093;10375;34201;18013;59700;28388;93901
110025;201710;4086;11225;3144;9588;520;1698;1844;5494;2364;7192
110026;201710;511;1556;448;1449;133;473;187;598;320;1071
110028;201710;5782;16844;4220;13780;1262;4436;514;1657;1776;6093
110029;201710;1194;3202;864;2702;228;731;366;1158;594;1889
110030;201710;9661;25966;7264;22462;1668;5797;2828;8700;4496;14497
110032;201710;3192;9782;2482;8295;860;2917;606;2039;1466;4956
110033;201710;4357;14106;3676;12825;1330;4680;1036;3986;2366;8666
110034;201710;3234;8597;2502;7555;845;2702;1106;3356;1951;6058
110037;201710;1631;5419;1377;4889;342;1266;639;2250;981;3516
110040;201710;2949;8937;2316;7753;747;2671;644;2074;1391;4745
110045;201710;4507;14291;3905;13455;1298;4813;1551;5338;2849;10151
110050;201710;1583;4908;1265;4289;544;1897;305;1043;849;2940
110060;201710;769;2486;589;2093;209;788;69;269;278;1057
110070;201710;1892;6253;1568;5496;565;2064;392;1334;957;3398
110080;201710;4613;12303;3693;11182;1008;3208;1761;5518;2769;8726
110090;201710;616;1755;439;1429;118;418;187;579;305;997
110092;201710;1144;3600;973;3335;169;640;538;1882;707;2522
110094;201710;3057;9051;2474;8118;849;2889;833;2799;1682;5688
110100;201710;1890;5913;1659;5485;372;1316;853;2809;1225;4125
110110;201710;1555;4720;1221;4203;446;1600;272;1006;718;2606
110120;201710;1477;4569;1114;3800;334;1203;236;805;570;2008
110130;201710;2328;6272;1590;5030;431;1512;477;1493;908;3005
110140;201710;2155;6936;1656;5904;460;1740;389;1335;849;3075
110143;201710;1362;3848;991;3147;341;1099;274;881;615;1980
110145;201710;993;2800;662;2163;158;556;222;721;380;1277
110146;201710;387;1126;298;996;57;181;145;508;202;689
110147;201710;615;1756;425;1383;109;363;155;480;264;843
110148;201710;1005;3051;613;2124;113;420;73;257;186;677
110149;201710;2888;8534;2159;7339;836;2809;660;2423;1496;5232
110150;201710;2097;5993;1683;5405;726;2577;380;1150;1106;3727
110155;201710;700;2187;591;1943;136;474;232;738;368;1212
110160;201710;1605;5146;1275;4445;480;1657;293;1086;773;2743
110170;201710;2170;6133;1584;5038;359;1205;755;2358;1114;3563
110175;201710;1435;4307;1131;3861;181;670;585;2101;766;2771
110180;201710;1107;3189;889;2828;265;819;387;1284;652;2103
120001;201710;2705;8900;2393;8425;499;1778;1403;5192;1902;6970
120005;201710;1666;6693;1542;6478;175;804;1143;4971;1318;5775
120010;201710;4756;15839;4483;15406;620;2060;3231;11461;3851;13521
120013;201710;1996;7904;1901;7767;501;1974;1100;4829;1601;6803
120017;201710;1935;6864;1774;6585;401;1503;973;3880;1374;5383
120020;201710;13767;60040;13183;58921;1576;7478;9752;44661;11328;52139
120025;201710;2327;7892;2194;7702;464;1645;1338;4815;1802;6460
120030;201710;6376;25051;6188;24799;324;1606;5409;21699;5733;23305
120032;201710;1546;7376;1474;7196;125;743;1137;5556;1262;6299
120033;201710;3764;14710;3574;14380;167;856;3118;12528;3285;13384
120034;201710;2177;8742;1978;8391;141;840;1582;6602;1723;7442
120035;201710;3175;13991;3073;13799;237;1216;2537;11492;2774;12708
120038;201710;2529;8857;2371;8569;579;2126;1286;4794;1865;6920
120039;201710;1798;8423;1744;8325;176;1075;1314;6276;1490;7351
120040;201710;39623;139019;36361;133416;7529;29442;20493;76465;28022;105907
120042;201710;3064;12312;2878;11901;172;906;2293;9453;2465;10359
120043;201710;1099;5029;1053;4926;62;352;911;4296;973;4648
120045;201710;4749;15147;4468;14844;226;859;4054;13447;4280;14306
120050;201710;7988;32037;7629;31305;876;3962;5636;23604;6512;27566
120060;201710;7951;34411;7717;33994;607;3214;6337;28098;6944;31312
120070;201710;2662;9549;2535;9313;359;1313;1750;6635;2109;7948
120080;201710;3720;13745;3510;13382;610;2422;2397;9330;3007;11752
130002;201710;3077;12727;2868;12429;120;650;2571;11179;2691;11829
130006;201710;2182;8902;1896;8376;145;771;1447;6392;1592;7163
130008;201710;2310;8771;2113;8414;95;501;1756;7006;1851;7507
130010;201710;3468;10591;3138;10212;90;348;2897;9441;2987;9789
130014;201710;3039;9658;2573;8877;429;1566;1652;5779;2081;7345
130020;201710;2663;10349;2507;10085;134;771;2059;8213;2193;8984
130030;201710;8413;30379;7957;29875;179;507;7489;28657;7668;29164
130040;201710;3790;11500;3254;10802;234;796;2573;8694;2807;9490
130050;201710;6289;25460;5931;24992;232;948;5336;22970;5568;23918
130060;201710;6428;28234;5888;27413;526;3072;4581;21289;5107;24361
130063;201710;4638;18515;4306;18119;163;826;3937;16673;4100;17499
130068;201710;3234;13149;2906;12466;221;1151;2210;9495;2431;10646
130070;201710;7996;26157;7109;25150;391;1290;6188;22443;6579;23733
130080;201710;5711;24146;5244;23506;473;2638;4120;18535;4593;21173
130083;201710;2353;8886;2177;8627;219;1019;1683;6653;1902;7672
130090;201710;2913;9846;2723;9580;64;276;2439;8713;2503;8989
130100;201710;6138;21652;5827;21307;113;391;5564;20538;5677;20929
130110;201710;6685;21147;6175;20541;551;1590;5198;17820;5749;19410
130115;201710;4889;16667;4614;16259;131;467;4073;14504;4204;14971
130120;201710;14610;54733;13646;53481;1384;5618;11000;44033;12384;49651
130130;201710;4259;16110;3945;15689;473;2152;2978;11800;3451;13952
130140;201710;6182;24133;6066;24007;238;1036;5633;22354;5871;23390
130150;201710;3433;13678;3333;13546;113;660;3040;12316;3153;12976
130160;201710;4441;17666;4127;17258;338;1700;3416;14430;3754;16130
130165;201710;2956;11978;2824;11749;122;691;2469;10250;2591;10941
130170;201710;10092;33040;8489;31129;711;2845;6934;25945;7645;28790
130180;201710;3713;12175;3592;12029;53;223;3433;11512;3486;11735
130185;201710;13429;39141;11549;37097;519;1237;10108;33935;10627;35172
130190;201710;16496;57004;14405;54160;1881;7118;10402;40546;12283;47664
130195;201710;2059;8423;1893;8215;89;380;1696;7487;1785;7867
130200;201710;2047;6675;1815;6345;173;597;1399;5038;1572;5635
130210;201710;1390;5346;1259;5191;113;648;997;4029;1110;4677
130220;201710;1982;7862;1820;7574;152;753;1371;5766;1523;6519
130230;201710;3766;17339;3495;16921;352;1965;2797;13743;3149;15708
130240;201710;9534;33188;8348;31496;253;1468;7321;27658;7574;29126
130250;201710;21550;71721;19977;69862;1702;5771;16504;59447;18206;65218
130255;201710;4068;14489;3752;13971;268;1183;3049;11383;3317;12566
130260;201710;228359;727952;202284;685249;61605;222472;83011;284669;144616;507141
130270;201710;7419;30196;6766;29157;803;3657;4999;22211;5802;25868
130280;201710;3376;14037;3231;13870;85;383;3031;13177;3116;13560
130290;201710;11550;41064;10742;40148;220;528;10199;38960;10419;39488
130300;201710;4486;16868;4243;16502;239;1191;3671;14266;3910;15457
130310;201710;5392;19985;4915;19341;388;1580;4056;16252;4444;17832
130320;201710;3009;10791;2746;10427;344;1276;1984;7808;2328;9084
130330;201710;3928;13805;3447;13187;151;785;2997;11440;3148;12225
130340;201710;19075;69941;17436;67965;1575;6064;14490;58122;16065;64186
130350;201710;3561;14047;3409;13825;198;1158;2911;11687;3109;12845
130353;201710;6027;18419;5278;17475;893;2804;3637;12847;4530;15651
130356;201710;4651;16525;4271;15913;497;1957;3063;11687;3560;13644
130360;201710;3268;9553;2849;9114;87;226;2660;8644;2747;8870
130370;201710;5566;21894;5058;21218;195;1103;4361;18364;4556;19467
130380;201710;7385;31080;7122;30682;466;2497;6137;26269;6603;28766
130390;201710;5213;23133;4900;22548;517;2770;3688;16950;4205;19720
130395;201710;2305;7789;2039;7321;240;896;1447;5233;1687;6129
130400;201710;2170;7965;2015;7747;114;471;1780;6912;1894;7383
130406;201710;10693;40211;9636;38770;1775;7401;6584;27030;8359;34431
130410;201710;3962;14659;3490;13828;1038;4322;1662;6797;2700;11119
130420;201710;11020;44730;10315;43776;1193;5463;8116;35008;9309;40471
130423;201710;3642;13202;3370;12843;179;934;2925;11015;3104;11949
130426;201710;2524;10397;2444;10270;96;466;2228;9448;2324;9914
130430;201710;3752;12354;3518;12023;428;1434;2742;9549;3170;10983
130440;201710;3871;13413;3555;13044;114;429;3278;12143;3392;12572
140002;201710;1760;5697;1595;5485;117;489;1253;4264;1370;4753
140005;201710;3335;9226;3190;9072;67;216;3061;8713;3128;8929
140010;201710;48712;138003;39242;124274;9728;32395;15587;52566;25315;84961
140015;201710;3138;9918;2842;9574;164;517;2490;8565;2654;9082
140017;201710;3305;10633;2963;10184;287;981;2213;7966;2500;8947
140020;201710;4696;15094;4147;14347;408;1672;3124;10802;3532;12474
140023;201710;2157;7037;1857;6570;243;890;1297;4694;1540;5584
140028;201710;2043;5566;1812;5264;209;690;1357;3841;1566;4531
140030;201710;3767;11542;3465;11152;404;1187;2696;8921;3100;10108
140040;201710;1856;8290;1778;8184;85;503;1619;7428;1704;7931
140045;201710;2529;9482;2198;9013;398;1588;1446;6295;1844;7883
140047;201710;5720;17359;4939;16127;1131;3753;2552;8869;3683;12622
140050;201710;1402;4291;1208;4003;172;549;807;2755;979;3304
140060;201710;1352;3963;1208;3752;120;362;950;2994;1070;3356
140070;201710;1694;9251;1639;9099;147;1023;1281;7089;1428;8112
150010;201710;38187;105505;35656;102079;1630;5380;30581;87082;32211;92462
150013;201710;1697;4880;1490;4646;143;400;1128;3647;1271;4047
150020;201710;12525;41387;12113;40814;1335;3640;9965;34931;11300;38571
150030;201710;7946;32378;7616;31925;452;1947;6641;28233;7093;30180
150034;201710;4015;11048;3517;10343;266;823;2860;8448;3126;9271
150040;201710;12686;38924;11348;37358;1136;2920;9237;32290;10373;35210
150050;201710;6068;23002;5733;22480;172;888;5147;20229;5319;21117
150060;201710;17991;54469;15929;51208;3773;11967;8714;29396;12487;41363
150070;201710;6242;24814;5620;24127;179;953;5171;22427;5350;23380
150080;201710;79072;197587;67691;182617;15576;43411;28217;83846;43793;127257
150085;201710;5759;18884;5445;18502;256;729;4947;17145;5203;17874
150090;201710;9953;38080;9456;37302;758;3284;7568;30101;8326;33385
150095;201710;5342;17082;4844;16393;289;915;3981;13834;4270;14749
150100;201710;3116;11299;2849;10817;223;917;2181;8284;2404;9201
150110;201710;3671;17182;3633;17127;237;1104;3223;15414;3460;16518
150120;201710;6842;23886;6656;23612;338;1007;5818;21312;6156;22319
150125;201710;733;2045;613;1900;112;386;373;1140;485;1526
150130;201710;21902;65732;19829;62758;2531;7286;14340;47112;16871;54398
150140;201710;178520;473662;162634;452749;24822;67887;108979;312375;133801;380262
150145;201710;4498;13835;4025;13204;589;1753;3044;10370;3633;12123
150150;201710;12473;36218;11476;34827;1312;4115;8466;26062;9778;30177
150157;201710;3101;9152;2658;8556;318;1129;1837;6030;2155;7159
150160;201710;2943;9263;2777;9003;703;2262;1551;5179;2254;7441
150170;201710;23531;80115;20972;76240;3499;12372;13436;51825;16935;64197
150172;201710;3442;10854;2930;10069;290;955;2194;7778;2484;8733
150175;201710;1757;5385;1598;5154;141;522;1244;4075;1385;4597
150178;201710;9764;28776;8268;26992;639;2133;6550;21959;7189;24092
150180;201710;19344;75748;18502;74616;1040;4524;16051;65504;17091;70028
150190;201710;6844;23559;6588;23225;202;871;6004;21233;6206;22104
150195;201710;5410;17394;5180;17035;108;386;4797;15828;4905;16214
150200;201710;5329;16537;4997;16153;65;187;4752;15506;4817;15693
150210;201710;24316;90617;23472;89465;1758;6785;19484;76208;21242;82993
150215;201710;7231;22355;6371;21016;2105;7024;2517;8759;4622;15783
150220;201710;10691;32830;9668;31279;1922;6143;5476;18477;7398;24620
150230;201710;12104;36382;10561;34289;1650;5167;6959;23836;8609;29003
150240;201710;32276;94828;27391;86090;9310;29999;7190;23573;16500;53572
150250;201710;4090;16866;3952;16665;630;2649;2877;12516;3507;15165
150260;201710;2206;8145;2094;7971;253;969;1511;5855;1764;6824
150270;201710;7891;23455;5990;20913;1769;6302;2593;9599;4362;15901
150275;201710;5894;20788;5561;20278;461;1664;4421;16360;4882;18024
150276;201710;2088;6207;1872;5938;265;841;1416;4601;1681;5442
150277;201710;4557;13524;3894;12720;398;1318;3049;10266;3447;11584
150280;201710;5968;26170;5808;25837;574;2576;4641;20951;5215;23527
150285;201710;3068;11482;2804;11076;317;1392;1963;7871;2280;9263
150290;201710;10191;28544;9572;27860;608;1382;8384;25250;8992;26632
150293;201710;9482;24262;6917;20821;1970;6022;2712;9072;4682;15094
150295;201710;7303;20679;5878;18983;1682;5405;2868;10525;4550;15930
150300;201710;1990;6505;1849;6310;71;352;1563;5313;1634;5665
150304;201710;4043;12869;3550;12056;631;2110;2256;7979;2887;10089
150307;201710;6331;20881;5984;20384;340;1162;5115;17585;5455;18747
150309;201710;5824;19237;5121;18168;1295;4535;2599;9921;3894;14456
150310;201710;6477;27015;6155;26576;376;1890;5235;22756;5611;24646
150320;201710;9258;24526;8501;23613;560;1487;6921;19507;7481;20994
150330;201710;13970;46506;13074;45153;1792;6269;9550;33832;11342;40101
150340;201710;2562;7799;2351;7481;228;693;1783;5754;2011;6447
150345;201710;7025;22351;6514;21646;512;1800;5322;17916;5834;19716
150350;201710;8158;23736;7622;23080;967;2350;5987;18948;6954;21298
150360;201710;21430;64313;18204;60281;2625;8294;12453;43122;15078;51416
150370;201710;9346;32980;8479;31774;833;3070;6442;25014;7275;28084
150375;201710;3042;13100;2779;12695;337;1575;2180;10106;2517;11681
150380;201710;9319;26675;8148;25021;435;1355;6875;21433;7310;22788
150390;201710;7579;32714;7098;31823;1193;5092;4815;22564;6008;27656
150400;201710;5971;22823;5723;22350;371;1470;4698;18560;5069;20030
150405;201710;8189;24002;7349;22981;521;1265;5868;19273;6389;20538
150410;201710;1671;6008;1517;5714;230;898;958;3681;1188;4579
150420;201710;32733;105850;27020;96783;9377;35190;7391;30300;16768;65490
150430;201710;7579;24471;7186;23890;764;2401;5596;19137;6360;21538
150440;201710;5396;18186;5153;17837;363;1197;4301;15157;4664;16354
150442;201710;21604;60068;18876;56037;2953;8649;11612;35877;14565;44526
150445;201710;5518;18480;5034;17698;353;1252;4086;14582;4439;15834
150450;201710;4467;20859;4293;20579;384;1951;3552;17244;3936;19195
150460;201710;7482;26211;6909;25486;282;1278;5922;22552;6204;23830
150470;201710;17403;52621;16611;51660;1225;3219;14345;45600;15570;48819
150475;201710;4019;13672;3669;13165;249;930;2991;10939;3240;11869
150480;201710;13648;46785;12493;44897;1914;6866;8829;32812;10743;39678
150490;201710;7363;27583;7115;27218;227;1094;6364;24416;6591;25510
150495;201710;4936;17938;4793;17754;142;588;4447;16553;4589;17141
150497;201710;2434;8679;2154;8147;620;2389;1000;3975;1620;6364
150500;201710;3185;8612;2888;8169;315;845;2253;6408;2568;7253
150503;201710;3788;11342;2981;10165;942;3245;1287;4734;2229;7979
150506;201710;10009;33948;9095;32649;1962;6547;5756;22218;7718;28765
150510;201710;9703;37069;8699;35006;1364;5264;5668;24102;7032;29366
150520;201710;6830;26759;6743;26649;172;770;6358;25251;6530;26021
150530;201710;12253;42226;10981;40215;1351;4277;8128;31063;9479;35340
150540;201710;4586;13630;4013;12782;193;626;3381;10802;3574;11428
150543;201710;6167;17889;5266;16669;940;3001;3479;11515;4419;14516
150548;201710;9574;30397;8855;29503;310;912;8118;27326;8428;28238
150549;201710;1995;6339;1815;6134;61;250;1638;5548;1699;5798
150550;201710;18858;59438;16446;55301;4769;16241;6543;23348;11312;39589
150553;201710;21382;70307;17436;62796;6138;23077;4822;18916;10960;41993
150555;201710;1709;4977;1413;4499;86;282;1026;3272;1112;3554
150560;201710;1784;5804;1631;5496;319;1041;900;3141;1219;4182
150563;201710;2424;7998;2200;7599;473;1738;1192;4148;1665;5886
150565;201710;3944;13425;3611;12877;117;568;3052;10949;3169;11517
150570;201710;5877;20840;5694;20529;402;1513;4613;16689;5015;18202
150580;201710;9557;40853;9230;40435;616;2881;7885;35205;8501;38086
150590;201710;6314;24432;6033;24058;176;873;5588;22308;5764;23181
150600;201710;8254;30813;7828;30216;226;1026;7104;27613;7330;28639
150610;201710;2409;7920;2220;7544;165;632;1752;5895;1917;6527
150611;201710;2767;9010;2596;8729;130;477;2205;7415;2335;7892
150613;201710;12035;34772;9468;30628;2261;7584;4130;13902;6391;21486
150616;201710;2941;8676;2215;7439;542;2013;649;2093;1191;4106
150618;201710;6333;20638;5527;19216;1080;3748;3166;11468;4246;15216
150619;201710;5038;16574;4556;15815;385;1469;3510;12137;3895;13606
150620;201710;6286;21868;5580;20963;730;2780;4099;15699;4829;18479
150630;201710;6002;17062;5668;16676;356;1071;4916;14623;5272;15694
150635;201710;3825;12095;3432;11360;834;2806;1594;5456;2428;8262
150640;201710;2079;6081;1926;5911;48;148;1794;5606;1842;5754
150650;201710;11033;33079;10009;31264;3008;9235;4221;14068;7229;23303
150655;201710;5233;16319;4892;15754;343;1105;4039;13092;4382;14197
150658;201710;4314;12665;3673;11795;751;2625;2213;7311;2964;9936
150660;201710;5509;16609;5002;15889;737;2291;3277;10657;4014;12948
150670;201710;7454;19166;6064;17515;604;1630;4782;14257;5386;15887
150680;201710;60691;195584;49331;177693;13292;47900;21137;85493;34429;133393
150690;201710;2148;6188;1925;5871;129;398;1573;4844;1702;5242
150700;201710;5892;18601;5459;18016;602;1914;4072;13876;4674;15790
150710;201710;4117;13817;3718;13179;339;1317;2719;9754;3058;11071
150715;201710;4813;15159;4258;14287;348;1226;3321;11260;3669;12486
150720;201710;6277;24596;5945;24000;515;2268;4713;19283;5228;21551
150730;201710;10263;34251;9391;32852;1126;4077;7017;25081;8143;29158
150740;201710;3596;11089;3177;10356;494;1604;2017;6683;2511;8287
150745;201710;4578;14504;4109;13834;854;3063;2654;8997;3508;12060
150746;201710;1341;4377;1268;4243;93;269;1017;3486;1110;3755
150747;201710;5106;16209;4555;15481;861;2630;2894;10579;3755;13209
150750;201710;3323;10941;3024;10501;193;756;2420;8517;2613;9273
150760;201710;11252;34919;10461;33915;1233;3878;7802;25922;9035;29800
150770;201710;5875;22093;5677;21794;169;538;5159;20623;5328;21161
150775;201710;943;2816;793;2563;140;536;458;1442;598;1978
150780;201710;3738;11981;3579;11797;97;384;3321;10975;3418;11359
150790;201710;4934;15738;4528;15269;259;766;3733;13574;3992;14340
150795;201710;14024;45620;12785;43658;2997;9847;7358;26599;10355;36446
150796;201710;3198;9026;2860;8624;214;682;2322;7122;2536;7804
150797;201710;3759;12440;3335;11742;129;437;2779;9900;2908;10337
150800;201710;13120;42327;12088;41071;2152;6641;8458;30514;10610;37155
150803;201710;6515;22971;6098;22305;554;2171;4824;17749;5378;19920
150805;201710;2795;9613;2513;9134;309;1090;1866;6927;2175;8017
150808;201710;5591;17633;4367;15370;1659;6378;461;1792;2120;8170
150810;201710;18935;55561;15098;50772;2793;9207;8848;32009;11641;41216
150812;201710;5159;15606;4682;14799;524;1827;3429;10623;3953;12450
150815;201710;8122;26784;7276;25691;743;2580;5695;20627;6438;23207
150820;201710;11093;32068;9980;30794;839;2286;7923;25365;8762;27651
150830;201710;11991;45659;11411;44927;471;2464;9751;39161;10222;41625
150835;201710;2178;7627;2024;7338;463;1698;1050;3928;1513;5626
150840;201710;7180;21493;5808;19122;1313;4583;2598;8703;3911;13286
160005;201710;899;2875;837;2723;29;127;742;2382;771;2509
160010;201710;1464;4762;1462;4760;12;17;1440;4715;1452;4732
160015;201710;1868;6757;1806;6668;99;362;1630;6095;1729;6457
160020;201710;1829;6708;1688;6487;248;1036;1234;4749;1482;5785
160021;201710;1034;4339;997;4280;96;546;792;3337;888;3883
160023;201710;1048;4212;1003;4138;74;291;833;3504;907;3795
160025;201710;1550;4655;1529;4632;31;79;1479;4510;1510;4589
160027;201710;7925;23321;7417;22754;786;2182;5986;19009;6772;21191
160030;201710;50998;168251;44894;158930;10862;37325;23147;89434;34009;126759
160040;201710;4343;16593;4226;16435;155;823;3879;14930;4034;15753
160050;201710;3487;12357;3046;11748;1533;5658;917;4187;2450;9845
160053;201710;3078;11069;2977;10928;559;1939;2079;7903;2638;9842
160055;201710;565;2237;558;2228;22;111;516;2043;538;2154
160060;201710;16568;54787;15638;53690;1428;4671;12782;44899;14210;49570
160070;201710;2844;11017;2651;10695;181;809;2162;8869;2343;9678
160080;201710;2647;9672;2570;9570;82;357;2360;8809;2442;9166
170025;201710;563;1698;472;1576;134;440;210;732;344;1172
170030;201710;1123;3654;950;3320;178;649;477;1727;655;2376
170035;201710;1400;3771;1090;3276;110;359;637;1946;747;2305
170040;201710;1743;5353;1483;5014;155;553;800;2923;955;3476
170070;201710;1544;4014;1167;3524;172;546;677;2077;849;2623
170100;201710;2332;6826;1975;6266;187;600;1422;4569;1609;5169
170105;201710;729;2277;534;1848;140;484;209;723;349;1207
170110;201710;837;2760;696;2486;149;573;316;1154;465;1727
170130;201710;1298;4038;994;3442;210;749;466;1701;676;2450
170190;201710;1454;4237;1035;3563;329;1070;240;1046;569;2116
170200;201710;1502;4033;934;2960;268;922;181;538;449;1460
170210;201710;27754;77941;21867;68550;7519;25647;3291;11305;10810;36952
170215;201710;1213;3625;1031;3355;83;333;747;2410;830;2743
170220;201710;5412;17893;4881;16863;1240;4206;2433;8849;3673;13055
170230;201710;1229;3904;985;3420;231;825;343;1226;574;2051
170240;201710;2662;7815;2119;6929;193;770;1429;4616;1622;5386
170255;201710;3432;10786;2696;9388;740;2643;1107;3945;1847;6588
170270;201710;1024;2492;666;1992;34;107;449;1325;483;1432
170290;201710;2818;8121;2444;7701;183;404;2016;6780;2199;7184
170300;201710;1849;5470;1517;4935;193;619;964;3246;1157;3865
170305;201710;721;2110;564;1809;79;282;279;867;358;1149
170307;201710;973;3442;806;3103;162;617;397;1592;559;2209
170310;201710;1425;3991;1087;3389;231;793;522;1604;753;2397
170320;201710;1034;2909;772;2482;130;441;393;1300;523;1741
170330;201710;783;2568;710;2450;45;199;545;1839;590;2038
170360;201710;461;1394;362;1227;53;211;215;693;268;904
170370;201710;1269;3550;978;3070;154;500;479;1528;633;2028
170380;201710;1764;5568;1385;4929;163;657;784;2859;947;3516
170382;201710;575;1759;478;1590;80;276;285;950;365;1226
170384;201710;1464;5829;1301;5491;372;1649;544;2317;916;3966
170386;201710;780;2216;501;1660;89;325;97;295;186;620
170388;201710;570;1712;420;1438;73;263;185;628;258;891
170389;201710;883;2934;777;2749;54;231;583;2039;637;2270
170390;201710;1387;3683;1083;3307;86;273;838;2606;924;2879
170410;201710;518;1650;412;1459;26;110;264;930;290;1040
170460;201710;401;1120;305;954;42;154;171;530;213;684
170510;201710;809;2595;620;2225;87;348;309;1093;396;1441
170550;201710;6180;17361;4548;14542;1444;5109;708;2317;2152;7426
170555;201710;1289;3674;1021;3252;123;422;536;1756;659;2178
170560;201710;1115;3304;847;2934;128;506;446;1703;574;2209
170600;201710;1305;3752;1094;3452;290;840;586;1961;876;2801
170610;201710;1651;4786;1264;4129;113;422;818;2636;931;3058
170625;201710;389;1133;270;866;36;116;89;270;125;386
170650;201710;1225;3804;952;3316;216;762;370;1393;586;2155
170700;201710;3492;10665;2783;9434;602;2206;1217;4243;1819;6449
170710;201710;1580;4571;1251;3967;280;979;550;1649;830;2628
170720;201710;1787;4747;1536;4385;93;197;1297;3853;1390;4050
170730;201710;922;2795;724;2455;176;616;330;1167;506;1783
170740;201710;2018;7224;1734;6688;244;967;1102;4300;1346;5267
170755;201710;851;2548;630;2111;84;333;292;963;376;1296
170765;201710;1171;3193;839;2656;218;706;321;1097;539;1803
170770;201710;1668;5451;1471;5113;232;807;920;3257;1152;4064
170820;201710;3850;13493;3434;12760;524;1891;2048;8113;2572;10004
170825;201710;961;2357;784;2115;71;161;543;1529;614;1690
170830;201710;1356;3898;1112;3510;39;100;912;2927;951;3027
170900;201710;2400;8438;2226;8152;182;727;1797;6626;1979;7353
170930;201710;3462;10068;2925;9197;676;2316;1357;4389;2033;6705
170950;201710;11927;34269;8724;28754;2634;9798;1264;4311;3898;14109
170980;201710;479;1318;363;1135;42;155;203;600;245;755
171050;201710;1532;5013;1373;4731;83;384;1059;3597;1142;3981
171070;201710;1299;4017;1166;3822;296;872;683;2448;979;3320
171090;201710;1071;2737;884;2485;66;175;648;1818;714;1993
171110;201710;565;1660;418;1393;110;411;167;492;277;903
171150;201710;986;2656;630;2014;65;239;397;1266;462;1505
171180;201710;702;2074;475;1620;89;319;203;720;292;1039
171190;201710;1499;5550;1339;5244;254;1041;726;2952;980;3993
171195;201710;820;2845;704;2644;128;551;424;1594;552;2145
171200;201710;559;1675;429;1434;116;407;150;497;266;904
171215;201710;439;1272;331;1066;72;257;134;415;206;672
171240;201710;703;2545;621;2373;66;311;390;1513;456;1824
171245;201710;564;1874;456;1631;95;369;197;683;292;1052
171250;201710;983;2824;760;2456;192;628;359;1194;551;1822
171270;201710;399;1560;346;1427;97;368;152;715;249;1083
171280;201710;833;2612;668;2307;164;554;286;1083;450;1637
171320;201710;3726;10956;3047;9773;722;2339;1350;4600;2072;6939
171330;201710;2608;7528;2083;6630;507;1681;995;3259;1502;4940
171360;201710;1379;4323;1207;4092;94;364;967;3295;1061;3659
171370;201710;650;1781;527;1612;59;199;357;1100;416;1299
171380;201710;1273;3954;1028;3526;237;864;468;1649;705;2513
171395;201710;906;2651;653;2162;104;408;325;1049;429;1457
171420;201710;1791;5635;1351;4741;255;995;584;2032;839;3027
171430;201710;1001;3032;833;2737;104;360;548;1765;652;2125
171488;201710;2372;7290;1966;6642;377;1301;1070;3772;1447;5073
171500;201710;877;2454;694;2164;69;232;473;1484;542;1716
171510;201710;785;2753;704;2605;51;223;488;1830;539;2053
171515;201710;453;1286;340;1088;29;98;205;647;234;745
171525;201710;574;1819;487;1658;36;158;323;1050;359;1208
171550;201710;337;1048;244;888;45;178;113;422;158;600
171570;201710;1203;3699;1040;3400;184;556;659;2235;843;2791
171575;201710;1834;5013;1237;3926;203;684;543;1709;746;2393
171610;201710;5134;15568;4096;13741;1028;3793;1137;3954;2165;7747
171620;201710;2734;7746;2306;7162;127;449;1884;5930;2011;6379
171630;201710;907;2685;751;2457;174;613;430;1422;604;2035
171650;201710;2006;6053;1487;5036;374;1294;494;1753;868;3047
171660;201710;2267;6145;1616;4970;267;839;866;2666;1133;3505
171665;201710;1363;3940;1054;3465;203;713;486;1650;689;2363
171670;201710;1767;4876;1402;4292;282;985;698;2083;980;3068
171700;201710;1133;3476;879;3008;142;479;464;1626;606;2105
171720;201710;731;2096;617;1894;78;257;418;1271;496;1528
171750;201710;1172;3495;845;2872;227;777;205;771;432;1548
171780;201710;1231;3276;895;2781;88;282;571;1763;659;2045
171790;201710;1428;5039;1158;4401;282;1098;516;2054;798;3152
171800;201710;659;1971;529;1773;55;191;336;1153;391;1344
171820;201710;9953;29501;7944;26111;1914;6644;2980;10251;4894;16895
171830;201710;1359;4932;1211;4603;250;994;633;2455;883;3449
171840;201710;673;1866;560;1696;37;121;410;1221;447;1342
171845;201710;618;1713;490;1511;73;266;271;849;344;1115
171850;201710;839;3028;732;2799;76;329;490;1868;566;2197
171855;201710;1079;3372;961;3165;82;280;661;2158;743;2438
171865;201710;386;1315;334;1230;65;260;163;592;228;852
171870;201710;737;2152;551;1792;97;320;259;928;356;1248
171875;201710;1167;3631;959;3284;72;302;715;2418;787;2720
171880;201710;905;3194;867;3144;68;224;726;2708;794;2932
171884;201710;917;2483;667;2112;139;500;207;739;346;1239
171886;201710;1279;3953;959;3325;289;1078;167;611;456;1689
171888;201710;737;2180;515;1738;53;194;319;1061;372;1255
171889;201710;486;1493;421;1372;77;273;191;646;268;919
171890;201710;1125;3254;882;2880;160;519;507;1680;667;2199
171900;201710;476;1742;370;1475;88;352;140;580;228;932
172000;201710;573;1825;473;1623;76;293;248;820;324;1113
172010;201710;1053;3713;946;3497;95;448;612;2187;707;2635
172015;201710;326;1264;269;1143;52;212;130;561;182;773
172020;201710;2182;7208;2038;6977;187;740;1526;5218;1713;5958
172025;201710;719;2068;524;1734;73;280;295;990;368;1270
172030;201710;1179;3632;1032;3383;34;140;834;2726;868;2866
172049;201710;1263;3211;864;2577;333;1055;368;1107;701;2162
172065;201710;1316;3476;1081;3207;61;162;969;2912;1030;3074
172080;201710;2336;7256;1940;6518;150;582;1329;4455;1479;5037
172085;201710;461;1314;313;1001;57;167;102;320;159;487
172090;201710;3913;10450;3147;9364;114;354;2675;8039;2789;8393
172093;201710;476;1464;367;1262;74;296;191;615;265;911
172097;201710;613;1742;465;1499;88;301;193;634;281;935
172100;201710;36981;100216;26546;83134;6809;23567;7393;24261;14202;47828
172110;201710;1580;5982;1381;5655;152;668;1014;4296;1166;4964
172120;201710;4698;14763;3815;13394;728;2538;2048;7506;2776;10044
172125;201710;256;798;202;703;30;115;103;366;133;481
172130;201710;642;1903;502;1673;24;89;348;1182;372;1271
172208;201710;2168;6062;1856;5598;232;714;1163;3548;1395;4262
172210;201710;2473;7205;2073;6618;442;1442;1142;3685;1584;5127
210005;201710;19751;60343;16406;55081;5006;17498;6350;22343;11356;39841
210010;201710;1665;5727;1524;5477;54;227;1314;4760;1368;4987
210015;201710;3222;10149;2914;9662;160;421;2495;8510;2655;8931
210020;201710;7031;16511;6448;15852;121;316;6004;14712;6125;15028
210030;201710;4889;16520;4638;16181;248;1205;3987;13763;4235;14968
210040;201710;2084;6163;1914;5970;37;87;1786;5665;1823;5752
210043;201710;6532;17918;5580;16789;745;2069;3904;12563;4649;14632
210047;201710;6300;22182;5776;21443;334;1544;4901;18158;5235;19702
210050;201710;2157;7839;1773;7095;335;1410;1011;4180;1346;5590
210055;201710;1708;5851;1563;5617;73;298;1254;4511;1327;4809
210060;201710;6678;26295;6155;25278;869;3664;4268;17948;5137;21612
210070;201710;7201;20891;6725;20316;56;163;6373;19433;6429;19596
210080;201710;3672;12974;3602;12888;17;68;3514;12629;3531;12697
210083;201710;4671;15726;4156;15165;73;346;3930;14405;4003;14751
210087;201710;2842;8331;2578;7981;199;613;2112;6667;2311;7280
210090;201710;9939;30790;9456;30040;318;1138;8545;27113;8863;28251
210095;201710;5917;20659;5590;20238;294;1190;4873;17819;5167;19009
210100;201710;6898;20798;6374;20078;230;890;5462;17173;5692;18063
210110;201710;2637;9030;2532;8893;57;243;2361;8287;2418;8530
210120;201710;23971;66924;20975;63295;2671;6896;14640;47179;17311;54075
210125;201710;3723;11255;3530;11043;547;1320;2767;9172;3314;10492
210130;201710;4089;11809;3690;11261;204;635;3073;9388;3277;10023
210135;201710;1511;4600;1344;4350;62;212;1114;3637;1176;3849
210140;201710;16084;49730;13570;46279;2968;10499;7495;26401;10463;36900
210150;201710;4524;11216;4037;10599;66;258;3658;9481;3724;9739
210160;201710;16434;51164;15271;49419;1331;4153;11790;39286;13121;43439
210170;201710;13636;46920;13185;46355;625;2248;11870;42067;12495;44315
210173;201710;2483;9502;2351;9292;40;235;2211;8767;2251;9002
210177;201710;2990;9067;2835;8883;56;138;2697;8544;2753;8682
210180;201710;1453;4215;1348;4073;38;137;1197;3595;1235;3732
210190;201710;4734;14731;4333;13997;137;679;3506;11075;3643;11754
210193;201710;1233;3887;1125;3721;50;190;928;3084;978;3274
210197;201710;1918;6516;1774;6340;208;666;1348;5048;1556;5714
210200;201710;7634;25562;7095;24788;763;2666;5594;19970;6357;22636
210203;201710;6802;21244;6391;20703;373;1128;5603;18478;5976;19606
210207;201710;3175;10208;3001;9900;149;463;2538;8536;2687;8999
210210;201710;8066;27109;7701;26622;84;415;7158;25024;7242;25439
210215;201710;1529;5682;1426;5535;73;348;1220;4762;1293;5110
210220;201710;5758;21318;5470;20819;266;1335;4715;17779;4981;19114
210230;201710;5045;16058;4658;15488;227;672;4115;13853;4342;14525
210232;201710;12247;38741;10184;36050;1508;5463;6551;25105;8059;30568
210235;201710;3583;10930;3179;10427;125;506;2795;9226;2920;9732
210237;201710;2234;8545;2157;8446;22;101;2083;8203;2105;8304
210240;201710;2761;8769;2574;8475;116;441;2216;7269;2332;7710
210250;201710;5261;16804;4906;16344;122;623;4438;14691;4560;15314
210255;201710;2569;8119;2318;7671;319;1117;1623;5354;1942;6471
210260;201710;5076;16266;4655;15608;340;1169;3804;12861;4144;14030
210270;201710;4833;14005;4432;13449;103;520;3933;11794;4036;12314
210275;201710;3466;8668;3226;8391;79;140;3044;8044;3123;8184
210280;201710;5409;16318;4601;15136;256;1204;3439;11100;3695;12304
210290;201710;5706;18543;5322;18076;163;642;4742;16181;4905;16823
210300;201710;34746;95973;29093;88958;1989;6350;22016;70047;24005;76397
210310;201710;2849;7811;2615;7499;69;145;2347;6797;2416;6942
210312;201710;2360;7007;2172;6773;49;249;1969;6102;2018;6351
210315;201710;2751;8295;2380;7836;78;245;2091;7060;2169;7305
210317;201710;3876;12533;3677;12297;128;497;3371;11316;3499;11813
210320;201710;18363;60066;17258;58656;586;2554;15492;52756;16078;55310
210325;201710;3408;10386;3069;9876;113;416;2665;8653;2778;9069
210330;201710;29213;79381;24366;73657;5519;15692;13347;46036;18866;61728
210340;201710;10655;32401;9697;31062;1013;3020;7126;23986;8139;27006
210350;201710;9371;28285;8414;26980;331;1159;7134;23081;7465;24240
210355;201710;3893;14117;3504;13509;142;739;2949;11485;3091;12224
210360;201710;14710;43702;13319;41798;718;2731;11071;34550;11789;37281
210370;201710;9472;22579;7867;20860;310;642;6972;19099;7282;19741
210375;201710;2921;8691;2393;7991;666;2267;1152;4076;1818;6343
210380;201710;5489;15090;4975;14432;310;815;4229;12513;4539;13328
210390;201710;2747;9982;2544;9645;135;661;2131;8071;2266;8732
210400;201710;4730;14836;4396;14423;109;282;4096;13613;4205;13895
210405;201710;7233;20307;5871;18327;1303;3973;3008;10017;4311;13990
210407;201710;1872;6654;1595;6121;147;628;1219;4643;1366;5271
210408;201710;2297;9112;2188;8961;160;808;1785;7418;1945;8226
210409;201710;3610;12945;3374;12602;127;677;2938;10943;3065;11620
210410;201710;3400;11005;3161;10631;248;754;2528;8771;2776;9525
210420;201710;3937;12961;3609;12383;184;653;3033;10485;3217;11138
210430;201710;2184;6510;2073;6386;122;336;1809;5637;1931;5973
210440;201710;3969;11601;3791;11379;79;233;3592;10828;3671;11061
210450;201710;2523;8055;2273;7667;118;412;1835;6188;1953;6600
210455;201710;3647;10403;3194;9859;659;1934;2137;6895;2796;8829
210460;201710;3309;10631;3034;10222;131;554;2552;8574;2683;9128
210462;201710;1306;4668;1201;4466;60;288;991;3648;1051;3936
210465;201710;2538;8066;2309;7735;94;280;2048;6981;2142;7261
210467;201710;5945;19751;5532;19276;317;1181;4844;17081;5161;18262
210470;201710;2069;5507;1461;4621;79;237;1108;3582;1187;3819
210480;201710;14611;46008;12746;43656;1706;5532;9021;33086;10727;38618
210490;201710;3655;9782;3097;8987;79;278;2709;7852;2788;8130
210500;201710;6001;24948;5746;24445;474;2318;4591;19522;5065;21840
210510;201710;6234;21153;5815;20651;271;821;5082;18587;5353;19408
210515;201710;3434;10813;3263;10626;121;328;3005;9985;3126;10313
210520;201710;2523;7521;2269;7187;121;417;1973;6295;2094;6712
210530;201710;47802;128889;40627;118126;6875;25332;11823;41805;18698;67137
210535;201710;3159;10874;3013;10679;87;331;2718;9718;2805;10049
210540;201710;13152;42711;11755;40791;1650;5546;8137;29706;9787;35252
210542;201710;5541;15114;4933;14442;233;499;4443;13366;4676;13865
210545;201710;2282;7205;2143;6996;48;217;1917;6201;1965;6418
210547;201710;3563;12768;3265;12221;366;1340;2351;9095;2717;10435
210550;201710;5771;17423;5105;16676;293;902;4467;14903;4760;15805
210560;201710;3709;11520;3318;10874;113;465;2865;9297;2978;9762
210565;201710;1395;5058;1213;4763;49;244;994;3991;1043;4235
210570;201710;11106;31321;10263;30361;380;957;9344;28077;9724;29034
210580;201710;2930;8446;2645;8099;241;489;2150;6919;2391;7408
210590;201710;3855;12404;3527;11964;169;779;3087;10363;3256;11142
210592;201710;2453;7602;2335;7411;33;173;2082;6560;2115;6733
210594;201710;2686;7449;2122;6582;113;329;1563;5003;1676;5332
210596;201710;2411;9018;2269;8725;169;761;1771;6836;1940;7597
210598;201710;1670;5133;1569;5008;45;163;1448;4641;1493;4804
210600;201710;2935;8348;2513;7781;89;287;2061;6406;2150;6693
210610;201710;2408;7684;2199;7417;98;467;1950;6468;2048;6935
210620;201710;2097;6686;1881;6421;37;93;1739;6055;1776;6148
210630;201710;3078;10927;2821;10544;204;972;2253;8272;2457;9244
210632;201710;4239;14528;3872;13978;386;1569;2982;10769;3368;12338
210635;201710;1846;6520;1736;6332;127;403;1459;5473;1586;5876
210637;201710;2478;8545;2262;8216;132;581;1795;6571;1927;7152
210640;201710;4603;18070;4532;17995;32;129;4441;17700;4473;17829
210650;201710;6906;20538;6666;20221;79;235;6435;19574;6514;19809
210660;201710;8369;24649;7589;23483;303;1139;6586;20160;6889;21299
210663;201710;2625;8101;2495;7944;116;374;2145;7001;2261;7375
210667;201710;1877;6258;1759;6073;63;261;1562;5438;1625;5699
210670;201710;4408;15802;4166;15412;183;885;3625;13362;3808;14247
210675;201710;4980;13835;4503;13215;372;923;3712;11282;4084;12205
210680;201710;3905;10401;3339;9724;126;293;2943;8714;3069;9007
210690;201710;7247;24440;6891;24061;268;981;6119;21917;6387;22898
210700;201710;2669;7613;2320;7198;211;502;1820;6187;2031;6689
210710;201710;4642;15395;4341;14946;165;774;3771;12945;3936;13719
210720;201710;2634;9215;2486;9017;65;337;2278;8213;2343;8550
210725;201710;1144;4256;1036;4046;36;134;796;3246;832;3380
210730;201710;1194;3394;1025;3163;76;233;815;2537;891;2770
210735;201710;4259;13772;3841;13102;351;1279;3100;10690;3451;11969
210740;201710;4927;14368;4601;14034;148;704;4112;12332;4260;13036
210745;201710;4129;11506;3888;11209;174;447;3470;10074;3644;10521
210750;201710;18959;50870;16668;48239;1795;5174;12406;36862;14201;42036
210760;201710;5472;16181;5108;15785;28;71;4975;15457;5003;15528
210770;201710;5677;15609;4922;14736;60;263;4526;13582;4586;13845
210780;201710;7144;24132;6548;23092;695;2315;4883;17724;5578;20039
210790;201710;4642;14795;4308;14382;168;424;3520;12459;3688;12883
210800;201710;4725;13136;4215;12505;79;296;3836;11364;3915;11660
210805;201710;3753;14792;3632;14604;142;731;3192;12876;3334;13607
210810;201710;4948;15086;4605;14639;242;497;4080;13410;4322;13907
210820;201710;7098;20628;6259;19307;758;2241;4227;13335;4985;15576
210825;201710;5883;19670;5602;19313;378;1217;4785;16889;5163;18106
210830;201710;8065;23129;7589;22549;544;1280;6484;19904;7028;21184
210840;201710;3377;9215;3077;8790;103;319;2661;7562;2764;7881
210845;201710;5740;16787;5553;16588;38;79;5469;16422;5507;16501
210850;201710;5779;20190;5203;19272;442;1939;3948;14580;4390;16519
210860;201710;17108;50248;15211;47579;965;2950;12315;39296;13280;42246
210870;201710;5791;18686;5203;17962;402;1317;4319;15227;4721;16544
210880;201710;4167;13480;3945;13203;255;951;3310;11097;3565;12048
210890;201710;4474;13601;4113;13177;241;617;3510;11743;3751;12360
210900;201710;4672;13946;3727;12298;1458;5141;782;2891;2240;8032
210905;201710;1827;5500;1589;5168;78;198;1349;4507;1427;4705
210910;201710;7489;23906;6608;22417;866;3050;4438;15166;5304;18216
210920;201710;2721;10062;2565;9809;106;563;2216;8452;2322;9015
210923;201710;1377;4628;1268;4448;96;386;931;3288;1027;3674
210927;201710;4773;15542;4467;15208;109;334;4171;14395;4280;14729
210930;201710;2435;8635;2254;8358;122;626;1849;6738;1971;7364
210940;201710;3222;11058;3086;10847;135;622;2698;9370;2833;9992
210945;201710;5658;17438;5416;17161;264;704;4860;15607;5124;16311
210950;201710;5022;15191;4081;13753;499;1522;2844;9992;3343;11514
210955;201710;1695;5371;1499;5071;148;482;1065;3720;1213;4202
210960;201710;8719;27555;7975;26536;1585;4908;4949;17682;6534;22590
210970;201710;1277;4341;1107;4044;99;433;827;2936;926;3369
210975;201710;1665;5585;1578;5417;130;471;1193;4099;1323;4570
210980;201710;9933;22832;9429;22319;289;508;8860;21300;9149;21808
210990;201710;15321;46850;12831;43308;2105;7280;7754;27190;9859;34470
211000;201710;14254;44968;12721;43232;647;2693;10734;37098;11381;39791
211003;201710;4810;16761;4334;16156;218;998;3595;13614;3813;14612
211010;201710;6314;23577;5913;23051;76;443;5482;21537;5558;21980
211020;201710;7394;23724;7089;23274;425;1568;6016;19804;6441;21372
211023;201710;2047;6912;1956;6772;113;436;1631;5638;1744;6074
211027;201710;2669;9688;2610;9585;231;916;2176;8005;2407;8921
211030;201710;3697;10982;3402;10666;304;672;2876;9463;3180;10135
211040;201710;4449;16474;4268;16206;162;872;3741;14194;3903;15066
211050;201710;9600;24616;9039;23979;215;561;8494;22555;8709;23116
211060;201710;5733;19874;5469;19463;300;1227;4787;17044;5087;18271
211065;201710;1995;6136;1770;5821;45;126;1597;5311;1642;5437
211070;201710;7652;25989;6939;24819;424;1574;5626;20409;6050;21983
211080;201710;1285;3728;1080;3420;58;298;852;2547;910;2845
211085;201710;1918;6208;1767;5966;153;509;1434;4900;1587;5409
211090;201710;3190;9161;2957;8843;74;354;2628;7741;2702;8095
211100;201710;6338;16891;6130;16627;36;146;5926;16008;5962;16154
211102;201710;2830;10684;2646;10425;159;704;2292;9096;2451;9800
211105;201710;2355;7808;1997;7180;242;885;1346;4885;1588;5770
211107;201710;4350;13970;3869;13295;207;705;3152;11183;3359;11888
211110;201710;6001;17336;4724;15431;631;1920;3266;11118;3897;13038
211120;201710;33759;96071;31371;93255;4347;12079;23191;71325;27538;83404
211125;201710;1966;6206;1718;5795;89;341;1443;4888;1532;5229
211130;201710;169118;444581;159014;431787;23493;66131;76381;229535;99874;295666
211140;201710;4945;15893;4570;15340;220;780;3898;13106;4118;13886
211150;201710;9352;26752;8373;25552;290;1087;7229;22088;7519;23175
211153;201710;2503;7888;2231;7533;438;1547;1467;5149;1905;6696
211157;201710;1071;3495;915;3248;55;295;635;2246;690;2541
211160;201710;3881;12388;3271;11360;214;1027;2347;7904;2561;8931
211163;201710;1685;5718;1605;5604;29;87;1502;5329;1531;5416
211167;201710;1492;4863;1416;4749;32;138;1333;4462;1365;4600
211170;201710;5919;15494;5669;15184;68;224;5393;14387;5461;14611
211172;201710;2388;6898;2161;6548;78;303;1831;5417;1909;5720
211174;201710;2647;8090;2481;7865;72;355;2241;7028;2313;7383
211176;201710;4032;12559;3432;11743;270;1076;2635;9043;2905;10119
211178;201710;4418;10625;3966;10117;28;100;3769;9531;3797;9631
211180;201710;4038;13927;3808;13579;261;996;3228;11616;3489;12612
211190;201710;2880;9139;2618;8744;63;313;2274;7524;2337;7837
211195;201710;1400;4147;1181;3858;68;209;978;3284;1046;3493
211200;201710;1941;6254;1693;5907;210;748;1111;4017;1321;4765
211210;201710;6539;20050;6118;19486;314;1071;5332;17078;5646;18149
211220;201710;32883;92166;28725;86853;4024;12250;19714;61611;23738;73861
211223;201710;4835;14691;4392;13999;432;1283;3320;10809;3752;12092
211227;201710;1677;5890;1532;5676;43;204;1345;5041;1388;5245
211230;201710;7246;23242;6611;22168;616;2132;5096;17166;5712;19298
211240;201710;7811;26593;7461;26135;206;1075;6795;23523;7001;24598
211245;201710;5532;16251;5483;16202;38;74;5425;16088;5463;16162
211250;201710;13538;40855;12664;39797;666;2097;11034;35031;11700;37128
211260;201710;7831;25058;7329;24398;258;999;6646;22225;6904;23224
211270;201710;9877;33306;8814;31947;422;1961;7241;26609;7663;28570
211280;201710;13002;38107;11876;36676;806;2047;9836;31407;10642;33454
211285;201710;1607;5911;1434;5577;251;1042;707;2831;958;3873
211290;201710;6829;22241;6522;21815;270;1001;5739;19300;6009;20301
211300;201710;7893;23407;7353;22691;82;210;6979;21685;7061;21895
211400;201710;11150;34523;9515;32083;1956;6667;5390;19614;7346;26281
220005;201710;1798;5046;1617;4766;49;202;1323;3787;1372;3989
220010;201710;1424;4140;1246;3851;29;123;995;3023;1024;3146
220020;201710;3102;9736;2891;9381;418;1381;1987;6460;2405;7841
220025;201710;2208;5303;1947;4928;35;104;1612;3991;1647;4095
220027;201710;1246;3342;1094;3136;41;144;892;2537;933;2681
220030;201710;3051;8063;2938;7881;121;364;2533;6662;2654;7026
220040;201710;7018;21529;6415;20431;1180;3717;4103;13220;5283;16937
220045;201710;1332;4382;1205;4135;52;262;928;3095;980;3357
220050;201710;4200;12746;3646;11850;162;675;3026;9764;3188;10439
220060;201710;2087;4988;1820;4678;28;60;1663;4281;1691;4341
220070;201710;2341;6596;2084;6187;105;298;1674;4948;1779;5246
220080;201710;649;1957;597;1875;31;126;497;1496;528;1622
220090;201710;1719;4295;1419;3881;24;84;1246;3382;1270;3466
220095;201710;680;1795;639;1740;8;22;599;1627;607;1649
220100;201710;1307;3845;1074;3408;50;217;863;2677;913;2894
220105;201710;2069;6545;1823;6063;140;486;1306;4381;1446;4867
220110;201710;3258;9355;3104;9099;65;268;2756;7951;2821;8219
220115;201710;2517;8141;2399;7938;104;437;2121;6905;2225;7342
220117;201710;1239;3223;1005;2865;24;73;859;2430;883;2503
220120;201710;11239;33359;10432;32359;125;552;9818;30400;9943;30952
220130;201710;894;2824;785;2661;21;140;698;2324;719;2464
220140;201710;1605;4241;1420;4016;100;218;1210;3491;1310;3709
220150;201710;6557;19847;6193;19330;147;699;5451;16769;5598;17468
220155;201710;1085;3252;861;2838;28;109;595;1933;623;2042
220157;201710;1059;2681;904;2421;16;63;739;1919;755;1982
220160;201710;2546;7609;2229;7013;63;318;1819;5600;1882;5918
220170;201710;1335;3901;1132;3572;27;140;974;3003;1001;3143
220173;201710;1989;5889;1599;5130;47;222;1302;4039;1349;4261
220177;201710;1752;5272;1714;5220;15;55;1666;5073;1681;5128
220180;201710;1148;2964;892;2498;12;48;665;1770;677;1818
220190;201710;4882;14855;4447;14276;447;1525;3429;11045;3876;12570
220191;201710;1351;4470;1267;4320;91;400;937;3096;1028;3496
220192;201710;1803;5073;1446;4432;40;154;1130;3401;1170;3555
220194;201710;1709;5078;1522;4780;69;277;1249;3845;1318;4122
220196;201710;1953;5522;1789;5242;71;286;1507;4321;1578;4607
220198;201710;1227;3627;994;3312;9;29;945;3184;954;3213
220200;201710;4480;14383;4118;13911;292;1052;3358;11372;3650;12424
220202;201710;2139;6213;1843;5685;30;149;1582;4785;1612;4934
220205;201710;2558;6880;2299;6526;37;139;2038;5706;2075;5845
220207;201710;824;2518;706;2310;60;229;483;1566;543;1795
220208;201710;1710;5412;1434;4894;319;1220;657;2241;976;3461
220209;201710;1587;4677;1364;4287;32;142;1104;3457;1136;3599
220210;201710;1575;4247;1365;3888;32;136;1110;3057;1142;3193
220211;201710;1463;4074;1389;3966;19;85;1238;3527;1257;3612
220213;201710;1643;4610;1490;4303;33;128;1224;3454;1257;3582
220217;201710;1931;6130;1843;6022;30;117;1740;5720;1770;5837
220220;201710;10147;27576;8831;25568;570;1511;6603;19542;7173;21053
220225;201710;1111;3125;909;2846;23;95;756;2339;779;2434
220230;201710;5407;14146;4815;13355;182;501;4199;11695;4381;12196
220240;201710;2840;8638;2614;8212;95;361;2163;6756;2258;7117
220245;201710;1486;3917;1226;3576;14;55;1080;3211;1094;3266
220250;201710;2658;8135;2420;7778;56;239;2134;6858;2190;7097
220253;201710;1603;4596;1347;4138;157;464;1007;3079;1164;3543
220255;201710;1710;4573;1455;4165;25;130;1203;3309;1228;3439
220260;201710;4155;13368;3714;12570;216;783;2923;9932;3139;10715
220265;201710;1235;4206;1129;4035;72;303;845;3005;917;3308
220270;201710;6537;21037;6201;20427;417;1710;5025;16102;5442;17812
220271;201710;1476;3998;1269;3671;50;145;1061;3101;1111;3246
220272;201710;1668;4962;1506;4672;32;114;1187;3630;1219;3744
220273;201710;1164;3398;1000;3085;44;163;777;2381;821;2544
220275;201710;2092;5223;1671;4706;42;165;1434;3999;1476;4164
220277;201710;2101;5687;1821;5235;37;131;1503;4238;1540;4369
220280;201710;1475;3962;1277;3630;60;208;1039;2859;1099;3067
220285;201710;1480;3950;1261;3665;19;78;1181;3418;1200;3496
220290;201710;5611;18210;4747;16946;460;1816;3384;12102;3844;13918
220300;201710;1774;5769;1542;5427;59;340;1263;4336;1322;4676
220310;201710;2498;7877;2161;7479;58;316;1866;6376;1924;6692
220320;201710;2736;8357;2295;7527;165;631;1737;5627;1902;6258
220323;201710;1438;4932;1255;4640;96;387;1010;3745;1106;4132
220325;201710;1151;3613;981;3279;48;201;761;2531;809;2732
220327;201710;1311;4112;1185;3887;44;226;984;3127;1028;3353
220330;201710;3677;9928;3209;9280;177;558;2635;7566;2812;8124
220335;201710;1721;5273;1539;5058;14;48;1457;4806;1471;4854
220340;201710;1786;4859;1470;4341;56;209;1080;3085;1136;3294
220342;201710;1123;3526;1033;3390;45;182;842;2776;887;2958
220345;201710;2836;6962;2417;6375;15;36;2299;6057;2314;6093
220350;201710;3472;9216;2875;8243;146;492;2194;6190;2340;6682
220360;201710;1116;3050;964;2822;36;124;788;2238;824;2362
220370;201710;9006;25650;8180;24555;222;896;7298;21711;7520;22607
220375;201710;1397;4385;1307;4267;8;24;1275;4176;1283;4200
220380;201710;1391;3607;1179;3307;30;108;1013;2789;1043;2897
220385;201710;781;1949;621;1671;11;43;520;1357;531;1400
220390;201710;8215;24539;7189;22761;1883;5990;2965;9860;4848;15850
220400;201710;1480;3719;1144;3181;26;101;900;2415;926;2516
220410;201710;1127;3250;953;2951;61;187;759;2317;820;2504
220415;201710;804;2210;700;2045;24;83;525;1501;549;1584
220420;201710;2026;5854;1675;5179;90;295;1240;3784;1330;4079
220430;201710;2349;6512;2289;6436;99;297;2056;5737;2155;6034
220435;201710;1666;4716;1504;4455;56;189;1182;3467;1238;3656
220440;201710;2342;7680;2150;7376;146;531;1762;5966;1908;6497
220450;201710;1996;5935;1703;5523;254;933;1189;3828;1443;4761
220455;201710;1277;4051;1222;3971;28;115;1122;3639;1150;3754
220460;201710;901;2418;818;2317;44;142;707;1957;751;2099
220465;201710;2302;7479;2094;7158;167;617;1593;5470;1760;6087
220470;201710;3491;10224;3163;9687;120;411;2555;7708;2675;8119
220480;201710;2329;6542;1958;5904;127;324;1471;4408;1598;4732
220490;201710;2286;6234;2087;5989;42;162;1855;5264;1897;5426
220500;201710;2770;7522;2443;6986;65;275;1968;5452;2033;5727
220510;201710;2698;7906;2188;7001;91;302;1681;5397;1772;5699
220515;201710;1663;4088;1491;3856;56;145;1320;3394;1376;3539
220520;201710;4893;13196;4500;12657;91;258;4082;11483;4173;11741
220525;201710;1202;3364;1119;3245;23;89;970;2778;993;2867
220527;201710;1287;3819;1137;3547;49;156;922;2911;971;3067
220530;201710;1171;3341;1044;3154;41;167;932;2759;973;2926
220535;201710;796;2318;739;2243;51;158;588;1786;639;1944
220540;201710;3327;10610;3170;10369;87;390;2796;9088;2883;9478
220545;201710;1359;4424;1276;4267;92;383;1033;3388;1125;3771
220550;201710;8732;27598;7984;26299;540;2028;6125;19884;6665;21912
220551;201710;1395;4278;1233;4010;56;243;981;3098;1037;3341
220552;201710;1476;4520;1279;4146;46;240;1028;3201;1074;3441
220553;201710;1551;4410;1332;4059;59;198;1044;3248;1103;3446
220554;201710;771;2184;647;1990;42;108;510;1572;552;1680
220555;201710;2024;6605;1888;6396;47;256;1602;5352;1649;5608
220556;201710;1268;3851;1120;3558;43;204;863;2621;906;2825
220557;201710;1503;4703;1308;4312;85;316;954;3087;1039;3403
220558;201710;1114;3320;971;3113;37;169;790;2473;827;2642
220559;201710;1582;4290;1384;3962;15;50;1163;3335;1178;3385
220560;201710;1610;3919;1308;3504;41;101;1135;3023;1176;3124
220570;201710;6956;22194;6505;21415;649;2237;4868;16188;5517;18425
220580;201710;6373;19031;6139;18649;188;624;5511;16633;5699;17257
220585;201710;1947;6467;1768;6136;80;337;1424;4878;1504;5215
220590;201710;1261;3652;1091;3392;120;390;736;2299;856;2689
220595;201710;2363;6756;2213;6557;21;115;2080;6093;2101;6208
220600;201710;1292;3088;1053;2776;69;113;871;2353;940;2466
220605;201710;1732;5110;1482;4681;37;159;1165;3597;1202;3756
220610;201710;2737;8096;2581;7871;44;200;2361;7150;2405;7350
220620;201710;7315;24180;7005;23745;233;1038;6297;21190;6530;22228
220630;201710;374;1153;305;1024;42;164;173;592;215;756
220635;201710;1632;5365;1448;4976;70;295;1110;3763;1180;4058
220640;201710;2659;7484;2315;6973;81;286;1943;5805;2024;6091
220650;201710;2028;5931;1774;5478;71;238;1345;4142;1416;4380
220660;201710;2702;8017;2438;7697;95;427;2123;6575;2218;7002
220665;201710;1234;3948;1111;3739;24;133;946;3137;970;3270
220667;201710;1599;5299;1450;5026;74;281;1179;4095;1253;4376
220669;201710;1681;5405;1610;5275;95;430;1319;4235;1414;4665
220670;201710;1920;5536;1672;5229;55;165;1487;4664;1542;4829
220672;201710;2514;7055;2248;6721;114;338;1977;5961;2091;6299
220675;201710;1230;3471;1137;3305;59;150;893;2606;952;2756
220680;201710;2510;7336;2391;7179;127;373;2092;6293;2219;6666
220690;201710;1595;4384;1396;4054;126;313;1040;3091;1166;3404
220695;201710;934;2673;848;2506;27;92;696;2039;723;2131
220700;201710;8007;22184;6860;20453;368;1238;5300;15677;5668;16915
220710;201710;834;2418;650;2047;47;135;465;1453;512;1588
220720;201710;1938;4926;1787;4700;39;130;1551;4041;1590;4171
220730;201710;1308;3800;1105;3477;28;121;904;2799;932;2920
220735;201710;982;2406;769;2053;25;64;639;1689;664;1753
220740;201710;1382;4085;1144;3775;37;140;976;3235;1013;3375
220750;201710;3650;10278;3323;9801;179;544;2818;8296;2997;8840
220755;201710;1103;3045;982;2848;34;121;786;2223;820;2344
220760;201710;2799;8760;2518;8376;93;373;2198;7289;2291;7662
220770;201710;19433;63783;17385;59946;6235;22265;5419;19679;11654;41944
220775;201710;1104;2999;1053;2942;10;46;1033;2875;1043;2921
220777;201710;1550;4142;1256;3668;48;143;952;2757;1000;2900
220779;201710;1310;3250;1198;3103;31;115;1059;2695;1090;2810
220780;201710;5290;14316;4666;13321;267;921;3770;10574;4037;11495
220785;201710;1384;3219;1277;3069;29;45;1204;2895;1233;2940
220790;201710;9960;29289;9058;27943;353;1463;7649;23255;8002;24718
220793;201710;780;2224;685;2065;27;98;567;1698;594;1796
220795;201710;1403;3842;1275;3671;38;140;1137;3263;1175;3403
220800;201710;15337;40140;13311;37068;861;2565;9461;25770;10322;28335
220810;201710;2889;8400;2538;7772;65;258;2108;6324;2173;6582
220820;201710;5201;13933;4612;13079;443;1165;3551;10124;3994;11289
220830;201710;6916;19510;6392;18722;357;1127;5250;15311;5607;16438
220840;201710;12424;39126;10910;36045;2073;6692;6060;20416;8133;27108
220850;201710;2915;9495;2694;9225;77;388;2422;8236;2499;8624
220855;201710;588;1735;511;1603;21;94;411;1262;432;1356
220860;201710;949;2463;832;2288;20;70;738;2007;758;2077
220865;201710;2545;6904;2012;5987;63;263;1604;4637;1667;4900
220870;201710;2331;7487;2023;7071;39;210;1857;6460;1896;6670
220880;201710;4786;12487;4338;11954;42;146;4084;11234;4126;11380
220885;201710;1205;4260;1059;3990;63;331;820;3062;883;3393
220887;201710;1307;3140;1167;2947;11;40;1097;2748;1108;2788
220890;201710;1562;5196;1345;4777;101;347;996;3596;1097;3943
220900;201710;1898;4990;1638;4625;34;103;1438;4026;1472;4129
220910;201710;1470;4381;1278;4087;38;131;1124;3610;1162;3741
220915;201710;948;2649;804;2372;23;102;639;1825;662;1927
220920;201710;1305;4606;1142;4365;80;398;888;3313;968;3711
220930;201710;1479;4543;1340;4328;34;158;1197;3799;1231;3957
220935;201710;1042;3064;852;2652;35;140;593;1742;628;1882
220937;201710;1357;3719;1180;3440;29;113;962;2754;991;2867
220940;201710;1350;4104;1165;3728;47;209;862;2678;909;2887
220945;201710;399;1474;361;1389;22;121;265;990;287;1111
220950;201710;1331;3199;897;2490;18;81;699;1863;717;1944
220955;201710;1474;4090;1296;3783;49;141;1069;3126;1118;3267
220960;201710;878;2230;693;1932;17;66;554;1524;571;1590
220965;201710;1672;4797;1525;4565;27;165;1315;3811;1342;3976
220970;201710;1852;4926;1451;4271;61;176;1136;3356;1197;3532
220975;201710;702;2217;630;2126;25;163;558;1790;583;1953
220980;201710;1147;3394;1044;3214;32;131;864;2618;896;2749
220985;201710;1165;3344;1065;3191;52;215;823;2355;875;2570
220987;201710;1435;4467;1270;4182;64;284;1034;3351;1098;3635
220990;201710;1706;4937;1467;4545;41;197;1161;3499;1202;3696
220995;201710;1188;3520;918;3084;68;272;654;2210;722;2482
220997;201710;2351;6954;2230;6778;46;190;2068;6231;2114;6421
221000;201710;3989;11801;3726;11368;175;725;3063;9183;3238;9908
221005;201710;1374;4060;1254;3831;114;339;939;2828;1053;3167
221010;201710;1182;2990;999;2757;23;79;876;2379;899;2458
221020;201710;1571;4942;1454;4702;39;182;1093;3485;1132;3667
221030;201710;1448;4186;1281;3924;43;186;1044;3132;1087;3318
221035;201710;1318;3684;1223;3558;25;61;1139;3369;1164;3430
221037;201710;594;1747;512;1599;12;57;360;1067;372;1124
221038;201710;543;1534;420;1317;23;85;280;872;303;957
221039;201710;880;2397;774;2240;19;71;655;1852;674;1923
221040;201710;4238;13089;3897;12530;161;562;3131;10097;3292;10659
221050;201710;3422;9910;3153;9567;59;243;2866;8626;2925;8869
221060;201710;7969;23051;6853;21192;344;1152;5281;16535;5625;17687
221062;201710;1203;4126;1058;3834;49;264;825;2939;874;3203
221063;201710;1123;3452;984;3228;77;278;708;2306;785;2584
221065;201710;2625;6951;2330;6475;52;178;2024;5537;2076;5715
221070;201710;3479;11073;2996;10155;169;635;2258;7622;2427;8257
221080;201710;3430;8585;2783;7630;78;292;2247;6078;2325;6370
221090;201710;1352;3687;1154;3349;20;82;986;2798;1006;2880
221093;201710;1453;4280;1363;4096;164;521;882;2552;1046;3073
221095;201710;885;2379;763;2178;7;25;630;1757;637;1782
221097;201710;795;2168;626;1854;21;78;459;1306;480;1384
221100;201710;95633;277123;86592;261456;16120;50170;50004;149423;66124;199593
221110;201710;9984;30620;9235;29690;296;1354;8050;25575;8346;26929
221120;201710;3978;12263;3741;11857;368;1215;2929;9292;3297;10507
221130;201710;4458;12415;3568;10607;1011;2928;1465;4448;2476;7376
221135;201710;1475;4317;1365;4155;43;165;1206;3648;1249;3813
221140;201710;1266;3110;1136;2918;11;37;1025;2597;1036;2634
221150;201710;1125;2852;891;2442;24;93;690;1806;714;1899
221160;201710;756;1962;693;1877;21;55;571;1535;592;1590
221170;201710;1082;3198;980;3027;28;99;796;2442;824;2541
230010;201710;3210;8670;2600;7585;197;650;1953;5603;2150;6253
230015;201710;2813;9582;2646;9244;269;1098;1797;6175;2066;7273
230020;201710;13108;42254;12684;41564;501;2082;10870;35202;11371;37284
230030;201710;11717;32206;10398;30255;300;1093;9000;25998;9300;27091
230040;201710;4118;11277;3541;10290;153;578;2816;8039;2969;8617
230050;201710;2667;8731;1964;6914;459;1556;633;2278;1092;3834
230060;201710;2263;6409;1890;5732;65;261;1524;4520;1589;4781
230070;201710;3929;11260;3365;10158;202;713;2341;7148;2543;7861
230075;201710;8828;29818;8219;28689;455;2273;6588;22412;7043;24685
230080;201710;2381;5869;1950;5216;52;207;1656;4350;1708;4557
230090;201710;3860;10535;3413;9810;213;701;2586;7314;2799;8015
230100;201710;16783;47546;15310;45283;2101;6542;9542;28370;11643;34912
230110;201710;11406;35707;10331;33465;1961;6519;5605;18220;7566;24739
230120;201710;7372;20488;6480;19105;625;1732;4722;14281;5347;16013
230125;201710;2929;8223;2440;7381;105;387;1868;5616;1973;6003
230130;201710;5641;18036;4739;16114;530;1924;3044;10182;3574;12106
230140;201710;3430;10636;2915;9719;159;651;2089;6919;2248;7570
230150;201710;1566;4802;1368;4367;273;859;715;2334;988;3193
230160;201710;6166;17253;5423;16132;247;941;4420;12978;4667;13919
230170;201710;5894;17912;5153;16491;256;999;3832;12020;4088;13019
230180;201710;1632;4674;1395;4209;43;193;1063;3069;1106;3262
230185;201710;3812;12020;3380;11237;370;1322;2378;7978;2748;9300
230190;201710;12100;37425;10581;34458;1643;5591;5586;18216;7229;23807
230195;201710;5090;15427;4535;14457;320;1152;3522;11063;3842;12215
230200;201710;4789;13505;4265;12494;207;652;3341;9582;3548;10234
230205;201710;3907;12596;3558;11966;209;906;2618;8656;2827;9562
230210;201710;9056;24572;7786;22628;608;1930;5586;16171;6194;18101
230220;201710;12928;35400;11673;33309;628;2021;9243;26022;9871;28043
230230;201710;6873;21508;6234;20248;541;1794;4516;14651;5057;16445
230240;201710;12958;35192;11461;32773;561;1548;9112;26001;9673;27549
230250;201710;8977;26949;8913;26830;429;1580;7014;20628;7443;22208
230260;201710;14136;45530;12843;42845;1767;6245;7480;25152;9247;31397
230270;201710;7361;20929;6028;18447;658;2078;3885;11984;4543;14062
230280;201710;19580;56230;16939;51600;891;3457;13070;38772;13961;42229
230290;201710;4624;13636;3999;12340;461;1323;2777;8693;3238;10016
230300;201710;4211;12242;4004;11947;153;639;3429;10000;3582;10639
230310;201710;4730;13843;4076;12686;129;529;2966;9037;3095;9566
230320;201710;7335;21714;6493;20182;373;1453;4933;15080;5306;16533
230330;201710;4669;13273;3918;11831;232;742;2865;8559;3097;9301
230340;201710;3444;11168;3049;10343;276;1013;2108;7067;2384;8080
230350;201710;18002;52270;16226;49230;1169;4257;10540;32280;11709;36537
230360;201710;2947;8287;2340;7153;145;519;1623;4885;1768;5404
230365;201710;2971;7700;2542;7003;69;296;2160;5836;2229;6132
230370;201710;50915;156270;45478;147224;10765;35805;21246;71758;32011;107563
230380;201710;6319;18110;5176;15948;192;733;3711;11232;3903;11965
230390;201710;3273;10188;2915;9572;148;635;2208;7100;2356;7735
230393;201710;2960;9521;2542;8670;116;618;1889;6188;2005;6806
230395;201710;5465;15413;4874;14378;556;1633;3239;9714;3795;11347
230400;201710;5481;16029;4911;15064;189;840;3922;11723;4111;12563
230410;201710;14223;43958;11907;39216;1521;5131;7218;23959;8739;29090
230420;201710;23584;72282;20901;67016;3390;11532;10902;34835;14292;46367
230423;201710;4340;13533;3852;12568;147;619;3075;9889;3222;10508
230425;201710;5434;17675;4985;16711;572;1968;3318;11154;3890;13122
230426;201710;2505;6948;1957;5888;56;240;1461;4311;1517;4551
230427;201710;1803;5267;1302;4122;79;271;863;2624;942;2895
230428;201710;8794;25745;8095;24532;1386;4463;4467;13399;5853;17862
230430;201710;4334;13336;3815;12369;244;964;2833;8909;3077;9873
230435;201710;5211;15345;4587;14194;603;1951;2755;8550;3358;10501
230440;201710;363432;999790;316574;924075;58727;179222;162316;476462;221043;655684
230445;201710;4356;11822;3711;10713;197;546;2665;7622;2862;8168
230450;201710;3439;10528;3030;9804;225;943;2201;6989;2426;7932
230460;201710;1866;5852;1640;5429;103;407;1269;4189;1372;4596
230465;201710;3953;11496;3297;10304;120;523;2386;7208;2506;7731
230470;201710;10992;38404;10130;36694;974;4214;7257;25871;8231;30085
230480;201710;1375;4228;1176;3825;112;431;842;2674;954;3105
230490;201710;2276;6765;1995;6241;237;766;1123;3407;1360;4173
230495;201710;5536;17441;4996;16422;443;1807;3299;10681;3742;12488
230500;201710;8257;29002;7821;28133;431;1931;5993;21506;6424;23437
230510;201710;1561;5259;1172;4284;236;921;442;1611;678;2532
230520;201710;4214;12732;3843;12014;328;1138;2689;8284;3017;9422
230523;201710;14732;45542;12443;40538;2979;10018;3180;10829;6159;20847
230526;201710;3859;11322;3307;10345;153;680;2586;7858;2739;8538
230530;201710;5125;16226;4544;15290;534;1910;3189;10852;3723;12762
230533;201710;3939;10619;3430;9690;261;701;2597;7397;2858;8098
230535;201710;5311;15295;4558;13920;324;998;3170;9868;3494;10866
230540;201710;16136;46453;14592;44033;388;1621;12474;37137;12862;38758
230550;201710;18870;53837;16261;49063;2336;7556;9202;27474;11538;35030
230560;201710;7114;19313;5905;17070;138;538;4789;13581;4927;14119
230565;201710;3325;9088;2694;7948;96;358;2005;5854;2101;6212
230570;201710;3439;9098;2995;8495;86;267;2503;7054;2589;7321
230580;201710;9402;27515;8551;26253;439;1656;7109;21611;7548;23267
230590;201710;8822;26452;7448;23851;548;1995;5170;16129;5718;18124
230600;201710;3718;10088;2823;8318;99;331;1838;5460;1937;5791
230610;201710;6175;18568;5577;17604;472;1543;4191;13235;4663;14778
230620;201710;2078;5833;1631;4905;166;537;941;2756;1107;3293
230625;201710;7742;24071;6919;22278;2090;7038;1846;6131;3936;13169
230630;201710;10280;31954;9300;29991;2532;7687;4049;14128;6581;21815
230640;201710;26139;82122;23969;78706;1900;7106;18683;60999;20583;68105
230650;201710;4536;13618;4085;12736;303;1031;3036;9321;3339;10352
230655;201710;9211;32982;8814;32277;609;2586;6994;25701;7603;28287
230660;201710;5936;18203;5055;16460;208;1061;4059;12903;4267;13964
230670;201710;5809;15001;4570;12845;173;564;3568;9779;3741;10343
230680;201710;2510;7314;2181;6677;261;811;1416;4338;1677;5149
230690;201710;6362;19939;5924;18982;598;2134;3642;11459;4240;13593
230700;201710;9205;25157;8124;23130;401;1388;6052;16695;6453;18083
230710;201710;7055;22515;6139;20785;581;2077;4447;15046;5028;17123
230720;201710;1792;5585;1533;5018;186;632;976;3173;1162;3805
230725;201710;3509;11609;3036;10409;770;2702;978;3359;1748;6061
230730;201710;52641;154169;44710;141090;11608;39975;13884;46218;25492;86193
230740;201710;6121;17676;5453;16542;177;678;4312;12954;4489;13632
230750;201710;7982;22465;6841;20556;260;960;5303;15561;5563;16521
230760;201710;10950;31301;9954;29491;845;2900;7095;20464;7940;23364
230763;201710;4235;12561;3681;11487;213;846;2781;8362;2994;9208
230765;201710;38357;114794;33623;106104;8011;26562;11699;37728;19710;64290
230770;201710;25161;67371;21926;62716;2901;8702;13695;39312;16596;48014
230780;201710;5707;21033;5452;20479;989;3687;3126;12208;4115;15895
230790;201710;2810;8573;2629;8274;161;559;2083;6556;2244;7115
230800;201710;7496;25284;6827;23860;998;3795;3825;13252;4823;17047
230810;201710;11290;35547;10507;34153;539;2110;8216;26290;8755;28400
230820;201710;3092;10434;2700;9575;292;1216;1644;5677;1936;6893
230830;201710;7268;21529;6392;19910;257;1069;5016;15325;5273;16394
230835;201710;3864;9904;3131;8726;132;453;2506;6838;2638;7291
230837;201710;3012;9985;2630;9208;163;746;1950;6646;2113;7392
230840;201710;8490;26671;7664;25235;543;1966;6001;19784;6544;21750
230850;201710;8916;27251;8078;25725;601;2086;5754;18297;6355;20383
230860;201710;4847;13408;4181;12383;177;647;3488;10202;3665;10849
230870;201710;16954;43489;14733;40121;599;1789;11597;31431;12196;33220
230880;201710;1936;6341;1800;6085;87;431;1365;4481;1452;4912
230890;201710;4241;14538;3935;13920;394;1531;2721;9554;3115;11085
230900;201710;2878;9118;2436;8160;348;1160;1440;4789;1788;5949
230910;201710;2968;8558;2443;7629;110;510;1901;5810;2011;6320
230920;201710;4347;12475;3992;11997;146;575;3460;10308;3606;10883
230930;201710;6531;19322;5646;17601;457;1554;3765;11621;4222;13175
230940;201710;7414;20722;6653;19454;194;684;5544;16104;5738;16788
230945;201710;6320;18751;5562;17306;459;1551;3775;11847;4234;13398
230950;201710;6240;16347;5696;15674;130;312;5088;14285;5218;14597
230960;201710;13310;40718;12150;38453;1952;6454;6135;19655;8087;26109
230970;201710;12791;37229;11153;34475;2096;6867;5393;16772;7489;23639
230980;201710;2659;8087;2321;7478;501;1562;1305;4362;1806;5924
230990;201710;1726;4978;1426;4411;98;405;961;2858;1059;3263
231000;201710;2510;6812;2094;5978;94;294;1472;4128;1566;4422
231010;201710;2914;7851;2409;6998;177;580;1767;5049;1944;5629
231020;201710;7869;25831;7345;24655;1286;4127;4337;15082;5623;19209
231025;201710;7155;21614;6574;20566;1120;3554;4029;12817;5149;16371
231030;201710;6822;21725;5752;19427;1060;3650;3009;10221;4069;13871
231040;201710;3061;9253;2709;8584;105;423;2070;6456;2175;6879
231050;201710;11290;31092;9502;27893;584;1784;7191;20933;7775;22717
231060;201710;2452;7655;2226;7280;96;460;1714;5517;1810;5977
231070;201710;7887;24408;7004;22649;1196;3912;3831;12581;5027;16493
231080;201710;3866;11716;3519;11109;139;721;2740;8300;2879;9021
231085;201710;5298;15182;4834;14581;407;1183;3619;11218;4026;12401
231090;201710;4134;11368;3264;9616;117;428;2321;6680;2438;7108
231095;201710;2015;6333;1737;5716;154;561;1192;3882;1346;4443
231100;201710;2894;8942;2486;8181;213;715;1775;5836;1988;6551
231110;201710;3320;10612;3271;10522;241;944;2371;7475;2612;8419
231120;201710;1879;6139;1712;5795;165;570;1140;3856;1305;4426
231123;201710;1920;5123;1635;4604;92;287;1215;3350;1307;3637
231126;201710;5814;16541;4746;14489;204;747;3414;10190;3618;10937
231130;201710;18049;53413;16232;50497;1925;6603;10757;33947;12682;40550
231135;201710;4037;11708;3426;10593;174;653;2490;7576;2664;8229
231140;201710;16959;51042;14377;46167;973;4073;9793;30552;10766;34625
231150;201710;5072;14692;4426;13462;706;2154;2282;7091;2988;9245
231160;201710;5403;17590;5043;16868;923;2980;2888;9929;3811;12909
231170;201710;4123;12803;3552;11611;236;908;2480;7905;2716;8813
231180;201710;13797;40323;11921;36434;2467;7632;5453;16530;7920;24162
231190;201710;4016;11589;3486;10695;190;788;2628;7772;2818;8560
231195;201710;4457;14635;3863;13376;269;1180;2731;9209;3000;10389
231200;201710;7822;25590;6829;23517;304;1546;5071;16931;5375;18477
231210;201710;4657;14580;4091;13621;201;882;3104;10094;3305;10976
231220;201710;11324;31116;9515;27717;500;1624;7041;20013;7541;21637
231230;201710;8761;28527;7954;27246;591;2337;5996;20597;6587;22934
231240;201710;11101;34078;10130;32143;1818;5858;5748;18470;7566;24328
231250;201710;1925;5257;1351;3926;129;374;714;2035;843;2409
231260;201710;3129;9417;2811;8893;356;1064;1842;5992;2198;7056
231270;201710;6623;17871;5714;16416;206;853;4438;12478;4644;13331
231280;201710;1660;5349;1553;5143;143;481;1099;3648;1242;4129
231290;201710;34510;109304;30695;101233;5515;19101;14104;46115;19619;65216
231300;201710;3940;11417;3262;10030;265;859;2140;6476;2405;7335
231310;201710;7259;20116;5939;17424;734;2167;3608;10443;4342;12610
231320;201710;6991;20655;5697;18037;163;731;4356;13575;4519;14306
231325;201710;2533;7291;2157;6666;432;1293;1135;3618;1567;4911
231330;201710;10070;32009;8738;29202;1723;5732;4496;15363;6219;21095
231335;201710;5357;14822;4595;13516;127;574;3876;11178;4003;11752
231340;201710;17065;54870;15645;52504;1274;4363;11783;40051;13057;44414
231350;201710;14654;41696;13695;40398;364;1117;12393;36746;12757;37863
231355;201710;4417;13754;3984;12988;236;908;3012;9765;3248;10673
231360;201710;7320;22937;6484;21465;691;2356;4533;15193;5224;17549
231370;201710;2304;6328;1823;5494;54;176;1377;4127;1431;4303
231375;201710;4139;13579;3836;13011;150;695;3136;10479;3286;11174
231380;201710;5434;15635;5141;15256;172;451;4469;13571;4641;14022
231390;201710;3275;10004;2975;9481;232;870;2127;6639;2359;7509
231395;201710;3747;11920;3315;11131;638;2141;1799;6151;2437;8292
231400;201710;8821;26557;8008;24947;412;1596;6138;18767;6550;20363
231410;201710;14448;46629;13094;44477;1086;3839;9896;33522;10982;37361
240010;201710;2402;6903;1933;5983;204;734;1169;3521;1373;4255
240020;201710;10320;31399;9211;29241;1190;4064;5645;17881;6835;21945
240030;201710;2510;6882;2417;6750;120;381;2130;5895;2250;6276
240040;201710;842;2425;699;2139;19;92;515;1505;534;1597
240050;201710;3283;8861;2750;7918;72;242;2162;6103;2234;6345
240060;201710;1351;3783;1176;3447;42;147;927;2646;969;2793
240070;201710;2215;6715;2050;6373;244;796;1462;4481;1706;5277
240080;201710;2784;7567;2379;6945;104;379;1799;5191;1903;5570
240090;201710;2183;5738;1825;5111;33;117;1465;4025;1498;4142
240100;201710;8090;22097;6900;19812;508;1545;5056;14194;5564;15739
240110;201710;4436;13535;3907;12515;410;1469;2452;7754;2862;9223
240120;201710;2490;8637;2368;8372;287;1159;1546;5391;1833;6550
240130;201710;2833;7040;2487;6505;86;269;2149;5537;2235;5806
240140;201710;2140;6395;1806;5744;208;762;1159;3624;1367;4386
240145;201710;5795;17523;5082;16300;840;2822;3088;10071;3928;12893
240150;201710;855;2664;758;2457;52;215;578;1803;630;2018
240160;201710;1359;4242;1189;3928;84;328;825;2742;909;3070
240165;201710;830;2538;724;2310;105;326;472;1517;577;1843
240170;201710;2221;6547;1908;5969;261;901;1153;3516;1414;4417
240180;201710;2681;8314;2351;7629;430;1434;1350;4439;1780;5873
240185;201710;1269;4230;1164;4054;68;297;955;3298;1023;3595
240190;201710;931;2927;828;2752;28;133;669;2195;697;2328
240200;201710;10988;29829;9443;27291;1685;5013;4397;12906;6082;17919
240210;201710;2720;7500;2472;7085;75;308;2070;5766;2145;6074
240220;201710;7115;23481;6511;22595;590;2526;4696;16285;5286;18811
240230;201710;5624;14790;4747;13363;298;817;3691;10417;3989;11234
240240;201710;1764;5367;1066;3587;173;593;219;693;392;1286
240250;201710;2565;7430;2403;7204;186;500;1929;5855;2115;6355
240260;201710;11620;37877;10889;36665;1447;5124;7179;24487;8626;29611
240270;201710;2209;6820;2037;6539;118;395;1670;5396;1788;5791
240280;201710;1558;4233;1366;3959;52;169;1132;3233;1184;3402
240290;201710;1164;3583;1000;3242;43;212;661;1977;704;2189
240300;201710;2212;5916;1653;4803;123;402;933;2654;1056;3056
240310;201710;8970;24879;7849;22987;1021;3197;4346;12719;5367;15916
240320;201710;1968;5575;1437;4458;35;168;1131;3314;1166;3482
240325;201710;28769;81672;23462;72578;6768;22058;6102;20151;12870;42209
240330;201710;1431;4250;1206;3780;62;247;811;2434;873;2681
240340;201710;1920;4844;1591;4328;93;246;1213;3248;1306;3494
240350;201710;2005;5473;1854;5292;46;162;1636;4662;1682;4824
240360;201710;6553;20016;5901;18977;1429;4473;3026;10323;4455;14796
240370;201710;1980;5438;1565;4618;137;404;1001;2935;1138;3339
240375;201710;849;2236;750;2056;35;139;566;1472;601;1611
240380;201710;2296;6734;1706;5386;167;556;943;2921;1110;3477
240390;201710;894;2420;698;2021;12;39;482;1312;494;1351
240400;201710;1309;3477;1007;2897;37;133;691;1907;728;2040
240410;201710;479;1544;437;1453;60;237;262;848;322;1085
240420;201710;4356;16566;4020;15769;644;3043;2192;8429;2836;11472
240430;201710;3209;8921;2826;8187;195;703;2126;5935;2321;6638
240440;201710;2396;5895;2130;5517;252;683;1480;3802;1732;4485
240450;201710;3876;11198;3204;9927;368;1237;1894;5743;2262;6980
240460;201710;2953;8726;2751;8435;260;866;2154;6589;2414;7455
240470;201710;3554;10995;2783;9358;349;1178;1603;5409;1952;6587
240480;201710;532;1439;395;1181;38;115;193;572;231;687
240485;201710;2044;6196;1750;5609;169;545;1181;3844;1350;4389
240490;201710;1702;4259;1409;3769;24;66;1202;3205;1226;3271
240500;201710;2154;5950;1919;5614;74;251;1603;4668;1677;4919
240510;201710;1608;4587;1503;4429;122;367;1226;3573;1348;3940
240520;201710;1254;3393;1072;3125;43;183;902;2549;945;2732
240530;201710;1865;6017;1736;5805;165;595;1302;4332;1467;4927
240540;201710;1954;5352;1777;5079;68;239;1542;4326;1610;4565
240550;201710;712;2010;615;1841;37;116;460;1368;497;1484
240560;201710;3200;8895;2885;8445;309;788;2175;6511;2484;7299
240570;201710;2894;7864;2077;6015;283;882;981;2600;1264;3482
240580;201710;7435;22520;6895;21599;527;1828;5504;17134;6031;18962
240590;201710;690;1923;600;1753;19;70;477;1369;496;1439
240600;201710;1640;4653;1234;3790;104;370;750;2229;854;2599
240610;201710;4310;12266;3759;11239;258;841;2642;7786;2900;8627
240615;201710;1007;2930;808;2511;104;364;517;1539;621;1903
240620;201710;1791;5224;1564;4835;127;362;1225;3783;1352;4145
240630;201710;2009;5988;1837;5699;158;419;1263;4030;1421;4449
240640;201710;899;2499;731;2226;59;230;510;1497;569;1727
240650;201710;3861;11152;3469;10515;178;572;2745;8283;2923;8855
240660;201710;2445;7303;2301;7086;111;408;1957;5921;2068;6329
240670;201710;2430;7196;2045;6365;184;651;1282;3863;1466;4514
240680;201710;1506;4306;1223;3805;60;233;862;2621;922;2854
240690;201710;857;2307;722;2068;26;94;590;1635;616;1729
240700;201710;2385;7047;2015;6369;72;302;1575;4853;1647;5155
240710;201710;15394;42418;13611;39230;2698;7589;7269;21503;9967;29092
240720;201710;4936;13628;4421;12761;910;2708;2392;6797;3302;9505
240725;201710;1037;3110;821;2613;50;173;524;1631;574;1804
240730;201710;2047;6004;1779;5476;116;374;1335;4062;1451;4436
240740;201710;1807;5068;1569;4621;73;300;1151;3232;1224;3532
240750;201710;1993;7339;1840;7024;357;1476;967;3743;1324;5219
240760;201710;1322;3508;997;3001;57;151;757;2315;814;2466
240770;201710;3029;8632;2704;8178;135;525;2262;6703;2397;7228
240780;201710;5367;14913;4427;13397;532;1620;2732;8430;3264;10050
240790;201710;844;2504;698;2225;22;91;530;1691;552;1782
240800;201710;33569;93832;29328;86605;5509;16876;13361;39930;18870;56806
240810;201710;77649;220195;70577;207770;17204;50495;33211;100179;50415;150674
240820;201710;5143;16499;4660;15711;1007;3475;2390;8396;3397;11871
240830;201710;8426;25417;7839;24528;338;1427;6528;20138;6866;21565
240840;201710;1109;2991;923;2664;75;231;634;1780;709;2011
240850;201710;1224;3566;915;2873;72;234;506;1580;578;1814
240860;201710;1234;3451;977;2969;30;136;732;2112;762;2248
240870;201710;1126;2970;894;2572;62;190;608;1698;670;1888
240880;201710;1222;4011;1159;3885;90;337;930;3085;1020;3422
240890;201710;4615;12882;3721;11154;670;2100;1718;5100;2388;7200
240895;201710;2536;8688;2363;8403;243;934;1765;6330;2008;7264
240910;201710;2996;8664;2618;7925;78;291;2126;6368;2204;6659
240920;201710;762;2405;662;2196;83;297;352;1156;435;1453
240930;201710;3391;8481;2950;7939;71;180;2395;6543;2466;6723
240933;201710;1675;4310;1442;3935;48;174;1184;3154;1232;3328
240940;201710;6007;15555;4877;13690;418;1214;3403;9351;3821;10565
240950;201710;929;2952;844;2782;43;186;633;2034;676;2220
240960;201710;784;2390;685;2188;51;175;493;1549;544;1724
240970;201710;1786;4897;1514;4415;59;221;1225;3460;1284;3681
240980;201710;2793;9076;2585;8699;282;1067;1846;6120;2128;7187
240990;201710;2464;7322;2321;7044;336;1070;1590;4761;1926;5831
241000;201710;955;2624;812;2364;35;119;572;1645;607;1764
241010;201710;2630;8812;2488;8547;275;1161;1786;5913;2061;7074
241020;201710;1998;5511;1527;4528;191;527;887;2620;1078;3147
241025;201710;1666;4952;1406;4459;90;311;923;2932;1013;3243
241030;201710;2369;7732;2041;7044;199;778;1380;4713;1579;5491
241040;201710;2217;7310;1998;6933;139;583;1523;5282;1662;5865
241050;201710;1226;3585;1044;3249;55;190;753;2293;808;2483
241060;201710;759;2184;670;2011;55;156;454;1358;509;1514
241070;201710;635;1835;570;1723;42;165;439;1249;481;1414
241080;201710;1120;3259;882;2789;24;110;658;2036;682;2146
241090;201710;1881;5722;1623;5267;72;329;1244;3981;1316;4310
241100;201710;1117;3262;935;2860;57;192;645;1929;702;2121
241105;201710;1096;3309;935;3023;245;778;382;1280;627;2058
241110;201710;852;2569;683;2184;37;136;453;1392;490;1528
241120;201710;6944;20941;6227;19640;1430;4286;3214;10826;4644;15112
241140;201710;3232;8604;2742;7658;181;496;2016;5503;2197;5999
241142;201710;742;2089;565;1742;48;169;327;973;375;1142
241150;201710;5371;15300;4832;14396;265;987;3702;10820;3967;11807
241160;201710;1171;3257;1063;3075;158;462;683;1912;841;2374
241170;201710;1152;3176;1041;2987;59;190;849;2371;908;2561
241180;201710;947;2582;706;2089;78;231;373;1093;451;1324
241190;201710;1090;2982;888;2574;36;136;636;1757;672;1893
241200;201710;17481;49205;15481;46178;3555;10931;7340;22547;10895;33478
241210;201710;1405;3893;1101;3286;110;346;668;1962;778;2308
241220;201710;7777;24989;7102;23750;2168;7309;3017;10562;5185;17871
241230;201710;2935;8276;2679;7863;110;426;2234;6370;2344;6796
241240;201710;1192;3472;715;2330;55;206;365;1189;420;1395
241250;201710;5847;17570;4830;15611;194;983;3583;11116;3777;12099
241255;201710;1787;6388;1599;5957;211;918;977;3597;1188;4515
241260;201710;4910;13201;3921;11610;129;591;2911;8403;3040;8994
241270;201710;1783;5363;1542;4882;113;449;1119;3473;1232;3922
241280;201710;1808;5084;1643;4792;115;352;1298;3734;1413;4086
241290;201710;2974;8006;2433;7086;110;399;1852;5285;1962;5684
241300;201710;1437;4027;1223;3637;42;134;835;2436;877;2570
241310;201710;1763;4909;1590;4622;53;206;1335;3818;1388;4024
241320;201710;878;3056;796;2856;96;395;516;1822;612;2217
241330;201710;1364;4097;1276;3981;53;230;1108;3400;1161;3630
241335;201710;2835;8301;2565;7818;122;432;2111;6343;2233;6775
241340;201710;1710;5189;1409;4503;304;1002;613;1921;917;2923
241350;201710;1845;5698;1675;5379;106;404;1263;3967;1369;4371
241355;201710;1316;3672;1065;3209;39;157;822;2444;861;2601
241360;201710;2047;5420;1656;4651;68;205;1229;3377;1297;3582
241370;201710;1341;3890;1077;3370;89;319;702;2106;791;2425
241380;201710;631;1758;510;1519;64;216;306;880;370;1096
241390;201710;2548;8181;2369;7893;179;669;1850;6162;2029;6831
241400;201710;3531;10114;3200;9623;258;830;2492;7490;2750;8320
241410;201710;2330;7059;2035;6563;390;1307;1150;3713;1540;5020
241415;201710;1584;4743;1372;4357;119;419;1028;3200;1147;3619
241420;201710;2015;6980;1800;6579;560;2173;562;2103;1122;4276
241430;201710;509;1492;394;1250;34;123;243;752;277;875
241440;201710;6554;22361;6017;21411;529;2202;4532;15997;5061;18199
241445;201710;917;2653;879;2607;31;71;803;2437;834;2508
241450;201710;2786;7336;2505;6931;246;652;1868;5190;2114;5842
241460;201710;3328;9473;2922;8634;211;721;2103;6046;2314;6767
241470;201710;1339;3662;1102;3333;63;231;881;2639;944;2870
241475;201710;1200;3569;967;3092;40;214;705;2123;745;2337
241480;201710;2595;8458;2323;7952;874;2995;629;2492;1503;5487
241490;201710;675;1740;544;1524;24;72;379;1025;403;1097
241500;201710;741;2309;638;2181;16;63;552;1883;568;1946
250010;201710;2690;8269;2237;7284;83;364;1649;5239;1732;5603
250020;201710;1554;4363;1169;3587;59;186;818;2464;877;2650
250030;201710;6630;18906;6057;18076;347;1152;4910;14424;5257;15576
250040;201710;3805;12553;3501;11921;340;1283;2468;8291;2808;9574
250050;201710;3221;9811;2987;9435;347;1144;2140;6682;2487;7826
250053;201710;1186;3543;1088;3393;115;387;768;2409;883;2796
250057;201710;622;2512;606;2495;4;15;581;2430;585;2445
250060;201710;5036;14372;4647;13832;430;1324;3613;10809;4043;12133
250070;201710;3771;11406;3462;10821;67;349;2685;8083;2752;8432
250073;201710;751;2170;646;1989;17;67;495;1468;512;1535
250077;201710;2099;5995;1657;5213;95;306;1190;3727;1285;4033
250080;201710;4126;11591;3864;11162;134;503;3254;9204;3388;9707
250090;201710;2617;7173;2423;6857;138;357;1998;5625;2136;5982
250100;201710;3730;11861;3481;11399;174;725;2848;9077;3022;9802
250110;201710;4668;13674;4365;13228;429;1559;3410;10065;3839;11624
250115;201710;492;1506;445;1430;18;97;334;1029;352;1126
250120;201710;1664;5240;1469;4863;60;273;1174;3876;1234;4149
250130;201710;5100;15585;4576;14620;133;713;3643;11353;3776;12066
250135;201710;1032;3091;964;2971;24;100;808;2458;832;2558
250140;201710;2035;6518;1973;6415;98;429;1641;5292;1739;5721
250150;201710;4743;15773;4384;15068;191;919;3388;11383;3579;12302
250153;201710;1443;3807;1188;3437;29;121;985;2789;1014;2910
250157;201710;1728;5485;1580;5171;202;620;1087;3619;1289;4239
250160;201710;3328;9387;3073;9013;65;227;2796;8184;2861;8411
250170;201710;1574;4486;1428;4261;73;277;1160;3409;1233;3686
250180;201710;15666;43865;14483;42148;1063;3609;10897;30972;11960;34581
250190;201710;3907;11238;3556;10653;540;1527;2292;6915;2832;8442
250200;201710;1825;5358;1549;4917;56;232;1264;3982;1320;4214
250205;201710;769;2645;720;2533;23;129;583;2022;606;2151
250210;201710;1455;4677;1349;4495;61;301;1064;3461;1125;3762
250215;201710;1357;4133;1210;3907;68;265;804;2570;872;2835
250220;201710;696;2021;561;1813;24;79;422;1360;446;1439
250230;201710;1586;3868;1227;3274;37;124;974;2504;1011;2628
250240;201710;2200;7091;2040;6798;76;302;1680;5545;1756;5847
250250;201710;4347;12872;3938;12304;128;452;3289;10253;3417;10705
250260;201710;1629;4762;1406;4377;43;147;1131;3515;1174;3662
250270;201710;1215;3768;1103;3620;83;272;829;2839;912;3111
250280;201710;3316;9735;2906;9080;159;560;2280;7079;2439;7639
250290;201710;1697;4631;1454;4290;16;44;1221;3605;1237;3649
250300;201710;5022;14700;4779;14389;280;1161;4075;11945;4355;13106
250310;201710;1070;3200;952;2986;34;138;744;2266;778;2404
250320;201710;8243;22784;7643;21962;679;2160;5980;16942;6659;19102
250330;201710;2343;7078;1994;6554;124;458;1546;5013;1670;5471
250340;201710;1048;2991;927;2791;16;59;784;2322;800;2381
250350;201710;4012;11183;3676;10737;133;391;3211;9415;3344;9806
250355;201710;1902;5944;1757;5761;26;143;1600;5216;1626;5359
250360;201710;1759;5119;1645;4928;34;116;1371;4096;1405;4212
250370;201710;11195;31721;9875;30045;553;1894;8242;24938;8795;26832
250375;201710;1003;2969;913;2837;17;59;818;2572;835;2631
250380;201710;1592;4437;1505;4323;54;198;1241;3441;1295;3639
250390;201710;1738;4710;1452;4228;185;518;964;2830;1149;3348
250400;201710;66936;175364;51998;151409;13812;42034;18121;54457;31933;96491
250403;201710;1523;4909;1410;4749;164;696;974;3173;1138;3869
250407;201710;1191;3203;1022;2949;79;186;746;2159;825;2345
250410;201710;524;1620;478;1532;12;62;393;1207;405;1269
250415;201710;1892;5551;1683;5186;66;219;1327;4081;1393;4300
250420;201710;1171;3415;1078;3279;18;65;989;3012;1007;3077
250430;201710;6053;15870;5394;14889;204;650;4439;12011;4643;12661
250435;201710;1327;3977;1177;3714;45;180;897;2788;942;2968
250440;201710;4360;12284;3912;11659;102;395;3346;9861;3448;10256
250450;201710;1808;5046;1563;4706;35;131;1305;3873;1340;4004
250460;201710;6263;18360;5909;17911;288;900;5189;15879;5477;16779
250470;201710;1472;3951;1233;3602;68;253;923;2613;991;2866
250480;201710;3624;10789;3324;10390;47;202;2992;9398;3039;9600
250485;201710;680;1609;499;1340;26;75;403;1048;429;1123
250490;201710;4103;11660;3825;11307;301;984;3093;9111;3394;10095
250500;201710;1818;5318;1636;5008;85;280;1314;4015;1399;4295
250510;201710;4962;13387;4361;12561;84;264;3910;11289;3994;11553
250520;201710;1683;4951;1554;4763;201;690;1018;3034;1219;3724
250523;201710;1864;5144;1747;4993;78;338;1516;4210;1594;4548
250527;201710;1522;4306;1457;4221;32;122;1354;3884;1386;4006
250530;201710;569;1719;506;1635;19;84;446;1424;465;1508
250535;201710;1320;4044;1215;3838;39;194;953;2932;992;3126
250540;201710;2369;6397;2171;6167;63;173;1934;5493;1997;5666
250550;201710;836;2803;761;2676;33;168;615;2105;648;2273
250560;201710;1602;4839;1495;4666;47;180;1242;3782;1289;3962
250570;201710;2487;7733;2202;7200;92;412;1757;5589;1849;6001
250580;201710;1030;2747;941;2610;48;189;787;2122;835;2311
250590;201710;797;2415;718;2288;23;113;590;1818;613;1931
250600;201710;7060;20083;6512;19246;543;1448;5180;15501;5723;16949
250610;201710;2923;8478;2713;8157;166;570;2207;6563;2373;7133
250620;201710;672;1922;596;1772;47;179;431;1238;478;1417
250625;201710;2473;7517;2312;7260;43;178;2040;6311;2083;6489
250630;201710;9012;27121;8048;25148;1345;4331;4778;14729;6123;19060
250640;201710;3293;9923;3103;9656;125;554;2619;7957;2744;8511
250650;201710;835;2193;720;2043;35;113;573;1575;608;1688
250660;201710;1655;4281;1500;4077;26;64;1385;3757;1411;3821
250670;201710;2228;7348;2108;7134;66;354;1793;5916;1859;6270
250680;201710;4807;12811;4514;12473;149;531;4067;11099;4216;11630
250690;201710;6002;14907;5720;14577;216;527;5263;13405;5479;13932
250700;201710;4226;12383;3843;11782;422;1342;2792;8490;3214;9832
250710;201710;4258;12945;3804;12318;362;1277;2703;8828;3065;10105
250720;201710;2674;7365;2459;7018;46;206;2225;6273;2271;6479
250730;201710;3602;10306;3263;9831;206;739;2660;7809;2866;8548
250740;201710;1831;5031;1562;4635;145;466;1200;3482;1345;3948
250750;201710;91350;250564;82959;238259;9273;28809;56094;158406;65367;187215
250760;201710;2260;6174;1987;5753;128;411;1548;4402;1676;4813
250770;201710;3724;12151;3463;11803;302;1196;2556;8653;2858;9849
250780;201710;1658;4779;1424;4311;138;473;974;2880;1112;3353
250790;201710;2214;7093;2072;6843;329;1098;1294;4351;1623;5449
250800;201710;2441;6755;2131;6248;80;212;1752;5108;1832;5320
250810;201710;1216;3481;1038;3213;41;168;838;2554;879;2722
250820;201710;1771;5584;1716;5517;80;337;1531;4865;1611;5202
250830;201710;5141;16285;4724;15367;375;1465;3357;10666;3732;12131
250840;201710;843;2703;732;2478;22;95;506;1727;528;1822
250850;201710;1879;5680;1682;5352;52;274;1355;4177;1407;4451
250855;201710;1035;3044;900;2811;34;157;681;2067;715;2224
250860;201710;3097;9783;2624;8928;496;1799;1293;4453;1789;6252
250870;201710;1051;2988;907;2712;33;118;728;2154;761;2272
250880;201710;1491;4033;1224;3635;163;467;791;2415;954;2882
250890;201710;8995;26051;8591;25500;716;2664;6786;19575;7502;22239
250900;201710;2606;8175;2299;7580;106;388;1845;5973;1951;6361
250905;201710;2043;6238;1965;6138;97;381;1702;5258;1799;5639
250910;201710;4852;13633;4546;13192;150;548;3938;11353;4088;11901
250915;201710;1454;4239;1367;4141;28;56;1266;3920;1294;3976
250920;201710;3102;8653;2904;8344;323;874;2130;6086;2453;6960
250930;201710;1913;5627;1825;5480;97;355;1505;4432;1602;4787
250933;201710;1084;3491;973;3263;50;238;679;2199;729;2437
250937;201710;678;1979;570;1780;34;124;429;1315;463;1439
250939;201710;1596;4550;1393;4231;53;214;1118;3294;1171;3508
250940;201710;3632;10529;3399;10152;54;214;3046;9103;3100;9317
250950;201710;1396;4021;1187;3739;38;163;1023;3208;1061;3371
250960;201710;1040;3240;957;3098;30;131;783;2485;813;2616
250970;201710;8186;22328;7120;20611;450;1505;5357;15245;5807;16750
250980;201710;2459;7064;2250;6668;65;274;1800;5164;1865;5438
250990;201710;1878;6170;1664;5695;107;471;1218;4067;1325;4538
251000;201710;2016;5824;1715;5352;48;235;1437;4410;1485;4645
251010;201710;2581;7530;2336;7132;46;176;2096;6399;2142;6575
251020;201710;1623;4471;1495;4310;55;172;1360;3905;1415;4077
251030;201710;967;2744;866;2528;47;175;614;1730;661;1905
251040;201710;1733;5274;1532;4927;59;287;1235;3847;1294;4134
251050;201710;1057;3017;876;2670;106;337;592;1764;698;2101
251060;201710;1018;2274;749;1924;18;84;603;1497;621;1581
251065;201710;447;1286;366;1172;17;76;247;735;264;811
251070;201710;715;2107;639;2006;17;68;544;1691;561;1759
251080;201710;17713;48727;15767;45718;2818;8554;9072;26609;11890;35163
251090;201710;2748;8245;2387;7543;87;334;1866;5799;1953;6133
251100;201710;870;2723;771;2551;35;164;540;1697;575;1861
251110;201710;1715;4920;1506;4509;61;187;1143;3380;1204;3567
251120;201710;6165;20023;5782;19328;391;1610;4451;14682;4842;16292
251130;201710;3597;9008;3277;8643;387;1032;2720;7159;3107;8191
251140;201710;4214;12398;3890;11919;117;479;3230;9822;3347;10301
251150;201710;2579;7918;2383;7616;141;618;1882;5845;2023;6463
251160;201710;1862;5987;1750;5811;72;248;1553;5197;1625;5445
251170;201710;1460;4256;1358;4138;39;153;1228;3736;1267;3889
251180;201710;2417;7177;2159;6773;238;823;1421;4404;1659;5227
251190;201710;4337;11782;4133;11524;81;303;3766;10317;3847;10620
251200;201710;3934;12497;3697;12196;85;352;3327;11027;3412;11379
251203;201710;935;3123;888;3023;40;182;673;2228;713;2410
251207;201710;993;3021;824;2703;23;126;578;1837;601;1963
251210;201710;7355;20211;6195;18707;331;1026;4975;15135;5306;16161
251220;201710;1147;2952;926;2653;44;110;728;2105;772;2215
251230;201710;4526;12723;4046;12074;172;634;3443;10070;3615;10704
251240;201710;3325;9625;2901;9026;226;742;2170;6621;2396;7363
251250;201710;9663;27757;8950;26712;882;2877;6444;18748;7326;21625
251260;201710;447;1411;406;1335;11;51;312;1010;323;1061
251270;201710;4071;13085;3700;12607;131;590;3149;10737;3280;11327
251272;201710;1273;3574;1190;3454;39;146;1058;3047;1097;3193
251274;201710;881;2625;736;2361;52;226;497;1504;549;1730
251275;201710;1208;3488;1099;3308;42;177;837;2394;879;2571
251276;201710;1092;3267;1044;3190;56;248;863;2580;919;2828
251278;201710;590;1778;521;1647;48;181;355;1116;403;1297
251280;201710;2204;6383;2022;6076;61;263;1623;4716;1684;4979
251290;201710;5491;14617;5189;14230;348;1260;4294;11394;4642;12654
251300;201710;740;2398;700;2329;13;57;585;1920;598;1977
251310;201710;2740;8134;2526;7809;94;443;2037;6117;2131;6560
251315;201710;1600;5283;1504;5112;99;360;1164;3918;1263;4278
251320;201710;1697;4592;1228;3804;58;214;865;2663;923;2877
251330;201710;1803;4617;1488;4218;46;179;1337;3744;1383;3923
251335;201710;999;3192;906;3043;53;226;692;2252;745;2478
251340;201710;3388;9304;2907;8646;126;434;2216;6491;2342;6925
251350;201710;1093;3398;1015;3266;35;159;827;2575;862;2734
251360;201710;1732;5295;1445;4896;26;108;1246;4271;1272;4379
251365;201710;708;2095;578;1809;12;53;449;1389;461;1442
251370;201710;22227;66146;21232;64762;2032;6885;16055;48444;18087;55329
251380;201710;1246;3785;1083;3510;27;133;913;2857;940;2990
251385;201710;701;1850;559;1616;21;68;402;1106;423;1174
251390;201710;5690;18347;4989;17004;1106;3958;2518;8519;3624;12477
251392;201710;976;2809;848;2594;43;167;624;1852;667;2019
251394;201710;611;1992;530;1850;30;134;400;1369;430;1503
251396;201710;741;2079;635;1903;44;122;433;1282;477;1404
251398;201710;898;2475;695;2115;27;111;500;1462;527;1573
251400;201710;1086;3023;918;2776;48;175;666;1933;714;2108
251410;201710;1566;3915;1300;3506;26;100;1088;2844;1114;2944
251420;201710;1838;5171;1562;4844;69;287;1216;3671;1285;3958
251430;201710;1520;4977;1379;4740;43;223;1190;4028;1233;4251
251440;201710;1121;3335;919;2936;29;111;727;2309;756;2420
251445;201710;1506;4484;1420;4367;91;354;1126;3367;1217;3721
251450;201710;4270;13305;3904;12781;92;428;3265;10592;3357;11020
251455;201710;989;3108;880;2890;56;247;655;2095;711;2342
251460;201710;814;2481;741;2362;31;124;612;1971;643;2095
251465;201710;424;1337;359;1185;15;73;273;882;288;955
251470;201710;1115;3172;870;2652;80;259;544;1618;624;1877
251480;201710;902;2489;786;2303;28;118;580;1627;608;1745
251490;201710;1733;5025;1512;4685;120;399;1028;3127;1148;3526
251500;201710;1730;5364;1635;5187;82;329;1373;4274;1455;4603
251510;201710;2408;7804;2164;7304;237;895;1342;4458;1579;5353
251520;201710;939;2556;738;2152;88;234;462;1336;550;1570
251530;201710;11974;32230;11124;31050;197;888;9811;26857;10008;27745
251540;201710;2738;8501;2508;8056;122;475;1989;6288;2111;6763
251550;201710;3416;8792;2820;8006;80;287;2343;6591;2423;6878
251560;201710;600;1888;544;1794;99;356;319;1004;418;1360
251570;201710;927;2726;767;2407;27;108;541;1634;568;1742
251580;201710;1778;4756;1614;4534;174;449;1247;3524;1421;3973
251590;201710;1466;4179;1356;4034;61;181;1101;3264;1162;3445
251593;201710;951;2881;875;2765;121;391;524;1627;645;2018
251597;201710;1940;5792;1862;5690;27;108;1703;5167;1730;5275
251600;201710;6286;17953;5746;17118;221;756;4780;14077;5001;14833
251610;201710;3241;9457;2846;8711;323;937;1959;6084;2282;7021
251615;201710;1107;3039;897;2683;28;130;660;1893;688;2023
251620;201710;15473;39766;13731;37734;314;791;11549;33347;11863;34138
251630;201710;4456;11190;3720;10153;221;622;2816;7609;3037;8231
251640;201710;2033;6087;1865;5766;72;317;1569;4742;1641;5059
251650;201710;3914;10938;3542;10442;178;618;3001;8781;3179;9399
251660;201710;3381;10593;3023;9945;100;494;2501;8036;2601;8530
251670;201710;4248;12403;3775;11785;32;155;3502;10977;3534;11132
251675;201710;684;2084;631;2015;103;355;403;1266;506;1621
251680;201710;2601;7383;2142;6685;57;217;1750;5424;1807;5641
251690;201710;3248;9422;2854;8664;92;307;2083;6180;2175;6487
251700;201710;1828;5830;1713;5679;82;389;1429;4622;1511;5011
251710;201710;807;2167;552;1631;62;224;276;787;338;1011
251720;201710;1373;4067;1144;3636;37;163;873;2687;910;2850
251740;201710;660;1885;533;1657;42;136;350;1068;392;1204
260005;201710;24869;58340;21353;53445;3025;7445;13964;34976;16989;42421
260010;201710;9432;25369;7973;23297;609;1811;5006;14985;5615;16796
260020;201710;6299;16260;5361;14916;142;564;4474;12349;4616;12913
260030;201710;6014;16749;5303;15628;260;915;4213;12369;4473;13284
260040;201710;8263;22161;6995;20473;718;2051;4940;14752;5658;16803
260050;201710;10897;33260;10203;32417;353;1428;8951;28574;9304;30002
260060;201710;3708;10265;3285;9516;269;738;2477;7263;2746;8001
260070;201710;9490;26478;8626;25122;717;2392;6320;18094;7037;20486
260080;201710;6175;15223;5532;14294;230;696;4551;11523;4781;12219
260090;201710;5089;13424;4700;12905;546;1474;3530;9820;4076;11294
260100;201710;3157;8651;2724;8029;140;507;2220;6505;2360;7012
260105;201710;4970;13692;4670;13228;131;555;4011;11125;4142;11680
260110;201710;21608;58414;19746;56108;997;2974;17081;48584;18078;51558
260120;201710;12884;37035;11319;34488;1929;6012;6575;20600;8504;26612
260130;201710;3001;8291;2788;7953;275;839;2082;5838;2357;6677
260140;201710;11831;29391;10586;27845;563;1690;8873;23309;9436;24999
260150;201710;3212;8381;2815;7874;171;566;2311;6404;2482;6970
260160;201710;5634;16875;4841;15811;140;652;4116;13537;4256;14189
260170;201710;16219;44054;15289;42754;1092;3008;12474;34958;13566;37966
260180;201710;3219;9420;2933;8989;158;567;2481;7527;2639;8094
260190;201710;16204;36232;14521;34197;266;812;12739;29463;13005;30275
260200;201710;10931;27278;9796;25833;371;1100;8705;22810;9076;23910
260210;201710;11640;34232;10182;31877;397;1562;8269;25803;8666;27365
260220;201710;9437;25314;9028;24799;280;971;8154;22162;8434;23133
260230;201710;9611;26192;8676;24922;399;1372;6992;19940;7391;21312
260240;201710;2796;8288;2454;7763;210;721;1893;5999;2103;6720
260250;201710;2126;5894;1869;5523;84;300;1513;4383;1597;4683
260260;201710;11753;32942;10580;31192;606;2121;8365;24414;8971;26535
260270;201710;3502;9978;3233;9577;203;861;2486;7099;2689;7960
260280;201710;12667;40021;11750;38667;513;1979;10128;33326;10641;35305
260290;201710;33104;94287;30745;90359;4584;13997;19657;57359;24241;71356
260300;201710;8830;25938;7812;24436;284;1268;6291;19572;6575;20840
260310;201710;4252;12247;3848;11661;571;1606;2622;8236;3193;9842
260320;201710;7193;22119;6568;21009;293;1094;5365;17029;5658;18123
260330;201710;2468;7826;2282;7469;114;440;1800;5769;1914;6209
260340;201710;1899;5336;1710;5063;31;124;1510;4438;1541;4562
260345;201710;21492;63525;19865;60615;4482;14791;8790;25904;13272;40695
260350;201710;4865;12703;4472;12162;157;531;3877;10433;4034;10964
260360;201710;2431;6699;2195;6284;82;367;1528;4290;1610;4657
260370;201710;5320;16170;4724;15078;269;1096;3585;11270;3854;12366
260380;201710;4719;15044;4224;14214;225;909;3129;10446;3354;11355
260390;201710;4145;13007;3597;11880;264;954;2478;8072;2742;9026
260392;201710;3387;10953;3097;10564;166;816;2581;8654;2747;9470
260400;201710;13621;36570;12747;35227;1153;3506;9570;25998;10723;29504
260410;201710;56929;158046;48842;145459;11846;37347;20020;61312;31866;98659
260415;201710;3602;10996;3197;10168;156;711;2268;6927;2424;7638
260420;201710;11983;27055;10708;25651;167;565;9859;23416;10026;23981
260430;201710;2851;8986;2471;8248;168;636;1713;5677;1881;6313
260440;201710;3327;9560;2968;8891;213;780;2232;6500;2445;7280
260450;201710;5006;13916;4783;13612;157;500;4295;12222;4452;12722
260460;201710;5203;16479;4741;15574;664;2458;2802;8973;3466;11431
260470;201710;4624;13052;4079;12421;113;310;3642;11393;3755;11703
260480;201710;4108;11245;3515;10401;374;1228;2330;7036;2704;8264
260490;201710;4887;12403;4327;11449;118;426;3727;9597;3845;10023
260500;201710;5737;15812;5004;14688;582;1663;3337;9937;3919;11600
260510;201710;8894;22623;7942;21357;260;849;7057;18820;7317;19669
260515;201710;4460;13059;3433;11023;173;618;2257;7167;2430;7785
260520;201710;16342;40858;15424;39622;1159;3040;12492;31856;13651;34896
260530;201710;9109;27755;8022;26025;258;1110;6761;21832;7019;22942
260540;201710;5754;14280;5244;13698;642;1282;4205;11476;4847;12758
260545;201710;47;142;22;83;7;24;3;13;10;37
260550;201710;2721;8478;2318;7601;234;928;1365;4395;1599;5323
260560;201710;6097;15869;5348;14834;137;568;4616;12626;4753;13194
260570;201710;6729;20739;6166;19875;599;2004;4704;15210;5303;17214
260580;201710;3769;10076;3420;9540;58;247;3058;8389;3116;8636
260590;201710;6249;15498;5742;14930;254;691;4990;13021;5244;13712
260600;201710;28210;79290;24760;73708;1471;5229;18306;53738;19777;58967
260610;201710;6201;17976;5898;17494;533;1684;4482;13200;5015;14884
260620;201710;14411;42498;13704;41322;2054;6866;8871;26168;10925;33034
260630;201710;2290;6364;1945;5844;52;217;1623;4835;1675;5052
260640;201710;17519;45590;16088;43751;1318;3974;12175;32805;13493;36779
260650;201710;5234;15883;4594;14810;195;834;3783;12115;3978;12949
260660;201710;7254;19862;6482;18863;188;762;5524;15836;5712;16598
260670;201710;2239;5912;1863;5362;104;310;1344;3832;1448;4142
260680;201710;21530;58537;19378;54898;2850;8182;11002;31130;13852;39312
260690;201710;3560;9505;2983;8577;125;396;2401;6870;2526;7266
260700;201710;5640;17056;5487;16887;22;37;5382;16723;5404;16760
260710;201710;1286;3583;1217;3490;73;259;911;2673;984;2932
260720;201710;18355;54843;17066;52529;3009;9458;10011;30806;13020;40264
260730;201710;6623;21187;6163;20442;432;1689;4939;16108;5371;17797
260740;201710;1284;3761;1139;3522;32;107;942;2919;974;3026
260750;201710;6793;19652;5965;18599;152;444;5368;17041;5520;17485
260760;201710;4866;12655;4501;12213;228;697;3749;10197;3977;10894
260765;201710;7200;23866;6762;23145;833;3504;4571;15170;5404;18674
260770;201710;3697;9884;3262;9170;104;339;2577;7196;2681;7535
260775;201710;4832;13882;4548;13441;322;1240;3391;9713;3713;10953
260780;201710;3499;10904;3269;10474;491;1732;2055;6426;2546;8158
260790;201710;104547;257556;95793;244700;17801;45608;56291;143493;74092;189101
260795;201710;3001;8487;2657;7960;154;533;1995;5996;2149;6529
260800;201710;5269;12950;4823;12330;109;377;4314;10694;4423;11071
260805;201710;3549;10668;3029;9760;241;918;2105;6711;2346;7629
260810;201710;6247;17550;5891;16906;528;1558;4542;12927;5070;14485
260820;201710;4039;10769;3590;10089;359;1232;2508;6822;2867;8054
260825;201710;2791;8770;2494;8271;136;562;1878;6177;2014;6739
260830;201710;3882;11954;3357;10955;472;1472;2232;7431;2704;8903
260840;201710;4090;11553;3638;10879;210;661;2951;8779;3161;9440
260845;201710;3929;11148;3722;10774;319;924;2769;8025;3088;8949
260850;201710;4808;14744;4247;13570;575;1961;2434;7632;3009;9593
260860;201710;3481;10302;2987;9329;130;504;2336;7173;2466;7677
260870;201710;4126;10764;3669;10172;125;474;3172;8642;3297;9116
260875;201710;6266;17165;5404;15785;708;2107;3503;10342;4211;12449
260880;201710;9618;27887;8642;26312;399;1295;6988;21385;7387;22680
260890;201710;12447;35100;11630;33826;940;3104;8435;24116;9375;27220
260900;201710;5382;16324;4659;14989;332;1325;3125;9856;3457;11181
260910;201710;3033;8909;2711;8354;119;437;2082;6383;2201;6820
260915;201710;4541;14715;4234;14279;67;354;3891;13081;3958;13435
260920;201710;3174;9382;2909;9030;126;441;2443;7701;2569;8142
260930;201710;3620;11811;3250;11164;234;900;2438;8361;2672;9261
260940;201710;13749;35185;12575;33297;1171;3397;9034;23498;10205;26895
260950;201710;6139;18318;5252;16576;774;2630;2648;7999;3422;10629
260960;201710;55410;144153;49432;134760;8243;23940;27776;74579;36019;98519
260970;201710;4793;14028;4393;13507;180;609;3496;10825;3676;11434
260980;201710;4116;12826;3782;12405;84;363;3402;11140;3486;11503
260990;201710;16723;50043;15024;47678;926;3379;11736;37171;12662;40550
261000;201710;15074;39474;12635;35919;1170;3604;8329;23998;9499;27602
261010;201710;2444;6665;2216;6376;74;184;1997;5795;2071;5979
261020;201710;6210;17635;5429;16218;456;1477;4045;11770;4501;13247
261030;201710;3719;11171;3285;10460;135;539;2646;8297;2781;8836
261040;201710;5000;15725;4228;14089;288;1121;3032;9901;3320;11022
261050;201710;7174;20419;6679;19587;712;2059;4587;13517;5299;15576
261060;201710;12120;33805;11215;32339;833;2644;8754;24949;9587;27593
261070;201710;51898;122859;45619;113975;4087;10346;32893;81581;36980;91927
261080;201710;5588;15492;5314;15096;230;660;4737;13541;4967;14201
261090;201710;16129;42843;14821;41036;609;1976;12604;34660;13213;36636
261100;201710;7867;23996;7005;22542;904;2998;4577;15024;5481;18022
261110;201710;56884;168366;50340;158058;12408;40709;22622;73031;35030;113740
261120;201710;3714;9664;3254;9102;69;229;2922;8186;2991;8415
261130;201710;7142;17789;6558;17119;162;485;5862;15273;6024;15758
261140;201710;3184;8301;2913;7898;278;832;2140;5743;2418;6575
261150;201710;5123;14316;4655;13582;165;604;3989;11539;4154;12143
261153;201710;1950;5867;1678;5416;85;346;1186;3794;1271;4140
261160;201710;188681;483684;171995;458854;44175;122891;72646;197283;116821;320174
261170;201710;5610;14786;5123;14096;273;747;4152;11396;4425;12143
261180;201710;9274;25125;8630;24223;729;2251;6226;17325;6955;19576
261190;201710;4719;14463;4385;14023;405;1596;3189;9973;3594;11569
261200;201710;3402;8193;3039;7755;262;692;2396;6064;2658;6756
261210;201710;1807;4690;1662;4497;80;233;1457;3941;1537;4174
261220;201710;13059;39341;11129;35491;1593;5497;6225;19725;7818;25222
261230;201710;4363;13364;3922;12782;98;420;3314;10919;3412;11339
261240;201710;4796;13294;4330;12546;352;988;3370;9790;3722;10778
261245;201710;3415;10298;2957;9488;127;578;2312;7189;2439;7767
261247;201710;2937;9029;2527;8272;159;607;1812;5912;1971;6519
261250;201710;17938;46617;16564;44781;3017;7872;10490;29500;13507;37372
261255;201710;3948;12070;3488;11224;189;828;2732;8553;2921;9381
261260;201710;12293;34135;10856;32370;406;1503;9207;27544;9613;29047
261270;201710;3698;10681;3358;10115;242;844;2558;7512;2800;8356
261280;201710;2516;7408;2283;7013;90;384;1847;5540;1937;5924
261290;201710;2819;7949;2519;7546;130;497;2005;5998;2135;6495
261300;201710;10929;33413;9522;30830;805;3121;6551;20710;7356;23831
261310;201710;6728;20100;6234;19263;1330;4142;3607;11171;4937;15313
261320;201710;5678;16915;5136;15968;137;573;4261;13028;4398;13601
261330;201710;5544;15025;5193;14565;210;819;4503;12361;4713;13180
261340;201710;3834;12294;3542;11824;255;1084;2611;8625;2866;9709
261350;201710;7998;24997;7470;24118;179;945;6189;19560;6368;20505
261360;201710;8089;20708;7037;19224;396;1152;5634;15115;6030;16267
261370;201710;18336;52772;17120;50815;3330;10199;9832;29265;13162;39464
261380;201710;3862;12741;3602;12199;541;2023;2234;7440;2775;9463
261390;201710;15795;47234;14058;44268;1694;5750;8671;27293;10365;33043
261400;201710;4530;15252;4037;14193;212;940;2952;10204;3164;11144
261410;201710;8919;23967;7778;22153;560;1710;6207;17610;6767;19320
261420;201710;6778;22379;6467;21963;1146;4434;4135;13878;5281;18312
261430;201710;3434;10214;2938;9445;134;449;2369;7652;2503;8101
261440;201710;1499;4640;1346;4355;46;231;977;3064;1023;3295
261450;201710;13330;38102;12769;37366;356;1310;11004;32056;11360;33366
261460;201710;6844;19842;6378;19169;279;940;5555;16630;5834;17570
261470;201710;3997;10697;3665;10259;59;258;3073;8627;3132;8885
261480;201710;4141;13785;3719;13064;224;948;2862;9841;3086;10789
261485;201710;4854;14490;4272;13504;451;1639;2846;8855;3297;10494
261500;201710;5359;14781;4777;13978;411;1172;3489;10481;3900;11653
261510;201710;1800;5678;1595;5316;100;383;1195;4009;1295;4392
261520;201710;2554;7972;2407;7690;96;368;1639;5396;1735;5764
261530;201710;10315;32876;9191;30640;1541;5779;4309;14204;5850;19983
261540;201710;7073;21939;6555;21063;1205;3881;3831;12598;5036;16479
261550;201710;3414;9390;3154;9011;248;835;2384;6674;2632;7509
261560;201710;7169;22615;6472;21667;554;2257;4906;16371;5460;18628
261570;201710;3314;9593;2854;8831;255;916;1910;5798;2165;6714
261580;201710;6033;17348;5545;16587;173;745;4866;14356;5039;15101
261590;201710;2547;6904;2139;6275;106;324;1649;4881;1755;5205
261600;201710;5095;13546;4333;12425;366;1066;3009;8761;3375;9827
261610;201710;2432;6656;2076;6130;74;272;1646;4850;1720;5122
261618;201710;2383;6460;2160;6156;101;322;1781;5004;1882;5326
261620;201710;3839;11784;3610;11404;812;2440;2128;7034;2940;9474
261630;201710;6860;19785;5888;17985;533;1964;3649;10727;4182;12691
261640;201710;33225;80432;31060;77827;1846;4148;25559;66276;27405;70424
261650;201710;3846;10718;3532;10299;164;639;2672;7814;2836;8453
270010;201710;4204;15231;3851;14556;208;1098;3024;11239;3232;12337
270020;201710;3688;9992;3390;9563;243;840;2781;7608;3024;8448
270030;201710;33604;98227;30786;93568;5042;15530;19180;58852;24222;74382
270040;201710;10231;30099;9363;28969;678;2433;7441;22998;8119;25431
270050;201710;4515;11785;4084;11278;254;682;3512;9819;3766;10501
270060;201710;1829;5154;1674;4956;197;608;1197;3604;1394;4212
270070;201710;4294;12978;3904;12419;162;757;3278;10157;3440;10914
270080;201710;1273;3880;1087;3526;101;354;770;2441;871;2795
270090;201710;1977;6174;1773;5771;82;389;1390;4364;1472;4753
270100;201710;5212;15408;4883;14897;378;1350;3836;11540;4214;12890
270110;201710;2832;7733;2475;7328;208;655;1924;5843;2132;6498
270120;201710;2969;8170;2630;7747;77;299;2349;6892;2426;7191
270130;201710;5061;14451;4514;13828;340;1137;3687;11420;4027;12557
270135;201710;1819;4755;1611;4505;99;226;1420;4040;1519;4266
270140;201710;10121;23404;8472;21246;457;1779;6946;16503;7403;18282
270150;201710;2581;8165;2502;8069;21;68;2457;7934;2478;8002
270160;201710;4849;15747;4457;15262;131;663;3884;13170;4015;13833
270170;201710;3493;10965;3138;10457;340;1439;2186;7055;2526;8494
270180;201710;2220;7092;2052;6855;72;342;1745;5718;1817;6060
270190;201710;1683;5302;1586;5173;65;239;1354;4436;1419;4675
270200;201710;2457;7826;2206;7486;162;701;1640;5395;1802;6096
270210;201710;4872;13354;4499;12872;210;671;3980;11335;4190;12006
270220;201710;1207;3789;1106;3630;235;864;613;1967;848;2831
270230;201710;9396;29032;8325;27259;890;3564;5325;16847;6215;20411
270235;201710;5752;18552;5370;17942;287;1192;4378;14499;4665;15691
270240;201710;9958;28417;8508;26559;1386;4727;5601;17380;6987;22107
270250;201710;2871;7588;2604;7246;335;864;1948;5501;2283;6365
270255;201710;4571;13661;3649;11978;216;903;2634;8421;2850;9324
270260;201710;5473;17011;5215;16627;189;848;4541;14100;4730;14948
270270;201710;1077;2984;993;2870;165;502;628;1777;793;2279
270280;201710;3541;9550;3039;8851;391;853;2148;6526;2539;7379
270290;201710;7591;25406;7087;24542;382;1782;5814;19800;6196;21582
270300;201710;3882;11197;3192;10437;271;970;2351;7723;2622;8693
270310;201710;6955;20651;6177;19480;204;1046;5158;15778;5362;16824
270320;201710;5641;17136;5182;16334;706;2398;3563;11029;4269;13427
270330;201710;3835;13086;3544;12692;320;1233;2756;9954;3076;11187
270340;201710;1577;4685;1381;4414;83;325;1119;3502;1202;3827
270350;201710;1811;4717;1613;4454;165;482;1172;3256;1337;3738
270360;201710;2172;6246;2017;6057;117;328;1786;5453;1903;5781
270370;201710;1392;4553;1281;4354;70;310;988;3332;1058;3642
270375;201710;2901;7504;2535;7048;51;141;2308;6453;2359;6594
270380;201710;5462;16710;5021;16099;411;1360;3851;12576;4262;13936
270390;201710;1200;3265;1030;3012;34;128;817;2337;851;2465
270400;201710;6073;17509;5379;16461;240;974;4138;12274;4378;13248
270410;201710;4537;14110;4126;13386;312;1176;3056;9771;3368;10947
270420;201710;5554;17224;5254;16832;213;970;4360;13685;4573;14655
270430;201710;127450;348968;108960;322699;29119;90791;40360;124111;69479;214902
270440;201710;4584;13378;4159;12822;140;588;3438;10539;3578;11127
270450;201710;6229;18433;5833;17911;346;1297;4797;14592;5143;15889
270460;201710;3286;8302;2940;7892;81;263;2625;6947;2706;7210
270470;201710;10145;31402;9314;30107;1059;3740;6490;21223;7549;24963
270480;201710;2782;8164;2415;7567;250;925;1759;5332;2009;6257
270490;201710;968;2924;869;2799;52;205;683;2179;735;2384
270500;201710;4735;15375;4404;14958;186;924;3703;12364;3889;13288
270510;201710;5738;16336;5114;15469;554;2104;3712;10733;4266;12837
270520;201710;3458;10683;3024;9899;968;3355;964;3384;1932;6739
270530;201710;1191;3676;1099;3540;72;240;827;2678;899;2918
270540;201710;2011;6404;1849;6179;87;443;1547;5007;1634;5450
270550;201710;6204;18197;5648;17513;561;1762;4299;13644;4860;15406
270560;201710;3053;8780;2782;8383;175;605;2168;6462;2343;7067
270570;201710;3671;11483;3295;10862;179;752;2656;8608;2835;9360
270580;201710;2086;6223;1978;6073;76;233;1757;5436;1833;5669
270590;201710;1431;4518;1356;4427;6;25;1335;4361;1341;4386
270600;201710;2725;8810;2465;8371;116;588;2068;6844;2184;7432
270610;201710;3224;9508;2935;9096;125;501;2530;7710;2655;8211
270620;201710;1310;4204;1213;4032;58;272;1016;3259;1074;3531
270630;201710;14369;41809;13113;39821;1357;4359;9616;29358;10973;33717
270640;201710;5435;16402;4865;15511;238;1014;3943;12270;4181;13284
270642;201710;2249;7730;2104;7514;145;752;1674;5785;1819;6537
270644;201710;2888;8133;2508;7616;262;828;1834;5676;2096;6504
270650;201710;3393;10443;3200;10174;427;1766;2278;6896;2705;8662
270660;201710;2099;5356;1669;4753;83;307;1228;3477;1311;3784
270670;201710;15324;38811;13474;36683;1185;3191;10558;29173;11743;32364
270680;201710;4371;12227;4137;11968;70;155;3943;11505;4013;11660
270690;201710;9083;23621;8066;22487;1616;4134;5482;16036;7098;20170
270700;201710;545;1710;477;1594;57;245;323;1033;380;1278
270710;201710;5771;17707;5410;17251;303;1289;4555;14254;4858;15543
270720;201710;3279;10604;2944;10027;113;668;2462;8157;2575;8825
270730;201710;6552;17659;6100;17164;400;1006;5318;15251;5718;16257
270740;201710;2244;6229;2091;6016;109;408;1759;4976;1868;5384
270750;201710;4993;14802;4575;14157;423;1521;3511;10791;3934;12312
270760;201710;3413;9876;3047;9323;93;395;2571;7758;2664;8153
270770;201710;18722;48064;15562;44258;2970;8073;9094;27653;12064;35726
270780;201710;1762;5386;1660;5244;125;434;1329;4214;1454;4648
270790;201710;1452;4509;1336;4339;204;684;855;2788;1059;3472
270800;201710;10546;30838;9782;29779;469;2058;8361;24818;8830;26876
270810;201710;2995;9167;2477;8223;206;832;1711;5598;1917;6430
270820;201710;1704;5335;1485;4961;157;591;1048;3460;1205;4051
270830;201710;5444;13615;4774;12812;314;917;3876;10537;4190;11454
270840;201710;7850;24201;7181;23284;237;1309;6267;19754;6504;21063
270850;201710;7629;21670;7137;21024;588;2268;5640;15895;6228;18163
270860;201710;10312;27948;8858;26148;792;2676;6629;19249;7421;21925
270870;201710;2025;6024;1757;5508;203;686;1215;3763;1418;4449
270880;201710;7918;24629;7325;23765;348;1495;6052;19294;6400;20789
270890;201710;2334;6956;2135;6625;177;644;1594;4816;1771;5460
270895;201710;2852;9853;2746;9696;96;521;2438;8424;2534;8945
270900;201710;1769;4740;1423;4193;59;200;1128;3248;1187;3448
270910;201710;3448;10860;3126;10284;166;739;2403;7730;2569;8469
270915;201710;8682;27856;7614;25939;1014;3981;4770;15894;5784;19875
270920;201710;5849;18150;5540;17720;246;1195;4759;14762;5005;15957
270930;201710;15379;40657;13181;37990;2370;6462;8491;25426;10861;31888
270940;201710;5485;17333;5084;16852;342;1613;3912;12645;4254;14258
280010;201710;650;1808;562;1658;30;139;400;1078;430;1217
280020;201710;4692;13030;4103;12080;536;1612;2702;7945;3238;9557
280030;201710;67365;172951;56879;157537;15846;45316;21079;61231;36925;106547
280040;201710;3018;8770;2700;8271;281;934;1906;5788;2187;6722
280050;201710;3479;10819;3222;10374;641;2164;1872;6004;2513;8168
280060;201710;4894;14509;4114;13232;726;2464;2108;6933;2834;9397
280067;201710;6658;18261;5744;16772;675;1966;3747;10951;4422;12917
280070;201710;1909;6068;1838;5951;123;398;1538;4973;1661;5371
280100;201710;3557;10644;3199;10040;408;1402;2194;6898;2602;8300
280110;201710;1285;3872;1188;3713;54;211;994;3042;1048;3253
280120;201710;7600;23216;6924;22077;965;2835;4928;16192;5893;19027
280130;201710;7878;20595;7288;19718;745;2117;5486;14872;6231;16989
280140;201710;5559;14186;5067;13507;349;947;4140;11020;4489;11967
280150;201710;3531;9847;3300;9518;168;629;2737;7759;2905;8388
280160;201710;1232;3649;1038;3299;151;507;645;2008;796;2515
280170;201710;4837;13737;4456;13167;309;893;3588;10733;3897;11626
280190;201710;1189;2873;998;2594;67;203;793;1999;860;2202
280200;201710;1119;3292;1008;3119;104;383;728;2184;832;2567
280210;201710;14175;39113;12607;36960;2262;6885;7187;21537;9449;28422
280220;201710;1735;4830;1553;4572;56;234;1286;3772;1342;4006
280230;201710;3262;9322;2952;8859;233;811;2217;6542;2450;7353
280240;201710;3395;9365;3089;8888;96;388;2615;7374;2711;7762
280250;201710;823;2159;655;1880;91;285;344;958;435;1243
280260;201710;2005;5232;1867;5068;53;146;1738;4734;1791;4880
280270;201710;2146;6481;1980;6217;110;398;1664;5158;1774;5556
280280;201710;4036;13084;3685;12515;603;1757;2373;8584;2976;10341
280290;201710;16559;47959;14933;45538;1731;5951;9756;29749;11487;35700
280300;201710;9610;27426;8820;26493;526;1800;6761;21179;7287;22979
280310;201710;1317;3645;1128;3310;39;148;839;2383;878;2531
280320;201710;8251;24844;7527;23693;1099;3712;4625;14423;5724;18135
280330;201710;4376;11685;3936;11031;277;891;3123;8562;3400;9453
280340;201710;4165;10397;3860;10020;279;674;3241;8631;3520;9305
280350;201710;21307;57590;18829;53908;2377;6981;12701;36623;15078;43604
280360;201710;5370;16211;4954;15502;800;2652;2960;9243;3760;11895
280370;201710;1936;5046;1640;4580;118;316;1244;3456;1362;3772
280380;201710;970;2909;874;2753;100;373;601;1849;701;2222
280390;201710;2980;8486;2581;7740;163;558;1912;5670;2075;6228
280400;201710;3727;10361;3370;9817;744;2070;1841;5628;2585;7698
280410;201710;2052;6361;1740;5723;186;663;1041;3329;1227;3992
280420;201710;4124;11577;3790;11081;147;468;3326;9718;3473;10186
280430;201710;2058;5281;1845;4974;72;254;1469;3870;1541;4124
280440;201710;4570;12748;4069;12063;288;923;3201;9376;3489;10299
280445;201710;2341;6225;2102;5800;47;169;1619;4316;1666;4485
280450;201710;9460;23161;8649;22127;416;884;7556;19665;7972;20549
280460;201710;6409;16471;5937;15786;599;1586;4669;12477;5268;14063
280470;201710;1778;5227;1589;4891;75;250;1213;3728;1288;3978
280480;201710;32415;88825;29906;85230;3445;10991;20877;58528;24322;69519
280490;201710;3718;11011;3248;10205;139;583;2474;7584;2613;8167
280500;201710;886;2303;790;2170;39;120;653;1788;692;1908
280510;201710;2451;7071;2204;6712;125;489;1623;4902;1748;5391
280520;201710;1688;4464;1520;4246;117;318;1238;3468;1355;3786
280530;201710;2415;6245;2196;5970;116;335;1820;4928;1936;5263
280540;201710;9007;24628;8280;23595;201;897;7298;20280;7499;21177
280550;201710;6650;16616;5486;14864;335;874;4151;11142;4486;12016
280560;201710;7092;20649;6705;20104;224;899;5802;17089;6026;17988
280570;201710;6073;16083;5180;14887;335;1129;3750;10664;4085;11793
280580;201710;5156;15554;4525;14411;638;1973;2917;9521;3555;11494
280590;201710;2588;6950;2273;6555;173;716;1589;4400;1762;5116
280600;201710;3288;9653;3005;9233;237;828;2242;6834;2479;7662
280610;201710;2422;6343;2218;6067;157;458;1785;4828;1942;5286
280620;201710;5196;14205;4556;13221;421;1089;3275;9849;3696;10938
280630;201710;3512;11142;3265;10767;227;806;2594;8697;2821;9503
280640;201710;2216;6564;2067;6400;53;162;1933;6041;1986;6203
280650;201710;1046;3052;909;2857;96;329;652;2010;748;2339
280660;201710;2678;7122;2497;6909;161;412;2137;5959;2298;6371
280670;201710;16726;41648;15209;39659;1388;3840;11368;29652;12756;33492
280680;201710;2729;7067;2328;6416;156;411;1744;4739;1900;5150
280690;201710;942;2515;824;2351;51;148;623;1757;674;1905
280700;201710;1017;2853;925;2687;28;99;713;2036;741;2135
280710;201710;13117;31897;11575;30092;600;1073;10095;27118;10695;28191
280720;201710;2463;5931;2166;5594;153;412;1502;4161;1655;4573
280730;201710;1044;2733;961;2610;51;182;796;2105;847;2287
280740;201710;13038;34156;11295;31425;1269;3518;7431;20784;8700;24302
280750;201710;3367;10003;3086;9517;202;743;2255;6855;2457;7598
280760;201710;5628;16533;5106;15727;709;2221;3241;10278;3950;12499
290010;201710;2838;6274;2047;5049;21;82;1684;3958;1705;4040
290020;201710;4557;13994;4362;13730;220;688;3822;12037;4042;12725
290030;201710;3462;9668;3159;9274;208;622;2642;7746;2850;8368
290035;201710;4739;11321;4055;10427;224;539;3238;8545;3462;9084
290040;201710;4252;10644;3599;9903;185;581;2865;8014;3050;8595
290050;201710;2201;7195;1914;6669;141;582;1345;4641;1486;5223
290060;201710;1275;3204;1041;2879;116;398;727;1929;843;2327
290070;201710;32095;78406;28141;73295;3559;9365;17684;47156;21243;56521
290080;201710;5510;16453;4726;15349;661;2208;3098;10272;3759;12480
290090;201710;2197;4324;1703;3797;50;101;1558;3488;1608;3589
290100;201710;8761;24752;7726;23108;1059;3047;4844;15022;5903;18069
290110;201710;4811;13667;4493;13110;545;1680;3063;8852;3608;10532
290115;201710;4301;12671;3837;12043;165;554;3221;10221;3386;10775
290120;201710;6719;16940;5554;15545;175;628;4717;13001;4892;13629
290130;201710;4491;11466;3631;10397;137;571;2907;8119;3044;8690
290135;201710;4434;10718;3685;9525;254;718;2747;6908;3001;7626
290140;201710;4372;12592;3681;11691;142;522;3191;10148;3333;10670
290150;201710;2208;6384;2091;6214;204;635;1600;4670;1804;5305
290160;201710;3196;7910;2993;7657;368;769;2315;6063;2683;6832
290170;201710;2568;7970;2416;7774;94;400;2135;6783;2229;7183
290180;201710;2822;7995;2376;7289;116;412;1866;5689;1982;6101
290190;201710;3801;12079;3579;11757;184;817;2858;9262;3042;10079
290195;201710;2237;5956;1849;5343;63;287;1481;4209;1544;4496
290200;201710;3856;11431;3336;10634;210;735;2627;8319;2837;9054
290205;201710;3313;9012;2969;8477;143;559;2343;6480;2486;7039
290210;201710;13287;38710;11969;36903;1149;3207;9091;28973;10240;32180
290220;201710;2494;6858;2353;6658;178;555;1924;5393;2102;5948
290225;201710;3222;7250;2736;6718;46;103;2565;6318;2611;6421
290230;201710;2229;6858;2079;6675;97;376;1762;5658;1859;6034
290240;201710;3561;9490;3074;8845;148;499;2462;6969;2610;7468
290250;201710;3799;11631;3493;11228;118;321;3016;10097;3134;10418
290260;201710;5092;13738;4187;12369;245;906;3288;9592;3533;10498
290265;201710;3457;10374;2922;9399;136;588;2236;7110;2372;7698
290270;201710;11629;41000;11106;40143;866;3642;8684;31128;9550;34770
290280;201710;5608;17240;5081;16388;375;1289;3795;12255;4170;13544
290290;201710;9776;29473;8420;27107;856;2826;5889;19026;6745;21852
290300;201710;4430;12343;3243;10096;204;730;2237;6991;2441;7721
290310;201710;1454;4094;1243;3768;137;486;832;2468;969;2954
290320;201710;24817;69079;21229;64423;5175;16088;10436;33017;15611;49105
290323;201710;3514;9821;3174;9372;87;296;2661;7756;2748;8052
290327;201710;4220;12377;3680;11389;324;995;2643;8200;2967;9195
290330;201710;1883;4389;1666;4156;54;115;1508;3810;1562;3925
290340;201710;5503;15432;4595;14296;820;2723;2973;9316;3793;12039
290350;201710;4496;13600;3909;12573;353;1173;2787;9089;3140;10262
290360;201710;4707;13479;4105;12669;112;446;3562;11013;3674;11459
290370;201710;4866;12779;3949;11521;227;626;3083;9105;3310;9731
290380;201710;5349;15219;4698;14263;177;615;3972;12144;4149;12759
290390;201710;14505;42822;12831;40300;1483;4795;8596;27622;10079;32417
290395;201710;2631;8313;2295;7655;91;414;1788;5918;1879;6332
290400;201710;3615;10230;2973;9225;178;635;2178;6638;2356;7273
290405;201710;4640;14033;3926;12762;286;1018;2693;8848;2979;9866
290410;201710;5523;15928;4508;14265;215;900;3411;10423;3626;11323
290420;201710;2957;8503;2511;7799;181;571;1925;5963;2106;6534
290430;201710;3006;9073;2596;8321;410;1348;1590;5140;2000;6488
290440;201710;2887;7403;2229;6451;94;331;1641;4773;1735;5104
290450;201710;3161;8982;2669;8241;122;490;2059;6187;2181;6677
290460;201710;11756;33428;10468;31081;2971;9137;3922;11507;6893;20644
290470;201710;4127;11425;3207;9979;589;1973;1554;4984;2143;6957
290475;201710;5880;18071;5162;16754;130;652;4085;12970;4215;13622
290480;201710;2006;5330;1824;5063;152;438;1208;3390;1360;3828
290485;201710;4587;14094;4015;13215;170;862;3384;10891;3554;11753
290490;201710;8365;21033;7836;20368;571;1587;6349;16508;6920;18095
290500;201710;3832;11912;3063;10283;393;1404;1649;5502;2042;6906
290510;201710;3138;8607;2763;8097;99;371;2356;6833;2455;7204
290515;201710;3669;9900;3065;9125;100;259;2659;8093;2759;8352
290520;201710;11138;33782;9007;29529;454;1877;6000;19364;6454;21241
290530;201710;4914;14368;4334;13434;235;730;3547;11029;3782;11759
290540;201710;3524;9935;3224;9522;103;335;2854;8394;2957;8729
290550;201710;4280;11272;3828;10757;52;171;3562;10065;3614;10236
290560;201710;6416;17633;5373;16105;604;1987;3758;11134;4362;13121
290570;201710;40924;108277;37932;104345;2958;8430;29325;80443;32283;88873
290580;201710;7223;23075;6677;22229;666;2169;5021;17105;5687;19274
290590;201710;6935;21997;6045;20391;183;793;4984;16810;5167;17603
290600;201710;17396;50971;16136;49140;988;3160;13043;40291;14031;43451
290610;201710;2436;8046;1991;7164;106;484;1382;4892;1488;5376
290620;201710;6148;17980;5582;17070;264;880;4706;14282;4970;15162
290630;201710;8397;21247;7157;19746;574;1580;5766;16066;6340;17646
290640;201710;2565;7218;2032;6299;91;295;1606;4896;1697;5191
290650;201710;10637;30309;10128;29583;2562;7228;5709;17566;8271;24794
290660;201710;3561;9614;3053;8863;114;306;2277;6937;2391;7243
290670;201710;6698;19628;5908;18341;540;1683;4357;13706;4897;15389
290680;201710;10056;29559;8795;27706;291;1455;7068;21679;7359;23134
290682;201710;4575;12656;4035;11862;136;457;3401;9931;3537;10388
290685;201710;3557;8207;2355;6542;227;606;1543;4409;1770;5015
290687;201710;6663;19226;5396;17086;925;2918;3019;9943;3944;12861
290689;201710;2855;8244;2461;7622;159;571;1814;5685;1973;6256
290690;201710;5300;14621;4545;13598;628;1821;3008;9081;3636;10902
290700;201710;2486;7155;2295;6892;78;292;1991;5986;2069;6278
290710;201710;7970;23761;7126;22600;295;1057;6118;19426;6413;20483
290720;201710;18219;51360;16889;49666;960;2817;14185;42140;15145;44957
290730;201710;6992;18390;6155;17352;307;868;4742;13369;5049;14237
290740;201710;974;2797;742;2377;44;185;563;1775;607;1960
290750;201710;10059;27080;8865;24971;1088;3277;5778;15877;6866;19154
290755;201710;2218;6258;1741;5384;99;352;1209;3680;1308;4032
290760;201710;3959;11814;3187;10310;432;1271;1862;6331;2294;7602
290770;201710;2512;8553;2349;8338;75;360;1948;6950;2023;7310
290780;201710;8319;21091;7240;19547;518;1114;5610;15498;6128;16612
290790;201710;4396;12568;3985;12022;160;439;3432;10428;3592;10867
290800;201710;6959;14741;5367;12945;356;725;4190;10384;4546;11109
290810;201710;5460;15673;4480;14075;132;517;3486;10973;3618;11490
290820;201710;4999;13831;4575;13245;286;941;3492;10134;3778;11075
290830;201710;4355;10745;3961;10212;133;436;3249;8238;3382;8674
290840;201710;16400;46245;14510;43332;1778;4862;9640;30133;11418;34995
290850;201710;5905;16230;5646;15907;514;1260;4480;13004;4994;14264
290860;201710;5295;17009;4877;16523;251;957;4096;14102;4347;15059
290870;201710;4599;13098;3654;11476;163;628;2663;8314;2826;8942
290880;201710;1386;3588;1103;3167;83;206;768;2258;851;2464
290890;201710;7194;17285;6286;16267;212;564;5704;14773;5916;15337
290900;201710;2276;6296;1755;5383;134;451;1115;3384;1249;3835
290910;201710;4895;12841;3964;11429;62;270;3329;9515;3391;9785
290920;201710;4954;12686;4609;12235;112;294;4229;11212;4341;11506
290930;201710;7976;22940;6790;21003;229;1015;5477;16519;5706;17534
290940;201710;3671;10919;3194;10225;187;610;2395;7784;2582;8394
290950;201710;1493;4036;1298;3726;97;290;937;2699;1034;2989
290960;201710;5198;14701;4775;14134;163;530;4054;12006;4217;12536
290970;201710;3601;10727;3065;9855;189;588;2254;7302;2443;7890
290980;201710;10157;27596;8756;25072;1625;4894;3998;11314;5623;16208
290990;201710;8828;25391;7682;23468;443;1613;6043;18091;6486;19704
291000;201710;3090;8865;2703;8387;272;745;2106;6701;2378;7446
291005;201710;14001;35025;12595;33297;768;2070;10330;27482;11098;29552
291010;201710;3162;9599;2503;8249;181;618;1641;5385;1822;6003
291020;201710;1240;3248;1010;2823;53;169;659;1744;712;1913
291030;201710;2349;6154;1678;4850;110;337;1059;2974;1169;3311
291040;201710;5294;15473;4668;14554;235;968;3730;11520;3965;12488
291050;201710;7324;22602;6697;21548;1231;4338;4080;12927;5311;17265
291060;201710;5730;20277;5331;19632;584;2549;3665;13272;4249;15821
291070;201710;15401;43564;13435;40580;629;2351;10687;31982;11316;34333
291072;201710;22398;63425;17681;54341;3981;13051;6418;20020;10399;33071
291075;201710;4803;13515;4317;12672;226;682;3375;9796;3601;10478
291077;201710;1497;4127;1231;3667;54;147;914;2739;968;2886
291080;201710;77705;230475;67650;213243;24919;79958;10699;35445;35618;115403
291085;201710;5508;14418;4717;13303;206;645;4000;11253;4206;11898
291090;201710;1737;3726;1464;3406;139;183;1183;2879;1322;3062
291100;201710;2775;6653;2060;5766;113;406;1582;4328;1695;4734
291110;201710;5356;17587;4718;16515;539;2030;3365;11572;3904;13602
291120;201710;7288;18958;6613;17985;459;1332;5114;13888;5573;15220
291125;201710;1917;3671;1484;3197;65;156;1217;2646;1282;2802
291130;201710;2845;8683;2339;7741;76;364;1763;5666;1839;6030
291140;201710;4169;12062;3389;10525;502;1408;2115;6679;2617;8087
291150;201710;2101;4999;1844;4698;35;97;1612;4072;1647;4169
291160;201710;4674;14487;4162;13591;474;1707;2717;8776;3191;10483
291165;201710;2308;6550;1809;5628;27;115;1320;4030;1347;4145
291170;201710;19836;52232;17112;47877;1239;3748;10897;30581;12136;34329
291180;201710;5993;15293;4766;13465;388;1151;3450;9727;3838;10878
291185;201710;3315;9243;2912;8535;121;391;2368;6852;2489;7243
291190;201710;7291;18948;6264;17520;409;1259;4985;13920;5394;15179
291200;201710;2862;8326;2182;7045;86;295;1443;4643;1529;4938
291210;201710;6263;15045;5290;13853;219;749;4048;10457;4267;11206
291220;201710;3954;11746;3583;11158;364;1257;2520;7771;2884;9028
291230;201710;4009;9677;3457;9057;84;150;3219;8543;3303;8693
291240;201710;4284;11379;3743;10456;79;269;3186;8762;3265;9031
291250;201710;3312;10088;2676;8895;174;564;1834;6172;2008;6736
291260;201710;1126;2995;996;2822;48;190;839;2302;887;2492
291270;201710;4711;14168;4083;13051;860;2872;2317;7495;3177;10367
291280;201710;2251;6245;1775;5441;231;752;993;2990;1224;3742
291290;201710;5769;15764;4785;14320;612;1883;3061;9281;3673;11164
291300;201710;3977;11247;3065;9668;148;490;2201;6898;2349;7388
291310;201710;5187;14481;4452;13135;185;627;3548;10351;3733;10978
291320;201710;5866;17717;4700;15375;1133;3573;2188;7464;3321;11037
291330;201710;1594;4487;1388;4137;86;270;1026;3014;1112;3284
291340;201710;3929;10600;3324;9681;82;306;2701;7793;2783;8099
291345;201710;3059;9717;2851;9430;157;564;2308;7683;2465;8247
291350;201710;5833;16411;4970;15091;202;628;4092;12602;4294;13230
291360;201710;31646;82667;26765;76045;5257;15252;14208;41642;19465;56894
291370;201710;7744;21751;7244;21083;462;1527;5599;16223;6061;17750
291380;201710;3371;10045;2988;9429;124;513;2375;7408;2499;7921
291390;201710;10788;27283;9621;25880;596;1804;7781;20843;8377;22647
291400;201710;13801;37028;11840;34082;1915;5059;7356;22384;9271;27443
291410;201710;2878;7736;2244;6670;81;366;1698;4877;1779;5243
291420;201710;1874;5100;1584;4730;49;201;1339;3979;1388;4180
291430;201710;3082;8690;2715;8152;102;483;2226;6488;2328;6971
291440;201710;6321;18725;5547;17403;433;1411;4312;13658;4745;15069
291450;201710;8132;22643;7019;21201;194;491;5995;18661;6189;19152
291460;201710;13061;38157;11771;36237;1154;3798;8214;25533;9368;29331
291465;201710;7720;21712;6702;20432;352;1494;5403;16181;5755;17675
291470;201710;14918;38441;13173;36377;656;1788;10131;28712;10787;30500
291480;201710;34966;83967;28333;75080;3897;11068;15748;42081;19645;53149
291490;201710;4363;12926;4072;12533;369;1164;3223;9999;3592;11163
291500;201710;4494;12086;3767;11043;106;426;3250;9494;3356;9920
291510;201710;3645;10477;3162;9772;83;386;2630;8113;2713;8499
291520;201710;3961;10216;3312;9319;243;728;2341;6624;2584;7352
291530;201710;2130;5454;1627;4745;326;879;919;2950;1245;3829
291535;201710;3237;10014;3000;9625;223;710;2258;7369;2481;8079
291540;201710;2075;4971;1632;4465;90;294;1408;3779;1498;4073
291550;201710;5002;12742;4308;11772;629;1611;2685;7500;3314;9111
291560;201710;18412;42474;12881;35911;948;2527;8847;25969;9795;28496
291570;201710;2158;5364;1850;4991;111;221;1551;4320;1662;4541
291580;201710;5666;16214;4803;15005;433;1552;3409;10596;3842;12148
291590;201710;1667;5139;1552;4946;144;519;1217;3872;1361;4391
291600;201710;5009;13307;3848;11432;716;2228;2017;5916;2733;8144
291610;201710;4677;14323;4490;14114;95;333;4197;13267;4292;13600
291620;201710;3064;7035;2228;6121;119;366;1708;4773;1827;5139
291630;201710;3136;7429;2472;6590;152;433;1979;5259;2131;5692
291640;201710;15089;40440;11980;35706;2664;8189;3997;12796;6661;20985
291650;201710;8269;23210;7509;22263;477;1194;6359;19187;6836;20381
291660;201710;2165;5362;1611;4509;123;458;1065;2787;1188;3245
291670;201710;1853;5066;1676;4807;127;332;1306;3810;1433;4142
291680;201710;3766;10450;3254;9597;403;1273;2254;6642;2657;7915
291685;201710;4638;11469;3793;10359;393;948;2704;7658;3097;8606
291690;201710;3635;9120;2861;7941;116;329;2293;6329;2409;6658
291700;201710;8699;26296;7758;24591;635;2059;5988;19019;6623;21078
291710;201710;4941;12705;3944;11331;420;1307;2621;7396;3041;8703
291720;201710;4582;14427;3816;12831;317;1210;2579;8467;2896;9677
291730;201710;6095;17147;5415;16237;324;1103;4384;13215;4708;14318
291733;201710;2848;7642;2364;6959;114;352;1712;5217;1826;5569
291735;201710;2922;7792;2476;7137;89;306;2102;6001;2191;6307
291740;201710;3781;10110;3103;9121;148;489;2453;7138;2601;7627
291750;201710;19457;49342;15678;43629;2321;6595;9143;26051;11464;32646
291760;201710;9984;31292;8540;28739;3093;11693;1928;6554;5021;18247
291770;201710;6972;19849;5899;17892;621;2035;4067;12089;4688;14124
291780;201710;4565;13048;4174;12410;153;500;3569;10567;3722;11067
291790;201710;2621;7750;2463;7525;183;561;1948;5957;2131;6518
291800;201710;28581;75837;24093;69479;3169;9085;14955;44211;18124;53296
291810;201710;10321;26737;8816;24821;267;930;7454;20835;7721;21765
291820;201710;3707;10429;3272;9804;148;520;2544;7630;2692;8150
291830;201710;4012;10303;3639;9776;286;787;2889;7807;3175;8594
291835;201710;6199;19053;5063;16905;911;3141;2841;9738;3752;12879
291840;201710;44893;125707;39288;118809;5004;15172;27106;84251;32110;99423
291845;201710;2397;7022;2187;6729;141;419;1812;5627;1953;6046
291850;201710;4189;12134;3472;10951;325;927;2502;8157;2827;9084
291855;201710;1805;4146;1553;3824;80;247;1279;3095;1359;3342
291860;201710;2244;6046;1639;4843;40;132;1123;3191;1163;3323
291870;201710;1306;3417;897;2663;61;217;569;1607;630;1824
291875;201710;2741;8365;2436;7848;121;450;1782;5629;1903;6079
291880;201710;4970;15378;4539;14526;433;1385;3297;10564;3730;11949
291890;201710;1291;3090;964;2669;202;446;616;1789;818;2235
291900;201710;1205;3137;932;2673;31;124;714;1991;745;2115
291905;201710;2689;7035;2054;5923;79;274;1534;4316;1613;4590
291910;201710;2744;7161;2356;6700;81;267;2035;5792;2116;6059
291915;201710;6733;20294;5693;18492;304;1157;4343;14140;4647;15297
291920;201710;24003;69215;21921;66297;2810;9218;14503;43554;17313;52772
291930;201710;2432;7149;2146;6676;188;695;1507;4564;1695;5259
291940;201710;3278;9067;2329;7365;238;765;1440;4430;1678;5195
291950;201710;8527;27277;7520;25321;1086;3633;4363;15121;5449;18754
291955;201710;11697;32449;10754;31275;1933;5395;7035;21426;8968;26821
291960;201710;3062;8652;2496;7789;144;481;1898;6039;2042;6520
291970;201710;3851;11281;3469;10670;242;968;2530;7677;2772;8645
291980;201710;10383;30036;8393;27049;570;1892;5915;19265;6485;21157
291990;201710;1991;5886;1859;5721;37;137;1729;5346;1766;5483
291992;201710;3951;9953;2913;8521;343;935;2190;6545;2533;7480
291995;201710;2111;5871;1724;5302;62;265;1391;4175;1453;4440
292000;201710;2310;6239;1995;5758;176;587;1377;3961;1553;4548
292010;201710;6008;14490;4961;13036;278;790;4033;10552;4311;11342
292020;201710;4209;13069;3747;12276;343;1209;2833;9213;3176;10422
292030;201710;1740;5619;1637;5454;138;528;994;3224;1132;3752
292040;201710;4084;11014;3508;10299;248;634;2861;8679;3109;9313
292045;201710;3555;10200;2923;9262;81;210;2635;8445;2716;8655
292050;201710;6304;18669;5249;16574;418;1449;3314;10342;3732;11791
292060;201710;12365;29597;11411;28430;738;1806;9595;23672;10333;25478
292070;201710;5174;14716;4666;14103;313;990;3956;11989;4269;12979
292080;201710;3247;8459;2674;7726;155;526;2283;6585;2438;7111
292090;201710;4063;9680;3276;8765;218;633;2637;7154;2855;7787
292100;201710;9654;25684;8485;24069;1673;4820;4512;13209;6185;18029
292105;201710;2961;8675;2671;8193;81;356;2259;6858;2340;7214
292110;201710;6126;16056;4628;13570;1158;3368;2079;6256;3237;9624
292120;201710;6590;18155;5415;16026;669;1999;3501;10442;4170;12441
292130;201710;2954;7877;2540;7313;253;761;1846;5374;2099;6135
292140;201710;4772;12223;3971;11050;293;792;3104;8676;3397;9468
292145;201710;2165;6622;1883;6121;139;447;1341;4420;1480;4867
292150;201710;12653;36903;11613;35323;349;1346;9782;29577;10131;30923
292160;201710;2328;6664;2063;6316;70;276;1839;5580;1909;5856
292170;201710;8124;22900;6839;20695;672;2130;4622;14035;5294;16165
292180;201710;2901;8083;2184;6851;431;1272;1111;3570;1542;4842
292190;201710;2808;7969;2425;7363;348;1132;1465;4502;1813;5634
292200;201710;6395;18514;5411;16880;1194;3834;2576;8278;3770;12112
292205;201710;3609;10645;3263;10120;100;476;2810;8542;2910;9018
292210;201710;5947;15209;5044;13988;125;474;4436;12162;4561;12636
292220;201710;1883;4950;1696;4662;210;552;1161;3170;1371;3722
292225;201710;3131;9514;2821;9037;99;425;2344;7412;2443;7837
292230;201710;7110;18754;6660;18094;177;755;5642;14923;5819;15678
292240;201710;4829;14378;4216;13145;340;1088;2887;8980;3227;10068
292250;201710;5143;14798;4784;14218;705;2062;3057;9230;3762;11292
292260;201710;3231;9033;2940;8635;203;551;2444;7301;2647;7852
292265;201710;3159;9299;2732;8574;87;409;2166;6617;2253;7026
292270;201710;3827;9630;3216;8876;238;714;2609;7206;2847;7920
292273;201710;2423;5618;2018;5112;88;158;1602;4196;1690;4354
292275;201710;1753;5002;1469;4580;93;221;1165;3795;1258;4016
292280;201710;2413;6322;2023;5865;95;239;1654;4995;1749;5234
292285;201710;2405;6316;1971;5682;118;407;1524;4366;1642;4773
292290;201710;6369;19048;5556;17810;265;1042;4446;14210;4711;15252
292300;201710;8821;24889;7456;23091;1259;4046;4540;14381;5799;18427
292303;201710;2772;8232;2493;7804;75;272;2150;6700;2225;6972
292305;201710;2535;6871;2360;6609;48;211;2099;5782;2147;5993
292310;201710;6144;17242;5602;16472;271;795;4673;13732;4944;14527
292320;201710;6379;17377;5338;15551;306;962;4137;11847;4443;12809
292330;201710;2376;5865;2147;5572;124;325;1729;4527;1853;4852
292335;201710;4858;12663;4358;11966;304;760;3554;9907;3858;10667
292340;201710;6210;16933;5344;15468;275;801;4056;11682;4331;12483
292350;201710;2251;6452;1934;6010;87;326;1606;4992;1693;5318
292360;201710;4828;12922;4302;12005;344;1095;3172;8700;3516;9795
292370;201710;9336;23510;8211;22055;246;688;7290;19440;7536;20128
292380;201710;6847;19825;6255;18817;533;1562;4719;14263;5252;15825
292390;201710;4036;8426;3028;7265;139;247;2637;6434;2776;6681
292400;201710;20397;62043;18536;58871;2426;8003;12272;39060;14698;47063
292405;201710;4406;10863;3651;9860;199;472;2992;8160;3191;8632
292410;201710;1992;5169;1776;4908;79;218;1531;4266;1610;4484
292420;201710;3570;11279;3368;10952;197;858;2795;8976;2992;9834
292430;201710;5012;14699;3808;12912;334;1213;2484;8504;2818;9717
292440;201710;8247;26828;7659;25975;128;609;7045;23980;7173;24589
292450;201710;3682;11129;3073;9973;178;644;2352;7657;2530;8301
292460;201710;4592;13403;3928;12253;355;1117;2845;8885;3200;10002
292465;201710;2343;6658;1970;6089;116;361;1414;4489;1530;4850
292467;201710;1686;5263;1611;5157;211;672;1143;3750;1354;4422
292470;201710;2890;7407;2325;6507;80;231;1839;5154;1919;5385
292480;201710;6249;15618;5155;14229;108;403;4580;12445;4688;12848
292490;201710;2204;5988;1849;5454;114;348;1414;4201;1528;4549
292500;201710;6247;17948;5230;16129;595;1807;3515;10950;4110;12757
292510;201710;12334;34871;10378;31830;672;2601;7676;23405;8348;26006
292520;201710;6237;16514;5486;15366;930;2566;3517;10070;4447;12636
292525;201710;5226;13400;4463;12503;164;460;3860;10880;4024;11340
292530;201710;26083;73186;22469;67750;5674;17336;9710;30503;15384;47839
292540;201710;3191;7656;2695;7090;203;487;2241;5979;2444;6466
292550;201710;6760;20090;5687;18684;443;1640;4382;14657;4825;16297
292560;201710;4101;11045;3562;10233;131;543;2878;8154;3009;8697
292570;201710;4048;10954;3536;10270;65;222;3236;9406;3301;9628
292575;201710;6514;20276;6212;19844;263;876;5338;17079;5601;17955
292580;201710;6880;19137;6149;18058;222;768;5326;15552;5548;16320
292590;201710;7149;19791;6551;18921;265;910;5673;16054;5938;16964
292593;201710;2754;7032;2359;6392;175;451;1840;4971;2015;5422
292595;201710;5507;14998;4876;14185;230;803;3992;11516;4222;12319
292600;201710;10693;29888;9445;28137;605;1608;7280;21990;7885;23598
292610;201710;4367;11635;3637;10427;203;513;2599;7678;2802;8191
292620;201710;6165;17792;5398;16940;83;232;5110;16222;5193;16454
292630;201710;8538;21662;7150;19436;481;1357;5094;13946;5575;15303
292640;201710;7682;23887;6987;22775;261;1022;5312;17347;5573;18369
292650;201710;4274;11306;3946;10879;215;578;3453;9465;3668;10043
292660;201710;10662;30833;9524;29152;653;2150;7431;22808;8084;24958
292665;201710;2173;6795;2007;6579;33;139;1797;5935;1830;6074
292670;201710;3477;9696;2726;8312;143;528;1853;5547;1996;6075
292680;201710;3825;10677;3232;9602;239;726;2364;6901;2603;7627
292690;201710;2578;7046;1870;5879;153;468;1222;3975;1375;4443
292700;201710;9287;26405;8142;24749;949;2751;5507;17378;6456;20129
292710;201710;2230;7323;2088;7138;54;218;1893;6489;1947;6707
292720;201710;9065;22529;7847;21170;298;907;6669;18187;6967;19094
292730;201710;3833;10431;3683;10226;157;402;3179;8865;3336;9267
292740;201710;314912;821543;293277;787840;52485;146316;171977;457688;224462;604004
292750;201710;6339;17117;5464;15801;256;756;4237;12344;4493;13100
292760;201710;3792;11421;3433;10767;278;948;2509;7836;2787;8784
292770;201710;5723;16431;4950;15254;911;2938;2852;9085;3763;12023
292780;201710;1765;3956;1360;3449;58;181;1067;2635;1125;2816
292790;201710;3798;8493;3229;7873;53;147;3037;7400;3090;7547
292800;201710;9584;26396;8669;24900;413;1286;7039;20062;7452;21348
292805;201710;3163;8338;2636;7583;260;705;1905;5547;2165;6252
292810;201710;9530;27110;7707;24343;429;1554;5660;17886;6089;19440
292820;201710;7534;20792;5601;17917;427;1629;4110;12998;4537;14627
292830;201710;2542;6184;2240;5800;50;189;2050;5262;2100;5451
292840;201710;8376;23233;7760;22395;172;733;6959;19632;7131;20365
292850;201710;2764;7503;2286;6739;175;635;1519;4325;1694;4960
292860;201710;15123;37253;13806;35550;1010;2505;10921;28289;11931;30794
292870;201710;17282;46255;15292;43216;1229;3984;9976;27761;11205;31745
292880;201710;11347;31879;10193;30226;522;2058;7749;22236;8271;24294
292890;201710;5372;17027;4838;16127;414;1530;3665;12173;4079;13703
292895;201710;2877;6611;2146;5518;124;311;1582;4065;1706;4376
292900;201710;2644;7655;2474;7384;89;404;1970;5654;2059;6058
292905;201710;4156;11723;3306;10399;263;798;2274;7276;2537;8074
292910;201710;4821;13918;4422;13203;416;1352;3033;9002;3449;10354
292920;201710;9637;27232;9207;26671;336;1310;8050;22891;8386;24201
292925;201710;5068;14908;4590;14124;254;772;3583;10989;3837;11761
292930;201710;6054;18953;5574;18024;391;1661;3828;12056;4219;13717
292935;201710;1985;5817;1632;5427;54;279;1411;4756;1465;5035
292937;201710;3027;7620;2635;7140;86;261;2271;6174;2357;6435
292940;201710;3078;8250;2507;7341;167;467;1898;5682;2065;6149
292950;201710;8794;24115;8045;22918;379;1218;6242;17504;6621;18722
292960;201710;5153;12732;4452;11785;139;437;3604;9385;3743;9822
292970;201710;3985;11722;3523;11095;134;579;2928;9208;3062;9787
292975;201710;4161;9523;3737;9031;203;431;3302;8049;3505;8480
292980;201710;3086;8001;2486;7077;130;405;1908;5361;2038;5766
292990;201710;11194;31310;9611;28805;433;1469;7682;23049;8115;24518
293000;201710;2604;6569;2388;6295;27;88;1896;5239;1923;5327
293010;201710;17020;45999;14316;41561;1946;5751;8841;25788;10787;31539
293015;201710;7228;23828;6046;21531;626;2607;4064;14365;4690;16972
293020;201710;8853;28402;8294;27637;185;866;7441;24650;7626;25516
293030;201710;5367;15063;4238;13236;162;541;2901;9358;3063;9899
293040;201710;3666;11258;3439;10918;115;424;3019;9563;3134;9987
293050;201710;20109;52925;18029;50079;1984;5668;11857;33656;13841;39324
293060;201710;3436;9143;2857;8207;213;689;2099;5928;2312;6617
293070;201710;23580;60778;19465;55140;4029;11184;9908;29726;13937;40910
293075;201710;3136;10553;2927;10194;199;864;2329;8105;2528;8969
293076;201710;3494;9341;3121;8836;106;285;2568;7390;2674;7675
293077;201710;5109;15101;4377;14081;570;1882;2859;9457;3429;11339
293080;201710;4658;14240;4154;13406;162;680;3396;10777;3558;11457
293090;201710;2996;9432;2469;8549;203;798;1714;5960;1917;6758
293100;201710;5612;15882;4692;14244;361;1095;3543;10853;3904;11948
293105;201710;3643;11903;3225;11078;288;1056;2246;7670;2534;8726
293110;201710;2150;5635;1836;5205;61;199;1538;4306;1599;4505
293120;201710;3875;11651;3601;11195;139;419;3033;9439;3172;9858
293130;201710;3619;10625;3309;10229;99;395;2884;8917;2983;9312
293135;201710;29600;73492;22494;63357;4568;14380;9075;25913;13643;40293
293140;201710;2055;5312;1900;5107;87;271;1584;4153;1671;4424
293150;201710;5255;16675;4442;15092;528;1815;2965;10208;3493;12023
293160;201710;3777;9513;3363;9013;332;627;2683;7634;3015;8261
293170;201710;3617;9532;3199;8964;155;510;2513;7051;2668;7561
293180;201710;4825;13350;3948;11894;132;566;3152;9250;3284;9816
293190;201710;13250;38594;11948;36629;385;1723;10126;30644;10511;32367
293200;201710;7586;19718;6473;18179;215;797;5049;14117;5264;14914
293210;201710;4942;13722;4320;12731;252;798;3351;9817;3603;10615
293220;201710;4817;13633;3901;12039;991;3044;1490;4843;2481;7887
293230;201710;3490;10334;3052;9614;385;1298;2037;6464;2422;7762
293240;201710;4238;11676;3442;10329;106;340;2632;7989;2738;8329
293245;201710;4074;11198;3628;10576;170;577;3022;8721;3192;9298
293250;201710;5315;13819;4713;12914;343;952;3624;9880;3967;10832
293260;201710;4280;12394;3574;11279;134;474;2584;8074;2718;8548
293270;201710;6183;15341;5221;14297;409;891;4325;12265;4734;13156
293280;201710;4931;13521;4203;12518;213;630;3219;9654;3432;10284
293290;201710;12845;41670;11921;39979;2978;10079;5505;19463;8483;29542
293300;201710;6156;14845;5335;13795;354;813;4021;10619;4375;11432
293305;201710;4254;10677;3678;9895;78;265;3194;8562;3272;8827
293310;201710;2228;5817;1808;5085;147;431;1263;3500;1410;3931
293315;201710;4098;10192;3429;9177;189;454;2761;7390;2950;7844
293317;201710;2375;6395;2125;5954;132;353;1589;4468;1721;4821
293320;201710;7861;24093;7536;23691;847;2681;6026;19165;6873;21846
293325;201710;1675;4640;1377;4154;231;730;846;2525;1077;3255
293330;201710;42836;139872;39175;132869;8768;30702;18044;61991;26812;92693
293340;201710;2446;6957;1984;6157;185;638;1252;3842;1437;4480
293345;201710;3064;9000;2689;8509;272;622;1965;6702;2237;7324
293350;201710;6594;19069;6078;18478;110;274;5651;17535;5761;17809
293360;201710;13645;38566;12314;36921;597;1967;10869;32560;11466;34527
310010;201710;780;2048;621;1810;70;247;297;806;367;1053
310020;201710;2206;6758;1816;6049;464;1717;256;828;720;2545
310030;201710;2092;6308;1677;5566;283;1072;989;3194;1272;4266
310040;201710;954;2464;786;2219;59;206;597;1627;656;1833
310050;201710;1575;5250;1467;5033;281;1075;722;2372;1003;3447
310060;201710;3234;9537;2826;8996;162;699;2308;7264;2470;7963
310070;201710;337;861;242;690;6;18;169;466;175;484
310080;201710;717;2008;539;1692;63;230;238;718;301;948
310090;201710;4465;12735;3782;11595;458;1512;2605;7954;3063;9466
310100;201710;3356;9878;2838;9027;138;559;2241;7050;2379;7609
310110;201710;4776;13157;3944;11672;675;2252;1947;5505;2622;7757
310120;201710;617;1708;444;1394;88;338;193;513;281;851
310130;201710;366;1088;324;1008;62;236;180;495;242;731
310140;201710;174;570;145;521;45;195;44;128;89;323
310150;201710;4256;12735;3534;11322;830;2862;1158;3639;1988;6501
310160;201710;6241;18897;5163;16866;1543;5493;1014;3254;2557;8747
310163;201710;1025;3188;849;2853;283;1040;227;718;510;1758
310170;201710;8703;23620;7532;21925;799;2446;5331;15571;6130;18017
310180;201710;1588;4395;1328;3998;135;508;873;2528;1008;3036
310190;201710;2947;9343;2548;8615;681;2505;306;982;987;3487
310200;201710;1661;5365;1367;4713;276;1043;492;1633;768;2676
310205;201710;1081;3083;820;2692;103;327;486;1648;589;1975
310210;201710;2655;7262;2234;6636;115;386;1678;4945;1793;5331
310220;201710;984;2854;846;2631;108;395;563;1675;671;2070
310230;201710;2253;6676;1933;6001;252;936;1154;3386;1406;4322
310240;201710;845;2970;771;2823;85;376;514;1849;599;2225
310250;201710;866;2655;768;2480;124;494;462;1390;586;1884
310260;201710;2628;8079;1897;6609;453;1791;285;791;738;2582
310270;201710;2589;6942;2078;6231;143;552;1640;4817;1783;5369
310280;201710;2205;5578;1757;4908;187;654;1105;2964;1292;3618
310285;201710;1863;6442;1686;6148;166;671;1147;4278;1313;4949
310290;201710;1076;3121;989;2966;222;780;528;1426;750;2206
310300;201710;1510;4935;1405;4754;292;1133;690;2198;982;3331
310310;201710;289;764;206;614;34;96;108;328;142;424
310320;201710;489;1322;323;1023;29;118;165;490;194;608
310330;201710;494;1208;318;883;41;125;127;304;168;429
310340;201710;7666;22222;6287;19875;1228;3858;3018;9914;4246;13772
310350;201710;12127;31187;8480;25214;2221;7119;2175;6396;4396;13515
310360;201710;448;1220;394;1146;16;58;311;887;327;945
310370;201710;1331;4373;1147;4004;241;886;458;1603;699;2489
310375;201710;1003;2687;677;2143;110;376;260;816;370;1192
310380;201710;362;893;194;589;39;120;66;183;105;303
310390;201710;425;1407;366;1282;100;369;78;227;178;596
310400;201710;8592;23207;6480;19686;1336;4483;2550;7530;3886;12013
310410;201710;679;2100;471;1734;123;489;97;338;220;827
310420;201710;3885;10626;2605;8032;544;1861;513;1404;1057;3265
310430;201710;1227;3778;865;3045;216;814;152;493;368;1307
310440;201710;534;1460;385;1176;47;176;198;582;245;758
310445;201710;1307;4008;1004;3444;65;245;699;2380;764;2625
310450;201710;4416;11834;3411;10287;269;862;2529;7673;2798;8535
310460;201710;1640;4634;1200;3818;266;917;335;1050;601;1967
310470;201710;3839;8551;3160;7692;266;804;2586;6170;2852;6974
310480;201710;1169;3274;865;2716;170;554;428;1299;598;1853
310490;201710;2881;8837;2388;7898;450;1736;1001;3144;1451;4880
310500;201710;1406;4303;1078;3653;236;870;439;1451;675;2321
310510;201710;1669;5055;1257;4209;322;1184;281;931;603;2115
310520;201710;1400;3519;1032;2949;82;226;675;1933;757;2159
310530;201710;865;2464;452;1468;73;265;64;166;137;431
310540;201710;3113;9470;2622;8582;695;2423;1004;3128;1699;5551
310550;201710;1133;3072;858;2623;121;471;543;1547;664;2018
310560;201710;13282;38705;10995;34647;2676;9375;3657;10751;6333;20126
310570;201710;1094;3174;926;2879;115;452;630;1872;745;2324
310590;201710;4059;11481;3409;10364;437;1482;1955;5818;2392;7300
310600;201710;1426;4446;1192;3923;203;712;533;1645;736;2357
310610;201710;501;1449;349;1186;67;284;154;471;221;755
310620;201710;139235;400374;113731;352909;26704;92728;39877;111022;66581;203750
310630;201710;4307;12449;3740;11442;314;1099;2687;8091;3001;9190
310640;201710;1008;3204;856;2898;233;879;240;760;473;1639
310650;201710;2548;7744;1950;6635;242;870;1074;3584;1316;4454
310660;201710;1259;3670;1096;3463;80;270;845;2648;925;2918
310665;201710;1245;3593;1083;3362;66;228;860;2704;926;2932
310670;201710;41532;119967;35749;109009;7200;23688;17068;50157;24268;73845
310680;201710;650;1732;568;1607;40;125;432;1197;472;1322
310690;201710;1403;4242;1129;3771;161;644;580;1851;741;2495
310700;201710;516;1209;393;1055;49;161;261;674;310;835
310710;201710;5441;17108;4091;14999;945;4053;401;1384;1346;5437
310720;201710;818;2290;709;2136;57;201;530;1579;587;1780
310730;201710;8561;25610;7589;23972;822;2936;4867;15163;5689;18099
310740;201710;4771;14447;3584;12009;759;2711;844;2725;1603;5436
310750;201710;1329;3305;956;2786;174;547;368;1000;542;1547
310760;201710;515;1506;412;1320;53;196;176;573;229;769
310770;201710;1011;2960;724;2506;106;414;349;1150;455;1564
310780;201710;3843;10153;3141;9011;239;730;2215;6273;2454;7003
310790;201710;1818;5828;1660;5538;343;1158;760;2665;1103;3823
310800;201710;2283;7220;1751;6168;504;2068;123;401;627;2469
310810;201710;1075;2944;924;2668;95;314;575;1587;670;1901
310820;201710;1151;3238;785;2523;183;650;214;657;397;1307
310825;201710;2821;9487;2318;8635;104;606;1812;6603;1916;7209
310830;201710;1354;4223;1085;3712;256;949;383;1261;639;2210
310840;201710;2015;5776;1426;4696;280;964;339;1039;619;2003
310850;201710;1443;4177;1265;3947;82;355;963;2929;1045;3284
310855;201710;2976;8586;2459;7836;273;983;1752;5520;2025;6503
310860;201710;6756;20334;5649;18211;553;1908;3545;11485;4098;13393
310870;201710;1022;2613;779;2235;155;463;467;1335;622;1798
310880;201710;973;2998;795;2641;99;378;478;1559;577;1937
310890;201710;2320;6788;1713;5739;437;1635;290;847;727;2482
310900;201710;4235;12626;3270;10735;631;2321;1391;4258;2022;6579
310910;201710;1747;4804;1067;3467;141;519;116;302;257;821
310920;201710;1785;5056;1402;4419;246;855;743;2303;989;3158
310925;201710;925;2843;807;2650;159;576;489;1549;648;2125
310930;201710;5763;15779;4420;13748;728;2394;2415;7703;3143;10097
310940;201710;5919;15879;4826;14251;505;1652;3175;9234;3680;10886
310945;201710;1138;3263;1027;3098;78;267;693;2039;771;2306
310950;201710;1963;5959;1411;4790;308;1192;465;1453;773;2645
310960;201710;624;1644;404;1247;70;252;136;437;206;689
310970;201710;1113;3533;829;2927;203;770;213;698;416;1468
310980;201710;364;860;233;645;31;98;143;374;174;472
310990;201710;1195;3661;940;3117;214;748;333;1064;547;1812
311000;201710;3767;11544;3130;10447;890;3254;1169;3717;2059;6971
311010;201710;724;2342;632;2125;228;824;220;722;448;1546
311020;201710;950;2653;693;2170;100;361;325;961;425;1322
311030;201710;1580;4257;1074;3341;287;1018;314;885;601;1903
311040;201710;372;1214;308;1064;76;270;68;208;144;478
311050;201710;2179;6288;1820;5704;437;1525;687;2085;1124;3610
311060;201710;2453;7008;1774;5548;281;1020;642;1813;923;2833
311070;201710;1514;4579;1193;4001;204;803;542;1733;746;2536
311080;201710;816;2316;683;2078;127;443;352;988;479;1431
311090;201710;1933;6592;1561;5909;409;1753;509;1860;918;3613
311100;201710;1917;6011;1378;4901;379;1505;181;577;560;2082
311110;201710;3097;7244;2147;5874;507;1441;900;2517;1407;3958
311115;201710;1173;3338;991;3068;77;293;749;2277;826;2570
311120;201710;6745;18512;5049;15420;987;3366;1566;4313;2553;7679
311130;201710;1874;5489;1543;4976;196;768;737;2278;933;3046
311140;201710;1206;3128;908;2716;65;215;603;1834;668;2049
311150;201710;1387;4804;1240;4529;200;777;733;2672;933;3449
311160;201710;3580;11446;2747;9894;908;3557;592;2088;1500;5645
311170;201710;765;2268;621;2001;46;165;350;1144;396;1309
311180;201710;1079;2874;805;2419;237;764;261;787;498;1551
311190;201710;1025;2932;791;2484;153;552;279;811;432;1363
311200;201710;1643;4850;1266;4063;352;1207;233;711;585;1918
311205;201710;886;2891;759;2640;79;347;417;1426;496;1773
311210;201710;979;3025;884;2904;132;401;631;2135;763;2536
311220;201710;759;2320;623;2046;138;499;247;752;385;1251
311230;201710;7757;24467;5963;20713;1267;4690;1839;6643;3106;11333
311240;201710;890;2636;708;2349;154;562;337;1087;491;1649
311250;201710;754;2338;651;2160;167;585;254;808;421;1393
311260;201710;2014;5340;1535;4541;329;1067;609;1715;938;2782
311265;201710;1168;3218;922;2826;98;335;585;1779;683;2114
311270;201710;3156;9834;2797;9317;232;1079;1989;6328;2221;7407
311280;201710;1102;3062;611;1955;110;397;129;394;239;791
311290;201710;1877;6063;1757;5788;221;722;1188;3946;1409;4668
311300;201710;4282;13274;3778;12436;238;1122;2915;9384;3153;10506
311310;201710;624;1951;536;1780;114;387;168;520;282;907
311320;201710;3172;10282;2841;9533;471;1831;1213;3744;1684;5575
311330;201710;4340;12467;3781;11526;582;1956;2022;6209;2604;8165
311340;201710;10647;32778;8921;29483;2680;9344;2233;7534;4913;16878
311350;201710;2129;5766;1638;4870;216;727;826;2270;1042;2997
311360;201710;827;2368;701;2200;351;1174;102;340;453;1514
311370;201710;3874;10885;3116;9566;325;1267;1720;4941;2045;6208
311380;201710;422;1350;340;1186;102;361;99;365;201;726
311390;201710;1686;5721;1440;5368;608;2580;387;1282;995;3862
311400;201710;1379;4133;1050;3498;178;698;422;1257;600;1955
311410;201710;1503;5039;1358;4848;310;1248;672;2383;982;3631
311420;201710;1716;5473;1163;4172;196;767;125;355;321;1122
311430;201710;3381;9637;2282;7383;376;1303;553;1768;929;3071
311440;201710;2317;7204;1693;6037;511;2025;359;1295;870;3320
311450;201710;1807;5919;1405;5127;379;1515;272;876;651;2391
311455;201710;921;2354;692;1989;198;587;224;633;422;1220
311460;201710;549;1760;401;1476;91;406;107;352;198;758
311470;201710;386;1289;307;1117;74;301;55;186;129;487
311480;201710;813;2117;725;1974;114;313;426;1115;540;1428
311490;201710;202;705;180;637;56;221;66;205;122;426
311500;201710;386;1104;306;964;49;177;155;491;204;668
311510;201710;2633;7779;1912;6434;499;1922;418;1364;917;3286
311520;201710;577;1800;538;1725;142;502;257;784;399;1286
311530;201710;8988;22537;6287;18154;1565;5189;1589;4378;3154;9567
311535;201710;718;2038;480;1589;109;433;112;355;221;788
311540;201710;554;1852;513;1785;143;500;242;858;385;1358
311545;201710;2064;6021;1834;5729;122;495;1396;4279;1518;4774
311547;201710;1447;3947;1255;3645;63;230;963;2774;1026;3004
311550;201710;2720;8221;2205;7204;370;1420;831;2588;1201;4008
311560;201710;248;603;196;542;29;89;110;279;139;368
311570;201710;1919;4765;1453;4111;58;170;1157;3394;1215;3564
311580;201710;2256;4364;1592;3599;225;420;1019;2484;1244;2904
311590;201710;484;1434;402;1309;87;335;190;604;277;939
311600;201710;1235;3520;1023;3237;110;335;748;2417;858;2752
311610;201710;2416;8518;2161;7958;548;1942;911;3495;1459;5437
311615;201710;2953;9096;2439;8260;222;895;1756;5880;1978;6775
311620;201710;382;1126;338;1053;31;115;251;771;282;886
311630;201710;1324;3795;1100;3385;86;304;786;2357;872;2661
311640;201710;560;1828;470;1660;101;388;192;667;293;1055
311650;201710;1971;5513;1715;5117;179;639;1124;3249;1303;3888
311660;201710;2750;8383;2075;7067;419;1508;377;1139;796;2647
311670;201710;1517;4167;1209;3685;236;796;509;1578;745;2374
311680;201710;1990;6163;1635;5475;269;968;1011;3361;1280;4329
311690;201710;527;1252;432;1132;20;62;343;904;363;966
311700;201710;2197;5589;1731;4961;60;206;1375;3870;1435;4076
311710;201710;1477;4479;1056;3640;308;1158;310;1093;618;2251
311720;201710;398;1287;337;1164;47;187;171;572;218;759
311730;201710;4889;12184;2905;8720;930;3123;388;1031;1318;4154
311740;201710;753;2298;710;2242;54;156;618;1985;672;2141
311750;201710;3860;12113;3272;11142;418;1694;1999;6553;2417;8247
311760;201710;634;2030;555;1852;116;449;173;483;289;932
311770;201710;1900;5913;1519;5163;354;1301;516;1699;870;3000
311780;201710;1179;3844;928;3299;215;891;232;701;447;1592
311783;201710;1970;6144;1665;5578;60;287;1347;4436;1407;4723
311787;201710;653;2088;475;1627;87;328;156;458;243;786
311790;201710;1398;3939;1026;3278;220;794;393;1226;613;2020
311800;201710;4713;15294;4088;13816;838;3168;590;1842;1428;5010
311810;201710;974;3158;829;2860;68;275;497;1700;565;1975
311820;201710;615;1788;521;1600;91;342;307;868;398;1210
311830;201710;7789;24330;5871;20034;1590;5906;555;1856;2145;7762
311840;201710;2754;8060;2470;7618;378;1336;1636;4974;2014;6310
311850;201710;288;854;247;786;31;96;161;510;192;606
311860;201710;48338;134877;40431;121580;6645;21312;22611;66759;29256;88071
311870;201710;1938;5513;1377;4432;249;920;497;1441;746;2361
311880;201710;6215;17382;5475;16361;487;1405;4111;12499;4598;13904
311890;201710;1342;3786;1101;3367;213;703;569;1684;782;2387
311900;201710;642;1843;528;1654;64;233;342;1051;406;1284
311910;201710;3889;11071;3254;10195;702;2303;1525;4802;2227;7105
311920;201710;1880;5785;1570;5242;167;628;942;3094;1109;3722
311930;201710;3049;8300;2494;7415;1015;3212;657;1817;1672;5029
311940;201710;12722;36749;10057;31504;1780;6169;3859;11416;5639;17585
311950;201710;2148;6244;1697;5475;117;505;1212;3840;1329;4345
311960;201710;435;1227;382;1127;48;204;226;568;274;772
311970;201710;428;1430;283;1051;51;220;60;203;111;423
311980;201710;450;1284;291;965;43;154;93;304;136;458
311990;201710;480;1230;337;1037;104;357;134;396;238;753
311995;201710;986;2906;557;1869;32;120;56;131;88;251
312000;201710;555;1596;491;1500;37;120;354;1100;391;1220
312010;201710;835;2714;690;2369;81;296;345;1154;426;1450
312015;201710;1286;4027;1157;3792;105;431;813;2587;918;3018
312020;201710;1079;3402;946;3176;194;703;412;1356;606;2059
312030;201710;1862;5025;1657;4779;38;176;1512;4314;1550;4490
312040;201710;731;2492;593;2165;108;457;202;686;310;1143
312050;201710;1194;4098;988;3636;269;1125;224;748;493;1873
312060;201710;774;2243;614;2011;154;523;296;964;450;1487
312070;201710;875;2651;618;2099;90;353;305;993;395;1346
312080;201710;2654;6902;1987;5892;208;740;1190;3302;1398;4042
312083;201710;916;2530;753;2272;101;336;508;1494;609;1830
312087;201710;2148;6104;1881;5726;122;375;1480;4598;1602;4973
312090;201710;8699;25290;6948;22366;1697;5747;2767;8880;4464;14627
312100;201710;1463;4599;1114;3996;159;702;515;1750;674;2452
312110;201710;969;3266;828;2965;244;983;201;636;445;1619
312120;201710;613;1867;481;1618;117;455;164;473;281;928
312125;201710;1146;3503;1029;3319;180;552;716;2380;896;2932
312130;201710;825;2252;648;1921;82;282;266;741;348;1023
312140;201710;774;2406;647;2121;161;569;213;640;374;1209
312150;201710;465;1363;396;1203;19;79;256;725;275;804
312160;201710;7237;23050;6065;20620;1136;4323;2495;8080;3631;12403
312170;201710;836;2385;678;2106;44;156;458;1377;502;1533
312180;201710;1287;3868;1098;3486;174;627;511;1535;685;2162
312190;201710;509;1612;382;1339;108;411;62;222;170;633
312200;201710;4588;12947;3779;11522;664;2062;2230;6829;2894;8891
312210;201710;1167;2957;870;2537;117;407;570;1586;687;1993
312220;201710;1982;6485;1821;6269;109;292;1503;5362;1612;5654
312230;201710;10540;31072;7837;25907;2431;8820;1010;3079;3441;11899
312235;201710;1546;4478;1348;4202;146;524;966;2964;1112;3488
312240;201710;756;2527;606;2212;153;618;151;544;304;1162
312245;201710;2320;6450;2047;6078;70;262;1713;5066;1783;5328
312247;201710;802;2217;599;1887;153;479;265;890;418;1369
312250;201710;1057;2827;747;2269;138;462;303;883;441;1345
312260;201710;909;2693;736;2413;77;288;502;1588;579;1876
312270;201710;651;1899;528;1651;38;163;273;780;311;943
312280;201710;404;1286;340;1154;113;396;38;133;151;529
312290;201710;719;2364;655;2258;137;524;219;747;356;1271
312300;201710;897;2808;660;2235;169;619;85;226;254;845
312310;201710;766;2711;691;2549;132;551;329;1186;461;1737
312320;201710;1844;5088;1410;4292;405;1333;311;896;716;2229
312330;201710;876;2578;733;2369;88;332;527;1660;615;1992
312340;201710;272;727;207;624;32;106;103;298;135;404
312350;201710;258;618;223;581;27;81;171;435;198;516
312352;201710;1533;4681;1353;4411;183;615;900;3062;1083;3677
312360;201710;2614;8151;2096;7041;473;1727;525;1700;998;3427
312370;201710;1652;4877;1422;4462;324;1122;651;1950;975;3072
312380;201710;2015;5025;1783;4719;42;104;1577;4232;1619;4336
312385;201710;1232;3518;1024;3151;147;524;637;1855;784;2379
312390;201710;1994;6129;1547;5266;356;1322;385;1210;741;2532
312400;201710;2815;8829;2299;7801;871;3038;560;1964;1431;5002
312410;201710;10318;31878;8978;29364;1826;6367;4178;13466;6004;19833
312420;201710;3599;10908;3298;10354;590;1962;1860;5840;2450;7802
312430;201710;7691;21707;6498;19585;747;2431;4246;12753;4993;15184
312440;201710;817;2575;666;2280;282;1039;121;413;403;1452
312450;201710;1099;3550;874;3107;266;989;314;1160;580;2149
312460;201710;341;986;284;907;48;175;164;537;212;712
312470;201710;508;1378;330;1051;60;226;108;311;168;537
312480;201710;1114;2817;797;2433;111;401;477;1392;588;1793
312490;201710;1896;4902;1476;4231;249;772;806;2229;1055;3001
312500;201710;734;1974;604;1781;67;232;354;1012;421;1244
312510;201710;3459;9876;2774;8508;402;1324;1326;3911;1728;5235
312520;201710;200;592;163;534;48;154;66;227;114;381
312530;201710;544;1562;481;1473;35;132;388;1181;423;1313
312540;201710;1367;4180;928;3214;205;766;394;1342;599;2108
312550;201710;737;2128;585;1797;68;225;318;898;386;1123
312560;201710;1938;5172;1661;4803;79;304;1367;3924;1446;4228
312570;201710;2166;6116;1780;5507;509;1642;671;2124;1180;3766
312580;201710;525;1651;424;1410;51;200;170;548;221;748
312590;201710;1633;5156;1377;4634;180;771;701;2191;881;2962
312595;201710;1718;5610;1581;5325;288;966;915;3158;1203;4124
312600;201710;829;2388;569;1977;96;394;246;832;342;1226
312610;201710;5995;16226;4230;13016;932;3114;971;2835;1903;5949
312620;201710;2314;6198;1724;5382;83;335;1301;4185;1384;4520
312630;201710;264;865;226;791;57;226;75;269;132;495
312640;201710;557;1630;403;1346;66;225;128;426;194;651
312650;201710;1995;5573;1427;4425;129;471;911;2677;1040;3148
312660;201710;1341;3436;1056;3016;119;401;695;1932;814;2333
312670;201710;4990;14290;4222;13218;555;2112;2507;7574;3062;9686
312675;201710;1289;3820;1048;3363;98;389;776;2438;874;2827
312680;201710;1322;3935;1154;3696;107;443;841;2624;948;3067
312690;201710;2099;5386;1668;4803;182;541;1152;3261;1334;3802
312695;201710;855;2742;787;2625;106;342;565;1910;671;2252
312700;201710;1840;5321;1424;4539;162;556;808;2535;970;3091
312705;201710;1257;3478;1037;3097;46;174;767;2222;813;2396
312707;201710;1378;4357;1076;3767;93;448;618;2059;711;2507
312710;201710;5941;14417;3778;11095;1187;3868;754;2247;1941;6115
312720;201710;890;2736;708;2392;86;340;347;1119;433;1459
312730;201710;1723;4144;1245;3540;82;262;814;2305;896;2567
312733;201710;1528;4105;1171;3446;49;145;753;2177;802;2322
312735;201710;715;1964;621;1806;100;372;400;1049;500;1421
312737;201710;778;1934;558;1607;121;366;239;680;360;1046
312738;201710;489;1433;337;1126;71;280;131;397;202;677
312740;201710;316;800;186;612;60;210;41;109;101;319
312750;201710;1192;4040;1069;3826;179;744;545;1855;724;2599
312760;201710;1856;5753;1371;4765;280;1018;404;1398;684;2416
312770;201710;38136;100550;27100;81456;6563;21052;7932;23259;14495;44311
312780;201710;2472;8298;2220;7843;295;1194;1344;4707;1639;5901
312790;201710;330;829;194;626;26;103;73;215;99;318
312800;201710;4625;14492;3692;12529;995;3657;1053;3555;2048;7212
312810;201710;1850;5350;1229;4157;313;1171;302;898;615;2069
312820;201710;1880;5244;1565;4693;76;280;1080;3139;1156;3419
312825;201710;1212;3151;1072;2974;46;144;888;2472;934;2616
312830;201710;2367;7100;1621;5606;421;1599;297;997;718;2596
312840;201710;1125;3558;894;3090;146;575;286;894;432;1469
312850;201710;754;2152;572;1822;92;343;249;758;341;1101
312860;201710;1400;3690;923;2886;238;784;245;740;483;1524
312870;201710;5456;16470;3630;12424;605;2232;894;2865;1499;5097
312880;201710;1309;3627;1116;3350;64;197;706;2224;770;2421
312890;201710;1907;5478;1230;4051;223;770;451;1505;674;2275
312900;201710;1141;3261;966;3020;90;303;626;2001;716;2304
312910;201710;1506;2921;876;2105;131;343;448;1036;579;1379
312920;201710;877;2610;675;2261;138;551;319;1000;457;1551
312930;201710;2042;5668;1706;5150;398;1251;771;2297;1169;3548
312940;201710;853;2663;735;2448;167;583;315;1055;482;1638
312950;201710;2466;6887;1907;6024;653;2222;530;1673;1183;3895
312960;201710;1889;5239;1637;4880;107;307;1252;3804;1359;4111
312965;201710;1720;5299;1450;4782;107;387;934;3071;1041;3458
312970;201710;941;2990;739;2643;180;718;245;840;425;1558
312980;201710;18416;57233;16369;53358;3457;12361;7525;23427;10982;35788
312990;201710;423;1232;283;976;78;311;104;349;182;660
313000;201710;433;1388;359;1250;66;304;140;432;206;736
313005;201710;2518;7666;2234;7168;218;778;1578;5007;1796;5785
313010;201710;3888;11960;3280;10884;709;2631;1732;5532;2441;8163
313020;201710;899;2945;635;2298;104;430;75;228;179;658
313030;201710;1275;3249;900;2668;139;488;488;1409;627;1897
313040;201710;745;2389;627;2119;67;276;325;1026;392;1302
313050;201710;1702;5088;1222;4324;279;1155;319;997;598;2152
313055;201710;1608;4864;1479;4673;36;131;1299;4094;1335;4225
313060;201710;876;2458;642;2031;192;662;128;371;320;1033
313065;201710;1772;5649;1518;5248;136;555;1138;3926;1274;4481
313070;201710;908;2559;732;2260;129;426;360;1086;489;1512
313080;201710;400;1147;294;933;71;267;84;210;155;477
313090;201710;4595;13079;3956;12017;1101;3607;1830;5540;2931;9147
313100;201710;1309;3655;1077;3290;68;235;826;2515;894;2750
313110;201710;1492;4162;1101;3430;134;476;521;1526;655;2002
313115;201710;2333;7438;2116;6972;379;1350;1018;3150;1397;4500
313120;201710;3395;8551;2805;7827;329;1000;1873;5273;2202;6273
313130;201710;24878;72118;20729;64086;3515;12057;9620;28146;13135;40203
313140;201710;498;1253;358;1026;21;80;251;697;272;777
313150;201710;1221;3757;999;3330;336;1178;255;862;591;2040
313160;201710;877;2458;693;2150;100;347;397;1186;497;1533
313170;201710;10529;34051;7918;28070;1646;6145;2497;8582;4143;14727
313180;201710;2172;5873;1653;5024;283;948;780;2306;1063;3254
313190;201710;3801;12122;2980;10262;604;2249;867;2794;1471;5043
313200;201710;1072;3244;933;2991;52;197;736;2303;788;2500
313210;201710;3714;11264;3124;10293;531;1942;1741;5539;2272;7481
313220;201710;1568;4450;1108;3555;211;783;376;1059;587;1842
313230;201710;2369;7767;2191;7529;105;392;1889;6486;1994;6878
313240;201710;8002;23005;5866;19074;1129;4071;2332;7183;3461;11254
313250;201710;6151;19028;5173;17234;550;1999;2770;9129;3320;11128
313260;201710;627;1772;432;1362;59;224;174;537;233;761
313270;201710;5097;15048;4267;13595;831;2806;2381;7628;3212;10434
313280;201710;359;1157;260;944;54;209;57;206;111;415
313290;201710;730;2553;609;2348;257;1078;94;325;351;1403
313300;201710;1637;5039;1301;4350;373;1349;187;546;560;1895
313310;201710;953;3140;833;2907;162;638;173;511;335;1149
313320;201710;2158;5992;1537;5005;309;1124;659;2126;968;3250
313330;201710;3940;11458;3248;10327;251;1081;2163;6630;2414;7711
313340;201710;1424;3392;1049;2843;164;450;643;1765;807;2215
313350;201710;2240;6850;1717;5735;303;1112;509;1579;812;2691
313360;201710;1233;3359;881;2758;170;654;447;1288;617;1942
313370;201710;1154;3756;1054;3539;148;558;574;1870;722;2428
313375;201710;1897;5046;1329;4149;247;919;400;1187;647;2106
313380;201710;4779;13724;3891;12079;922;3186;1486;4184;2408;7370
313390;201710;845;2824;773;2696;56;246;522;1779;578;2025
313400;201710;3338;9023;2835;8398;227;656;2299;6861;2526;7517
313410;201710;1167;3216;965;2893;120;411;706;2078;826;2489
313420;201710;15171;35939;9012;25597;1908;6050;1316;3768;3224;9818
313430;201710;885;2714;662;2261;120;504;257;785;377;1289
313440;201710;5776;13075;4003;10871;303;822;2609;7186;2912;8008
313450;201710;595;1754;449;1459;92;309;129;388;221;697
313460;201710;1989;6462;1685;5934;417;1709;710;2276;1127;3985
313470;201710;2900;7650;2470;7041;276;776;1726;4946;2002;5722
313480;201710;807;2345;561;1855;82;326;175;510;257;836
313490;201710;1457;3586;720;2486;257;1041;61;218;318;1259
313500;201710;396;1279;317;1084;46;180;119;375;165;555
313505;201710;8466;24672;7736;23792;315;1051;6873;21206;7188;22257
313507;201710;1337;3581;1147;3311;73;246;854;2463;927;2709
313510;201710;12823;37013;11142;34107;1474;4946;5856;17593;7330;22539
313520;201710;13094;39912;10955;36104;1005;3802;7382;24010;8387;27812
313530;201710;464;1371;390;1249;30;108;170;510;200;618
313535;201710;2446;6966;2165;6452;173;510;1508;4466;1681;4976
313540;201710;845;2629;638;2104;160;551;200;641;360;1192
313545;201710;1145;4037;994;3741;170;707;555;2004;725;2711
313550;201710;1669;5236;1458;4831;365;1278;715;2283;1080;3561
313560;201710;2286;4989;1813;4450;105;259;1474;3622;1579;3881
313570;201710;897;2931;739;2604;190;735;280;942;470;1677
313580;201710;5424;15233;4298;13483;720;2367;2230;7259;2950;9626
313590;201710;857;2548;678;2269;294;1082;162;535;456;1617
313600;201710;3569;10481;3110;9721;230;860;2381;7374;2611;8234
313610;201710;956;2697;808;2420;136;416;509;1522;645;1938
313620;201710;5208;15282;4460;13946;1016;3383;1897;5870;2913;9253
313630;201710;7787;20686;5596;17481;880;2986;2783;8979;3663;11965
313640;201710;911;2321;602;1876;177;602;198;583;375;1185
313650;201710;1783;5695;1535;5284;136;557;1019;3485;1155;4042
313652;201710;805;2779;746;2663;113;470;459;1560;572;2030
313655;201710;933;2831;773;2580;76;295;506;1669;582;1964
313657;201710;1316;3721;1045;3300;82;355;742;2185;824;2540
313660;201710;827;2590;706;2337;133;538;343;1051;476;1589
313665;201710;4076;12245;3357;10873;532;1917;1793;5657;2325;7574
313670;201710;40203;112625;28865;91290;6034;20783;9891;30152;15925;50935
313680;201710;972;2796;846;2594;79;281;539;1614;618;1895
313690;201710;799;2771;661;2472;143;552;204;780;347;1332
313695;201710;1476;4475;1194;3988;107;423;834;2765;941;3188
313700;201710;3283;10966;2836;10408;316;1196;2186;8137;2502;9333
313710;201710;1300;3407;974;2884;119;374;560;1658;679;2032
313720;201710;5274;15730;3995;13099;744;2747;1416;4278;2160;7025
313730;201710;1200;3067;918;2689;83;259;580;1678;663;1937
313740;201710;1732;6297;1468;5592;374;1556;139;500;513;2056
313750;201710;1920;5598;1500;4767;393;1388;475;1357;868;2745
313753;201710;1904;5003;1413;4170;201;668;748;2156;949;2824
313760;201710;4530;13549;3515;11532;906;3215;1188;3701;2094;6916
313770;201710;3403;10264;2863;9503;342;1210;1839;6153;2181;7363
313780;201710;3774;10430;2902;9023;452;1584;852;2689;1304;4273
313790;201710;428;1417;409;1383;68;240;235;773;303;1013
313800;201710;1183;3036;1005;2778;70;229;773;2174;843;2403
313810;201710;1541;4243;1285;3865;118;401;911;2753;1029;3154
313820;201710;12002;30874;9089;25891;1450;4724;3711;9895;5161;14619
313830;201710;331;1048;299;989;69;247;142;478;211;725
313835;201710;860;2756;754;2560;74;302;436;1424;510;1726
313840;201710;6367;17888;4918;15438;1223;4154;1092;3376;2315;7530
313850;201710;966;2580;834;2355;121;429;463;1183;584;1612
313860;201710;2661;7719;1973;6251;400;1363;633;1864;1033;3227
313862;201710;1248;3143;819;2427;89;283;431;1281;520;1564
313865;201710;2136;6401;1922;6069;175;603;1441;4501;1616;5104
313867;201710;1066;3599;917;3281;302;1115;332;1191;634;2306
313868;201710;1649;5412;1408;4919;111;443;1037;3587;1148;4030
313870;201710;776;2232;610;1950;133;470;204;585;337;1055
313880;201710;1300;3814;1050;3411;244;877;385;1121;629;1998
313890;201710;1953;4798;1463;4165;186;577;863;2547;1049;3124
313900;201710;3444;11785;3002;10844;909;3593;755;2737;1664;6330
313910;201710;632;2049;513;1811;150;568;86;302;236;870
313920;201710;3014;9859;2532;8959;510;1843;1308;4782;1818;6625
313925;201710;1707;4599;1326;3883;216;596;777;2318;993;2914
313930;201710;6061;21113;5158;19539;518;1869;3474;13896;3992;15765
313940;201710;8233;25749;6269;22391;1506;6038;1635;6318;3141;12356
313950;201710;3952;10497;3042;9104;776;2776;1374;3827;2150;6603
313960;201710;5179;13349;3679;10965;861;2779;1105;3142;1966;5921
313970;201710;1299;3848;1152;3606;92;354;709;2250;801;2604
313980;201710;1244;3649;857;2947;147;578;313;1014;460;1592
313990;201710;1583;5696;1333;5073;434;1783;341;1200;775;2983
314000;201710;8314;24640;7355;22777;701;2695;4792;14514;5493;17209
314010;201710;1194;3150;971;2841;53;207;734;2100;787;2307
314015;201710;1892;5561;1523;4959;215;831;840;2667;1055;3498
314020;201710;502;1457;314;1051;63;250;64;208;127;458
314030;201710;785;2492;615;2094;95;348;268;897;363;1245
314040;201710;724;2051;605;1819;119;398;260;747;379;1145
314050;201710;1514;4524;1196;3868;206;776;553;1657;759;2433
314053;201710;1496;4692;1317;4441;161;541;936;3319;1097;3860
314055;201710;2151;6212;1885;5818;54;241;1577;4844;1631;5085
314060;201710;1089;3273;878;2909;57;226;605;1968;662;2194
314070;201710;4051;12010;3239;10519;810;2778;1130;3528;1940;6306
314080;201710;1712;5185;1237;4131;212;838;341;1006;553;1844
314085;201710;2007;6449;1711;6003;427;1631;721;2517;1148;4148
314090;201710;3281;10589;2870;9864;331;1373;1740;5962;2071;7335
314100;201710;3036;7448;2628;6900;85;182;2261;6124;2346;6306
314110;201710;3865;11914;3344;10886;620;2235;1571;4755;2191;6990
314120;201710;881;2079;404;1284;99;360;64;196;163;556
314130;201710;711;2031;367;1258;59;228;95;322;154;550
314140;201710;4585;13956;3665;12064;677;2322;1580;5198;2257;7520
314150;201710;1458;3964;1161;3450;141;444;681;1981;822;2425
314160;201710;2437;6456;1818;5427;265;853;870;2675;1135;3528
314170;201710;989;2893;820;2544;116;389;468;1379;584;1768
314180;201710;4841;14554;4187;13524;800;2766;2220;7153;3020;9919
314190;201710;715;2105;529;1803;103;374;246;857;349;1231
314200;201710;2799;8336;2410;7606;182;739;1750;5332;1932;6071
314210;201710;1915;5297;1658;4873;149;493;1039;2990;1188;3483
314220;201710;1354;4053;972;3316;302;1145;226;707;528;1852
314225;201710;1226;3536;1091;3347;70;239;820;2526;890;2765
314230;201710;674;2015;596;1895;77;300;360;1118;437;1418
314240;201710;1042;3034;833;2698;197;694;352;1169;549;1863
314250;201710;529;1548;357;1153;66;231;117;339;183;570
314260;201710;913;3083;766;2759;154;673;269;870;423;1543
314270;201710;2964;9016;2448;8101;145;587;1813;5878;1958;6465
314280;201710;3168;8008;2066;6041;382;1252;737;2017;1119;3269
314290;201710;4427;12025;3788;10968;528;1597;2411;6889;2939;8486
314300;201710;1485;4698;1180;4035;327;1169;335;1119;662;2288
314310;201710;5197;14539;4043;12484;1245;4084;1060;3061;2305;7145
314315;201710;795;3028;709;2837;52;266;532;2084;584;2350
314320;201710;2733;7660;1889;6272;482;1722;724;2438;1206;4160
314330;201710;47452;139356;38870;125005;11848;40171;9509;30989;21357;71160
314340;201710;2495;6554;1361;4376;274;1011;173;400;447;1411
314345;201710;1250;4048;1118;3815;147;521;734;2459;881;2980
314350;201710;1092;3035;757;2446;187;656;174;538;361;1194
314360;201710;668;2075;416;1492;82;338;88;306;170;644
314370;201710;568;1709;497;1600;64;232;347;1090;411;1322
314380;201710;1155;3411;813;2734;223;824;118;417;341;1241
314390;201710;11349;31678;7971;25409;1870;6420;1916;5581;3786;12001
314400;201710;4123;12283;3450;11240;1029;3488;1185;4001;2214;7489
314410;201710;2652;7988;1934;6618;379;1383;683;2648;1062;4031
314420;201710;713;1943;559;1716;24;129;427;1258;451;1387
314430;201710;5905;16778;4829;14859;1084;3521;1703;5255;2787;8776
314435;201710;1381;4178;1212;3915;63;278;908;2897;971;3175
314437;201710;947;2506;747;2227;22;75;508;1554;530;1629
314440;201710;511;1533;419;1380;123;452;133;385;256;837
314450;201710;1403;4032;1183;3680;183;705;656;1898;839;2603
314460;201710;3526;11531;2718;9712;650;2507;463;1607;1113;4114
314465;201710;2191;6645;1984;6248;71;308;1574;4843;1645;5151
314467;201710;904;2558;767;2326;27;82;588;1774;615;1856
314470;201710;2134;6530;1801;5859;388;1394;719;2159;1107;3553
314480;201710;5402;17308;3931;13692;735;2802;724;2281;1459;5083
314490;201710;852;2449;641;2015;98;344;361;1077;459;1421
314500;201710;1700;4669;1230;3865;232;763;411;1290;643;2053
314505;201710;1839;4965;1625;4691;126;403;1164;3359;1290;3762
314510;201710;1856;4915;1222;4026;287;1015;423;1418;710;2433
314520;201710;3257;10805;2253;8465;451;1936;215;698;666;2634
314530;201710;5422;18606;5053;17909;652;2346;3369;12182;4021;14528
314535;201710;2600;7062;2174;6456;146;470;1664;4919;1810;5389
314537;201710;1043;3139;825;2757;85;333;552;1808;637;2141
314540;201710;348;1018;269;856;46;166;109;323;155;489
314545;201710;1511;4334;1358;4120;64;191;1119;3572;1183;3763
314550;201710;648;1660;460;1399;61;236;204;554;265;790
314560;201710;3924;12918;3229;11354;565;2189;1076;3576;1641;5765
314570;201710;286;832;219;702;28;108;114;353;142;461
314580;201710;474;1557;365;1312;84;330;50;177;134;507
314585;201710;729;2313;534;1878;106;449;209;678;315;1127
314587;201710;1854;5455;1496;4849;253;770;799;2654;1052;3424
314590;201710;2607;8570;2038;7248;413;1591;598;2043;1011;3634
314600;201710;1678;5155;1097;3937;264;1043;112;340;376;1383
314610;201710;6810;21404;5768;19332;1188;4564;2403;7682;3591;12246
314620;201710;1705;4671;1451;4309;76;245;1176;3457;1252;3702
314625;201710;1444;4618;1306;4406;121;567;980;3159;1101;3726
314630;201710;4598;13297;3980;12312;201;840;3144;9614;3345;10454
314640;201710;562;1506;424;1259;99;325;159;414;258;739
314650;201710;964;2587;675;2111;88;334;269;744;357;1078
314655;201710;1534;4437;1101;3585;234;744;439;1433;673;2177
314660;201710;305;781;202;580;13;29;103;286;116;315
314670;201710;1569;4052;1097;3245;103;346;680;1946;783;2292
314675;201710;1749;5014;1522;4630;135;474;1121;3362;1256;3836
314690;201710;1955;6212;1577;5499;506;1939;269;917;775;2856
314700;201710;8935;28213;6135;22064;1536;6098;1068;3766;2604;9864
314710;201710;7653;22685;5545;18184;1116;4041;1046;3112;2162;7153
314720;201710;2158;6938;1684;5904;392;1504;424;1468;816;2972
314730;201710;2057;6005;1589;5165;411;1459;472;1413;883;2872
314740;201710;2606;7864;2155;7027;259;1024;1146;3572;1405;4596
314750;201710;328;987;258;848;30;121;135;418;165;539
314760;201710;1768;5647;1276;4469;187;750;288;827;475;1577
314770;201710;1018;3114;567;1918;42;156;136;387;178;543
314780;201710;301;777;222;662;51;179;103;289;154;468
314790;201710;9902;29379;7528;24969;2797;10278;792;2274;3589;12552
314795;201710;1411;4053;1238;3771;70;291;958;2808;1028;3099
314800;201710;10990;30030;6846;21861;1613;5581;882;2557;2495;8138
314810;201710;9202;25991;6974;22108;2100;7037;1584;5085;3684;12122
314820;201710;854;2307;632;1927;116;406;314;915;430;1321
314830;201710;1476;4802;1299;4481;283;1076;652;2234;935;3310
314840;201710;875;2955;710;2709;85;433;458;1680;543;2113
314850;201710;1877;5118;1499;4478;119;431;1138;3322;1257;3753
314860;201710;3104;9975;2692;9176;426;1662;1579;5248;2005;6910
314870;201710;5579;16124;4667;14868;435;1526;3451;11091;3886;12617
314875;201710;1689;5349;1570;5187;105;304;1344;4505;1449;4809
314880;201710;882;2259;704;2015;45;107;491;1487;536;1594
314890;201710;463;1375;340;1100;58;214;132;380;190;594
314900;201710;632;1746;507;1538;107;359;186;559;293;918
314910;201710;1645;5146;1312;4605;329;1331;551;1853;880;3184
314915;201710;2287;7142;1973;6571;152;624;1346;4351;1498;4975
314920;201710;425;1176;336;1052;25;85;195;592;220;677
314930;201710;4688;15026;3908;13358;897;3297;1262;4120;2159;7417
314940;201710;381;1085;336;1002;44;136;204;578;248;714
314950;201710;357;991;251;829;36;131;95;307;131;438
314960;201710;693;1965;537;1657;83;301;278;793;361;1094
314970;201710;598;1973;526;1842;114;451;188;642;302;1093
314980;201710;1198;3584;968;3223;291;1078;83;259;374;1337
314990;201710;2204;6720;1574;5268;386;1474;338;986;724;2460
314995;201710;1524;4576;1296;4207;118;506;791;2447;909;2953
315000;201710;1035;2914;819;2559;72;274;524;1608;596;1882
315010;201710;399;1228;306;1031;67;277;111;327;178;604
315015;201710;2002;6047;1834;5832;215;707;1240;4125;1455;4832
315020;201710;782;2376;565;1927;90;345;267;872;357;1217
315030;201710;557;1641;415;1365;111;383;88;263;199;646
315040;201710;855;2537;782;2401;137;450;472;1433;609;1883
315050;201710;1172;3267;915;2885;103;379;472;1473;575;1852
315053;201710;1045;3067;871;2727;109;420;480;1463;589;1883
315057;201710;1582;5285;1400;4904;218;770;798;2797;1016;3567
315060;201710;600;1921;414;1526;97;378;70;257;167;635
315070;201710;644;1900;494;1609;139;483;148;461;287;944
315080;201710;2729;8641;2215;7501;506;1750;947;3208;1453;4958
315090;201710;766;2561;608;2211;133;519;164;564;297;1083
315100;201710;1078;3533;756;2736;160;670;254;850;414;1520
315110;201710;1258;3541;1007;3107;153;523;462;1416;615;1939
315120;201710;11951;28663;8604;24147;1079;3133;4433;13090;5512;16223
315130;201710;1228;3861;1058;3539;228;904;375;1159;603;2063
315140;201710;2701;8038;2160;6989;437;1600;939;2761;1376;4361
315150;201710;4086;10718;2996;8944;457;1490;1256;3709;1713;5199
315160;201710;1354;3718;969;3077;203;679;404;1261;607;1940
315170;201710;1414;4497;1084;3755;240;884;181;620;421;1504
315180;201710;16145;43716;8891;28661;1553;5674;1741;5079;3294;10753
315190;201710;1918;4806;1588;4314;357;979;995;2679;1352;3658
315200;201710;3590;11415;2803;9874;880;3398;565;1948;1445;5346
315210;201710;7353;20863;5732;17430;830;2792;2373;6705;3203;9497
315213;201710;1089;3157;961;2968;32;98;781;2403;813;2501
315217;201710;2403;7923;1957;7087;162;766;1238;4341;1400;5107
315220;201710;8748;24928;7235;22267;2259;7209;2134;6641;4393;13850
315230;201710;2879;7526;2580;7171;85;134;2329;6779;2414;6913
315240;201710;2759;8420;2344;7751;598;2117;1137;3673;1735;5790
315250;201710;9316;27494;7299;23679;1472;5230;2766;8792;4238;14022
315260;201710;883;2729;553;1938;106;387;53;160;159;547
315270;201710;711;2220;518;1833;93;395;140;439;233;834
315280;201710;2715;7415;1635;5152;357;1197;258;790;615;1987
315290;201710;1164;3136;758;2463;245;857;182;610;427;1467
315300;201710;611;1594;426;1358;214;727;114;374;328;1101
315310;201710;1262;3817;990;3291;98;361;566;1804;664;2165
315320;201710;650;1926;498;1681;59;286;235;729;294;1015
315330;201710;693;2483;405;1657;86;384;100;382;186;766
315340;201710;3093;8476;2427;7477;351;1174;1277;3858;1628;5032
315350;201710;1691;4657;1297;4029;88;298;778;2427;866;2725
315360;201710;1637;5202;1240;4326;224;849;425;1408;649;2257
315370;201710;446;1372;379;1232;72;230;170;547;242;777
315380;201710;203;646;149;521;38;149;31;94;69;243
315390;201710;1115;3495;837;2899;171;655;236;761;407;1416
315400;201710;4069;11929;3291;10474;506;1689;1650;5178;2156;6867
315410;201710;2175;5293;1722;4683;381;1097;742;1988;1123;3085
315415;201710;1091;3311;909;3028;298;1096;310;1034;608;2130
315420;201710;1114;3491;826;2904;188;687;119;377;307;1064
315430;201710;3456;9082;2550;7616;698;2364;768;2153;1466;4517
315440;201710;917;2684;788;2465;130;505;394;1100;524;1605
315445;201710;1952;5180;1500;4480;196;625;957;2842;1153;3467
315450;201710;2243;6785;1969;6343;290;905;1238;4086;1528;4991
315460;201710;28594;90243;25444;84037;8391;29494;6616;21031;15007;50525
315470;201710;454;1311;362;1157;28;110;191;591;219;701
315480;201710;1434;4235;1003;3347;228;820;221;738;449;1558
315490;201710;2878;7434;2082;6304;348;1171;705;2019;1053;3190
315500;201710;477;1369;301;971;33;125;134;380;167;505
315510;201710;1258;3597;1089;3325;56;216;891;2677;947;2893
315520;201710;1077;3126;853;2766;62;257;563;1752;625;2009
315530;201710;618;2018;484;1674;169;642;159;499;328;1141
315540;201710;1039;3081;799;2639;129;494;303;987;432;1481
315550;201710;1668;4611;1255;3995;270;971;454;1407;724;2378
315560;201710;5843;19259;5303;18425;430;1711;3683;12806;4113;14517
315570;201710;1794;5566;1608;5189;162;610;874;2752;1036;3362
315580;201710;2165;5868;1705;5079;412;1384;528;1527;940;2911
315590;201710;886;2468;736;2234;99;342;365;1090;464;1432
315600;201710;2387;8109;1811;6964;267;1043;1008;4015;1275;5058
315610;201710;914;2460;721;2097;127;471;309;746;436;1217
315620;201710;294;1024;279;993;60;209;158;602;218;811
315630;201710;804;2443;655;2143;161;534;155;460;316;994
315640;201710;373;1058;318;970;47;170;156;446;203;616
315645;201710;804;2242;598;1873;191;639;155;460;346;1099
315650;201710;1760;4677;1386;4140;79;310;1040;3056;1119;3366
315660;201710;2499;6311;1958;5418;135;371;1359;3713;1494;4084
315670;201710;10533;32927;9202;30321;2068;7367;4025;12830;6093;20197
315680;201710;2836;9167;2176;7862;599;2343;711;2534;1310;4877
315690;201710;2807;7696;1868;6004;456;1546;428;1489;884;3035
315700;201710;7010;20950;5772;18501;986;3399;2705;8405;3691;11804
315710;201710;1840;4960;1351;4168;91;380;835;2438;926;2818
315720;201710;3930;12050;3449;11170;223;1043;2291;7107;2514;8150
315725;201710;1564;4623;1343;4321;191;622;975;3186;1166;3808
315727;201710;579;1668;447;1417;86;306;191;558;277;864
315730;201710;679;2108;626;1991;81;299;310;932;391;1231
315733;201710;1004;2858;857;2610;206;730;334;951;540;1681
315737;201710;1160;3459;913;2997;48;207;622;2009;670;2216
315740;201710;936;2779;771;2445;129;483;370;1041;499;1524
315750;201710;1171;3350;1011;3082;58;200;754;2309;812;2509
315760;201710;1072;2755;1022;2692;17;33;963;2546;980;2579
315765;201710;1714;4857;1474;4544;42;141;1319;4105;1361;4246
315770;201710;1172;3684;1013;3433;340;1260;319;1057;659;2317
315780;201710;22453;69318;19949;64353;3064;11268;10026;30835;13090;42103
315790;201710;3515;11376;3048;10475;269;935;2026;7141;2295;8076
315800;201710;1207;4690;917;3831;193;878;181;714;374;1592
315810;201710;1259;3287;1083;3024;84;285;827;2215;911;2500
315820;201710;2271;7315;1975;6790;314;1209;1227;4150;1541;5359
315830;201710;1089;3372;848;2921;71;302;379;1238;450;1540
315840;201710;748;1965;483;1441;68;211;164;465;232;676
315850;201710;954;3193;877;3058;208;792;455;1493;663;2285
315860;201710;504;1603;358;1315;80;347;102;337;182;684
315870;201710;434;1246;366;1138;28;100;235;695;263;795
315880;201710;1062;2848;828;2497;86;313;351;1010;437;1323
315890;201710;1426;4704;1257;4377;415;1559;494;1640;909;3199
315895;201710;5481;16168;4501;14143;725;2541;1990;5842;2715;8383
315900;201710;804;2163;718;2041;66;241;560;1504;626;1745
315910;201710;469;1508;422;1435;81;288;265;879;346;1167
315920;201710;1585;4287;818;2629;169;577;177;495;346;1072
315930;201710;1006;2562;722;2082;170;510;264;752;434;1262
315935;201710;797;2614;700;2422;159;623;209;722;368;1345
315940;201710;597;1858;507;1679;86;311;247;816;333;1127
315950;201710;1166;3407;1011;3138;166;520;691;2151;857;2671
315960;201710;3381;10244;2218;8011;747;3150;90;212;837;3362
315970;201710;649;1873;507;1674;57;177;356;1210;413;1387
315980;201710;3536;8261;2115;6010;488;1533;686;1765;1174;3298
315990;201710;3611;9836;2891;8600;382;1284;1593;4666;1975;5950
316000;201710;513;1510;426;1382;90;348;170;516;260;864
316010;201710;657;2059;526;1804;52;225;276;869;328;1094
316020;201710;954;3031;829;2788;91;407;547;1728;638;2135
316030;201710;2990;8593;2209;7188;235;816;1343;4437;1578;5253
316040;201710;2843;8950;2130;7498;348;1375;493;1651;841;3026
316045;201710;1848;5577;1744;5402;150;447;1376;4344;1526;4791
316050;201710;357;1101;274;950;42;176;147;487;189;663
316060;201710;691;1976;527;1708;66;309;305;911;371;1220
316070;201710;5478;16456;4693;14837;890;3131;2087;6367;2977;9498
316080;201710;694;2374;582;2113;161;636;63;222;224;858
316090;201710;481;1483;345;1191;56;223;127;416;183;639
316095;201710;1368;4296;1178;3953;204;720;628;2091;832;2811
316100;201710;2512;8031;1868;6516;401;1552;508;1652;909;3204
316105;201710;844;2377;643;2037;119;406;341;1074;460;1480
316110;201710;11484;37282;10240;35143;1441;5112;6597;23001;8038;28113
316120;201710;1055;3285;782;2628;191;679;193;554;384;1233
316130;201710;1399;3217;838;2360;125;404;364;983;489;1387
316140;201710;1031;2828;728;2353;117;396;384;1249;501;1645
316150;201710;1446;3773;1238;3421;173;535;663;1742;836;2277
316160;201710;1054;3091;857;2729;103;363;481;1461;584;1824
316165;201710;892;2289;712;2029;131;437;402;1129;533;1566
316170;201710;1141;3136;840;2654;117;412;417;1257;534;1669
316180;201710;1348;4103;923;3175;202;773;139;397;341;1170
316190;201710;2756;8265;1564;5296;291;989;416;1256;707;2245
316200;201710;3385;10475;2576;8906;604;2370;602;1977;1206;4347
316210;201710;3980;12348;3083;10482;1076;3921;328;1126;1404;5047
316220;201710;697;2123;486;1678;101;386;56;213;157;599
316225;201710;1242;3231;1005;2837;99;348;680;1817;779;2165
316230;201710;399;1123;336;1022;48;150;155;500;203;650
316240;201710;6096;18310;5428;17344;618;2000;3955;12695;4573;14695
316245;201710;3050;10468;2778;10032;210;1100;2141;7498;2351;8598
316250;201710;9062;24962;6898;21004;1904;6320;1515;4414;3419;10734
316255;201710;2571;7565;2257;7121;359;1239;1476;4690;1835;5929
316257;201710;1251;3229;902;2660;124;399;400;1149;524;1548
316260;201710;1841;4959;1417;4322;64;229;790;2501;854;2730
316265;201710;1256;3477;923;2876;59;188;587;1818;646;2006
316270;201710;3365;11146;3041;10409;702;2563;1252;4111;1954;6674
316280;201710;3000;9415;2709;8856;370;1376;1507;4752;1877;6128
316290;201710;3089;9345;2550;8299;463;1704;916;2966;1379;4670
316292;201710;3944;11533;3397;10638;355;1286;2424;7433;2779;8719
316294;201710;740;2297;563;1973;116;462;97;344;213;806
316295;201710;2134;6485;1893;6040;122;516;1422;4365;1544;4881
316300;201710;981;3098;818;2793;54;209;531;1832;585;2041
316310;201710;859;2162;512;1615;101;353;205;623;306;976
316320;201710;551;1665;440;1462;69;262;157;503;226;765
316330;201710;1037;3048;792;2516;68;255;523;1605;591;1860
316340;201710;1049;3114;790;2597;103;420;392;1207;495;1627
316350;201710;1234;3836;1090;3590;138;492;694;2268;832;2760
316360;201710;688;1820;550;1605;63;210;386;1093;449;1303
316370;201710;4291;12892;3537;11447;954;3506;818;2346;1772;5852
316380;201710;1559;4000;1212;3521;45;148;926;2661;971;2809
316390;201710;822;2322;679;2092;162;562;277;841;439;1403
316400;201710;1231;3727;903;3102;150;536;346;1143;496;1679
316410;201710;972;3099;876;2954;91;319;691;2325;782;2644
316420;201710;1770;5466;1571;5202;119;464;1203;3915;1322;4379
316430;201710;824;2444;561;1878;131;472;134;429;265;901
316440;201710;637;2044;496;1820;142;595;83;311;225;906
316443;201710;574;1699;453;1472;107;387;134;420;241;807
316447;201710;1616;4612;1443;4357;70;257;1198;3583;1268;3840
316450;201710;2106;6849;1730;6074;179;695;1181;4100;1360;4795
316460;201710;805;2399;734;2265;241;781;335;996;576;1777
316470;201710;6446;19621;5057;16863;1124;4234;1511;4778;2635;9012
316480;201710;191;606;163;545;39;145;56;171;95;316
316490;201710;325;938;244;767;37;117;101;294;138;411
316500;201710;1178;4014;789;2942;169;686;80;272;249;958
316510;201710;648;2406;598;2307;168;707;204;779;372;1486
316520;201710;988;2836;802;2515;139;503;334;977;473;1480
316530;201710;863;2652;677;2300;124;534;283;853;407;1387
316540;201710;724;2273;639;2118;110;431;212;654;322;1085
316550;201710;1177;3802;1086;3633;145;537;730;2428;875;2965
316553;201710;2633;8532;1878;6643;562;2121;303;1017;865;3138
316555;201710;2737;8993;2430;8580;160;622;1886;6771;2046;7393
316556;201710;641;1583;473;1315;39;133;281;709;320;842
316557;201710;833;2900;746;2726;327;1265;216;747;543;2012
316560;201710;259;907;210;812;63;286;43;154;106;440
316570;201710;1149;3647;1000;3355;320;1098;293;1004;613;2102
316580;201710;356;916;229;674;57;185;73;196;130;381
316590;201710;1348;3657;982;3007;175;594;538;1529;713;2123
316600;201710;982;3164;882;2971;165;623;437;1440;602;2063
316610;201710;565;1968;491;1825;65;338;304;1068;369;1406
316620;201710;2102;6137;1800;5660;131;490;1272;3997;1403;4487
316630;201710;1476;4594;1185;4023;374;1256;409;1551;783;2807
316640;201710;144;419;117;369;25;96;57;151;82;247
316650;201710;957;3265;789;3010;64;272;531;2078;595;2350
316660;201710;168;428;72;228;8;36;13;33;21;69
316670;201710;1963;5269;1532;4541;469;1473;472;1348;941;2821
316680;201710;1879;4957;1485;4357;150;488;1064;3044;1214;3532
316690;201710;1054;3484;918;3205;245;972;303;1029;548;2001
316695;201710;1001;3037;877;2814;66;261;585;1839;651;2100
316700;201710;365;1014;319;952;21;97;224;613;245;710
316710;201710;2602;9388;2156;8436;700;2812;651;2727;1351;5539
316720;201710;16216;50640;13358;44485;3046;10819;4613;14792;7659;25611
316730;201710;319;982;278;886;80;285;98;280;178;565
316740;201710;631;2024;583;1944;63;285;406;1320;469;1605
316750;201710;396;1285;316;1113;54;213;113;380;167;593
316760;201710;3453;11223;2915;10341;1305;4893;893;3200;2198;8093
316770;201710;1418;3708;1199;3409;40;144;1017;2911;1057;3055
316780;201710;558;1815;470;1629;145;560;47;123;192;683
316790;201710;689;1969;530;1690;153;525;158;499;311;1024
316800;201710;5200;16119;4379;14532;614;2303;2467;7823;3081;10126
316805;201710;812;1998;755;1929;20;32;679;1816;699;1848
316810;201710;535;1572;406;1322;105;380;162;490;267;870
316820;201710;342;867;187;592;29;99;26;89;55;188
316830;201710;594;1880;526;1752;109;411;287;926;396;1337
316840;201710;2631;7751;2279;7109;471;1652;1054;3147;1525;4799
316850;201710;1982;5521;1553;4799;204;745;841;2524;1045;3269
316860;201710;16926;51096;14199;46273;3018;11142;5747;18158;8765;29300
316870;201710;6025;18584;4738;15780;1189;4271;1257;3994;2446;8265
316880;201710;813;2347;705;2173;156;559;287;842;443;1401
316890;201710;1186;2753;804;2238;170;575;462;1159;632;1734
316900;201710;2320;6663;1830;5640;435;1475;573;1584;1008;3059
316905;201710;463;1490;389;1327;108;389;154;523;262;912
316910;201710;870;2552;591;2018;158;626;67;209;225;835
316920;201710;1607;4232;1114;3482;239;831;447;1389;686;2220
316930;201710;7613;24716;5803;20974;1197;4689;1086;3813;2283;8502
316935;201710;3916;11508;2853;9390;699;2444;755;2462;1454;4906
316940;201710;6558;20643;5118;17476;1106;4102;1356;4341;2462;8443
316950;201710;1651;4231;1343;3808;76;254;1048;2907;1124;3161
316960;201710;4532;11257;3513;9840;558;1707;2087;5806;2645;7513
316970;201710;3052;9511;2836;9101;584;2058;1194;3593;1778;5651
316980;201710;788;2398;563;1949;165;620;74;260;239;880
316990;201710;9481;28726;7413;24170;2111;7343;725;2219;2836;9562
317000;201710;2607;8577;2483;8407;174;581;1940;6990;2114;7571
317005;201710;2413;7239;2060;6639;406;1350;1039;3317;1445;4667
317010;201710;23316;57457;14139;43250;3577;12092;2723;9064;6300;21156
317020;201710;60086;156537;35613;109466;7094;23853;7437;20914;14531;44767
317030;201710;659;1917;568;1781;37;152;394;1204;431;1356
317040;201710;9678;26718;7326;22575;1857;6015;2731;8461;4588;14476
317043;201710;750;1935;612;1738;133;410;315;878;448;1288
317047;201710;1136;2913;851;2463;61;189;580;1669;641;1858
317050;201710;1302;4247;954;3442;175;679;307;1028;482;1707
317052;201710;2178;6862;1966;6508;210;763;1378;4490;1588;5253
317057;201710;1601;4235;1206;3552;78;293;829;2358;907;2651
317060;201710;399;1104;233;748;47;181;67;185;114;366
317065;201710;1216;3567;1056;3276;49;223;832;2493;881;2716
317070;201710;7894;23916;5401;18449;1212;4659;752;2440;1964;7099
317075;201710;955;2827;718;2316;147;492;142;435;289;927
317080;201710;5831;15036;4751;13248;1600;4668;1266;3311;2866;7979
317090;201710;4487;14397;4146;13873;359;1262;3075;10334;3434;11596
317100;201710;2601;6680;1836;5432;630;1992;542;1579;1172;3571
317103;201710;1762;5976;1573;5621;186;886;955;3217;1141;4103
317107;201710;1341;3909;1130;3510;72;273;752;2179;824;2452
317110;201710;611;1486;351;1083;59;226;120;383;179;609
317115;201710;1111;3329;933;2951;76;238;659;2085;735;2323
317120;201710;10819;33423;8638;29179;1573;5952;4030;13092;5603;19044
317130;201710;7360;20223;5577;17106;1249;4214;1881;5675;3130;9889
317140;201710;561;1742;495;1622;69;226;290;947;359;1173
317150;201710;942;2498;791;2318;50;156;629;1826;679;1982
317160;201710;3416;8720;2505;7432;248;766;1637;4872;1885;5638
317170;201710;1920;5027;1393;4137;222;755;488;1271;710;2026
317180;201710;1581;5270;1275;4573;307;1173;307;1076;614;2249
317190;201710;1302;3680;1008;3223;66;237;657;2073;723;2310
317200;201710;4249;12544;3363;10776;833;2923;872;2623;1705;5546
317210;201710;892;2535;758;2348;65;273;545;1663;610;1936
317220;201710;263;885;240;837;58;227;105;361;163;588
320010;201710;4591;14129;3876;12743;545;1927;2264;7286;2809;9213
320013;201710;1794;5422;1244;4176;217;733;515;1782;732;2515
320016;201710;2874;7841;2432;7220;149;437;1924;5700;2073;6137
320020;201710;3479;10523;2831;9277;781;2677;858;2899;1639;5576
320030;201710;1458;4525;1038;3607;306;1122;293;955;599;2077
320035;201710;1656;4839;1418;4444;472;1632;569;1691;1041;3323
320040;201710;3032;9498;2538;8560;504;1827;1110;3728;1614;5555
320050;201710;1607;4180;1413;3849;338;957;696;1872;1034;2829
320060;201710;9417;28820;7013;23695;1660;6079;1665;5447;3325;11526
320070;201710;1347;4128;1052;3507;235;849;313;1007;548;1856
320080;201710;5295;14796;3965;12217;840;2677;1427;4453;2267;7130
320090;201710;6921;19675;5331;16571;1369;4414;2033;6232;3402;10646
320100;201710;2316;7210;1883;6344;569;1935;598;2059;1167;3994
320110;201710;1167;3313;970;2961;247;775;274;850;521;1625
320115;201710;1766;6106;1564;5731;763;2858;432;1637;1195;4495
320120;201710;13606;39207;10422;33299;2417;8418;3027;9448;5444;17866
320130;201710;31428;97572;28022;91251;5087;18533;14531;46051;19618;64584
320140;201710;3039;9401;2208;7579;540;2037;525;1802;1065;3839
320150;201710;12403;34804;9344;28793;2937;9687;1099;3074;4036;12761
320160;201710;4791;14589;3937;12895;860;3074;1716;5478;2576;8552
320170;201710;1597;4902;1235;4147;274;967;525;1727;799;2694
320180;201710;697;2346;578;2099;203;756;137;520;340;1276
320190;201710;3124;10534;2434;8895;634;2428;425;1507;1059;3935
320200;201710;936;2790;727;2410;234;864;171;584;405;1448
320210;201710;4436;12121;3605;10583;633;2064;1793;5013;2426;7077
320220;201710;2468;7096;1967;6250;364;1266;1039;3308;1403;4574
320225;201710;1201;4009;891;3234;331;1241;125;465;456;1706
320230;201710;4042;12542;3300;11225;911;3360;1261;4318;2172;7678
320240;201710;12522;35226;10003;31019;2301;7651;3800;11836;6101;19487
320245;201710;2822;9330;2536;8677;971;3440;614;2089;1585;5529
320250;201710;1766;5263;1254;4109;328;1209;231;687;559;1896
320255;201710;1602;5458;1420;5137;553;2069;554;2090;1107;4159
320260;201710;955;2866;714;2317;227;813;190;523;417;1336
320265;201710;2355;7501;2021;6867;849;2995;595;2003;1444;4998
320270;201710;2471;7143;1834;5958;343;1179;892;2964;1235;4143
320280;201710;5335;16212;4563;14714;1243;4325;1204;3730;2447;8055
320290;201710;1326;4179;929;3214;276;1053;160;520;436;1573
320300;201710;3810;12540;3251;11289;1080;3959;658;2284;1738;6243
320305;201710;4380;13478;3629;11851;903;3112;1332;4281;2235;7393
320310;201710;1775;5255;1420;4539;333;1111;556;1762;889;2873
320313;201710;1961;5403;1340;4151;317;1112;266;775;583;1887
320316;201710;1503;4465;1191;3828;333;1119;432;1388;765;2507
320320;201710;17874;52077;13683;44451;3705;12933;4515;14434;8220;27367
320330;201710;2741;8018;2226;7090;659;2074;893;3029;1552;5103
320332;201710;5082;15756;4350;14420;1105;3905;2035;6636;3140;10541
320334;201710;1913;5927;1343;4678;322;1272;312;1017;634;2289
320335;201710;1936;5746;1252;4135;349;1255;208;635;557;1890
320340;201710;4826;12942;4176;11932;849;2560;2078;6091;2927;8651
320350;201710;4778;12486;3523;10216;611;1849;1588;4548;2199;6397
320360;201710;1508;3992;1131;3282;197;559;473;1359;670;1918
320370;201710;2506;8214;2001;7049;572;2072;625;2191;1197;4263
320380;201710;2042;5982;1779;5511;415;1361;860;2608;1275;3969
320390;201710;6658;19368;5253;16405;1362;4501;1735;5248;3097;9749
320400;201710;3242;9781;2784;8925;646;2191;1227;3917;1873;6108
320405;201710;4119;11837;3547;10790;583;1913;2035;6071;2618;7984
320410;201710;4806;13210;3654;11487;748;2487;1636;5299;2384;7786
320420;201710;2387;7004;1930;6201;576;2033;452;1437;1028;3470
320425;201710;1925;4884;1502;4177;145;459;934;2509;1079;2968
320430;201710;2524;6884;2082;5991;378;1145;1157;3171;1535;4316
320435;201710;2465;7930;1981;6942;787;2879;503;1846;1290;4725
320440;201710;971;3046;819;2697;172;638;345;1092;517;1730
320450;201710;1669;5117;1349;4491;345;1251;586;1878;931;3129
320455;201710;3635;11754;2691;9549;764;2878;678;2353;1442;5231
320460;201710;2270;7159;1633;5685;403;1487;310;998;713;2485
320465;201710;1318;3948;1000;3283;133;480;519;1716;652;2196
320470;201710;3808;11077;2708;8724;741;2570;573;1778;1314;4348
320480;201710;1626;4955;1395;4484;302;1068;643;2018;945;3086
320490;201710;14017;41770;11902;38001;2811;9815;4607;14720;7418;24535
320495;201710;1312;3775;857;2833;226;781;179;625;405;1406
320500;201710;42821;124077;36616;113334;7280;24267;18548;56069;25828;80336
320501;201710;4348;13214;3297;11384;988;3839;892;2940;1880;6779
320503;201710;1956;6437;1536;5518;533;2117;434;1421;967;3538
320506;201710;3260;9883;2278;7626;671;2408;92;247;763;2655
320510;201710;8077;24044;6936;22087;1297;4563;3573;11159;4870;15722
320515;201710;1734;4963;1392;4234;420;1335;345;1048;765;2383
320517;201710;1966;6282;1560;5442;568;2135;306;1018;874;3153
320520;201710;30404;89107;24840;79513;5573;19553;9485;30162;15058;49715
320530;201710;24548;71430;20162;63536;3169;11768;10956;32509;14125;44277
330010;201710;18795;56188;16463;52014;3478;11533;8721;27647;12199;39180
330015;201710;1354;3709;1156;3347;194;650;550;1521;744;2171
330020;201710;17507;48733;15846;46080;2632;8529;10236;28972;12868;37501
330022;201710;1801;5140;1465;4605;296;999;841;2620;1137;3619
330023;201710;2994;8915;2504;8111;663;2317;842;2632;1505;4949
330025;201710;4463;11938;3290;9821;1039;3348;1020;3023;2059;6371
330030;201710;8239;25899;7010;23610;1235;4644;3632;11679;4867;16323
330040;201710;10921;31969;9741;29797;1698;5677;5712;16884;7410;22561
330045;201710;74215;193769;64070;179639;7818;22324;45287;125904;53105;148228
330050;201710;2204;6413;1822;5747;473;1580;748;2238;1221;3818
330060;201710;5052;14266;4314;13110;1028;3425;1876;5473;2904;8898
330070;201710;18346;53683;16248;50238;3342;10947;8088;25148;11430;36095
330080;201710;7819;21675;7152;20633;589;1777;5137;14661;5726;16438
330090;201710;2406;6221;2085;5741;306;923;1226;3289;1532;4212
330093;201710;1806;5161;1478;4648;209;679;904;2952;1113;3631
330095;201710;982;3204;836;2886;128;490;372;1208;500;1698
330100;201710;59378;173606;51742;161914;5800;20976;33896;104815;39696;125791
330110;201710;2066;6442;1839;6050;389;1356;721;2330;1110;3686
330115;201710;1641;4684;1425;4354;288;994;784;2322;1072;3316
330120;201710;2721;6984;2300;6416;271;896;1594;4331;1865;5227
330130;201710;3205;9957;2841;9356;607;2118;1474;4845;2081;6963
330140;201710;2927;8755;2619;8298;516;1861;1509;4659;2025;6520
330150;201710;1868;5481;1532;4875;373;1247;495;1562;868;2809
330160;201710;1052;3213;916;2989;216;788;456;1429;672;2217
330170;201710;86291;253142;78107;240236;14501;46780;45017;137693;59518;184473
330180;201710;1953;5546;1654;5019;79;325;1191;3516;1270;3841
330185;201710;8149;23745;6972;21654;1056;3624;4266;12902;5322;16526
330187;201710;3517;9854;2993;9028;506;1696;1822;5395;2328;7091
330190;201710;24280;66293;22385;63488;2910;8498;16669;47211;19579;55709
330200;201710;12607;37962;11128;35671;2619;8482;5930;19486;8549;27968
330205;201710;1859;5072;1617;4675;131;437;1118;3153;1249;3590
330210;201710;3049;8332;2364;7002;542;1681;866;2454;1408;4135
330220;201710;9017;26500;7573;23585;1865;6271;2074;5974;3939;12245
330225;201710;3337;10025;2839;9143;306;1256;1820;5600;2126;6856
330227;201710;15073;42241;13515;40020;2012;6201;9200;27417;11212;33618
330230;201710;1179;3353;1031;3131;114;406;672;1983;786;2389
330240;201710;16405;48113;13858;43656;3715;12600;5529;16908;9244;29508
330245;201710;1249;3596;900;2974;212;749;208;677;420;1426
330250;201710;31705;91164;28271;85683;7342;22463;12351;38647;19693;61110
330260;201710;4137;12204;3434;10922;626;2148;1621;4947;2247;7095
330270;201710;20634;44859;13472;35047;2851;8192;5204;13528;8055;21720
330280;201710;2130;6142;1747;5433;280;969;882;2612;1162;3581
330285;201710;16503;45614;14422;42534;2141;6910;9186;26569;11327;33479
330290;201710;3089;8813;2692;8150;436;1437;1481;4297;1917;5734
330300;201710;3027;9629;2689;8983;468;1738;1506;4853;1974;6591
330310;201710;2151;5924;1740;5204;169;496;1108;3306;1277;3802
330320;201710;11835;34159;10897;32725;1363;4382;8047;23967;9410;28349
330330;201710;26058;68867;22534;63481;3517;10962;14232;38973;17749;49935
330340;201710;12704;36111;10100;31536;2344;7895;3814;11472;6158;19367
330350;201710;82620;230157;72984;216597;9058;28965;51034;150644;60092;179609
330360;201710;5979;16961;5634;16475;549;1710;4409;12797;4958;14507
330370;201710;3344;11585;2977;10811;940;3514;1019;3733;1959;7247
330380;201710;4559;14327;3782;12785;932;3385;1258;4139;2190;7524
330385;201710;3666;12209;3285;11515;951;3520;1319;4695;2270;8215
330390;201710;20345;64578;17278;58376;4033;14604;7302;24077;11335;38681
330395;201710;2902;8240;2643;7828;200;718;1820;5289;2020;6007
330400;201710;2591;7788;2335;7312;230;897;1594;4675;1824;5572
330410;201710;2603;7795;2029;6708;399;1454;907;2861;1306;4315
330411;201710;2148;6447;1880;5912;196;718;1265;3811;1461;4529
330412;201710;1338;4390;1126;3959;192;732;554;1836;746;2568
330414;201710;21903;59767;18727;55311;3069;8864;11732;35020;14801;43884
330415;201710;3254;9671;2615;8536;525;1692;1142;3879;1667;5571
330420;201710;9100;24734;6103;19501;1163;3985;1711;5241;2874;9226
330430;201710;6710;19239;5923;17826;1140;3817;3090;8946;4230;12763
330440;201710;1473;4727;1293;4405;359;1379;474;1488;833;2867
330450;201710;1282;4093;1093;3744;205;794;538;1798;743;2592
330452;201710;12583;35996;10213;31667;2278;7608;4746;14339;7024;21947
330455;201710;493957;1293026;391008;1130966;73641;227873;212230;603795;285871;831668
330460;201710;1112;3467;930;3155;207;754;419;1380;626;2134
330470;201710;3762;10944;3332;10248;842;2807;1509;4507;2351;7314
330475;201710;7732;22704;6622;20999;1883;6541;2820;8666;4703;15207
330480;201710;5466;15536;4823;14545;712;2355;3026;8907;3738;11262
330490;201710;104199;263595;90625;243811;10465;30184;62081;164436;72546;194620
330500;201710;4750;14075;4469;13627;502;1649;3316;10065;3818;11714
330510;201710;33298;98971;29129;92303;9194;29138;12194;39670;21388;68808
330513;201710;1164;3456;1054;3263;334;1075;443;1371;777;2446
330515;201710;2705;8108;2325;7379;796;2618;697;2204;1493;4822
330520;201710;10075;29928;8888;27803;1755;5930;4223;12859;5978;18789
330530;201710;1453;4038;1201;3592;272;891;539;1542;811;2433
330540;201710;2652;7705;2176;6820;609;1982;764;2348;1373;4330
330550;201710;7127;23213;6299;21646;2557;9178;1324;4659;3881;13837
330555;201710;9263;26453;8269;24998;1518;4779;5066;15509;6584;20288
330560;201710;3996;11788;3489;10845;495;1678;2034;6143;2529;7821
330570;201710;2915;8550;2448;7740;554;1831;1261;3952;1815;5783
330575;201710;5061;14016;4508;12997;515;1714;3196;8871;3711;10585
330580;201710;11627;35567;9581;31540;2625;9103;3642;11854;6267;20957
330590;201710;1471;4353;1362;4196;157;502;1000;3104;1157;3606
330600;201710;10656;30980;8596;27230;1469;4963;4147;13106;5616;18069
330610;201710;8165;24834;7286;23358;1048;3820;4383;13683;5431;17503
330615;201710;1526;5190;1396;4999;515;1949;569;2051;1084;4000
330620;201710;3315;11160;2884;10291;1090;4128;617;2125;1707;6253
330630;201710;21960;61607;17786;54311;2334;8297;10807;31701;13141;39998
350010;201710;1741;4959;1008;3367;256;871;78;223;334;1094
350020;201710;541;1464;316;1006;34;115;148;426;182;541
350030;201710;4097;12419;3103;10403;835;3013;801;2621;1636;5634
350040;201710;469;1546;332;1213;66;269;101;336;167;605
350050;201710;835;2434;641;2057;147;530;186;500;333;1030
350055;201710;631;1797;544;1656;60;202;387;1166;447;1368
350060;201710;100;304;83;277;16;60;37;128;53;188
350070;201710;3742;10638;2356;7785;454;1584;668;2010;1122;3594
350075;201710;575;1859;442;1579;181;662;63;215;244;877
350080;201710;633;1807;393;1282;55;192;167;533;222;725
350090;201710;554;1413;333;975;75;220;103;292;178;512
350100;201710;1883;5508;1293;4367;215;844;511;1602;726;2446
350110;201710;410;1226;307;1002;26;103;183;574;209;677
350115;201710;1212;3606;1027;3219;203;684;503;1452;706;2136
350120;201710;795;2189;485;1544;64;202;253;844;317;1046
350130;201710;2983;8582;2530;7720;288;974;1460;4216;1748;5190
350140;201710;548;1805;447;1596;39;175;260;893;299;1068
350150;201710;457;1468;398;1349;141;499;103;334;244;833
350160;201710;9094;24265;5823;18250;949;3393;2827;8217;3776;11610
350170;201710;1402;4561;1139;3952;272;1008;291;962;563;1970
350180;201710;1051;2789;625;1914;114;390;287;851;401;1241
350190;201710;2888;8692;2204;7252;483;1806;877;2459;1360;4265
350200;201710;344;1024;308;962;24;75;223;681;247;756
350210;201710;4832;12407;3334;9845;740;2248;1518;4425;2258;6673
350220;201710;2186;6695;1796;5833;367;1359;777;2333;1144;3692
350230;201710;780;2379;685;2207;162;545;305;986;467;1531
350240;201710;570;1741;427;1405;67;238;169;536;236;774
350250;201710;1997;6801;1714;6274;622;2460;432;1614;1054;4074
350260;201710;819;2163;548;1648;95;289;261;774;356;1063
350270;201710;4526;13363;3757;11766;681;2351;1753;5137;2434;7488
350275;201710;1829;5708;1603;5312;387;1364;652;2115;1039;3479
350280;201710;19812;46941;12336;34535;2445;7337;3695;10013;6140;17350
350290;201710;2500;7564;1891;6322;379;1410;661;2106;1040;3516
350300;201710;588;1711;415;1321;90;276;124;369;214;645
350310;201710;812;2645;684;2330;93;362;272;870;365;1232
350315;201710;510;1523;364;1222;62;233;120;365;182;598
350320;201710;10306;30604;8723;27753;2485;8419;1798;5850;4283;14269
350330;201710;13456;35606;9291;26716;1503;4368;4516;12326;6019;16694
350335;201710;372;1103;323;1015;18;47;251;803;269;850
350340;201710;976;2745;653;2109;135;472;211;673;346;1145
350350;201710;680;2012;566;1856;123;423;219;695;342;1118
350360;201710;859;2852;731;2549;205;699;288;1009;493;1708
350370;201710;535;1527;372;1157;115;360;54;154;169;514
350380;201710;4251;12188;3002;9752;703;2454;963;2993;1666;5447
350390;201710;9018;26685;7615;24025;2185;7077;2741;8474;4926;15551
350395;201710;390;1044;194;643;27;98;61;175;88;273
350400;201710;7361;20262;5552;17027;1451;4831;1697;4952;3148;9783
350410;201710;8035;25414;6311;21855;1636;6206;1587;5108;3223;11314
350420;201710;541;1668;406;1419;86;349;59;201;145;550
350430;201710;642;1959;541;1782;81;329;315;974;396;1303
350440;201710;1276;3856;1032;3309;233;762;432;1348;665;2110
350450;201710;6659;20250;5326;17625;1251;4431;1576;4969;2827;9400
350460;201710;1442;3794;823;2574;164;572;252;742;416;1314
350470;201710;218;560;178;488;13;49;125;321;138;370
350480;201710;729;2089;505;1633;91;330;86;243;177;573
350490;201710;1650;4913;1350;4351;309;1073;429;1259;738;2332
350500;201710;561;1646;484;1512;72;261;273;828;345;1089
350510;201710;1025;2980;763;2439;109;404;377;1150;486;1554
350520;201710;1663;5812;1305;4981;275;1145;421;1548;696;2693
350530;201710;2144;6086;1677;5130;485;1550;481;1387;966;2937
350535;201710;1284;3894;1169;3723;133;512;822;2539;955;3051
350540;201710;1618;4462;1194;3714;270;925;484;1506;754;2431
350550;201710;8866;22726;6008;18004;889;3033;2667;7466;3556;10499
350560;201710;3258;10393;2746;9199;318;1135;1563;5163;1881;6298
350570;201710;17490;54360;15195;49854;4061;14430;6186;19327;10247;33757
350580;201710;1662;5118;1002;3454;199;730;111;311;310;1041
350590;201710;3850;11395;2936;9528;701;2605;1223;3574;1924;6179
350600;201710;37755;93613;24710;69779;3770;11715;11100;28916;14870;40631
350610;201710;6227;18186;4787;15400;979;3324;2026;6394;3005;9718
350620;201710;372;1020;269;863;32;132;130;398;162;530
350630;201710;1470;4157;1090;3410;137;507;534;1533;671;2040
350635;201710;6329;17968;5027;15697;1087;3725;2293;6874;3380;10599
350640;201710;772;2322;482;1589;80;292;135;395;215;687
350650;201710;7204;20802;4706;15269;1022;3614;1239;3792;2261;7406
350660;201710;4669;13222;3699;11481;714;2382;1752;5377;2466;7759
350670;201710;1375;4262;1254;4029;285;921;633;2034;918;2955
350680;201710;993;2865;690;2280;148;516;289;972;437;1488
350690;201710;932;2872;707;2404;139;505;278;889;417;1394
350700;201710;3931;11243;2811;9353;618;2305;1167;3638;1785;5943
350710;201710;2539;7682;2196;7017;309;1101;1262;3896;1571;4997
350715;201710;762;2274;674;2087;84;302;377;1086;461;1388
350720;201710;137;384;119;353;23;76;45;131;68;207
350730;201710;390;1361;342;1240;66;262;159;570;225;832
350740;201710;1508;4520;1033;3429;197;696;258;775;455;1471
350745;201710;531;1612;321;1078;47;171;133;400;180;571
350750;201710;8480;25110;6887;22053;1489;5347;2236;6464;3725;11811
350760;201710;11718;33020;9197;28614;2543;8567;2194;6091;4737;14658
350770;201710;628;1754;437;1360;68;221;221;684;289;905
350775;201710;554;1445;428;1233;48;155;207;587;255;742
350780;201710;1765;5150;1367;4419;371;1357;314;1078;685;2435
350790;201710;1722;5119;1200;4056;271;996;204;586;475;1582
350800;201710;2925;9455;2678;8947;493;1800;1359;4384;1852;6184
350810;201710;1869;5126;1602;4757;341;1052;860;2653;1201;3705
350820;201710;694;1796;414;1254;64;198;148;418;212;616
350830;201710;751;2328;473;1664;67;238;126;403;193;641
350840;201710;2386;7901;1876;6845;595;2348;514;1772;1109;4120
350850;201710;5400;17253;4408;15142;1336;4782;1169;4051;2505;8833
350860;201710;3022;8997;2814;8653;108;466;2203;6662;2311;7128
350870;201710;2567;7920;2044;7001;441;1676;1022;3454;1463;5130
350880;201710;1221;3954;974;3349;222;789;253;850;475;1639
350890;201710;633;1746;393;1228;43;142;115;298;158;440
350900;201710;5413;16282;3822;12880;1238;4559;381;1232;1619;5791
350910;201710;780;2188;676;1981;144;493;387;1083;531;1576
350920;201710;11017;29850;9632;27533;674;2232;7324;20108;7998;22340
350925;201710;4342;13033;3311;11021;810;2805;1076;3178;1886;5983
350930;201710;1318;3649;930;2846;143;447;452;1337;595;1784
350940;201710;1784;5567;1544;5106;241;890;886;2834;1127;3724
350945;201710;880;2674;702;2336;118;432;328;1030;446;1462
350950;201710;70589;204217;57407;175824;10053;33782;30105;87192;40158;120974
350960;201710;4457;13981;3707;12483;753;2889;1869;5981;2622;8870
350970;201710;3503;11743;2897;10264;940;3614;440;1371;1380;4985
350980;201710;572;1821;495;1643;197;679;155;510;352;1189
350990;201710;1697;5386;1337;4712;354;1380;413;1350;767;2730
350995;201710;770;2547;716;2431;75;313;438;1412;513;1725
351000;201710;2479;7055;1929;6015;385;1331;675;1970;1060;3301
351010;201710;279;782;164;525;22;72;74;235;96;307
351015;201710;641;2151;545;1971;113;454;234;818;347;1272
351020;201710;8017;23744;6642;21561;1491;5074;3589;11576;5080;16650
351030;201710;2204;7152;1843;6278;352;1372;854;2712;1206;4084
351040;201710;3830;10838;3375;10074;291;1030;2515;7250;2806;8280
351050;201710;15053;39994;10450;32297;2435;8197;3540;10823;5975;19020
351060;201710;37913;103746;30318;90784;4805;15734;17698;51487;22503;67221
351070;201710;1284;3508;813;2638;240;861;81;224;321;1085
351080;201710;2428;6969;1871;6229;451;1655;836;2613;1287;4268
351090;201710;347;1104;248;911;46;186;48;177;94;363
351100;201710;2458;7161;1625;5209;440;1466;290;982;730;2448
351110;201710;6112;15818;3729;11717;817;2840;1070;3105;1887;5945
351120;201710;639;1825;458;1460;74;246;183;525;257;771
351130;201710;915;2523;442;1535;75;253;82;277;157;530
351140;201710;1586;5164;1239;4415;374;1456;275;860;649;2316
351150;201710;1362;4449;901;3305;197;774;64;199;261;973
351160;201710;1090;3700;933;3341;229;881;316;989;545;1870
351170;201710;1313;4062;1118;3623;130;457;628;1933;758;2390
351190;201710;777;2405;602;1964;96;310;198;615;294;925
351200;201710;1586;4282;1249;3716;92;318;718;2042;810;2360
351210;201710;1284;3372;812;2435;104;374;377;1014;481;1388
351220;201710;2773;8815;2486;8250;328;1221;1506;4840;1834;6061
351230;201710;1695;5042;1320;4363;292;1084;597;1816;889;2900
351240;201710;1384;3963;977;3088;216;708;411;1229;627;1937
351250;201710;1003;2868;584;1888;91;314;195;615;286;929
351260;201710;873;2531;722;2222;260;784;147;444;407;1228
351270;201710;290;930;251;843;59;230;113;323;172;553
351280;201710;4680;13063;3560;10905;675;2285;1416;4134;2091;6419
351290;201710;901;2513;619;1964;135;439;253;774;388;1213
351300;201710;12551;38322;9354;31784;2243;8215;2936;10050;5179;18265
351310;201710;2689;7852;2133;6844;330;1234;1116;3341;1446;4575
351320;201710;864;2766;690;2336;129;471;239;757;368;1228
351330;201710;723;2654;669;2563;65;179;521;2117;586;2296
351340;201710;5591;17956;4687;16209;1294;4650;1758;6059;3052;10709
351350;201710;7940;23054;6770;20942;1279;4084;3826;11487;5105;15571
351360;201710;3716;11171;3341;10456;849;2885;1057;3063;1906;5948
351370;201710;2122;6433;1576;5220;351;1232;588;1789;939;3021
351380;201710;36665;100702;30837;90029;5913;18274;15001;42637;20914;60911
351385;201710;255;709;166;521;26;80;49;147;75;227
351390;201710;1113;3326;871;2859;213;842;408;1199;621;2041
351400;201710;902;2794;789;2583;205;713;335;1075;540;1788
351410;201710;2237;6703;1836;5921;288;944;971;3076;1259;4020
351420;201710;265;733;172;541;43;124;51;156;94;280
351430;201710;727;2225;667;2112;83;294;481;1492;564;1786
351440;201710;3005;8666;2138;6800;411;1412;376;1035;787;2447
351450;201710;1412;3932;1079;3322;250;810;296;948;546;1758
351460;201710;641;1844;552;1672;226;666;199;620;425;1286
351470;201710;982;2799;827;2500;96;354;469;1321;565;1675
351480;201710;2516;7983;2203;7451;315;1299;1192;3867;1507;5166
351490;201710;1690;5375;1484;4939;127;530;984;3108;1111;3638
351492;201710;306;952;261;831;19;72;137;396;156;468
351495;201710;184;588;140;468;22;82;61;194;83;276
351500;201710;30485;81753;22791;68205;5362;16958;9883;28516;15245;45474
351510;201710;9588;27389;7594;23510;1473;4955;3966;11901;5439;16856
351512;201710;468;1333;339;1049;53;166;145;419;198;585
351515;201710;2517;6754;1654;5117;354;1262;384;1158;738;2420
351518;201710;2073;5901;1401;4664;264;1012;634;1916;898;2928
351519;201710;623;1819;428;1387;80;303;85;191;165;494
351520;201710;866;2366;372;1254;54;210;121;355;175;565
351530;201710;327;976;191;620;27;82;59;155;86;237
351535;201710;2110;5381;1619;4585;142;496;1036;2778;1178;3274
351540;201710;1750;4896;1238;3916;438;1491;211;583;649;2074
351550;201710;5156;14770;3570;11216;602;2100;1530;4441;2132;6541
351560;201710;419;1328;355;1179;83;314;81;265;164;579
351565;201710;155;528;136;481;31;110;55;186;86;296
351570;201710;14083;40312;11430;35071;1878;6283;6774;19967;8652;26250
351580;201710;281;778;171;555;32;95;52;186;84;281
351590;201710;484;1183;267;750;32;107;136;356;168;463
351600;201710;1644;4457;1265;3752;173;577;696;1933;869;2510
351610;201710;623;1631;436;1301;43;159;233;608;276;767
351620;201710;18012;54458;13848;46418;2679;10160;4610;13796;7289;23956
351630;201710;22955;66836;19756;61425;3709;12104;11694;35575;15403;47679
351640;201710;13544;38749;11095;34518;1684;5856;6817;20529;8501;26385
351650;201710;384;1116;180;617;34;130;26;75;60;205
351660;201710;741;2324;497;1697;103;397;90;271;193;668
351670;201710;4092;12464;3208;10360;599;2082;1514;4584;2113;6666
351680;201710;451;1401;272;897;57;174;51;177;108;351
351685;201710;433;1356;362;1212;89;285;136;459;225;744
351690;201710;961;2743;660;2104;123;421;235;668;358;1089
351700;201710;914;2644;775;2373;169;500;312;955;481;1455
351710;201710;545;1764;444;1530;58;242;185;588;243;830
351720;201710;1300;3747;927;2980;172;587;342;1076;514;1663
351730;201710;960;2643;719;2237;103;383;357;1038;460;1421
351740;201710;3790;10091;2965;8494;546;1654;1231;3270;1777;4924
351750;201710;1192;3680;740;2653;130;506;255;918;385;1424
351760;201710;3062;9366;2339;7767;583;2111;641;1909;1224;4020
351770;201710;1950;6076;1636;5427;508;1736;573;1866;1081;3602
351780;201710;1306;3574;704;2238;121;430;161;482;282;912
351790;201710;1097;2999;917;2705;138;374;584;1755;722;2129
351800;201710;562;1228;288;733;40;114;101;228;141;342
351810;201710;968;2748;803;2444;71;188;563;1687;634;1875
351820;201710;2364;7285;1663;5783;343;1282;227;795;570;2077
351830;201710;4180;12210;3225;10329;452;1685;1714;5276;2166;6961
351840;201710;6289;20666;5383;18790;1215;4668;2146;7074;3361;11742
351850;201710;1937;5149;1308;4036;218;801;476;1313;694;2114
351860;201710;2741;8630;2334;7788;510;1829;1093;3575;1603;5404
351870;201710;23726;67189;19201;59400;6179;19847;6933;21636;13112;41483
351880;201710;108565;321879;88645;283445;26594;91122;23767;71892;50361;163014
351885;201710;651;2157;585;2006;150;526;248;833;398;1359
351890;201710;566;1741;460;1533;105;363;72;196;177;559
351900;201710;1112;3323;889;2942;214;747;287;951;501;1698
351905;201710;413;1205;311;996;37;127;142;416;179;543
351907;201710;18837;53328;15566;47291;890;3340;11336;33521;12226;36861
351910;201710;1064;3100;823;2554;171;579;337;948;508;1527
351920;201710;880;2352;686;2029;86;296;345;984;431;1280
351925;201710;929;2741;744;2369;113;377;350;1047;463;1424
351930;201710;2632;8054;2511;7828;285;1179;2013;6016;2298;7195
351940;201710;957;2743;758;2397;89;323;419;1309;508;1632
351950;201710;1487;3894;1068;3130;87;287;600;1718;687;2005
351960;201710;4570;12666;3363;10453;775;2591;1367;4133;2142;6724
351970;201710;5288;18244;4698;17076;1066;4263;2084;7174;3150;11437
351980;201710;896;2556;667;2060;112;400;311;873;423;1273
351990;201710;1305;3463;971;2888;162;573;294;804;456;1377
352000;201710;2141;6812;1912;6324;248;941;1084;3401;1332;4342
352010;201710;1763;5507;1462;4890;353;1296;218;776;571;2072
352020;201710;1400;4234;1178;3802;249;879;513;1566;762;2445
352030;201710;4783;13695;3887;12355;758;2677;2105;6591;2863;9268
352040;201710;1890;5686;1345;4539;278;986;203;629;481;1615
352042;201710;3123;8280;1904;5818;374;1213;802;2424;1176;3637
352044;201710;1861;5475;1109;3907;191;735;241;787;432;1522
352050;201710;11227;32809;7563;24788;1822;6741;1315;3830;3137;10571
352060;201710;674;2024;526;1705;87;308;219;666;306;974
352070;201710;747;1715;558;1445;95;269;242;614;337;883
352080;201710;431;1214;262;831;45;160;77;217;122;377
352090;201710;1320;4379;1043;3696;184;715;299;940;483;1655
352100;201710;2929;8734;2366;7678;544;1924;1036;3213;1580;5137
352110;201710;519;1695;427;1495;103;369;149;485;252;854
352115;201710;463;1440;404;1328;76;254;207;689;283;943
352120;201710;815;2582;660;2260;88;363;337;1045;425;1408
352130;201710;1762;5265;1134;3671;251;863;312;964;563;1827
352140;201710;1516;4203;921;2978;147;512;354;1073;501;1585
352150;201710;725;2069;576;1796;151;468;273;858;424;1326
352160;201710;854;2354;645;1996;141;487;240;707;381;1194
352170;201710;2598;7709;2215;6851;453;1520;1070;3052;1523;4572
352180;201710;2867;8030;2367;7068;570;1814;892;2498;1462;4312
352190;201710;1059;3138;842;2716;142;535;287;796;429;1331
352200;201710;367;1210;270;1005;44;171;78;283;122;454
352210;201710;15312;40792;12752;36918;1792;5559;8493;24558;10285;30117
352215;201710;510;1475;460;1412;55;193;294;872;349;1065
352220;201710;12965;37413;9598;31111;2951;10159;2317;7467;5268;17626
352230;201710;11544;37617;9458;33468;2693;10445;2930;9667;5623;20112
352240;201710;11047;31043;8407;26251;2099;7415;2882;8146;4981;15561
352250;201710;19547;60119;16541;54566;4750;16363;6922;22597;11672;38960
352260;201710;5324;15275;3681;11908;621;2172;1818;5731;2439;7903
352265;201710;850;2593;735;2398;63;269;495;1545;558;1814
352270;201710;1470;4846;1175;4191;279;1043;332;1164;611;2207
352280;201710;2220;6321;1793;5615;226;882;914;2684;1140;3566
352290;201710;1031;3233;871;2859;162;629;392;1150;554;1779
352300;201710;959;2738;693;2179;108;408;318;881;426;1289
352310;201710;42814;120972;33180;104290;8889;28642;13825;43753;22714;72395
352320;201710;5347;15668;4376;13654;887;3035;1814;5054;2701;8089
352330;201710;1865;5752;1552;5291;438;1636;587;1900;1025;3536
352340;201710;4465;13418;3353;11347;901;3274;957;3030;1858;6304
352350;201710;1570;5023;1358;4542;249;941;525;1622;774;2563
352360;201710;980;2888;872;2712;168;619;570;1690;738;2309
352370;201710;861;2842;773;2627;64;273;509;1674;573;1947
352380;201710;821;2472;666;2199;179;654;169;529;348;1183
352390;201710;17076;43686;11340;33525;1845;6082;5652;15746;7497;21828
352400;201710;3212;9178;2506;7844;644;2277;1148;3269;1792;5546
352410;201710;2684;7745;2226;6996;385;1326;1134;3425;1519;4751
352420;201710;850;2211;631;1821;107;340;242;671;349;1011
352430;201710;6261;17664;4935;15481;1499;4953;1721;5405;3220;10358
352440;201710;15128;45242;12187;39398;2604;8964;5175;16266;7779;25230
352450;201710;579;1735;348;1206;79;304;90;300;169;604
352460;201710;2386;7297;1848;6249;440;1629;573;1841;1013;3470
352470;201710;3648;9797;2656;8046;318;1107;1360;3835;1678;4942
352480;201710;3666;9478;2620;7592;494;1619;1106;2920;1600;4539
352490;201710;649;2141;496;1773;95;365;165;595;260;960
352500;201710;8613;23533;6828;20493;3448;11195;1185;2659;4633;13854
352510;201710;2880;8575;2254;7424;623;2226;694;2223;1317;4449
352520;201710;1995;6489;1699;5855;430;1564;715;2378;1145;3942
352530;201710;7950;24291;5612;18857;1355;4911;826;2234;2181;7145
352540;201710;499;1542;359;1226;71;260;92;294;163;554
352550;201710;858;2674;609;2148;131;503;139;454;270;957
352560;201710;530;1569;367;1189;71;233;77;221;148;454
352570;201710;1785;5570;1204;4307;316;1242;191;573;507;1815
352580;201710;792;2374;611;1996;102;376;204;609;306;985
352585;201710;227;711;187;614;22;79;84;261;106;340
352590;201710;11983;35209;9225;29637;3120;10687;3253;9572;6373;20259
352600;201710;1792;5309;1381;4396;268;917;589;1772;857;2689
352610;201710;3164;9562;2488;8333;575;2139;795;2488;1370;4627
352620;201710;5032;14725;4336;13586;1188;3772;1819;5725;3007;9497
352630;201710;653;1845;544;1642;99;369;262;727;361;1096
352640;201710;2436;6894;1972;6137;164;556;1333;4128;1497;4684
352650;201710;632;1899;464;1477;78;268;136;414;214;682
352660;201710;918;3192;784;2897;163;647;285;1030;448;1677
352670;201710;9320;27188;5700;19288;1373;5128;411;1355;1784;6483
352680;201710;2908;9295;2174;7619;428;1703;874;2835;1302;4538
352690;201710;28595;76626;21077;62397;2284;7672;12250;34515;14534;42187
352700;201710;533;1480;412;1308;147;516;132;380;279;896
352710;201710;4844;13651;3533;11072;941;3248;1286;3780;2227;7028
352720;201710;7464;22940;6320;20509;2576;8520;1269;3895;3845;12415
352725;201710;400;1093;200;644;19;76;97;283;116;359
352730;201710;2272;7089;2033;6464;422;1492;1013;2913;1435;4405
352740;201710;2087;5373;1607;4630;205;671;918;2540;1123;3211
352750;201710;417;1137;223;736;42;153;52;146;94;299
352760;201710;1307;4156;1037;3499;198;738;430;1354;628;2092
352770;201710;754;2294;600;1951;136;482;193;592;329;1074
352780;201710;586;1941;463;1629;98;366;158;546;256;912
352790;201710;601;1672;419;1323;61;207;133;389;194;596
352800;201710;1081;3706;805;2970;189;735;189;625;378;1360
352810;201710;997;2536;622;1809;122;354;232;668;354;1022
352820;201710;561;1470;376;1166;80;259;90;281;170;540
352830;201710;528;1469;271;868;40;137;42;111;82;248
352840;201710;3648;11776;3220;10913;976;3462;1262;4103;2238;7565
352850;201710;9919;26958;7069;22362;1898;6424;2173;6737;4071;13161
352860;201710;797;2611;704;2397;152;549;276;916;428;1465
352870;201710;798;2055;519;1441;44;146;282;711;326;857
352880;201710;1879;4888;1323;3823;212;645;579;1491;791;2136
352885;201710;260;799;211;703;30;96;127;417;157;513
352890;201710;610;1543;398;1087;66;209;158;354;224;563
352900;201710;17308;48882;12502;39288;2440;8467;4931;14517;7371;22984
352910;201710;384;1073;206;675;19;75;42;112;61;187
352920;201710;2355;6686;1739;5462;262;910;864;2534;1126;3444
352930;201710;5217;15674;4121;13385;798;2749;1604;4976;2402;7725
352940;201710;20716;63572;16930;55442;5532;19869;2382;7035;7914;26904
352950;201710;419;1147;224;751;48;167;23;66;71;233
352960;201710;606;1764;354;1178;60;227;130;403;190;630
352965;201710;309;901;186;617;48;164;32;93;80;257
352970;201710;2954;7318;2360;6415;249;688;1591;4348;1840;5036
352980;201710;1186;3613;981;3260;202;700;483;1610;685;2310
352990;201710;3799;11642;3300;10773;777;2884;1547;4733;2324;7617
353000;201710;441;1221;218;705;39;133;55;165;94;298
353010;201710;2555;6925;1803;5414;415;1367;556;1549;971;2916
353020;201710;3747;10067;2148;6606;334;1106;725;2020;1059;3126
353030;201710;3439;9804;2604;8187;715;2362;505;1584;1220;3946
353040;201710;447;1216;354;1032;77;241;121;315;198;556
353050;201710;4693;14918;3688;12820;930;3474;1374;4549;2304;8023
353060;201710;41818;117550;35700;107457;3489;12481;24942;72192;28431;84673
353070;201710;9104;27437;6581;22078;1501;5379;1929;6389;3430;11768
353080;201710;4362;13175;3096;10565;764;2852;878;2739;1642;5591
353090;201710;512;1700;457;1580;41;163;277;904;318;1067
353100;201710;278;762;113;378;10;33;21;63;31;96
353110;201710;6886;20893;5981;19403;980;3511;3743;12149;4723;15660
353120;201710;510;1468;343;1098;66;235;106;297;172;532
353130;201710;2267;6236;1614;5192;486;1668;491;1560;977;3228
353140;201710;2039;5537;1614;4734;226;731;876;2435;1102;3166
353150;201710;1417;4067;1084;3475;292;943;334;1043;626;1986
353160;201710;621;1683;412;1297;72;248;151;426;223;674
353170;201710;460;1397;393;1308;78;336;192;583;270;919
353180;201710;8563;23172;6904;20450;1037;3347;4352;12730;5389;16077
353190;201710;3304;9623;2661;8243;367;1233;1466;4237;1833;5470
353200;201710;1025;3332;716;2477;165;615;183;602;348;1217
353205;201710;321;1086;289;999;77;304;140;467;217;771
353210;201710;947;2368;614;1758;37;133;374;1029;411;1162
353215;201710;420;1254;346;1094;55;200;135;356;190;556
353220;201710;547;1625;420;1373;110;364;94;302;204;666
353230;201710;740;2262;648;2118;157;557;233;683;390;1240
353240;201710;2013;6111;1706;5516;230;875;1042;3243;1272;4118
353250;201710;999;2601;720;2068;118;352;314;881;432;1233
353260;201710;831;2279;535;1697;120;410;146;429;266;839
353270;201710;588;1708;491;1504;70;212;233;686;303;898
353280;201710;610;1849;442;1447;78;276;127;399;205;675
353282;201710;1732;5304;1565;4963;220;754;900;2759;1120;3513
353284;201710;366;951;202;607;36;125;65;164;101;289
353286;201710;125;373;90;302;24;80;22;59;46;139
353290;201710;1041;3009;779;2489;84;340;451;1312;535;1652
353300;201710;1440;4270;1132;3612;193;706;446;1279;639;1985
353310;201710;263;735;192;600;33;117;90;267;123;384
353320;201710;553;1559;457;1369;43;135;291;855;334;990
353325;201710;591;1850;419;1452;73;260;123;425;196;685
353330;201710;503;1380;345;1044;43;147;190;542;233;689
353340;201710;2779;7814;1869;6105;529;1830;550;1818;1079;3648
353350;201710;3055;9009;2154;6977;554;1905;395;1146;949;3051
353360;201710;444;1439;388;1321;51;196;234;782;285;978
353370;201710;560;1839;486;1681;49;188;287;957;336;1145
353380;201710;279;917;229;801;42;159;81;273;123;432
353390;201710;5365;14424;3937;11808;782;2466;1503;4287;2285;6753
353400;201710;422;1280;336;1096;68;244;70;179;138;423
353410;201710;551;1598;458;1410;85;295;229;679;314;974
353420;201710;497;1366;292;897;71;217;35;93;106;310
353430;201710;1991;6321;1494;5191;414;1560;348;1135;762;2695
353440;201710;53155;160415;39929;132370;9747;33533;16041;51700;25788;85233
353450;201710;382;1057;261;803;41;148;105;295;146;443
353460;201710;3212;9145;2390;7446;272;970;1067;3327;1339;4297
353470;201710;6449;18811;4817;15573;1063;3727;1442;4374;2505;8101
353475;201710;1343;3753;1001;3005;143;473;387;1047;530;1520
353480;201710;1313;3951;1180;3687;103;342;841;2572;944;2914
353490;201710;901;2590;655;2051;136;430;259;775;395;1205
353500;201710;908;2351;743;2084;190;527;397;1130;587;1657
353510;201710;821;2597;602;2029;162;565;88;256;250;821
353520;201710;1086;2998;771;2425;97;336;354;1064;451;1400
353530;201710;2232;6321;1841;5552;244;835;994;2829;1238;3664
353540;201710;1874;5619;1586;5098;338;1151;772;2423;1110;3574
353550;201710;5585;15779;4507;13847;800;2691;2282;6630;3082;9321
353560;201710;1973;6291;1599;5617;542;2040;369;1248;911;3288
353570;201710;481;1409;345;1132;79;250;154;501;233;751
353580;201710;2089;5890;1752;5278;391;1242;886;2596;1277;3838
353590;201710;647;1885;426;1375;87;296;148;486;235;782
353600;201710;1633;4455;1382;3963;166;524;744;2035;910;2559
353610;201710;565;1917;433;1612;93;368;91;309;184;677
353620;201710;2289;6963;1770;5922;437;1553;447;1402;884;2955
353625;201710;453;1215;264;824;35;126;134;398;169;524
353630;201710;1203;4112;924;3391;179;692;176;588;355;1280
353640;201710;1333;3710;1019;3095;121;435;571;1685;692;2120
353650;201710;8276;23804;6251;19500;1034;3456;2947;8691;3981;12147
353657;201710;292;871;239;773;34;112;94;272;128;384
353660;201710;988;2340;689;1842;134;415;320;746;454;1161
353670;201710;3207;10001;2692;8976;738;2695;1104;3471;1842;6166
353680;201710;661;1986;521;1751;135;493;200;641;335;1134
353690;201710;489;1271;223;703;28;86;29;79;57;165
353700;201710;1853;5483;1584;4955;235;790;911;2715;1146;3505
353710;201710;3227;7549;1608;4800;318;924;602;1692;920;2616
353715;201710;530;1504;370;1179;23;90;102;289;125;379
353720;201710;1776;5322;1469;4849;274;1024;784;2472;1058;3496
353730;201710;3971;11756;3061;9753;538;1893;1259;3662;1797;5555
353740;201710;1672;4806;1212;3911;317;1104;313;952;630;2056
353750;201710;835;2722;589;2166;145;577;113;395;258;972
353760;201710;10469;27303;8578;24656;1255;4028;5487;15472;6742;19500
353770;201710;650;2003;331;1165;66;256;36;82;102;338
353780;201710;3983;13042;3362;11740;983;3722;819;2734;1802;6456
353790;201710;2159;7157;1709;6204;491;2045;423;1378;914;3423
353800;201710;15300;45643;12210;39974;2725;9637;5141;16546;7866;26183
353810;201710;968;2946;706;2374;131;514;246;786;377;1300
353820;201710;1434;4547;1173;3916;208;819;517;1636;725;2455
353830;201710;590;1592;461;1366;61;189;241;674;302;863
353850;201710;1585;4773;1293;4158;348;1108;415;1372;763;2480
353860;201710;2430;7588;1971;6575;537;1874;642;2093;1179;3967
353870;201710;26014;73678;18113;57645;3111;10992;7234;21035;10345;32027
353880;201710;2646;8035;2182;7160;264;988;1208;3872;1472;4860
353890;201710;2164;5298;1540;4314;200;623;887;2370;1087;2993
353900;201710;717;2185;535;1829;117;421;176;579;293;1000
353910;201710;1876;6364;1713;6084;234;829;1188;4350;1422;5179
353920;201710;2232;6440;1513;4948;340;1241;284;804;624;2045
353930;201710;4109;12012;2880;9709;769;2844;507;1588;1276;4432
353940;201710;1053;3372;782;2729;157;581;214;699;371;1280
353950;201710;2878;8793;2399;7785;471;1688;1170;3491;1641;5179
353960;201710;572;1733;398;1349;94;300;112;374;206;674
353970;201710;568;1570;456;1370;47;154;284;827;331;981
353980;201710;12448;35499;10290;31548;1809;5845;5639;16889;7448;22734
353990;201710;627;1722;437;1338;45;148;264;775;309;923
354000;201710;2144;5734;1290;4035;255;868;197;596;452;1464
354010;201710;326;960;265;836;39;125;160;487;199;612
354020;201710;3627;11075;3024;9754;805;2838;955;2780;1760;5618
354025;201710;770;2170;535;1727;116;388;162;544;278;932
354030;201710;454;1129;262;753;43;129;105;283;148;412
354040;201710;721;1878;470;1389;43;147;271;741;314;888
354050;201710;920;2830;670;2304;169;648;142;457;311;1105
354060;201710;4233;12848;2905;9903;779;2744;705;2246;1484;4990
354070;201710;2711;8617;2139;7364;538;1996;445;1364;983;3360
354075;201710;1850;6398;1576;5801;297;1247;782;2803;1079;4050
354080;201710;1400;4109;933;3097;175;640;276;806;451;1446
354085;201710;367;827;322;770;5;25;227;510;232;535
354090;201710;1401;4045;1266;3776;135;466;871;2560;1006;3026
354100;201710;13507;43138;10893;38242;2690;10144;4381;15104;7071;25248
354105;201710;910;2537;778;2342;138;401;479;1472;617;1873
354110;201710;496;1375;384;1206;107;375;110;313;217;688
354120;201710;1600;4482;1124;3446;185;609;415;1149;600;1758
354130;201710;5467;15372;3833;12168;1314;4479;186;409;1500;4888
354140;201710;21092;52937;13597;39526;3009;9349;4268;11465;7277;20814
354150;201710;3331;8727;2499;7212;516;1596;1040;2893;1556;4489
354160;201710;3173;10010;2440;8352;713;2533;692;2330;1405;4863
354165;201710;509;1615;420;1441;89;361;209;675;298;1036
354170;201710;1329;4111;1060;3474;125;450;543;1671;668;2121
354180;201710;435;1323;340;1114;61;224;127;362;188;586
354190;201710;1384;4259;1101;3656;189;692;377;1248;566;1940
354200;201710;889;2468;711;2138;86;273;344;960;430;1233
354210;201710;615;1891;504;1677;66;261;280;857;346;1118
354220;201710;2868;8219;2299;7122;413;1367;1147;3441;1560;4808
354230;201710;687;1991;556;1784;78;308;295;864;373;1172
354240;201710;1241;3901;871;3058;164;629;203;646;367;1275
354250;201710;509;1382;328;1071;95;328;86;283;181;611
354260;201710;7364;21348;5896;18758;1524;5125;1873;6083;3397;11208
354270;201710;1058;3406;849;2974;165;616;309;1071;474;1687
354280;201710;681;1921;594;1778;100;378;344;938;444;1316
354290;201710;826;2871;732;2639;151;572;308;1095;459;1667
354300;201710;3668;11472;3317;10809;1036;3508;1171;3667;2207;7175
354310;201710;743;2275;604;1983;126;437;294;932;420;1369
354320;201710;796;2235;539;1717;115;415;187;544;302;959
354323;201710;482;1264;340;987;43;118;128;350;171;468
354325;201710;1183;3784;869;3050;154;577;317;1050;471;1627
354330;201710;5977;16972;4708;14538;866;3110;2428;6893;3294;10003
354340;201710;22391;64370;17050;55099;4537;15920;6136;19088;10673;35008
354350;201710;1055;3011;903;2702;161;559;527;1445;688;2004
354360;201710;470;1412;272;975;49;167;34;120;83;287
354370;201710;1014;3337;863;3023;115;478;465;1580;580;2058
354380;201710;709;2090;523;1721;126;481;93;259;219;740
354390;201710;12533;34288;8300;26298;1633;5525;2042;6175;3675;11700
354400;201710;1505;5140;1197;4372;228;888;387;1401;615;2289
354410;201710;4794;14437;3953;12774;981;3428;1572;4885;2553;8313
354420;201710;1325;3764;941;2922;146;481;470;1390;616;1871
354425;201710;1988;5590;1629;4878;437;1366;529;1626;966;2992
354430;201710;1292;4046;1118;3718;198;751;542;1709;740;2460
354440;201710;517;1489;347;1126;39;138;143;429;182;567
354450;201710;356;1010;212;694;30;110;43;125;73;235
354460;201710;916;2530;642;1984;111;367;279;851;390;1218
354470;201710;530;1335;391;1060;30;91;199;484;229;575
354480;201710;780;2063;619;1792;70;221;369;1012;439;1233
354490;201710;731;2364;580;2011;98;373;252;837;350;1210
354500;201710;1949;6052;1687;5637;559;2066;399;1316;958;3382
354510;201710;778;2160;680;1958;104;296;371;1023;475;1319
354515;201710;250;802;198;688;38;160;79;270;117;430
354520;201710;6513;20233;4015;13420;691;2610;1913;5930;2604;8540
354530;201710;3367;10754;2755;9459;699;2564;1065;3601;1764;6165
354540;201710;1154;3420;898;2931;246;840;243;808;489;1648
354550;201710;484;1357;373;1148;67;215;200;594;267;809
354560;201710;1771;4739;1003;3068;138;441;467;1360;605;1801
354570;201710;1084;2993;473;1489;94;325;68;196;162;521
354580;201710;9819;26998;6548;20765;1175;4055;2664;7973;3839;12028
354600;201710;1548;4731;1259;4180;217;793;664;2130;881;2923
354610;201710;354;983;194;619;36;128;55;156;91;284
354620;201710;412;1254;298;1041;53;236;116;341;169;577
354625;201710;301;914;187;651;25;92;43;126;68;218
354630;201710;1945;6204;1624;5531;662;2414;166;542;828;2956
354640;201710;2905;9347;2188;7681;451;1762;452;1439;903;3201
354650;201710;826;2385;701;2132;91;288;442;1367;533;1655
354660;201710;2330;6314;1676;5188;121;456;1143;3482;1264;3938
354670;201710;944;2843;692;2235;169;597;187;547;356;1144
354680;201710;4134;12676;3662;11822;981;3301;1778;5727;2759;9028
354690;201710;698;2217;470;1674;102;393;107;363;209;756
354700;201710;1024;2841;713;2171;133;443;301;809;434;1252
354710;201710;503;1474;365;1167;43;150;167;487;210;637
354720;201710;254;676;134;416;42;131;20;58;62;189
354730;201710;8966;26673;6647;22225;1146;4275;3337;10632;4483;14907
354740;201710;313;889;121;443;16;78;20;66;36;144
354750;201710;2343;6738;1645;5422;335;1263;637;1947;972;3210
354760;201710;1732;5276;1317;4421;427;1516;206;700;633;2216
354765;201710;296;821;138;460;15;53;30;95;45;148
354770;201710;2127;5704;1536;4641;419;1365;503;1459;922;2824
354780;201710;51352;138993;42266;120676;6518;20733;23010;61589;29528;82322
354790;201710;826;2574;690;2307;99;351;356;1147;455;1498
354800;201710;2325;6571;1921;5948;400;1345;930;2772;1330;4117
354805;201710;940;2717;697;2192;79;284;257;715;336;999
354810;201710;560;1744;332;1223;58;236;78;270;136;506
354820;201710;885;2875;699;2495;135;544;158;490;293;1034
354830;201710;434;1122;299;871;105;305;99;280;204;585
354840;201710;703;2026;475;1484;79;234;227;691;306;925
354850;201710;17867;52042;12897;42224;2269;8502;6408;19511;8677;28013
354860;201710;1232;3759;988;3342;217;810;321;974;538;1784
354870;201710;40912;114115;34829;102397;6420;20583;18117;51076;24537;71659
354880;201710;4525;12127;2373;7310;347;1235;809;2070;1156;3305
354890;201710;14076;39640;11824;35628;2182;7164;5899;17135;8081;24299
354900;201710;436;1257;282;920;33;109;73;230;106;339
354910;201710;5607;16190;3270;11355;646;2467;226;731;872;3198
354920;201710;327;933;183;617;27;116;28;72;55;188
354925;201710;255;772;130;464;30;108;26;81;56;189
354930;201710;326;849;191;609;28;94;86;265;114;359
354940;201710;1574;5487;1269;4707;445;1750;120;401;565;2151
354950;201710;1374;4162;1135;3755;110;469;703;2210;813;2679
354960;201710;763;2200;617;1972;126;438;277;863;403;1301
354970;201710;3570;11276;3017;10155;512;1907;1671;5443;2183;7350
354980;201710;25079;65801;17621;52088;2617;8975;8383;22842;11000;31817
354990;201710;53963;149379;40995;124884;5812;19335;21561;63148;27373;82483
354995;201710;1888;5394;1532;4817;335;1127;793;2412;1128;3539
355000;201710;1302;4002;1117;3655;271;1003;231;639;502;1642
355010;201710;2982;9115;2156;7108;735;2582;246;813;981;3395
355020;201710;2970;9287;2243;7823;768;2951;616;2048;1384;4999
355030;201710;1145880;2986210;913615;2538592;182246;551226;417095;1088890;599341;1640116
355040;201710;2525;7512;2217;6975;365;1187;1401;4388;1766;5575
355050;201710;978;2809;747;2367;222;699;160;480;382;1179
355060;201710;4321;13347;3415;11471;665;2536;1401;4277;2066;6813
355070;201710;6955;20083;5749;18007;915;3303;3161;9263;4076;12566
355080;201710;822;2693;553;2069;96;413;40;122;136;535
355090;201710;1082;3465;867;3020;185;657;289;1022;474;1679
355100;201710;16789;49658;13904;44868;3043;10591;7593;23924;10636;34515
355110;201710;1027;3152;810;2766;314;1140;146;493;460;1633
355120;201710;591;1761;443;1476;77;295;168;527;245;822
355130;201710;588;1450;262;751;35;104;94;243;129;347
355140;201710;1157;3517;1066;3355;177;627;701;2193;878;2820
355150;201710;3568;10275;2892;9053;550;1823;1337;4173;1887;5996
355160;201710;1634;4963;1287;4331;359;1339;316;1021;675;2360
355170;201710;8116;22382;6265;19393;1936;6297;2217;6963;4153;13260
355180;201710;2646;7932;2027;6784;462;1846;649;1939;1111;3785
355190;201710;1452;4321;1228;3912;357;1261;485;1606;842;2867
355200;201710;764;2565;664;2372;294;1131;147;480;441;1611
355210;201710;2754;8147;2405;7436;268;977;1572;4622;1840;5599
355220;201710;37105;108081;30086;94035;9026;29792;9118;26175;18144;55967
355230;201710;1233;3222;708;2139;142;409;167;488;309;897
355240;201710;21873;60879;14954;46912;3114;10220;5495;17000;8609;27220
355250;201710;30066;88324;23661;76418;6423;22050;7954;25223;14377;47273
355255;201710;790;2114;440;1378;88;279;140;438;228;717
355260;201710;1102;3176;864;2744;146;561;483;1421;629;1982
355270;201710;1470;4579;1160;3847;269;942;419;1311;688;2253
355280;201710;25448;71492;19515;59867;3630;12001;8268;24243;11898;36244
355290;201710;766;2373;591;1951;150;478;169;524;319;1002
355300;201710;1243;3869;1020;3393;215;761;306;1007;521;1768
355310;201710;996;2901;764;2497;94;348;400;1310;494;1658
355320;201710;508;1473;423;1303;79;292;169;436;248;728
355330;201710;1840;5417;1383;4532;225;799;736;2299;961;3098
355340;201710;2808;6817;2449;6291;313;823;1664;4226;1977;5049
355350;201710;1243;4030;951;3376;213;827;283;992;496;1819
355360;201710;1158;3408;1020;3098;109;336;730;2266;839;2602
355365;201710;346;982;188;659;42;130;29;105;71;235
355370;201710;6059;15705;4759;13936;1100;3355;2130;6666;3230;10021
355380;201710;2947;8501;2267;7088;470;1573;620;1691;1090;3264
355385;201710;1051;3300;944;3070;220;779;392;1185;612;1964
355390;201710;737;2144;563;1778;106;358;214;617;320;975
355395;201710;1875;5620;1375;4463;217;738;543;1645;760;2383
355400;201710;8383;26935;7090;24207;2165;8020;1868;5939;4033;13959
355410;201710;18816;56947;14159;47698;3785;13865;2800;9547;6585;23412
355420;201710;679;2395;595;2208;152;662;140;524;292;1186
355430;201710;3511;9423;2800;8176;619;1861;1309;3808;1928;5669
355440;201710;820;2403;573;1859;122;411;162;491;284;902
355450;201710;3491;9812;2145;6939;430;1443;668;2004;1098;3447
355460;201710;541;1431;342;1067;57;215;138;366;195;581
355465;201710;360;1107;264;876;58;211;58;172;116;383
355470;201710;1011;2827;580;1886;165;543;173;547;338;1090
355475;201710;205;575;192;542;21;74;145;393;166;467
355480;201710;3184;10207;2785;9477;534;2062;1527;4995;2061;7057
355490;201710;918;2640;530;1761;76;275;170;537;246;812
355495;201710;744;2331;592;2028;114;443;160;519;274;962
355500;201710;6194;17907;4001;13005;681;2384;915;2809;1596;5193
355510;201710;1662;4239;837;2638;120;410;239;667;359;1077
355520;201710;403;936;201;554;20;60;103;265;123;325
355530;201710;445;1030;161;471;19;67;46;103;65;170
355535;201710;551;1606;433;1398;125;465;142;400;267;865
355540;201710;7790;23148;6935;21801;1443;4829;3959;12151;5402;16980
355550;201710;659;2018;524;1731;77;256;217;715;294;971
355560;201710;1051;3080;580;1985;114;411;31;100;145;511
355570;201710;230;703;120;434;22;87;20;75;42;162
355580;201710;1173;3108;785;2399;115;426;362;1058;477;1484
355590;201710;189;503;146;432;22;75;81;234;103;309
355600;201710;1367;3757;984;2993;249;830;334;951;583;1781
355610;201710;1599;4356;1149;3482;178;570;527;1542;705;2112
355620;201710;4250;12709;3327;10652;482;1803;1635;4794;2117;6597
355630;201710;2185;6456;1543;5185;349;1225;526;1784;875;3009
355635;201710;864;2719;746;2514;86;313;496;1730;582;2043
355640;201710;2638;8170;1865;6586;447;1673;344;1211;791;2884
355645;201710;3823;11951;3197;10919;409;1663;1967;6585;2376;8248
355650;201710;6441;18670;5491;16874;1228;4166;3009;8634;4237;12800
355660;201710;1219;3607;912;2972;123;509;399;1250;522;1759
355670;201710;3051;9194;2113;6928;367;1373;901;2603;1268;3976
355680;201710;2095;6338;1080;3774;307;1159;82;249;389;1408
355690;201710;546;1734;359;1318;101;403;13;29;114;432
355695;201710;231;764;133;485;12;48;16;53;28;101
355700;201710;5436;17121;4592;15204;1198;4017;1805;5833;3003;9850
355710;201710;8350;20713;5144;14804;1023;3113;1609;4294;2632;7407
355715;201710;365;1089;224;746;52;190;52;160;104;350
355720;201710;1410;4509;1158;3959;243;885;451;1398;694;2283
355730;201710;801;2530;667;2235;187;620;209;655;396;1275
410010;201710;1220;3647;976;3084;223;780;184;578;407;1358
410020;201710;1071;3451;912;3085;288;958;281;946;569;1904
410030;201710;1207;3870;1008;3431;247;883;320;1087;567;1970
410040;201710;9173;28899;7783;26247;1745;6404;2537;8361;4282;14765
410045;201710;1011;2758;686;2139;105;379;211;599;316;978
410050;201710;2537;6676;1596;4909;408;1339;230;623;638;1962
410060;201710;2088;6302;1726;5532;394;1301;661;2110;1055;3411
410070;201710;1593;4396;1195;3603;269;884;389;1133;658;2017
410080;201710;1330;3680;1021;3113;183;605;416;1240;599;1845
410090;201710;963;2849;897;2717;126;391;471;1499;597;1890
410100;201710;2234;6841;1646;5370;270;1020;277;857;547;1877
410105;201710;340;1034;216;721;38;154;40;110;78;264
410110;201710;2979;8235;2185;6607;328;1093;768;2247;1096;3340
410115;201710;503;1333;366;1081;70;224;129;360;199;584
410120;201710;2320;7761;2106;7335;859;3128;471;1630;1330;4758
410130;201710;1021;3061;944;2915;346;1198;279;728;625;1926
410140;201710;15121;38799;9666;28888;2026;6577;2028;5691;4054;12268
410150;201710;15202;38004;7556;22287;1482;4676;1219;3444;2701;8120
410160;201710;2773;8292;2437;7631;536;1860;915;2916;1451;4776
410165;201710;706;2056;569;1727;83;271;299;852;382;1123
410170;201710;2095;5881;1553;4672;449;1480;184;524;633;2004
410180;201710;11150;34061;9287;29870;1778;6121;4255;12803;6033;18924
410185;201710;500;1397;365;1139;67;221;104;294;171;515
410190;201710;1898;5366;1497;4549;323;1040;305;882;628;1922
410200;201710;3848;10130;2502;7584;534;1862;462;1369;996;3231
410210;201710;2484;7140;1729;5478;285;1018;442;1184;727;2202
410220;201710;592;1571;416;1236;49;166;113;340;162;506
410230;201710;1373;4154;1173;3738;237;863;510;1534;747;2397
410240;201710;4062;11901;3476;10729;1072;3692;441;1336;1513;5028
410250;201710;2579;6842;1790;5332;435;1408;424;1229;859;2637
410260;201710;1551;4169;1126;3473;225;785;500;1495;725;2280
410270;201710;503;1362;386;1137;32;114;197;567;229;681
410275;201710;731;2209;484;1615;70;254;205;674;275;928
410280;201710;2012;5752;1384;4433;308;1086;393;1139;701;2225
410290;201710;3200;9491;2485;8009;586;1878;903;2940;1489;4818
410300;201710;665;1780;523;1507;91;285;226;597;317;882
410302;201710;417;1101;216;701;22;75;108;352;130;427
410304;201710;1095;3328;971;3067;210;714;463;1448;673;2162
410305;201710;1627;4289;1217;3599;302;936;529;1547;831;2483
410310;201710;2237;6932;1915;6345;413;1508;611;2021;1024;3529
410315;201710;775;2058;421;1404;101;348;104;334;205;682
410320;201710;1126;3321;732;2421;96;372;110;336;206;708
410322;201710;514;1482;277;910;32;112;81;258;113;370
410330;201710;1348;3628;1031;3001;235;740;259;744;494;1484
410335;201710;839;2430;695;2131;114;414;308;865;422;1279
410337;201710;719;1868;515;1489;74;228;201;543;275;771
410340;201710;495;1387;337;994;46;163;144;353;190;516
410345;201710;1915;5239;1151;3616;257;834;274;808;531;1642
410347;201710;690;1793;504;1460;48;164;158;427;206;591
410350;201710;1138;3316;851;2729;136;472;242;704;378;1176
410360;201710;3850;9955;3013;8522;286;955;1793;4930;2079;5885
410370;201710;10605;30038;7535;22951;1221;4171;2554;6858;3775;11029
410380;201710;1292;3635;1091;3220;136;501;417;1152;553;1653
410390;201710;2434;6983;1683;5408;498;1716;319;915;817;2631
410395;201710;876;2727;717;2372;160;584;321;1072;481;1656
410400;201710;4367;13175;3509;11351;688;2382;1279;3961;1967;6343
410405;201710;773;2076;626;1830;149;451;272;790;421;1241
410410;201710;1072;3277;1045;3242;219;843;609;1833;828;2676
410420;201710;6446;20301;5125;17324;1142;4257;999;3050;2141;7307
410425;201710;2592;7969;1925;6562;374;1353;468;1486;842;2839
410430;201710;12268;32520;8850;26209;1604;5171;2654;7462;4258;12633
410440;201710;2832;9610;2526;8991;446;1657;1330;4951;1776;6608
410442;201710;2343;7642;2062;7036;632;2293;619;2066;1251;4359
410445;201710;2207;6876;1826;6119;422;1546;558;1922;980;3468
410450;201710;1708;4792;1295;3947;262;884;249;634;511;1518
410460;201710;1599;4470;1242;3840;269;905;367;1057;636;1962
410465;201710;2208;6973;1800;6090;425;1437;577;1917;1002;3354
410470;201710;1681;5241;1280;4319;320;1165;237;829;557;1994
410480;201710;29186;79341;16927;54385;2643;9375;1470;4087;4113;13462
410490;201710;10561;31429;7758;25358;1653;5832;2281;6953;3934;12785
410500;201710;1505;4564;1151;3780;342;1249;180;495;522;1744
410510;201710;2180;5721;1444;4223;268;795;476;1352;744;2147
410520;201710;2938;9869;2714;9417;749;2677;1208;4256;1957;6933
410530;201710;1423;3929;790;2415;142;441;78;193;220;634
410540;201710;2622;7591;1876;6041;326;1117;789;2520;1115;3637
410550;201710;5881;16741;4033;12663;816;2803;683;1936;1499;4739
410560;201710;1270;3623;1000;3097;234;793;372;1051;606;1844
410570;201710;2469;7643;2078;6914;569;2112;351;1242;920;3354
410580;201710;20962;59954;16623;51532;3599;12406;6213;17880;9812;30286
410590;201710;1350;4120;893;2913;162;559;198;578;360;1137
410600;201710;1680;4841;1332;4151;319;984;437;1399;756;2383
410610;201710;726;2051;541;1685;66;227;183;545;249;772
410620;201710;1808;5810;1219;4347;290;1108;119;350;409;1458
410630;201710;2182;6405;1431;4679;295;1062;123;313;418;1375
410640;201710;3787;9990;2717;8067;725;2422;409;1159;1134;3581
410645;201710;1058;3536;968;3381;424;1509;237;895;661;2404
410650;201710;1884;5642;1450;4720;413;1442;344;1015;757;2457
410655;201710;1332;4450;1096;3981;52;190;735;2863;787;3053
410657;201710;683;1832;438;1319;86;278;165;448;251;726
410660;201710;2943;8091;1598;5053;327;1056;219;680;546;1736
410670;201710;876;2310;587;1719;108;312;258;740;366;1052
410680;201710;2825;8918;2090;7080;543;1804;485;1755;1028;3559
410685;201710;573;1623;482;1455;80;274;256;737;336;1011
410690;201710;109251;301689;75449;232657;14094;48276;21279;57690;35373;105966
410700;201710;2059;5835;1804;5368;393;1240;819;2299;1212;3539
410710;201710;855;2460;579;1885;95;320;232;720;327;1040
410712;201710;687;2055;602;1897;194;655;224;679;418;1334
410715;201710;821;2634;561;1986;111;406;146;503;257;909
410720;201710;2707;7880;2129;6640;352;1273;403;1122;755;2395
410725;201710;1028;2799;672;2102;110;373;112;312;222;685
410730;201710;515;1437;375;1167;99;341;56;172;155;513
410740;201710;909;2647;637;2102;115;417;247;817;362;1234
410750;201710;1672;4719;1371;4111;287;942;484;1369;771;2311
410752;201710;313;820;148;452;22;75;49;126;71;201
410753;201710;247;751;168;568;20;72;28;81;48;153
410754;201710;1059;2990;908;2749;49;137;605;1988;654;2125
410755;201710;703;1753;500;1393;46;142;276;727;322;869
410760;201710;2539;7376;2142;6684;592;1995;607;1892;1199;3887
410765;201710;12240;36783;9543;31447;1623;5979;1027;3259;2650;9238
410770;201710;885;2367;618;1862;107;349;208;605;315;954
410773;201710;1270;3578;1147;3393;169;578;833;2414;1002;2992
410775;201710;1353;3759;1207;3522;235;755;456;1295;691;2050
410780;201710;573;1495;344;1022;75;225;81;261;156;486
410785;201710;735;2194;604;1927;153;540;186;553;339;1093
410790;201710;503;1589;420;1383;116;407;41;103;157;510
410800;201710;2728;6529;2154;5640;206;591;955;2478;1161;3069
410810;201710;314;916;249;784;37;138;107;323;144;461
410820;201710;691;2029;486;1546;114;379;70;210;184;589
410830;201710;27141;74471;21054;63715;5670;19020;6707;19338;12377;38358
410832;201710;976;2687;834;2412;108;396;465;1257;573;1653
410840;201710;6754;18844;4294;13795;1023;3646;457;1134;1480;4780
410845;201710;1097;3190;910;2828;198;688;307;910;505;1598
410850;201710;2414;7243;2121;6716;452;1567;824;2633;1276;4200
410855;201710;567;1551;419;1248;47;166;186;513;233;679
410860;201710;3792;10437;2980;8857;537;1717;971;2770;1508;4487
410865;201710;1327;4313;1235;4154;294;1043;670;2332;964;3375
410870;201710;1155;3374;1053;3214;87;278;726;2246;813;2524
410880;201710;3697;11197;2916;9659;559;2028;418;1441;977;3469
410890;201710;873;2748;666;2298;145;544;144;485;289;1029
410895;201710;914;3073;795;2799;316;1207;135;448;451;1655
410900;201710;850;2337;574;1775;92;308;153;395;245;703
410910;201710;354;880;225;619;13;39;113;291;126;330
410920;201710;722;1975;577;1735;136;464;210;617;346;1081
410930;201710;1453;4284;1185;3722;342;1229;266;800;608;2029
410940;201710;19985;61240;16138;53805;4765;17135;3009;10334;7774;27469
410950;201710;1799;5633;1652;5393;83;327;1347;4344;1430;4671
410960;201710;7340;19816;4609;14702;1259;4436;1213;3760;2472;8196
410965;201710;996;2859;766;2387;154;511;313;915;467;1426
410970;201710;3836;11040;2863;9102;719;2684;435;1234;1154;3918
410975;201710;1339;3771;1046;3192;215;769;345;1028;560;1797
410980;201710;6382;17424;4232;13264;647;2223;1543;4655;2190;6878
410990;201710;1041;2921;683;2177;207;738;142;381;349;1119
411000;201710;469;1389;334;1100;44;161;78;217;122;378
411005;201710;433;1249;276;887;54;178;50;155;104;333
411007;201710;2129;6585;1867;6050;486;1699;571;1827;1057;3526
411010;201710;3893;12620;3345;11407;977;3532;347;1104;1324;4636
411020;201710;2296;6891;1959;6287;612;2105;572;1767;1184;3872
411030;201710;667;1760;445;1257;88;262;134;340;222;602
411040;201710;733;2034;324;1013;55;177;55;152;110;329
411050;201710;1811;6119;1574;5560;467;1767;233;726;700;2493
411060;201710;1524;4386;1082;3454;229;860;195;548;424;1408
411065;201710;324;925;247;773;46;142;98;309;144;451
411070;201710;5994;17066;4792;14740;1067;3602;1572;4583;2639;8185
411080;201710;1942;5571;1668;5079;491;1585;381;1184;872;2769
411090;201710;766;2021;529;1591;50;166;93;257;143;423
411095;201710;1397;3590;1001;2893;158;509;356;969;514;1478
411100;201710;1090;3151;801;2539;107;412;213;670;320;1082
411110;201710;559;1593;257;881;26;85;15;39;41;124
411120;201710;1382;4092;1051;3373;335;1241;200;519;535;1760
411125;201710;4245;13356;3971;12846;991;3321;1713;5668;2704;8989
411130;201710;653;1863;470;1460;101;319;154;514;255;833
411140;201710;2172;7050;1818;6237;433;1554;734;2568;1167;4122
411150;201710;3685;10202;2690;8202;575;1948;219;558;794;2506
411155;201710;920;2470;615;1896;71;234;265;761;336;995
411160;201710;273;736;205;604;32;87;49;153;81;240
411170;201710;716;2190;554;1815;124;426;173;566;297;992
411180;201710;5148;14762;4084;12741;812;2789;1522;4654;2334;7443
411190;201710;1226;3463;998;2977;238;769;250;653;488;1422
411200;201710;4230;12196;3286;10475;891;3041;913;2855;1804;5896
411210;201710;1912;5170;1506;4474;444;1476;166;435;610;1911
411220;201710;818;2296;660;1981;153;507;228;643;381;1150
411230;201710;1051;2928;684;2199;151;517;185;587;336;1104
411240;201710;1564;3706;883;2545;120;364;391;1077;511;1441
411250;201710;1871;5405;1508;4736;366;1294;456;1419;822;2713
411260;201710;342;888;214;646;28;86;87;241;115;327
411270;201710;1679;5069;1414;4527;244;889;640;1964;884;2853
411275;201710;1238;3429;926;2780;185;609;277;774;462;1383
411280;201710;1401;3971;894;2844;168;599;148;411;316;1010
411290;201710;693;1976;501;1601;92;300;190;615;282;915
411295;201710;996;2625;831;2321;136;416;328;885;464;1301
411300;201710;1114;2832;737;2119;71;222;263;673;334;895
411310;201710;808;2136;646;1865;46;139;243;696;289;835
411320;201710;4970;14131;3595;11494;876;2872;799;2395;1675;5267
411325;201710;1477;4517;1296;4150;241;790;656;2162;897;2952
411330;201710;3010;8989;2376;7707;651;2297;575;1893;1226;4190
411340;201710;738;2150;477;1530;55;225;212;646;267;871
411342;201710;643;1732;503;1469;113;355;191;515;304;870
411345;201710;945;2734;791;2440;137;486;440;1344;577;1830
411350;201710;2542;7363;1852;5946;487;1726;165;540;652;2266
411360;201710;597;1492;412;1195;54;186;148;378;202;564
411370;201710;43147;116296;33332;98635;4019;13748;17002;47025;21021;60773
411373;201710;1281;3672;1076;3323;153;515;467;1462;620;1977
411375;201710;1010;2719;754;2241;134;434;249;683;383;1117
411380;201710;989;2642;651;1872;91;294;260;668;351;962
411390;201710;1667;4909;1324;4078;244;813;415;1147;659;1960
411400;201710;2036;5505;1637;4721;323;1062;595;1622;918;2684
411410;201710;1925;5713;1457;4689;349;1234;300;849;649;2083
411420;201710;3755;10095;2352;7239;366;1276;374;911;740;2187
411430;201710;3067;8965;2539;8052;571;1925;1092;3376;1663;5301
411435;201710;445;1335;330;1093;76;245;118;365;194;610
411440;201710;2534;7934;2163;7153;562;1949;561;1947;1123;3896
411450;201710;2531;7093;1996;6190;356;1114;1024;3259;1380;4373
411460;201710;3455;9766;1929;6398;333;1286;245;726;578;2012
411470;201710;739;2159;508;1632;88;312;93;277;181;589
411480;201710;4131;12153;2976;9848;639;2314;602;1872;1241;4186
411490;201710;1431;4107;1136;3555;204;744;341;935;545;1679
411500;201710;1578;4168;1108;3326;176;611;334;980;510;1591
411510;201710;1907;5524;1593;4886;405;1373;326;1007;731;2380
411520;201710;23178;61664;14065;42859;2264;7571;3729;10132;5993;17703
411530;201710;907;2491;607;1926;118;408;193;585;311;993
411535;201710;453;1370;207;740;20;84;20;52;40;136
411540;201710;2804;7428;2039;5869;453;1408;558;1471;1011;2879
411545;201710;969;3030;842;2768;93;317;533;1791;626;2108
411550;201710;674;1801;535;1566;104;344;89;243;193;587
411560;201710;1948;5586;1276;4125;193;700;80;192;273;892
411570;201710;6973;17738;4920;14450;1079;3589;1155;3381;2234;6970
411573;201710;789;2231;702;2089;69;219;441;1302;510;1521
411575;201710;1555;4640;1300;4135;308;1049;370;1161;678;2210
411580;201710;3884;10228;2305;7413;266;1047;309;888;575;1935
411585;201710;733;2287;356;1254;65;232;59;179;124;411
411590;201710;340;993;273;863;39;138;118;333;157;471
411600;201710;279;785;191;629;38;139;69;224;107;363
411605;201710;1441;3971;973;2950;151;538;378;1082;529;1620
411610;201710;2085;5724;1533;4563;307;999;579;1650;886;2649
411620;201710;2729;8099;2407;7587;448;1556;1373;4270;1821;5826
411630;201710;512;1385;342;1069;77;281;61;145;138;426
411640;201710;463;1385;332;1055;43;133;106;335;149;468
411650;201710;191;576;139;469;28;94;22;78;50;172
411660;201710;866;2305;615;1834;47;145;323;940;370;1085
411670;201710;1050;2854;819;2380;142;416;280;787;422;1203
411680;201710;1496;4292;1231;3797;212;742;586;1793;798;2535
411690;201710;3195;9089;2426;7638;494;1633;672;2186;1166;3819
411695;201710;650;2063;486;1663;77;287;156;553;233;840
411700;201710;1459;4108;998;3184;215;750;146;413;361;1163
411705;201710;1580;5540;1418;5203;327;1157;760;2959;1087;4116
411710;201710;1641;4608;1260;3858;343;1114;186;577;529;1691
411720;201710;883;2399;695;2021;103;327;240;653;343;980
411721;201710;788;2242;623;1875;132;414;117;344;249;758
411722;201710;612;1785;388;1269;72;282;126;336;198;618
411725;201710;1249;3916;784;2768;191;704;148;530;339;1234
411727;201710;1542;4559;1081;3536;312;1041;141;418;453;1459
411729;201710;627;1615;426;1232;94;281;109;267;203;548
411730;201710;4683;13627;3877;11936;1206;3850;1090;3306;2296;7156
411740;201710;569;1583;316;1007;60;213;57;153;117;366
411745;201710;829;2425;622;1955;110;366;143;388;253;754
411750;201710;4686;13586;3581;11160;524;1799;1516;4510;2040;6309
411760;201710;6859;19651;5668;17563;1953;6425;1121;3648;3074;10073
411770;201710;3151;9906;2481;8379;696;2477;331;1083;1027;3560
411780;201710;2810;8417;2487;7798;651;2182;1023;3242;1674;5424
411790;201710;2910;7946;1823;5669;448;1538;289;828;737;2366
411800;201710;1020;2949;679;2155;93;321;114;336;207;657
411810;201710;1605;4387;1279;3761;226;735;589;1634;815;2369
411820;201710;11179;35481;9330;31609;3142;11053;2504;8585;5646;19638
411830;201710;565;1418;386;1111;96;316;44;140;140;456
411840;201710;9784;27103;6986;21516;1448;4871;1611;4845;3059;9716
411845;201710;426;1263;240;787;44;170;18;50;62;220
411850;201710;7102;20296;5544;17244;1604;5367;1031;3089;2635;8456
411860;201710;795;2388;611;1995;114;413;167;500;281;913
411870;201710;743;2356;502;1719;98;370;97;297;195;667
411880;201710;1983;5663;1486;4746;382;1338;244;755;626;2093
411885;201710;773;2071;609;1795;102;357;231;650;333;1007
411890;201710;1091;3233;740;2429;120;444;54;145;174;589
411900;201710;854;2613;526;1783;130;445;54;188;184;633
411910;201710;1070;3385;798;2758;226;819;202;670;428;1489
411915;201710;15985;41815;9885;30117;1867;6177;2367;6599;4234;12776
411920;201710;881;2878;761;2595;233;881;115;353;348;1234
411925;201710;583;1602;386;1228;101;341;88;265;189;606
411930;201710;5326;17483;4656;16154;2218;8388;312;1127;2530;9515
411940;201710;2992;9734;2491;8558;643;2300;534;1699;1177;3999
411950;201710;12106;36580;10210;33047;2239;7774;4629;14649;6868;22423
411960;201710;5210;15021;4612;13855;957;3155;1764;5049;2721;8204
411965;201710;482;1339;343;1098;64;236;89;286;153;522
411970;201710;808;2122;668;1921;129;344;363;1160;492;1504
411980;201710;1440;4091;1195;3617;319;1012;355;1045;674;2057
411990;201710;32461;96197;23499;77442;5300;19185;6919;21777;12219;40962
411995;201710;2471;6915;1979;6096;553;1923;570;1621;1123;3544
412000;201710;2124;5081;1564;4142;138;445;907;2203;1045;2648
412010;201710;653;2148;493;1758;70;291;112;345;182;636
412015;201710;588;1720;492;1532;78;244;244;775;322;1019
412020;201710;418;1238;262;871;45;167;91;278;136;445
412030;201710;699;2090;499;1679;76;275;175;567;251;842
412033;201710;883;2571;626;1996;85;281;219;736;304;1017
412035;201710;843;2286;536;1733;88;321;225;705;313;1026
412040;201710;574;1671;403;1310;71;238;73;232;144;470
412050;201710;1609;4472;1193;3667;222;772;293;896;515;1668
412060;201710;6955;22788;6117;21027;1872;6960;1414;4679;3286;11639
412065;201710;680;1994;510;1650;102;352;153;475;255;827
412070;201710;1216;3183;896;2544;132;402;387;1094;519;1496
412080;201710;1538;4666;950;3267;122;479;37;102;159;581
412085;201710;327;920;108;373;10;39;11;31;21;70
412090;201710;4849;13644;4277;12621;1078;3225;2039;6212;3117;9437
412100;201710;1697;5113;1364;4454;420;1480;265;873;685;2353
412110;201710;913;2535;634;1932;134;445;145;445;279;890
412120;201710;1658;5424;1383;4799;339;1276;379;1116;718;2392
412125;201710;599;1895;506;1675;120;423;155;491;275;914
412130;201710;589;1722;427;1348;70;246;97;327;167;573
412135;201710;539;1534;281;869;46;142;90;259;136;401
412140;201710;1509;4154;1082;3326;234;804;174;474;408;1278
412150;201710;2937;8094;2481;7213;280;946;1566;4414;1846;5360
412160;201710;1074;3455;665;2353;174;673;78;260;252;933
412170;201710;4210;12564;3513;11246;811;2819;1416;4261;2227;7080
412175;201710;1327;4233;1143;3860;244;849;475;1616;719;2465
412180;201710;1604;4672;1203;3925;223;875;483;1411;706;2286
412190;201710;3188;8639;2404;7189;389;1249;900;2806;1289;4055
412200;201710;1914;5970;1382;4617;324;1156;283;935;607;2091
412210;201710;625;1679;367;1139;75;283;63;153;138;436
412215;201710;3718;10394;3210;9436;847;2515;1418;4593;2265;7108
412217;201710;1023;2825;889;2580;71;248;614;1697;685;1945
412220;201710;5431;16447;4820;15301;1189;3720;1972;6631;3161;10351
412230;201710;2694;8604;2246;7640;428;1628;619;1923;1047;3551
412240;201710;7241;18802;4560;13791;875;2946;1043;2953;1918;5899
412250;201710;1875;5261;1472;4440;371;1187;228;618;599;1805
412260;201710;1204;3358;832;2542;119;396;280;776;399;1172
412265;201710;877;2653;756;2416;192;657;288;919;480;1576
412270;201710;779;2378;539;1800;89;331;191;598;280;929
412280;201710;523;1625;411;1393;127;445;66;208;193;653
412290;201710;998;2710;706;2167;125;433;219;623;344;1056
412300;201710;1495;4453;1246;3954;331;1135;265;790;596;1925
412310;201710;809;2400;675;2159;88;381;329;1052;417;1433
412320;201710;799;2128;574;1691;83;317;188;537;271;854
412330;201710;1396;3908;1000;3102;182;581;395;1201;577;1782
412340;201710;953;2878;630;2065;102;354;137;411;239;765
412350;201710;2510;7154;1653;5325;314;1131;130;343;444;1474
412360;201710;256;745;162;522;23;84;56;164;79;248
412370;201710;784;2355;584;1962;125;463;62;202;187;665
412380;201710;1542;4650;1154;3750;296;990;220;760;516;1750
412382;201710;592;1598;402;1216;65;207;110;291;175;498
412385;201710;2147;6389;1847;5750;679;2143;461;1534;1140;3677
412390;201710;2108;5730;1787;5217;382;1211;836;2455;1218;3666
412395;201710;705;2059;524;1677;58;190;262;823;320;1013
412400;201710;870;2596;673;2148;157;526;154;521;311;1047
412402;201710;1703;4686;1293;3947;287;993;186;523;473;1516
412405;201710;3067;8858;1932;6318;343;1267;67;189;410;1456
412410;201710;4916;14201;3833;12175;916;3314;864;2610;1780;5924
412420;201710;400;1135;223;712;29;97;88;243;117;340
412430;201710;511;1397;345;1064;43;151;121;364;164;515
412440;201710;2733;8079;1969;6585;491;1815;368;1230;859;3045
412450;201710;273;884;199;691;26;80;13;37;39;117
412460;201710;780;2348;657;2091;143;477;194;585;337;1062
412470;201710;1736;5794;1408;4970;392;1445;282;1039;674;2484
412480;201710;979;2884;626;2011;112;403;82;200;194;603
412490;201710;932;2651;772;2329;150;439;294;858;444;1297
412500;201710;1781;4917;1435;4222;252;812;377;993;629;1805
412510;201710;1989;6389;1479;5069;401;1458;198;627;599;2085
412520;201710;1298;3696;925;2878;235;741;106;315;341;1056
412530;201710;558;1608;435;1341;68;228;96;286;164;514
412535;201710;974;3047;754;2578;103;342;332;1240;435;1582
412540;201710;1210;3377;858;2612;122;458;244;758;366;1216
412545;201710;708;1929;477;1420;85;260;111;281;196;541
412550;201710;28953;84672;20089;65275;4251;14728;5282;16097;9533;30825
412555;201710;225;652;152;485;24;84;41;105;65;189
412560;201710;4959;15005;3728;12156;786;2858;810;2535;1596;5393
412570;201710;3925;11002;2519;8025;521;1826;339;1116;860;2942
412575;201710;880;2564;712;2173;110;370;293;826;403;1196
412580;201710;1284;3449;902;2697;152;517;357;996;509;1513
412590;201710;469;1316;260;872;53;177;27;84;80;261
412600;201710;1349;4032;1008;3251;192;686;316;978;508;1664
412610;201710;690;2002;433;1370;92;294;146;433;238;727
412620;201710;1199;3535;920;3015;228;883;253;740;481;1623
412625;201710;7749;22428;5493;17812;937;3272;592;2108;1529;5380
412627;201710;917;2740;633;2106;183;665;164;526;347;1191
412630;201710;2898;9038;2204;7428;427;1410;657;2128;1084;3538
412635;201710;391;1104;270;835;54;177;38;92;92;269
412640;201710;967;2768;575;1848;85;297;115;337;200;634
412650;201710;1494;4393;1251;3926;234;851;412;1155;646;2006
412660;201710;2537;7008;1832;5606;331;1124;489;1358;820;2482
412665;201710;555;1419;308;949;65;217;86;242;151;459
412667;201710;1615;4520;1255;3778;209;724;472;1350;681;2074
412670;201710;512;1530;404;1325;98;360;111;351;209;711
412680;201710;1362;3993;852;2886;149;563;240;719;389;1282
412690;201710;765;2233;579;1839;124;397;136;436;260;833
412700;201710;1834;5180;1505;4666;363;1294;555;1664;918;2958
412710;201710;5805;18172;4862;16194;1030;3736;1318;4056;2348;7792
412720;201710;1278;3919;925;3050;147;526;195;547;342;1073
412730;201710;2045;6026;1171;3942;258;924;162;516;420;1440
412740;201710;1551;4698;1069;3590;207;765;132;491;339;1256
412750;201710;3898;11374;3421;10587;489;1763;2108;6321;2597;8084
412760;201710;2500;7478;2257;7053;337;1160;1344;4087;1681;5247
412770;201710;9904;26758;5451;17245;744;2477;1021;2926;1765;5403
412780;201710;1203;3566;1014;3196;195;683;424;1284;619;1967
412785;201710;2044;5578;1512;4559;374;1137;626;1882;1000;3019
412788;201710;1298;3989;1093;3556;291;1027;390;1190;681;2217
412790;201710;987;2898;655;2171;135;493;156;437;291;930
412795;201710;1003;2741;642;1942;117;376;186;538;303;914
412796;201710;2302;7048;2004;6373;390;1303;775;2314;1165;3617
412800;201710;3062;8328;2198;6503;338;1126;821;2241;1159;3367
412810;201710;10814;28872;6317;19215;868;2996;1708;4420;2576;7416
412820;201710;6620;19100;4868;15612;1077;3638;1448;4681;2525;8319
412830;201710;317;935;230;753;34;120;52;163;86;283
412840;201710;1724;4816;1356;4065;221;706;379;1124;600;1830
412850;201710;2921;8225;2226;6957;418;1411;750;2237;1168;3648
412853;201710;1730;4831;1448;4193;154;499;760;2005;914;2504
412855;201710;1218;3497;887;2710;170;590;188;472;358;1062
412860;201710;961;2829;761;2403;173;589;264;786;437;1375
412862;201710;725;1800;461;1333;70;224;162;462;232;686
412863;201710;1123;3680;1092;3626;101;360;835;2745;936;3105
412865;201710;710;2048;515;1661;94;308;170;565;264;873
412870;201710;868;2463;683;2149;230;810;130;429;360;1239
412880;201710;834;2432;587;1863;119;418;82;234;201;652
420005;201710;450;1335;262;890;40;141;92;306;132;447
420010;201710;2972;7977;2273;6950;240;780;1584;4858;1824;5638
420020;201710;568;1827;340;1247;52;240;47;142;99;382
420030;201710;272;724;143;494;33;132;18;68;51;200
420040;201710;614;1930;339;1289;55;235;16;46;71;281
420050;201710;663;1778;425;1312;73;240;216;644;289;884
420055;201710;173;536;97;349;18;78;25;84;43;162
420060;201710;148;487;107;381;19;84;19;46;38;130
420070;201710;1062;3415;792;2755;171;644;273;962;444;1606
420075;201710;137;362;70;215;14;40;9;17;23;57
420080;201710;484;1476;374;1253;109;375;101;322;210;697
420090;201710;374;1304;261;992;63;241;52;208;115;449
420100;201710;1071;3258;975;3112;121;412;688;2187;809;2599
420110;201710;269;893;248;846;75;269;74;228;149;497
420120;201710;269;859;204;707;56;235;65;184;121;419
420125;201710;299;1035;264;962;66;271;124;434;190;705
420127;201710;306;864;104;367;23;90;14;38;37;128
420130;201710;1729;5651;1322;4798;347;1378;329;1092;676;2470
420140;201710;3416;10037;2500;8287;624;2320;356;1060;980;3380
420150;201710;477;1275;312;1004;36;137;158;471;194;608
420160;201710;219;592;111;369;16;62;33;104;49;166
420165;201710;181;542;105;350;22;83;33;103;55;186
420170;201710;202;640;132;485;37;164;15;50;52;214
420180;201710;272;813;147;526;22;82;37;127;59;209
420190;201710;169;565;102;389;29;113;16;55;45;168
420195;201710;1199;3494;955;3048;254;921;155;469;409;1390
420200;201710;2601;7636;1529;5317;284;1163;339;1039;623;2202
420205;201710;1162;3552;881;3004;149;562;478;1636;627;2198
420207;201710;1413;4054;930;3067;230;854;241;749;471;1603
420208;201710;485;1293;259;904;49;204;108;389;157;593
420209;201710;190;615;125;456;34;138;50;174;84;312
420210;201710;2013;5672;1286;4443;298;1171;516;1690;814;2861
420213;201710;724;2506;675;2399;184;711;315;1116;499;1827
420215;201710;269;855;176;646;58;204;15;69;73;273
420220;201710;170;601;139;538;41;181;38;137;79;318
420230;201710;3312;9823;2566;8473;468;1805;1131;3544;1599;5349
420240;201710;10552;29159;6818;21895;960;3644;3374;9847;4334;13491
420243;201710;515;1521;397;1294;79;269;143;464;222;733
420245;201710;1198;3377;824;2656;97;382;408;1212;505;1594
420250;201710;451;1419;394;1305;89;321;179;570;268;891
420253;201710;494;1304;364;1110;32;95;196;597;228;692
420257;201710;247;669;143;474;27;90;63;211;90;301
420260;201710;1001;3152;786;2763;136;542;367;1280;503;1822
420270;201710;540;1511;229;747;22;83;71;207;93;290
420280;201710;1686;4569;992;3283;190;689;275;872;465;1561
420285;201710;106;298;50;185;10;39;5;11;15;50
420287;201710;437;1191;319;1004;109;362;95;298;204;660
420290;201710;4368;13337;3237;10669;635;2274;1062;3153;1697;5427
420300;201710;6035;17484;3728;12525;799;3050;808;2414;1607;5464
420310;201710;749;1894;456;1282;56;169;312;851;368;1020
420315;201710;832;2635;633;2216;175;648;225;774;400;1422
420320;201710;3775;11624;3093;10358;1005;3716;746;2338;1751;6054
420325;201710;198;639;153;542;42;148;42;151;84;299
420330;201710;837;2739;596;2142;128;502;180;599;308;1101
420340;201710;1180;3557;838;2802;163;585;53;172;216;757
420350;201710;1394;3971;977;3137;165;581;524;1650;689;2231
420360;201710;2550;7630;1480;5221;301;1174;136;491;437;1665
420370;201710;1383;3885;1105;3434;136;504;780;2349;916;2853
420380;201710;4932;14186;3202;10575;744;2629;883;2868;1627;5497
420390;201710;1045;2757;666;1961;116;379;226;484;342;863
420395;201710;1068;3246;707;2452;108;410;77;240;185;650
420400;201710;958;2870;646;2204;127;489;139;439;266;928
420410;201710;576;1564;416;1278;40;148;297;901;337;1049
420415;201710;362;1124;274;928;86;312;74;240;160;552
420417;201710;673;2134;536;1806;117;423;201;663;318;1086
420419;201710;251;848;176;666;57;245;10;34;67;279
420420;201710;9478;27579;7136;23229;2640;9286;1422;4262;4062;13548
420425;201710;894;2356;623;1857;60;225;281;777;341;1002
420430;201710;3020;9016;1942;6471;443;1594;555;1697;998;3291
420435;201710;234;711;133;479;32;144;41;127;73;271
420440;201710;709;2104;389;1298;128;474;106;315;234;789
420445;201710;332;957;210;680;46;156;60;182;106;338
420450;201710;677;2057;478;1609;101;373;136;392;237;765
420455;201710;1841;5166;1456;4498;222;798;728;2135;950;2933
420460;201710;8063;22855;6058;19302;1196;4335;2451;7434;3647;11769
420470;201710;833;2216;455;1465;88;313;108;307;196;620
420475;201710;62;189;42;147;13;43;5;16;18;59
420480;201710;4408;12297;3043;9800;674;2341;854;2705;1528;5046
420490;201710;564;1487;296;1015;70;260;62;224;132;484
420500;201710;1307;3983;905;3165;234;881;272;939;506;1820
420510;201710;111;384;83;308;18;74;43;146;61;220
420515;201710;48;138;38;123;6;24;14;44;20;68
420517;201710;744;2175;674;2057;48;160;522;1581;570;1741
420519;201710;377;985;244;761;43;152;68;201;111;353
420520;201710;495;1311;230;783;28;93;26;65;54;158
420530;201710;1008;3059;730;2460;153;564;199;602;352;1166
420535;201710;254;727;114;390;29;100;11;37;40;137
420540;201710;20202;54292;13792;41453;2873;9549;4215;10866;7088;20415
420543;201710;295;776;231;656;50;127;113;313;163;440
420545;201710;1303;4056;1045;3503;249;888;336;1090;585;1978
420550;201710;3320;9985;2288;7987;577;2299;579;2063;1156;4362
420555;201710;316;948;236;785;46;154;86;278;132;432
420560;201710;433;1219;317;1008;53;166;178;555;231;721
420570;201710;2026;6228;1576;5272;336;1285;613;1899;949;3184
420580;201710;1627;4551;1270;3983;270;982;614;1837;884;2819
420590;201710;2901;8434;1787;5929;366;1339;305;813;671;2152
420600;201710;887;2828;766;2571;142;501;414;1394;556;1895
420610;201710;447;1346;247;889;57;219;53;181;110;400
420620;201710;473;1418;402;1284;120;408;124;384;244;792
420630;201710;765;2345;596;1951;134;487;249;752;383;1239
420640;201710;669;1931;310;1114;86;352;23;64;109;416
420650;201710;2386;6847;1537;5085;272;970;465;1377;737;2347
420660;201710;400;1170;273;908;55;199;65;204;120;403
420665;201710;520;1440;366;1180;61;238;155;454;216;692
420670;201710;1492;4294;1046;3385;186;736;320;906;506;1642
420675;201710;153;496;113;391;29;127;21;52;50;179
420680;201710;326;828;197;640;36;123;78;236;114;359
420690;201710;744;2551;527;1934;90;339;89;269;179;608
420700;201710;2790;8133;2187;6943;398;1410;853;2595;1251;4005
420710;201710;591;1895;443;1569;94;405;170;544;264;949
420720;201710;1396;3968;1057;3479;301;1031;435;1425;736;2456
420730;201710;2693;7757;2138;6841;411;1429;1034;3208;1445;4637
420740;201710;742;2252;527;1808;139;519;121;392;260;911
420750;201710;1789;5605;1287;4479;209;812;424;1329;633;2141
420757;201710;80;188;25;98;5;25;9;31;14;56
420760;201710;372;1145;172;581;37;122;20;61;57;183
420765;201710;483;1538;252;927;47;191;57;211;104;402
420768;201710;1110;3688;935;3338;292;1043;483;1772;775;2815
420770;201710;509;1397;249;906;50;209;55;197;105;406
420775;201710;559;1638;306;1046;67;248;42;124;109;372
420780;201710;1093;3240;645;2221;126;461;145;464;271;925
420785;201710;174;508;131;409;26;82;39;107;65;189
420790;201710;1027;3429;809;2991;210;843;332;1168;542;2011
420800;201710;748;2021;356;1171;79;296;109;334;188;630
420810;201710;1638;5553;1340;4884;440;1819;299;960;739;2779
420820;201710;8274;23057;5614;18712;1315;4879;1775;5587;3090;10466
420830;201710;2700;8164;2164;7143;562;2026;747;2382;1309;4408
420840;201710;834;2408;385;1360;77;292;61;195;138;487
420845;201710;1503;4208;953;3183;225;864;260;850;485;1714
420850;201710;1194;3902;753;2798;184;768;82;250;266;1018
420860;201710;302;837;186;625;45;179;41;128;86;307
420870;201710;863;2454;669;2131;255;903;196;579;451;1482
420880;201710;882;2916;690;2440;163;644;136;412;299;1056
420890;201710;7796;21379;4209;13928;747;2733;1047;3025;1794;5758
420895;201710;174;519;101;330;29;106;33;94;62;200
420900;201710;1444;3974;906;2976;179;698;284;815;463;1513
420910;201710;21982;63157;15002;49665;2666;10023;5042;15314;7708;25337
420915;201710;487;1916;341;1470;69;312;147;591;216;903
420917;201710;341;1018;185;581;30;100;84;247;114;347
420920;201710;127;375;53;193;5;20;7;22;12;42
420930;201710;16741;46490;12423;38969;2382;8179;5279;15888;7661;24067
420940;201710;2387;6798;1699;5476;449;1588;117;328;566;1916
420945;201710;150;466;110;372;28;110;36;112;64;222
420950;201710;424;1205;231;797;30;127;68;224;98;351
420960;201710;843;2360;622;1951;126;450;224;639;350;1089
420970;201710;2521;7545;1836;6222;545;1936;322;1140;867;3076
420980;201710;368;1111;288;994;118;431;94;353;212;784
420985;201710;384;1123;183;669;34;145;63;213;97;358
420990;201710;528;1567;305;1091;60;233;41;121;101;354
421000;201710;444;1531;303;1153;59;249;56;158;115;407
421003;201710;501;1317;189;627;23;74;24;61;47;135
421005;201710;114;357;84;301;20;81;40;154;60;235
421010;201710;3945;11139;2801;9119;665;2407;613;1801;1278;4208
421020;201710;402;1217;305;1048;26;100;197;684;223;784
421030;201710;696;2384;585;2114;190;761;119;395;309;1156
421040;201710;803;1948;495;1464;63;221;272;786;335;1007
421050;201710;1319;3717;752;2472;149;521;210;641;359;1162
421055;201710;176;486;88;292;22;74;22;67;44;141
421060;201710;501;1578;351;1207;71;283;128;425;199;708
421070;201710;553;1746;351;1231;80;302;44;144;124;446
421080;201710;663;2750;605;2655;74;244;462;2182;536;2426
421085;201710;435;1225;191;664;32;121;39;123;71;244
421090;201710;357;957;166;530;15;51;39;116;54;167
421100;201710;898;2331;454;1388;106;345;48;127;154;472
421105;201710;1313;3877;1053;3469;176;607;492;1695;668;2302
421110;201710;869;2838;758;2626;147;553;415;1404;562;1957
421120;201710;1061;3401;726;2638;105;441;186;581;291;1022
421125;201710;342;917;247;765;70;238;74;190;144;428
421130;201710;3026;9798;2620;9008;719;2676;1166;3994;1885;6670
421140;201710;280;809;207;660;38;121;87;257;125;378
421145;201710;460;1359;276;897;50;173;111;347;161;520
421150;201710;480;1361;323;1085;58;232;122;383;180;615
421160;201710;814;2180;440;1417;76;281;193;603;269;884
421165;201710;194;640;155;551;20;63;76;286;96;349
421170;201710;1143;3163;884;2759;136;442;541;1701;677;2143
421175;201710;1092;3061;738;2414;149;583;261;747;410;1330
421180;201710;433;1133;203;667;45;168;37;111;82;279
421185;201710;334;889;223;681;43;130;110;344;153;474
421187;201710;342;1019;226;745;33;112;88;268;121;380
421189;201710;361;1132;280;945;49;176;87;264;136;440
421190;201710;9274;26322;5843;19777;1226;4629;963;3055;2189;7684
421200;201710;765;2434;632;2176;138;512;237;781;375;1293
421205;201710;189;540;139;442;34;131;52;151;86;282
421210;201710;1052;3107;768;2517;194;668;262;850;456;1518
421220;201710;1472;4897;1260;4406;349;1359;189;577;538;1936
421223;201710;430;1333;297;1064;54;207;120;431;174;638
421225;201710;985;3156;841;2842;186;691;393;1350;579;2041
421227;201710;822;2301;568;1842;112;402;295;931;407;1333
421230;201710;433;1331;347;1177;103;372;119;396;222;768
421240;201710;327;1020;157;579;19;92;20;67;39;159
421250;201710;1393;3874;872;2977;222;817;208;717;430;1534
421260;201710;280;786;59;216;10;32;10;39;20;71
421265;201710;703;2111;633;2001;78;292;447;1385;525;1677
421270;201710;460;1306;247;871;50;173;67;230;117;403
421280;201710;1458;4577;1163;4011;266;1025;511;1729;777;2754
421290;201710;847;2361;488;1566;86;296;84;232;170;528
421300;201710;223;663;155;517;41;165;52;156;93;321
421310;201710;179;566;139;462;29;110;47;147;76;257
421315;201710;256;774;152;543;25;90;18;70;43;160
421320;201710;635;1941;374;1279;72;253;66;168;138;421
421330;201710;560;1776;420;1501;106;397;110;391;216;788
421335;201710;401;1338;329;1187;77;315;73;273;150;588
421340;201710;1367;3898;1084;3430;178;634;540;1665;718;2299
421350;201710;985;3120;792;2731;129;558;400;1301;529;1859
421360;201710;2406;6863;1493;5031;327;1313;493;1480;820;2793
421370;201710;463;1563;324;1205;89;348;78;292;167;640
421380;201710;781;2277;673;2082;109;363;358;1060;467;1423
421390;201710;165;460;70;238;19;73;20;61;39;134
421400;201710;241;810;175;681;57;245;67;235;124;480
421410;201710;218;645;118;433;16;71;50;185;66;256
421415;201710;339;1059;155;539;38;141;27;82;65;223
421420;201710;632;1866;490;1587;74;262;234;721;308;983
421430;201710;155;509;117;423;18;69;31;106;49;175
421440;201710;667;1931;461;1574;84;324;215;722;299;1046
421450;201710;391;1202;227;811;36;157;24;78;60;235
421460;201710;481;1401;284;1018;59;219;76;268;135;487
421470;201710;281;902;211;759;48;209;61;200;109;409
421480;201710;2630;7300;1753;5797;611;2316;285;788;896;3104
421490;201710;212;612;102;365;17;65;20;61;37;126
421500;201710;1813;6050;1378;5097;395;1631;153;521;548;2152
421505;201710;300;954;266;895;46;155;145;491;191;646
421507;201710;430;1280;285;985;76;285;74;245;150;530
421510;201710;196;619;149;505;33;108;67;200;100;308
421520;201710;615;1720;380;1189;56;209;164;462;220;671
421530;201710;290;920;170;617;37;165;38;111;75;276
421535;201710;504;1484;315;1097;37;147;150;481;187;628
421540;201710;226;605;155;484;32;110;62;180;94;290
421545;201710;682;2090;494;1718;116;461;177;587;293;1048
421550;201710;1896;5778;1625;5321;414;1525;687;2143;1101;3668
421555;201710;253;728;77;274;16;70;11;27;27;97
421560;201710;116;356;61;225;12;45;9;36;21;81
421565;201710;679;1923;524;1673;132;473;225;733;357;1206
421567;201710;505;1799;395;1504;196;772;73;283;269;1055
421568;201710;488;1470;322;1089;61;228;101;325;162;553
421569;201710;234;695;103;370;20;67;18;71;38;138
421570;201710;1095;3176;694;2304;181;626;114;348;295;974
421575;201710;331;1033;288;915;47;163;150;450;197;613
421580;201710;2657;8324;1982;6866;451;1778;618;1887;1069;3665
421590;201710;162;509;128;440;16;59;72;237;88;296
421600;201710;460;1376;331;1081;82;275;78;235;160;510
421605;201710;581;1738;399;1395;78;306;120;396;198;702
421610;201710;1210;3299;800;2517;146;517;225;675;371;1192
421620;201710;3741;10957;2318;8070;673;2534;523;1800;1196;4334
421625;201710;315;867;119;411;23;76;19;66;42;142
421630;201710;2630;7589;1455;4868;283;1092;271;791;554;1883
421635;201710;173;516;97;324;16;63;28;75;44;138
421640;201710;896;2568;619;2047;133;463;197;642;330;1105
421650;201710;2053;6313;1414;4915;320;1288;214;585;534;1873
421660;201710;6630;21182;5519;18922;1097;4147;1956;6223;3053;10370
421670;201710;884;2587;610;1993;148;559;204;633;352;1192
421680;201710;965;3063;779;2666;260;942;207;678;467;1620
421690;201710;1225;3929;901;3156;217;855;173;566;390;1421
421700;201710;447;1447;245;913;47;189;59;195;106;384
421710;201710;188;605;77;267;16;63;25;80;41;143
421715;201710;179;453;86;272;19;63;42;132;61;195
421720;201710;1788;5209;1062;3708;261;1005;234;754;495;1759
421725;201710;150;414;98;317;25;93;33;92;58;185
421730;201710;411;1203;214;691;35;123;64;181;99;304
421740;201710;592;1867;421;1457;99;395;98;314;197;709
421750;201710;877;2213;488;1480;64;204;178;499;242;703
421755;201710;256;713;138;431;17;64;53;152;70;216
421760;201710;932;2728;488;1681;81;298;103;313;184;611
421770;201710;2448;7056;1816;5887;451;1515;618;2138;1069;3653
421775;201710;312;900;223;742;37;134;97;303;134;437
421780;201710;847;2855;616;2314;125;524;169;573;294;1097
421790;201710;648;1710;379;1291;154;560;113;356;267;916
421795;201710;293;865;176;565;28;102;57;169;85;271
421800;201710;2358;7010;1757;5873;402;1468;711;2257;1113;3725
421810;201710;632;1811;449;1455;98;372;157;461;255;833
421820;201710;822;2401;449;1547;88;328;57;170;145;498
421825;201710;1269;3920;1188;3783;162;580;818;2539;980;3119
421830;201710;2219;7395;1939;6821;495;1918;633;2082;1128;4000
421835;201710;197;541;124;417;24;99;65;192;89;291
421840;201710;232;724;160;570;37;145;55;186;92;331
421850;201710;400;1233;225;798;41;162;53;165;94;327
421860;201710;270;849;178;643;32;139;52;154;84;293
421870;201710;3227;8959;2246;7013;549;1911;679;1983;1228;3894
421875;201710;367;1058;161;575;28;102;15;46;43;148
421880;201710;629;1886;464;1540;119;422;80;270;199;692
421885;201710;247;738;193;649;58;214;50;147;108;361
421890;201710;737;2492;614;2241;188;769;209;696;397;1465
421895;201710;331;1020;300;971;49;176;198;638;247;814
421900;201710;839;2290;564;1744;113;379;217;638;330;1017
421910;201710;383;1226;278;987;60;258;58;172;118;430
421915;201710;432;1290;261;876;54;175;42;132;96;307
421917;201710;556;1557;365;1274;123;473;84;295;207;768
421920;201710;568;1658;371;1353;178;650;112;440;290;1090
421930;201710;2431;6479;1234;4185;340;1248;155;492;495;1740
421935;201710;497;1624;387;1406;86;353;166;562;252;915
421940;201710;200;663;119;428;21;94;38;121;59;215
421950;201710;3070;8123;1434;4769;328;1219;199;633;527;1852
421960;201710;157;437;109;359;19;78;23;79;42;157
421970;201710;2044;5499;1118;3600;275;943;251;718;526;1661
421985;201710;353;891;187;571;30;113;49;157;79;270
422000;201710;1434;4172;1196;3739;217;795;641;1954;858;2749
430003;201710;489;1564;413;1423;110;433;131;412;241;845
430005;201710;298;842;194;637;51;164;86;281;137;445
430010;201710;1792;4806;1398;4130;267;874;708;2063;975;2937
430020;201710;600;1467;486;1318;81;251;291;750;372;1001
430030;201710;1007;2561;629;1852;189;575;161;483;350;1058
430040;201710;9827;25843;6307;19078;1603;5438;323;1038;1926;6476
430045;201710;598;1611;424;1242;51;161;205;575;256;736
430047;201710;280;654;124;376;23;73;33;96;56;169
430050;201710;938;2549;539;1678;120;375;126;371;246;746
430055;201710;290;748;133;407;12;41;67;191;79;232
430057;201710;60;150;31;92;9;31;5;9;14;40
430060;201710;15489;47646;13091;43612;3621;12956;4963;16763;8584;29719
430063;201710;872;2541;693;2143;162;494;364;1127;526;1621
430064;201710;1048;3113;787;2543;228;785;200;628;428;1413
430066;201710;132;311;89;241;6;21;55;141;61;162
430070;201710;654;1741;139;474;16;56;10;22;26;78
430080;201710;708;1909;414;1311;80;283;154;423;234;706
430085;201710;905;2271;544;1623;98;312;181;562;279;874
430087;201710;632;1972;535;1794;98;375;263;838;361;1213
430090;201710;651;1712;223;730;23;90;55;183;78;273
430100;201710;729;1862;372;1180;77;252;112;317;189;569
430105;201710;961;2721;651;2159;128;478;282;918;410;1396
430107;201710;196;619;140;474;21;76;35;106;56;182
430110;201710;1894;5174;1485;4538;283;907;738;2171;1021;3078
430120;201710;1366;4170;918;3095;209;719;377;1332;586;2051
430130;201710;3877;10771;3201;9719;977;2722;1155;4202;2132;6924
430140;201710;1001;3012;645;2194;166;573;213;721;379;1294
430150;201710;679;1762;383;1182;84;287;96;295;180;582
430155;201710;292;805;166;534;24;86;37;107;61;193
430160;201710;15831;44398;13590;40716;3467;10874;4883;15346;8350;26220
430163;201710;1958;5439;1533;4735;204;712;920;2816;1124;3528
430165;201710;404;949;95;309;9;27;9;25;18;52
430170;201710;886;2509;338;1211;68;248;52;165;120;413
430175;201710;724;2304;608;2016;158;507;272;922;430;1429
430180;201710;727;1967;591;1724;98;333;337;935;435;1268
430185;201710;453;1151;282;827;46;145;119;304;165;449
430187;201710;598;1680;461;1423;86;290;189;569;275;859
430190;201710;1403;4208;1205;3808;283;945;523;1624;806;2569
430192;201710;143;435;60;188;9;29;9;23;18;52
430195;201710;368;1110;77;249;11;38;4;9;15;47
430200;201710;1195;3773;997;3366;306;1070;301;995;607;2065
430205;201710;495;1422;393;1210;25;100;304;906;329;1006
430210;201710;5242;13716;3499;10074;527;1731;1371;3206;1898;4937
430215;201710;323;880;222;668;40;137;90;252;130;389
430220;201710;644;1623;201;652;35;117;38;110;73;227
430222;201710;220;680;177;584;25;90;74;224;99;314
430223;201710;292;826;244;735;46;140;114;347;160;487
430225;201710;33;83;12;37;3;7;3;6;6;13
430230;201710;1463;4393;1387;4292;282;791;993;3206;1275;3997
430235;201710;216;692;174;587;23;94;68;225;91;319
430237;201710;525;1325;377;1073;33;108;232;623;265;731
430240;201710;961;2347;651;1858;72;237;372;1028;444;1265
430245;201710;748;2284;580;1951;194;642;239;845;433;1487
430250;201710;1023;2897;855;2625;253;836;56;150;309;986
430258;201710;126;343;91;284;8;29;46;145;54;174
430260;201710;628;1771;459;1430;84;263;223;721;307;984
430265;201710;232;701;174;594;40;138;33;115;73;253
430270;201710;2529;6972;2189;6419;269;862;1422;4090;1691;4952
430280;201710;4492;11691;3493;9932;805;2346;1486;4239;2291;6585
430290;201710;2253;5858;2053;5570;95;310;1761;4715;1856;5025
430300;201710;8162;23237;6726;20567;1422;4675;3081;9416;4503;14091
430310;201710;6388;18463;4858;15489;947;3402;2121;6367;3068;9769
430320;201710;846;2428;492;1638;107;321;223;808;330;1129
430330;201710;625;1603;440;1247;119;349;181;454;300;803
430340;201710;710;1688;362;1097;69;227;175;514;244;741
430350;201710;5689;16741;4704;14687;1466;4765;1669;5031;3135;9796
430355;201710;349;872;118;373;24;85;10;31;34;116
430360;201710;795;2112;594;1743;128;393;204;567;332;960
430367;201710;250;678;158;494;45;165;49;149;94;314
430370;201710;472;1328;269;896;61;217;61;185;122;402
430380;201710;676;1734;373;1174;120;420;94;292;214;712
430390;201710;3088;8333;1788;5658;280;983;130;333;410;1316
430400;201710;1143;2700;862;2254;176;469;491;1247;667;1716
430410;201710;593;1529;414;1221;54;190;240;690;294;880
430420;201710;3027;8684;2349;7149;699;2245;764;2242;1463;4487
430430;201710;605;1631;342;1080;88;296;63;187;151;483
430435;201710;1695;4566;1241;3750;332;1038;340;1047;672;2085
430440;201710;3362;10384;2646;8784;591;2086;1204;4084;1795;6170
430450;201710;6348;17652;5256;15565;1326;4161;1948;5800;3274;9961
430460;201710;23867;69532;18327;59948;4581;16487;6215;19789;10796;36276
430461;201710;464;1205;139;443;18;59;33;97;51;156
430462;201710;271;743;174;575;30;108;35;133;65;241
430463;201710;4122;12653;3456;11451;701;2535;1671;5573;2372;8108
430465;201710;504;1361;418;1201;83;254;247;694;330;948
430466;201710;3469;9122;2947;8300;693;2083;1496;3995;2189;6078
430467;201710;462;1283;375;1117;61;203;173;485;234;688
430468;201710;1207;3346;1008;3023;179;584;538;1594;717;2178
430469;201710;541;1529;56;192;7;17;9;22;16;39
430470;201710;6416;17414;4615;14350;1480;4836;865;2775;2345;7611
430471;201710;484;1610;436;1498;101;360;168;565;269;925
430480;201710;907;2447;477;1537;82;291;70;197;152;488
430485;201710;146;427;64;212;9;35;14;38;23;73
430490;201710;324;913;188;616;30;108;82;281;112;389
430495;201710;371;1074;239;802;39;149;87;262;126;411
430500;201710;1076;2906;835;2509;208;704;342;957;550;1661
430510;201710;21315;59933;16081;49548;4187;14038;5158;14804;9345;28842
430511;201710;348;1061;144;508;23;74;14;41;37;115
430512;201710;921;2351;781;2117;215;598;237;678;452;1276
430513;201710;788;2059;419;1241;108;339;151;414;259;753
430515;201710;408;1171;289;928;56;162;135;456;191;618
430517;201710;1046;3277;848;2872;153;529;402;1402;555;1931
430520;201710;1343;3623;760;2393;141;476;147;429;288;905
430530;201710;1102;2893;427;1333;83;257;99;300;182;557
430535;201710;2559;7352;1889;6053;354;1206;789;2495;1143;3701
430537;201710;393;1322;326;1143;43;156;226;793;269;949
430540;201710;601;1360;372;1029;67;185;205;559;272;744
430543;201710;493;1126;401;1024;73;160;266;715;339;875
430544;201710;611;1923;479;1612;118;423;217;704;335;1127
430545;201710;1379;4322;1160;3978;334;1215;503;1756;837;2971
430550;201710;539;1512;301;985;64;220;53;149;117;369
430558;201710;71;225;46;161;12;43;13;38;25;81
430560;201710;408;962;176;531;15;56;50;138;65;194
430570;201710;955;2338;625;1750;94;334;324;805;418;1139
430580;201710;1159;2839;724;2129;115;382;348;988;463;1370
430583;201710;177;461;36;113;4;13;6;21;10;34
430585;201710;256;635;143;414;26;87;59;148;85;235
430587;201710;169;535;131;437;30;106;47;167;77;273
430590;201710;1296;3366;1150;3120;68;220;971;2586;1039;2806
430593;201710;16;58;14;51;3;13;7;25;10;38
430595;201710;278;800;75;271;8;37;12;41;20;78
430597;201710;314;903;215;662;19;71;81;211;100;282
430600;201710;1780;4811;885;2747;156;487;226;667;382;1154
430605;201710;1177;3478;916;2936;151;581;363;1146;514;1727
430607;201710;687;1585;499;1303;41;120;324;865;365;985
430610;201710;6252;16508;4692;14105;1418;4648;819;2528;2237;7176
430613;201710;286;682;96;297;5;20;29;74;34;94
430620;201710;591;1629;481;1414;125;411;209;584;334;995
430630;201710;455;1323;138;453;26;85;25;76;51;161
430632;201710;594;1652;280;878;35;121;105;297;140;418
430635;201710;553;1561;416;1272;73;248;241;719;314;967
430637;201710;437;1213;377;1107;56;193;213;583;269;776
430640;201710;1312;3492;678;2149;94;294;150;431;244;725
430642;201710;416;1127;276;845;50;153;117;358;167;511
430645;201710;275;621;104;288;21;60;27;74;48;134
430650;201710;1613;5147;1357;4605;330;1170;686;2352;1016;3522
430655;201710;151;380;117;334;28;82;48;128;76;210
430660;201710;4902;13534;3876;11732;895;2882;1676;5048;2571;7930
430670;201710;475;1320;397;1180;41;141;264;781;305;922
430673;201710;661;1563;273;813;55;164;85;248;140;412
430675;201710;225;669;58;208;11;48;12;39;23;87
430676;201710;3470;9956;2772;8689;561;1860;1168;3666;1729;5526
430680;201710;987;2756;600;1955;132;429;119;370;251;799
430690;201710;3380;9749;2829;8673;844;2743;735;2254;1579;4997
430692;201710;227;738;176;644;13;54;118;442;131;496
430693;201710;1069;2862;617;1920;138;468;117;325;255;793
430695;201710;546;1382;341;989;49;160;185;519;234;679
430697;201710;413;1125;297;925;59;184;130;433;189;617
430700;201710;7745;19778;4114;13089;843;2926;481;1556;1324;4482
430705;201710;254;748;164;535;30;104;48;152;78;256
430710;201710;1559;3903;1200;3294;230;709;551;1461;781;2170
430720;201710;678;1714;438;1335;115;350;136;428;251;778
430730;201710;1433;3753;917;2861;158;505;417;1341;575;1846
430740;201710;612;1748;344;1171;62;215;82;304;144;519
430745;201710;484;1375;244;796;36;123;48;153;84;276
430750;201710;1412;3804;1048;3177;223;737;509;1500;732;2237
430755;201710;476;1222;301;872;24;80;164;430;188;510
430760;201710;2213;5641;1626;4720;375;1194;640;1932;1015;3126
430770;201710;5489;15581;4394;13639;798;2690;2358;7166;3156;9856
430780;201710;2135;5711;1369;4346;253;832;471;1582;724;2414
430781;201710;408;1197;262;862;55;190;57;185;112;375
430783;201710;504;1205;293;843;38;123;141;378;179;501
430786;201710;59;203;42;159;8;29;9;34;17;63
430790;201710;3931;10753;2733;8311;526;1772;1253;3614;1779;5386
430800;201710;810;2207;560;1682;80;281;286;814;366;1095
430805;201710;522;1436;311;947;39;113;155;455;194;568
430807;201710;403;1074;268;813;34;122;105;303;139;425
430810;201710;721;1960;263;914;48;163;63;208;111;371
430820;201710;1266;3547;695;2345;150;528;133;442;283;970
430825;201710;309;836;116;351;28;75;23;56;51;131
430830;201710;1542;4747;1361;4441;156;561;928;3048;1084;3609
430840;201710;877;2609;761;2396;170;524;398;1263;568;1787
430843;201710;108;271;34;101;6;15;10;29;16;44
430845;201710;298;807;211;648;89;289;28;71;117;360
430850;201710;2174;6253;1829;5632;431;1447;846;2589;1277;4036
430860;201710;925;2368;460;1432;85;321;178;498;263;819
430865;201710;545;1442;476;1321;149;433;204;542;353;975
430870;201710;705;1905;327;1080;62;222;82;242;144;464
430880;201710;998;2722;724;2214;199;633;255;783;454;1416
430885;201710;236;567;121;391;11;40;85;268;96;308
430890;201710;1348;3604;893;2703;63;275;126;334;189;609
430900;201710;2641;6633;1910;5464;330;1068;931;2542;1261;3610
430905;201710;835;2363;564;1803;119;419;152;462;271;881
430910;201710;1414;4028;946;3029;192;722;367;1059;559;1781
430912;201710;478;1364;347;1128;40;139;215;709;255;848
430915;201710;530;1646;389;1394;106;375;139;545;245;920
430920;201710;17868;51226;15114;46342;2565;8646;8583;25609;11148;34255
430925;201710;134;300;58;159;8;18;20;60;28;78
430930;201710;8572;22701;5600;17558;1514;5035;1347;4456;2861;9491
430940;201710;1210;3642;674;2293;170;605;101;308;271;913
430950;201710;774;2043;519;1536;99;319;230;619;329;938
430955;201710;166;454;59;193;12;33;10;35;22;68
430957;201710;205;709;180;654;35;129;85;311;120;440
430960;201710;1346;3356;950;2680;202;643;466;1308;668;1951
430965;201710;1489;3969;1201;3460;80;280;935;2599;1015;2879
430970;201710;376;1017;200;640;23;76;89;277;112;353
430975;201710;502;1650;387;1368;91;344;146;513;237;857
430980;201710;370;937;224;679;47;153;84;254;131;407
430990;201710;534;1606;325;1076;54;207;129;413;183;620
430995;201710;617;1717;441;1387;95;298;192;578;287;876
431000;201710;1425;3515;646;1944;110;359;31;77;141;436
431010;201710;2275;6275;1318;4446;216;803;98;286;314;1089
431020;201710;9046;21469;5807;16192;1391;4134;1610;4291;3001;8425
431030;201710;321;905;138;483;33;113;15;57;48;170
431033;201710;2351;7128;1989;6522;524;1791;763;2630;1287;4421
431036;201710;200;526;66;206;6;12;15;41;21;53
431040;201710;899;2425;614;1913;116;427;285;815;401;1242
431041;201710;461;1126;378;1004;66;183;204;535;270;718
431043;201710;433;1139;222;742;83;287;54;169;137;456
431046;201710;130;347;65;189;7;21;14;38;21;59
431050;201710;1559;3918;1106;3178;237;693;524;1513;761;2206
431053;201710;484;1488;374;1264;116;414;85;290;201;704
431055;201710;629;1642;567;1545;51;149;416;1120;467;1269
431057;201710;271;809;151;503;31;111;44;130;75;241
431060;201710;4912;14395;4067;12823;1327;4544;832;2758;2159;7302
431065;201710;488;1358;334;1063;60;197;84;266;144;463
431070;201710;575;1681;321;1073;87;312;46;117;133;429
431075;201710;208;659;156;549;31;118;52;188;83;306
431080;201710;645;1874;446;1438;88;294;141;436;229;730
431085;201710;682;1892;521;1536;78;223;310;904;388;1127
431087;201710;476;1373;403;1218;28;85;273;838;301;923
431090;201710;472;1157;183;579;37;132;41;123;78;255
431100;201710;3042;8002;2417;6998;592;1859;882;2503;1474;4362
431110;201710;1394;3504;1015;2785;264;733;373;977;637;1710
431112;201710;510;1633;450;1513;101;344;229;756;330;1100
431113;201710;396;1150;323;1010;105;338;103;338;208;676
431115;201710;1206;3444;963;3013;165;582;527;1585;692;2167
431120;201710;2430;7269;1802;5967;573;2144;456;1374;1029;3518
431123;201710;406;1165;264;863;64;202;114;387;178;589
431125;201710;1222;3662;852;2854;282;952;207;772;489;1724
431127;201710;269;742;58;198;7;19;11;30;18;49
431130;201710;3111;8915;2133;6934;484;1657;658;2163;1142;3820
431140;201710;4587;11347;2546;7547;364;1170;863;2296;1227;3466
431142;201710;479;1380;381;1203;61;201;226;706;287;907
431150;201710;985;2893;734;2363;172;573;268;869;440;1442
431160;201710;734;2092;584;1799;144;424;210;710;354;1134
431162;201710;495;1206;218;684;28;99;48;134;76;233
431164;201710;157;427;48;166;9;37;6;20;15;57
431170;201710;616;1664;406;1261;114;371;106;320;220;691
431171;201710;673;1852;573;1678;95;297;308;879;403;1176
431173;201710;426;1210;323;1025;126;423;67;212;193;635
431175;201710;884;2430;655;2003;179;561;137;403;316;964
431177;201710;698;2192;508;1827;156;600;175;618;331;1218
431179;201710;337;698;70;192;10;31;16;33;26;64
431180;201710;2001;5429;1287;4037;304;1030;244;764;548;1794
431190;201710;492;1343;273;870;38;133;56;146;94;279
431198;201710;327;1065;291;992;100;352;88;328;188;680
431200;201710;387;1060;102;336;12;31;1;3;13;34
431205;201710;235;676;100;359;24;89;41;148;65;237
431210;201710;667;1770;559;1605;153;420;268;808;421;1228
431213;201710;226;707;179;615;21;78;106;367;127;445
431215;201710;272;849;188;638;25;96;70;220;95;316
431217;201710;152;448;98;334;16;57;44;148;60;205
431220;201710;717;1962;403;1305;38;142;169;501;207;643
431225;201710;1255;3413;973;2899;180;543;451;1364;631;1907
431230;201710;686;2038;515;1615;91;307;239;734;330;1041
431235;201710;130;356;30;92;7;22;2;4;9;26
431237;201710;421;1245;338;1111;60;232;171;540;231;772
431238;201710;20;65;15;50;5;19;4;11;9;30
431240;201710;3436;9837;2860;8835;693;2356;1185;3540;1878;5896
431242;201710;353;1043;291;920;71;218;117;385;188;603
431244;201710;320;777;167;478;23;82;60;133;83;215
431245;201710;1083;2864;741;2168;148;476;306;866;454;1342
431247;201710;206;590;119;391;22;72;29;91;51;163
431250;201710;1309;4064;1101;3751;263;923;478;1701;741;2624
431260;201710;295;801;143;495;15;68;40;124;55;192
431261;201710;260;853;217;754;42;158;87;293;129;451
431262;201710;404;1160;171;597;15;51;88;312;103;363
431265;201710;1326;3253;598;1803;92;297;180;447;272;744
431267;201710;275;769;154;459;6;23;99;273;105;296
431270;201710;2591;6294;1447;4325;394;1263;397;1221;791;2484
431275;201710;194;574;100;359;22;84;14;40;36;124
431280;201710;268;737;83;283;8;30;13;24;21;54
431290;201710;294;891;213;720;24;98;74;222;98;320
431295;201710;76;214;29;98;3;14;7;19;10;33
431300;201710;352;842;52;188;1;3;6;17;7;20
431301;201710;248;764;70;247;7;20;5;11;12;31
431303;201710;634;1643;362;1095;43;145;132;393;175;538
431306;201710;2062;5166;1233;3684;168;569;427;1169;595;1738
431308;201710;29;99;26;87;14;50;6;19;20;69
431310;201710;618;1794;363;1192;61;210;119;400;180;610
431320;201710;625;1770;313;1081;61;226;50;161;111;387
431330;201710;2040;5015;1027;3172;256;897;151;408;407;1305
431333;201710;349;946;128;389;15;42;33;90;48;132
431335;201710;34;104;23;81;9;30;3;3;12;33
431337;201710;2413;6985;1679;5609;473;1741;284;916;757;2657
431339;201710;491;1329;337;1015;69;224;173;512;242;736
431340;201710;19799;52424;14316;42789;3231;10559;3975;11492;7206;22051
431342;201710;507;1207;378;1005;63;204;263;662;326;866
431344;201710;360;977;240;747;11;39;156;481;167;520
431346;201710;274;689;98;303;14;43;21;66;35;109
431349;201710;736;2032;417;1279;63;205;144;410;207;615
431350;201710;3703;10613;2886;9076;727;2494;956;2891;1683;5385
431360;201710;645;1586;380;1127;79;247;150;429;229;676
431365;201710;1568;4396;1317;3989;149;495;875;2668;1024;3163
431370;201710;4240;11657;3307;10075;809;2623;1367;4342;2176;6965
431380;201710;742;2264;660;2114;83;290;403;1292;486;1582
431390;201710;2383;6258;1399;4364;261;914;423;1197;684;2111
431395;201710;1216;3484;928;2992;240;790;362;1200;602;1990
431400;201710;378;1136;184;605;30;93;42;136;72;229
431402;201710;984;2376;649;1782;110;322;360;941;470;1263
431403;201710;157;463;128;412;25;97;74;219;99;316
431405;201710;3818;10680;3147;9663;482;1679;1805;5458;2287;7137
431406;201710;517;1589;418;1406;99;332;223;758;322;1090
431407;201710;459;1302;308;993;68;216;116;366;184;582
431410;201710;13238;37192;8855;28556;2123;7749;2228;6821;4351;14570
431413;201710;173;441;58;191;5;21;11;28;16;49
431415;201710;636;1751;424;1371;98;363;129;366;227;729
431417;201710;468;1192;381;1052;65;191;225;609;290;800
431420;201710;1237;3275;1064;3003;216;619;474;1415;690;2034
431430;201710;515;1348;295;902;52;174;80;226;132;400
431440;201710;20434;54317;15765;46683;4261;13406;4329;13532;8590;26938
431442;201710;100;307;60;208;11;35;3;9;14;44
431445;201710;476;1358;163;539;25;79;32;101;57;180
431446;201710;374;1098;261;825;80;252;57;181;137;433
431447;201710;606;1682;412;1289;91;288;178;547;269;835
431449;201710;721;1956;498;1495;46;146;250;751;296;897
431450;201710;1989;4602;1706;4216;159;438;1291;3084;1450;3522
431454;201710;57;182;49;161;9;30;20;71;29;101
431455;201710;652;1645;336;952;52;158;131;326;183;484
431460;201710;2848;7725;2283;6628;618;1830;734;2182;1352;4012
431470;201710;1614;4607;1162;3629;240;788;420;1299;660;2087
431475;201710;205;594;30;119;3;14;1;1;4;15
431477;201710;577;1484;360;1034;43;124;173;449;216;573
431478;201710;275;723;76;230;15;51;7;17;22;68
431480;201710;2929;7797;2306;6798;354;1153;1298;3768;1652;4921
431490;201710;92094;243640;78506;223076;8739;28575;54722;151902;63461;180477
431500;201710;494;1331;371;1085;79;225;194;558;273;783
431505;201710;435;1085;284;834;29;84;167;495;196;579
431507;201710;344;821;153;433;35;113;58;144;93;257
431510;201710;1637;4561;1216;3715;251;828;464;1394;715;2222
431513;201710;301;759;144;439;18;51;81;246;99;297
431514;201710;87;244;42;139;7;28;12;31;19;59
431515;201710;563;1498;363;1105;74;249;162;455;236;704
431517;201710;72;241;53;185;11;37;10;33;21;70
431520;201710;480;1191;199;645;42;152;43;130;85;282
431530;201710;3902;9022;2494;6953;710;2035;388;1096;1098;3131
431531;201710;207;588;147;468;17;64;47;141;64;205
431532;201710;501;1344;379;1085;87;253;134;387;221;640
431535;201710;253;613;107;327;24;83;43;117;67;200
431540;201710;1907;6262;1761;6027;105;445;1307;4506;1412;4951
431545;201710;373;1024;69;230;6;28;18;52;24;80
431550;201710;1948;5609;1645;5027;375;1227;663;1942;1038;3169
431555;201710;657;1570;443;1215;45;131;270;744;315;875
431560;201710;18838;52730;13040;42355;2754;9856;3355;11617;6109;21473
431570;201710;5348;13100;4144;11491;862;2580;2206;6004;3068;8584
431575;201710;151;480;131;431;26;91;15;34;41;125
431580;201710;503;1379;258;869;48;196;85;279;133;475
431590;201710;848;2230;538;1621;114;361;181;550;295;911
431595;201710;359;1007;249;766;36;99;119;357;155;456
431600;201710;1652;4409;1196;3653;334;1127;277;846;611;1973
431610;201710;1340;3716;960;2970;124;379;463;1466;587;1845
431620;201710;521;1461;226;699;45;137;106;312;151;449
431630;201710;1237;3313;643;2038;175;568;163;476;338;1044
431640;201710;5957;16164;5366;15324;863;2506;3486;10090;4349;12596
431642;201710;497;1306;331;971;37;106;145;413;182;519
431643;201710;350;899;151;442;18;48;46;120;64;168
431645;201710;1594;4378;1316;3895;215;672;809;2412;1024;3084
431647;201710;145;416;91;292;11;42;22;57;33;99
431650;201710;248;746;173;580;29;106;51;161;80;267
431660;201710;960;2616;539;1762;85;317;119;320;204;637
431670;201710;1109;2828;822;2339;144;477;381;1007;525;1484
431673;201710;249;671;94;333;23;77;9;28;32;105
431675;201710;666;1697;133;457;14;55;34;106;48;161
431680;201710;7821;21456;5977;17897;1596;5001;1848;5602;3444;10603
431690;201710;18567;50979;14279;43493;3784;12109;4443;14104;8227;26213
431695;201710;136;376;92;295;22;74;30;73;52;147
431697;201710;446;1187;372;1065;71;205;183;544;254;749
431700;201710;1405;3883;1204;3515;198;573;652;1893;850;2466
431710;201710;10544;30045;8827;27385;2597;8455;2906;9843;5503;18298
431720;201710;5974;16282;4245;12757;1031;3274;824;2294;1855;5568
431725;201710;32;93;20;68;3;12;7;23;10;35
431730;201710;3340;9228;2551;7911;697;2362;759;2502;1456;4864
431740;201710;4663;12322;3432;10142;1092;3593;586;1500;1678;5093
431750;201710;7403;20802;6369;19135;1397;4537;2957;8980;4354;13517
431755;201710;318;879;67;246;12;45;13;47;25;92
431760;201710;3992;10630;3137;9158;427;1443;1779;4916;2206;6359
431770;201710;1804;4716;1480;4235;212;641;944;2667;1156;3308
431775;201710;200;548;102;325;26;90;8;20;34;110
431780;201710;1907;5154;1378;4114;308;942;436;1253;744;2195
431790;201710;991;2856;737;2323;150;509;258;784;408;1293
431795;201710;297;796;169;512;34;101;46;135;80;236
431800;201710;7080;20168;5511;17230;1831;6209;650;2109;2481;8318
431805;201710;316;751;94;306;7;25;30;100;37;125
431810;201710;2988;7772;2100;6055;424;1352;859;2330;1283;3682
431820;201710;2143;6438;1844;5899;375;1273;820;2625;1195;3898
431830;201710;9433;22224;7192;18975;1724;4935;2945;7826;4669;12761
431840;201710;2247;6675;1938;6110;408;1318;1012;3257;1420;4575
431842;201710;704;1778;244;772;32;117;65;186;97;303
431843;201710;304;865;241;738;29;99;112;326;141;425
431844;201710;269;727;77;250;20;74;13;28;33;102
431845;201710;479;1338;344;1044;21;59;213;640;234;699
431846;201710;270;800;229;738;18;81;179;567;197;648
431848;201710;188;502;96;311;7;26;14;35;21;61
431849;201710;445;1067;76;219;9;28;12;27;21;55
431850;201710;4104;11895;3408;10419;786;2566;1108;3316;1894;5882
431860;201710;719;1890;473;1399;95;287;217;613;312;900
431861;201710;113;307;49;166;8;28;13;36;21;64
431862;201710;470;1538;383;1376;71;277;189;687;260;964
431870;201710;16309;46583;13289;41091;2682;9188;5687;17190;8369;26378
431880;201710;3655;10470;2931;9094;640;2228;1157;3450;1797;5678
431890;201710;4366;11695;2938;8976;897;2963;465;1474;1362;4437
431900;201710;1024;2722;617;1907;136;468;265;771;401;1239
431910;201710;821;2016;347;1014;48;130;96;266;144;396
431912;201710;435;1295;364;1156;75;238;196;632;271;870
431915;201710;1016;2786;785;2384;171;570;377;1103;548;1673
431920;201710;1169;3134;979;2829;89;264;741;2145;830;2409
431930;201710;806;2285;556;1838;136;422;263;910;399;1332
431935;201710;54;176;43;153;11;40;9;29;20;69
431936;201710;309;914;191;629;51;180;47;152;98;332
431937;201710;223;604;132;406;33;108;22;57;55;165
431940;201710;2278;6083;1428;4340;309;1006;427;1214;736;2220
431950;201710;1480;4360;1273;4012;243;811;648;2018;891;2829
431960;201710;2637;7251;2162;6307;580;1766;627;1783;1207;3549
431970;201710;389;1055;175;588;45;155;42;130;87;285
431971;201710;82;227;47;163;8;24;7;23;15;47
431973;201710;452;1513;386;1382;36;126;270;983;306;1109
431975;201710;105;242;24;83;4;15;3;7;7;22
431980;201710;1159;3323;916;2874;214;703;342;1052;556;1755
431990;201710;5852;15510;3878;12357;745;2637;1073;3414;1818;6051
432000;201710;9131;25192;7308;21953;2190;6678;2624;7997;4814;14675
432010;201710;1878;5180;1486;4464;195;653;783;2274;978;2927
432020;201710;1949;4719;1437;3954;357;1059;702;1853;1059;2912
432023;201710;479;1264;278;856;43;162;133;355;176;517
432026;201710;1023;3088;763;2530;161;512;385;1278;546;1790
432030;201710;329;888;212;638;46;139;99;283;145;422
432032;201710;468;1249;310;927;33;113;147;406;180;519
432035;201710;753;2238;665;2092;218;747;213;665;431;1412
432040;201710;866;2064;418;1279;67;219;135;405;202;624
432045;201710;240;666;130;438;30;108;35;123;65;231
432050;201710;533;1473;446;1317;119;363;178;535;297;898
432055;201710;830;2224;545;1678;148;495;193;576;341;1071
432057;201710;347;861;244;676;39;90;122;321;161;411
432060;201710;484;1200;159;522;27;110;51;143;78;253
432065;201710;227;642;161;506;39;132;52;157;91;289
432067;201710;774;2358;617;2012;108;331;321;1052;429;1383
432070;201710;2159;5813;1339;4168;261;864;283;836;544;1700
432080;201710;3557;9693;2922;8582;784;2533;1113;3210;1897;5743
432085;201710;314;876;216;714;72;225;90;305;162;530
432090;201710;1321;3686;1014;3107;263;870;402;1194;665;2064
432100;201710;1196;3390;502;1721;82;311;37;94;119;405
432110;201710;2220;6496;1565;5152;362;1400;120;349;482;1749
432120;201710;3383;9958;2783;8870;957;3252;603;1926;1560;5178
432130;201710;2540;6842;2070;6240;739;2382;747;2286;1486;4668
432132;201710;283;788;140;475;19;64;44;141;63;205
432135;201710;749;2107;570;1732;90;298;361;1067;451;1365
432140;201710;1618;5122;1257;4425;243;879;579;2106;822;2985
432143;201710;1260;3622;1022;3221;163;553;555;1759;718;2312
432145;201710;1234;3685;779;2597;126;466;122;354;248;820
432146;201710;138;425;92;314;29;103;16;51;45;154
432147;201710;379;1273;309;1125;95;364;64;238;159;602
432149;201710;377;1026;232;691;29;93;102;291;131;384
432150;201710;3199;8915;2380;7355;565;1959;663;1961;1228;3920
432160;201710;4071;12468;3436;11381;1037;3639;1038;3434;2075;7073
432162;201710;355;842;53;159;9;25;7;21;16;46
432163;201710;255;694;54;173;5;16;3;11;8;27
432166;201710;572;1704;456;1452;86;322;145;384;231;706
432170;201710;1166;3467;791;2694;185;688;169;554;354;1242
432180;201710;2380;6261;1323;4118;289;977;269;723;558;1700
432183;201710;343;1083;252;863;80;298;48;161;128;459
432185;201710;824;2189;548;1673;51;155;324;964;375;1119
432190;201710;2451;6537;1590;4773;373;1195;538;1525;911;2720
432195;201710;998;2629;672;2063;177;513;206;650;383;1163
432200;201710;2562;7531;2032;6620;497;1715;876;2895;1373;4610
432210;201710;372;1040;258;834;49;184;105;320;154;504
432215;201710;724;2225;636;2074;91;293;394;1334;485;1627
432218;201710;241;626;136;394;20;54;48;129;68;183
432220;201710;3901;9951;3000;8486;459;1487;1684;4540;2143;6027
432225;201710;95;281;69;229;14;43;27;90;41;133
432230;201710;808;2100;456;1367;80;260;118;314;198;574
432232;201710;453;1162;337;969;55;183;166;472;221;655
432234;201710;277;712;139;424;35;102;23;58;58;160
432235;201710;102;295;38;132;7;25;2;6;9;31
432237;201710;402;1076;353;989;14;49;243;648;257;697
432240;201710;12891;38282;10746;35257;1123;4455;6630;22609;7753;27064
432250;201710;4077;13698;3663;12855;1129;4140;1239;4530;2368;8670
432252;201710;422;1061;275;802;44;147;126;346;170;493
432253;201710;1198;3757;665;2331;156;613;32;91;188;704
432254;201710;747;1997;194;642;41;158;17;46;58;204
432255;201710;183;447;84;263;13;45;27;68;40;113
432260;201710;6146;15641;4409;12671;1071;3205;1635;4881;2706;8086
432270;201710;2159;6395;1815;5740;550;1838;323;1028;873;2866
432280;201710;1210;3205;633;1983;101;327;200;591;301;918
432285;201710;189;589;21;73;2;5;1;1;3;6
432290;201710;408;1220;250;848;63;211;63;199;126;410
432300;201710;21632;62753;18683;57658;2992;10094;10993;33303;13985;43397
432310;201710;695;2052;544;1788;119;387;269;895;388;1282
432320;201710;221;533;78;241;10;38;14;42;24;80
432330;201710;271;693;89;293;12;31;18;63;30;94
432335;201710;170;482;69;247;14;54;11;32;25;86
432340;201710;304;738;153;470;29;105;46;122;75;227
432345;201710;600;1537;547;1463;47;172;388;982;435;1154
432350;201710;358;962;184;600;33;96;52;165;85;261
432360;201710;196;597;37;132;5;23;9;25;14;48
432370;201710;376;1006;256;770;19;65;161;479;180;544
432375;201710;602;1534;446;1260;67;193;254;709;321;902
432377;201710;223;737;29;112;3;14;7;18;10;32
432380;201710;1173;3511;773;2631;177;677;324;1042;501;1719
500020;201710;2129;5943;1645;5150;369;1306;719;2172;1088;3478
500025;201710;1283;2984;769;2111;66;186;439;1184;505;1370
500060;201710;6279;18869;4960;16497;703;2369;2974;10339;3677;12708
500070;201710;4038;11342;3116;9719;675;2306;1216;3922;1891;6228
500080;201710;1294;3680;914;2989;217;801;341;1085;558;1886
500085;201710;1928;4826;1327;3933;165;517;775;2270;940;2787
500090;201710;2004;5629;1384;4505;270;928;521;1803;791;2731
500100;201710;3015;8204;2375;7126;386;1313;1031;2909;1417;4222
500110;201710;6824;19897;5244;17449;1101;3947;1987;7257;3088;11204
500124;201710;2012;6455;1726;5968;426;1414;845;3251;1271;4665
500150;201710;1290;3163;823;2405;175;573;266;689;441;1262
500190;201710;4571;11516;3471;10046;723;2191;1800;5390;2523;7581
500200;201710;2247;5583;1669;4583;336;986;778;1991;1114;2977
500210;201710;4400;12709;3533;11352;872;2952;1547;5052;2419;8004
500215;201710;1223;3693;901;3049;133;500;410;1342;543;1842
500220;201710;2904;8551;2254;7412;374;1331;997;3303;1371;4634
500230;201710;2523;6307;1796;5161;265;797;930;2684;1195;3481
500240;201710;3885;11977;2728;9624;497;2018;726;2730;1223;4748
500260;201710;2933;6785;1820;5125;213;621;934;2567;1147;3188
500270;201710;108191;277722;67915;205251;15347;49848;16745;49714;32092;99562
500280;201710;1275;3283;970;2850;95;313;665;1932;760;2245
500290;201710;4029;8976;2239;6406;359;1127;784;2183;1143;3310
500295;201710;2492;6854;1443;4573;217;748;411;1105;628;1853
500310;201710;798;1987;631;1771;101;286;355;1016;456;1302
500315;201710;3148;9676;2591;8738;353;1212;1593;5619;1946;6831
500320;201710;16917;52223;12640;44330;3578;13585;3494;13074;7072;26659
500325;201710;3748;9108;2571;7357;376;1157;1482;4304;1858;5461
500330;201710;6606;16486;4411;12737;468;1478;2205;6494;2673;7972
500345;201710;1797;4589;1327;3925;362;1088;510;1507;872;2595
500348;201710;2281;6328;1886;5697;206;708;1205;3621;1411;4329
500350;201710;1243;3587;661;2218;69;236;222;778;291;1014
500370;201710;19867;57799;14525;48393;2961;11153;5177;17349;8138;28502
500375;201710;2487;6822;1776;5404;363;1205;521;1576;884;2781
500380;201710;3279;8587;2424;7173;638;1991;896;2690;1534;4681
500390;201710;497;1114;290;799;43;127;141;387;184;514
500400;201710;1181;3471;843;2694;198;666;235;710;433;1376
500410;201710;2181;6116;1760;5486;284;894;1066;3416;1350;4310
500430;201710;2550;6864;1848;5830;341;1213;712;2390;1053;3603
500440;201710;1265;3190;791;2385;133;407;295;938;428;1345
500450;201710;1170;3261;725;2352;150;513;91;241;241;754
500460;201710;3690;10551;2478;8178;586;2132;508;1694;1094;3826
500470;201710;2448;6989;1676;5381;499;1740;325;945;824;2685
500480;201710;2146;6495;1954;6235;143;418;1507;5138;1650;5556
500490;201710;809;2188;575;1799;154;542;145;470;299;1012
500500;201710;3804;10926;2827;9486;966;3687;681;2349;1647;6036
500510;201710;800;2053;500;1505;43;150;257;732;300;882
500515;201710;1944;4932;1562;4394;136;384;1061;3112;1197;3496
500520;201710;3146;10654;2639;9647;494;1998;1359;4946;1853;6944
500525;201710;988;3066;794;2740;136;534;397;1408;533;1942
500540;201710;5329;14176;3073;10030;780;3027;298;865;1078;3892
500560;201710;4954;15410;4297;14387;361;1299;3209;10938;3570;12237
500568;201710;4084;9616;2611;7392;606;2033;751;1966;1357;3999
500570;201710;6827;17263;4011;12131;1015;3286;709;2062;1724;5348
500580;201710;3216;9145;2605;8126;351;1112;1627;5109;1978;6221
500600;201710;3421;8777;2239;6779;466;1553;698;2086;1164;3639
500620;201710;7240;20346;5187;16362;794;2689;2407;7707;3201;10396
500625;201710;548;1576;300;1005;57;213;120;385;177;598
500627;201710;721;1897;451;1392;90;263;105;344;195;607
500630;201710;5559;14412;3620;11075;867;2823;999;3100;1866;5923
500635;201710;2543;9251;2111;8609;213;889;1503;6583;1716;7472
500640;201710;1632;3861;1173;3191;61;192;819;2165;880;2357
500660;201710;17518;50008;13255;43122;4220;15137;3141;10403;7361;25540
500690;201710;2303;6692;1715;5745;818;3011;187;611;1005;3622
500710;201710;3100;8959;2426;7710;631;2156;740;2331;1371;4487
500720;201710;5209;13513;3209;10198;905;3213;571;1793;1476;5006
500730;201710;883;2449;574;1842;121;423;175;551;296;974
500740;201710;4288;11079;3235;9188;273;905;1742;5023;2015;5928
500750;201710;906;2473;721;2126;125;418;323;887;448;1305
500755;201710;1003;2854;643;2137;126;437;109;306;235;743
500769;201710;5040;12988;2687;8308;489;1702;481;1186;970;2888
500770;201710;1634;4545;1053;3447;192;663;333;1103;525;1766
500780;201710;1234;3317;857;2588;219;679;216;631;435;1310
500790;201710;8476;22767;6937;20355;1358;4381;3641;10661;4999;15042
500793;201710;1954;5413;1403;4445;464;1520;207;594;671;2114
500795;201710;2237;6393;1901;5926;187;498;1444;4792;1631;5290
500797;201710;738;1959;501;1538;99;336;176;525;275;861
500800;201710;2754;7007;1954;5824;673;2268;344;1077;1017;3345
500830;201710;17542;45473;12184;35717;2107;6697;5088;14374;7195;21071
500840;201710;1149;3102;731;2275;89;293;283;826;372;1119
510010;201710;1383;3875;1081;3373;267;819;522;1700;789;2519
510020;201710;3306;8920;1906;6128;419;1403;404;1210;823;2613
510025;201710;6810;18878;4481;14423;887;3115;1270;3877;2157;6992
510030;201710;1858;4527;1363;3847;316;906;583;1674;899;2580
510035;201710;1010;2808;672;2277;114;395;383;1368;497;1763
510040;201710;1832;4630;1400;3998;145;425;861;2466;1006;2891
510050;201710;1771;4801;1225;3858;305;1086;519;1515;824;2601
510060;201710;1322;3574;1002;3049;156;505;493;1473;649;1978
510080;201710;1036;3173;814;2748;234;908;169;459;403;1367
510100;201710;669;1702;458;1305;54;159;216;587;270;746
510120;201710;271;540;160;403;8;23;109;274;117;297
510125;201710;2510;6417;1872;5356;310;1098;758;1984;1068;3082
510130;201710;1457;3972;1163;3468;310;979;341;1007;651;1986
510140;201710;2755;8214;2088;7312;829;3312;613;1915;1442;5227
510160;201710;1251;3989;1076;3722;216;763;669;2350;885;3113
510170;201710;4532;13256;3507;11453;723;2545;1506;4876;2229;7421
510180;201710;11650;29525;7702;23132;2132;6883;2080;7022;4212;13905
510185;201710;1563;4268;1123;3622;311;985;498;1915;809;2900
510190;201710;2276;6314;1567;5211;432;1595;554;1865;986;3460
510250;201710;13044;37862;11321;35403;2763;9147;5619;18263;8382;27410
510260;201710;2042;8516;1667;7765;258;1173;956;5061;1214;6234
510263;201710;3315;9170;2220;7171;499;1744;351;1100;850;2844
510267;201710;5362;15497;3443;11294;771;2661;673;2225;1444;4886
510268;201710;1322;3469;930;2765;130;398;523;1516;653;1914
510269;201710;1048;3085;699;2375;237;891;148;445;385;1336
510270;201710;2733;8708;2129;7535;475;1722;763;2644;1238;4366
510279;201710;1701;5025;1317;4262;296;1063;558;1697;854;2760
510285;201710;1179;3278;856;2732;236;807;243;758;479;1565
510300;201710;3432;9274;2712;8283;264;777;1863;5872;2127;6649
510305;201710;1312;4061;965;3379;221;800;312;1184;533;1984
510310;201710;759;2142;582;1841;207;672;172;567;379;1239
510320;201710;3667;10096;2759;8484;472;1640;961;2912;1433;4552
510325;201710;4684;14394;3850;13187;1086;3859;1889;6788;2975;10647
510330;201710;2682;8542;2010;7348;488;1853;706;2853;1194;4706
510335;201710;4881;14371;3776;12860;409;1478;2416;8765;2825;10243
510336;201710;474;1437;368;1251;63;227;180;626;243;853
510337;201710;1744;5529;1294;4695;500;1921;248;947;748;2868
510340;201710;69164;176540;46369;140705;14977;51366;8690;26201;23667;77567
510343;201710;1016;2967;717;2354;143;483;253;799;396;1282
510345;201710;1404;4146;1058;3470;202;671;420;1361;622;2032
510350;201710;2782;7504;1958;6259;502;1694;740;2456;1242;4150
510360;201710;1578;3765;1055;3110;66;256;785;2313;851;2569
510370;201710;1587;4930;1198;4252;208;785;651;2422;859;3207
510380;201710;501;1399;269;919;73;271;33;118;106;389
510385;201710;936;3534;680;2968;76;380;355;1688;431;2068
510390;201710;1052;3290;851;2976;229;807;383;1414;612;2221
510395;201710;730;1755;505;1408;57;177;252;755;309;932
510410;201710;3818;11948;3129;10632;795;2727;1482;5320;2277;8047
510420;201710;2153;5188;1587;4345;163;543;906;2440;1069;2983
510450;201710;599;1539;363;1115;86;284;58;175;144;459
510452;201710;637;1974;458;1592;83;274;226;794;309;1068
510454;201710;828;2517;658;2200;98;353;363;1234;461;1587
510455;201710;928;2772;677;2223;127;471;231;705;358;1176
510460;201710;2093;5349;1513;4515;164;600;872;2491;1036;3091
510480;201710;4102;10256;2916;8197;461;1369;1333;3577;1794;4946
510490;201710;1476;4468;1216;4097;284;1012;587;1971;871;2983
510500;201710;1440;4115;942;3163;172;686;403;1301;575;1987
510510;201710;2917;9595;2388;8552;731;2867;594;2251;1325;5118
510515;201710;5828;16111;3801;12240;877;3086;918;2675;1795;5761
510517;201710;1346;3923;1052;3389;314;1082;178;548;492;1630
510520;201710;1985;4337;1284;3455;46;138;796;2286;842;2424
510523;201710;892;2497;750;2251;87;264;499;1528;586;1792
510525;201710;4883;14639;3809;12433;797;2828;1247;3668;2044;6496
510530;201710;518;1361;381;1154;25;117;281;799;306;916
510550;201710;2742;8671;2053;7339;527;1996;659;2398;1186;4394
510558;201710;1886;5359;1579;4926;96;325;1005;3342;1101;3667
510560;201710;1628;4768;988;3602;239;967;229;885;468;1852
510562;201710;5163;14592;3768;11896;1005;3433;1034;3385;2039;6818
510590;201710;3097;7891;2313;6873;479;1332;1309;4146;1788;5478
510600;201710;1500;3699;971;2843;238;710;325;979;563;1689
510610;201710;2598;7186;2020;6316;210;745;1230;3797;1440;4542
510615;201710;1870;5428;1516;4877;420;1364;674;2304;1094;3668
510617;201710;766;2286;637;2084;30;79;531;1811;561;1890
510618;201710;1357;3805;977;3078;194;709;462;1360;656;2069
510619;201710;729;1959;414;1367;84;321;64;194;148;515
510620;201710;1301;3229;692;2195;176;627;106;311;282;938
510621;201710;965;2962;775;2621;176;655;232;761;408;1416
510622;201710;3643;10864;2690;8766;859;3042;584;1787;1443;4829
510623;201710;3090;8130;2249;6728;487;1703;735;2086;1222;3789
510624;201710;1649;4415;729;2483;120;463;106;302;226;765
510625;201710;1886;5096;1362;4219;369;1302;224;690;593;1992
510626;201710;1532;3863;947;3008;267;947;192;625;459;1572
510627;201710;586;1602;396;1228;111;368;94;289;205;657
510628;201710;1497;3555;1001;2874;190;542;556;1665;746;2207
510629;201710;1532;4885;1210;4176;323;1201;400;1423;723;2624
510630;201710;2836;8855;1847;6799;424;1681;308;1223;732;2904
510631;201710;430;1168;338;1015;4;8;264;808;268;816
510637;201710;2836;7669;2247;6708;691;2297;716;2085;1407;4382
510642;201710;4764;14974;3912;13706;1126;4272;1596;5843;2722;10115
510645;201710;895;1973;554;1526;155;425;169;492;324;917
510650;201710;6086;18752;5428;17968;935;3181;3816;13144;4751;16325
510665;201710;1710;4343;1041;3146;203;664;360;1124;563;1788
510670;201710;382;832;205;569;20;69;109;306;129;375
510675;201710;5819;17396;4465;14803;1245;4456;950;3133;2195;7589
510677;201710;1963;5159;1456;4464;196;642;903;2850;1099;3492
510680;201710;662;1941;461;1533;110;365;60;197;170;562
510682;201710;1836;5788;1365;4898;380;1472;289;1063;669;2535
510685;201710;868;2357;654;1995;94;322;321;913;415;1235
510700;201710;3827;9855;2565;8024;628;1993;1147;3776;1775;5769
510704;201710;9379;24163;6420;18890;1270;4083;2331;6551;3601;10634
510706;201710;1923;5552;1254;4540;248;956;616;2418;864;3374
510710;201710;2690;7313;1858;5641;378;1174;643;1863;1021;3037
510715;201710;708;1680;489;1318;73;196;189;515;262;711
510718;201710;2443;5541;1393;4282;594;1881;246;988;840;2869
510719;201710;379;858;232;660;35;120;119;333;154;453
510720;201710;1014;2552;691;2069;179;600;206;578;385;1178
510724;201710;695;2009;497;1642;102;366;199;619;301;985
510726;201710;724;1595;465;1215;62;183;309;773;371;956
510729;201710;678;1664;342;1033;61;208;93;263;154;471
510730;201710;2901;7756;2032;6253;548;1766;589;1866;1137;3632
510735;201710;913;2809;698;2498;93;374;435;1580;528;1954
510740;201710;1265;3497;915;2947;98;292;581;2037;679;2329
510757;201710;629;2068;517;1861;208;779;176;629;384;1408
510760;201710;32220;78094;20618;59861;6118;19825;4232;11379;10350;31204
510770;201710;4501;10433;3488;9282;350;818;2244;6695;2594;7513
510774;201710;366;1024;280;837;56;159;134;428;190;587
510775;201710;600;1757;455;1501;111;432;80;236;191;668
510776;201710;457;1279;354;1061;84;240;134;424;218;664
510777;201710;1628;4645;1206;4068;88;320;968;3291;1056;3611
510779;201710;574;1679;459;1478;54;152;280;940;334;1092
510780;201710;3450;9937;2748;8850;690;2304;1069;3810;1759;6114
510785;201710;1922;5246;1190;3913;300;1104;170;563;470;1667
510787;201710;2253;6482;1711;5537;791;2682;192;579;983;3261
510788;201710;644;1604;448;1314;79;220;175;616;254;836
510790;201710;13735;38823;8920;29472;2101;7989;1052;3136;3153;11125
510792;201710;8383;23368;5460;17888;1151;4124;1045;3361;2196;7485
510794;201710;1122;3398;828;2836;248;931;184;569;432;1500
510795;201710;7728;22163;5498;18083;1503;5404;1059;3626;2562;9030
510800;201710;1512;4068;1116;3473;235;768;505;1516;740;2284
510805;201710;1862;5120;1294;4113;263;893;480;1398;743;2291
510810;201710;630;1461;457;1230;111;306;231;601;342;907
510820;201710;774;1639;448;1205;64;212;187;479;251;691
510830;201710;716;1947;537;1683;105;318;280;934;385;1252
510835;201710;597;1650;423;1348;67;230;198;605;265;835
510840;201710;40158;99983;31705;88886;7027;19841;15530;45966;22557;65807
510850;201710;1657;4272;995;3140;307;1104;192;540;499;1644
510860;201710;2629;7739;1797;6212;614;2401;170;574;784;2975
510880;201710;562;1832;475;1668;128;476;209;743;337;1219
510885;201710;566;1521;428;1322;77;280;164;478;241;758
510890;201710;705;2146;583;1974;110;408;324;1110;434;1518
510895;201710;1205;3392;891;2840;220;776;306;899;526;1675
520005;201710;1822;5254;1506;4842;446;1366;676;2426;1122;3792
520010;201710;2053;6466;1505;5280;523;2064;265;816;788;2880
520013;201710;2807;7834;2056;6331;483;1550;604;1960;1087;3510
520015;201710;505;1395;401;1252;111;366;115;385;226;751
520017;201710;1024;2975;836;2662;199;673;391;1231;590;1904
520020;201710;362;921;294;829;78;236;153;414;231;650
520025;201710;30730;89569;27531;85584;3283;10899;20058;62461;23341;73360
520030;201710;4788;13928;3917;12505;542;1855;2203;7128;2745;8983
520050;201710;437;1087;270;776;19;47;154;459;173;506
520055;201710;854;2518;707;2235;100;300;384;1239;484;1539
520060;201710;1368;4082;1096;3571;272;989;296;933;568;1922
520080;201710;1780;4893;1434;4429;265;783;733;2463;998;3246
520082;201710;1022;2648;888;2425;107;240;567;1593;674;1833
520085;201710;700;2086;595;1911;148;463;200;629;348;1092
520090;201710;837;1889;598;1588;113;267;348;992;461;1259
520110;201710;37540;106298;28096;91459;10154;37584;1980;5942;12134;43526
520120;201710;184;464;106;330;11;34;39;122;50;156
520130;201710;3419;9270;3002;8622;657;2001;1546;4564;2203;6565
520140;201710;33813;103950;27609;92449;10137;36922;3078;10484;13215;47406
520145;201710;403;1086;287;883;68;219;91;265;159;484
520150;201710;495;1253;394;1131;64;189;233;671;297;860
520160;201710;808;2059;641;1808;124;354;276;798;400;1152
520170;201710;4695;10169;3532;8865;228;608;2942;7460;3170;8068
520180;201710;2071;5905;1727;5397;392;1333;772;2377;1164;3710
520215;201710;1889;4718;1457;4032;299;931;704;1889;1003;2820
520235;201710;645;1588;435;1270;61;198;172;482;233;680
520250;201710;1521;4114;1083;3421;296;1014;190;613;486;1627
520260;201710;779;1948;489;1421;76;231;199;579;275;810
520280;201710;588;1646;487;1458;149;431;193;634;342;1065
520310;201710;1225;2841;822;2204;215;599;279;817;494;1416
520320;201710;1842;5470;1516;4881;163;550;862;2836;1025;3386
520330;201710;2983;9036;2235;7698;559;2145;688;2358;1247;4503
520340;201710;1991;4854;1457;4077;178;440;969;2845;1147;3285
520350;201710;3048;7946;2265;6579;659;2064;736;2057;1395;4121
520355;201710;1564;4456;1268;3989;325;1124;533;1676;858;2800
520357;201710;803;2071;637;1821;49;148;440;1270;489;1418
520360;201710;691;1908;548;1667;175;561;166;522;341;1083
520380;201710;1305;3419;814;2461;110;374;357;985;467;1359
520390;201710;948;2240;558;1716;184;644;135;382;319;1026
520393;201710;522;1251;387;1048;44;121;193;488;237;609
520396;201710;737;2178;630;1984;110;352;402;1265;512;1617
520400;201710;1425;3964;1187;3628;238;759;707;2167;945;2926
520410;201710;1618;3642;1078;2900;144;424;656;1749;800;2173
520420;201710;351;922;259;730;25;75;169;446;194;521
520425;201710;1254;3224;889;2595;234;697;378;1118;612;1815
520430;201710;2022;5081;1138;3518;212;703;76;239;288;942
520440;201710;3368;8475;2224;6482;636;1977;513;1498;1149;3475
520450;201710;10822;28542;7396;22620;2228;7441;449;1424;2677;8865
520455;201710;666;1909;514;1666;182;641;135;442;317;1083
520460;201710;897;2537;759;2333;105;321;520;1637;625;1958
520465;201710;823;2244;695;2039;109;366;441;1227;550;1593
520470;201710;1731;5383;1520;5071;326;1106;942;3302;1268;4408
520480;201710;786;2296;512;1794;108;423;85;273;193;696
520485;201710;1407;4185;1212;3907;176;619;822;2646;998;3265
520490;201710;3706;11192;2939;9984;676;2321;1520;5308;2196;7629
520495;201710;1393;3447;1141;3117;77;223;851;2400;928;2623
520500;201710;1257;3524;1015;3151;246;850;424;1265;670;2115
520505;201710;697;1803;515;1551;119;350;245;740;364;1090
520510;201710;6595;18444;4926;15807;1186;4246;1424;4623;2610;8869
520520;201710;1047;2764;815;2429;254;762;259;857;513;1619
520530;201710;1819;5909;1453;5270;546;1964;335;1424;881;3388
520540;201710;2626;7142;1785;5541;451;1437;350;1145;801;2582
520545;201710;978;2808;775;2455;158;524;250;780;408;1304
520547;201710;657;1998;542;1787;155;518;196;624;351;1142
520549;201710;10145;29564;8401;26894;1964;6491;4170;13677;6134;20168
520551;201710;3916;11478;3426;10749;559;1981;2229;6867;2788;8848
520552;201710;719;2089;644;1995;86;260;461;1471;547;1731
520570;201710;577;1516;418;1265;115;360;141;436;256;796
520580;201710;2714;6380;1949;5375;253;737;1204;3384;1457;4121
520590;201710;1323;3738;983;3122;217;721;213;704;430;1425
520620;201710;7848;22182;6501;20357;1816;5912;2818;9023;4634;14935
520630;201710;980;2487;654;1939;106;323;236;673;342;996
520640;201710;2484;6596;1986;5762;445;1308;834;2462;1279;3770
520650;201710;861;2197;611;1758;96;289;320;931;416;1220
520660;201710;442;1071;252;762;67;222;52;173;119;395
520670;201710;941;2757;819;2572;61;204;628;1952;689;2156
520680;201710;745;1937;562;1646;123;355;248;750;371;1105
520690;201710;331;823;224;665;67;204;70;219;137;423
520710;201710;550;1396;352;1023;12;33;225;636;237;669
520725;201710;1504;3755;1111;3101;141;464;721;1965;862;2429
520735;201710;792;2069;549;1630;105;318;189;573;294;891
520740;201710;1776;4482;1438;4061;234;662;851;2466;1085;3128
520750;201710;678;1715;515;1472;102;271;232;710;334;981
520753;201710;1433;3697;1255;3433;156;397;786;2250;942;2647
520760;201710;965;2304;864;2173;105;211;668;1782;773;1993
520780;201710;1740;4276;1310;3653;147;426;721;1955;868;2381
520790;201710;3067;7578;2255;6351;178;468;1546;4557;1724;5025
520800;201710;15279;41472;12834;38482;2421;7002;7952;25372;10373;32374
520810;201710;1188;2745;902;2417;145;438;515;1453;660;1891
520815;201710;624;1919;448;1543;142;543;66;252;208;795
520830;201710;1657;4004;1249;3527;65;142;998;2826;1063;2968
520840;201710;1796;5550;1567;5191;609;2131;415;1491;1024;3622
520850;201710;606;1712;419;1415;113;433;102;343;215;776
520860;201710;6121;17654;4749;15434;1125;3960;1695;5651;2820;9611
520870;201710;83212;215473;60825;180956;18229;59045;14403;42168;32632;101213
520880;201710;6169;17707;4856;15741;1699;5988;976;3150;2675;9138
520890;201710;3755;9927;2820;8414;619;2077;1217;3552;1836;5629
520910;201710;3792;10096;2548;7929;815;2762;460;1398;1275;4160
520915;201710;637;1833;479;1504;94;318;190;588;284;906
520920;201710;3855;9729;2633;7937;407;1364;1215;3721;1622;5085
520929;201710;645;1673;493;1398;91;215;256;805;347;1020
520940;201710;1102;3040;874;2714;70;232;660;2066;730;2298
520945;201710;565;1305;441;1101;49;112;288;701;337;813
520960;201710;971;2693;764;2337;139;453;376;1126;515;1579
520970;201710;2433;7309;2067;6645;597;2103;473;1551;1070;3654
520980;201710;736;2023;614;1836;154;507;264;777;418;1284
520990;201710;2865;8998;2650;8686;304;1064;1774;6008;2078;7072
520993;201710;937;2343;692;1939;35;100;491;1386;526;1486
520995;201710;2143;5714;1792;5248;425;1254;874;2594;1299;3848
521000;201710;7052;20522;5517;17595;1706;5785;1308;4188;3014;9973
521010;201710;3816;10511;2932;8945;506;1533;1450;4423;1956;5956
521015;201710;650;1716;559;1571;77;220;392;1096;469;1316
521020;201710;2781;7731;1837;5806;512;1757;202;606;714;2363
521030;201710;591;1428;427;1170;63;154;197;583;260;737
521040;201710;6643;17127;5279;15011;1622;4841;1766;5227;3388;10068
521056;201710;806;2304;638;2019;194;644;176;608;370;1252
521060;201710;985;2545;774;2221;72;212;446;1318;518;1530
521080;201710;1085;2595;588;1768;72;238;220;578;292;816
521090;201710;2924;7683;2211;6636;697;2212;475;1465;1172;3677
521100;201710;1815;4265;1322;3577;230;603;756;2104;986;2707
521120;201710;4568;11280;3459;9843;573;1666;1598;4989;2171;6655
521130;201710;996;2535;680;1949;49;175;379;1071;428;1246
521140;201710;1064;3000;825;2565;167;547;288;903;455;1450
521150;201710;11194;27308;7318;21099;2222;6931;2223;6617;4445;13548
521160;201710;711;1613;472;1241;88;259;224;557;312;816
521170;201710;1056;2583;787;2164;88;254;498;1320;586;1574
521180;201710;5852;18189;5109;16828;1248;4373;1859;6245;3107;10618
521190;201710;9002;24882;5674;18722;1452;5170;1024;3491;2476;8661
521200;201710;749;1981;567;1678;61;202;313;914;374;1116
521205;201710;602;1638;467;1408;36;115;320;945;356;1060
521210;201710;814;2214;471;1482;116;413;65;162;181;575
521220;201710;4121;10185;2862;8356;612;1894;1066;3078;1678;4972
521225;201710;340;824;274;751;23;51;207;603;230;654
521230;201710;1232;3550;1129;3377;408;1227;549;1668;957;2895
521250;201710;29782;87315;24695;79890;10400;34730;6714;23452;17114;58182
521260;201710;712;1672;547;1438;92;275;303;787;395;1062
521270;201710;1729;4760;1553;4532;150;320;1207;3691;1357;4011
521280;201710;1837;5307;1441;4580;452;1556;435;1387;887;2943
521290;201710;431;1142;333;1007;66;231;177;524;243;755
521295;201710;1143;2648;930;2374;85;195;707;1890;792;2085
521300;201710;1806;4829;1501;4389;199;582;1013;3033;1212;3615
521305;201710;722;1946;559;1674;91;258;301;934;392;1192
521308;201710;4182;12179;3277;10421;662;2141;1532;4920;2194;7061
521310;201710;8095;22398;5481;17431;1404;4805;1370;4234;2774;9039
521340;201710;345;847;304;794;21;48;251;659;272;707
521350;201710;2041;5308;1616;4668;238;702;1057;3028;1295;3730
521370;201710;995;2707;635;2062;196;700;66;217;262;917
521375;201710;1367;3783;1053;3321;274;928;391;1274;665;2202
521377;201710;1229;2895;1011;2629;52;136;883;2297;935;2433
521380;201710;5914;16200;4109;12893;518;1698;1102;3571;1620;5269
521385;201710;586;1466;469;1328;114;325;204;621;318;946
521390;201710;715;1931;563;1714;175;589;176;546;351;1135
521400;201710;1953;5148;1679;4830;238;768;1199;3438;1437;4206
521405;201710;1332;3561;1023;3035;237;727;456;1388;693;2115
521410;201710;692;2003;622;1903;150;417;312;1040;462;1457
521440;201710;1385;3850;1073;3238;278;888;261;727;539;1615
521450;201710;3660;11503;2864;9886;814;2936;673;2406;1487;5342
521460;201710;6415;17915;5077;15534;1560;5120;1607;4777;3167;9897
521470;201710;606;1749;411;1311;80;250;90;275;170;525
521480;201710;367;1043;218;728;41;147;63;204;104;351
521483;201710;2531;6529;1872;5379;478;1428;526;1489;1004;2917
521486;201710;1648;4032;1300;3555;86;219;995;2720;1081;2939
521487;201710;464;1207;334;1011;74;237;128;393;202;630
521490;201710;828;2299;625;1942;36;136;425;1288;461;1424
521500;201710;1491;4084;1059;3356;157;585;520;1552;677;2137
521520;201710;794;1823;558;1485;98;266;260;724;358;990
521523;201710;13217;45155;11719;42008;3772;14417;2409;9294;6181;23711
521525;201710;1015;2523;812;2227;94;286;509;1360;603;1646
521530;201710;2030;5415;1247;3871;285;943;283;907;568;1850
521540;201710;865;2275;562;1753;92;353;246;758;338;1111
521550;201710;1423;3607;884;2520;179;557;352;1008;531;1565
521560;201710;3526;10763;2713;9645;733;2933;1278;4661;2011;7594
521565;201710;586;1471;490;1346;77;200;317;867;394;1067
521570;201710;3993;10934;2621;8245;589;2011;351;1140;940;3151
521580;201710;539;1294;304;915;49;152;59;184;108;336
521590;201710;608;1608;463;1359;122;407;192;527;314;934
521600;201710;401;1149;257;828;63;199;54;164;117;363
521630;201710;1355;3269;903;2608;226;732;261;705;487;1437
521640;201710;1983;4944;1526;4301;374;1038;687;1991;1061;3029
521645;201710;551;1583;375;1232;91;302;104;323;195;625
521680;201710;1196;3796;957;3296;308;1120;99;345;407;1465
521690;201710;475;1360;429;1283;99;312;220;644;319;956
521710;201710;2793;7842;2082;6544;443;1455;411;1286;854;2741
521720;201710;1942;5301;1496;4495;233;729;787;2300;1020;3029
521730;201710;3659;11307;2993;10017;1067;3930;471;1368;1538;5298
521740;201710;3564;9885;2847;8825;739;2523;1086;3533;1825;6056
521760;201710;13920;42462;11648;38777;3424;12473;3881;13286;7305;25759
521770;201710;2648;7294;1977;5992;661;2170;468;1346;1129;3516
521800;201710;5878;17435;4927;15799;1493;5024;1595;5507;3088;10531
521805;201710;857;1912;593;1541;198;488;222;634;420;1122
521810;201710;718;1741;504;1427;94;288;216;644;310;932
521830;201710;5067;15167;4303;14032;536;1927;2842;9191;3378;11118
521839;201710;675;1811;485;1460;106;347;187;531;293;878
521850;201710;5551;14732;4116;12386;1152;3740;728;2101;1880;5841
521860;201710;1804;4679;1342;3964;246;815;455;1316;701;2131
521870;201710;497;1569;401;1382;93;338;124;401;217;739
521878;201710;677;1901;483;1515;82;293;168;481;250;774
521880;201710;19630;49631;13499;40012;3487;10882;4108;12780;7595;23662
521890;201710;3122;8966;2228;7133;576;1971;311;935;887;2906
521900;201710;1438;3623;951;2892;219;687;315;934;534;1621
521910;201710;1166;2704;813;2286;97;287;489;1444;586;1731
521920;201710;359;1075;270;892;61;231;76;255;137;486
521925;201710;601;1770;471;1522;102;332;137;430;239;762
521930;201710;3606;10514;2979;9522;998;3237;842;2813;1840;6050
521935;201710;641;1767;520;1532;131;378;217;637;348;1015
521940;201710;1082;2727;819;2376;204;670;385;1082;589;1752
521945;201710;579;1755;484;1586;87;291;237;830;324;1121
521950;201710;612;1528;505;1384;41;116;394;1087;435;1203
521960;201710;665;1920;485;1557;77;260;218;675;295;935
521970;201710;2630;6806;2204;6304;151;385;1799;5341;1950;5726
521971;201710;892;2305;599;1820;131;414;148;444;279;858
521973;201710;1012;2934;840;2657;127;445;467;1467;594;1912
521975;201710;12030;32850;10588;31014;1830;5585;6760;19833;8590;25418
521980;201710;2303;5948;1881;5398;205;520;1422;4179;1627;4699
521990;201710;1146;3243;922;2880;125;399;541;1748;666;2147
522000;201710;2347;6618;1751;5860;202;664;982;3573;1184;4237
522005;201710;346;843;251;700;77;199;87;261;164;460
522010;201710;3401;9105;2641;7892;894;2775;597;1784;1491;4559
522015;201710;893;2566;714;2262;164;546;281;886;445;1432
522020;201710;4956;12515;3562;10289;891;2679;1482;4300;2373;6979
522026;201710;694;1903;523;1679;91;306;283;959;374;1265
522028;201710;503;1381;363;1077;58;183;166;463;224;646
522040;201710;2472;5686;1786;4845;297;812;1186;3255;1483;4067
522045;201710;15012;46844;11882;40550;3143;11618;2194;7437;5337;19055
522050;201710;1068;2985;747;2374;157;522;235;685;392;1207
522060;201710;2290;6713;1923;6136;345;1145;1072;3488;1417;4633
522068;201710;1645;4886;1433;4633;190;551;1010;3451;1200;4002
522070;201710;604;1735;524;1600;62;255;355;1030;417;1285
522100;201710;530;1478;414;1306;88;299;200;625;288;924
522108;201710;820;2475;680;2246;54;249;514;1627;568;1876
522119;201710;1477;4131;1204;3742;217;684;634;2036;851;2720
522130;201710;342;939;271;840;72;230;128;410;200;640
522140;201710;15504;43764;12103;37711;3908;12992;1906;5809;5814;18801
522145;201710;811;2072;612;1781;144;377;328;1040;472;1417
522150;201710;932;2367;735;2071;212;589;279;821;491;1410
522155;201710;856;2401;731;2208;152;416;371;1188;523;1604
522157;201710;577;1585;487;1451;30;115;356;1035;386;1150
522160;201710;5994;16329;4188;13077;1211;4112;389;1327;1600;5439
522170;201710;2270;6482;1686;5386;572;1950;298;962;870;2912
522180;201710;420;1133;268;861;64;210;50;181;114;391
522185;201710;15101;40568;11839;36375;4166;13568;4125;13592;8291;27160
522190;201710;824;1990;629;1717;123;319;286;832;409;1151
522200;201710;1653;5155;1210;4156;264;953;194;661;458;1614
522205;201710;1367;3520;1069;3084;102;325;747;2162;849;2487
522220;201710;1469;3662;1102;3158;155;402;621;1900;776;2302
522230;201710;1226;3248;1008;2921;168;545;577;1677;745;2222
530010;201710;169134;507902;147020;470834;34227;121691;67312;210207;101539;331898
110001;201709;3087;9842;2620;9060;674;2455;1177;4115;1851;6570
110002;201709;10914;30837;8274;26304;2653;9043;2553;8082;5206;17125
110003;201709;656;1994;504;1691;161;573;91;284;252;857
110004;201709;7650;23686;6127;20654;1910;6800;1179;4371;3089;11171
110005;201709;1861;5395;1383;4537;349;1203;541;1815;890;3018
110006;201709;1577;4678;1027;3500;315;1135;111;367;426;1502
110007;201709;1226;3548;997;3141;307;1012;355;1302;662;2314
110008;201709;2339;7685;2137;7407;266;861;1650;5966;1916;6827
110009;201709;4014;11982;2972;10267;916;3287;882;3201;1798;6488
110010;201709;5695;19437;4942;18215;1516;5432;2136;8847;3652;14279
110011;201709;6048;18282;4952;16155;1695;5794;1245;4090;2940;9884
110012;201709;13464;37269;10077;31500;2683;8793;2069;6623;4752;15416
110013;201709;5070;15843;4263;14303;1741;5993;882;3217;2623;9210
110014;201709;3484;9785;2772;8594;845;2719;1146;3488;1991;6207
110015;201709;4522;13155;3001;10091;788;2810;412;1396;1200;4206
110018;201709;3338;9182;2273;7430;573;2099;658;2074;1231;4173
110020;201709;61573;164095;45097;141207;10319;34058;17886;59540;28205;93598
110025;201709;3998;11052;3107;9484;524;1714;1817;5407;2341;7121
110026;201709;507;1545;445;1439;136;482;186;596;322;1078
110028;201709;5573;16487;4189;13716;1253;4424;511;1653;1764;6077
110029;201709;1174;3156;854;2674;224;724;370;1176;594;1900
110030;201709;9453;25556;7136;22177;1664;5789;2746;8494;4410;14283
110032;201709;3164;9715;2492;8333;856;2911;614;2069;1470;4980
110033;201709;4349;14096;3691;12861;1325;4653;1055;4061;2380;8714
110034;201709;3172;8488;2466;7488;834;2678;1099;3342;1933;6020
110037;201709;1595;5350;1358;4842;341;1274;625;2212;966;3486
110040;201709;2925;8895;2314;7760;739;2649;658;2122;1397;4771
110045;201709;4457;14206;3876;13404;1282;4767;1561;5399;2843;10166
110050;201709;1550;4832;1261;4274;532;1852;309;1065;841;2917
110060;201709;765;2479;588;2096;210;796;68;265;278;1061
110070;201709;1854;6146;1548;5436;551;2033;405;1384;956;3417
110080;201709;4562;12194;3668;11102;999;3179;1765;5518;2764;8697
110090;201709;611;1746;436;1423;119;421;188;584;307;1005
110092;201709;1129;3567;968;3316;164;614;540;1891;704;2505
110094;201709;3035;9017;2478;8137;850;2903;845;2840;1695;5743
110100;201709;1884;5903;1661;5493;369;1307;858;2838;1227;4145
110110;201709;1520;4670;1221;4207;447;1596;276;1028;723;2624
110120;201709;1472;4566;1114;3808;333;1203;232;795;565;1998
110130;201709;2301;6245;1587;5048;435;1530;471;1488;906;3018
110140;201709;2134;6886;1644;5874;457;1730;380;1300;837;3030
110143;201709;1348;3823;988;3155;350;1135;277;893;627;2028
110145;201709;985;2774;654;2135;159;560;221;711;380;1271
110146;201709;375;1102;294;982;55;177;143;502;198;679
110147;201709;597;1709;416;1356;110;369;148;462;258;831
110148;201709;997;3038;614;2130;111;413;75;266;186;679
110149;201709;2867;8476;2163;7328;827;2769;685;2514;1512;5283
110150;201709;2085;5978;1679;5404;730;2598;370;1120;1100;3718
110155;201709;696;2175;587;1929;135;472;231;733;366;1205
110160;201709;1577;5062;1266;4416;479;1653;291;1086;770;2739
110170;201709;2166;6162;1591;5086;366;1231;756;2377;1122;3608
110175;201709;1440;4330;1136;3886;179;667;593;2130;772;2797
110180;201709;1095;3151;881;2802;260;798;391;1293;651;2091
120001;201709;2676;8849;2368;8377;496;1778;1394;5180;1890;6958
120005;201709;1647;6649;1529;6436;180;816;1123;4909;1303;5725
120010;201709;4736;15768;4468;15345;613;2043;3241;11476;3854;13519
120013;201709;1973;7845;1880;7712;485;1920;1098;4844;1583;6764
120017;201709;1911;6813;1754;6538;407;1532;945;3792;1352;5324
120020;201709;13644;59828;13122;58797;1582;7511;9705;44578;11287;52089
120025;201709;2256;7744;2161;7601;442;1567;1329;4795;1771;6362
120030;201709;6343;24929;6170;24714;303;1533;5424;21727;5727;23260
120032;201709;1526;7319;1458;7151;124;741;1122;5514;1246;6255
120033;201709;3719;14600;3544;14304;172;870;3086;12439;3258;13309
120034;201709;2102;8630;1950;8349;138;837;1559;6570;1697;7407
120035;201709;3104;13813;3010;13636;202;1083;2564;11662;2766;12745
120038;201709;2470;8711;2329;8453;566;2084;1270;4754;1836;6838
120039;201709;1783;8383;1730;8287;186;1162;1280;6101;1466;7263
120040;201709;38706;136905;35729;131812;7460;29433;20193;75655;27653;105088
120042;201709;3055;12341;2878;11954;168;893;2291;9482;2459;10375
120043;201709;1087;4945;1041;4845;62;343;906;4247;968;4590
120045;201709;4667;15028;4406;14745;248;951;3971;13254;4219;14205
120050;201709;7882;31819;7529;31093;884;4014;5534;23356;6418;27370
120060;201709;7870;34263;7651;33876;640;3398;6239;27816;6879;31214
120070;201709;2640;9540;2524;9317;366;1341;1737;6633;2103;7974
120080;201709;3682;13640;3486;13308;602;2419;2395;9309;2997;11728
130002;201709;3063;12658;2862;12370;121;656;2570;11143;2691;11799
130006;201709;2175;8885;1891;8362;152;811;1439;6360;1591;7171
130008;201709;2302;8764;2112;8415;102;527;1751;6987;1853;7514
130010;201709;3342;10429;3056;10093;97;390;2817;9304;2914;9694
130014;201709;3011;9605;2560;8850;424;1553;1651;5789;2075;7342
130020;201709;2670;10292;2524;10050;129;741;2102;8281;2231;9022
130030;201709;8288;30108;7865;29633;193;557;7391;28384;7584;28941
130040;201709;3582;10955;3115;10350;247;858;2514;8516;2761;9374
130050;201709;6206;25251;5849;24784;239;973;5245;22724;5484;23697
130060;201709;6247;27895;5820;27207;532;3096;4519;21095;5051;24191
130063;201709;4542;18332;4225;17951;180;929;3846;16416;4026;17345
130068;201709;3211;13103;2895;12443;223;1144;2198;9477;2421;10621
130070;201709;7875;26206;7119;25341;394;1303;6214;22684;6608;23987
130080;201709;5650;23976;5210;23368;486;2701;4075;18331;4561;21032
130083;201709;2313;8808;2150;8564;221;1037;1660;6579;1881;7616
130090;201709;2852;9699;2684;9456;66;285;2397;8570;2463;8855
130100;201709;6042;21478;5762;21164;112;387;5506;20413;5618;20800
130110;201709;6553;20923;6108;20399;552;1612;5127;17645;5679;19257
130115;201709;4836;16556;4591;16177;136;486;4056;14442;4192;14928
130120;201709;14536;54525;13582;53283;1381;5615;10949;43865;12330;49480
130130;201709;4049;15812;3929;15627;480;2168;3008;11906;3488;14074
130140;201709;6157;24084;6040;23957;237;1043;5616;22325;5853;23368
130150;201709;3366;13533;3301;13452;112;640;3035;12329;3147;12969
130160;201709;4340;17512;4071;17162;343;1767;3371;14297;3714;16064
130165;201709;2922;11894;2797;11677;128;723;2439;10155;2567;10878
130170;201709;9879;32586;8350;30789;700;2850;6824;25661;7524;28511
130180;201709;3585;11905;3526;11832;50;191;3384;11394;3434;11585
130185;201709;13002;38553;11281;36674;515;1254;9856;33495;10371;34749
130190;201709;16159;56012;14109;53230;1889;7159;10118;39593;12007;46752
130195;201709;1991;8327;1878;8180;96;403;1681;7470;1777;7873
130200;201709;1999;6569;1784;6262;185;653;1362;4924;1547;5577
130210;201709;1384;5330;1258;5181;113;649;998;4030;1111;4679
130220;201709;1949;7809;1794;7532;159;782;1336;5666;1495;6448
130230;201709;3717;17170;3463;16772;353;1955;2764;13597;3117;15552
130240;201709;9380;33016;8250;31388;264;1530;7213;27477;7477;29007
130250;201709;20835;70482;19479;68852;1784;6145;15931;58091;17715;64236
130255;201709;4034;14365;3736;13880;262;1154;3048;11350;3310;12504
130260;201709;225109;720679;199881;679296;60538;219541;82331;282883;142869;502424
130270;201709;7389;30141;6757;29141;808;3691;5013;22260;5821;25951
130280;201709;3323;13911;3200;13766;89;400;2996;13058;3085;13458
130290;201709;11377;40651;10649;39826;209;497;10131;38694;10340;39191
130300;201709;4445;16788;4227;16454;242;1191;3657;14231;3899;15422
130310;201709;5331;19833;4887;19242;394;1596;4016;16110;4410;17706
130320;201709;2993;10761;2741;10415;344;1287;1981;7783;2325;9070
130330;201709;3889;13723;3434;13143;152;800;2990;11395;3142;12195
130340;201709;18695;69104;17124;67215;1630;6280;14142;57204;15772;63484
130350;201709;3507;13940;3363;13731;202;1199;2869;11579;3071;12778
130353;201709;5866;18096;5163;17205;868;2769;3575;12676;4443;15445
130356;201709;4582;16389;4239;15831;495;1953;3041;11620;3536;13573
130360;201709;3249;9547;2842;9121;86;227;2659;8663;2745;8890
130370;201709;5481;21686;4990;21038;200;1135;4292;18163;4492;19298
130380;201709;7325;30859;7073;30475;445;2390;6124;26234;6569;28624
130390;201709;5184;22903;4881;22337;511;2734;3706;16915;4217;19649
130395;201709;2279;7721;2022;7265;241;900;1431;5174;1672;6074
130400;201709;2105;7822;1954;7606;104;461;1727;6777;1831;7238
130406;201709;10598;39870;9552;38448;1762;7366;6526;26757;8288;34123
130410;201709;3932;14601;3473;13796;1046;4366;1636;6725;2682;11091
130420;201709;10792;44197;10193;43371;1209;5525;8011;34639;9220;40164
130423;201709;3626;13190;3357;12833;183;952;2911;10988;3094;11940
130426;201709;2483;10303;2410;10183;96;469;2196;9368;2292;9837
130430;201709;3690;12275;3499;11997;408;1365;2764;9672;3172;11037
130440;201709;3792;13270;3481;12906;116;456;3201;11971;3317;12427
140002;201709;1737;5633;1573;5422;116;480;1239;4231;1355;4711
140005;201709;3336;9206;3197;9058;55;179;3086;8753;3141;8932
140010;201709;48505;137630;39145;124080;9635;32092;15720;53104;25355;85196
140015;201709;3094;9789;2816;9467;143;453;2503;8566;2646;9019
140017;201709;3293;10582;2953;10136;281;957;2220;7973;2501;8930
140020;201709;4638;15056;4119;14348;428;1752;3082;10738;3510;12490
140023;201709;2103;6909;1810;6459;236;895;1260;4568;1496;5463
140028;201709;2027;5552;1802;5256;206;685;1348;3830;1554;4515
140030;201709;3713;11407;3424;11031;420;1217;2636;8761;3056;9978
140040;201709;1841;8269;1767;8168;81;496;1611;7415;1692;7911
140045;201709;2466;9284;2166;8866;382;1538;1440;6254;1822;7792
140047;201709;5570;16960;4821;15776;1125;3743;2467;8609;3592;12352
140050;201709;1394;4279;1209;4004;179;569;801;2741;980;3310
140060;201709;1329;3906;1187;3698;120;369;932;2945;1052;3314
140070;201709;1689;9210;1635;9063;147;1021;1282;7080;1429;8101
150010;201709;37161;104343;34775;101088;1728;5674;29565;85633;31293;91307
150013;201709;1678;4839;1487;4623;151;437;1117;3587;1268;4024
150020;201709;12347;41064;11950;40510;1299;3643;9839;34623;11138;38266
150030;201709;7732;31929;7488;31584;454;1966;6527;27940;6981;29906
150034;201709;3941;10944;3467;10264;254;786;2836;8431;3090;9217
150040;201709;12431;38624;11174;37152;1115;2937;9125;32133;10240;35070
150050;201709;5868;22551;5572;22076;175;917;4985;19774;5160;20691
150060;201709;17709;53875;15725;50727;3784;12068;8550;28959;12334;41027
150070;201709;6192;24725;5588;24061;172;915;5152;22398;5324;23313
150080;201709;78595;196414;67404;181734;15365;42803;28287;83959;43652;126762
150085;201709;5652;18640;5362;18285;230;632;4896;17040;5126;17672
150090;201709;9898;37958;9425;37233;731;3177;7591;30241;8322;33418
150095;201709;5298;16984;4809;16306;288;929;3957;13747;4245;14676
150100;201709;3107;11316;2855;10856;223;935;2197;8335;2420;9270
150110;201709;3660;17145;3626;17094;242;1119;3216;15382;3458;16501
150120;201709;6778;23775;6598;23512;347;1047;5750;21174;6097;22221
150125;201709;730;2033;612;1890;110;375;383;1167;493;1542
150130;201709;21551;65034;19668;62313;2457;7174;14279;46864;16736;54038
150140;201709;174067;464479;158913;444624;23973;65830;107881;310087;131854;375917
150145;201709;4406;13639;3970;13063;550;1661;3043;10354;3593;12015
150150;201709;12254;35718;11293;34364;1309;4142;8292;25582;9601;29724
150157;201709;3058;9038;2627;8454;308;1095;1823;5978;2131;7073
150160;201709;2926;9237;2767;8994;707;2284;1547;5176;2254;7460
150170;201709;23261;79395;20782;75689;3375;11940;13472;52030;16847;63970
150172;201709;3290;10564;2850;9878;287;961;2144;7661;2431;8622
150175;201709;1739;5318;1592;5119;139;510;1252;4090;1391;4600
150178;201709;9595;28476;8158;26763;688;2297;6382;21533;7070;23830
150180;201709;19062;75032;18274;73975;1041;4591;15824;64767;16865;69358
150190;201709;6827;23475;6572;23143;188;842;6010;21198;6198;22040
150195;201709;5309;17130;5085;16775;105;374;4715;15624;4820;15998
150200;201709;5256;16375;4934;16001;62;184;4688;15345;4750;15529
150210;201709;24206;90298;23448;89274;1632;6300;19772;77136;21404;83436
150215;201709;7103;22089;6272;20800;2079;7013;2450;8547;4529;15560
150220;201709;10674;32833;9656;31289;1923;6168;5470;18480;7393;24648
150230;201709;12021;36224;10500;34164;1663;5218;6901;23679;8564;28897
150240;201709;31808;93713;27152;85444;9218;29717;7208;23690;16426;53407
150250;201709;4036;16729;3902;16533;637;2683;2820;12366;3457;15049
150260;201709;2135;8019;2035;7868;250;993;1462;5747;1712;6740
150270;201709;7717;23191;5929;20822;1694;6085;2646;9824;4340;15909
150275;201709;5827;20652;5521;20180;469;1698;4380;16255;4849;17953
150276;201709;2078;6198;1866;5934;255;822;1420;4614;1675;5436
150277;201709;4475;13372;3832;12592;401;1343;2979;10100;3380;11443
150280;201709;5906;26023;5747;25689;588;2694;4572;20708;5160;23402
150285;201709;3046;11435;2788;11035;326;1422;1940;7808;2266;9230
150290;201709;10014;28277;9476;27679;610;1417;8302;25065;8912;26482
150293;201709;9046;23616;6702;20444;1956;6052;2611;8839;4567;14891
150295;201709;7189;20562;5871;18993;1641;5285;2916;10691;4557;15976
150300;201709;1969;6441;1831;6251;65;325;1554;5292;1619;5617
150304;201709;3976;12758;3511;11987;609;2053;2257;8017;2866;10070
150307;201709;6296;20795;5955;20307;328;1147;5113;17558;5441;18705
150309;201709;5795;19263;5121;18244;1288;4542;2617;10009;3905;14551
150310;201709;6397;26912;6093;26495;398;2013;5159;22554;5557;24567
150320;201709;9169;24235;8432;23358;551;1456;6887;19376;7438;20832
150330;201709;13778;46082;12960;44861;1807;6370;9460;33565;11267;39935
150340;201709;2528;7759;2334;7463;208;652;1798;5808;2006;6460
150345;201709;6906;22168;6459;21546;514;1812;5274;17825;5788;19637
150350;201709;8087;23662;7566;23025;1034;2520;5864;18740;6898;21260
150360;201709;20849;63340;17934;59674;2655;8461;12224;42534;14879;50995
150370;201709;9237;32752;8400;31589;807;3007;6411;24942;7218;27949
150375;201709;3020;13020;2762;12624;332;1545;2171;10088;2503;11633
150380;201709;9221;26452;8087;24856;443;1379;6821;21282;7264;22661
150390;201709;7465;32376;7016;31542;1196;5108;4747;22311;5943;27419
150400;201709;5929;22719;5691;22261;381;1498;4650;18412;5031;19910
150405;201709;8096;23900;7277;22900;538;1304;5774;19142;6312;20446
150410;201709;1644;5970;1506;5700;235;927;943;3641;1178;4568
150420;201709;32189;104587;26634;95777;9184;34666;7354;30200;16538;64866
150430;201709;7510;24331;7126;23760;770;2458;5535;18945;6305;21403
150440;201709;5280;17922;5066;17618;356;1197;4244;15005;4600;16202
150442;201709;21350;59609;18688;55685;2951;8664;11441;35534;14392;44198
150445;201709;5433;18282;4970;17539;364;1295;4013;14366;4377;15661
150450;201709;4379;20636;4215;20368;384;1961;3479;17032;3863;18993
150460;201709;7315;25953;6764;25250;296;1347;5771;22257;6067;23604
150470;201709;17228;52381;16454;51437;1254;3308;14160;45258;15414;48566
150475;201709;3954;13468;3616;12987;256;967;2946;10773;3202;11740
150480;201709;13568;46594;12449;44771;1874;6772;8827;32778;10701;39550
150490;201709;7292;27466;7066;27126;229;1104;6318;24340;6547;25444
150495;201709;4845;17748;4703;17565;146;605;4359;16356;4505;16961
150497;201709;2409;8646;2139;8125;623;2403;993;3972;1616;6375
150500;201709;3171;8610;2883;8189;310;844;2258;6434;2568;7278
150503;201709;3653;11041;2903;9957;908;3142;1287;4740;2195;7882
150506;201709;9912;33838;9059;32620;1924;6434;5787;22389;7711;28823
150510;201709;9611;36875;8652;34872;1375;5307;5638;24010;7013;29317
150520;201709;6755;26594;6670;26486;174;772;6294;25112;6468;25884
150530;201709;12124;41877;10918;39964;1291;4135;8160;31053;9451;35188
150540;201709;4579;13618;4024;12815;197;645;3383;10805;3580;11450
150543;201709;5980;17578;5175;16477;957;3049;3399;11315;4356;14364
150548;201709;9468;30172;8790;29325;301;897;8069;27180;8370;28077
150549;201709;1986;6333;1809;6131;61;251;1640;5562;1701;5813
150550;201709;18604;58976;16289;54994;4805;16379;6356;22837;11161;39216
150553;201709;20910;69114;17087;61828;6039;22834;4758;18716;10797;41550
150555;201709;1684;4914;1397;4451;83;276;1015;3248;1098;3524
150560;201709;1761;5737;1611;5435;306;1001;901;3127;1207;4128
150563;201709;2401;7963;2185;7575;466;1708;1187;4143;1653;5851
150565;201709;3930;13405;3599;12858;119;574;3037;10921;3156;11495
150570;201709;5816;20777;5642;20487;412;1561;4549;16585;4961;18146
150580;201709;9503;40604;9203;40223;617;2853;7873;35056;8490;37909
150590;201709;6198;24080;5941;23746;173;848;5516;22060;5689;22908
150600;201709;8180;30687;7788;30133;231;1063;7060;27479;7291;28542
150610;201709;2361;7814;2183;7449;164;640;1728;5820;1892;6460
150611;201709;2733;8960;2566;8686;134;495;2171;7357;2305;7852
150613;201709;11767;34245;9316;30295;2272;7649;4051;13726;6323;21375
150616;201709;2903;8573;2179;7345;534;1984;630;2032;1164;4016
150618;201709;6247;20476;5496;19155;1111;3879;3134;11348;4245;15227
150619;201709;4951;16419;4509;15718;390;1517;3460;11998;3850;13515
150620;201709;6205;21722;5519;20843;681;2634;4114;15783;4795;18417
150630;201709;5918;16930;5600;16562;376;1149;4826;14422;5202;15571
150635;201709;3771;11955;3389;11243;839;2823;1550;5338;2389;8161
150640;201709;2053;5996;1907;5835;55;177;1765;5496;1820;5673
150650;201709;10877;32761;9898;31011;2945;9093;4230;14105;7175;23198
150655;201709;5129;16153;4808;15608;356;1154;3943;12878;4299;14032
150658;201709;4262;12523;3637;11677;749;2623;2173;7185;2922;9808
150660;201709;5420;16523;4962;15852;836;2608;3137;10305;3973;12913
150670;201709;7383;19037;6014;17408;605;1654;4731;14127;5336;15781
150680;201709;59439;193358;48850;176556;13222;47791;20994;85148;34216;132939
150690;201709;2087;6122;1878;5817;129;411;1524;4771;1653;5182
150700;201709;5831;18446;5419;17898;607;1935;4038;13755;4645;15690
150710;201709;4100;13801;3706;13171;341;1336;2707;9722;3048;11058
150715;201709;4562;14143;4034;13316;354;1272;3093;10239;3447;11511
150720;201709;6218;24502;5894;23918;507;2278;4670;19192;5177;21470
150730;201709;10115;33859;9276;32497;1117;4054;6939;24829;8056;28883
150740;201709;3544;11009;3150;10309;490;1618;1988;6601;2478;8219
150745;201709;4517;14423;4078;13798;867;3121;2616;8912;3483;12033
150746;201709;1331;4356;1260;4223;93;275;1010;3465;1103;3740
150747;201709;5070;16110;4533;15396;847;2581;2883;10544;3730;13125
150750;201709;3310;10876;3012;10441;195;769;2409;8445;2604;9214
150760;201709;11141;34738;10384;33774;1202;3846;7780;25854;8982;29700
150770;201709;5801;21952;5610;21663;166;525;5093;20504;5259;21029
150775;201709;927;2765;781;2518;138;536;452;1413;590;1949
150780;201709;3651;11749;3508;11586;101;393;3243;10749;3344;11142
150790;201709;4864;15593;4476;15147;263;788;3704;13484;3967;14272
150795;201709;13896;45260;12681;43359;2932;9643;7364;26590;10296;36233
150796;201709;3149;8950;2827;8567;215;692;2286;7055;2501;7747
150797;201709;3656;12263;3307;11663;127;432;2763;9842;2890;10274
150800;201709;13058;42191;12048;40964;2167;6662;8421;30439;10588;37101
150803;201709;6475;22893;6065;22236;558;2182;4790;17667;5348;19849
150805;201709;2716;9436;2459;9006;309;1113;1815;6766;2124;7879
150808;201709;5470;17422;4323;15281;1648;6346;458;1782;2106;8128
150810;201709;18548;54711;14845;50113;2695;8896;8867;32100;11562;40996
150812;201709;5070;15441;4614;14668;523;1816;3372;10532;3895;12348
150815;201709;8004;26490;7193;25455;735;2551;5643;20479;6378;23030
150820;201709;11013;31860;9931;30638;806;2189;7937;25402;8743;27591
150830;201709;11919;45571;11352;44856;471;2470;9719;39142;10190;41612
150835;201709;2139;7495;1988;7208;460;1679;1031;3873;1491;5552
150840;201709;7108;21369;5764;19047;1298;4547;2588;8715;3886;13262
160005;201709;868;2832;818;2719;29;116;728;2413;757;2529
160010;201709;1393;4600;1392;4599;11;15;1372;4559;1383;4574
160015;201709;1826;6656;1769;6574;96;354;1592;5992;1688;6346
160020;201709;1810;6654;1675;6434;238;993;1234;4751;1472;5744
160021;201709;1012;4309;978;4253;96;551;774;3308;870;3859
160023;201709;987;4091;964;4047;71;280;806;3454;877;3734
160025;201709;1482;4528;1463;4507;36;90;1411;4378;1447;4468
160027;201709;7849;23271;7349;22714;817;2286;5881;18845;6698;21131
160030;201709;50126;166334;44146;157160;10662;36990;22723;88201;33385;125191
160040;201709;4196;16315;4098;16177;180;939;3719;14513;3899;15452
160050;201709;3382;12160;2998;11624;1509;5605;903;4144;2412;9749
160053;201709;2981;10841;2889;10711;543;1900;2017;7747;2560;9647
160055;201709;542;2198;535;2189;25;132;490;1980;515;2112
160060;201709;16053;53955;15213;52969;1501;4907;12314;43995;13815;48902
160070;201709;2807;10948;2623;10636;177;825;2143;8809;2320;9634
160080;201709;2552;9448;2487;9364;68;329;2302;8662;2370;8991
170025;201709;547;1670;463;1556;133;444;208;723;341;1167
170030;201709;1117;3640;947;3314;175;637;471;1713;646;2350
170035;201709;1384;3742;1087;3264;116;387;631;1926;747;2313
170040;201709;1729;5320;1479;4998;157;556;797;2908;954;3464
170070;201709;1536;4010;1165;3528;172;542;679;2100;851;2642
170100;201709;2300;6748;1963;6230;193;628;1419;4546;1612;5174
170105;201709;724;2277;539;1872;137;481;213;734;350;1215
170110;201709;825;2731;699;2489;147;560;318;1164;465;1724
170130;201709;1283;4017;989;3434;214;762;463;1699;677;2461
170190;201709;1443;4218;1027;3543;327;1063;241;1053;568;2116
170200;201709;1494;4028;933;2970;268;927;183;552;451;1479
170210;201709;27536;77471;21816;68389;7508;25532;3462;11880;10970;37412
170215;201709;1196;3602;1020;3340;89;363;736;2377;825;2740
170220;201709;5377;17840;4868;16854;1230;4184;2434;8872;3664;13056
170230;201709;1218;3854;982;3393;226;799;364;1306;590;2105
170240;201709;2637;7768;2110;6911;192;777;1417;4582;1609;5359
170255;201709;3371;10643;2671;9314;744;2649;1105;3969;1849;6618
170270;201709;1019;2480;664;1986;34;110;450;1320;484;1430
170290;201709;2781;8052;2412;7640;189;406;1987;6735;2176;7141
170300;201709;1819;5416;1500;4903;199;625;940;3193;1139;3818
170305;201709;715;2096;560;1795;76;268;280;871;356;1139
170307;201709;957;3386;802;3082;169;647;396;1578;565;2225
170310;201709;1416;3992;1081;3394;226;789;529;1628;755;2417
170320;201709;1022;2893;762;2466;133;451;384;1278;517;1729
170330;201709;766;2514;697;2403;40;174;538;1819;578;1993
170360;201709;452;1374;360;1220;53;213;212;681;265;894
170370;201709;1253;3526;966;3052;158;515;471;1509;629;2024
170380;201709;1736;5523;1371;4905;171;681;767;2822;938;3503
170382;201709;571;1757;476;1594;78;270;287;961;365;1231
170384;201709;1451;5799;1294;5481;371;1645;554;2371;925;4016
170386;201709;769;2194;506;1673;86;315;102;308;188;623
170388;201709;571;1706;420;1429;74;257;186;625;260;882
170389;201709;868;2897;773;2736;52;219;584;2045;636;2264
170390;201709;1349;3641;1059;3284;90;298;804;2538;894;2836
170410;201709;514;1645;411;1460;26;109;262;929;288;1038
170460;201709;395;1108;299;942;42;153;166;523;208;676
170510;201709;797;2565;610;2202;86;355;301;1065;387;1420
170550;201709;6128;17244;4518;14456;1432;5082;705;2311;2137;7393
170555;201709;1282;3659;1018;3245;125;431;541;1763;666;2194
170560;201709;1109;3292;845;2926;128;509;448;1708;576;2217
170600;201709;1269;3687;1074;3409;299;867;565;1908;864;2775
170610;201709;1608;4717;1248;4095;120;449;809;2616;929;3065
170625;201709;362;1066;258;829;33;112;90;272;123;384
170650;201709;1190;3720;932;3250;213;759;359;1358;572;2117
170700;201709;3462;10611;2771;9412;591;2181;1231;4286;1822;6467
170710;201709;1577;4574;1253;3981;279;975;549;1649;828;2624
170720;201709;1771;4726;1527;4372;104;226;1274;3809;1378;4035
170730;201709;917;2753;723;2421;177;620;326;1121;503;1741
170740;201709;2006;7191;1732;6671;249;981;1101;4288;1350;5269
170755;201709;846;2533;627;2099;84;325;290;964;374;1289
170765;201709;1147;3151;827;2627;210;684;321;1097;531;1781
170770;201709;1648;5423;1459;5104;237;811;900;3216;1137;4027
170820;201709;3817;13479;3424;12797;530;1905;2065;8236;2595;10141
170825;201709;942;2333;775;2106;72;169;532;1508;604;1677
170830;201709;1349;3886;1109;3503;43;114;907;2910;950;3024
170900;201709;2387;8419;2219;8143;182;727;1803;6665;1985;7392
170930;201709;3420;9957;2908;9138;661;2289;1386;4478;2047;6767
170950;201709;11793;34024;8693;28695;2620;9731;1262;4331;3882;14062
170980;201709;476;1319;363;1138;44;159;200;595;244;754
171050;201709;1510;4955;1356;4679;87;392;1047;3560;1134;3952
171070;201709;1270;3961;1150;3780;282;838;693;2465;975;3303
171090;201709;1050;2703;870;2459;61;167;646;1814;707;1981
171110;201709;560;1646;416;1385;112;418;167;494;279;912
171150;201709;984;2652;638;2036;68;247;395;1256;463;1503
171180;201709;697;2068;473;1615;91;326;200;715;291;1041
171190;201709;1474;5486;1316;5183;245;1018;715;2916;960;3934
171195;201709;815;2822;701;2627;112;507;435;1609;547;2116
171200;201709;548;1653;422;1418;116;410;146;481;262;891
171215;201709;433;1264;327;1058;71;261;140;441;211;702
171240;201709;685;2504;619;2372;70;336;389;1510;459;1846
171245;201709;560;1866;457;1631;100;394;191;658;291;1052
171250;201709;961;2774;747;2422;189;620;357;1188;546;1808
171270;201709;382;1524;341;1420;96;368;148;702;244;1070
171280;201709;827;2606;669;2311;159;543;297;1116;456;1659
171320;201709;3681;10887;3015;9724;738;2375;1322;4552;2060;6927
171330;201709;2565;7474;2078;6645;521;1760;988;3231;1509;4991
171360;201709;1349;4246;1199;4041;96;364;967;3270;1063;3634
171370;201709;629;1748;517;1591;56;189;355;1099;411;1288
171380;201709;1238;3882;999;3458;267;949;398;1465;665;2414
171395;201709;887;2608;646;2137;104;403;321;1036;425;1439
171420;201709;1786;5619;1349;4731;262;1014;577;2022;839;3036
171430;201709;988;2998;822;2708;107;363;540;1744;647;2107
171488;201709;2354;7241;1960;6618;368;1261;1071;3761;1439;5022
171500;201709;870;2443;689;2153;67;226;475;1492;542;1718
171510;201709;780;2751;700;2605;53;236;487;1824;540;2060
171515;201709;447;1262;338;1072;27;91;206;643;233;734
171525;201709;565;1797;484;1648;36;161;325;1058;361;1219
171550;201709;339;1053;245;895;51;201;107;401;158;602
171570;201709;1197;3691;1039;3402;184;561;668;2273;852;2834
171575;201709;1816;4963;1235;3910;201;678;545;1708;746;2386
171610;201709;5039;15365;4056;13631;1019;3778;1140;3964;2159;7742
171620;201709;2669;7631;2279;7098;121;427;1871;5904;1992;6331
171630;201709;883;2629;734;2408;177;620;418;1384;595;2004
171650;201709;1991;6035;1477;5009;374;1299;484;1708;858;3007
171660;201709;2184;5990;1603;4942;270;852;857;2628;1127;3480
171665;201709;1353;3916;1054;3458;205;710;495;1685;700;2395
171670;201709;1742;4833;1393;4271;289;1011;688;2071;977;3082
171700;201709;1071;3340;861;2955;144;479;457;1605;601;2084
171720;201709;727;2095;619;1904;87;280;407;1245;494;1525
171750;201709;1152;3467;839;2859;228;780;214;802;442;1582
171780;201709;1208;3222;890;2759;87;278;563;1743;650;2021
171790;201709;1426;5027;1160;4389;276;1093;520;2052;796;3145
171800;201709;657;1970;528;1772;56;191;335;1154;391;1345
171820;201709;9831;29162;7896;25947;1860;6441;3010;10345;4870;16786
171830;201709;1343;4908;1203;4596;268;1057;603;2373;871;3430
171840;201709;665;1866;558;1706;37;123;410;1231;447;1354
171845;201709;610;1686;483;1490;73;271;264;824;337;1095
171850;201709;828;2992;726;2779;78;340;496;1889;574;2229
171855;201709;1072;3366;958;3166;79;277;668;2184;747;2461
171865;201709;385;1314;333;1229;65;266;161;579;226;845
171870;201709;718;2108;545;1773;103;333;246;896;349;1229
171875;201709;1152;3596;952;3263;70;298;709;2391;779;2689
171880;201709;897;3169;859;3117;66;221;722;2692;788;2913
171884;201709;909;2476;665;2112;136;493;202;721;338;1214
171886;201709;1249;3886;946;3287;280;1048;171;621;451;1669
171888;201709;734;2171;521;1752;55;202;321;1066;376;1268
171889;201709;482;1486;418;1369;77;269;191;659;268;928
171890;201709;1103;3201;874;2852;154;494;508;1700;662;2194
171900;201709;477;1742;373;1477;87;350;143;583;230;933
172000;201709;564;1804;468;1610;78;304;244;809;322;1113
172010;201709;1046;3693;946;3493;99;469;613;2185;712;2654
172015;201709;325;1272;269;1155;50;209;133;578;183;787
172020;201709;2166;7166;2030;6952;186;732;1515;5187;1701;5919
172025;201709;712;2051;520;1723;73;285;290;972;363;1257
172030;201709;1158;3599;1017;3360;36;148;815;2689;851;2837
172049;201709;1238;3175;853;2553;340;1084;358;1070;698;2154
172065;201709;1307;3450;1073;3184;61;165;961;2886;1022;3051
172080;201709;2321;7207;1934;6489;153;589;1324;4435;1477;5024
172085;201709;458;1308;315;1006;57;168;105;328;162;496
172090;201709;3895;10416;3143;9347;112;352;2681;8055;2793;8407
172093;201709;467;1450;366;1263;72;293;190;619;262;912
172097;201709;610;1733;463;1491;91;310;192;629;283;939
172100;201709;35955;98092;26000;81800;6740;23443;7167;23692;13907;47135
172110;201709;1565;5953;1377;5643;152;669;1004;4256;1156;4925
172120;201709;4678;14705;3807;13372;735;2554;2038;7487;2773;10041
172125;201709;247;775;198;686;31;119;101;356;132;475
172130;201709;565;1568;428;1344;24;91;276;854;300;945
172208;201709;2123;5997;1827;5561;227;698;1147;3530;1374;4228
172210;201709;2413;7105;2043;6564;420;1376;1136;3696;1556;5072
210005;201709;19578;59956;16347;54896;5005;17498;6361;22329;11366;39827
210010;201709;1657;5719;1517;5470;50;218;1312;4762;1362;4980
210015;201709;3204;10122;2909;9654;153;412;2495;8499;2648;8911
210020;201709;6893;16351;6413;15796;128;334;5994;14727;6122;15061
210030;201709;4855;16461;4609;16128;245;1204;3967;13721;4212;14925
210040;201709;2069;6174;1909;5995;39;96;1782;5691;1821;5787
210043;201709;6521;17917;5581;16799;741;2049;3916;12609;4657;14658
210047;201709;6232;22084;5722;21364;340;1585;4839;18020;5179;19605
210050;201709;2133;7792;1756;7060;361;1505;974;4060;1335;5565
210055;201709;1679;5771;1536;5539;72;295;1217;4408;1289;4703
210060;201709;6637;26207;6140;25248;886;3716;4240;17880;5126;21596
210070;201709;7162;20823;6704;20268;58;175;6347;19363;6405;19538
210080;201709;3607;12828;3540;12745;18;72;3452;12484;3470;12556
210083;201709;4596;15636;4120;15117;81;389;3889;14320;3970;14709
210087;201709;2847;8364;2586;8018;202;619;2115;6693;2317;7312
210090;201709;9908;30663;9436;29931;324;1160;8530;27031;8854;28191
210095;201709;5828;20460;5537;20083;292;1202;4834;17682;5126;18884
210100;201709;6847;20704;6333;20004;243;948;5407;17030;5650;17978
210110;201709;2607;8993;2511;8865;55;235;2343;8277;2398;8512
210120;201709;23766;66649;20883;63171;2606;6724;14694;47434;17300;54158
210125;201709;3682;11169;3499;10969;523;1241;2771;9194;3294;10435
210130;201709;4009;11671;3661;11183;194;619;3066;9357;3260;9976
210135;201709;1495;4564;1335;4331;64;221;1104;3613;1168;3834
210140;201709;15789;49239;13376;45926;2871;10289;7430;26312;10301;36601
210150;201709;4454;11116;3982;10519;65;253;3604;9398;3669;9651
210160;201709;16319;50975;15220;49307;1291;4001;11838;39482;13129;43483
210170;201709;13483;46428;13042;45876;633;2257;11725;41589;12358;43846
210173;201709;2487;9654;2363;9463;40;236;2221;8948;2261;9184
210177;201709;2953;8992;2805;8815;57;139;2666;8474;2723;8613
210180;201709;1432;4180;1337;4052;36;134;1186;3570;1222;3704
210190;201709;4703;14672;4309;13949;139;686;3480;11023;3619;11709
210193;201709;1219;3867;1117;3709;49;188;925;3080;974;3268
210197;201709;1881;6444;1739;6270;209;678;1315;4974;1524;5652
210200;201709;7614;25561;7088;24803;759;2667;5605;20016;6364;22683
210203;201709;6661;20824;6258;20293;348;1047;5512;18206;5860;19253
210207;201709;3141;10212;2971;9911;156;493;2506;8526;2662;9019
210210;201709;8015;26978;7651;26494;87;428;7099;24862;7186;25290
210215;201709;1354;5216;1257;5075;75;363;1055;4299;1130;4662
210220;201709;5723;21260;5455;20794;277;1364;4709;17812;4986;19176
210230;201709;4982;15951;4612;15405;210;645;4090;13802;4300;14447
210232;201709;12166;38582;10153;35989;1514;5485;6547;25114;8061;30599
210235;201709;3582;10930;3183;10431;129;516;2802;9238;2931;9754
210237;201709;2184;8472;2117;8385;20;98;2046;8145;2066;8243
210240;201709;2752;8738;2568;8449;109;413;2221;7282;2330;7695
210250;201709;5198;16704;4872;16277;122;647;4429;14675;4551;15322
210255;201709;2530;8020;2290;7592;315;1096;1614;5339;1929;6435
210260;201709;4994;16117;4592;15489;340;1187;3747;12731;4087;13918
210270;201709;4765;13896;4400;13382;103;520;3901;11724;4004;12244
210275;201709;3410;8550;3192;8303;80;143;3018;7967;3098;8110
210280;201709;5367;16231;4593;15107;250;1192;3434;11067;3684;12259
210290;201709;5573;18302;5215;17867;164;636;4631;15965;4795;16601
210300;201709;34523;95681;28973;88783;1980;6355;21962;69968;23942;76323
210310;201709;2817;7758;2592;7458;69;147;2322;6754;2391;6901
210312;201709;2316;6924;2139;6702;54;265;1937;6027;1991;6292
210315;201709;2716;8271;2363;7835;81;279;2069;7004;2150;7283
210317;201709;3855;12446;3661;12217;128;494;3353;11225;3481;11719
210320;201709;18065;59710;16987;58330;597;2622;15227;52402;15824;55024
210325;201709;3372;10354;3044;9855;117;433;2637;8612;2754;9045
210330;201709;28987;78641;24261;73159;5317;15019;13617;46712;18934;61731
210340;201709;10538;32215;9641;30938;994;2971;7146;24073;8140;27044
210350;201709;9304;28177;8362;26887;329;1166;7082;22972;7411;24138
210355;201709;3835;13968;3454;13368;145;760;2904;11344;3049;12104
210360;201709;14617;43532;13256;41678;722;2767;11004;34401;11726;37168
210370;201709;9226;22216;7710;20590;306;628;6828;18866;7134;19494
210375;201709;2867;8617;2376;7961;671;2277;1141;4038;1812;6315
210380;201709;5419;14997;4918;14352;309;823;4178;12436;4487;13259
210390;201709;2734;9910;2536;9585;135;649;2131;8049;2266;8698
210400;201709;4710;14799;4394;14407;107;270;4103;13634;4210;13904
210405;201709;7153;20120;5820;18187;1328;4071;2936;9788;4264;13859
210407;201709;1871;6661;1597;6136;152;637;1213;4632;1365;5269
210408;201709;2283;9063;2175;8913;163;824;1774;7369;1937;8193
210409;201709;3537;12817;3330;12510;128;672;2908;10901;3036;11573
210410;201709;3371;10973;3145;10620;234;709;2534;8822;2768;9531
210420;201709;3899;12875;3578;12309;178;653;3008;10408;3186;11061
210430;201709;2137;6446;2044;6341;114;325;1783;5591;1897;5916
210440;201709;3908;11528;3737;11315;78;235;3539;10758;3617;10993
210450;201709;2507;8034;2263;7662;120;421;1824;6168;1944;6589
210455;201709;3601;10324;3167;9808;647;1914;2131;6887;2778;8801
210460;201709;3284;10604;3019;10210;132;556;2534;8547;2666;9103
210462;201709;1280;4607;1178;4408;60;295;972;3609;1032;3904
210465;201709;2519;8048;2313;7755;100;291;2051;7010;2151;7301
210467;201709;5868;19626;5496;19201;321;1209;4808;16985;5129;18194
210470;201709;2057;5477;1468;4618;84;249;1107;3569;1191;3818
210480;201709;14360;45476;12602;43249;1687;5481;8949;32881;10636;38362
210490;201709;3643;9779;3093;9000;78;283;2714;7875;2792;8158
210500;201709;5912;24756;5715;24377;475;2283;4574;19569;5049;21852
210510;201709;6197;21091;5793;20610;276;840;5054;18527;5330;19367
210515;201709;3400;10788;3245;10618;126;343;2986;9968;3112;10311
210520;201709;2487;7465;2242;7145;117;404;1957;6286;2074;6690
210530;201709;47236;127442;40378;117170;6658;24661;11812;41675;18470;66336
210535;201709;3156;10864;3009;10668;87;330;2717;9725;2804;10055
210540;201709;12785;41889;11425;40022;1646;5583;7866;29041;9512;34624
210542;201709;5438;14965;4883;14353;244;519;4385;13261;4629;13780
210545;201709;2261;7172;2132;6983;45;218;1910;6186;1955;6404
210547;201709;3534;12661;3251;12148;354;1294;2375;9156;2729;10450
210550;201709;5694;17219;5049;16517;294;937;4442;14813;4736;15750
210560;201709;3697;11508;3312;10873;116;481;2863;9304;2979;9785
210565;201709;1375;5027;1201;4743;51;254;978;3951;1029;4205
210570;201709;10992;31162;10180;30244;386;986;9260;27947;9646;28933
210580;201709;2913;8441;2638;8104;247;504;2144;6941;2391;7445
210590;201709;3802;12329;3483;11899;174;806;3044;10281;3218;11087
210592;201709;2428;7546;2314;7359;35;184;2060;6499;2095;6683
210594;201709;2679;7480;2119;6621;112;326;1559;5031;1671;5357
210596;201709;2391;8955;2255;8677;181;795;1762;6813;1943;7608
210598;201709;1626;5091;1540;4982;51;193;1413;4588;1464;4781
210600;201709;2923;8322;2499;7755;91;301;2054;6393;2145;6694
210610;201709;2386;7644;2187;7389;97;460;1939;6436;2036;6896
210620;201709;2071;6642;1865;6384;40;90;1720;6022;1760;6112
210630;201709;3028;10839;2810;10504;206;992;2246;8229;2452;9221
210632;201709;4194;14516;3852;14002;388;1586;2966;10784;3354;12370
210635;201709;1834;6485;1726;6301;121;393;1458;5462;1579;5855
210637;201709;2475;8566;2261;8241;133;588;1797;6590;1930;7178
210640;201709;4562;18308;4490;18232;41;172;4389;17891;4430;18063
210650;201709;6853;20405;6630;20112;86;261;6409;19492;6495;19753
210660;201709;8194;24151;7431;23017;295;1135;6468;19808;6763;20943
210663;201709;2617;8079;2489;7924;120;384;2135;6965;2255;7349
210667;201709;1869;6242;1755;6067;62;263;1560;5429;1622;5692
210670;201709;4364;15705;4135;15333;184;883;3590;13277;3774;14160
210675;201709;4951;13759;4483;13152;389;972;3673;11168;4062;12140
210680;201709;3864;10313;3307;9645;123;295;2913;8637;3036;8932
210690;201709;7184;24319;6843;23958;267;977;6085;21856;6352;22833
210700;201709;2614;7529;2304;7165;208;497;1812;6168;2020;6665
210710;201709;4587;15312;4312;14901;171;796;3743;12901;3914;13697
210720;201709;2586;9131;2441;8935;68;353;2236;8134;2304;8487
210725;201709;1128;4226;1024;4020;35;130;785;3230;820;3360
210730;201709;1185;3377;1020;3152;78;234;812;2526;890;2760
210735;201709;4180;13637;3778;12986;365;1319;3014;10494;3379;11813
210740;201709;4908;14334;4584;14002;148;710;4101;12304;4249;13014
210745;201709;4061;11420;3841;11147;177;459;3420;9990;3597;10449
210750;201709;18749;50468;16499;47888;1838;5304;12216;36419;14054;41723
210760;201709;5407;16127;5071;15766;25;70;4938;15434;4963;15504
210770;201709;5658;15604;4913;14741;60;264;4515;13583;4575;13847
210780;201709;7083;24022;6523;23039;699;2335;4851;17642;5550;19977
210790;201709;4577;14489;4263;14100;167;418;3493;12197;3660;12615
210800;201709;4678;13072;4184;12461;81;305;3804;11312;3885;11617
210805;201709;3687;14692;3571;14511;145;750;3133;12771;3278;13521
210810;201709;4877;14986;4548;14554;225;469;4043;13360;4268;13829
210820;201709;7055;20567;6257;19304;748;2214;4239;13389;4987;15603
210825;201709;5787;19535;5536;19207;417;1361;4674;16625;5091;17986
210830;201709;7986;22993;7528;22433;556;1323;6411;19754;6967;21077
210840;201709;3351;9201;3058;8784;86;300;2663;7585;2749;7885
210845;201709;5697;16730;5528;16549;39;84;5444;16383;5483;16467
210850;201709;5760;20122;5194;19221;453;1977;3939;14539;4392;16516
210860;201709;17014;50051;15149;47420;939;2946;12293;39156;13232;42102
210870;201709;5641;18517;5155;17896;408;1359;4265;15116;4673;16475
210880;201709;4115;13406;3913;13152;255;969;3290;11065;3545;12034
210890;201709;4474;13616;4120;13202;234;611;3531;11802;3765;12413
210900;201709;4527;13544;3647;12048;1444;5046;832;3056;2276;8102
210905;201709;1796;5465;1565;5138;79;206;1323;4467;1402;4673
210910;201709;7410;23758;6565;22324;863;3060;4423;15130;5286;18190
210920;201709;2647;9918;2515;9694;107;558;2156;8308;2263;8866
210923;201709;1367;4616;1274;4463;102;406;932;3292;1034;3698
210927;201709;4695;15369;4417;15065;108;341;4126;14258;4234;14599
210930;201709;2426;8617;2249;8346;119;624;1848;6732;1967;7356
210940;201709;3186;11013;3058;10810;137;642;2674;9333;2811;9975
210945;201709;5600;17276;5364;17008;254;673;4827;15495;5081;16168
210950;201709;4933;15040;4050;13689;480;1484;2854;10028;3334;11512
210955;201709;1684;5369;1496;5080;150;490;1060;3715;1210;4205
210960;201709;8663;27447;7935;26452;1581;4901;4922;17627;6503;22528
210970;201709;1256;4307;1099;4031;101;436;816;2912;917;3348
210975;201709;1655;5549;1569;5385;132;484;1187;4072;1319;4556
210980;201709;9759;22581;9361;22177;292;518;8788;21145;9080;21663
210990;201709;15115;46540;12675;43052;2231;7747;7433;26291;9664;34038
211000;201709;14183;44898;12690;43200;655;2735;10722;37106;11377;39841
211003;201709;4724;16569;4261;15982;228;1041;3523;13414;3751;14455
211010;201709;6279;23408;5892;22904;77;448;5472;21416;5549;21864
211020;201709;7375;23671;7078;23236;451;1652;5976;19677;6427;21329
211023;201709;2031;6890;1945;6758;122;473;1616;5606;1738;6079
211027;201709;2669;9710;2612;9613;233;918;2173;8017;2406;8935
211030;201709;3571;10799;3360;10572;326;709;2818;9353;3144;10062
211040;201709;4412;16368;4235;16106;157;880;3715;14100;3872;14980
211050;201709;9554;24525;9027;23933;221;573;8498;22558;8719;23131
211060;201709;5670;19771;5429;19396;316;1281;4727;16906;5043;18187
211065;201709;1964;6091;1748;5786;41;126;1582;5275;1623;5401
211070;201709;7583;25836;6907;24719;413;1542;5617;20389;6030;21931
211080;201709;1262;3697;1080;3422;58;302;852;2545;910;2847
211085;201709;1878;6141;1736;5906;160;536;1392;4797;1552;5333
211090;201709;3184;9181;2956;8868;73;342;2635;7795;2708;8137
211100;201709;6222;16709;6035;16473;30;120;5854;15936;5884;16056
211102;201709;2714;10432;2571;10231;159;684;2226;8960;2385;9644
211105;201709;2333;7751;1990;7154;243;899;1347;4872;1590;5771
211107;201709;4347;13979;3868;13303;215;733;3149;11181;3364;11914
211110;201709;5948;17268;4712;15410;636;1945;3249;11070;3885;13015
211120;201709;33320;95748;30995;93014;4257;11908;23003;71505;27260;83413
211125;201709;1958;6183;1717;5787;87;343;1444;4883;1531;5226
211130;201709;166593;439940;156792;427552;23019;65280;75738;228178;98757;293458
211140;201709;4867;15746;4522;15227;199;742;3877;13051;4076;13793
211150;201709;9255;26584;8305;25418;286;1079;7174;21983;7460;23062
211153;201709;2479;7875;2221;7536;436;1543;1470;5159;1906;6702
211157;201709;1067;3470;916;3234;56;300;637;2236;693;2536
211160;201709;3853;12339;3252;11326;209;1021;2334;7882;2543;8903
211163;201709;1681;5760;1603;5649;31;92;1494;5361;1525;5453
211167;201709;1482;4846;1411;4740;30;128;1333;4475;1363;4603
211170;201709;5846;15402;5620;15121;69;226;5343;14316;5412;14542
211172;201709;2377;6868;2155;6537;75;319;1854;5504;1929;5823
211174;201709;2623;8004;2460;7783;61;311;2239;7020;2300;7331
211176;201709;3965;12437;3392;11665;265;1064;2615;9016;2880;10080
211178;201709;4348;10520;3918;10033;30;104;3719;9439;3749;9543
211180;201709;4020;13899;3795;13556;257;998;3221;11602;3478;12600
211190;201709;2837;9072;2593;8703;64;315;2246;7473;2310;7788
211195;201709;1385;4127;1171;3844;67;205;972;3278;1039;3483
211200;201709;1920;6216;1673;5869;215;755;1102;4032;1317;4787
211210;201709;6467;19892;6080;19385;322;1084;5310;17043;5632;18127
211220;201709;32431;91333;28389;86180;4001;12239;19412;60926;23413;73165
211223;201709;4802;14659;4373;13991;423;1279;3328;10858;3751;12137
211227;201709;1672;5900;1524;5683;42;201;1345;5068;1387;5269
211230;201709;7203;23173;6583;22122;622;2160;5075;17130;5697;19290
211240;201709;7781;26584;7439;26138;205;1069;6775;23531;6980;24600
211245;201709;5482;16194;5435;16146;36;72;5380;16035;5416;16107
211250;201709;13281;40573;12441;39557;688;2158;10776;34699;11464;36857
211260;201709;7799;24958;7310;24312;262;1020;6628;22129;6890;23149
211270;201709;9762;33130;8751;31836;427;2003;7167;26433;7594;28436
211280;201709;12853;37985;11743;36574;826;2108;9672;31198;10498;33306
211285;201709;1575;5797;1402;5462;242;1015;700;2788;942;3803
211290;201709;6714;22011;6424;21610;268;999;5658;19140;5926;20139
211300;201709;7772;23199;7255;22506;89;238;6871;21448;6960;21686
211400;201709;11036;34392;9455;32028;1998;6860;5291;19370;7289;26230
220005;201709;1793;5028;1613;4755;48;202;1319;3773;1367;3975
220010;201709;1413;4116;1241;3839;26;117;992;3013;1018;3130
220020;201709;3072;9661;2867;9322;426;1398;1955;6371;2381;7769
220025;201709;2181;5267;1935;4914;32;97;1603;3984;1635;4081
220027;201709;1242;3334;1094;3137;41;144;893;2547;934;2691
220030;201709;3002;7986;2892;7812;115;356;2500;6621;2615;6977
220040;201709;6988;21548;6398;20478;1168;3706;4120;13314;5288;17020
220045;201709;1322;4362;1200;4122;50;254;924;3089;974;3343
220050;201709;4158;12659;3620;11789;161;673;3004;9704;3165;10377
220060;201709;2070;4973;1818;4682;27;59;1664;4291;1691;4350
220070;201709;2305;6536;2058;6141;91;254;1670;4973;1761;5227
220080;201709;641;1933;591;1856;31;127;492;1481;523;1608
220090;201709;1698;4270;1402;3861;25;90;1235;3366;1260;3456
220095;201709;678;1787;639;1735;7;21;601;1626;608;1647
220100;201709;1297;3828;1069;3399;53;234;857;2665;910;2899
220105;201709;2065;6537;1818;6054;133;455;1320;4443;1453;4898
220110;201709;3210;9250;3073;9021;66;268;2726;7877;2792;8145
220115;201709;2486;8097;2376;7909;104;438;2098;6876;2202;7314
220117;201709;1226;3206;1002;2863;27;90;855;2425;882;2515
220120;201709;11159;33172;10382;32212;124;559;9774;30263;9898;30822
220130;201709;876;2797;770;2640;21;135;683;2308;704;2443
220140;201709;1596;4231;1414;4010;104;225;1198;3470;1302;3695
220150;201709;6524;19802;6179;19317;146;693;5448;16787;5594;17480
220155;201709;1077;3236;855;2826;30;116;591;1926;621;2042
220157;201709;1057;2679;903;2420;16;67;735;1909;751;1976
220160;201709;2519;7557;2206;6966;66;330;1804;5576;1870;5906
220170;201709;1321;3879;1126;3560;28;145;966;2986;994;3131
220173;201709;1978;5873;1596;5134;49;236;1289;3997;1338;4233
220177;201709;1722;5222;1686;5172;16;65;1638;5018;1654;5083
220180;201709;1133;2923;879;2461;12;48;657;1750;669;1798
220190;201709;4796;14693;4367;14124;453;1566;3357;10865;3810;12431
220191;201709;1351;4468;1268;4320;96;420;936;3088;1032;3508
220192;201709;1787;5054;1433;4415;42;160;1114;3373;1156;3533
220194;201709;1694;5049;1513;4760;71;284;1236;3816;1307;4100
220196;201709;1937;5478;1780;5210;73;294;1499;4289;1572;4583
220198;201709;1225;3621;993;3307;9;32;945;3176;954;3208
220200;201709;4459;14347;4106;13884;300;1093;3348;11338;3648;12431
220202;201709;2135;6206;1848;5691;26;138;1593;4812;1619;4950
220205;201709;2552;6860;2294;6505;37;139;2039;5705;2076;5844
220207;201709;821;2504;703;2296;57;217;485;1570;542;1787
220208;201709;1697;5388;1429;4887;317;1211;661;2256;978;3467
220209;201709;1580;4666;1362;4285;31;136;1105;3466;1136;3602
220210;201709;1563;4225;1358;3873;35;151;1097;3025;1132;3176
220211;201709;1452;4049;1378;3940;20;91;1232;3508;1252;3599
220213;201709;1633;4581;1482;4280;36;138;1215;3425;1251;3563
220217;201709;1916;6087;1833;5988;30;119;1733;5693;1763;5812
220220;201709;10076;27431;8803;25498;575;1538;6591;19490;7166;21028
220225;201709;1100;3107;909;2842;24;96;755;2335;779;2431
220230;201709;5350;14067;4785;13306;206;566;4142;11577;4348;12143
220240;201709;2821;8607;2603;8195;96;367;2150;6726;2246;7093
220245;201709;1475;3906;1223;3575;15;57;1074;3204;1089;3261
220250;201709;2660;8147;2423;7792;56;239;2135;6868;2191;7107
220253;201709;1585;4558;1336;4115;156;468;997;3055;1153;3523
220255;201709;1677;4537;1426;4131;27;136;1172;3265;1199;3401
220260;201709;4105;13271;3685;12504;228;819;2886;9845;3114;10664
220265;201709;1234;4216;1129;4046;79;328;838;2989;917;3317
220270;201709;6505;21016;6195;20444;415;1715;5018;16101;5433;17816
220271;201709;1439;3937;1261;3656;60;167;1043;3063;1103;3230
220272;201709;1659;4946;1500;4663;34;129;1174;3591;1208;3720
220273;201709;1151;3376;989;3067;50;181;758;2338;808;2519
220275;201709;2048;5153;1644;4662;42;165;1403;3939;1445;4104
220277;201709;2086;5693;1821;5263;38;134;1500;4253;1538;4387
220280;201709;1450;3941;1262;3622;62;218;1019;2833;1081;3051
220285;201709;1464;3934;1251;3656;20;84;1170;3402;1190;3486
220290;201709;5578;18174;4725;16926;463;1843;3361;12047;3824;13890
220300;201709;1697;5648;1505;5351;65;370;1229;4245;1294;4615
220310;201709;2438;7811;2131;7443;59;321;1837;6338;1896;6659
220320;201709;2683;8234;2276;7488;173;663;1725;5616;1898;6279
220323;201709;1416;4901;1245;4633;104;412;996;3721;1100;4133
220325;201709;1156;3635;986;3301;49;206;764;2542;813;2748
220327;201709;1298;4095;1174;3874;46;230;976;3123;1022;3353
220330;201709;3636;9840;3194;9240;168;517;2664;7696;2832;8213
220335;201709;1697;5210;1525;5009;15;54;1442;4754;1457;4808
220340;201709;1769;4816;1460;4312;55;203;1075;3069;1130;3272
220342;201709;1116;3519;1033;3394;47;187;842;2780;889;2967
220345;201709;2733;6839;2419;6400;14;33;2299;6074;2313;6107
220350;201709;3460;9204;2875;8255;151;512;2196;6200;2347;6712
220360;201709;1108;3035;963;2817;39;131;788;2240;827;2371
220370;201709;8939;25497;8127;24427;220;899;7262;21635;7482;22534
220375;201709;1393;4387;1305;4271;8;24;1274;4182;1282;4206
220380;201709;1371;3581;1171;3296;29;106;1006;2779;1035;2885
220385;201709;776;1954;617;1683;11;43;515;1363;526;1406
220390;201709;8095;24322;7125;22645;1846;5899;2969;9897;4815;15796
220400;201709;1468;3700;1135;3163;26;101;892;2397;918;2498
220410;201709;1115;3223;946;2935;60;185;753;2311;813;2496
220415;201709;798;2201;697;2041;24;83;519;1489;543;1572
220420;201709;2018;5849;1672;5181;88;289;1241;3798;1329;4087
220430;201709;2333;6471;2275;6397;95;288;2046;5709;2141;5997
220435;201709;1651;4691;1491;4432;58;195;1169;3441;1227;3636
220440;201709;2300;7599;2135;7341;146;533;1745;5924;1891;6457
220450;201709;1952;5825;1666;5423;260;963;1147;3702;1407;4665
220455;201709;1265;4015;1211;3937;27;107;1110;3604;1137;3711
220460;201709;890;2407;809;2309;46;145;694;1937;740;2082
220465;201709;2274;7421;2077;7112;177;658;1579;5431;1756;6089
220470;201709;3452;10143;3140;9639;120;413;2540;7680;2660;8093
220480;201709;2308;6514;1950;5899;124;325;1469;4408;1593;4733
220490;201709;2260;6213;2066;5973;40;153;1830;5235;1870;5388
220500;201709;2762;7510;2442;6987;67;285;1966;5446;2033;5731
220510;201709;2687;7897;2180;7001;93;309;1673;5392;1766;5701
220515;201709;1656;4072;1486;3845;62;160;1311;3375;1373;3535
220520;201709;4843;13104;4460;12582;90;264;4050;11424;4140;11688
220525;201709;1190;3342;1112;3231;25;91;958;2755;983;2846
220527;201709;1275;3805;1132;3545;51;161;909;2886;960;3047
220530;201709;1161;3323;1035;3137;42;167;921;2737;963;2904
220535;201709;782;2317;740;2260;52;164;592;1806;644;1970
220540;201709;3298;10559;3149;10329;86;396;2788;9077;2874;9473
220545;201709;1350;4403;1270;4254;92;382;1025;3371;1117;3753
220550;201709;8669;27473;7959;26235;538;2010;6105;19851;6643;21861
220551;201709;1379;4251;1222;3992;55;244;971;3078;1026;3322
220552;201709;1444;4454;1260;4103;47;251;1012;3163;1059;3414
220553;201709;1545;4414;1326;4065;58;202;1033;3236;1091;3438
220554;201709;763;2179;646;1994;38;98;514;1586;552;1684
220555;201709;2008;6569;1878;6371;48;261;1602;5347;1650;5608
220556;201709;1256;3824;1114;3548;43;199;856;2613;899;2812
220557;201709;1490;4689;1299;4304;87;322;950;3099;1037;3421
220558;201709;1102;3293;962;3087;39;176;783;2455;822;2631
220559;201709;1554;4237;1360;3916;17;58;1144;3295;1161;3353
220560;201709;1591;3884;1290;3473;42;108;1114;2981;1156;3089
220570;201709;6906;22103;6479;21347;667;2306;4834;16083;5501;18389
220580;201709;6340;18974;6121;18615;195;652;5496;16601;5691;17253
220585;201709;1943;6454;1764;6123;81;343;1419;4864;1500;5207
220590;201709;1242;3627;1084;3383;119;389;734;2299;853;2688
220595;201709;2339;6718;2195;6527;23;129;2055;6035;2078;6164
220600;201709;1278;3075;1053;2777;68;108;872;2359;940;2467
220605;201709;1724;5099;1477;4674;39;165;1155;3574;1194;3739
220610;201709;2716;8060;2565;7843;43;189;2346;7127;2389;7316
220620;201709;7272;24086;6969;23661;212;982;6282;21160;6494;22142
220630;201709;368;1142;305;1023;42;164;171;586;213;750
220635;201709;1618;5341;1434;4954;74;312;1092;3722;1166;4034
220640;201709;2619;7421;2295;6949;80;296;1928;5780;2008;6076
220650;201709;2011;5923;1770;5491;74;251;1340;4143;1414;4394
220660;201709;2711;8016;2454;7709;90;428;2174;6686;2264;7114
220665;201709;1199;3901;1086;3699;23;116;927;3124;950;3240
220667;201709;1595;5280;1448;5012;74;280;1179;4083;1253;4363
220669;201709;1678;5385;1608;5257;101;452;1316;4211;1417;4663
220670;201709;1867;5463;1649;5195;58;174;1458;4619;1516;4793
220672;201709;2451;6937;2204;6627;119;359;1923;5833;2042;6192
220675;201709;1226;3463;1134;3298;59;152;893;2604;952;2756
220680;201709;2469;7319;2353;7169;132;394;2049;6257;2181;6651
220690;201709;1589;4376;1391;4047;122;304;1041;3101;1163;3405
220695;201709;932;2663;846;2496;27;92;692;2024;719;2116
220700;201709;7905;22015;6802;20346;375;1272;5245;15550;5620;16822
220710;201709;832;2423;649;2052;47;135;464;1457;511;1592
220720;201709;1926;4895;1777;4672;40;134;1542;4018;1582;4152
220730;201709;1301;3787;1098;3465;27;115;900;2798;927;2913
220735;201709;977;2398;765;2047;25;64;634;1681;659;1745
220740;201709;1337;4037;1133;3764;34;123;973;3253;1007;3376
220750;201709;3628;10250;3311;9787;175;545;2809;8285;2984;8830
220755;201709;1098;3048;979;2856;37;133;782;2225;819;2358
220760;201709;2763;8715;2494;8344;90;364;2180;7266;2270;7630
220770;201709;19100;62945;17148;59272;6088;21848;5441;19778;11529;41626
220775;201709;1099;2985;1049;2929;11;50;1028;2858;1039;2908
220777;201709;1551;4145;1263;3687;49;140;952;2764;1001;2904
220779;201709;1294;3228;1196;3100;27;100;1071;2742;1098;2842
220780;201709;5209;14208;4620;13275;273;942;3723;10498;3996;11440
220785;201709;1368;3202;1267;3058;32;46;1195;2892;1227;2938
220790;201709;9831;29085;8989;27813;366;1505;7572;23094;7938;24599
220793;201709;761;2178;675;2043;27;94;562;1702;589;1796
220795;201709;1382;3823;1259;3658;38;143;1124;3255;1162;3398
220800;201709;15025;39726;13157;36860;857;2591;9385;25652;10242;28243
220810;201709;2880;8385;2537;7776;65;258;2107;6319;2172;6577
220820;201709;5152;13882;4581;13050;432;1157;3540;10124;3972;11281
220830;201709;6828;19367;6337;18616;366;1153;5193;15195;5559;16348
220840;201709;12260;38750;10871;35936;2042;6667;6091;20443;8133;27110
220850;201709;2891;9463;2695;9217;74;375;2430;8250;2504;8625
220855;201709;585;1732;509;1603;22;98;409;1261;431;1359
220860;201709;930;2438;815;2267;22;80;718;1972;740;2052
220865;201709;2537;6879;2011;5980;59;256;1605;4631;1664;4887
220870;201709;2266;7346;1983;6962;37;197;1823;6364;1860;6561
220880;201709;4698;12383;4301;11922;43;155;4055;11223;4098;11378
220885;201709;1200;4262;1056;3993;63;324;818;3071;881;3395
220887;201709;1298;3117;1161;2927;10;37;1091;2729;1101;2766
220890;201709;1550;5183;1340;4778;98;352;991;3581;1089;3933
220900;201709;1873;4947;1632;4613;37;111;1430;4005;1467;4116
220910;201709;1458;4361;1268;4069;40;140;1115;3592;1155;3732
220915;201709;928;2605;792;2343;24;105;632;1813;656;1918
220920;201709;1280;4578;1134;4365;79;407;879;3302;958;3709
220930;201709;1460;4525;1325;4320;34;165;1176;3761;1210;3926
220935;201709;1037;3048;848;2637;35;136;588;1725;623;1861
220937;201709;1344;3706;1178;3441;32;124;962;2750;994;2874
220940;201709;1318;4038;1148;3691;46;204;843;2633;889;2837
220945;201709;399;1472;361;1387;22;120;266;992;288;1112
220950;201709;1323;3188;892;2481;19;81;692;1853;711;1934
220955;201709;1430;4036;1265;3750;50;145;1033;3059;1083;3204
220960;201709;880;2230;696;1933;15;62;557;1527;572;1589
220965;201709;1661;4786;1516;4558;30;176;1314;3826;1344;4002
220970;201709;1849;4942;1451;4291;64;190;1129;3347;1193;3537
220975;201709;688;2189;616;2098;25;163;544;1760;569;1923
220980;201709;1134;3372;1036;3201;33;133;855;2601;888;2734
220985;201709;1159;3331;1062;3182;54;217;817;2339;871;2556
220987;201709;1426;4457;1267;4188;62;274;1028;3340;1090;3614
220990;201709;1697;4923;1460;4536;40;195;1154;3486;1194;3681
220995;201709;1189;3533;920;3098;69;270;656;2230;725;2500
220997;201709;2329;6915;2213;6748;45;189;2050;6192;2095;6381
221000;201709;3961;11743;3706;11324;184;762;3035;9109;3219;9871
221005;201709;1365;4073;1248;3851;121;357;919;2806;1040;3163
221010;201709;1169;2965;990;2744;23;79;869;2373;892;2452
221020;201709;1565;4930;1449;4695;38;180;1087;3470;1125;3650
221030;201709;1429;4168;1267;3911;45;195;1024;3093;1069;3288
221035;201709;1311;3672;1219;3549;25;62;1136;3361;1161;3423
221037;201709;590;1740;511;1599;12;57;359;1066;371;1123
221038;201709;538;1528;423;1326;25;91;282;876;307;967
221039;201709;878;2400;774;2246;19;71;654;1855;673;1926
221040;201709;4224;13054;3901;12526;159;542;3145;10138;3304;10680
221050;201709;3387;9874;3128;9548;60;246;2837;8595;2897;8841
221060;201709;7685;22529;6628;20760;323;1125;5204;16285;5527;17410
221062;201709;1191;4120;1052;3834;50;267;823;2950;873;3217
221063;201709;1107;3430;977;3218;80;291;700;2288;780;2579
221065;201709;2617;6929;2325;6460;52;179;2022;5526;2074;5705
221070;201709;3473;11080;2997;10180;171;641;2256;7629;2427;8270
221080;201709;3395;8520;2764;7589;81;307;2233;6049;2314;6356
221090;201709;1347;3682;1152;3349;23;92;981;2793;1004;2885
221093;201709;1449;4274;1361;4093;162;518;883;2554;1045;3072
221095;201709;882;2383;763;2187;7;27;632;1773;639;1800
221097;201709;788;2147;625;1845;21;78;460;1307;481;1385
221100;201709;94481;274422;85688;259246;16028;50089;49532;148333;65560;198422
221110;201709;9854;30398;9141;29520;303;1388;7958;25402;8261;26790
221120;201709;3908;12104;3699;11745;390;1291;2870;9127;3260;10418
221130;201709;4391;12281;3549;10572;1017;2929;1463;4462;2480;7391
221135;201709;1465;4311;1363;4157;46;172;1202;3644;1248;3816
221140;201709;1249;3081;1124;2894;12;38;1016;2582;1028;2620
221150;201709;1123;2859;893;2457;27;104;688;1806;715;1910
221160;201709;753;1954;689;1868;22;61;567;1525;589;1586
221170;201709;1081;3206;982;3038;27;98;799;2451;826;2549
230010;201709;3187;8623;2589;7563;197;649;1965;5632;2162;6281
230015;201709;2789;9519;2628;9191;272;1105;1782;6131;2054;7236
230020;201709;13023;42101;12615;41434;506;2094;10827;35148;11333;37242
230030;201709;11560;32032;10309;30160;308;1127;8898;25849;9206;26976
230040;201709;4071;11200;3515;10238;157;592;2774;7943;2931;8535
230050;201709;2651;8709;1959;6907;468;1584;607;2195;1075;3779
230060;201709;2242;6343;1882;5696;72;287;1514;4478;1586;4765
230070;201709;3892;11191;3352;10134;200;714;2346;7170;2546;7884
230075;201709;8753;29691;8165;28604;470;2346;6532;22300;7002;24646
230080;201709;2316;5791;1914;5175;53;213;1616;4281;1669;4494
230090;201709;3820;10488;3387;9783;208;699;2570;7298;2778;7997
230100;201709;16236;46681;15049;44788;2145;6708;9366;28023;11511;34731
230110;201709;11270;35418;10256;33296;1894;6397;5632;18286;7526;24683
230120;201709;7321;20398;6440;19037;620;1746;4694;14236;5314;15982
230125;201709;2895;8175;2427;7373;108;395;1847;5578;1955;5973
230130;201709;5588;17953;4710;16074;542;1954;3018;10146;3560;12100
230140;201709;3397;10581;2903;9699;156;645;2083;6908;2239;7553
230150;201709;1553;4794;1362;4368;278;902;717;2332;995;3234
230160;201709;6059;17059;5386;16049;244;938;4411;12988;4655;13926
230170;201709;5822;17803;5119;16447;257;1014;3806;11983;4063;12997
230180;201709;1625;4672;1391;4213;47;213;1055;3052;1102;3265
230185;201709;3761;11934;3348;11177;382;1361;2332;7859;2714;9220
230190;201709;11905;37019;10452;34141;1636;5597;5533;18072;7169;23669
230195;201709;5059;15362;4513;14412;318;1139;3498;11023;3816;12162
230200;201709;4692;13328;4225;12417;206;681;3325;9556;3531;10237
230205;201709;3881;12557;3549;11952;223;972;2601;8609;2824;9581
230210;201709;8789;24239;7658;22451;648;2061;5451;15953;6099;18014
230220;201709;12758;35169;11572;33170;644;2104;9111;25777;9755;27881
230230;201709;6830;21417;6215;20225;539;1800;4514;14648;5053;16448
230240;201709;12843;35002;11363;32607;587;1597;9007;25825;9594;27422
230250;201709;8890;26786;8831;26676;433;1594;6936;20468;7369;22062
230260;201709;14004;45313;12774;42762;1754;6205;7472;25259;9226;31464
230270;201709;7331;20917;6036;18515;675;2157;3864;11942;4539;14099
230280;201709;19455;56117;16912;51661;906;3523;13029;38757;13935;42280
230290;201709;4585;13568;3970;12288;454;1302;2768;8676;3222;9978
230300;201709;4195;12199;3993;11910;158;659;3418;9961;3576;10620
230310;201709;4692;13782;4058;12662;133;546;2954;9029;3087;9575
230320;201709;7238;21497;6437;20049;386;1504;4873;14926;5259;16430
230330;201709;4646;13233;3920;11833;239;773;2861;8537;3100;9310
230340;201709;3383;11084;3027;10330;270;1017;2115;7116;2385;8133
230350;201709;17715;51808;16059;48952;1201;4385;10379;31960;11580;36345
230360;201709;2933;8281;2332;7166;151;539;1607;4868;1758;5407
230365;201709;2944;7642;2532;6969;69;296;2149;5797;2218;6093
230370;201709;49772;153773;44749;145345;10785;36040;20690;70194;31475;106234
230380;201709;6261;17996;5154;15906;200;750;3703;11229;3903;11979
230390;201709;3246;10163;2913;9587;157;672;2199;7087;2356;7759
230393;201709;2918;9448;2520;8646;117;618;1867;6155;1984;6773
230395;201709;5367;15211;4813;14253;564;1680;3168;9548;3732;11228
230400;201709;5387;15850;4847;14948;196;861;3873;11658;4069;12519
230410;201709;14008;43572;11825;39071;1538;5223;7135;23721;8673;28944
230420;201709;23163;71408;20672;66528;3427;11712;10708;34342;14135;46054
230423;201709;4288;13424;3808;12469;155;638;3036;9805;3191;10443
230425;201709;5378;17588;4957;16675;592;2034;3270;11045;3862;13079
230426;201709;2470;6865;1952;5859;55;234;1463;4317;1518;4551
230427;201709;1791;5232;1299;4111;83;281;854;2598;937;2879
230428;201709;8537;25281;7966;24244;1359;4398;4391;13220;5750;17618
230430;201709;4324;13323;3811;12365;248;980;2826;8900;3074;9880
230435;201709;5110;15174;4519;14075;582;1919;2735;8528;3317;10447
230440;201709;351623;979427;311880;914104;59326;181479;159651;470916;218977;652395
230445;201709;4300;11727;3683;10665;205;576;2659;7642;2864;8218
230450;201709;3412;10454;3016;9754;230;966;2195;6953;2425;7919
230460;201709;1828;5787;1610;5378;106;416;1228;4090;1334;4506
230465;201709;3899;11392;3272;10255;124;539;2358;7147;2482;7686
230470;201709;10804;37986;9962;36305;1032;4436;7060;25360;8092;29796
230480;201709;1356;4173;1170;3797;110;428;840;2653;950;3081
230490;201709;2258;6734;1985;6223;239;771;1112;3379;1351;4150
230495;201709;5436;17279;4945;16327;458;1899;3247;10534;3705;12433
230500;201709;8187;28838;7767;27995;437;1977;5949;21364;6386;23341
230510;201709;1541;5236;1162;4272;240;938;430;1578;670;2516
230520;201709;4171;12636;3814;11953;333;1164;2664;8220;2997;9384
230523;201709;14435;44910;12301;40208;2941;9907;3175;10846;6116;20753
230526;201709;3802;11213;3272;10272;159;718;2568;7832;2727;8550
230530;201709;5058;16068;4509;15194;551;1977;3155;10760;3706;12737
230533;201709;3892;10570;3402;9676;265;723;2558;7343;2823;8066
230535;201709;5241;15152;4525;13834;335;1050;3146;9799;3481;10849
230540;201709;15997;46248;14504;43898;400;1670;12382;36969;12782;38639
230550;201709;18438;53048;16055;48644;2366;7713;9046;27105;11412;34818
230560;201709;6947;19112;5839;17082;147;583;4687;13445;4834;14028
230565;201709;3308;9044;2692;7928;95;360;2017;5877;2112;6237
230570;201709;3386;9027;2970;8461;92;290;2485;7036;2577;7326
230580;201709;9290;27315;8468;26096;425;1625;7065;21538;7490;23163
230590;201709;8754;26323;7423;23789;533;1969;5170;16131;5703;18100
230600;201709;3725;10103;2830;8329;95;315;1850;5494;1945;5809
230610;201709;6130;18525;5551;17591;476;1558;4163;13200;4639;14758
230620;201709;2053;5775;1616;4865;173;558;941;2760;1114;3318
230625;201709;7631;23825;6847;22128;2061;6981;1852;6162;3913;13143
230630;201709;10203;31771;9281;29974;2529;7717;4044;14117;6573;21834
230640;201709;25776;81369;23732;78140;1913;7155;18461;60452;20374;67607
230650;201709;4522;13609;4079;12737;294;1008;3051;9380;3345;10388
230655;201709;9147;32861;8761;32179;601;2586;6967;25659;7568;28245
230660;201709;5909;18135;5043;16419;216;1105;4045;12848;4261;13953
230670;201709;5771;14965;4562;12863;174;581;3556;9770;3730;10351
230680;201709;2479;7257;2160;6640;261;806;1402;4315;1663;5121
230690;201709;6302;19858;5903;18967;605;2133;3605;11405;4210;13538
230700;201709;9120;25018;8082;23083;416;1463;5999;16564;6415;18027
230710;201709;6998;22409;6100;20714;612;2173;4384;14895;4996;17068
230720;201709;1771;5520;1517;4966;187;634;955;3119;1142;3753
230725;201709;3557;11777;3057;10505;776;2725;937;3254;1713;5979
230730;201709;50994;150837;43628;138656;11731;40784;12755;42992;24486;83776
230740;201709;6099;17655;5454;16560;187;715;4296;12913;4483;13628
230750;201709;7772;22159;6755;20440;272;1005;5212;15412;5484;16417
230760;201709;10824;31045;9891;29329;826;2858;7084;20424;7910;23282
230763;201709;4187;12474;3657;11444;220;873;2756;8319;2976;9192
230765;201709;37501;113063;33092;104861;8044;26777;11276;36603;19320;63380
230770;201709;24677;66650;21744;62372;2879;8650;13611;39171;16490;47821
230780;201709;5661;20910;5409;20365;997;3722;3101;12128;4098;15850
230790;201709;2772;8505;2600;8219;164;570;2054;6492;2218;7062
230800;201709;7360;24948;6742;23634;1007;3853;3775;13100;4782;16953
230810;201709;11181;35314;10448;34024;552;2149;8157;26162;8709;28311
230820;201709;3058;10367;2694;9570;288;1199;1640;5665;1928;6864
230830;201709;7213;21424;6360;19853;271;1116;4979;15236;5250;16352
230835;201709;3813;9857;3108;8714;137;469;2473;6798;2610;7267
230837;201709;2979;9924;2606;9171;164;751;1930;6616;2094;7367
230840;201709;8297;26266;7554;24987;535;1949;5961;19748;6496;21697
230850;201709;8806;27047;8026;25628;625;2184;5702;18177;6327;20361
230860;201709;4795;13322;4152;12332;187;673;3453;10135;3640;10808
230870;201709;16790;43267;14638;40015;601;1820;11524;31362;12125;33182
230880;201709;1919;6299;1784;6042;90;442;1348;4432;1438;4874
230890;201709;4184;14430;3888;13828;394;1559;2680;9452;3074;11011
230900;201709;2818;8987;2393;8053;359;1192;1398;4679;1757;5871
230910;201709;2939;8500;2424;7585;114;517;1880;5752;1994;6269
230920;201709;4317;12427;3988;11984;156;616;3466;10333;3622;10949
230930;201709;6484;19248;5640;17607;462;1563;3773;11668;4235;13231
230940;201709;7316;20576;6590;19352;192;695;5486;16006;5678;16701
230945;201709;6213;18537;5486;17154;447;1522;3756;11855;4203;13377
230950;201709;6164;16243;5659;15609;130;314;5061;14234;5191;14548
230960;201709;13108;40249;12034;38154;1920;6390;6102;19588;8022;25978
230970;201709;12590;36808;11017;34137;2089;6861;5328;16608;7417;23469
230980;201709;2623;8017;2301;7441;511;1598;1289;4336;1800;5934
230990;201709;1703;4906;1408;4353;102;422;950;2811;1052;3233
231000;201709;2486;6780;2080;5959;98;304;1454;4096;1552;4400
231010;201709;2881;7815;2385;6969;189;619;1736;4993;1925;5612
231020;201709;7751;25501;7245;24361;1265;4099;4296;14921;5561;19020
231025;201709;7120;21592;6558;20579;1104;3534;4020;12818;5124;16352
231030;201709;6774;21659;5729;19416;1058;3660;3003;10241;4061;13901
231040;201709;3026;9205;2694;8568;105;437;2065;6437;2170;6874
231050;201709;11131;30864;9462;27869;579;1789;7166;20959;7745;22748
231060;201709;2421;7585;2202;7222;103;491;1694;5458;1797;5949
231070;201709;7844;24351;6988;22642;1193;3903;3811;12564;5004;16467
231080;201709;3834;11645;3504;11059;143;738;2730;8269;2873;9007
231085;201709;5049;14854;4741;14416;414;1194;3551;11124;3965;12318
231090;201709;4115;11335;3256;9604;117;427;2309;6662;2426;7089
231095;201709;1989;6302;1721;5704;153;558;1191;3913;1344;4471
231100;201709;2856;8859;2457;8113;218;737;1748;5763;1966;6500
231110;201709;3298;10591;3259;10520;256;997;2351;7421;2607;8418
231120;201709;1842;6051;1690;5745;173;612;1128;3824;1301;4436
231123;201709;1865;5028;1613;4578;96;300;1206;3349;1302;3649
231126;201709;5780;16471;4734;14446;203;747;3395;10114;3598;10861
231130;201709;17971;53308;16218;50494;2000;6815;10674;33778;12674;40593
231135;201709;3995;11648;3401;10566;178;654;2471;7561;2649;8215
231140;201709;16847;50861;14316;46099;981;4127;9735;30449;10716;34576
231150;201709;5021;14570;4418;13432;705;2158;2280;7057;2985;9215
231160;201709;5313;17423;4980;16738;885;2925;2898;9941;3783;12866
231170;201709;4080;12710;3535;11581;245;940;2462;7866;2707;8806
231180;201709;13709;40108;11868;36292;2400;7434;5545;16815;7945;24249
231190;201709;4000;11565;3477;10686;193;796;2618;7757;2811;8553
231195;201709;4388;14505;3813;13287;277;1214;2683;9113;2960;10327
231200;201709;7780;25502;6816;23491;304;1554;5060;16913;5364;18467
231210;201709;4608;14501;4077;13602;198;888;3093;10067;3291;10955
231220;201709;11168;30813;9488;27658;473;1562;7060;20067;7533;21629
231230;201709;8613;28164;7840;26942;593;2353;5947;20471;6540;22824
231240;201709;10937;33670;10023;31848;1792;5801;5684;18279;7476;24080
231250;201709;1905;5237;1333;3900;127;375;702;2005;829;2380
231260;201709;3081;9291;2787;8800;364;1105;1836;5942;2200;7047
231270;201709;6582;17779;5711;16385;209;862;4440;12461;4649;13323
231280;201709;1635;5283;1531;5081;148;506;1080;3591;1228;4097
231290;201709;33718;107659;30189;100085;5490;19170;13790;45329;19280;64499
231300;201709;3924;11394;3255;10023;248;823;2161;6545;2409;7368
231310;201709;7212;20049;5921;17395;747;2225;3572;10353;4319;12578
231320;201709;6934;20545;5687;18015;167;735;4326;13502;4493;14237
231325;201709;2523;7273;2146;6645;439;1306;1120;3578;1559;4884
231330;201709;9995;31869;8699;29150;1673;5599;4555;15556;6228;21155
231335;201709;5310;14764;4574;13491;127;578;3854;11150;3981;11728
231340;201709;16851;54472;15510;52230;1251;4322;11748;40081;12999;44403
231350;201709;14475;41368;13588;40175;369;1128;12276;36507;12645;37635
231355;201709;4391;13725;3969;12986;237;930;2995;9735;3232;10665
231360;201709;7224;22711;6410;21281;721;2480;4450;14950;5171;17430
231370;201709;2299;6333;1821;5511;51;175;1383;4151;1434;4326
231375;201709;4094;13486;3802;12934;165;767;3092;10342;3257;11109
231380;201709;5348;15545;5090;15212;181;471;4406;13495;4587;13966
231390;201709;3247;9975;2964;9472;246;924;2117;6621;2363;7545
231395;201709;3680;11815;3298;11093;625;2114;1811;6198;2436;8312
231400;201709;8739;26401;7947;24829;415;1624;6088;18666;6503;20290
231410;201709;14291;46388;13016;44372;1136;3944;9811;33483;10947;37427
240010;201709;2360;6846;1928;5978;209;755;1166;3513;1375;4268
240020;201709;10077;30864;9052;28873;1215;4173;5496;17477;6711;21650
240030;201709;2491;6846;2398;6714;119;391;2116;5866;2235;6257
240040;201709;838;2423;699;2148;20;95;515;1513;535;1608
240050;201709;3242;8770;2729;7867;71;236;2148;6071;2219;6307
240060;201709;1339;3764;1169;3435;45;158;918;2626;963;2784
240070;201709;2179;6626;2027;6312;239;780;1448;4447;1687;5227
240080;201709;2772;7530;2378;6942;104;383;1806;5208;1910;5591
240090;201709;2174;5731;1825;5121;30;107;1464;4031;1494;4138
240100;201709;7821;21641;6830;19707;520;1577;4995;14126;5515;15703
240110;201709;4390;13443;3872;12431;419;1511;2415;7644;2834;9155
240120;201709;2468;8613;2348;8348;273;1109;1535;5405;1808;6514
240130;201709;2779;7003;2439;6476;86;282;2102;5500;2188;5782
240140;201709;2129;6366;1803;5740;210;771;1152;3607;1362;4378
240145;201709;5704;17346;5033;16194;852;2874;3024;9888;3876;12762
240150;201709;849;2649;753;2443;50;215;579;1799;629;2014
240160;201709;1356;4231;1189;3928;87;343;822;2727;909;3070
240165;201709;824;2526;721;2303;109;337;461;1484;570;1821
240170;201709;2189;6477;1884;5912;266;920;1137;3475;1403;4395
240180;201709;2651;8239;2334;7581;421;1411;1345;4420;1766;5831
240185;201709;1262;4211;1157;4035;67;293;953;3297;1020;3590
240190;201709;922;2904;820;2729;28;130;665;2186;693;2316
240200;201709;10848;29547;9386;27164;1690;5022;4342;12819;6032;17841
240210;201709;2700;7453;2457;7050;77;317;2052;5716;2129;6033
240220;201709;7051;23407;6481;22575;615;2630;4634;16125;5249;18755
240230;201709;5594;14722;4744;13355;308;840;3684;10411;3992;11251
240240;201709;1755;5358;1061;3584;175;605;218;689;393;1294
240250;201709;2528;7377;2372;7157;178;499;1908;5801;2086;6300
240260;201709;11493;37539;10790;36383;1413;5034;7169;24465;8582;29499
240270;201709;2176;6762;2018;6505;113;386;1662;5383;1775;5769
240280;201709;1521;4173;1352;3937;52;170;1119;3221;1171;3391
240290;201709;1153;3579;997;3255;41;203;660;1992;701;2195
240300;201709;2195;5871;1650;4787;126;406;925;2629;1051;3035
240310;201709;8892;24782;7855;23040;1030;3237;4342;12732;5372;15969
240320;201709;1944;5543;1466;4538;35;168;1128;3324;1163;3492
240325;201709;28481;80870;23287;72013;6736;21949;6034;19929;12770;41878
240330;201709;1419;4225;1200;3769;64;259;804;2416;868;2675
240340;201709;1901;4809;1576;4299;98;260;1201;3226;1299;3486
240350;201709;1988;5430;1839;5251;48;166;1624;4623;1672;4789
240360;201709;6406;19688;5781;18685;1464;4609;2900;9967;4364;14576
240370;201709;1962;5401;1555;4601;142;416;991;2909;1133;3325
240375;201709;833;2209;740;2042;35;139;556;1455;591;1594
240380;201709;2285;6758;1711;5438;163;555;952;2976;1115;3531
240390;201709;884;2396;704;2033;13;45;481;1299;494;1344
240400;201709;1305;3477;1007;2904;41;147;694;1928;735;2075
240410;201709;475;1543;433;1452;63;244;256;839;319;1083
240420;201709;4331;16511;4009;15740;655;3092;2166;8324;2821;11416
240430;201709;3143;8761;2810;8128;175;634;2147;5993;2322;6627
240440;201709;2367;5855;2111;5492;266;720;1441;3719;1707;4439
240450;201709;3826;11080;3175;9847;367;1238;1866;5663;2233;6901
240460;201709;2912;8650;2716;8372;247;849;2131;6529;2378;7378
240470;201709;3514;10924;2756;9308;348;1200;1589;5368;1937;6568
240480;201709;524;1425;392;1175;36;110;194;576;230;686
240485;201709;2013;6134;1736;5583;177;581;1169;3809;1346;4390
240490;201709;1681;4228;1401;3759;23;65;1206;3213;1229;3278
240500;201709;2147;5933;1914;5601;75;253;1600;4653;1675;4906
240510;201709;1586;4568;1497;4433;127;381;1216;3561;1343;3942
240520;201709;1241;3377;1062;3118;45;190;886;2511;931;2701
240530;201709;1848;5985;1722;5780;171;624;1280;4271;1451;4895
240540;201709;1866;5234;1715;5000;68;242;1481;4247;1549;4489
240550;201709;709;2009;614;1843;39;120;457;1363;496;1483
240560;201709;3196;8890;2885;8443;304;785;2185;6528;2489;7313
240570;201709;2871;7823;2078;6023;280;875;985;2603;1265;3478
240580;201709;7393;22393;6863;21500;511;1806;5504;17089;6015;18895
240590;201709;689;1918;599;1750;19;71;475;1361;494;1432
240600;201709;1634;4638;1240;3803;109;384;749;2222;858;2606
240610;201709;4294;12247;3753;11235;264;861;2635;7771;2899;8632
240615;201709;974;2858;798;2497;109;376;510;1531;619;1907
240620;201709;1780;5205;1559;4835;120;357;1228;3788;1348;4145
240630;201709;1985;5947;1818;5672;154;411;1259;4030;1413;4441
240640;201709;886;2480;733;2235;59;226;511;1496;570;1722
240650;201709;3849;11127;3464;10502;184;583;2734;8258;2918;8841
240660;201709;2391;7241;2255;7038;113;403;1901;5850;2014;6253
240670;201709;2417;7184;2046;6381;188;654;1269;3834;1457;4488
240680;201709;1484;4262;1211;3777;64;239;847;2586;911;2825
240690;201709;852;2297;722;2068;28;99;588;1627;616;1726
240700;201709;2362;6997;2005;6344;71;300;1564;4822;1635;5122
240710;201709;15313;42300;13572;39186;2714;7660;7243;21454;9957;29114
240720;201709;4859;13515;4375;12685;934;2780;2322;6637;3256;9417
240725;201709;1020;3062;811;2584;52;178;511;1587;563;1765
240730;201709;2024;5984;1764;5468;119;384;1322;4057;1441;4441
240740;201709;1783;5031;1559;4606;73;302;1148;3230;1221;3532
240750;201709;1954;7246;1810;6953;363;1517;948;3695;1311;5212
240760;201709;1305;3492;988;2997;54;145;752;2313;806;2458
240770;201709;2984;8530;2675;8103;141;540;2230;6616;2371;7156
240780;201709;5347;14851;4414;13351;522;1599;2747;8446;3269;10045
240790;201709;838;2496;697;2227;23;95;531;1701;554;1796
240800;201709;33146;93038;29041;86041;5528;16989;13106;39335;18634;56324
240810;201709;76735;218116;69925;206175;17196;50603;32864;99346;50060;149949
240820;201709;5117;16464;4649;15716;1019;3526;2347;8296;3366;11822
240830;201709;8310;25185;7766;24367;349;1453;6460;19995;6809;21448
240840;201709;1098;2967;918;2651;75;232;632;1769;707;2001
240850;201709;1224;3565;917;2875;75;249;507;1578;582;1827
240860;201709;1224;3441;975;2978;31;143;729;2114;760;2257
240870;201709;1110;2937;884;2553;60;185;601;1674;661;1859
240880;201709;1197;3963;1143;3855;92;357;916;3042;1008;3399
240890;201709;4567;12788;3709;11111;678;2117;1708;5069;2386;7186
240895;201709;2521;8657;2351;8375;245;940;1749;6282;1994;7222
240910;201709;2965;8628;2599;7910;78;294;2107;6343;2185;6637
240920;201709;740;2354;645;2155;90;322;343;1126;433;1448
240930;201709;3353;8442;2927;7920;71;188;2378;6533;2449;6721
240933;201709;1655;4284;1424;3910;51;191;1163;3107;1214;3298
240940;201709;5928;15446;4822;13611;433;1260;3333;9214;3766;10474
240950;201709;913;2896;830;2733;46;198;625;2005;671;2203
240960;201709;779;2385;680;2182;51;179;489;1540;540;1719
240970;201709;1779;4882;1509;4408;67;249;1216;3442;1283;3691
240980;201709;2749;8999;2556;8647;298;1132;1805;6014;2103;7146
240990;201709;2438;7269;2313;7028;344;1105;1583;4748;1927;5853
241000;201709;949;2615;809;2361;35;119;568;1638;603;1757
241010;201709;2624;8800;2484;8539;276;1157;1787;5922;2063;7079
241020;201709;1982;5484;1533;4537;194;534;887;2618;1081;3152
241025;201709;1657;4946;1420;4507;92;330;914;2904;1006;3234
241030;201709;2369;7739;2053;7084;198;783;1386;4719;1584;5502
241040;201709;2178;7243;1977;6893;141;586;1500;5224;1641;5810
241050;201709;1208;3541;1033;3217;56;195;742;2254;798;2449
241060;201709;751;2168;670;2012;56;160;453;1355;509;1515
241070;201709;624;1809;565;1703;41;162;438;1245;479;1407
241080;201709;1108;3236;878;2781;26;119;658;2042;684;2161
241090;201709;1868;5719;1617;5283;71;323;1238;3991;1309;4314
241100;201709;1131;3309;960;2926;56;195;653;1953;709;2148
241105;201709;1093;3315;934;3031;243;770;383;1292;626;2062
241110;201709;842;2540;678;2167;38;137;445;1368;483;1505
241120;201709;6886;20845;6208;19613;1452;4348;3185;10748;4637;15096
241140;201709;3202;8531;2732;7629;179;495;2011;5486;2190;5981
241142;201709;734;2076;562;1735;46;162;324;973;370;1135
241150;201709;5326;15248;4802;14366;275;1013;3649;10733;3924;11746
241160;201709;897;2598;796;2429;154;460;420;1275;574;1735
241170;201709;1125;3139;1028;2971;70;207;829;2334;899;2541
241180;201709;939;2576;701;2081;85;255;365;1072;450;1327
241190;201709;1076;2948;877;2548;38;145;629;1748;667;1893
241200;201709;17295;48776;15341;45838;3574;11011;7217;22238;10791;33249
241210;201709;1397;3868;1098;3269;112;352;668;1954;780;2306
241220;201709;7663;24715;7030;23547;2165;7296;2998;10521;5163;17817
241230;201709;2923;8277;2683;7893;111;431;2228;6363;2339;6794
241240;201709;1173;3420;717;2340;56;213;361;1184;417;1397
241250;201709;5812;17485;4814;15566;193;985;3582;11116;3775;12101
241255;201709;1749;6296;1566;5889;217;936;950;3543;1167;4479
241260;201709;4863;13101;3899;11557;132;601;2886;8348;3018;8949
241270;201709;1779;5349;1540;4873;110;447;1120;3465;1230;3912
241280;201709;1768;5037;1619;4766;122;377;1259;3655;1381;4032
241290;201709;2946;7949;2426;7060;118;423;1839;5244;1957;5667
241300;201709;1424;3989;1214;3609;42;129;834;2442;876;2571
241310;201709;1743;4884;1574;4608;56;221;1319;3792;1375;4013
241320;201709;868;3034;790;2844;99;408;508;1804;607;2212
241330;201709;1363;4095;1275;3979;56;240;1100;3373;1156;3613
241335;201709;2809;8245;2548;7777;122;429;2100;6318;2222;6747
241340;201709;1688;5137;1399;4483;303;1002;612;1922;915;2924
241350;201709;1833;5683;1670;5376;117;447;1246;3917;1363;4364
241355;201709;1309;3656;1058;3193;45;170;814;2429;859;2599
241360;201709;2039;5399;1658;4656;71;211;1225;3366;1296;3577
241370;201709;1334;3887;1078;3383;87;317;705;2116;792;2433
241380;201709;622;1742;508;1520;63;211;304;874;367;1085
241390;201709;2547;8176;2371;7896;187;693;1845;6143;2032;6836
241400;201709;3504;10074;3185;9598;267;848;2469;7462;2736;8310
241410;201709;2310;7010;2031;6556;389;1304;1164;3758;1553;5062
241415;201709;1562;4695;1362;4345;122;433;1023;3192;1145;3625
241420;201709;1987;6895;1783;6526;558;2164;544;2050;1102;4214
241430;201709;504;1451;389;1209;33;119;238;715;271;834
241440;201709;6381;22067;5896;21210;535;2261;4426;15773;4961;18034
241445;201709;906;2633;868;2587;31;70;792;2418;823;2488
241450;201709;2766;7325;2490;6924;251;678;1853;5167;2104;5845
241460;201709;3304;9412;2907;8597;212;720;2094;6027;2306;6747
241470;201709;1335;3654;1101;3331;67;239;876;2626;943;2865
241475;201709;1178;3525;977;3126;44;237;704;2135;748;2372
241480;201709;2556;8378;2304;7904;881;3021;625;2477;1506;5498
241490;201709;672;1740;541;1524;25;74;375;1017;400;1091
241500;201709;733;2298;631;2170;19;73;542;1870;561;1943
250010;201709;2673;8244;2244;7310;84;368;1652;5256;1736;5624
250020;201709;1546;4360;1168;3596;61;194;817;2466;878;2660
250030;201709;6596;18857;6036;18059;345;1146;4893;14401;5238;15547
250040;201709;3752;12447;3481;11869;351;1322;2452;8247;2803;9569
250050;201709;3184;9803;2962;9443;375;1245;2059;6480;2434;7725
250053;201709;1181;3529;1084;3380;114;375;767;2408;881;2783
250057;201709;618;2520;604;2505;3;9;581;2447;584;2456
250060;201709;4942;14234;4583;13726;430;1348;3553;10667;3983;12015
250070;201709;3740;11365;3449;10811;70;363;2667;8048;2737;8411
250073;201709;748;2165;648;1994;16;66;496;1468;512;1534
250077;201709;2079;5954;1648;5198;97;320;1180;3689;1277;4009
250080;201709;4076;11500;3833;11095;138;514;3212;9099;3350;9613
250090;201709;2586;7139;2393;6827;134;354;1967;5581;2101;5935
250100;201709;3693;11796;3455;11353;175;736;2825;9036;3000;9772
250110;201709;4598;13542;4316;13126;439;1594;3360;9964;3799;11558
250115;201709;483;1493;438;1420;18;97;330;1029;348;1126
250120;201709;1672;5267;1480;4898;66;292;1173;3874;1239;4166
250130;201709;5034;15523;4543;14595;136;713;3613;11335;3749;12048
250135;201709;1016;3062;952;2950;27;109;793;2429;820;2538
250140;201709;2017;6493;1960;6397;98;424;1628;5273;1726;5697
250150;201709;4694;15667;4348;14982;194;935;3356;11292;3550;12227
250153;201709;1416;3777;1178;3419;28;119;979;2788;1007;2907
250157;201709;1706;5432;1562;5130;211;646;1058;3544;1269;4190
250160;201709;3264;9298;3042;8961;67;233;2769;8150;2836;8383
250170;201709;1549;4450;1410;4234;75;289;1139;3368;1214;3657
250180;201709;15424;43394;14282;41730;1094;3756;10692;30475;11786;34231
250190;201709;3864;11165;3532;10606;539;1519;2267;6865;2806;8384
250200;201709;1822;5339;1548;4902;56;232;1264;3968;1320;4200
250205;201709;767;2645;717;2529;23;129;580;2020;603;2149
250210;201709;1442;4654;1342;4482;60;308;1053;3425;1113;3733
250215;201709;1348;4115;1207;3901;66;262;809;2583;875;2845
250220;201709;694;2022;562;1818;25;86;416;1338;441;1424
250230;201709;1554;3832;1212;3258;37;129;959;2483;996;2612
250240;201709;2193;7068;2042;6795;81;321;1684;5557;1765;5878
250250;201709;4317;12875;3925;12327;130;457;3277;10274;3407;10731
250260;201709;1617;4739;1398;4365;41;143;1128;3522;1169;3665
250270;201709;1210;3754;1100;3608;87;278;819;2813;906;3091
250280;201709;3298;9691;2897;9050;167;588;2266;7032;2433;7620
250290;201709;1679;4600;1440;4264;14;45;1210;3577;1224;3622
250300;201709;4975;14643;4739;14343;287;1180;4036;11912;4323;13092
250310;201709;1059;3182;946;2978;31;130;740;2261;771;2391
250320;201709;8042;22504;7511;21754;701;2232;5831;16648;6532;18880
250330;201709;2310;7033;1972;6523;121;457;1525;4972;1646;5429
250340;201709;1034;2972;917;2780;15;55;773;2304;788;2359
250350;201709;3968;11111;3643;10686;124;390;3192;9372;3316;9762
250355;201709;1898;5916;1753;5733;26;143;1596;5185;1622;5328
250360;201709;1742;5092;1630;4902;35;119;1354;4058;1389;4177
250370;201709;10974;31288;9728;29724;579;1982;8101;24623;8680;26605
250375;201709;998;2956;911;2828;17;59;815;2556;832;2615
250380;201709;1586;4435;1503;4325;58;214;1239;3443;1297;3657
250390;201709;1719;4694;1436;4213;187;526;948;2813;1135;3339
250400;201709;66022;173713;51698;150668;13624;41460;18273;54938;31897;96398
250403;201709;1511;4898;1403;4746;171;695;952;3139;1123;3834
250407;201709;1178;3187;1012;2938;77;177;736;2145;813;2322
250410;201709;516;1597;473;1516;13;71;384;1175;397;1246
250415;201709;1881;5520;1672;5150;70;230;1314;4044;1384;4274
250420;201709;1154;3387;1065;3255;19;71;977;2987;996;3058
250430;201709;5985;15731;5336;14764;198;644;4392;11898;4590;12542
250435;201709;1310;3950;1168;3696;49;190;883;2755;932;2945
250440;201709;4318;12203;3888;11605;102;399;3325;9806;3427;10205
250450;201709;1777;5004;1545;4678;38;147;1292;3851;1330;3998
250460;201709;6166;18166;5823;17728;292;929;5101;15672;5393;16601
250470;201709;1459;3933;1232;3609;75;276;908;2576;983;2852
250480;201709;3587;10737;3308;10361;49;215;2976;9340;3025;9555
250485;201709;672;1602;496;1338;26;78;402;1051;428;1129
250490;201709;4012;11558;3761;11234;337;1093;2995;8933;3332;10026
250500;201709;1787;5271;1612;4976;84;275;1293;3990;1377;4265
250510;201709;4904;13340;4318;12534;81;258;3868;11249;3949;11507
250520;201709;1661;4923;1544;4758;207;722;1008;3021;1215;3743
250523;201709;1816;5083;1716;4950;83;358;1482;4146;1565;4504
250527;201709;1492;4283;1426;4197;32;129;1329;3867;1361;3996
250530;201709;562;1712;502;1632;18;79;444;1427;462;1506
250535;201709;1308;4023;1208;3824;39;193;944;2914;983;3107
250540;201709;2335;6355;2150;6140;67;183;1917;5473;1984;5656
250550;201709;838;2819;762;2689;33;169;618;2125;651;2294
250560;201709;1580;4807;1480;4638;52;195;1227;3752;1279;3947
250570;201709;2473;7707;2195;7180;91;408;1751;5570;1842;5978
250580;201709;1018;2723;931;2589;49;191;779;2102;828;2293
250590;201709;790;2403;714;2280;23;113;589;1816;612;1929
250600;201709;6967;19932;6439;19116;591;1582;5042;15172;5633;16754
250610;201709;2901;8439;2695;8125;168;575;2183;6506;2351;7081
250620;201709;662;1903;590;1758;53;199;425;1217;478;1416
250625;201709;2434;7450;2290;7212;46;193;2022;6271;2068;6464
250630;201709;8899;26923;7984;25044;1387;4475;4682;14502;6069;18977
250640;201709;3263;9876;3085;9628;130;577;2600;7915;2730;8492
250650;201709;823;2164;715;2023;38;123;572;1570;610;1693
250660;201709;1642;4279;1498;4090;25;59;1392;3794;1417;3853
250670;201709;2210;7333;2100;7137;69;372;1788;5925;1857;6297
250680;201709;4707;12719;4434;12404;151;544;3979;10983;4130;11527
250690;201709;5940;14795;5675;14486;214;531;5224;13317;5438;13848
250700;201709;4143;12214;3802;11681;412;1314;2758;8405;3170;9719
250710;201709;4192;12843;3756;12240;352;1248;2668;8767;3020;10015
250720;201709;2668;7352;2460;7013;47;208;2228;6274;2275;6482
250730;201709;3511;10169;3198;9729;215;748;2589;7698;2804;8446
250740;201709;1811;5002;1548;4614;149;473;1184;3453;1333;3926
250750;201709;90174;248407;82118;236605;9162;28616;55639;157573;64801;186189
250760;201709;2233;6143;1973;5747;127;431;1530;4358;1657;4789
250770;201709;3695;12108;3456;11792;317;1251;2545;8621;2862;9872
250780;201709;1625;4711;1405;4271;145;495;949;2815;1094;3310
250790;201709;2197;7057;2068;6824;337;1130;1285;4315;1622;5445
250800;201709;2431;6739;2128;6242;79;212;1753;5113;1832;5325
250810;201709;1199;3451;1030;3195;43;178;829;2530;872;2708
250820;201709;1759;5555;1707;5492;83;355;1522;4837;1605;5192
250830;201709;5109;16226;4720;15379;379;1463;3363;10724;3742;12187
250840;201709;839;2700;731;2480;23;98;504;1722;527;1820
250850;201709;1866;5626;1675;5306;53;280;1353;4147;1406;4427
250855;201709;1032;3050;900;2818;33;154;682;2074;715;2228
250860;201709;3075;9763;2617;8930;501;1817;1276;4423;1777;6240
250870;201709;1051;2983;908;2709;33;117;727;2147;760;2264
250880;201709;1475;4000;1211;3605;174;511;769;2348;943;2859
250890;201709;8918;25939;8525;25402;742;2730;6713;19465;7455;22195
250900;201709;2575;8132;2281;7563;111;417;1820;5925;1931;6342
250905;201709;2009;6176;1938;6091;99;393;1672;5189;1771;5582
250910;201709;4819;13564;4527;13148;155;557;3911;11296;4066;11853
250915;201709;1426;4213;1357;4134;31;66;1262;3914;1293;3980
250920;201709;3064;8580;2889;8317;316;865;2124;6079;2440;6944
250930;201709;1873;5546;1788;5402;108;399;1466;4340;1574;4739
250933;201709;1071;3486;963;3266;57;268;656;2145;713;2413
250937;201709;671;1968;566;1775;33;121;427;1315;460;1436
250939;201709;1574;4526;1385;4230;53;217;1111;3291;1164;3508
250940;201709;3596;10453;3372;10084;59;235;3017;9019;3076;9254
250950;201709;1380;3995;1178;3726;40;167;1006;3174;1046;3341
250960;201709;1023;3214;947;3081;33;138;770;2459;803;2597
250970;201709;8106;22187;7066;20503;450;1500;5313;15142;5763;16642
250980;201709;2437;7027;2228;6629;69;286;1779;5132;1848;5418
250990;201709;1866;6158;1658;5696;114;495;1205;4034;1319;4529
251000;201709;1994;5784;1707;5340;46;228;1429;4405;1475;4633
251010;201709;2580;7540;2339;7150;50;190;2090;6379;2140;6569
251020;201709;1603;4427;1480;4271;54;166;1352;3887;1406;4053
251030;201709;960;2728;865;2521;46;169;612;1723;658;1892
251040;201709;1701;5210;1521;4902;58;282;1230;3843;1288;4125
251050;201709;1051;3009;873;2667;109;342;587;1754;696;2096
251060;201709;1005;2251;737;1902;18;84;595;1487;613;1571
251065;201709;444;1278;364;1167;19;86;245;728;264;814
251070;201709;716;2123;644;2025;22;90;542;1685;564;1775
251080;201709;17501;48352;15654;45496;2944;8885;8841;26107;11785;34992
251090;201709;2711;8180;2374;7519;89;336;1854;5775;1943;6111
251100;201709;877;2756;781;2589;37;177;549;1723;586;1900
251110;201709;1698;4885;1496;4487;67;198;1130;3358;1197;3556
251120;201709;6100;19902;5741;19242;409;1685;4400;14547;4809;16232
251130;201709;3539;8956;3254;8632;387;1054;2701;7137;3088;8191
251140;201709;4128;12297;3863;11890;119;488;3216;9838;3335;10326
251150;201709;2564;7885;2371;7592;142;624;1868;5807;2010;6431
251160;201709;1833;5927;1739;5785;66;235;1558;5202;1624;5437
251170;201709;1427;4181;1340;4080;36;144;1213;3689;1249;3833
251180;201709;2409;7187;2162;6801;254;879;1411;4382;1665;5261
251190;201709;4304;11718;4106;11470;84;317;3733;10240;3817;10557
251200;201709;3885;12425;3663;12136;85;358;3294;10961;3379;11319
251203;201709;935;3117;891;3020;41;187;672;2216;713;2403
251207;201709;988;3006;826;2701;23;126;579;1835;602;1961
251210;201709;7190;19992;6158;18648;339;1058;4941;15066;5280;16124
251220;201709;1142;2945;927;2657;47;114;722;2094;769;2208
251230;201709;4482;12650;4035;12064;175;647;3461;10149;3636;10796
251240;201709;3287;9542;2883;8982;253;822;2135;6553;2388;7375
251250;201709;9557;27558;8894;26587;907;2999;6402;18643;7309;21642
251260;201709;442;1392;404;1324;14;62;309;994;323;1056
251270;201709;4048;13069;3686;12604;131;601;3155;10775;3286;11376
251272;201709;1265;3590;1187;3475;41;150;1059;3075;1100;3225
251274;201709;874;2620;738;2374;53;231;499;1515;552;1746
251275;201709;1187;3442;1098;3302;48;198;832;2374;880;2572
251276;201709;1061;3244;1013;3167;69;299;820;2500;889;2799
251278;201709;590;1775;523;1648;50;180;354;1114;404;1294
251280;201709;2178;6342;2001;6042;59;260;1611;4704;1670;4964
251290;201709;5443;14564;5143;14179;363;1312;4231;11294;4594;12606
251300;201709;729;2395;691;2329;14;59;576;1922;590;1981
251310;201709;2723;8110;2514;7793;92;443;2031;6106;2123;6549
251315;201709;1580;5245;1490;5080;97;357;1152;3890;1249;4247
251320;201709;1693;4590;1224;3797;57;206;866;2672;923;2878
251330;201709;1755;4557;1460;4177;49;192;1311;3708;1360;3900
251335;201709;990;3186;899;3040;55;241;686;2251;741;2492
251340;201709;3348;9304;2907;8690;132;469;2209;6486;2341;6955
251350;201709;1089;3397;1013;3267;36;165;825;2577;861;2742
251360;201709;1696;5244;1432;4871;24;101;1241;4270;1265;4371
251365;201709;695;2071;573;1794;12;53;443;1370;455;1423
251370;201709;22058;65780;21101;64455;1898;6536;16131;48696;18029;55232
251380;201709;1233;3778;1081;3523;28;138;911;2863;939;3001
251385;201709;692;1837;551;1605;25;74;391;1089;416;1163
251390;201709;5561;18161;4914;16888;1151;4120;2428;8295;3579;12415
251392;201709;958;2784;833;2575;41;162;614;1847;655;2009
251394;201709;608;1991;529;1853;30;134;398;1367;428;1501
251396;201709;739;2079;636;1908;43;121;433;1284;476;1405
251398;201709;890;2461;696;2118;29;116;503;1474;532;1590
251400;201709;1068;3000;908;2761;48;167;664;1941;712;2108
251410;201709;1553;3901;1295;3503;27;105;1084;2831;1111;2936
251420;201709;1805;5149;1558;4851;71;292;1210;3672;1281;3964
251430;201709;1505;4951;1374;4735;43;220;1189;4035;1232;4255
251440;201709;1114;3318;911;2915;30;113;720;2294;750;2407
251445;201709;1496;4466;1414;4355;96;372;1114;3340;1210;3712
251450;201709;4252;13264;3888;12743;92;428;3253;10561;3345;10989
251455;201709;984;3103;877;2889;58;252;653;2099;711;2351
251460;201709;806;2463;735;2346;30;121;610;1964;640;2085
251465;201709;423;1338;361;1192;15;76;276;890;291;966
251470;201709;1122;3201;881;2691;83;268;545;1624;628;1892
251480;201709;881;2445;776;2276;31;128;570;1599;601;1727
251490;201709;1714;4989;1507;4670;121;401;1020;3110;1141;3511
251500;201709;1708;5342;1614;5167;83;339;1352;4235;1435;4574
251510;201709;2390;7756;2156;7273;245;902;1342;4474;1587;5376
251520;201709;938;2547;742;2156;83;218;471;1351;554;1569
251530;201709;11848;32040;11022;30892;206;941;9700;26618;9906;27559
251540;201709;2706;8440;2493;8028;134;523;1974;6241;2108;6764
251550;201709;3350;8701;2792;7958;79;291;2318;6551;2397;6842
251560;201709;600;1888;543;1792;99;353;317;999;416;1352
251570;201709;920;2707;759;2385;28;109;539;1633;567;1742
251580;201709;1757;4726;1598;4510;177;463;1229;3492;1406;3955
251590;201709;1428;4142;1347;4026;62;186;1088;3249;1150;3435
251593;201709;943;2863;870;2757;126;408;518;1614;644;2022
251597;201709;1932;5774;1857;5676;30;120;1695;5136;1725;5256
251600;201709;6224;17883;5711;17091;226;767;4735;14015;4961;14782
251610;201709;3207;9385;2825;8660;333;972;1931;6008;2264;6980
251615;201709;1090;3022;884;2672;30;138;647;1876;677;2014
251620;201709;15233;39334;13601;37422;331;829;11431;33044;11762;33873
251630;201709;4377;11091;3689;10112;225;635;2790;7571;3015;8206
251640;201709;2022;6077;1857;5759;74;326;1558;4722;1632;5048
251650;201709;3850;10875;3521;10429;173;620;2988;8781;3161;9401
251660;201709;3357;10543;3011;9912;98;486;2493;8015;2591;8501
251670;201709;4224;12370;3765;11783;31;151;3502;11000;3533;11151
251675;201709;682;2078;631;2011;106;363;399;1255;505;1618
251680;201709;2575;7327;2126;6643;59;221;1730;5367;1789;5588
251690;201709;3161;9259;2815;8588;89;308;2074;6177;2163;6485
251700;201709;1813;5812;1703;5667;86;403;1417;4604;1503;5007
251710;201709;800;2157;548;1625;63;228;271;778;334;1006
251720;201709;1366;4064;1142;3642;36;160;867;2678;903;2838
251740;201709;657;1873;535;1654;42;138;356;1075;398;1213
260005;201709;24369;57534;20943;52763;3081;7599;13474;34023;16555;41622
260010;201709;9313;25161;7905;23163;634;1899;4955;14878;5589;16777
260020;201709;6171;16157;5258;14850;150;606;4354;12192;4504;12798
260030;201709;5931;16654;5261;15595;265;933;4167;12294;4432;13227
260040;201709;8228;22096;7019;20510;735;2132;4980;14890;5715;17022
260050;201709;10750;33066;10139;32312;362;1476;8883;28425;9245;29901
260060;201709;3682;10237;3266;9496;278;762;2441;7197;2719;7959
260070;201709;9381;26297;8561;24998;738;2468;6229;17870;6967;20338
260080;201709;6089;15139;5471;14249;255;758;4469;11402;4724;12160
260090;201709;5081;13397;4705;12901;526;1418;3575;9918;4101;11336
260100;201709;3151;8663;2724;8056;139;503;2216;6515;2355;7018
260105;201709;4923;13606;4664;13196;134;567;4007;11095;4141;11662
260110;201709;21100;57591;19349;55451;969;2923;16777;48152;17746;51075
260120;201709;12688;36716;11203;34282;1936;6045;6487;20419;8423;26464
260130;201709;2987;8257;2787;7943;272;829;2092;5868;2364;6697
260140;201709;11608;29074;10409;27592;562;1718;8708;23035;9270;24753
260150;201709;3129;8274;2752;7792;174;588;2251;6309;2425;6897
260160;201709;5509;16733;4744;15703;147;707;4006;13313;4153;14020
260170;201709;16045;43653;15199;42478;925;2653;12680;35352;13605;38005
260180;201709;3176;9372;2901;8959;169;605;2441;7462;2610;8067
260190;201709;16003;35970;14374;33994;267;810;12606;29277;12873;30087
260200;201709;10784;27062;9770;25749;380;1092;8701;22804;9081;23896
260210;201709;11493;33966;10152;31802;404;1603;8262;25768;8666;27371
260220;201709;9280;25131;8906;24653;288;991;8029;22006;8317;22997
260230;201709;9461;25958;8602;24800;394;1366;6957;19905;7351;21271
260240;201709;2794;8281;2456;7765;215;737;1887;5979;2102;6716
260250;201709;2099;5831;1843;5464;88;313;1491;4323;1579;4636
260260;201709;11649;32803;10512;31111;620;2191;8288;24298;8908;26489
260270;201709;3454;9894;3204;9523;214;898;2455;7029;2669;7927
260280;201709;12556;39854;11656;38527;528;2045;10011;33100;10539;35145
260290;201709;32078;92134;29938;88530;4515;13921;19103;56063;23618;69984
260300;201709;8717;25791;7720;24310;303;1332;6163;19310;6466;20642
260310;201709;4193;12164;3812;11604;588;1666;2585;8150;3173;9816
260320;201709;7145;22017;6551;20967;297;1108;5346;16976;5643;18084
260330;201709;2464;7814;2281;7460;116;452;1803;5777;1919;6229
260340;201709;1872;5276;1699;5025;32;128;1499;4400;1531;4528
260345;201709;21120;62682;19572;59897;4516;14965;8502;25121;13018;40086
260350;201709;4826;12643;4442;12112;162;551;3852;10383;4014;10934
260360;201709;2420;6679;2193;6283;81;365;1522;4273;1603;4638
260370;201709;5291;16113;4701;15027;268;1090;3570;11240;3838;12330
260380;201709;4658;14920;4192;14131;221;907;3109;10392;3330;11299
260390;201709;4117;12948;3584;11852;267;970;2466;8022;2733;8992
260392;201709;3364;10920;3079;10539;169;833;2559;8596;2728;9429
260400;201709;13322;36009;12532;34794;1158;3542;9406;25677;10564;29219
260410;201709;56343;157084;48454;144818;11803;37429;19767;60748;31570;98177
260415;201709;3555;10941;3175;10166;166;749;2226;6850;2392;7599
260420;201709;11786;26796;10567;25466;151;541;9747;23267;9898;23808
260430;201709;2830;8952;2463;8236;175;652;1695;5639;1870;6291
260440;201709;3277;9477;2919;8802;225;822;2171;6363;2396;7185
260450;201709;4926;13812;4725;13536;158;518;4247;12150;4405;12668
260460;201709;5166;16350;4719;15483;649;2424;2807;8968;3456;11392
260470;201709;4529;12951;4070;12413;117;291;3630;11412;3747;11703
260480;201709;4076;11221;3496;10402;367;1206;2326;7061;2693;8267
260490;201709;4825;12333;4278;11400;116;418;3674;9526;3790;9944
260500;201709;5653;15694;4958;14611;578;1663;3325;9938;3903;11601
260510;201709;8567;22196;7834;21190;263;870;6961;18663;7224;19533
260515;201709;4434;13041;3424;11037;170;622;2253;7169;2423;7791
260520;201709;16145;40537;15258;39353;1162;3064;12342;31588;13504;34652
260530;201709;8986;27576;7927;25891;263;1155;6676;21689;6939;22844
260540;201709;5636;14131;5166;13602;697;1395;4053;11229;4750;12624
260545;201709;42;143;23;94;7;24;3;13;10;37
260550;201709;2697;8424;2295;7543;239;936;1332;4308;1571;5244
260560;201709;6060;15793;5331;14792;147;610;4598;12582;4745;13192
260570;201709;6593;20551;6063;19728;600;2044;4594;14986;5194;17030
260580;201709;3714;10007;3375;9483;61;244;3004;8305;3065;8549
260590;201709;6182;15397;5700;14855;258;694;4953;12956;5211;13650
260600;201709;27882;78664;24615;73353;1459;5235;18259;53634;19718;58869
260610;201709;6108;17785;5821;17323;520;1660;4452;13112;4972;14772
260620;201709;14147;41969;13486;40867;2028;6855;8727;25818;10755;32673
260630;201709;2264;6337;1930;5842;56;240;1605;4800;1661;5040
260640;201709;17149;44993;15790;43237;1385;4186;11792;32003;13177;36189
260650;201709;5170;15794;4570;14760;195;836;3763;12077;3958;12913
260660;201709;7206;19799;6459;18833;184;747;5514;15836;5698;16583
260670;201709;2213;5874;1847;5342;98;302;1333;3818;1431;4120
260680;201709;21179;57878;19083;54336;2870;8282;10713;30522;13583;38804
260690;201709;3549;9484;2980;8563;129;412;2395;6846;2524;7258
260700;201709;5598;16974;5450;16812;22;37;5345;16649;5367;16686
260710;201709;1290;3602;1223;3511;74;263;921;2705;995;2968
260720;201709;18049;54280;16866;52101;2903;9181;9967;30758;12870;39939
260730;201709;6532;21026;6092;20313;449;1752;4851;15906;5300;17658
260740;201709;1265;3726;1128;3495;30;101;934;2893;964;2994
260750;201709;6717;19557;5899;18517;158;460;5299;16943;5457;17403
260760;201709;4790;12550;4447;12137;214;655;3718;10174;3932;10829
260765;201709;7138;23815;6727;23132;826;3518;4570;15205;5396;18723
260770;201709;3669;9825;3258;9159;111;360;2579;7205;2690;7565
260775;201709;4748;13698;4477;13281;319;1221;3332;9587;3651;10808
260780;201709;3459;10809;3237;10384;509;1779;2020;6323;2529;8102
260790;201709;103300;255116;94810;242669;17640;45339;55711;142269;73351;187608
260795;201709;2962;8441;2636;7945;160;563;1973;5957;2133;6520
260800;201709;5178;12849;4756;12271;108;372;4247;10628;4355;11000
260805;201709;3528;10610;3017;9724;246;928;2095;6680;2341;7608
260810;201709;6206;17449;5889;16884;524;1555;4576;13019;5100;14574
260820;201709;3987;10704;3569;10063;385;1290;2434;6672;2819;7962
260825;201709;2766;8727;2480;8253;128;542;1874;6180;2002;6722
260830;201709;3802;11779;3324;10864;471;1463;2219;7414;2690;8877
260840;201709;4036;11471;3602;10836;219;676;2908;8721;3127;9397
260845;201709;3902;11125;3712;10790;335;982;2763;8036;3098;9018
260850;201709;4758;14676;4218;13543;600;2042;2381;7507;2981;9549
260860;201709;3462;10279;2973;9311;133;510;2325;7167;2458;7677
260870;201709;4059;10678;3630;10120;127;482;3128;8571;3255;9053
260875;201709;6197;17033;5373;15707;710;2131;3480;10254;4190;12385
260880;201709;9520;27749;8579;26230;380;1261;6966;21376;7346;22637
260890;201709;12336;34923;11546;33698;926;3054;8394;24098;9320;27152
260900;201709;5344;16229;4632;14911;324;1305;3111;9815;3435;11120
260910;201709;3004;8852;2685;8306;123;454;2050;6311;2173;6765
260915;201709;4490;14644;4200;14237;67;355;3847;13003;3914;13358
260920;201709;3122;9323;2900;9024;135;464;2425;7679;2560;8143
260930;201709;3599;11775;3230;11133;240;911;2411;8309;2651;9220
260940;201709;13583;34919;12464;33119;1197;3512;8906;23177;10103;26689
260950;201709;6001;18038;5190;16439;789;2729;2606;7885;3395;10614
260960;201709;54439;142432;48670;133381;8108;23716;27260;73586;35368;97302
260970;201709;4743;13966;4372;13470;182;631;3474;10767;3656;11398
260980;201709;4057;12716;3731;12306;86;375;3352;11033;3438;11408
260990;201709;16564;49869;14921;47559;915;3348;11656;37082;12571;40430
261000;201709;14886;39141;12484;35626;1210;3733;8123;23548;9333;27281
261010;201709;2422;6637;2203;6363;78;195;1979;5771;2057;5966
261020;201709;6173;17573;5406;16186;457;1472;4022;11751;4479;13223
261030;201709;3684;11101;3255;10394;138;539;2619;8246;2757;8785
261040;201709;4941;15631;4198;14046;297;1150;3016;9903;3313;11053
261050;201709;7117;20358;6660;19573;707;2048;4575;13511;5282;15559
261060;201709;11982;33607;11110;32177;841;2708;8651;24708;9492;27416
261070;201709;51096;121413;45030;112832;4040;10329;32445;80693;36485;91022
261080;201709;5542;15410;5280;15032;222;642;4708;13487;4930;14129
261090;201709;15897;42530;14637;40781;638;2049;12402;34350;13040;36399
261100;201709;7797;23888;6955;22474;930;3097;4494;14821;5424;17918
261110;201709;56054;166647;49823;156818;12400;40807;22191;71822;34591;112629
261120;201709;3683;9599;3240;9057;70;234;2909;8145;2979;8379
261130;201709;7034;17649;6485;17024;160;491;5793;15175;5953;15666
261140;201709;3106;8197;2845;7806;287;867;2056;5592;2343;6459
261150;201709;5118;14321;4664;13616;164;609;4024;11636;4188;12245
261153;201709;1933;5819;1671;5384;81;330;1190;3794;1271;4124
261160;201709;186350;478492;170104;454364;43328;120868;72568;196889;115896;317757
261170;201709;5524;14646;5078;14004;268;735;4126;11348;4394;12083
261180;201709;9158;25001;8552;24160;765;2389;6109;17110;6874;19499
261190;201709;4646;14319;4333;13905;409;1607;3149;9892;3558;11499
261200;201709;3347;8115;2992;7685;253;673;2376;6063;2629;6736
261210;201709;1788;4666;1652;4484;82;237;1448;3933;1530;4170
261220;201709;12958;39097;11070;35339;1595;5518;6188;19632;7783;25150
261230;201709;4337;13311;3904;12740;100;425;3295;10871;3395;11296
261240;201709;4750;13235;4300;12507;354;993;3361;9814;3715;10807
261245;201709;3391;10252;2941;9457;126;576;2301;7175;2427;7751
261247;201709;2916;8979;2512;8236;161;622;1797;5872;1958;6494
261250;201709;17787;46418;16443;44611;3026;7901;10384;29318;13410;37219
261255;201709;3933;12002;3484;11180;195;852;2734;8537;2929;9389
261260;201709;12149;33891;10763;32189;425;1565;9097;27291;9522;28856
261270;201709;3638;10590;3321;10054;254;874;2513;7425;2767;8299
261280;201709;2498;7383;2276;7013;88;369;1835;5517;1923;5886
261290;201709;2800;7922;2510;7540;134;518;1994;5972;2128;6490
261300;201709;10827;33259;9463;30761;837;3255;6461;20493;7298;23748
261310;201709;6607;19868;6161;19103;1325;4148;3557;11048;4882;15196
261320;201709;5613;16816;5099;15912;140;586;4231;12986;4371;13572
261330;201709;5477;14936;5136;14489;215;836;4445;12272;4660;13108
261340;201709;3781;12210;3509;11773;252;1082;2577;8558;2829;9640
261350;201709;7904;24878;7419;24053;179;961;6151;19485;6330;20446
261360;201709;7996;20571;6996;19163;395;1146;5596;15067;5991;16213
261370;201709;18219;52580;17022;50650;3323;10220;9750;29084;13073;39304
261380;201709;3834;12700;3575;12161;535;2023;2221;7411;2756;9434
261390;201709;15704;47032;14010;44126;1713;5803;8610;27143;10323;32946
261400;201709;4501;15189;4017;14142;210;946;2934;10138;3144;11084
261410;201709;8787;23703;7699;21976;542;1677;6163;17505;6705;19182
261420;201709;6649;22065;6373;21701;1149;4419;4095;13783;5244;18202
261430;201709;3399;10144;2917;9398;138;464;2351;7608;2489;8072
261440;201709;1488;4625;1339;4351;47;237;981;3096;1028;3333
261450;201709;13238;37873;12705;37190;359;1328;10979;31981;11338;33309
261460;201709;6759;19701;6319;19062;288;974;5495;16508;5783;17482
261470;201709;3962;10650;3638;10219;60;261;3054;8593;3114;8854
261480;201709;4066;13655;3663;12962;224;963;2809;9719;3033;10682
261485;201709;4771;14332;4212;13389;463;1715;2782;8689;3245;10404
261500;201709;5277;14606;4705;13816;420;1199;3429;10342;3849;11541
261510;201709;1778;5627;1580;5279;106;409;1175;3954;1281;4363
261520;201709;2541;7962;2405;7711;101;381;1627;5386;1728;5767
261530;201709;10279;32831;9204;30702;1572;5881;4321;14252;5893;20133
261540;201709;6978;21760;6473;20898;1205;3889;3789;12528;4994;16417
261550;201709;3364;9313;3136;8986;238;825;2378;6657;2616;7482
261560;201709;7123;22598;6444;21673;568;2321;4877;16324;5445;18645
261570;201709;3292;9566;2845;8830;263;932;1894;5775;2157;6707
261580;201709;5903;17283;5427;16538;181;783;4735;14239;4916;15022
261590;201709;2503;6822;2117;6224;111;338;1625;4818;1736;5156
261600;201709;5053;13479;4309;12384;356;1063;3003;8744;3359;9807
261610;201709;2412;6620;2063;6102;70;259;1650;4867;1720;5126
261618;201709;2362;6434;2145;6139;108;350;1755;4951;1863;5301
261620;201709;3797;11718;3581;11360;831;2484;2093;6973;2924;9457
261630;201709;6818;19740;5871;17987;542;2006;3617;10670;4159;12676
261640;201709;32837;79907;30808;77474;1808;4102;25435;66172;27243;70274
261650;201709;3804;10680;3501;10275;167;648;2655;7823;2822;8471
270010;201709;4182;15207;3841;14550;208;1100;3016;11234;3224;12334
270020;201709;3649;9958;3364;9546;243;849;2754;7575;2997;8424
270030;201709;33317;97758;30616;93299;5090;15741;19055;58597;24145;74338
270040;201709;10064;29885;9242;28803;711;2549;7270;22661;7981;25210
270050;201709;4434;11683;4020;11196;265;710;3443;9731;3708;10441
270060;201709;1835;5176;1682;4982;205;625;1196;3610;1401;4235
270070;201709;4259;12919;3885;12383;168;772;3266;10141;3434;10913
270080;201709;1257;3863;1076;3521;100;353;757;2425;857;2778
270090;201709;1984;6197;1784;5805;82;387;1401;4396;1483;4783
270100;201709;5182;15351;4858;14847;381;1377;3812;11457;4193;12834
270110;201709;2778;7693;2445;7314;214;687;1908;5844;2122;6531
270120;201709;2954;8144;2627;7734;79;299;2344;6868;2423;7167
270130;201709;4905;14334;4475;13847;363;1223;3676;11468;4039;12691
270135;201709;1791;4706;1593;4467;109;244;1395;4002;1504;4246
270140;201709;10075;23302;8467;21223;458;1806;6952;16476;7410;18282
270150;201709;2563;8129;2488;8042;23;74;2442;7905;2465;7979
270160;201709;4784;15638;4409;15174;134;671;3827;13053;3961;13724
270170;201709;3476;10941;3135;10455;342;1434;2177;7035;2519;8469
270180;201709;2205;7053;2041;6821;78;379;1734;5676;1812;6055
270190;201709;1678;5314;1585;5190;68;252;1360;4474;1428;4726
270200;201709;2431;7780;2203;7474;164;711;1648;5420;1812;6131
270210;201709;4791;13252;4435;12788;218;687;3901;11219;4119;11906
270220;201709;1189;3761;1095;3607;236;873;603;1935;839;2808
270230;201709;9327;28909;8277;27176;884;3544;5282;16747;6166;20291
270235;201709;5726;18478;5356;17884;286;1189;4381;14500;4667;15689
270240;201709;9736;27984;8331;26181;1466;4962;5343;16721;6809;21683
270250;201709;2874;7629;2611;7294;350;920;1945;5510;2295;6430
270255;201709;4505;13553;3623;11942;223;926;2623;8442;2846;9368
270260;201709;5445;16969;5196;16601;193;875;4515;14032;4708;14907
270270;201709;1073;2992;989;2878;169;512;620;1771;789;2283
270280;201709;3521;9530;3031;8848;389;866;2131;6473;2520;7339
270290;201709;7557;25349;7060;24495;380;1782;5797;19763;6177;21545
270300;201709;3741;11045;3174;10408;276;989;2341;7697;2617;8686
270310;201709;6911;20575;6158;19444;208;1062;5153;15794;5361;16856
270320;201709;5598;17051;5150;16270;706;2409;3537;10962;4243;13371
270330;201709;3796;13034;3534;12676;319;1238;2747;9936;3066;11174
270340;201709;1549;4607;1361;4354;82;322;1111;3478;1193;3800
270350;201709;1798;4699;1604;4444;166;485;1161;3242;1327;3727
270360;201709;2115;6178;1975;6013;119;334;1742;5400;1861;5734
270370;201709;1384;4532;1275;4336;72;313;978;3302;1050;3615
270375;201709;2883;7472;2528;7025;51;138;2300;6430;2351;6568
270380;201709;5430;16682;5013;16105;407;1353;3862;12599;4269;13952
270390;201709;1182;3243;1025;3003;37;141;810;2319;847;2460
270400;201709;6000;17422;5354;16461;249;1004;4108;12233;4357;13237
270410;201709;4509;14068;4105;13355;313;1177;3031;9715;3344;10892
270420;201709;5496;17137;5234;16794;213;977;4347;13661;4560;14638
270430;201709;124685;344146;107088;318972;29164;91326;38806;120496;67970;211822
270440;201709;4531;13295;4134;12773;138;585;3415;10481;3553;11066
270450;201709;6154;18288;5792;17812;349;1298;4775;14542;5124;15840
270460;201709;3228;8219;2902;7834;81;272;2586;6874;2667;7146
270470;201709;10009;31046;9217;29826;1044;3714;6402;20959;7446;24673
270480;201709;2748;8141;2400;7565;254;943;1735;5287;1989;6230
270490;201709;948;2910;860;2794;51;197;675;2174;726;2371
270500;201709;4703;15346;4386;14951;186;945;3707;12407;3893;13352
270510;201709;5724;16314;5104;15449;552;2116;3728;10790;4280;12906
270520;201709;3384;10497;2999;9799;976;3387;939;3288;1915;6675
270530;201709;1174;3645;1088;3517;68;237;824;2672;892;2909
270540;201709;1986;6368;1837;6157;88;447;1536;4982;1624;5429
270550;201709;6168;18145;5635;17483;566;1787;4288;13601;4854;15388
270560;201709;3024;8745;2763;8358;180;625;2149;6432;2329;7057
270570;201709;3641;11445;3282;10843;183;764;2642;8580;2825;9344
270580;201709;2045;6134;1952;6005;76;235;1733;5379;1809;5614
270590;201709;1399;4459;1338;4383;6;27;1319;4319;1325;4346
270600;201709;2704;8776;2454;8353;120;607;2054;6804;2174;7411
270610;201709;3189;9434;2922;9054;124;486;2530;7725;2654;8211
270620;201709;1308;4214;1215;4052;58;282;1015;3257;1073;3539
270630;201709;14328;41766;13085;39800;1359;4377;9595;29340;10954;33717
270640;201709;5403;16368;4842;15485;243;1041;3919;12235;4162;13276
270642;201709;2216;7663;2078;7462;156;794;1640;5695;1796;6489
270644;201709;2845;8085;2475;7580;264;842;1799;5616;2063;6458
270650;201709;3382;10441;3199;10187;436;1803;2278;6905;2714;8708
270660;201709;2091;5336;1668;4742;88;327;1236;3502;1324;3829
270670;201709;15145;38566;13342;36495;1201;3228;10423;28969;11624;32197
270680;201709;4351;12176;4131;11930;72;162;3935;11459;4007;11621
270690;201709;8961;23473;8002;22402;1705;4360;5323;15709;7028;20069
270700;201709;541;1708;475;1594;58;250;321;1033;379;1283
270710;201709;5694;17538;5363;17119;301;1286;4519;14160;4820;15446
270720;201709;3262;10556;2930;9982;111;657;2449;8114;2560;8771
270730;201709;6421;17509;5994;17042;319;946;5312;15206;5631;16152
270740;201709;2224;6193;2075;5985;112;421;1748;4963;1860;5384
270750;201709;4954;14748;4548;14115;438;1567;3462;10675;3900;12242
270760;201709;3377;9835;3030;9299;94;395;2557;7735;2651;8130
270770;201709;17996;46782;15071;43257;2906;7915;8898;27245;11804;35160
270780;201709;1747;5377;1652;5243;128;448;1312;4176;1440;4624
270790;201709;1452;4523;1337;4353;211;707;851;2780;1062;3487
270800;201709;10498;30757;9768;29750;471;2057;8346;24795;8817;26852
270810;201709;2967;9099;2458;8175;211;840;1688;5528;1899;6368
270820;201709;1691;5331;1477;4963;169;644;1020;3382;1189;4026
270830;201709;5339;13429;4713;12685;319;925;3835;10512;4154;11437
270840;201709;7730;24028;7097;23161;238;1324;6183;19613;6421;20937
270850;201709;7484;21502;7061;20944;591;2292;5557;15765;6148;18057
270860;201709;10168;27667;8729;25893;799;2694;6485;18943;7284;21637
270870;201709;2006;5991;1744;5484;208;707;1198;3728;1406;4435
270880;201709;7869;24546;7285;23693;357;1533;6002;19178;6359;20711
270890;201709;2279;6854;2108;6549;179;644;1574;4753;1753;5397
270895;201709;2830;9820;2727;9666;92;500;2420;8404;2512;8904
270900;201709;1758;4729;1419;4188;57;203;1130;3257;1187;3460
270910;201709;3458;10905;3148;10360;167;751;2409;7742;2576;8493
270915;201709;8589;27707;7565;25856;999;3936;4781;16004;5780;19940
270920;201709;5819;18113;5525;17703;241;1184;4764;14796;5005;15980
270930;201709;15211;40497;13059;37889;2381;6575;8359;25193;10740;31768
270940;201709;5338;17058;4984;16653;343;1612;3833;12493;4176;14105
280010;201709;640;1791;555;1643;32;146;399;1079;431;1225
280020;201709;4648;12960;4080;12045;535;1613;2685;7920;3220;9533
280030;201709;66494;171302;56354;156375;15776;45172;20810;60610;36586;105782
280040;201709;2998;8782;2688;8297;281;938;1906;5832;2187;6770
280050;201709;3449;10762;3196;10327;652;2213;1825;5882;2477;8095
280060;201709;4830;14404;4080;13165;720;2453;2090;6908;2810;9361
280067;201709;6583;18185;5714;16758;695;2037;3689;10836;4384;12873
280070;201709;1881;6019;1814;5908;128;403;1506;4908;1634;5311
280100;201709;3500;10549;3166;9975;410;1410;2163;6823;2573;8233
280110;201709;1276;3855;1181;3702;54;211;990;3036;1044;3247
280120;201709;7575;23163;6906;22028;964;2847;4924;16183;5888;19030
280130;201709;7736;20284;7191;19494;734;2112;5419;14724;6153;16836
280140;201709;5529;14174;5058;13524;362;981;4116;10994;4478;11975
280150;201709;3475;9749;3245;9421;169;628;2680;7660;2849;8288
280160;201709;1229;3639;1036;3288;153;510;636;1981;789;2491
280170;201709;4762;13631;4388;13068;319;924;3510;10608;3829;11532
280190;201709;1173;2853;985;2577;65;201;784;1991;849;2192
280200;201709;1118;3298;1009;3128;104;380;728;2191;832;2571
280210;201709;13984;38775;12464;36697;2250;6877;7087;21339;9337;28216
280220;201709;1710;4804;1541;4560;59;245;1280;3763;1339;4008
280230;201709;3186;9218;2890;8770;239;839;2150;6433;2389;7272
280240;201709;3366;9333;3065;8859;98;393;2591;7337;2689;7730
280250;201709;816;2154;650;1878;97;303;336;946;433;1249
280260;201709;1988;5206;1854;5050;54;155;1727;4717;1781;4872
280270;201709;2130;6458;1971;6206;118;416;1652;5145;1770;5561
280280;201709;3977;12969;3641;12413;604;1770;2337;8476;2941;10246
280290;201709;16336;47696;14809;45395;1712;5950;9680;29663;11392;35613
280300;201709;9490;27322;8767;26457;548;1858;6699;21104;7247;22962
280310;201709;1314;3642;1127;3312;40;151;837;2381;877;2532
280320;201709;8116;24698;7455;23637;1128;3834;4526;14228;5654;18062
280330;201709;4277;11539;3868;10922;291;953;3053;8410;3344;9363
280340;201709;4053;10280;3774;9928;271;681;3159;8522;3430;9203
280350;201709;20938;56945;18561;53445;2420;7195;12432;36029;14852;43224
280360;201709;5306;16086;4901;15394;784;2623;2957;9243;3741;11866
280370;201709;1905;4996;1619;4542;123;322;1220;3417;1343;3739
280380;201709;964;2901;871;2750;102;383;598;1843;700;2226
280390;201709;2954;8445;2555;7698;169;581;1880;5603;2049;6184
280400;201709;3698;10319;3351;9792;754;2117;1831;5600;2585;7717
280410;201709;2025;6323;1728;5717;197;711;1029;3314;1226;4025
280420;201709;4069;11482;3741;10995;157;482;3265;9613;3422;10095
280430;201709;2042;5267;1842;4978;71;252;1463;3866;1534;4118
280440;201709;4526;12653;4044;11997;297;940;3176;9338;3473;10278
280445;201709;2333;6215;2095;5789;49;176;1620;4331;1669;4507
280450;201709;9226;22839;8489;21900;424;899;7413;19516;7837;20415
280460;201709;6345;16344;5905;15704;622;1649;4609;12326;5231;13975
280470;201709;1774;5220;1587;4888;75;251;1208;3716;1283;3967
280480;201709;31953;87718;29565;84318;3498;11139;20603;57814;24101;68953
280490;201709;3653;10903;3228;10192;153;651;2455;7553;2608;8204
280500;201709;866;2288;772;2157;41;132;632;1760;673;1892
280510;201709;2422;7040;2181;6692;132;518;1597;4867;1729;5385
280520;201709;1667;4440;1505;4232;124;332;1218;3439;1342;3771
280530;201709;2374;6190;2175;5936;122;368;1801;4890;1923;5258
280540;201709;8956;24525;8251;23518;204;905;7272;20206;7476;21111
280550;201709;6574;16541;5439;14820;346;902;4082;11051;4428;11953
280560;201709;7048;20555;6665;20012;232;931;5755;16971;5987;17902
280570;201709;5968;15910;5134;14789;338;1147;3706;10550;4044;11697
280580;201709;5097;15519;4481;14382;658;2037;2851;9417;3509;11454
280590;201709;2550;6905;2244;6520;171;710;1553;4352;1724;5062
280600;201709;3262;9606;2986;9196;227;803;2237;6824;2464;7627
280610;201709;2379;6284;2183;6018;136;429;1766;4787;1902;5216
280620;201709;5132;14151;4518;13197;428;1128;3232;9791;3660;10919
280630;201709;3467;11060;3241;10720;225;792;2580;8682;2805;9474
280640;201709;2172;6504;2035;6352;50;166;1910;6001;1960;6167
280650;201709;1038;3033;903;2839;92;314;652;2012;744;2326
280660;201709;2609;7039;2457;6861;162;430;2097;5906;2259;6336
280670;201709;16464;41206;14999;39264;1423;3951;11167;29228;12590;33179
280680;201709;2716;7068;2326;6438;152;405;1743;4750;1895;5155
280690;201709;927;2502;814;2343;56;172;617;1752;673;1924
280700;201709;998;2816;905;2646;29;102;698;2005;727;2107
280710;201709;12876;31591;11408;29866;582;1089;9966;26914;10548;28003
280720;201709;2409;5898;2128;5577;162;450;1490;4148;1652;4598
280730;201709;1014;2690;936;2573;44;159;786;2112;830;2271
280740;201709;12842;33770;11138;31102;1291;3577;7290;20513;8581;24090
280750;201709;3336;9921;3081;9485;204;730;2248;6834;2452;7564
280760;201709;5542;16333;5061;15595;703;2199;3204;10166;3907;12365
290010;201709;2705;6063;1995;4952;25;99;1640;3884;1665;3983
290020;201709;4445;13858;4264;13614;231;727;3722;11901;3953;12628
290030;201709;3346;9526;3105;9207;220;670;2573;7611;2793;8281
290035;201709;4578;11142;4009;10385;203;541;3229;8539;3432;9080
290040;201709;4179;10538;3569;9846;183;595;2851;7961;3034;8556
290050;201709;2195;7191;1922;6691;138;573;1357;4679;1495;5252
290060;201709;1257;3175;1038;2875;113;388;727;1931;840;2319
290070;201709;31513;77391;27629;72374;3671;9738;17090;45910;20761;55648
290080;201709;5484;16405;4709;15313;665;2207;3085;10266;3750;12473
290090;201709;2150;4261;1672;3753;49;89;1526;3452;1575;3541
290100;201709;8629;24522;7697;23051;1073;3111;4845;15016;5918;18127
290110;201709;4741;13480;4449;12975;560;1742;3008;8686;3568;10428
290115;201709;4261;12636;3818;12039;154;516;3251;10372;3405;10888
290120;201709;6638;16813;5505;15465;180;652;4654;12880;4834;13532
290130;201709;4448;11417;3611;10377;136;572;2895;8108;3031;8680
290135;201709;4396;10658;3672;9520;257;731;2734;6885;2991;7616
290140;201709;4324;12505;3652;11627;142;533;3156;10055;3298;10588
290150;201709;2181;6306;2071;6149;208;648;1589;4655;1797;5303
290160;201709;3180;7877;2986;7633;302;634;2384;6193;2686;6827
290170;201709;2522;7902;2372;7709;96;406;2099;6732;2195;7138
290180;201709;2798;7940;2365;7255;119;423;1857;5658;1976;6081
290190;201709;3746;11991;3547;11696;184;815;2830;9212;3014;10027
290195;201709;2197;5879;1832;5294;63;288;1467;4160;1530;4448
290200;201709;3802;11361;3302;10594;206;732;2607;8290;2813;9022
290205;201709;3301;9007;2959;8481;144;565;2318;6433;2462;6998
290210;201709;13175;38484;11889;36732;1144;3241;9043;28850;10187;32091
290220;201709;2459;6814;2329;6629;182;564;1889;5336;2071;5900
290225;201709;3099;7127;2679;6664;47;113;2516;6279;2563;6392
290230;201709;2170;6800;2034;6636;94;382;1718;5598;1812;5980
290240;201709;3492;9389;3057;8808;152;517;2452;6937;2604;7454
290250;201709;3735;11517;3453;11147;128;369;2983;9991;3111;10360
290260;201709;4986;13624;4129;12313;257;930;3233;9547;3490;10477
290265;201709;3454;10347;2930;9396;132;572;2244;7108;2376;7680
290270;201709;11538;40874;11036;40044;871;3667;8615;31017;9486;34684
290280;201709;5518;17055;5026;16261;369;1279;3766;12187;4135;13466
290290;201709;9686;29257;8408;27061;851;2790;5912;19132;6763;21922
290300;201709;4376;12221;3225;10059;187;671;2258;7094;2445;7765
290310;201709;1426;4068;1230;3757;143;505;812;2440;955;2945
290320;201709;24593;68794;21111;64324;4906;15423;10711;33958;15617;49381
290323;201709;3458;9740;3150;9332;85;295;2642;7716;2727;8011
290327;201709;4194;12312;3672;11361;338;1026;2632;8169;2970;9195
290330;201709;1849;4335;1646;4117;56;126;1486;3764;1542;3890
290340;201709;5298;15061;4496;14059;844;2786;2893;9120;3737;11906
290350;201709;4412;13453;3894;12568;363;1220;2777;9086;3140;10306
290360;201709;4613;13340;4061;12589;109;434;3517;10932;3626;11366
290370;201709;4754;12653;3942;11511;223;632;3099;9143;3322;9775
290380;201709;5270;15138;4641;14206;184;635;3901;12037;4085;12672
290390;201709;14381;42565;12762;40137;1474;4775;8546;27507;10020;32282
290395;201709;2598;8228;2278;7597;93;415;1775;5886;1868;6301
290400;201709;3586;10178;2959;9198;178;629;2164;6604;2342;7233
290405;201709;4608;13986;3911;12738;290;1034;2670;8775;2960;9809
290410;201709;5468;15816;4476;14187;219;901;3384;10356;3603;11257
290420;201709;2939;8492;2501;7797;188;594;1910;5944;2098;6538
290430;201709;2986;9029;2593;8306;407;1337;1602;5176;2009;6513
290440;201709;2867;7375;2224;6436;95;332;1649;4793;1744;5125
290450;201709;3133;8958;2660;8242;122;488;2050;6187;2172;6675
290460;201709;11610;33069;10408;30912;2993;9200;3889;11437;6882;20637
290470;201709;4035;11253;3152;9867;591;1990;1513;4881;2104;6871
290475;201709;5790;17904;5096;16626;129;660;4033;12865;4162;13525
290480;201709;2065;5566;1897;5323;160;467;1273;3628;1433;4095
290485;201709;4551;14059;3988;13196;177;891;3356;10871;3533;11762
290490;201709;8286;20923;7769;20271;562;1600;6331;16477;6893;18077
290500;201709;3767;11771;3042;10222;383;1366;1652;5516;2035;6882
290510;201709;3102;8579;2745;8090;106;397;2335;6807;2441;7204
290515;201709;3629;9836;3038;9080;97;253;2643;8061;2740;8314
290520;201709;10889;33185;8831;29043;463;1921;5827;18837;6290;20758
290530;201709;4873;14302;4311;13398;236;738;3527;10986;3763;11724
290540;201709;3461;9848;3178;9449;104;347;2805;8301;2909;8648
290550;201709;4243;11186;3803;10684;54;178;3541;9998;3595;10176
290560;201709;6252;17362;5334;16015;625;2012;3727;11097;4352;13109
290570;201709;40459;107414;37520;103560;2984;8530;28910;79634;31894;88164
290580;201709;7106;22863;6603;22075;658;2152;4976;17029;5634;19181
290590;201709;6858;21811;5988;20245;181;784;4960;16762;5141;17546
290600;201709;17223;50603;16054;48915;1024;3232;12985;40178;14009;43410
290610;201709;2412;7989;1975;7128;111;503;1369;4863;1480;5366
290620;201709;6075;17880;5543;17022;281;929;4653;14205;4934;15134
290630;201709;8245;20984;7107;19633;555;1543;5770;16070;6325;17613
290640;201709;2529;7157;2049;6367;105;355;1592;4876;1697;5231
290650;201709;10424;29906;9953;29239;2483;7051;5704;17560;8187;24611
290660;201709;3532;9566;3041;8843;114;306;2270;6922;2384;7228
290670;201709;6633;19528;5868;18277;546;1689;4285;13541;4831;15230
290680;201709;9879;29244;8745;27626;296;1443;7129;22037;7425;23480
290682;201709;4524;12584;4000;11810;139;476;3367;9876;3506;10352
290685;201709;3504;8140;2341;6532;227;613;1531;4385;1758;4998
290687;201709;6575;19082;5338;16998;928;2952;2968;9836;3896;12788
290689;201709;2811;8159;2459;7614;169;595;1816;5699;1985;6294
290690;201709;5173;14437;4501;13504;639;1842;2966;8997;3605;10839
290700;201709;2450;7121;2286;6893;81;306;1980;5973;2061;6279
290710;201709;7776;23472;7050;22464;314;1112;6039;19267;6353;20379
290720;201709;18032;51055;16753;49430;986;2877;14024;41837;15010;44714
290730;201709;6874;18278;6162;17365;324;909;4751;13382;5075;14291
290740;201709;960;2761;749;2382;47;188;566;1779;613;1967
290750;201709;9873;26681;8710;24617;1077;3271;5628;15527;6705;18798
290755;201709;2209;6233;1739;5369;98;354;1213;3683;1311;4037
290760;201709;3933;11768;3181;10301;432;1275;1864;6336;2296;7611
290770;201709;2483;8498;2323;8286;77;373;1921;6880;1998;7253
290780;201709;8255;20959;7222;19473;537;1143;5595;15464;6132;16607
290790;201709;4348;12515;3952;11988;163;458;3412;10409;3575;10867
290800;201709;6806;14543;5316;12856;358;731;4152;10331;4510;11062
290810;201709;5372;15543;4429;14003;141;543;3441;10908;3582;11451
290820;201709;4977;13810;4558;13233;273;912;3488;10156;3761;11068
290830;201709;4284;10643;3923;10155;140;452;3209;8177;3349;8629
290840;201709;16222;45950;14383;43103;1748;4846;9572;29990;11320;34836
290850;201709;5826;16144;5575;15828;525;1294;4397;12893;4922;14187
290860;201709;5201;16841;4820;16392;261;999;4035;13942;4296;14941
290870;201709;4501;12872;3602;11344;164;640;2637;8255;2801;8895
290880;201709;1370;3550;1097;3142;84;207;765;2247;849;2454
290890;201709;7035;17132;6152;16149;217;576;5577;14677;5794;15253
290900;201709;2240;6241;1739;5359;128;441;1121;3412;1249;3853
290910;201709;4793;12728;3939;11417;65;287;3314;9522;3379;9809
290920;201709;4845;12540;4534;12139;116;311;4147;11094;4263;11405
290930;201709;7887;22783;6751;20950;233;1039;5450;16473;5683;17512
290940;201709;3589;10831;3146;10179;192;636;2356;7750;2548;8386
290950;201709;1487;4030;1296;3727;101;302;930;2681;1031;2983
290960;201709;5160;14626;4759;14091;157;520;4050;11984;4207;12504
290970;201709;3583;10703;3061;9854;199;614;2242;7279;2441;7893
290980;201709;9969;27283;8601;24811;1687;5090;3762;10778;5449;15868
290990;201709;8765;25304;7637;23409;465;1674;5970;17944;6435;19618
291000;201709;3026;8752;2702;8349;272;745;2118;6701;2390;7446
291005;201709;13697;34461;12351;32809;773;2104;10106;27036;10879;29140
291010;201709;3149;9560;2499;8234;185;630;1631;5354;1816;5984
291020;201709;1226;3233;1006;2831;59;190;650;1734;709;1924
291030;201709;2310;6088;1668;4834;107;332;1053;2961;1160;3293
291040;201709;5255;15417;4645;14516;232;963;3720;11508;3952;12471
291050;201709;7243;22480;6639;21463;1214;4301;4050;12901;5264;17202
291060;201709;5695;20249;5321;19645;615;2686;3635;13196;4250;15882
291070;201709;15280;43325;13362;40410;633;2370;10627;31844;11260;34214
291072;201709;22152;63067;17633;54347;3985;13105;6391;19996;10376;33101
291075;201709;4756;13453;4280;12629;223;671;3341;9744;3564;10415
291077;201709;1468;4075;1219;3650;54;148;904;2726;958;2874
291080;201709;76122;227509;66601;211075;24391;78674;10550;35067;34941;113741
291085;201709;5437;14314;4690;13259;219;698;3972;11197;4191;11895
291090;201709;1704;3699;1464;3428;145;206;1181;2882;1326;3088
291100;201709;2703;6555;2035;5727;112;412;1572;4315;1684;4727
291110;201709;5294;17479;4683;16462;532;2005;3363;11612;3895;13617
291120;201709;7206;18833;6570;17911;482;1411;5066;13772;5548;15183
291125;201709;1894;3654;1467;3186;60;146;1208;2641;1268;2787
291130;201709;2821;8616;2331;7712;74;356;1762;5664;1836;6020
291140;201709;4083;11902;3393;10554;501;1407;2114;6703;2615;8110
291150;201709;2071;4943;1833;4668;35;100;1601;4042;1636;4142
291160;201709;4620;14443;4137;13597;477;1750;2686;8689;3163;10439
291165;201709;2299;6515;1803;5599;28;119;1314;3999;1342;4118
291170;201709;19649;51900;17009;47701;1249;3787;10775;30326;12024;34113
291180;201709;5839;15153;4752;13474;376;1133;3445;9732;3821;10865
291185;201709;3300;9209;2906;8510;119;377;2376;6877;2495;7254
291190;201709;7207;18809;6216;17433;434;1333;4919;13773;5353;15106
291200;201709;2827;8264;2181;7039;84;286;1444;4648;1528;4934
291210;201709;6148;14900;5251;13797;232;787;3997;10370;4229;11157
291220;201709;3907;11687;3560;11131;377;1304;2503;7746;2880;9050
291230;201709;3839;9483;3438;9029;86;160;3221;8559;3307;8719
291240;201709;4253;11317;3727;10420;80;275;3172;8725;3252;9000
291250;201709;3284;10035;2661;8862;176;582;1823;6146;1999;6728
291260;201709;1091;2940;970;2777;44;191;825;2278;869;2469
291270;201709;4730;14304;4140;13233;880;2924;2330;7562;3210;10486
291280;201709;2181;6096;1728;5320;238;774;974;2956;1212;3730
291290;201709;5560;15333;4730;14166;619;1888;3025;9212;3644;11100
291300;201709;3957;11205;3055;9646;153;508;2186;6861;2339;7369
291310;201709;5153;14446;4426;13113;185;632;3527;10328;3712;10960
291320;201709;5793;17604;4675;15355;1126;3589;2173;7421;3299;11010
291330;201709;1569;4452;1369;4108;82;260;1010;2993;1092;3253
291340;201709;3864;10448;3278;9572;81;301;2686;7772;2767;8073
291345;201709;3005;9595;2807;9335;150;574;2282;7608;2432;8182
291350;201709;5626;16137;4911;14981;215;670;4006;12390;4221;13060
291360;201709;31247;81983;26489;75522;5297;15448;14007;41201;19304;56649
291370;201709;7627;21568;7178;20969;457;1523;5562;16153;6019;17676
291380;201709;3361;10024;2981;9414;125;509;2366;7384;2491;7893
291390;201709;10313;26594;9476;25571;599;1794;7722;20789;8321;22583
291400;201709;13657;36661;11785;33833;1911;5061;7396;22386;9307;27447
291410;201709;2860;7689;2236;6636;85;383;1686;4823;1771;5206
291420;201709;1874;5002;1596;4650;44;175;1367;3955;1411;4130
291430;201709;3065;8663;2710;8141;100;481;2224;6476;2324;6957
291440;201709;6261;18622;5505;17319;440;1430;4283;13598;4723;15028
291450;201709;8013;22470;6974;21124;199;513;5941;18552;6140;19065
291460;201709;12665;37388;11445;35572;1190;3945;7873;24781;9063;28726
291465;201709;7668;21666;6671;20427;365;1549;5382;16172;5747;17721
291470;201709;14768;38304;13057;36285;661;1827;10037;28624;10698;30451
291480;201709;34542;83311;28116;74743;3845;11004;15737;42157;19582;53161
291490;201709;4242;12754;3963;12374;373;1199;3097;9749;3470;10948
291500;201709;4416;11979;3717;10957;111;454;3189;9362;3300;9816
291510;201709;3585;10394;3161;9777;82;380;2636;8148;2718;8528
291520;201709;3825;10013;3275;9248;235;705;2348;6675;2583;7380
291530;201709;2091;5414;1610;4732;317;868;916;2945;1233;3813
291535;201709;3222;9984;2989;9603;220;703;2254;7363;2474;8066
291540;201709;2032;4940;1623;4467;96;290;1391;3774;1487;4064
291550;201709;4907;12613;4254;11694;621;1588;2648;7456;3269;9044
291560;201709;17941;41939;12795;35852;908;2435;8828;26081;9736;28516
291570;201709;2118;5294;1846;4974;115;232;1549;4316;1664;4548
291580;201709;5409;15654;4635;14570;438;1580;3268;10220;3706;11800
291590;201709;1652;5110;1538;4923;141;510;1203;3846;1344;4356
291600;201709;4958;13235;3811;11375;736;2289;1968;5798;2704;8087
291610;201709;4580;14167;4428;13997;92;331;4138;13139;4230;13470
291620;201709;3030;7001;2210;6105;126;393;1688;4740;1814;5133
291630;201709;3075;7322;2447;6528;141;400;1965;5238;2106;5638
291640;201709;14832;40026;11832;35462;2712;8376;3784;12259;6496;20635
291650;201709;8143;23025;7447;22158;477;1206;6298;19071;6775;20277
291660;201709;2153;5334;1609;4494;126;471;1053;2740;1179;3211
291670;201709;1828;5009;1656;4760;129;339;1289;3773;1418;4112
291680;201709;3698;10361;3222;9565;402;1290;2220;6568;2622;7858
291685;201709;4596;11395;3775;10321;411;998;2658;7544;3069;8542
291690;201709;3507;8999;2812;7923;121;346;2222;6224;2343;6570
291700;201709;8601;26124;7690;24476;660;2094;5897;18869;6557;20963
291710;201709;4894;12621;3922;11283;451;1394;2571;7248;3022;8642
291720;201709;4572;14385;3813;12808;316;1206;2578;8456;2894;9662
291730;201709;5962;16941;5364;16135;323;1113;4355;13161;4678;14274
291733;201709;2800;7583;2331;6915;118;371;1672;5131;1790;5502
291735;201709;2874;7722;2438;7081;85;300;2071;5953;2156;6253
291740;201709;3756;10119;3106;9188;147;482;2467;7246;2614;7728
291750;201709;19251;49013;15579;43463;2366;6731;9014;25775;11380;32506
291760;201709;9860;31081;8513;28679;3126;11793;1913;6506;5039;18299
291770;201709;6863;19609;5831;17735;628;2085;4007;11917;4635;14002
291780;201709;4458;12895;4084;12281;163;525;3465;10404;3628;10929
291790;201709;2616;7749;2464;7533;180;558;1954;5973;2134;6531
291800;201709;28081;74885;24049;69289;3099;8952;15208;44821;18307;53773
291810;201709;10120;26471;8777;24759;272;946;7435;20830;7707;21776
291820;201709;3647;10369;3240;9774;149;525;2516;7596;2665;8121
291830;201709;3979;10267;3631;9777;296;822;2871;7781;3167;8603
291835;201709;6152;18986;5043;16895;962;3310;2773;9563;3735;12873
291840;201709;44275;124293;38830;117688;5005;15247;26787;83506;31792;98753
291845;201709;2383;7015;2189;6737;135;403;1820;5648;1955;6051
291850;201709;4173;12094;3468;10928;324;921;2510;8165;2834;9086
291855;201709;1784;4110;1546;3803;84;260;1267;3061;1351;3321
291860;201709;2236;6055;1661;4929;41;154;1134;3222;1175;3376
291870;201709;1284;3394;891;2649;61;222;572;1610;633;1832
291875;201709;2724;8308;2422;7800;117;443;1783;5624;1900;6067
291880;201709;4940;15338;4521;14502;449;1466;3263;10460;3712;11926
291890;201709;1258;3046;947;2649;207;455;597;1763;804;2218
291900;201709;1191;3111;923;2654;32;126;704;1971;736;2097
291905;201709;2661;6976;2042;5894;81;269;1525;4303;1606;4572
291910;201709;2702;7111;2321;6658;85;275;1994;5737;2079;6012
291915;201709;6641;20134;5645;18416;299;1157;4315;14101;4614;15258
291920;201709;23262;67622;21320;64892;2699;9038;14152;42637;16851;51675
291930;201709;2385;7060;2132;6640;186;692;1511;4584;1697;5276
291940;201709;3224;8948;2332;7350;248;796;1444;4429;1692;5225
291950;201709;8421;27054;7458;25184;1110;3722;4297;14943;5407;18665
291955;201709;11421;31838;10544;30750;1937;5401;6837;20913;8774;26314
291960;201709;3034;8592;2477;7743;143;479;1876;5991;2019;6470
291970;201709;3756;11151;3420;10598;248;993;2481;7579;2729;8572
291980;201709;10319;29933;8361;27011;579;1931;5887;19193;6466;21124
291990;201709;1958;5839;1832;5681;41;151;1693;5281;1734;5432
291992;201709;3835;9716;2883;8399;338;937;2181;6451;2519;7388
291995;201709;2075;5792;1712;5260;67;271;1382;4159;1449;4430
292000;201709;2269;6207;1980;5751;173;583;1361;3942;1534;4525
292010;201709;5908;14379;4910;12988;288;816;3968;10484;4256;11300
292020;201709;4053;12837;3721;12249;333;1170;2861;9349;3194;10519
292030;201709;1729;5581;1625;5414;141;536;985;3198;1126;3734
292040;201709;4043;10931;3499;10273;247;624;2863;8698;3110;9322
292045;201709;3399;9971;2921;9289;80;198;2646;8517;2726;8715
292050;201709;6230;18556;5212;16517;425;1451;3281;10310;3706;11761
292060;201709;12254;29493;11315;28341;722;1794;9524;23601;10246;25395
292070;201709;5102;14582;4612;14000;310;976;3911;11914;4221;12890
292080;201709;3219;8436;2656;7711;154;517;2267;6581;2421;7098
292090;201709;3956;9562;3233;8719;212;641;2618;7142;2830;7783
292100;201709;9546;25453;8396;23866;1669;4827;4401;12952;6070;17779
292105;201709;2915;8623;2637;8162;93;380;2201;6764;2294;7144
292110;201709;6050;15925;4633;13587;1176;3414;2088;6280;3264;9694
292120;201709;6463;17939;5351;15928;692;2053;3419;10295;4111;12348
292130;201709;2890;7800;2490;7249;270;809;1780;5257;2050;6066
292140;201709;4699;12132;3929;11006;310;830;3039;8583;3349;9413
292145;201709;2137;6545;1868;6071;150;480;1309;4326;1459;4806
292150;201709;12532;36698;11520;35160;355;1383;9699;29444;10054;30827
292160;201709;2289;6615;2057;6310;70;270;1833;5584;1903;5854
292170;201709;8035;22745;6773;20576;663;2111;4588;13981;5251;16092
292180;201709;2868;8024;2184;6858;432;1291;1110;3568;1542;4859
292190;201709;2742;7881;2379;7295;359;1159;1413;4418;1772;5577
292200;201709;6295;18322;5349;16751;1193;3819;2560;8276;3753;12095
292205;201709;3574;10599;3238;10082;106;502;2778;8468;2884;8970
292210;201709;5940;15245;5038;14015;129;477;4423;12168;4552;12645
292220;201709;1835;4891;1655;4612;243;653;1078;2989;1321;3642
292225;201709;3102;9469;2804;9012;100;435;2331;7392;2431;7827
292230;201709;6943;18490;6521;17870;181;765;5496;14656;5677;15421
292240;201709;4784;14328;4199;13133;345;1094;2868;8966;3213;10060
292250;201709;5071;14681;4728;14126;709;2097;2998;9091;3707;11188
292260;201709;3192;8959;2914;8581;197;538;2426;7268;2623;7806
292265;201709;3129;9270;2711;8550;97;450;2135;6549;2232;6999
292270;201709;3789;9568;3201;8841;234;703;2609;7214;2843;7917
292273;201709;2367;5550;2013;5100;95;173;1608;4215;1703;4388
292275;201709;1721;4945;1463;4568;93;220;1161;3797;1254;4017
292280;201709;2366;6203;1994;5766;87;227;1626;4886;1713;5113
292285;201709;2366;6286;1947;5670;125;426;1497;4341;1622;4767
292290;201709;6229;18834;5483;17689;265;1071;4382;14076;4647;15147
292300;201709;8601;24513;7348;22866;1340;4315;4401;14027;5741;18342
292303;201709;2762;8212;2490;7798;76;269;2146;6695;2222;6964
292305;201709;2502;6817;2342;6576;50;216;2096;5801;2146;6017
292310;201709;6079;17151;5563;16423;275;812;4624;13650;4899;14462
292320;201709;6340;17313;5320;15516;314;985;4126;11835;4440;12820
292330;201709;2339;5804;2125;5532;134;334;1726;4512;1860;4846
292335;201709;4829;12605;4347;11937;292;731;3563;9938;3855;10669
292340;201709;6182;16862;5334;15428;274;802;4066;11692;4340;12494
292350;201709;2222;6421;1915;5991;85;327;1595;4979;1680;5306
292360;201709;4799;12798;4299;11947;348;1102;3192;8736;3540;9838
292370;201709;9038;23193;7938;21762;266;742;6992;19074;7258;19816
292380;201709;6767;19686;6211;18746;515;1487;4720;14331;5235;15818
292390;201709;3901;8141;2970;7137;131;224;2630;6446;2761;6670
292400;201709;20179;61553;18381;58492;2495;8194;12085;38551;14580;46745
292405;201709;4370;10805;3626;9819;203;483;2964;8117;3167;8600
292410;201709;1959;5116;1759;4875;79;224;1513;4226;1592;4450
292420;201709;3538;11238;3345;10923;200;869;2772;8951;2972;9820
292430;201709;5000;14683;3814;12934;330;1196;2491;8519;2821;9715
292440;201709;8243;26815;7664;25975;132;625;7057;23993;7189;24618
292450;201709;3646;11064;3054;9940;175;635;2321;7572;2496;8207
292460;201709;4513;13282;3899;12200;349;1099;2839;8909;3188;10008
292465;201709;2296;6561;1934;6000;118;374;1393;4425;1511;4799
292467;201709;1673;5255;1604;5152;211;671;1144;3767;1355;4438
292470;201709;2841;7315;2300;6456;76;217;1824;5129;1900;5346
292480;201709;6121;15476;5115;14184;107;395;4560;12459;4667;12854
292490;201709;2185;5943;1838;5422;115;352;1405;4171;1520;4523
292500;201709;6091;17656;5189;16052;607;1845;3484;10910;4091;12755
292510;201709;12224;34763;10345;31843;661;2592;7661;23445;8322;26037
292520;201709;6158;16348;5413;15208;941;2602;3433;9870;4374;12472
292525;201709;5096;13228;4401;12413;178;468;3810;10844;3988;11312
292530;201709;25620;72284;22273;67272;5538;16900;9861;31021;15399;47921
292540;201709;3080;7565;2659;7075;218;520;2188;5929;2406;6449
292550;201709;6601;19745;5590;18436;426;1603;4342;14582;4768;16185
292560;201709;4038;10983;3523;10199;131;550;2838;8100;2969;8650
292570;201709;3997;10885;3521;10254;68;238;3224;9388;3292;9626
292575;201709;6402;20080;6138;19701;254;856;5279;16960;5533;17816
292580;201709;6806;19024;6113;18002;238;793;5276;15490;5514;16283
292590;201709;7109;19735;6537;18907;266;918;5665;16042;5931;16960
292593;201709;2720;6982;2345;6380;178;462;1825;4942;2003;5404
292595;201709;5467;14941;4863;14157;236;815;3973;11470;4209;12285
292600;201709;10535;29673;9354;28014;614;1637;7187;21865;7801;23502
292610;201709;4312;11574;3606;10411;200;522;2573;7646;2773;8168
292620;201709;6066;17644;5333;16828;96;257;5029;16072;5125;16329
292630;201709;8461;21532;7103;19361;478;1353;5069;13916;5547;15269
292640;201709;7588;23737;6942;22690;274;1088;5286;17287;5560;18375
292650;201709;4177;11188;3867;10784;215;598;3378;9359;3593;9957
292660;201709;10595;30724;9495;29097;660;2182;7400;22740;8060;24922
292665;201709;2147;6753;1988;6547;30;135;1781;5901;1811;6036
292670;201709;3449;9642;2719;8289;147;544;1841;5509;1988;6053
292680;201709;3739;10499;3211;9551;249;751;2351;6887;2600;7638
292690;201709;2549;6993;1859;5855;149;457;1222;3967;1371;4424
292700;201709;9237;26349;8115;24733;975;2792;5472;17357;6447;20149
292710;201709;2211;7267;2069;7080;54;219;1871;6420;1925;6639
292720;201709;8970;22383;7786;21063;269;881;6676;18183;6945;19064
292730;201709;3720;10331;3580;10141;124;350;3124;8832;3248;9182
292740;201709;310710;813192;289858;780747;51779;145052;170494;454929;222273;599981
292750;201709;6293;17051;5434;15753;250;762;4222;12304;4472;13066
292760;201709;3762;11371;3419;10752;287;979;2496;7806;2783;8785
292770;201709;5677;16345;4920;15194;882;2854;2877;9188;3759;12042
292780;201709;1726;3909;1339;3424;63;200;1030;2565;1093;2765
292790;201709;3712;8378;3203;7823;44;127;3037;7405;3081;7532
292800;201709;9374;26108;8542;24724;418;1321;6934;19915;7352;21236
292805;201709;3095;8227;2625;7555;276;743;1890;5517;2166;6260
292810;201709;9358;26768;7611;24111;453;1604;5595;17786;6048;19390
292820;201709;7464;20644;5566;17831;435;1662;4082;12929;4517;14591
292830;201709;2470;6077;2182;5714;52;204;2000;5185;2052;5389
292840;201709;8011;22873;7476;22141;173;784;6686;19344;6859;20128
292850;201709;2746;7472;2279;6724;184;664;1509;4303;1693;4967
292860;201709;14891;36826;13622;35193;1000;2507;10770;27996;11770;30503
292870;201709;17105;45879;15163;42912;1228;3997;9889;27538;11117;31535
292880;201709;11269;31735;10139;30129;531;2103;7696;22113;8227;24216
292890;201709;5282;16836;4761;15959;431;1585;3562;11914;3993;13499
292895;201709;2839;6571;2131;5506;124;318;1560;4031;1684;4349
292900;201709;2606;7597;2451;7345;92;418;1960;5642;2052;6060
292905;201709;4091;11624;3274;10340;268;807;2241;7227;2509;8034
292910;201709;4754;13797;4367;13094;431;1403;2960;8827;3391;10230
292920;201709;9511;26926;9087;26379;346;1349;7923;22574;8269;23923
292925;201709;5017;14808;4559;14070;251;778;3569;10971;3820;11749
292930;201709;5987;18805;5545;17941;368;1613;3863;12145;4231;13758
292935;201709;1942;5747;1614;5385;57;283;1391;4711;1448;4994
292937;201709;2976;7562;2612;7114;88;268;2246;6136;2334;6404
292940;201709;3032;8144;2506;7334;165;481;1901;5681;2066;6162
292950;201709;8573;23697;7875;22580;375;1248;6086;17176;6461;18424
292960;201709;5086;12592;4406;11680;145;461;3551;9256;3696;9717
292970;201709;3965;11679;3508;11056;133;578;2917;9182;3050;9760
292975;201709;3991;9352;3591;8889;194;434;3189;7939;3383;8373
292980;201709;3062;7963;2475;7054;134;415;1894;5323;2028;5738
292990;201709;11157;31263;9610;28816;436;1470;7702;23130;8138;24600
293000;201709;2570;6531;2366;6274;27;89;1873;5210;1900;5299
293010;201709;16671;45313;14135;41163;1942;5780;8730;25510;10672;31290
293015;201709;7141;23637;6011;21442;624;2594;4043;14316;4667;16910
293020;201709;8726;28183;8221;27493;188;890;7375;24502;7563;25392
293030;201709;5306;14989;4227;13224;172;550;2905;9409;3077;9959
293040;201709;3619;11200;3412;10883;120;451;2992;9521;3112;9972
293050;201709;19745;52333;17747;49619;2064;5910;11478;32955;13542;38865
293060;201709;3409;9081;2848;8169;209;682;2102;5929;2311;6611
293070;201709;23108;59882;19048;54313;3993;11187;9557;28940;13550;40127
293075;201709;3123;10523;2916;10169;197;865;2326;8098;2523;8963
293076;201709;3457;9291;3089;8793;107;282;2528;7331;2635;7613
293077;201709;5035;14975;4324;13978;584;1934;2816;9363;3400;11297
293080;201709;4636;14199;4149;13402;163;686;3399;10787;3562;11473
293090;201709;2962;9371;2450;8510;204;787;1702;5959;1906;6746
293100;201709;5528;15747;4663;14192;369;1111;3511;10797;3880;11908
293105;201709;3626;11861;3216;11048;294;1062;2237;7652;2531;8714
293110;201709;2076;5510;1807;5145;70;215;1503;4246;1573;4461
293120;201709;3765;11476;3561;11149;145;452;3002;9402;3147;9854
293130;201709;3591;10583;3294;10205;99;392;2870;8896;2969;9288
293135;201709;28866;72374;22315;62943;4553;14363;9004;25751;13557;40114
293140;201709;2018;5271;1877;5082;87;277;1564;4121;1651;4398
293150;201709;5208;16585;4421;15052;520;1806;2956;10190;3476;11996
293160;201709;3701;9431;3337;8989;337;630;2665;7645;3002;8275
293170;201709;3539;9453;3148;8927;161;537;2450;6944;2611;7481
293180;201709;4798;13289;3930;11846;128;540;3149;9259;3277;9799
293190;201709;13109;38362;11853;36466;398;1788;10029;30446;10427;32234
293200;201709;7388;19368;6390;18042;212;774;5026;14197;5238;14971
293210;201709;4899;13644;4298;12682;252;801;3337;9782;3589;10583
293220;201709;4752;13564;3883;12018;987;3024;1482;4833;2469;7857
293230;201709;3449;10240;3026;9549;394;1318;2008;6392;2402;7710
293240;201709;4209;11639;3424;10303;111;354;2611;7943;2722;8297
293245;201709;4027;11115;3596;10514;167;573;2998;8676;3165;9249
293250;201709;5212;13693;4638;12814;356;996;3531;9717;3887;10713
293260;201709;4222;12243;3525;11141;140;509;2577;8024;2717;8533
293270;201709;5904;14963;5121;14108;363;859;4313;12201;4676;13060
293280;201709;4892;13477;4177;12485;207;626;3202;9628;3409;10254
293290;201709;12837;41712;11918;40026;2984;10110;5482;19420;8466;29530
293300;201709;6111;14761;5314;13753;351;802;4016;10625;4367;11427
293305;201709;4211;10616;3642;9845;78;268;3162;8523;3240;8791
293310;201709;2224;5823;1808;5095;149;437;1263;3508;1412;3945
293315;201709;4038;10109;3398;9140;189;457;2734;7358;2923;7815
293317;201709;2328;6376;2092;5949;143;399;1550;4430;1693;4829
293320;201709;7668;23742;7367;23368;882;2805;5812;18686;6694;21491
293325;201709;1636;4593;1366;4137;228;726;847;2538;1075;3264
293330;201709;42447;139057;38895;132266;8691;30519;18074;62274;26765;92793
293340;201709;2421;6917;1968;6128;196;682;1236;3803;1432;4485
293345;201709;3029;8923;2668;8457;254;585;1975;6718;2229;7303
293350;201709;6400;18776;5973;18289;118;301;5547;17337;5665;17638
293360;201709;13297;38123;12050;36577;615;2026;10598;32189;11213;34215
310010;201709;767;2034;620;1813;69;247;293;798;362;1045
310020;201709;2164;6694;1817;6063;461;1719;252;813;713;2532
310030;201709;2038;6176;1673;5548;286;1083;986;3184;1272;4267
310040;201709;941;2450;775;2207;61;221;587;1609;648;1830
310050;201709;1533;5164;1442;4968;280;1075;713;2333;993;3408
310060;201709;3206;9488;2809;8958;164;709;2285;7200;2449;7909
310070;201709;328;851;234;681;5;17;160;452;165;469
310080;201709;715;2007;537;1691;63;229;237;721;300;950
310090;201709;4418;12680;3769;11595;466;1546;2582;7929;3048;9475
310100;201709;3346;9868;2834;9034;140;568;2237;7047;2377;7615
310110;201709;4755;13138;3940;11685;656;2194;1977;5613;2633;7807
310120;201709;611;1700;441;1391;89;343;190;501;279;844
310130;201709;366;1088;323;1007;62;236;179;494;241;730
310140;201709;169;569;144;526;43;184;44;136;87;320
310150;201709;4138;12496;3514;11272;823;2836;1159;3672;1982;6508
310160;201709;6064;18501;5044;16569;1543;5484;928;3050;2471;8534
310163;201709;1014;3160;846;2841;285;1046;225;718;510;1764
310170;201709;8596;23412;7489;21827;787;2416;5327;15581;6114;17997
310180;201709;1582;4380;1331;3997;142;532;882;2548;1024;3080
310190;201709;2930;9324;2542;8619;690;2550;300;966;990;3516
310200;201709;1623;5262;1346;4644;267;1006;484;1612;751;2618
310205;201709;1072;3047;812;2657;104;328;479;1615;583;1943
310210;201709;2620;7189;2218;6595;119;392;1670;4926;1789;5318
310220;201709;974;2832;838;2614;109;400;555;1652;664;2052
310230;201709;2223;6642;1914;5973;253;956;1141;3360;1394;4316
310240;201709;812;2910;750;2791;84;383;495;1802;579;2185
310250;201709;832;2591;748;2437;126;511;443;1340;569;1851
310260;201709;2600;8007;1879;6559;445;1761;274;763;719;2524
310270;201709;2560;6895;2061;6198;146;566;1619;4763;1765;5329
310280;201709;2192;5557;1747;4889;176;625;1108;2986;1284;3611
310285;201709;1829;6383;1667;6116;167;679;1137;4278;1304;4957
310290;201709;1070;3104;986;2959;219;771;530;1440;749;2211
310300;201709;1494;4899;1404;4743;298;1151;698;2226;996;3377
310310;201709;288;765;209;622;36;102;107;324;143;426
310320;201709;460;1268;312;995;26;103;164;495;190;598
310330;201709;493;1208;321;892;45;133;125;298;170;431
310340;201709;7586;22066;6234;19751;1263;3938;2942;9731;4205;13669
310350;201709;11944;30842;8364;24969;2222;7132;2067;6143;4289;13275
310360;201709;440;1204;391;1138;17;59;308;880;325;939
310370;201709;1322;4358;1145;4006;239;875;467;1643;706;2518
310375;201709;994;2675;674;2137;108;371;255;800;363;1171
310380;201709;360;890;195;591;42;126;67;183;109;309
310390;201709;415;1387;358;1265;98;368;78;229;176;597
310400;201709;8373;22699;6344;19362;1354;4534;2419;7203;3773;11737
310410;201709;659;2060;465;1715;122;487;89;313;211;800
310420;201709;3768;10387;2571;7949;541;1867;485;1319;1026;3186
310430;201709;1198;3715;855;3021;210;795;138;451;348;1246
310440;201709;522;1450;385;1183;50;185;194;579;244;764
310445;201709;1275;3948;993;3419;66;260;693;2359;759;2619
310450;201709;4352;11709;3381;10218;273;881;2500;7593;2773;8474
310460;201709;1602;4538;1178;3753;263;909;328;1035;591;1944
310470;201709;3808;8498;3156;7677;261;796;2599;6188;2860;6984
310480;201709;1155;3262;865;2721;170;558;424;1290;594;1848
310490;201709;2859;8814;2383;7896;447;1739;1015;3199;1462;4938
310500;201709;1242;3989;1036;3561;236;882;424;1415;660;2297
310510;201709;1646;5009;1246;4190;330;1217;272;903;602;2120
310520;201709;1380;3477;1023;2927;79;218;683;1959;762;2177
310530;201709;859;2453;450;1467;75;279;56;143;131;422
310540;201709;3067;9354;2594;8497;692;2410;994;3101;1686;5511
310550;201709;1106;3016;846;2589;121;470;543;1549;664;2019
310560;201709;13078;38210;10874;34331;2661;9318;3603;10649;6264;19967
310570;201709;1084;3156;920;2867;117;462;623;1851;740;2313
310590;201709;4006;11367;3378;10281;439;1483;1935;5784;2374;7267
310600;201709;1412;4414;1183;3905;195;694;527;1623;722;2317
310610;201709;479;1421;346;1184;68;290;149;462;217;752
310620;201709;132775;387489;110943;346137;26218;91424;38828;108798;65046;200222
310630;201709;4251;12315;3712;11355;309;1065;2681;8090;2990;9155
310640;201709;1007;3210;863;2924;236;892;242;770;478;1662
310650;201709;2526;7713;1942;6626;240;872;1082;3627;1322;4499
310660;201709;1244;3647;1090;3451;82;273;841;2653;923;2926
310665;201709;1242;3582;1083;3354;64;221;866;2717;930;2938
310670;201709;39243;115119;34293;105514;7084;23464;16105;47868;23189;71332
310680;201709;647;1726;568;1612;42;135;430;1195;472;1330
310690;201709;1375;4167;1108;3706;159;635;568;1813;727;2448
310700;201709;515;1212;394;1062;51;165;255;660;306;825
310710;201709;5372;16980;4059;14928;939;4038;398;1375;1337;5413
310720;201709;808;2282;711;2143;62;214;524;1567;586;1781
310730;201709;8454;25385;7515;23805;848;3051;4787;14940;5635;17991
310740;201709;4706;14290;3547;11919;750;2673;834;2728;1584;5401
310750;201709;1318;3275;960;2783;179;562;377;1020;556;1582
310760;201709;509;1481;407;1297;50;187;177;566;227;753
310770;201709;978;2914;704;2469;103;412;343;1137;446;1549
310780;201709;3797;10072;3114;8951;261;785;2157;6128;2418;6913
310790;201709;1797;5783;1650;5509;345;1159;756;2657;1101;3816
310800;201709;2264;7178;1742;6144;502;2062;123;402;625;2464
310810;201709;1056;2909;911;2641;91;300;566;1571;657;1871
310820;201709;1129;3190;782;2508;183;649;213;657;396;1306
310825;201709;2797;9450;2308;8618;103;605;1804;6586;1907;7191
310830;201709;1323;4157;1073;3683;258;953;375;1249;633;2202
310840;201709;1990;5721;1416;4675;270;932;346;1075;616;2007
310850;201709;1425;4153;1252;3930;86;377;950;2903;1036;3280
310855;201709;2813;8254;2370;7630;273;1002;1688;5375;1961;6377
310860;201709;6662;20122;5593;18090;542;1878;3512;11423;4054;13301
310870;201709;1015;2610;777;2241;161;485;457;1311;618;1796
310880;201709;963;2980;791;2633;96;366;477;1562;573;1928
310890;201709;2291;6730;1722;5766;435;1636;293;855;728;2491
310900;201709;4046;12166;3173;10465;615;2287;1357;4177;1972;6464
310910;201709;1733;4786;1072;3491;138;513;114;304;252;817
310920;201709;1774;5042;1398;4420;248;868;733;2284;981;3152
310925;201709;897;2786;790;2604;166;606;468;1481;634;2087
310930;201709;5720;15684;4428;13752;733;2417;2426;7725;3159;10142
310940;201709;5772;15674;4776;14169;542;1764;3083;9021;3625;10785
310945;201709;1122;3241;1018;3084;78;279;693;2043;771;2322
310950;201709;1946;5924;1406;4776;313;1215;467;1460;780;2675
310960;201709;526;1442;377;1171;69;249;126;409;195;658
310970;201709;1101;3510;830;2932;206;776;208;683;414;1459
310980;201709;356;844;229;634;32;99;138;362;170;461
310990;201709;1172;3608;926;3085;206;727;327;1057;533;1784
311000;201709;3435;10922;3013;10171;865;3188;1137;3637;2002;6825
311010;201709;715;2328;624;2110;222;809;218;723;440;1532
311020;201709;923;2596;684;2152;95;353;324;968;419;1321
311030;201709;1565;4220;1065;3320;282;1006;309;878;591;1884
311040;201709;371;1212;307;1062;76;273;68;207;144;480
311050;201709;2168;6270;1815;5694;433;1498;688;2096;1121;3594
311060;201709;2407;6919;1747;5488;275;999;625;1779;900;2778
311070;201709;1394;4343;1148;3889;211;833;532;1718;743;2551
311080;201709;790;2286;660;2049;127;449;318;916;445;1365
311090;201709;1926;6576;1562;5912;418;1805;511;1857;929;3662
311100;201709;1892;5964;1367;4881;387;1528;177;577;564;2105
311110;201709;3034;7109;2132;5813;491;1392;912;2544;1403;3936
311115;201709;1158;3313;986;3053;77;292;745;2264;822;2556
311120;201709;6689;18392;5029;15366;979;3346;1563;4315;2542;7661
311130;201709;1847;5436;1523;4934;200;776;721;2242;921;3018
311140;201709;1173;3063;883;2662;62;211;594;1815;656;2026
311150;201709;1376;4786;1233;4518;201;785;730;2667;931;3452
311160;201709;3538;11394;2738;9886;913;3585;587;2083;1500;5668
311170;201709;747;2225;608;1965;51;188;340;1109;391;1297
311180;201709;1046;2834;793;2399;246;794;247;752;493;1546
311190;201709;1017;2913;786;2474;151;547;271;792;422;1339
311200;201709;1634;4827;1263;4060;346;1197;232;700;578;1897
311205;201709;885;2899;760;2650;80;348;414;1427;494;1775
311210;201709;961;2983;869;2866;131;399;619;2108;750;2507
311220;201709;743;2303;621;2048;143;516;242;747;385;1263
311230;201709;7701;24304;5942;20608;1264;4668;1830;6600;3094;11268
311240;201709;871;2602;698;2329;153;558;329;1069;482;1627
311250;201709;716;2245;627;2093;172;612;237;755;409;1367
311260;201709;1957;5223;1522;4513;331;1073;594;1675;925;2748
311265;201709;1150;3190;914;2814;101;349;576;1754;677;2103
311270;201709;3132;9777;2784;9279;224;1044;1987;6341;2211;7385
311280;201709;1071;2974;606;1936;110;399;134;411;244;810
311290;201709;1860;6047;1745;5779;226;735;1178;3935;1404;4670
311300;201709;4249;13236;3757;12414;245;1136;2887;9353;3132;10489
311310;201709;627;1959;538;1787;117;397;162;500;279;897
311320;201709;3136;10203;2822;9502;472;1840;1199;3726;1671;5566
311330;201709;4253;12278;3717;11376;608;2050;1950;5999;2558;8049
311340;201709;10564;32584;8885;29396;2658;9274;2271;7674;4929;16948
311350;201709;2106;5740;1636;4879;224;770;822;2264;1046;3034
311360;201709;810;2355;691;2198;350;1172;94;324;444;1496
311370;201709;3772;10736;3081;9519;340;1312;1676;4850;2016;6162
311380;201709;420;1352;339;1188;100;358;101;374;201;732
311390;201709;1654;5654;1413;5305;610;2589;373;1255;983;3844
311400;201709;1339;4073;1040;3476;175;680;415;1248;590;1928
311410;201709;1483;5006;1344;4828;303;1230;671;2394;974;3624
311420;201709;1694;5411;1150;4145;192;757;119;336;311;1093
311430;201709;3258;9329;2218;7192;372;1293;515;1643;887;2936
311440;201709;2291;7149;1683;6007;514;2033;348;1266;862;3299
311450;201709;1791;5882;1397;5113;377;1516;267;856;644;2372
311455;201709;899;2320;686;1973;200;591;225;635;425;1226
311460;201709;535;1718;398;1456;86;382;105;346;191;728
311470;201709;380;1275;307;1119;77;318;54;182;131;500
311480;201709;803;2098;721;1969;113;315;426;1115;539;1430
311490;201709;200;704;178;636;54;213;65;204;119;417
311500;201709;379;1092;302;959;49;178;151;485;200;663
311510;201709;2593;7719;1919;6456;507;1947;417;1359;924;3306
311520;201709;569;1783;530;1708;148;530;245;743;393;1273
311530;201709;8787;22200;6256;18128;1568;5243;1576;4349;3144;9592
311535;201709;695;1980;471;1556;109;437;109;336;218;773
311540;201709;549;1841;509;1775;143;498;240;849;383;1347
311545;201709;2044;5995;1821;5713;123;502;1391;4283;1514;4785
311547;201709;1419;3904;1231;3606;62;218;947;2746;1009;2964
311550;201709;2692;8163;2186;7168;363;1389;833;2634;1196;4023
311560;201709;229;576;189;527;29;89;108;277;137;366
311570;201709;1912;4782;1455;4141;60;177;1156;3410;1216;3587
311580;201709;2207;4300;1575;3568;220;417;1010;2464;1230;2881
311590;201709;478;1415;397;1292;88;338;183;580;271;918
311600;201709;1206;3472;996;3193;114;347;716;2351;830;2698
311610;201709;2400;8492;2149;7937;559;1983;896;3456;1455;5439
311615;201709;2934;9069;2435;8255;220;886;1760;5899;1980;6785
311620;201709;375;1106;331;1033;32;121;245;749;277;870
311630;201709;1314;3776;1092;3371;91;327;780;2335;871;2662
311640;201709;551;1821;462;1653;99;380;187;665;286;1045
311650;201709;1955;5511;1707;5126;172;626;1126;3270;1298;3896
311660;201709;2682;8237;2050;6995;416;1500;364;1104;780;2604
311670;201709;1493;4133;1198;3670;242;826;496;1540;738;2366
311680;201709;1978;6153;1631;5475;282;1009;997;3324;1279;4333
311690;201709;505;1220;418;1111;24;71;329;884;353;955
311700;201709;2180;5566;1717;4943;68;225;1356;3843;1424;4068
311710;201709;1459;4454;1054;3645;309;1172;310;1096;619;2268
311720;201709;396;1283;337;1168;48;189;170;570;218;759
311730;201709;4814;12038;2883;8658;930;3146;375;985;1305;4131
311740;201709;744;2290;714;2249;58;163;619;1988;677;2151
311750;201709;3783;11966;3214;11018;431;1739;1929;6373;2360;8112
311760;201709;625;2011;546;1833;115;446;163;455;278;901
311770;201709;1879;5864;1507;5128;352;1293;503;1656;855;2949
311780;201709;1160;3801;921;3286;229;954;221;664;450;1618
311783;201709;1936;6097;1640;5534;57;275;1322;4389;1379;4664
311787;201709;632;2048;470;1625;86;325;148;437;234;762
311790;201709;1361;3859;1013;3230;209;753;400;1245;609;1998
311800;201709;4637;15106;4052;13708;820;3097;558;1757;1378;4854
311810;201709;966;3138;824;2848;66;267;499;1709;565;1976
311820;201709;604;1760;510;1572;92;346;302;858;394;1204
311830;201709;7560;23797;5790;19798;1590;5901;556;1853;2146;7754
311840;201709;2709;7984;2436;7564;391;1390;1591;4860;1982;6250
311850;201709;283;846;246;782;32;105;158;496;190;601
311860;201709;46610;131697;39523;119624;6446;20855;22214;66099;28660;86954
311870;201709;1922;5480;1379;4430;248;916;496;1434;744;2350
311880;201709;6124;17261;5435;16314;479;1364;4088;12493;4567;13857
311890;201709;1325;3758;1092;3357;215;716;555;1656;770;2372
311900;201709;627;1820;520;1641;66;237;331;1034;397;1271
311910;201709;3858;11056;3232;10188;671;2239;1567;4975;2238;7214
311920;201709;1848;5743;1554;5225;166;624;941;3116;1107;3740
311930;201709;3006;8210;2467;7349;994;3147;659;1845;1653;4992
311940;201709;12463;36146;9924;31150;1802;6255;3741;11119;5543;17374
311950;201709;2133;6205;1696;5464;119;510;1217;3849;1336;4359
311960;201709;418;1198;369;1107;53;220;211;539;264;759
311970;201709;412;1375;281;1044;51;223;59;201;110;424
311980;201709;454;1288;295;975;45;165;97;315;142;480
311990;201709;457;1199;334;1026;103;351;136;408;239;759
311995;201709;975;2893;554;1875;37;142;50;117;87;259
312000;201709;548;1584;485;1489;36;116;349;1092;385;1208
312010;201709;834;2714;691;2375;84;307;340;1141;424;1448
312015;201709;1274;4016;1150;3787;106;437;801;2564;907;3001
312020;201709;1070;3389;941;3169;196;713;417;1373;613;2086
312030;201709;1811;4959;1630;4739;40;192;1493;4284;1533;4476
312040;201709;720;2472;587;2156;110;464;192;663;302;1127
312050;201709;1188;4097;989;3647;274;1143;216;719;490;1862
312060;201709;760;2211;608;1994;140;485;300;975;440;1460
312070;201709;862;2628;610;2084;93;369;299;979;392;1348
312080;201709;2587;6741;1974;5831;201;719;1187;3271;1388;3990
312083;201709;895;2479;744;2246;92;302;519;1535;611;1837
312087;201709;2121;6073;1869;5714;127;393;1471;4589;1598;4982
312090;201709;8555;24980;6871;22198;1686;5731;2719;8756;4405;14487
312100;201709;1445;4550;1103;3968;156;692;501;1712;657;2404
312110;201709;955;3243;826;2962;241;968;198;629;439;1597
312120;201709;605;1851;477;1609;115;449;162;473;277;922
312125;201709;1123;3444;1007;3263;192;579;680;2292;872;2871
312130;201709;806;2211;633;1883;82;281;256;715;338;996
312140;201709;765;2384;642;2109;166;587;207;622;373;1209
312150;201709;465;1365;394;1199;20;83;254;720;274;803
312160;201709;7138;22855;6030;20546;1158;4391;2462;7984;3620;12375
312170;201709;832;2381;691;2142;48;168;457;1381;505;1549
312180;201709;1268;3820;1090;3460;165;601;508;1521;673;2122
312190;201709;500;1597;380;1335;109;413;62;221;171;634
312200;201709;4520;12795;3746;11443;667;2078;2220;6822;2887;8900
312210;201709;1111;2873;845;2497;127;451;537;1493;664;1944
312220;201709;1966;6464;1815;6268;102;255;1534;5505;1636;5760
312230;201709;10236;30421;7740;25625;2413;8761;999;3068;3412;11829
312235;201709;1539;4478;1353;4227;147;534;967;2967;1114;3501
312240;201709;752;2520;604;2210;155;626;150;545;305;1171
312245;201709;2274;6376;2023;6034;70;260;1702;5054;1772;5314
312247;201709;773;2166;580;1855;146;473;258;874;404;1347
312250;201709;1043;2789;741;2257;145;486;292;849;437;1335
312260;201709;904;2678;731;2398;79;293;498;1574;577;1867
312270;201709;650;1905;528;1659;38;163;272;781;310;944
312280;201709;404;1296;343;1168;115;403;40;139;155;542
312290;201709;722;2371;657;2264;134;513;225;767;359;1280
312300;201709;854;2720;652;2215;168;627;82;209;250;836
312310;201709;749;2690;689;2554;129;537;340;1236;469;1773
312320;201709;1827;5049;1401;4265;404;1331;306;872;710;2203
312330;201709;868;2555;728;2351;89;336;522;1642;611;1978
312340;201709;272;727;209;627;32;106;104;300;136;406
312350;201709;257;619;222;582;25;79;171;437;196;516
312352;201709;1519;4651;1345;4396;185;633;904;3080;1089;3713
312360;201709;2575;8081;2096;7065;472;1722;542;1771;1014;3493
312370;201709;1629;4834;1403;4430;328;1140;631;1900;959;3040
312380;201709;1967;4937;1757;4666;40;105;1557;4192;1597;4297
312385;201709;1236;3528;1053;3229;131;458;679;1996;810;2454
312390;201709;1967;6073;1534;5240;358;1322;381;1214;739;2536
312400;201709;2796;8787;2292;7785;861;3010;558;1966;1419;4976
312410;201709;9853;30867;8693;28689;1748;6176;4076;13261;5824;19437
312420;201709;3555;10783;3277;10282;567;1885;1888;5923;2455;7808
312430;201709;7613;21574;6446;19497;778;2541;4158;12544;4936;15085
312440;201709;795;2504;658;2246;255;940;162;559;417;1499
312450;201709;1085;3514;866;3088;268;992;313;1164;581;2156
312460;201709;335;972;279;895;44;167;166;542;210;709
312470;201709;501;1358;333;1051;59;221;109;309;168;530
312480;201709;1078;2765;790;2417;113;399;473;1389;586;1788
312490;201709;1872;4858;1458;4191;247;763;796;2206;1043;2969
312500;201709;720;1948;595;1762;72;248;346;989;418;1237
312510;201709;3380;9689;2736;8390;364;1231;1363;3992;1727;5223
312520;201709;200;592;163;534;49;156;64;221;113;377
312530;201709;544;1561;481;1472;35;132;388;1179;423;1311
312540;201709;1354;4153;930;3217;210;783;400;1358;610;2141
312550;201709;727;2096;577;1769;76;246;310;886;386;1132
312560;201709;1925;5129;1659;4778;82;309;1364;3901;1446;4210
312570;201709;2121;6049;1762;5488;499;1621;668;2124;1167;3745
312580;201709;512;1627;417;1401;50;197;168;552;218;749
312590;201709;1623;5136;1371;4624;189;810;686;2152;875;2962
312595;201709;1702;5579;1574;5305;295;989;909;3139;1204;4128
312600;201709;781;2314;555;1943;97;402;245;821;342;1223
312610;201709;5863;15892;4188;12894;947;3156;940;2748;1887;5904
312620;201709;2260;6141;1715;5376;85;335;1292;4168;1377;4503
312630;201709;259;846;222;775;57;226;72;254;129;480
312640;201709;494;1515;383;1296;66;224;122;402;188;626
312650;201709;1970;5522;1424;4413;126;459;912;2681;1038;3140
312660;201709;1332;3420;1057;3021;121;407;691;1927;812;2334
312670;201709;4951;14211;4196;13162;599;2259;2442;7380;3041;9639
312675;201709;1258;3785;1040;3359;99;398;771;2433;870;2831
312680;201709;1311;3917;1149;3690;113;469;824;2575;937;3044
312690;201709;2080;5365;1658;4794;184;554;1137;3233;1321;3787
312695;201709;845;2736;782;2631;111;364;553;1889;664;2253
312700;201709;1787;5205;1392;4450;162;554;794;2505;956;3059
312705;201709;1241;3451;1026;3076;47;178;757;2201;804;2379
312707;201709;1366;4327;1070;3737;95;454;618;2050;713;2504
312710;201709;5873;14249;3745;10993;1187;3871;736;2181;1923;6052
312720;201709;791;2541;668;2298;89;351;334;1090;423;1441
312730;201709;1695;4098;1224;3507;89;293;789;2245;878;2538
312733;201709;1511;4074;1166;3441;50;150;747;2165;797;2315
312735;201709;712;1955;620;1801;101;377;396;1033;497;1410
312737;201709;766;1920;555;1606;125;380;237;675;362;1055
312738;201709;479;1413;334;1120;74;291;128;392;202;683
312740;201709;308;774;181;597;59;207;40;108;99;315
312750;201709;1170;3994;1067;3821;187;772;542;1854;729;2626
312760;201709;1833;5712;1369;4763;281;1026;399;1385;680;2411
312770;201709;37673;99461;26965;81065;6518;20959;7924;23249;14442;44208
312780;201709;2452;8266;2211;7833;303;1228;1332;4676;1635;5904
312790;201709;330;832;198;634;24;94;76;221;100;315
312800;201709;4572;14412;3667;12516;1034;3799;971;3328;2005;7127
312810;201709;1825;5297;1219;4137;312;1165;299;893;611;2058
312820;201709;1877;5254;1566;4709;75;277;1079;3151;1154;3428
312825;201709;1193;3132;1057;2959;53;162;871;2452;924;2614
312830;201709;2338;7014;1606;5555;412;1561;291;962;703;2523
312840;201709;1118;3541;891;3088;148;593;287;893;435;1486
312850;201709;732;2113;563;1806;95;349;234;727;329;1076
312860;201709;1387;3669;917;2873;231;764;252;759;483;1523
312870;201709;5411;16380;3632;12471;610;2292;883;2825;1493;5117
312880;201709;1282;3589;1100;3327;63;194;709;2249;772;2443
312890;201709;1875;5424;1206;4006;221;759;441;1489;662;2248
312900;201709;1137;3263;971;3033;91;302;630;2016;721;2318
312910;201709;1501;2917;879;2111;130;341;449;1036;579;1377
312920;201709;859;2573;666;2240;136;546;312;982;448;1528
312930;201709;2031;5644;1703;5136;396;1245;784;2333;1180;3578
312940;201709;838;2629;727;2424;165;576;310;1040;475;1616
312950;201709;2421;6794;1879;5960;653;2227;517;1642;1170;3869
312960;201709;1879;5230;1632;4882;110;322;1252;3808;1362;4130
312965;201709;1714;5292;1452;4798;114;420;933;3072;1047;3492
312970;201709;897;2866;711;2554;170;691;237;808;407;1499
312980;201709;17503;55209;15798;51896;3428;12355;7204;22574;10632;34929
312990;201709;422;1230;284;977;79;313;104;349;183;662
313000;201709;432;1384;358;1246;65;301;139;428;204;729
313005;201709;2505;7633;2221;7139;230;816;1559;4957;1789;5773
313010;201709;3701;11511;3170;10569;699;2598;1670;5355;2369;7953
313020;201709;870;2896;632;2294;104;429;73;224;177;653
313030;201709;1259;3214;894;2656;140;495;476;1382;616;1877
313040;201709;726;2332;617;2082;62;252;323;1025;385;1277
313050;201709;1693;5080;1218;4323;280;1152;316;1005;596;2157
313055;201709;1592;4829;1468;4645;38;136;1288;4071;1326;4207
313060;201709;859;2416;628;1993;187;650;117;344;304;994
313065;201709;1756;5631;1511;5242;141;578;1129;3912;1270;4490
313070;201709;900;2535;727;2242;132;436;352;1059;484;1495
313080;201709;402;1168;297;955;72;273;86;222;158;495
313090;201709;4546;12978;3929;11953;1114;3646;1809;5489;2923;9135
313100;201709;1115;3251;998;3085;67;231;800;2458;867;2689
313110;201709;1481;4156;1098;3429;141;498;515;1515;656;2013
313115;201709;2253;7263;2070;6867;386;1379;989;3086;1375;4465
313120;201709;3339;8476;2798;7814;330;1009;1879;5310;2209;6319
313130;201709;24419;71072;20423;63328;3546;12207;9376;27525;12922;39732
313140;201709;496;1256;365;1048;23;85;251;701;274;786
313150;201709;1196;3706;985;3302;346;1223;249;843;595;2066
313160;201709;867;2436;684;2129;106;370;383;1147;489;1517
313170;201709;10335;33903;7827;28061;1621;6079;2454;8652;4075;14731
313180;201709;2120;5737;1622;4952;292;977;770;2286;1062;3263
313190;201709;3712;11897;2917;10077;598;2235;838;2709;1436;4944
313200;201709;1059;3220;926;2979;53;201;727;2288;780;2489
313210;201709;3663;11158;3090;10234;528;1935;1713;5501;2241;7436
313220;201709;1550;4401;1098;3524;212;788;370;1046;582;1834
313230;201709;2318;7647;2147;7417;111;423;1842;6347;1953;6770
313240;201709;7847;22696;5825;18979;1114;4030;2318;7151;3432;11181
313250;201709;6114;18931;5146;17164;528;1945;2784;9182;3312;11127
313260;201709;617;1749;426;1348;63;242;166;504;229;746
313270;201709;5056;14942;4246;13527;801;2699;2399;7699;3200;10398
313280;201709;359;1163;263;962;52;205;59;215;111;420
313290;201709;706;2482;588;2283;241;1020;89;318;330;1338
313300;201709;1613;4992;1292;4331;368;1342;189;552;557;1894
313310;201709;935;3095;829;2890;165;651;172;507;337;1158
313320;201709;2149;5981;1534;5003;311;1124;653;2121;964;3245
313330;201709;3886;11390;3228;10304;255;1111;2142;6578;2397;7689
313340;201709;1404;3367;1048;2846;164;449;641;1770;805;2219
313350;201709;2216;6818;1712;5727;305;1115;496;1554;801;2669
313360;201709;1220;3326;877;2740;170;655;442;1277;612;1932
313370;201709;1117;3688;1040;3505;146;547;564;1848;710;2395
313375;201709;1878;4979;1324;4117;247;915;403;1188;650;2103
313380;201709;4503;13230;3778;11839;910;3153;1411;4037;2321;7190
313390;201709;838;2807;769;2690;60;263;511;1748;571;2011
313400;201709;3279;8932;2820;8371;227;666;2299;6868;2526;7534
313410;201709;1138;3173;948;2866;130;446;681;2025;811;2471
313420;201709;14931;35451;8967;25490;1888;6010;1324;3786;3212;9796
313430;201709;874;2685;653;2234;119;499;250;760;369;1259
313440;201709;5643;12863;3948;10764;293;810;2551;7051;2844;7861
313450;201709;564;1680;436;1424;89;290;125;384;214;674
313460;201709;1949;6383;1671;5899;419;1710;697;2252;1116;3962
313470;201709;2841;7592;2449;7028;281;805;1708;4922;1989;5727
313480;201709;793;2316;561;1853;82;323;181;538;263;861
313490;201709;1402;3525;723;2498;261;1051;61;218;322;1269
313500;201709;393;1273;314;1076;46;180;118;377;164;557
313505;201709;8378;24533;7671;23682;333;1092;6789;21044;7122;22136
313507;201709;1297;3511;1114;3251;82;281;809;2358;891;2639
313510;201709;12723;36801;11097;33993;1443;4845;5873;17656;7316;22501
313520;201709;12921;39552;10871;35905;1015;3839;7292;23790;8307;27629
313530;201709;465;1376;392;1255;31;116;171;514;202;630
313535;201709;2414;6885;2145;6405;164;485;1506;4466;1670;4951
313540;201709;837;2604;635;2091;161;550;195;620;356;1170
313545;201709;1143;4034;995;3750;169;699;562;2023;731;2722
313550;201709;1665;5230;1460;4840;360;1261;723;2313;1083;3574
313560;201709;2231;4921;1781;4405;108;274;1444;3578;1552;3852
313570;201709;869;2881;725;2572;186;725;279;938;465;1663
313580;201709;5375;15152;4271;13455;720;2384;2228;7272;2948;9656
313590;201709;844;2518;672;2255;287;1054;160;529;447;1583
313600;201709;3548;10461;3112;9731;231;850;2377;7381;2608;8231
313610;201709;949;2698;808;2434;142;432;504;1522;646;1954
313620;201709;5097;15074;4401;13819;1012;3378;1864;5811;2876;9189
313630;201709;7522;20148;5522;17336;875;2967;2755;8942;3630;11909
313640;201709;892;2296;601;1878;173;590;201;591;374;1181
313650;201709;1729;5602;1523;5253;137;564;1022;3500;1159;4064
313652;201709;804;2773;746;2659;109;459;462;1565;571;2024
313655;201709;895;2750;756;2534;74;289;489;1627;563;1916
313657;201709;1289;3693;1040;3307;74;326;747;2219;821;2545
313660;201709;813;2555;696;2314;127;511;339;1053;466;1564
313665;201709;3874;11818;3233;10568;530;1904;1716;5465;2246;7369
313670;201709;39375;110841;28481;90310;6008;20745;9695;29618;15703;50363
313680;201709;964;2779;844;2581;79;281;540;1615;619;1896
313690;201709;790;2751;653;2453;144;558;203;778;347;1336
313695;201709;1451;4440;1178;3962;104;417;819;2729;923;3146
313700;201709;3269;10967;2836;10430;322;1220;2187;8164;2509;9384
313710;201709;1293;3401;971;2882;125;400;552;1632;677;2032
313720;201709;5199;15592;3970;13073;732;2725;1408;4273;2140;6998
313730;201709;1189;3056;911;2682;77;244;577;1683;654;1927
313740;201709;1713;6234;1453;5543;382;1594;129;469;511;2063
313750;201709;1904;5570;1507;4789;390;1379;466;1342;856;2721
313753;201709;1883;4979;1402;4157;199;663;734;2125;933;2788
313760;201709;4213;12902;3379;11204;882;3168;1146;3593;2028;6761
313770;201709;3320;10139;2820;9433;357;1273;1798;6046;2155;7319
313780;201709;3732;10322;2870;8926;447;1573;844;2655;1291;4228
313790;201709;422;1406;404;1373;64;229;239;787;303;1016
313800;201709;1145;2974;991;2746;66;222;763;2149;829;2371
313810;201709;1515;4196;1269;3831;127;426;889;2702;1016;3128
313820;201709;11614;30113;8948;25580;1415;4664;3684;9837;5099;14501
313830;201709;320;1017;287;956;64;233;139;468;203;701
313835;201709;850;2736;746;2543;76;311;426;1395;502;1706
313840;201709;6295;17728;4873;15326;1208;4097;1084;3384;2292;7481
313850;201709;960;2564;831;2346;126;447;456;1158;582;1605
313860;201709;2644;7684;1962;6237;397;1351;622;1842;1019;3193
313862;201709;1236;3118;819;2417;94;299;424;1251;518;1550
313865;201709;2118;6377;1908;6052;156;556;1452;4549;1608;5105
313867;201709;1051;3562;915;3270;300;1108;333;1191;633;2299
313868;201709;1642;5428;1408;4959;107;440;1043;3641;1150;4081
313870;201709;750;2188;602;1934;134;476;196;560;330;1036
313880;201709;1259;3758;1038;3386;241;868;380;1118;621;1986
313890;201709;1929;4767;1447;4140;191;596;848;2519;1039;3115
313900;201709;3341;11568;2975;10774;908;3609;764;2771;1672;6380
313910;201709;621;2029;513;1819;151;576;85;305;236;881
313920;201709;2951;9690;2516;8879;515;1853;1328;4846;1843;6699
313925;201709;1701;4590;1320;3872;219;604;769;2298;988;2902
313930;201709;6004;21033;5119;19503;538;1950;3417;13756;3955;15706
313940;201709;8116;25491;6216;22259;1515;6086;1633;6331;3148;12417
313950;201709;3837;10317;2960;8964;797;2832;1291;3628;2088;6460
313960;201709;5095;13172;3642;10880;866;2839;1081;3084;1947;5923
313970;201709;1283;3808;1139;3573;95;366;702;2230;797;2596
313980;201709;1217;3605;847;2922;144;575;314;1018;458;1593
313990;201709;1554;5634;1326;5063;431;1766;342;1224;773;2990
314000;201709;8116;24304;7250;22591;713;2750;4696;14294;5409;17044
314010;201709;1181;3131;971;2841;53;206;736;2103;789;2309
314015;201709;1736;5224;1432;4714;210;823;781;2497;991;3320
314020;201709;501;1453;314;1050;61;242;65;211;126;453
314030;201709;772;2468;610;2077;94;347;264;881;358;1228
314040;201709;718;2039;599;1806;122;410;254;730;376;1140
314050;201709;1499;4484;1181;3829;207;776;544;1629;751;2405
314053;201709;1491;4676;1311;4424;159;535;935;3321;1094;3856
314055;201709;2121;6174;1867;5795;59;261;1556;4806;1615;5067
314060;201709;1082;3261;871;2896;58;233;597;1944;655;2177
314070;201709;3865;11651;3142;10308;805;2801;1071;3362;1876;6163
314080;201709;1694;5136;1229;4098;210;828;343;1011;553;1839
314085;201709;1969;6386;1691;5975;428;1648;695;2446;1123;4094
314090;201709;3203;10454;2805;9751;344;1433;1657;5752;2001;7185
314100;201709;2991;7388;2628;6899;89;171;2275;6175;2364;6346
314110;201709;3796;11764;3316;10802;620;2234;1547;4686;2167;6920
314120;201709;879;2075;406;1293;93;345;78;241;171;586
314130;201709;705;2015;367;1257;57;219;88;295;145;514
314140;201709;4551;13874;3657;12041;669;2292;1602;5280;2271;7572
314150;201709;1463;3981;1166;3469;146;455;678;1981;824;2436
314160;201709;2428;6435;1822;5433;269;865;865;2658;1134;3523
314170;201709;976;2859;816;2526;110;363;472;1395;582;1758
314180;201709;4727;14356;4124;13403;830;2858;2151;6980;2981;9838
314190;201709;638;1718;450;1414;103;378;169;470;272;848
314200;201709;2757;8261;2395;7586;184;745;1738;5326;1922;6071
314210;201709;1886;5255;1662;4891;152;515;1040;2991;1192;3506
314220;201709;1343;4018;967;3292;302;1148;225;695;527;1843
314225;201709;1222;3527;1098;3358;68;236;827;2535;895;2771
314230;201709;660;2004;590;1896;78;304;352;1108;430;1412
314240;201709;1035;3025;827;2689;189;672;357;1188;546;1860
314250;201709;517;1521;354;1146;67;242;112;323;179;565
314260;201709;894;3062;756;2753;152;667;250;824;402;1491
314270;201709;2918;8916;2413;8022;155;632;1774;5782;1929;6414
314280;201709;2846;7457;1961;5827;379;1254;774;2148;1153;3402
314290;201709;4399;11974;3774;10943;543;1642;2381;6810;2924;8452
314300;201709;1447;4633;1171;4014;327;1177;330;1100;657;2277
314310;201709;5128;14430;4061;12533;1236;4065;1096;3160;2332;7225
314315;201709;774;2975;698;2815;54;274;527;2091;581;2365
314320;201709;2698;7569;1873;6224;474;1701;726;2442;1200;4143
314330;201709;46919;137923;38549;124014;11763;39934;9499;30839;21262;70773
314340;201709;2470;6491;1353;4362;271;1009;165;396;436;1405
314345;201709;1225;3989;1100;3763;147;528;728;2442;875;2970
314350;201709;1076;2988;752;2424;192;667;176;537;368;1204
314360;201709;666;2073;417;1496;82;341;87;305;169;646
314370;201709;564;1698;498;1599;66;235;347;1091;413;1326
314380;201709;1146;3386;812;2716;221;817;120;413;341;1230
314390;201709;11183;31268;7903;25239;1862;6393;1921;5639;3783;12032
314400;201709;4078;12159;3427;11159;1040;3531;1187;3988;2227;7519
314410;201709;2595;7590;1894;6252;401;1467;622;2197;1023;3664
314420;201709;706;1933;555;1709;25;131;422;1250;447;1381
314430;201709;5777;16530;4785;14757;1086;3526;1695;5250;2781;8776
314435;201709;1354;4119;1204;3887;67;297;892;2834;959;3131
314437;201709;924;2497;748;2242;26;88;525;1605;551;1693
314440;201709;506;1515;415;1367;127;466;132;382;259;848
314450;201709;1385;4003;1173;3660;179;696;650;1879;829;2575
314460;201709;3494;11470;2698;9671;646;2498;456;1592;1102;4090
314465;201709;2186;6629;1991;6267;75;333;1583;4867;1658;5200
314467;201709;895;2544;765;2323;27;87;585;1766;612;1853
314470;201709;2098;6432;1779;5793;394;1407;700;2114;1094;3521
314480;201709;5175;16798;3814;13383;720;2774;682;2164;1402;4938
314490;201709;822;2383;628;1985;96;336;352;1060;448;1396
314500;201709;1659;4586;1210;3817;223;748;407;1275;630;2023
314505;201709;1829;4955;1622;4689;130;420;1168;3371;1298;3791
314510;201709;1830;4851;1218;3999;287;1015;411;1372;698;2387
314520;201709;3134;10473;2165;8206;428;1864;205;692;633;2556
314530;201709;5374;18515;5013;17838;679;2446;3303;12014;3982;14460
314535;201709;2568;6991;2147;6394;148;487;1641;4861;1789;5348
314537;201709;1016;3083;822;2740;86;343;553;1800;639;2143
314540;201709;341;1001;266;846;45;162;107;324;152;486
314545;201709;1499;4307;1348;4095;69;208;1106;3535;1175;3743
314550;201709;636;1643;451;1384;61;232;192;533;253;765
314560;201709;3847;12714;3161;11177;548;2188;1070;3522;1618;5710
314570;201709;283;823;217;695;27;105;114;351;141;456
314580;201709;472;1559;365;1318;86;341;50;178;136;519
314585;201709;712;2267;525;1852;105;444;203;666;308;1110
314587;201709;1835;5438;1486;4842;249;768;796;2645;1045;3413
314590;201709;2537;8407;2001;7149;414;1612;574;1972;988;3584
314600;201709;1654;5148;1100;3975;256;1031;111;342;367;1373
314610;201709;6557;20972;5647;19083;1173;4517;2375;7640;3548;12157
314620;201709;1648;4583;1430;4283;69;229;1169;3455;1238;3684
314625;201709;1424;4586;1291;4381;127;599;964;3120;1091;3719
314630;201709;4533;13195;3945;12259;197;828;3114;9563;3311;10391
314640;201709;556;1495;420;1249;101;334;155;403;256;737
314650;201709;955;2582;675;2122;91;349;268;739;359;1088
314655;201709;1531;4438;1106;3599;235;746;441;1436;676;2182
314660;201709;303;777;203;583;16;38;101;281;117;319
314670;201709;1544;3996;1083;3203;106;348;667;1910;773;2258
314675;201709;1737;5006;1519;4630;137;487;1122;3372;1259;3859
314690;201709;1930;6152;1567;5464;501;1916;270;919;771;2835
314700;201709;8795;27866;6052;21854;1526;6084;1018;3617;2544;9701
314710;201709;7549;22439;5485;18022;1111;4037;1014;3018;2125;7055
314720;201709;2144;6899;1672;5871;386;1485;419;1461;805;2946
314730;201709;2024;5944;1570;5133;402;1442;477;1437;879;2879
314740;201709;2582;7833;2150;7030;257;1034;1146;3572;1403;4606
314750;201709;319;965;250;826;31;119;132;420;163;539
314760;201709;1761;5646;1285;4500;179;719;294;858;473;1577
314770;201709;1012;3091;576;1948;50;193;132;367;182;560
314780;201709;297;779;223;670;51;183;103;291;154;474
314790;201709;9810;29210;7502;24909;2799;10338;747;2126;3546;12464
314795;201709;1403;4034;1232;3753;69;288;950;2783;1019;3071
314800;201709;10827;29657;6799;21725;1617;5595;839;2456;2456;8051
314810;201709;9091;25720;6905;21924;2094;7045;1560;5018;3654;12063
314820;201709;827;2258;613;1891;119;419;298;873;417;1292
314830;201709;1458;4769;1289;4461;283;1095;653;2240;936;3335
314840;201709;866;2935;703;2690;88;438;454;1674;542;2112
314850;201709;1846;5092;1477;4464;129;477;1111;3272;1240;3749
314860;201709;3071;9932;2682;9178;419;1651;1588;5307;2007;6958
314870;201709;5460;15960;4644;14837;421;1522;3470;11128;3891;12650
314875;201709;1676;5325;1561;5168;110;328;1329;4456;1439;4784
314880;201709;874;2243;704;2011;47;109;495;1500;542;1609
314890;201709;459;1367;338;1096;56;207;134;382;190;589
314900;201709;620;1717;497;1516;101;339;188;570;289;909
314910;201709;1628;5104;1306;4577;333;1334;537;1808;870;3142
314915;201709;2287;7161;1979;6601;150;626;1354;4373;1504;4999
314920;201709;413;1161;332;1046;24;84;191;580;215;664
314930;201709;4377;14301;3755;12929;868;3219;1202;3935;2070;7154
314940;201709;382;1092;339;1011;48;148;205;585;253;733
314950;201709;350;978;247;820;37;137;88;283;125;420
314960;201709;678;1955;531;1664;86;309;262;763;348;1072
314970;201709;585;1950;517;1823;112;449;181;626;293;1075
314980;201709;1189;3568;963;3214;286;1065;81;254;367;1319
314990;201709;2168;6633;1571;5258;388;1490;343;998;731;2488
314995;201709;1478;4484;1274;4151;115;487;782;2443;897;2930
315000;201709;1027;2877;816;2534;69;261;527;1597;596;1858
315010;201709;392;1207;305;1025;64;269;113;331;177;600
315015;201709;2008;6078;1840;5863;218;723;1243;4144;1461;4867
315020;201709;778;2363;565;1926;86;322;263;867;349;1189
315030;201709;555;1641;416;1373;109;380;88;259;197;639
315040;201709;842;2509;777;2390;139;457;470;1426;609;1883
315050;201709;1165;3256;914;2883;113;405;473;1471;586;1876
315053;201709;1023;3013;855;2680;107;426;474;1446;581;1872
315057;201709;1564;5252;1391;4889;220;785;786;2767;1006;3552
315060;201709;596;1914;414;1524;97;378;67;248;164;626
315070;201709;637;1875;488;1586;136;467;157;490;293;957
315080;201709;2712;8610;2207;7489;501;1736;954;3236;1455;4972
315090;201709;749;2509;595;2167;128;491;162;568;290;1059
315100;201709;1063;3506;749;2731;167;698;240;814;407;1512
315110;201709;1228;3481;991;3078;153;528;449;1396;602;1924
315120;201709;11768;28247;8499;23871;1087;3151;4349;12837;5436;15988
315130;201709;1207;3807;1050;3509;230;906;370;1144;600;2050
315140;201709;2647;7983;2142;6999;442;1626;926;2758;1368;4384
315150;201709;4038;10626;2978;8914;462;1508;1236;3663;1698;5171
315160;201709;1283;3577;944;3000;200;673;397;1242;597;1915
315170;201709;1399;4437;1077;3714;237;870;188;638;425;1508
315180;201709;15872;43196;8794;28452;1518;5558;1664;4886;3182;10444
315190;201709;1885;4779;1570;4299;379;1039;960;2616;1339;3655
315200;201709;3443;11168;2783;9824;884;3408;555;1921;1439;5329
315210;201709;7188;20484;5678;17315;846;2840;2321;6581;3167;9421
315213;201709;1065;3120;953;2948;33;99;783;2418;816;2517
315217;201709;2385;7899;1949;7084;166;775;1237;4366;1403;5141
315220;201709;8695;24846;7245;22298;2290;7291;2123;6628;4413;13919
315230;201709;2834;7458;2540;7111;94;150;2282;6703;2376;6853
315240;201709;2744;8405;2336;7756;604;2140;1117;3631;1721;5771
315250;201709;9088;26940;7170;23332;1468;5249;2701;8617;4169;13866
315260;201709;861;2667;545;1921;107;392;55;169;162;561
315270;201709;686;2150;506;1793;87;369;135;430;222;799
315280;201709;2671;7308;1610;5085;350;1174;253;775;603;1949
315290;201709;1151;3100;753;2443;248;864;176;591;424;1455
315300;201709;552;1501;402;1309;213;724;110;372;323;1096
315310;201709;1250;3808;982;3290;90;341;574;1838;664;2179
315320;201709;641;1899;493;1661;60;291;232;719;292;1010
315330;201709;682;2441;413;1687;90;403;98;370;188;773
315340;201709;3044;8418;2390;7432;352;1195;1228;3740;1580;4935
315350;201709;1699;4679;1315;4093;91;313;864;2742;955;3055
315360;201709;1579;5056;1216;4258;228;862;416;1391;644;2253
315370;201709;438;1349;375;1219;75;243;164;525;239;768
315380;201709;200;641;148;518;38;149;32;97;70;246
315390;201709;1069;3385;813;2828;169;641;217;710;386;1351
315400;201709;4034;11873;3273;10448;495;1675;1638;5144;2133;6819
315410;201709;2153;5269;1706;4667;383;1109;759;2037;1142;3146
315415;201709;1047;3211;877;2946;300;1103;286;972;586;2075
315420;201709;1097;3443;825;2889;187;676;126;398;313;1074
315430;201709;3407;9021;2533;7589;714;2407;729;2065;1443;4472
315440;201709;908;2669;782;2453;128;503;390;1092;518;1595
315445;201709;1928;5148;1490;4463;199;630;947;2839;1146;3469
315450;201709;2223;6762;1964;6343;283;913;1233;4062;1516;4975
315460;201709;27713;88177;24835;82443;8381;29568;6139;19691;14520;49259
315470;201709;453;1312;362;1159;28;110;190;592;218;702
315480;201709;1427;4212;1011;3357;230;823;225;754;455;1577
315490;201709;2887;7413;2066;6266;360;1217;676;1933;1036;3150
315500;201709;478;1365;300;960;34;130;130;360;164;490
315510;201709;1248;3563;1080;3291;57;222;883;2648;940;2870
315520;201709;1069;3103;850;2750;64;262;559;1740;623;2002
315530;201709;602;1973;474;1639;171;650;152;480;323;1130
315540;201709;1017;3030;792;2620;133;510;293;959;426;1469
315550;201709;1643;4547;1237;3940;265;969;450;1387;715;2356
315560;201709;5769;19114;5248;18314;427;1711;3667;12778;4094;14489
315570;201709;1772;5542;1598;5188;173;652;854;2707;1027;3359
315580;201709;2118;5788;1669;5011;408;1379;518;1511;926;2890
315590;201709;863;2425;722;2203;99;341;367;1099;466;1440
315600;201709;2322;8034;1810;6986;268;1050;1006;4023;1274;5073
315610;201709;903;2450;721;2101;124;464;308;746;432;1210
315620;201709;287;1013;272;982;59;208;155;595;214;803
315630;201709;797;2424;646;2123;159;519;152;468;311;987
315640;201709;364;1051;313;967;48;175;149;432;197;607
315645;201709;767;2184;591;1850;189;633;162;481;351;1114
315650;201709;1746;4654;1374;4118;79;311;1031;3039;1110;3350
315660;201709;2462;6243;1951;5412;137;373;1359;3729;1496;4102
315670;201709;10262;32312;9038;29894;2060;7350;3915;12539;5975;19889
315680;201709;2802;9068;2171;7829;610;2379;704;2508;1314;4887
315690;201709;2766;7620;1854;5979;454;1549;417;1462;871;3011
315700;201709;6943;20842;5738;18435;989;3410;2687;8371;3676;11781
315710;201709;1797;4876;1337;4142;92;384;822;2419;914;2803
315720;201709;3860;11909;3421;11094;227;1057;2262;7013;2489;8070
315725;201709;1499;4509;1316;4255;180;589;974;3198;1154;3787
315727;201709;570;1660;442;1414;88;317;186;542;274;859
315730;201709;674;2101;623;1987;82;307;311;936;393;1243
315733;201709;954;2765;838;2564;207;729;334;958;541;1687
315737;201709;1149;3438;912;2996;49;211;617;1993;666;2204
315740;201709;919;2744;755;2410;131;489;359;1015;490;1504
315750;201709;1146;3315;1002;3072;57;206;755;2319;812;2525
315760;201709;1050;2710;1004;2651;15;27;947;2508;962;2535
315765;201709;1672;4790;1449;4502;49;160;1287;4045;1336;4205
315770;201709;1154;3647;999;3402;339;1259;301;1007;640;2266
315780;201709;21352;66863;19197;62449;3082;11347;9444;29367;12526;40714
315790;201709;3475;11311;3034;10464;269;935;2021;7154;2290;8089
315800;201709;1202;4668;923;3825;193;857;177;691;370;1548
315810;201709;1245;3265;1080;3020;86;290;818;2198;904;2488
315820;201709;2240;7289;1954;6766;333;1258;1187;4065;1520;5323
315830;201709;1056;3327;850;2932;77;330;366;1187;443;1517
315840;201709;750;1968;487;1457;73;223;157;448;230;671
315850;201709;938;3156;869;3036;204;780;469;1542;673;2322
315860;201709;492;1579;348;1294;81;351;99;332;180;683
315870;201709;431;1244;362;1135;26;94;236;706;262;800
315880;201709;1058;2842;829;2504;94;343;358;1035;452;1378
315890;201709;1415;4692;1252;4372;419;1575;487;1622;906;3197
315895;201709;5341;15831;4408;13910;711;2493;1914;5647;2625;8140
315900;201709;789;2144;712;2033;66;243;556;1499;622;1742
315910;201709;466;1503;420;1431;80;281;264;882;344;1163
315920;201709;1573;4258;813;2622;172;588;167;473;339;1061
315930;201709;987;2533;716;2074;164;487;262;755;426;1242
315935;201709;792;2603;701;2419;161;631;207;708;368;1339
315940;201709;591;1843;504;1674;90;326;244;805;334;1131
315950;201709;1139;3351;992;3092;174;539;658;2072;832;2611
315960;201709;3338;10149;2194;7929;744;3134;94;216;838;3350
315970;201709;644;1866;503;1670;58;178;352;1207;410;1385
315980;201709;3438;8132;2093;5993;488;1529;659;1723;1147;3252
315990;201709;3571;9775;2868;8558;386;1306;1568;4600;1954;5906
316000;201709;505;1496;419;1368;92;353;166;511;258;864
316010;201709;647;2038;519;1789;52;225;270;853;322;1078
316020;201709;951;3029;829;2794;93;414;548;1736;641;2150
316030;201709;2970;8557;2199;7167;185;681;1389;4589;1574;5270
316040;201709;2740;8591;2051;7198;334;1326;446;1449;780;2775
316045;201709;1821;5539;1723;5370;153;459;1356;4305;1509;4764
316050;201709;355;1104;278;968;44;185;146;485;190;670
316060;201709;684;1958;529;1710;66;304;309;919;375;1223
316070;201709;5422;16312;4658;14729;891;3130;2059;6275;2950;9405
316080;201709;683;2349;576;2101;157;629;65;231;222;860
316090;201709;479;1479;345;1191;58;237;122;397;180;634
316095;201709;1363;4294;1177;3959;202;715;632;2114;834;2829
316100;201709;2499;7974;1868;6498;403;1554;500;1623;903;3177
316105;201709;836;2354;636;2017;127;422;318;1021;445;1443
316110;201709;11338;37073;10155;35025;1415;5091;6560;22974;7975;28065
316120;201709;1038;3237;778;2613;188;672;192;554;380;1226
316130;201709;1386;3180;835;2345;123;401;362;970;485;1371
316140;201709;1026;2803;732;2353;95;309;430;1405;525;1714
316150;201709;1388;3643;1186;3306;167;516;644;1709;811;2225
316160;201709;1049;3079;851;2711;107;381;476;1443;583;1824
316165;201709;885;2266;709;2014;127;422;398;1116;525;1538
316170;201709;1128;3113;829;2637;123;434;397;1204;520;1638
316180;201709;1334;4058;925;3171;200;764;144;412;344;1176
316190;201709;2725;8194;1543;5239;291;993;393;1187;684;2180
316200;201709;3345;10375;2556;8849;584;2323;623;2051;1207;4374
316210;201709;3930;12235;3068;10436;1062;3858;340;1172;1402;5030
316220;201709;690;2103;483;1668;97;371;57;217;154;588
316225;201709;1235;3229;1007;2855;108;370;669;1808;777;2178
316230;201709;394;1114;329;1008;44;139;152;497;196;636
316240;201709;6033;18207;5392;17285;625;2031;3919;12625;4544;14656
316245;201709;3036;10462;2766;10028;212;1105;2137;7515;2349;8620
316250;201709;8881;24622;6793;20782;1874;6258;1484;4327;3358;10585
316255;201709;2529;7464;2223;7037;359;1247;1451;4614;1810;5861
316257;201709;1191;3167;896;2656;124;403;398;1141;522;1544
316260;201709;1814;4929;1403;4311;67;247;782;2491;849;2738
316265;201709;1255;3479;929;2889;64;209;594;1835;658;2044
316270;201709;3305;11033;3011;10353;696;2549;1239;4081;1935;6630
316280;201709;2958;9343;2682;8801;388;1440;1480;4664;1868;6104
316290;201709;3035;9246;2521;8232;466;1721;897;2926;1363;4647
316292;201709;3705;10994;3230;10208;347;1268;2303;7108;2650;8376
316294;201709;718;2233;549;1929;117;466;89;319;206;785
316295;201709;1926;5955;1753;5636;122;523;1339;4152;1461;4675
316300;201709;970;3060;812;2768;55;207;525;1811;580;2018
316310;201709;668;1865;458;1484;95;340;175;550;270;890
316320;201709;543;1643;438;1458;73;276;148;468;221;744
316330;201709;1023;3018;780;2488;67;248;519;1607;586;1855
316340;201709;1034;3093;781;2581;107;436;381;1179;488;1615
316350;201709;1224;3816;1086;3581;137;492;690;2257;827;2749
316360;201709;691;1836;552;1622;60;200;392;1121;452;1321
316370;201709;4183;12623;3488;11263;964;3553;796;2243;1760;5796
316380;201709;1521;3946;1210;3523;48;156;922;2651;970;2807
316390;201709;805;2269;667;2046;152;520;282;855;434;1375
316400;201709;1210;3674;901;3089;155;561;354;1163;509;1724
316410;201709;958;3070;867;2931;91;320;684;2302;775;2622
316420;201709;1760;5455;1566;5199;121;474;1196;3898;1317;4372
316430;201709;815;2430;554;1868;131;474;132;425;263;899
316440;201709;619;2016;493;1815;140;598;87;330;227;928
316443;201709;577;1705;452;1472;105;383;133;417;238;800
316447;201709;1577;4524;1412;4286;69;248;1177;3552;1246;3800
316450;201709;2091;6827;1732;6091;177;691;1181;4100;1358;4791
316460;201709;772;2318;704;2189;235;758;314;948;549;1706
316470;201709;6330;19394;4988;16712;1133;4294;1453;4641;2586;8935
316480;201709;189;608;160;544;40;150;52;158;92;308
316490;201709;312;905;236;748;37;117;96;279;133;396
316500;201709;1166;3996;786;2938;161;665;77;259;238;924
316510;201709;635;2362;588;2268;168;709;194;737;362;1446
316520;201709;964;2785;792;2493;138;499;336;990;474;1489
316530;201709;852;2635;671;2289;123;530;287;870;410;1400
316540;201709;720;2269;636;2114;108;424;213;657;321;1081
316550;201709;1159;3762;1080;3616;150;551;716;2387;866;2938
316553;201709;2486;8142;1788;6380;537;2040;288;978;825;3018
316555;201709;2732;8994;2432;8591;164;634;1870;6727;2034;7361
316556;201709;625;1557;467;1300;39;132;273;683;312;815
316557;201709;823;2877;744;2724;326;1266;214;740;540;2006
316560;201709;251;897;210;811;62;284;42;149;104;433
316570;201709;1134;3608;990;3322;320;1102;285;977;605;2079
316580;201709;352;905;226;663;61;194;68;185;129;379
316590;201709;1337;3639;976;3002;170;584;536;1527;706;2111
316600;201709;977;3150;878;2960;169;632;430;1424;599;2056
316610;201709;558;1959;489;1822;66;345;303;1063;369;1408
316620;201709;2090;6123;1796;5656;131;499;1274;3999;1405;4498
316630;201709;1465;4568;1175;3996;373;1260;409;1552;782;2812
316640;201709;140;414;117;372;25;100;60;157;85;257
316650;201709;954;3266;786;3012;67;278;527;2074;594;2352
316660;201709;164;422;74;237;7;30;12;29;19;59
316670;201709;1932;5211;1524;4514;464;1457;480;1387;944;2844
316680;201709;1834;4850;1454;4275;152;494;1035;2970;1187;3464
316690;201709;1047;3471;914;3196;244;973;297;1007;541;1980
316695;201709;999;3038;879;2820;65;257;588;1852;653;2109
316700;201709;360;1000;314;938;21;98;220;601;241;699
316710;201709;2547;9326;2147;8406;701;2831;643;2695;1344;5526
316720;201709;15762;49569;13074;43741;3017;10767;4436;14311;7453;25078
316730;201709;317;976;278;882;79;280;102;291;181;571
316740;201709;614;1988;575;1920;62;282;403;1312;465;1594
316750;201709;396;1291;317;1123;54;220;110;371;164;591
316760;201709;3408;11116;2888;10283;1298;4887;896;3233;2194;8120
316770;201709;1406;3689;1189;3391;40;148;1004;2881;1044;3029
316780;201709;559;1823;472;1639;145;561;46;122;191;683
316790;201709;680;1953;529;1683;153;525;160;505;313;1030
316800;201709;5091;15898;4301;14358;641;2387;2370;7559;3011;9946
316805;201709;786;1957;746;1904;23;38;670;1792;693;1830
316810;201709;527;1547;405;1310;104;374;160;477;264;851
316820;201709;337;857;183;581;28;97;26;91;54;188
316830;201709;567;1833;508;1717;106;408;275;903;381;1311
316840;201709;2606;7724;2265;7109;463;1629;1054;3178;1517;4807
316850;201709;1928;5404;1537;4755;206;743;842;2536;1048;3279
316860;201709;16628;50697;14113;46156;3015;11152;5685;18038;8700;29190
316870;201709;5868;18240;4661;15605;1180;4238;1209;3898;2389;8136
316880;201709;803;2342;700;2173;157;563;281;838;438;1401
316890;201709;1170;2718;801;2220;162;551;467;1168;629;1719
316900;201709;2308;6642;1824;5629;436;1485;571;1569;1007;3054
316905;201709;455;1469;385;1316;108;392;151;509;259;901
316910;201709;855;2515;585;2003;154;608;70;221;224;829
316920;201709;1574;4142;1099;3430;237;832;434;1338;671;2170
316930;201709;7513;24517;5772;20898;1198;4721;1057;3703;2255;8424
316935;201709;3880;11424;2845;9355;701;2460;747;2435;1448;4895
316940;201709;6525;20574;5115;17485;1123;4158;1328;4250;2451;8408
316950;201709;1609;4164;1311;3755;83;280;1008;2835;1091;3115
316960;201709;4429;11069;3457;9707;556;1699;2046;5707;2602;7406
316970;201709;2986;9384;2805;9029;568;2044;1206;3606;1774;5650
316980;201709;772;2340;552;1899;162;599;73;255;235;854
316990;201709;9351;28488;7367;24098;2117;7372;713;2202;2830;9574
317000;201709;2582;8580;2472;8433;168;547;1971;7173;2139;7720
317005;201709;2386;7179;2048;6602;408;1363;1034;3298;1442;4661
317010;201709;22899;56531;13936;42662;3520;11927;2662;8866;6182;20793
317020;201709;59371;155002;35257;108626;7045;23720;7212;20406;14257;44126
317030;201709;653;1911;565;1779;38;165;388;1185;426;1350
317040;201709;9475;26301;7245;22365;1842;5978;2686;8353;4528;14331
317043;201709;732;1892;599;1703;123;384;309;855;432;1239
317047;201709;1121;2900;846;2463;57;183;577;1668;634;1851
317050;201709;1269;4157;944;3410;171;667;304;1021;475;1688
317052;201709;2139;6821;1961;6521;209;773;1376;4496;1585;5269
317057;201709;1583;4216;1201;3548;80;305;820;2330;900;2635
317060;201709;399;1104;238;761;48;184;69;189;117;373
317065;201709;1208;3550;1054;3279;49;221;827;2479;876;2700
317070;201709;7699;23482;5342;18267;1212;4648;726;2358;1938;7006
317075;201709;946;2800;717;2304;143;474;144;434;287;908
317080;201709;5782;14965;4727;13226;1585;4630;1269;3341;2854;7971
317090;201709;4450;14335;4116;13826;361;1280;3052;10289;3413;11569
317100;201709;2557;6581;1819;5375;622;1952;535;1565;1157;3517
317103;201709;1748;5957;1563;5610;186;896;940;3179;1126;4075
317107;201709;1325;3887;1119;3495;73;275;741;2161;814;2436
317110;201709;588;1443;343;1060;57;223;123;389;180;612
317115;201709;1085;3276;913;2912;76;242;642;2045;718;2287
317120;201709;10214;32195;8299;28314;1537;5825;3861;12742;5398;18567
317130;201709;7072;19753;5474;16937;1226;4172;1869;5688;3095;9860
317140;201709;554;1725;492;1611;72;235;285;927;357;1162
317150;201709;932;2484;787;2311;50;156;624;1813;674;1969
317160;201709;3339;8569;2474;7348;253;788;1625;4829;1878;5617
317170;201709;1890;4979;1391;4134;218;740;489;1280;707;2020
317180;201709;1552;5216;1276;4591;315;1205;316;1102;631;2307
317190;201709;1305;3681;1011;3224;66;241;661;2076;727;2317
317200;201709;4203;12433;3332;10697;831;2924;869;2639;1700;5563
317210;201709;881;2511;750;2327;68;287;537;1635;605;1922
317220;201709;257;876;237;832;59;229;103;357;162;586
320010;201709;4526;13970;3830;12616;548;1941;2226;7170;2774;9111
320013;201709;1786;5407;1239;4162;219;747;507;1750;726;2497
320016;201709;2823;7764;2406;7172;156;456;1889;5626;2045;6082
320020;201709;3394;10363;2777;9173;764;2645;848;2875;1612;5520
320030;201709;1464;4542;1042;3635;300;1108;308;1011;608;2119
320035;201709;1642;4818;1411;4433;471;1634;561;1668;1032;3302
320040;201709;2962;9332;2489;8431;498;1820;1086;3659;1584;5479
320050;201709;1589;4171;1400;3845;343;971;680;1842;1023;2813
320060;201709;9186;28254;6872;23270;1673;6152;1516;4951;3189;11103
320070;201709;1339;4109;1049;3499;239;868;313;1006;552;1874
320080;201709;5240;14673;3934;12147;837;2684;1398;4368;2235;7052
320090;201709;6796;19367;5293;16432;1355;4377;2036;6221;3391;10598
320100;201709;2283;7129;1861;6286;558;1893;586;2020;1144;3913
320110;201709;1137;3235;957;2917;246;767;262;819;508;1586
320115;201709;1752;6064;1554;5697;757;2842;425;1614;1182;4456
320120;201709;13340;38617;10260;32900;2414;8451;2932;9223;5346;17674
320130;201709;30748;95903;27512;89883;5020;18368;14268;45430;19288;63798
320140;201709;3016;9346;2199;7556;552;2090;503;1731;1055;3821
320150;201709;12260;34449;9293;28653;2928;9633;1096;3092;4024;12725
320160;201709;4680;14349;3892;12785;881;3146;1662;5327;2543;8473
320170;201709;1558;4815;1226;4115;267;940;532;1748;799;2688
320180;201709;675;2285;566;2066;201;755;132;509;333;1264
320190;201709;3103;10501;2424;8876;635;2434;415;1472;1050;3906
320200;201709;922;2757;722;2399;235;864;173;594;408;1458
320210;201709;4337;11970;3578;10555;661;2168;1758;4933;2419;7101
320220;201709;2219;6572;1809;5863;355;1246;956;3110;1311;4356
320225;201709;1193;3989;894;3243;330;1242;127;470;457;1712
320230;201709;3970;12419;3275;11179;908;3356;1254;4308;2162;7664
320240;201709;12037;34222;9721;30323;2269;7598;3657;11513;5926;19111
320245;201709;2758;9175;2490;8557;953;3422;600;2026;1553;5448
320250;201709;1753;5249;1253;4105;329;1211;228;670;557;1881
320255;201709;1578;5388;1401;5074;540;2016;550;2081;1090;4097
320260;201709;948;2840;710;2298;222;793;191;528;413;1321
320265;201709;2327;7451;2003;6835;842;2984;598;2023;1440;5007
320270;201709;2449;7089;1811;5907;347;1198;876;2936;1223;4134
320280;201709;5343;16232;4570;14735;1243;4326;1208;3739;2451;8065
320290;201709;1311;4151;921;3197;282;1081;150;489;432;1570
320300;201709;3756;12447;3224;11234;1077;3962;650;2272;1727;6234
320305;201709;4315;13365;3600;11803;912;3133;1307;4221;2219;7354
320310;201709;1741;5197;1406;4509;331;1107;544;1742;875;2849
320313;201709;1908;5290;1308;4068;304;1067;268;786;572;1853
320316;201709;1490;4425;1184;3802;351;1183;408;1303;759;2486
320320;201709;17467;51179;13444;43842;3642;12779;4369;14052;8011;26831
320330;201709;2708;7960;2204;7050;659;2078;879;2998;1538;5076
320332;201709;4960;15469;4263;14199;1105;3922;1970;6491;3075;10413
320334;201709;1894;5890;1335;4667;316;1244;321;1056;637;2300
320335;201709;1909;5680;1241;4108;349;1262;201;616;550;1878
320340;201709;4757;12830;4136;11867;855;2609;2045;6022;2900;8631
320350;201709;4705;12338;3498;10142;607;1820;1561;4487;2168;6307
320360;201709;1502;3985;1138;3302;193;546;473;1355;666;1901
320370;201709;2488;8166;1993;7019;570;2059;620;2170;1190;4229
320380;201709;1997;5881;1748;5431;399;1321;862;2608;1261;3929
320390;201709;6494;19008;5179;16217;1368;4519;1699;5174;3067;9693
320400;201709;3192;9671;2750;8850;617;2101;1246;3991;1863;6092
320405;201709;4060;11718;3507;10698;596;1949;2007;5997;2603;7946
320410;201709;4757;13184;3639;11504;749;2504;1618;5275;2367;7779
320420;201709;2387;7008;1932;6212;571;2027;454;1442;1025;3469
320425;201709;1914;4862;1496;4168;141;451;934;2514;1075;2965
320430;201709;2485;6794;2069;5941;379;1146;1150;3149;1529;4295
320435;201709;2453;7895;1982;6940;791;2887;501;1835;1292;4722
320440;201709;910;2917;783;2605;168;633;324;1032;492;1665
320450;201709;1650;5075;1336;4460;347;1267;575;1846;922;3113
320455;201709;3615;11669;2688;9500;760;2838;671;2317;1431;5155
320460;201709;2252;7105;1626;5656;414;1541;305;959;719;2500
320465;201709;1306;3914;992;3259;134;482;510;1689;644;2171
320470;201709;3786;11050;2692;8700;740;2562;570;1794;1310;4356
320480;201709;1611;4929;1385;4468;310;1087;624;1971;934;3058
320490;201709;13733;41163;11705;37532;2824;9905;4441;14248;7265;24153
320495;201709;1297;3728;845;2797;229;797;170;594;399;1391
320500;201709;41973;122262;36150;112190;7223;24127;18293;55556;25516;79683
320501;201709;4280;13015;3252;11230;968;3744;861;2865;1829;6609
320503;201709;1921;6331;1526;5479;532;2106;427;1401;959;3507
320506;201709;3283;9939;2283;7636;674;2414;91;246;765;2660
320510;201709;7712;23251;6726;21537;1280;4516;3477;10934;4757;15450
320515;201709;1717;4928;1383;4210;423;1344;335;1019;758;2363
320517;201709;1920;6157;1522;5341;550;2069;300;1022;850;3091
320520;201709;30040;88106;24640;78798;5553;19507;9393;29800;14946;49307
320530;201709;23784;69764;19679;62329;3161;11818;10632;31725;13793;43543
330010;201709;18334;55167;16149;51271;3432;11395;8640;27583;12072;38978
330015;201709;1327;3652;1138;3308;189;627;545;1527;734;2154
330020;201709;17145;48056;15547;45486;2601;8449;9974;28423;12575;36872
330022;201709;1756;5048;1439;4540;288;971;831;2605;1119;3576
330023;201709;2930;8762;2456;7981;654;2298;814;2548;1468;4846
330025;201709;4373;11752;3254;9719;1010;3250;1030;3053;2040;6303
330030;201709;7990;25366;6883;23286;1217;4584;3539;11454;4756;16038
330040;201709;10760;31671;9656;29612;1703;5703;5667;16812;7370;22515
330045;201709;71457;188864;61978;175570;7648;22201;43487;122183;51135;144384
330050;201709;2161;6342;1794;5698;461;1553;736;2221;1197;3774
330060;201709;4996;14149;4275;13025;1033;3437;1877;5511;2910;8948
330070;201709;17708;52068;15755;48873;3240;10696;7934;24762;11174;35458
330080;201709;7660;21309;7012;20290;564;1696;5091;14602;5655;16298
330090;201709;2363;6154;2070;5714;307;928;1214;3273;1521;4201
330093;201709;1742;5021;1443;4551;213;687;859;2830;1072;3517
330095;201709;959;3150;818;2843;133;516;357;1163;490;1679
330100;201709;58411;171616;51082;160396;5892;21369;33282;103206;39174;124575
330110;201709;2050;6398;1827;6015;399;1392;698;2249;1097;3641
330115;201709;1615;4632;1411;4323;281;978;784;2323;1065;3301
330120;201709;2659;6889;2273;6358;277;911;1562;4274;1839;5185
330130;201709;3078;9677;2752;9125;600;2113;1404;4641;2004;6754
330140;201709;2886;8694;2619;8298;514;1869;1515;4660;2029;6529
330150;201709;1842;5432;1518;4837;378;1255;470;1498;848;2753
330160;201709;1037;3181;912;2977;217;793;460;1443;677;2236
330170;201709;85091;250883;77220;238401;14475;47028;44211;135660;58686;182688
330180;201709;1928;5500;1639;4994;80;332;1178;3486;1258;3818
330185;201709;7785;23072;6733;21159;1084;3745;4052;12432;5136;16177
330187;201709;3452;9715;2949;8916;500;1671;1795;5341;2295;7012
330190;201709;23727;65220;21990;62631;2943;8659;16318;46416;19261;55075
330200;201709;12226;37474;10991;35459;2589;8480;5869;19345;8458;27825
330205;201709;1843;5042;1611;4659;137;463;1109;3129;1246;3592
330210;201709;3017;8266;2362;6991;556;1709;854;2444;1410;4153
330220;201709;8828;26072;7465;23309;1871;6294;2022;5833;3893;12127
330225;201709;3277;9910;2789;9041;306;1263;1778;5509;2084;6772
330227;201709;14887;41894;13372;39724;2073;6374;8978;26909;11051;33283
330230;201709;1161;3320;1018;3105;119;422;660;1962;779;2384
330240;201709;16147;47561;13693;43253;3744;12711;5394;16539;9138;29250
330245;201709;1225;3559;897;2968;220;775;198;643;418;1418
330250;201709;30537;89009;27535;84106;7304;22490;11797;37404;19101;59894
330260;201709;4065;12071;3386;10821;611;2103;1592;4886;2203;6989
330270;201709;19705;43099;12938;33906;2770;8024;4917;12925;7687;20949
330280;201709;2118;6114;1749;5437;276;953;884;2623;1160;3576
330285;201709;16048;44814;14224;42051;2148;6929;9062;26253;11210;33182
330290;201709;3031;8667;2654;8038;437;1443;1451;4216;1888;5659
330300;201709;2966;9511;2653;8905;469;1749;1483;4801;1952;6550
330310;201709;2089;5803;1718;5154;169;508;1109;3309;1278;3817
330320;201709;11386;33278;10539;31956;1309;4257;7780;23395;9089;27652
330330;201709;25270;67329;21962;62257;3483;10918;13803;38077;17286;48995
330340;201709;12479;35587;9945;31120;2337;7879;3700;11193;6037;19072
330350;201709;80384;225363;71189;212443;9052;29081;49491;147033;58543;176114
330360;201709;5873;16747;5540;16274;573;1781;4281;12484;4854;14265
330370;201709;3291;11427;2942;10698;940;3519;1001;3666;1941;7185
330380;201709;4436;14047;3716;12607;911;3328;1248;4108;2159;7436
330385;201709;3575;12040;3248;11423;950;3546;1309;4641;2259;8187
330390;201709;19714;63122;16957;57493;4030;14626;7147;23680;11177;38306
330395;201709;2866;8164;2612;7758;199;713;1798;5242;1997;5955
330400;201709;2532;7644;2298;7206;236;922;1558;4556;1794;5478
330410;201709;2580;7718;2015;6665;396;1439;908;2855;1304;4294
330411;201709;2057;6238;1814;5749;192;701;1206;3665;1398;4366
330412;201709;1329;4375;1119;3942;190;734;552;1828;742;2562
330414;201709;21602;59182;18525;54856;3135;9059;11481;34420;14616;43479
330415;201709;3184;9504;2571;8426;531;1738;1106;3748;1637;5486
330420;201709;8896;24416;6049;19384;1168;4017;1661;5101;2829;9118
330430;201709;6564;18947;5812;17594;1154;3848;2962;8663;4116;12511
330440;201709;1409;4591;1266;4326;356;1367;460;1449;816;2816
330450;201709;1267;4061;1087;3736;203;787;538;1804;741;2591
330452;201709;12154;35027;9881;30844;2221;7469;4528;13809;6749;21278
330455;201709;477997;1263099;381164;1109709;72271;225232;206105;590394;278376;815626
330460;201709;1064;3391;916;3124;205;752;410;1358;615;2110
330470;201709;3710;10899;3322;10266;841;2804;1528;4608;2369;7412
330475;201709;7483;22327;6505;20789;1890;6596;2676;8324;4566;14920
330480;201709;5351;15298;4755;14382;727;2401;2972;8765;3699;11166
330490;201709;99728;255313;87545;237412;10017;29068;60107;160632;70124;189700
330500;201709;4654;13810;4388;13391;462;1536;3297;9998;3759;11534
330510;201709;32879;98137;28874;91726;9121;28985;12011;39240;21132;68225
330513;201709;1152;3433;1047;3247;331;1066;441;1365;772;2431
330515;201709;2627;7974;2282;7282;787;2586;669;2147;1456;4733
330520;201709;9845;29398;8751;27417;1754;5922;4143;12660;5897;18582
330530;201709;1423;3995;1187;3568;277;912;530;1517;807;2429
330540;201709;2600;7592;2143;6732;600;1962;744;2277;1344;4239
330550;201709;6987;22974;6187;21445;2550;9218;1228;4370;3778;13588
330555;201709;8948;25887;8016;24500;1495;4736;4869;15114;6364;19850
330560;201709;3928;11667;3470;10805;504;1715;2009;6072;2513;7787
330570;201709;2895;8506;2443;7730;561;1847;1236;3882;1797;5729
330575;201709;4919;13688;4399;12719;519;1727;3107;8647;3626;10374
330580;201709;11511;35330;9504;31353;2602;9021;3614;11830;6216;20851
330590;201709;1446;4300;1348;4159;157;499;996;3101;1153;3600
330600;201709;10500;30639;8486;26966;1426;4860;4104;12988;5530;17848
330610;201709;8024;24649;7216;23255;1075;3901;4290;13475;5365;17376
330615;201709;1495;5151;1381;4978;515;1950;554;2022;1069;3972
330620;201709;3217;10957;2831;10144;1086;4129;586;2045;1672;6174
330630;201709;21589;60842;17528;53706;2327;8318;10597;31152;12924;39470
350010;201709;1645;4678;996;3340;258;884;84;243;342;1127
350020;201709;528;1419;307;982;34;117;146;423;180;540
350030;201709;4047;12294;3076;10331;842;3030;794;2611;1636;5641
350040;201709;457;1514;329;1207;63;268;103;337;166;605
350050;201709;802;2382;634;2041;146;534;185;497;331;1031
350055;201709;615;1761;532;1626;63;210;372;1133;435;1343
350060;201709;100;304;83;277;15;57;38;131;53;188
350070;201709;3698;10550;2343;7752;450;1577;657;1975;1107;3552
350075;201709;568;1847;442;1577;183;665;65;222;248;887
350080;201709;614;1767;386;1261;57;202;160;511;217;713
350090;201709;547;1411;332;981;74;219;110;317;184;536
350100;201709;1774;5281;1248;4254;218;863;480;1517;698;2380
350110;201709;403;1207;300;983;25;102;180;567;205;669
350115;201709;1177;3513;1012;3171;204;679;493;1425;697;2104
350120;201709;792;2216;485;1576;61;204;257;873;318;1077
350130;201709;2977;8579;2528;7720;297;1003;1453;4205;1750;5208
350140;201709;546;1807;447;1601;40;179;257;883;297;1062
350150;201709;457;1470;399;1353;143;504;100;329;243;833
350160;201709;8775;23534;5653;17807;927;3307;2691;7870;3618;11177
350170;201709;1363;4472;1120;3892;265;989;282;934;547;1923
350180;201709;1036;2755;619;1894;110;376;282;837;392;1213
350190;201709;2841;8581;2189;7208;479;1807;875;2447;1354;4254
350200;201709;333;995;300;938;22;71;216;660;238;731
350210;201709;4728;12206;3304;9770;745;2265;1482;4335;2227;6600
350220;201709;2116;6562;1787;5808;363;1352;785;2359;1148;3711
350230;201709;771;2355;677;2183;158;531;300;966;458;1497
350240;201709;555;1701;417;1374;68;245;169;534;237;779
350250;201709;1967;6722;1696;6220;621;2447;442;1653;1063;4100
350260;201709;809;2141;545;1636;98;300;249;730;347;1030
350270;201709;4471;13225;3724;11662;674;2314;1732;5076;2406;7390
350275;201709;1771;5594;1581;5266;389;1378;634;2067;1023;3445
350280;201709;19623;46582;12275;34400;2441;7333;3673;9993;6114;17326
350290;201709;2354;7244;1812;6114;362;1363;623;2005;985;3368
350300;201709;563;1624;404;1280;91;279;124;372;215;651
350310;201709;804;2633;681;2333;96;371;267;862;363;1233
350315;201709;499;1489;354;1188;60;222;116;354;176;576
350320;201709;9650;29112;8280;26665;2381;8129;1682;5615;4063;13744
350330;201709;13048;34780;9049;26186;1521;4391;4246;11692;5767;16083
350335;201709;361;1091;319;1009;17;42;246;794;263;836
350340;201709;950;2699;633;2073;130;466;200;659;330;1125
350350;201709;665;2006;560;1861;119;415;209;675;328;1090
350360;201709;834;2775;713;2489;198;678;278;977;476;1655
350370;201709;521;1494;365;1140;111;348;55;162;166;510
350380;201709;4172;12003;2959;9642;688;2405;964;3006;1652;5411
350390;201709;8835;26283;7493;23742;2197;7126;2670;8290;4867;15416
350395;201709;382;1030;189;634;26;95;58;170;84;265
350400;201709;7192;19897;5473;16811;1417;4707;1720;5045;3137;9752
350410;201709;7836;24959;6189;21548;1628;6210;1509;4901;3137;11111
350420;201709;523;1618;393;1383;83;346;55;185;138;531
350430;201709;627;1919;529;1745;82;330;303;939;385;1269
350440;201709;1227;3759;1006;3239;217;700;427;1349;644;2049
350450;201709;6549;20026;5291;17529;1236;4386;1547;4886;2783;9272
350460;201709;1401;3698;814;2543;162;567;258;768;420;1335
350470;201709;208;535;171;470;13;49;119;306;132;355
350480;201709;714;2053;498;1618;90;328;84;241;174;569
350490;201709;1620;4852;1331;4312;303;1055;422;1262;725;2317
350500;201709;547;1609;474;1477;71;257;267;804;338;1061
350510;201709;1010;2950;755;2423;110;407;368;1133;478;1540
350520;201709;1640;5745;1286;4929;268;1122;402;1480;670;2602
350530;201709;2077;5947;1646;5068;491;1578;440;1290;931;2868
350535;201709;1214;3778;1123;3642;134;529;790;2481;924;3010
350540;201709;1595;4411;1189;3699;277;928;473;1481;750;2409
350550;201709;8698;22374;5927;17806;886;3024;2585;7254;3471;10278
350560;201709;3191;10246;2710;9112;317;1131;1525;5065;1842;6196
350570;201709;17032;53123;14863;48862;4042;14387;6009;18815;10051;33202
350580;201709;1642;5072;995;3436;197;721;108;300;305;1021
350590;201709;3801;11311;2905;9477;712;2641;1188;3486;1900;6127
350600;201709;37153;92365;24459;69195;3764;11690;10898;28461;14662;40151
350610;201709;6119;17968;4739;15284;966;3284;2015;6387;2981;9671
350620;201709;367;1008;268;859;32;134;135;405;167;539
350630;201709;1458;4119;1082;3378;137;507;526;1506;663;2013
350635;201709;6134;17524;4886;15350;1068;3692;2214;6703;3282;10395
350640;201709;766;2308;483;1597;82;300;131;386;213;686
350650;201709;7062;20554;4648;15149;1024;3638;1202;3688;2226;7326
350660;201709;4630;13140;3687;11453;702;2350;1748;5377;2450;7727
350670;201709;1345;4172;1233;3954;280;905;618;1980;898;2885
350680;201709;982;2854;684;2278;148;536;282;945;430;1481
350690;201709;898;2791;686;2344;137;501;263;850;400;1351
350700;201709;3861;11054;2768;9208;605;2243;1138;3541;1743;5784
350710;201709;2504;7618;2169;6972;305;1099;1250;3888;1555;4987
350715;201709;753;2257;665;2068;83;304;374;1073;457;1377
350720;201709;135;380;118;350;23;76;44;130;67;206
350730;201709;361;1285;332;1212;64;258;154;557;218;815
350740;201709;1502;4511;1040;3444;199;698;266;809;465;1507
350745;201709;526;1598;320;1073;48;175;130;388;178;563
350750;201709;8234;24479;6769;21692;1497;5375;2153;6261;3650;11636
350760;201709;11455;32419;9051;28223;2512;8484;2183;6073;4695;14557
350770;201709;609;1713;425;1330;66;214;213;665;279;879
350775;201709;544;1423;422;1218;43;145;211;599;254;744
350780;201709;1745;5119;1354;4396;362;1319;312;1081;674;2400
350790;201709;1685;5043;1183;4015;263;976;213;609;476;1585
350800;201709;2835;9241;2639;8829;483;1770;1344;4353;1827;6123
350810;201709;1799;5001;1568;4675;334;1035;841;2597;1175;3632
350820;201709;626;1672;395;1211;57;179;141;402;198;581
350830;201709;749;2336;482;1696;68;252;135;428;203;680
350840;201709;2362;7851;1860;6815;597;2344;499;1737;1096;4081
350850;201709;5265;16872;4317;14872;1304;4675;1152;4012;2456;8687
350860;201709;3008;8969;2806;8633;107;463;2193;6639;2300;7102
350870;201709;2517;7838;2033;6988;433;1665;1032;3501;1465;5166
350880;201709;1203;3919;960;3324;221;785;243;822;464;1607
350890;201709;634;1752;395;1238;43;139;122;317;165;456
350900;201709;5232;15877;3750;12662;1207;4456;388;1246;1595;5702
350910;201709;770;2175;669;1971;144;495;380;1066;524;1561
350920;201709;10818;29423;9483;27184;678;2267;7177;19746;7855;22013
350925;201709;4244;12834;3293;10963;804;2811;1057;3102;1861;5913
350930;201709;1290;3583;915;2809;134;425;450;1342;584;1767
350940;201709;1718;5410;1511;5011;240;890;871;2792;1111;3682
350945;201709;859;2639;702;2340;113;410;332;1063;445;1473
350950;201709;68779;200049;56321;173164;10052;33922;29350;85332;39402;119254
350960;201709;4344;13770;3662;12369;742;2859;1849;5944;2591;8803
350970;201709;3454;11622;2876;10200;945;3645;438;1362;1383;5007
350980;201709;565;1812;490;1638;197;686;154;506;351;1192
350990;201709;1669;5339;1329;4693;358;1396;406;1320;764;2716
350995;201709;745;2477;698;2376;75;316;436;1407;511;1723
351000;201709;2439;6978;1918;6000;378;1318;688;2008;1066;3326
351010;201709;275;769;163;520;22;72;74;232;96;304
351015;201709;629;2133;537;1962;117;477;225;796;342;1273
351020;201709;7817;23444;6568;21433;1519;5160;3492;11357;5011;16517
351030;201709;2159;7050;1816;6217;359;1393;820;2616;1179;4009
351040;201709;3638;10462;3279;9850;297;1046;2443;7099;2740;8145
351050;201709;14726;39324;10249;31826;2405;8147;3428;10559;5833;18706
351060;201709;36926;101474;29594;88920;4748;15620;17068;49839;21816;65459
351070;201709;1266;3465;812;2633;237;851;79;214;316;1065
351080;201709;2412;6935;1869;6220;442;1625;844;2631;1286;4256
351090;201709;344;1107;248;922;46;189;47;174;93;363
351100;201709;2350;6907;1555;4992;410;1369;301;1021;711;2390
351110;201709;6271;16095;3761;11820;803;2817;1057;3058;1860;5875
351120;201709;627;1798;458;1451;74;240;183;516;257;756
351130;201709;916;2534;452;1565;75;251;88;301;163;552
351140;201709;1561;5095;1235;4392;382;1487;273;850;655;2337
351150;201709;1273;4248;856;3196;189;743;55;172;244;915
351160;201709;1072;3637;923;3294;226;851;309;966;535;1817
351170;201709;1288;4006;1098;3572;128;465;616;1902;744;2367
351190;201709;755;2355;595;1956;92;297;189;597;281;894
351200;201709;1533;4194;1223;3666;96;322;695;1998;791;2320
351210;201709;1217;3263;796;2411;104;381;362;976;466;1357
351220;201709;2722;8701;2453;8166;319;1191;1484;4786;1803;5977
351230;201709;1671;4963;1309;4306;285;1062;600;1825;885;2887
351240;201709;1339;3844;950;3012;222;730;389;1181;611;1911
351250;201709;990;2846;579;1882;95;331;188;591;283;922
351260;201709;858;2501;713;2208;253;770;149;449;402;1219
351270;201709;274;874;239;795;55;209;108;310;163;519
351280;201709;4640;12976;3527;10826;655;2217;1397;4097;2052;6314
351290;201709;892;2496;615;1950;134;439;252;765;386;1204
351300;201709;12278;37662;9178;31271;2203;8093;2892;9918;5095;18011
351310;201709;2602;7655;2068;6674;332;1232;1057;3188;1389;4420
351320;201709;850;2737;684;2327;126;464;239;763;365;1227
351330;201709;557;1937;503;1847;64;173;356;1407;420;1580
351340;201709;5413;17601;4591;15974;1260;4555;1721;5970;2981;10525
351350;201709;7051;20988;6073;19148;1194;3901;3295;10063;4489;13964
351360;201709;3678;11093;3317;10400;848;2892;1040;3017;1888;5909
351370;201709;2088;6365;1577;5223;345;1230;596;1799;941;3029
351380;201709;35815;98930;30376;88944;5837;18008;14800;42297;20637;60305
351385;201709;251;710;165;524;25;80;50;152;75;232
351390;201709;1077;3262;856;2817;219;867;392;1148;611;2015
351400;201709;894;2797;791;2613;211;743;334;1079;545;1822
351410;201709;2177;6553;1820;5859;283;933;985;3122;1268;4055
351420;201709;250;696;165;523;41;118;48;148;89;266
351430;201709;713;2204;658;2103;86;308;475;1488;561;1796
351440;201709;2912;8482;2105;6737;401;1376;354;989;755;2365
351450;201709;1384;3852;1056;3255;249;818;296;946;545;1764
351460;201709;615;1785;534;1630;220;653;188;593;408;1246
351470;201709;953;2736;809;2458;98;361;455;1292;553;1653
351480;201709;2487;7923;2199;7427;310;1279;1200;3886;1510;5165
351490;201709;1645;5274;1457;4874;132;550;955;3031;1087;3581
351492;201709;297;925;253;806;18;67;131;383;149;450
351495;201709;183;585;139;465;23;86;59;187;82;273
351500;201709;29801;80197;22334;67018;5296;16784;9591;27733;14887;44517
351510;201709;9397;26992;7466;23205;1467;4939;3857;11629;5324;16568
351512;201709;464;1321;339;1045;52;159;148;429;200;588
351515;201709;2416;6605;1614;5041;357;1291;383;1143;740;2434
351518;201709;2004;5770;1353;4557;270;1029;588;1816;858;2845
351519;201709;616;1796;428;1381;79;293;89;199;168;492
351520;201709;845;2291;361;1221;52;202;117;346;169;548
351530;201709;323;971;191;624;29;84;57;154;86;238
351535;201709;2097;5360;1616;4579;143;504;1035;2774;1178;3278
351540;201709;1724;4840;1228;3888;421;1440;216;603;637;2043
351550;201709;5023;14524;3519;11112;602;2107;1493;4374;2095;6481
351560;201709;412;1310;354;1177;84;320;79;259;163;579
351565;201709;153;524;136;481;31;110;54;181;85;291
351570;201709;13834;39707;11257;34586;1860;6265;6680;19694;8540;25959
351580;201709;276;756;169;541;32;93;55;190;87;283
351590;201709;475;1164;267;746;32;107;134;352;166;459
351600;201709;1629;4424;1261;3733;169;565;694;1930;863;2495
351610;201709;614;1615;432;1292;45;165;229;596;274;761
351620;201709;17511;53401;13615;45769;2650;10095;4500;13520;7150;23615
351630;201709;22394;65503;19378;60439;3661;12036;11418;34825;15079;46861
351640;201709;13295;38190;10921;34099;1682;5880;6685;20219;8367;26099
351650;201709;375;1097;174;607;33;126;27;82;60;208
351660;201709;740;2305;505;1713;103;390;91;274;194;664
351670;201709;3966;12179;3131;10176;578;2032;1470;4481;2048;6513
351680;201709;451;1416;273;914;58;179;51;184;109;363
351685;201709;417;1318;357;1192;87;281;138;463;225;744
351690;201709;955;2735;671;2134;118;408;252;726;370;1134
351700;201709;910;2644;772;2375;174;521;310;954;484;1475
351710;201709;527;1716;431;1490;62;254;177;570;239;824
351720;201709;1270;3685;900;2920;167;577;324;1027;491;1604
351730;201709;954;2628;716;2229;106;397;345;1007;451;1404
351740;201709;3777;10101;2957;8521;546;1665;1211;3238;1757;4903
351750;201709;1171;3631;727;2622;135;535;238;861;373;1396
351760;201709;3038;9334;2332;7765;590;2143;635;1895;1225;4038
351770;201709;1922;6015;1618;5381;502;1722;575;1875;1077;3597
351780;201709;1280;3511;703;2222;121;429;161;480;282;909
351790;201709;1088;2980;912;2694;141;384;577;1734;718;2118
351800;201709;559;1227;286;736;45;129;97;227;142;356
351810;201709;957;2734;794;2433;72;195;552;1666;624;1861
351820;201709;2332;7205;1652;5736;335;1260;225;777;560;2037
351830;201709;4137;12125;3197;10276;455;1705;1685;5204;2140;6909
351840;201709;6059;20130;5242;18408;1206;4618;2066;6892;3272;11510
351850;201709;1913;5084;1305;4020;217;806;499;1387;716;2193
351860;201709;2682;8477;2301;7688;501;1802;1089;3563;1590;5365
351870;201709;23253;66340;18977;58911;6084;19639;6849;21410;12933;41049
351880;201709;106929;317673;87660;280646;26105;89661;23695;71816;49800;161477
351885;201709;637;2125;575;1983;153;536;239;802;392;1338
351890;201709;542;1679;450;1496;105;366;71;199;176;565
351900;201709;1107;3316;894;2950;225;780;282;934;507;1714
351905;201709;397;1164;299;964;37;127;138;409;175;536
351907;201709;18408;52368;15308;46628;879;3315;11140;33035;12019;36350
351910;201709;1012;2985;796;2491;173;586;326;937;499;1523
351920;201709;861;2305;671;1989;82;289;333;948;415;1237
351925;201709;921;2728;741;2370;115;387;344;1030;459;1417
351930;201709;2585;7952;2466;7733;280;1175;1982;5946;2262;7121
351940;201709;935;2691;739;2343;89;323;407;1279;496;1602
351950;201709;1489;3897;1070;3135;89;296;598;1709;687;2005
351960;201709;4428;12405;3298;10293;750;2540;1334;4028;2084;6568
351970;201709;5216;18063;4641;16915;1078;4319;2033;7014;3111;11333
351980;201709;883;2526;655;2031;116;410;301;852;417;1262
351990;201709;1289;3445;966;2879;163;571;293;799;456;1370
352000;201709;2090;6693;1875;6232;256;966;1051;3315;1307;4281
352010;201709;1685;5356;1427;4805;344;1268;216;765;560;2033
352020;201709;1356;4128;1147;3713;249;886;497;1510;746;2396
352030;201709;4681;13499;3834;12229;745;2640;2080;6553;2825;9193
352040;201709;1844;5593;1326;4494;278;989;203;639;481;1628
352042;201709;3101;8256;1887;5796;368;1199;799;2429;1167;3628
352044;201709;1817;5357;1085;3845;185;724;230;753;415;1477
352050;201709;10845;32013;7367;24314;1762;6547;1286;3783;3048;10330
352060;201709;665;1999;520;1686;90;311;215;661;305;972
352070;201709;738;1711;551;1443;101;290;232;598;333;888
352080;201709;421;1190;261;819;46;166;77;214;123;380
352090;201709;1311;4353;1039;3687;190;735;291;932;481;1667
352100;201709;2845;8508;2312;7508;536;1890;1015;3156;1551;5046
352110;201709;503;1667;416;1479;101;370;143;478;244;848
352115;201709;455;1428;397;1317;72;244;208;701;280;945
352120;201709;814;2575;662;2260;92;381;338;1045;430;1426
352130;201709;1700;5112;1101;3598;248;863;300;946;548;1809
352140;201709;1484;4129;909;2943;145;505;342;1032;487;1537
352150;201709;703;2017;563;1753;141;446;281;870;422;1316
352160;201709;838;2318;636;1971;140;481;235;692;375;1173
352170;201709;2553;7617;2196;6805;452;1509;1058;3023;1510;4532
352180;201709;2808;7886;2346;6972;575;1820;880;2458;1455;4278
352190;201709;1042;3089;831;2673;138;521;280;769;418;1290
352200;201709;358;1181;264;987;40;151;77;283;117;434
352210;201709;14785;39830;12396;36212;1785;5555;8180;23914;9965;29469
352215;201709;509;1484;460;1422;55;192;295;888;350;1080
352220;201709;12734;36875;9449;30736;2930;10150;2230;7243;5160;17393
352230;201709;11265;36993;9348;33137;2655;10306;2910;9679;5565;19985
352240;201709;10789;30534;8317;26021;2110;7467;2830;8015;4940;15482
352250;201709;19043;58724;16102;53244;4696;16197;6580;21535;11276;37732
352260;201709;5172;15176;3638;11972;613;2156;1805;5879;2418;8035
352265;201709;845;2590;733;2403;65;281;491;1537;556;1818
352270;201709;1436;4784;1156;4162;276;1031;331;1178;607;2209
352280;201709;2193;6279;1770;5565;231;908;894;2630;1125;3538
352290;201709;1008;3168;854;2801;163;633;378;1106;541;1739
352300;201709;948;2709;688;2162;111;415;314;874;425;1289
352310;201709;42354;120131;33060;103986;8812;28422;13925;44024;22737;72446
352320;201709;5262;15497;4313;13520;886;3028;1752;4921;2638;7949
352330;201709;1846;5729;1543;5285;446;1673;574;1867;1020;3540
352340;201709;4346;13115;3276;11125;889;3230;898;2885;1787;6115
352350;201709;1538;4947;1338;4500;241;921;515;1602;756;2523
352360;201709;963;2845;857;2669;164;603;565;1677;729;2280
352370;201709;844;2783;755;2564;73;309;481;1574;554;1883
352380;201709;806;2442;660;2174;177;639;170;534;347;1173
352390;201709;16813;43094;11214;33172;1842;6076;5571;15536;7413;21612
352400;201709;3092;8864;2397;7544;636;2227;1062;3072;1698;5299
352410;201709;2622;7595;2192;6904;392;1349;1081;3279;1473;4628
352420;201709;804;2134;621;1796;109;346;245;680;354;1026
352430;201709;5959;17029;4815;15158;1472;4879;1694;5324;3166;10203
352440;201709;14725;44278;11943;38744;2536;8769;5077;16009;7613;24778
352450;201709;570;1690;346;1190;76;290;94;311;170;601
352460;201709;2312;7134;1837;6202;451;1660;571;1824;1022;3484
352470;201709;3573;9639;2608;7927;314;1085;1307;3704;1621;4789
352480;201709;3606;9385;2605;7578;489;1609;1094;2894;1583;4503
352490;201709;619;2083;472;1721;91;353;153;566;244;919
352500;201709;8442;23098;6723;20172;3401;10985;1163;2656;4564;13641
352510;201709;2781;8324;2176;7208;601;2144;669;2165;1270;4309
352520;201709;1903;6259;1629;5661;411;1516;691;2316;1102;3832
352530;201709;7705;23834;5568;18754;1352;4888;811;2194;2163;7082
352540;201709;487;1516;353;1213;68;244;91;301;159;545
352550;201709;849;2667;610;2163;130;510;140;456;270;966
352560;201709;532;1575;370;1196;73;237;76;217;149;454
352570;201709;1755;5474;1193;4264;318;1258;190;558;508;1816
352580;201709;786;2362;606;1985;100;372;195;579;295;951
352585;201709;218;682;180;589;25;88;81;256;106;344
352590;201709;11531;34051;8997;29010;3085;10614;3139;9266;6224;19880
352600;201709;1771;5262;1360;4348;266;910;575;1746;841;2656
352610;201709;3132;9487;2473;8292;588;2187;786;2464;1374;4651
352620;201709;4941;14530;4288;13449;1155;3697;1833;5771;2988;9468
352630;201709;603;1758;525;1601;101;379;251;698;352;1077
352640;201709;2382;6767;1939;6047;154;524;1335;4143;1489;4667
352650;201709;627;1885;469;1489;80;283;132;393;212;676
352660;201709;909;3167;775;2868;164;651;279;1005;443;1656
352670;201709;9154;26854;5624;19141;1345;5053;405;1331;1750;6384
352680;201709;2868;9142;2131;7473;419;1665;854;2779;1273;4444
352690;201709;27685;74770;20611;61287;2278;7665;11864;33550;14142;41215
352700;201709;514;1444;405;1287;138;478;139;407;277;885
352710;201709;4768;13471;3483;10950;921;3196;1266;3735;2187;6931
352720;201709;7319;22600;6252;20329;2526;8375;1276;3919;3802;12294
352725;201709;393;1073;197;628;18;70;93;267;111;337
352730;201709;2193;6899;1965;6303;408;1447;958;2779;1366;4226
352740;201709;2066;5320;1595;4592;197;649;911;2515;1108;3164
352750;201709;415;1142;226;749;42;153;53;153;95;306
352760;201709;1272;4098;1020;3467;204;764;410;1304;614;2068
352770;201709;745;2269;597;1946;136;483;194;596;330;1079
352780;201709;577;1912;458;1607;95;356;157;540;252;896
352790;201709;593;1656;415;1311;62;207;134;394;196;601
352800;201709;1058;3642;789;2919;174;678;201;677;375;1355
352810;201709;982;2495;614;1780;127;373;221;632;348;1005
352820;201709;552;1451;371;1160;78;248;93;302;171;550
352830;201709;516;1428;265;842;37;125;41;108;78;233
352840;201709;3574;11675;3179;10861;948;3387;1272;4188;2220;7575
352850;201709;9774;26636;7001;22174;1868;6352;2181;6734;4049;13086
352860;201709;780;2573;692;2370;147;537;271;903;418;1440
352870;201709;793;2046;511;1425;44;150;279;710;323;860
352880;201709;1831;4780;1304;3777;195;590;591;1543;786;2133
352885;201709;256;790;208;694;29;94;128;422;157;516
352890;201709;593;1492;394;1075;68;226;158;355;226;581
352900;201709;16978;48164;12337;38873;2433;8459;4824;14248;7257;22707
352910;201709;370;1032;204;674;22;81;39;106;61;187
352920;201709;2297;6582;1724;5419;262;916;846;2475;1108;3391
352930;201709;5081;15360;4066;13203;780;2683;1584;4917;2364;7600
352940;201709;20146;62345;16626;54648;5496;19823;2132;6337;7628;26160
352950;201709;399;1103;225;754;46;154;28;88;74;242
352960;201709;591;1702;349;1151;59;224;123;368;182;592
352965;201709;308;895;185;608;50;173;30;83;80;256
352970;201709;2899;7186;2326;6323;244;680;1567;4280;1811;4960
352980;201709;1151;3524;961;3198;193;680;479;1608;672;2288
352990;201709;3767;11567;3286;10727;786;2898;1526;4679;2312;7577
353000;201709;438;1213;216;699;38;132;55;162;93;294
353010;201709;2523;6879;1793;5412;415;1362;543;1520;958;2882
353020;201709;3723;10019;2134;6572;326;1079;707;1977;1033;3056
353030;201709;3332;9576;2562;8066;710;2342;495;1566;1205;3908
353040;201709;415;1136;331;972;74;229;109;288;183;517
353050;201709;4601;14722;3629;12681;923;3431;1347;4497;2270;7928
353060;201709;41225;116430;35295;106599;3483;12471;24603;71516;28086;83987
353070;201709;8923;26977;6492;21831;1469;5272;1908;6348;3377;11620
353080;201709;4231;12952;3027;10428;736;2754;844;2683;1580;5437
353090;201709;505;1679;451;1559;40;159;277;908;317;1067
353100;201709;265;738;109;370;14;48;19;54;33;102
353110;201709;6794;20658;5934;19252;962;3465;3733;12119;4695;15584
353120;201709;509;1467;344;1102;66;235;106;297;172;532
353130;201709;2246;6184;1601;5150;485;1661;489;1552;974;3213
353140;201709;2037;5536;1618;4744;224;729;890;2471;1114;3200
353150;201709;1372;3982;1057;3414;281;916;323;1019;604;1935
353160;201709;615;1676;409;1299;74;255;147;420;221;675
353170;201709;446;1349;380;1262;79;342;188;574;267;916
353180;201709;8307;22665;6738;20074;1010;3275;4229;12461;5239;15736
353190;201709;3243;9490;2624;8165;367;1244;1443;4191;1810;5435
353200;201709;1001;3270;697;2427;167;623;178;592;345;1215
353205;201709;315;1081;286;1000;74;296;141;474;215;770
353210;201709;935;2337;606;1731;37;137;368;1008;405;1145
353215;201709;416;1249;337;1073;57;207;126;337;183;544
353220;201709;531;1580;413;1349;110;370;97;303;207;673
353230;201709;715;2220;637;2096;152;535;229;694;381;1229
353240;201709;1982;6056;1685;5471;229;874;1024;3205;1253;4079
353250;201709;972;2573;708;2068;116;350;307;883;423;1233
353260;201709;820;2281;535;1717;122;421;137;417;259;838
353270;201709;577;1681;482;1483;70;209;230;685;300;894
353280;201709;580;1790;426;1411;77;271;118;381;195;652
353282;201709;1712;5257;1547;4920;223;764;881;2714;1104;3478
353284;201709;353;932;204;616;37;124;60;156;97;280
353286;201709;121;367;88;299;24;80;20;56;44;136
353290;201709;995;2902;751;2422;87;351;420;1226;507;1577
353300;201709;1410;4206;1106;3550;197;727;421;1219;618;1946
353310;201709;252;707;184;580;33;113;81;245;114;358
353320;201709;540;1537;444;1347;43;136;274;814;317;950
353325;201709;582;1831;419;1458;72;257;128;448;200;705
353330;201709;484;1324;339;1020;38;129;190;543;228;672
353340;201709;2678;7563;1786;5888;508;1768;502;1694;1010;3462
353350;201709;2991;8883;2141;6962;565;1938;397;1179;962;3117
353360;201709;431;1402;381;1296;47;180;234;786;281;966
353370;201709;548;1800;474;1641;48;184;277;924;325;1108
353380;201709;278;916;231;805;44;164;79;267;123;431
353390;201709;5284;14232;3884;11673;796;2513;1458;4172;2254;6685
353400;201709;419;1267;339;1104;66;237;69;172;135;409
353410;201709;542;1568;451;1383;86;296;229;675;315;971
353420;201709;495;1362;291;891;71;216;34;92;105;308
353430;201709;1949;6239;1471;5141;399;1506;334;1100;733;2606
353440;201709;51486;156438;38952;129636;9668;33424;15394;49873;25062;83297
353450;201709;380;1057;263;809;41;147;106;299;147;446
353460;201709;3160;9021;2370;7391;273;984;1034;3226;1307;4210
353470;201709;6334;18529;4743;15359;1046;3684;1402;4261;2448;7945
353475;201709;1326;3696;987;2956;142;468;374;1009;516;1477
353480;201709;1301;3932;1171;3671;103;340;837;2571;940;2911
353490;201709;879;2547;648;2036;134;421;254;757;388;1178
353500;201709;901;2339;740;2081;189;527;397;1128;586;1655
353510;201709;816;2595;599;2031;167;583;85;256;252;839
353520;201709;1083;2994;771;2429;99;346;351;1050;450;1396
353530;201709;2186;6241;1835;5547;235;798;1010;2899;1245;3697
353540;201709;1855;5560;1567;5042;339;1154;755;2367;1094;3521
353550;201709;5524;15623;4460;13718;780;2635;2269;6599;3049;9234
353560;201709;1955;6264;1589;5600;538;2024;365;1239;903;3263
353570;201709;482;1413;345;1136;80;254;151;497;231;751
353580;201709;2055;5822;1736;5244;377;1216;906;2649;1283;3865
353590;201709;638;1859;424;1366;85;291;151;490;236;781
353600;201709;1632;4459;1385;3977;165;526;746;2048;911;2574
353610;201709;555;1884;426;1585;93;365;85;291;178;656
353620;201709;2255;6887;1764;5899;449;1596;441;1376;890;2972
353625;201709;447;1205;261;817;36;130;133;391;169;521
353630;201709;1188;4086;917;3387;177;696;169;561;346;1257
353640;201709;1306;3647;993;3029;119;430;556;1638;675;2068
353650;201709;8025;23220;6099;19117;1024;3411;2791;8317;3815;11728
353657;201709;288;864;237;768;32;105;91;264;123;369
353660;201709;956;2290;665;1800;142;443;286;669;428;1112
353670;201709;3150;9871;2664;8899;741;2732;1074;3368;1815;6100
353680;201709;654;1988;522;1764;138;502;196;638;334;1140
353690;201709;465;1197;216;688;24;77;28;83;52;160
353700;201709;1806;5362;1555;4869;228;769;885;2639;1113;3408
353710;201709;3146;7385;1562;4698;318;920;542;1544;860;2464
353715;201709;527;1493;369;1173;23;87;101;288;124;375
353720;201709;1746;5260;1454;4814;276;1025;769;2443;1045;3468
353730;201709;3923;11664;3043;9718;537;1890;1246;3634;1783;5524
353740;201709;1628;4700;1182;3823;315;1110;301;911;616;2021
353750;201709;815;2693;588;2168;149;586;107;381;256;967
353760;201709;10092;26601;8324;24132;1238;3984;5317;15140;6555;19124
353770;201709;644;1979;326;1149;62;244;35;79;97;323
353780;201709;3789;12604;3262;11467;956;3634;793;2678;1749;6312
353790;201709;2117;7053;1689;6150;485;2016;417;1372;902;3388
353800;201709;14883;44821;11969;39448;2701;9598;4987;16149;7688;25747
353810;201709;922;2836;684;2318;129;516;238;763;367;1279
353820;201709;1401;4457;1160;3886;208;818;522;1652;730;2470
353830;201709;576;1557;455;1344;59;184;244;680;303;864
353850;201709;1527;4623;1259;4063;343;1114;413;1357;756;2471
353860;201709;2397;7528;1952;6542;540;1884;616;2025;1156;3909
353870;201709;25711;72935;17975;57268;3104;10997;7162;20811;10266;31808
353880;201709;2579;7922;2154;7112;272;1023;1190;3844;1462;4867
353890;201709;2118;5198;1505;4225;203;636;853;2284;1056;2920
353900;201709;705;2151;530;1810;120;431;171;568;291;999
353910;201709;1849;6308;1693;6044;220;783;1196;4396;1416;5179
353920;201709;2201;6387;1516;4963;336;1226;285;804;621;2030
353930;201709;4013;11798;2823;9572;769;2852;473;1504;1242;4356
353940;201709;1039;3349;777;2723;156;586;211;687;367;1273
353950;201709;2842;8731;2376;7755;466;1677;1156;3479;1622;5156
353960;201709;562;1701;390;1324;93;304;110;365;203;669
353970;201709;564;1564;454;1366;47;154;282;822;329;976
353980;201709;12266;35094;10175;31256;1834;5937;5521;16557;7355;22494
353990;201709;574;1597;423;1295;46;154;247;718;293;872
354000;201709;2097;5609;1263;3941;238;805;197;600;435;1405
354010;201709;315;946;262;836;37;125;161;497;198;622
354020;201709;3560;10938;2984;9676;792;2805;937;2741;1729;5546
354025;201709;765;2159;533;1718;113;377;158;535;271;912
354030;201709;436;1104;261;755;41;128;106;285;147;413
354040;201709;711;1861;462;1376;40;138;269;744;309;882
354050;201709;899;2781;663;2282;180;682;137;439;317;1121
354060;201709;4176;12692;2876;9784;771;2722;704;2221;1475;4943
354070;201709;2603;8364;2086;7211;528;1977;432;1332;960;3309
354075;201709;1783;6245;1543;5710;295;1223;772;2779;1067;4002
354080;201709;1366;4027;932;3076;176;635;280;818;456;1453
354085;201709;362;830;322;778;6;28;234;535;240;563
354090;201709;1357;3933;1237;3692;129;452;854;2511;983;2963
354100;201709;12973;42014;10650;37576;2632;9950;4336;14981;6968;24931
354105;201709;887;2501;763;2318;129;377;486;1502;615;1879
354110;201709;498;1381;386;1212;116;406;105;288;221;694
354120;201709;1594;4474;1125;3453;183;606;423;1168;606;1774
354130;201709;5372;15121;3810;12084;1332;4533;185;420;1517;4953
354140;201709;20856;52378;13477;39203;2974;9242;4188;11287;7162;20529
354150;201709;3311;8706;2487;7208;509;1574;1034;2889;1543;4463
354160;201709;3129;9897;2403;8248;690;2454;680;2307;1370;4761
354165;201709;498;1599;415;1437;88;357;203;671;291;1028
354170;201709;1306;4058;1041;3419;132;472;519;1605;651;2077
354180;201709;410;1267;332;1090;61;225;122;343;183;568
354190;201709;1372;4215;1094;3622;194;711;368;1207;562;1918
354200;201709;883;2448;704;2115;83;259;346;970;429;1229
354210;201709;607;1876;499;1670;64;256;278;858;342;1114
354220;201709;2771;8006;2278;7036;414;1360;1146;3423;1560;4783
354230;201709;665;1947;541;1752;79;321;285;834;364;1155
354240;201709;1205;3812;846;2986;155;586;196;642;351;1228
354250;201709;504;1370;325;1065;93;320;88;293;181;613
354260;201709;7247;21069;5831;18566;1515;5088;1835;5961;3350;11049
354270;201709;1025;3352;828;2933;163;615;296;1053;459;1668
354280;201709;671;1901;591;1763;102;382;343;932;445;1314
354290;201709;818;2846;727;2622;144;542;319;1140;463;1682
354300;201709;3659;11485;3319;10839;1046;3551;1175;3680;2221;7231
354310;201709;737;2257;606;1993;128;443;299;957;427;1400
354320;201709;781;2205;541;1721;117;422;187;544;304;966
354323;201709;480;1260;338;983;43;115;127;349;170;464
354325;201709;1174;3762;863;3034;159;592;315;1045;474;1637
354330;201709;5869;16737;4642;14367;866;3101;2371;6738;3237;9839
354340;201709;21313;62296;16725;54248;4513;15850;6015;18810;10528;34660
354350;201709;1038;2979;896;2690;161;567;524;1441;685;2008
354360;201709;457;1377;265;951;48;159;29;106;77;265
354370;201709;1006;3318;858;3008;110;468;473;1598;583;2066
354380;201709;710;2092;527;1727;131;500;85;231;216;731
354390;201709;12123;33505;8073;25780;1575;5366;1915;5901;3490;11267
354400;201709;1478;5066;1185;4332;229;899;374;1353;603;2252
354410;201709;4731;14286;3905;12646;975;3401;1548;4841;2523;8242
354420;201709;1294;3720;922;2883;148;496;451;1340;599;1836
354425;201709;1942;5492;1598;4808;433;1358;503;1556;936;2914
354430;201709;1238;3952;1091;3670;197;758;529;1686;726;2444
354440;201709;507;1468;341;1114;38;136;142;431;180;567
354450;201709;350;1003;208;690;31;115;40;121;71;236
354460;201709;909;2509;636;1960;111;365;277;849;388;1214
354470;201709;519;1309;395;1075;26;91;207;501;233;592
354480;201709;759;2022;609;1772;67;213;363;1001;430;1214
354490;201709;713;2317;573;1988;91;346;251;836;342;1182
354500;201709;1925;6011;1677;5617;557;2062;392;1300;949;3362
354510;201709;769;2126;681;1954;93;249;392;1097;485;1346
354515;201709;245;795;194;683;37;158;76;263;113;421
354520;201709;6370;19945;3959;13282;691;2626;1884;5844;2575;8470
354530;201709;3261;10517;2693;9318;670;2493;1060;3606;1730;6099
354540;201709;1133;3369;887;2893;250;853;234;778;484;1631
354550;201709;435;1231;340;1060;65;213;179;544;244;757
354560;201709;1753;4686;996;3036;148;472;456;1323;604;1795
354570;201709;1077;2985;476;1503;96;334;70;190;166;524
354580;201709;9731;26772;6504;20660;1156;4011;2619;7828;3775;11839
354600;201709;1513;4654;1242;4138;216;785;651;2111;867;2896
354610;201709;343;960;189;605;38;135;48;136;86;271
354620;201709;387;1205;292;1023;48;211;121;372;169;583
354625;201709;290;887;179;627;24;89;41;123;65;212
354630;201709;1898;6106;1602;5473;652;2380;165;540;817;2920
354640;201709;2851;9219;2160;7606;439;1732;452;1436;891;3168
354650;201709;806;2346;686;2098;87;284;438;1351;525;1635
354660;201709;2288;6226;1645;5112;122;457;1115;3417;1237;3874
354670;201709;937;2832;693;2247;169;603;187;550;356;1153
354680;201709;3980;12388;3592;11653;967;3270;1760;5690;2727;8960
354690;201709;700;2223;474;1685;101;384;108;368;209;752
354700;201709;1020;2839;711;2173;133;446;296;800;429;1246
354710;201709;502;1480;365;1180;40;146;169;496;209;642
354720;201709;251;668;134;415;44;139;17;49;61;188
354730;201709;8747;26140;6507;21838;1127;4222;3244;10385;4371;14607
354740;201709;306;873;119;437;16;77;20;66;36;143
354750;201709;2276;6592;1618;5361;332;1251;616;1893;948;3144
354760;201709;1676;5165;1305;4385;425;1511;201;676;626;2187
354765;201709;295;818;137;456;14;49;30;96;44;145
354770;201709;2112;5667;1535;4634;430;1390;502;1461;932;2851
354780;201709;50607;137242;41882;119649;6435;20492;22853;61216;29288;81708
354790;201709;799;2504;669;2244;94;336;343;1106;437;1442
354800;201709;2265;6464;1894;5888;394;1337;920;2747;1314;4084
354805;201709;925;2681;685;2159;79;286;249;691;328;977
354810;201709;558;1745;333;1230;56;230;72;244;128;474
354820;201709;871;2832;691;2459;137;553;161;500;298;1053
354830;201709;431;1114;298;867;106;306;96;269;202;575
354840;201709;696;2003;474;1482;80;248;228;688;308;936
354850;201709;17359;51051;12649;41731;2259;8503;6213;19112;8472;27615
354860;201709;1204;3693;972;3302;218;828;326;993;544;1821
354870;201709;39640;110936;33914;99901;6355;20444;17590;49764;23945;70208
354880;201709;4438;11922;2322;7174;343;1223;799;2053;1142;3276
354890;201709;13776;38927;11602;35062;2203;7249;5715;16647;7918;23896
354900;201709;432;1247;278;910;34;113;68;212;102;325
354910;201709;5537;16074;3252;11332;630;2449;221;713;851;3162
354920;201709;323;922;180;606;27;116;30;76;57;192
354925;201709;251;765;128;458;31;108;24;77;55;185
354930;201709;319;829;183;587;28;93;80;253;108;346
354940;201709;1540;5402;1247;4651;436;1719;113;391;549;2110
354950;201709;1342;4107;1117;3716;114;489;678;2138;792;2627
354960;201709;744;2164;603;1942;117;418;277;864;394;1282
354970;201709;3488;11064;2970;10018;502;1869;1644;5367;2146;7236
354980;201709;24323;64376;17333;51431;2605;8953;8184;22401;10789;31354
354990;201709;52095;145532;40051;122618;5800;19369;20892;61510;26692;80879
354995;201709;1849;5332;1505;4773;343;1173;761;2337;1104;3510
355000;201709;1278;3950;1115;3646;270;996;226;617;496;1613
355010;201709;2943;9036;2144;7089;721;2551;262;867;983;3418
355020;201709;2925;9194;2221;7787;766;2947;613;2045;1379;4992
355030;201709;1123820;2935508;898549;2502002;180410;546701;408648;1070291;589058;1616992
355040;201709;2481;7444;2186;6923;354;1191;1385;4347;1739;5538
355050;201709;969;2784;740;2344;226;717;150;444;376;1161
355060;201709;4129;12905;3284;11142;639;2474;1339;4144;1978;6618
355070;201709;6680;19509;5561;17593;898;3262;3036;8992;3934;12254
355080;201709;799;2647;543;2051;94;402;33;106;127;508
355090;201709;1044;3380;844;2959;174;633;287;1011;461;1644
355100;201709;16414;48771;13591;44085;3001;10578;7387;23311;10388;33889
355110;201709;994;3107;803;2753;310;1119;149;503;459;1622
355120;201709;587;1744;439;1459;79;304;165;514;244;818
355130;201709;573;1412;255;738;33;100;87;231;120;331
355140;201709;1113;3435;1029;3288;181;645;656;2088;837;2733
355150;201709;3480;10062;2829;8890;543;1807;1306;4096;1849;5903
355160;201709;1612;4908;1285;4323;359;1329;322;1049;681;2378
355170;201709;7715;21636;6074;18932;1925;6266;2079;6605;4004;12871
355180;201709;2615;7876;2018;6768;459;1830;653;1969;1112;3799
355190;201709;1406;4201;1190;3808;346;1215;465;1562;811;2777
355200;201709;754;2565;660;2378;298;1157;142;464;440;1621
355210;201709;2662;7916;2334;7241;267;969;1514;4465;1781;5434
355220;201709;35896;105260;29229;91864;8886;29472;8642;24980;17528;54452
355230;201709;1222;3187;704;2127;142;405;166;486;308;891
355240;201709;21572;60280;14850;46658;3133;10293;5371;16654;8504;26947
355250;201709;29181;86461;23311;75463;6232;21495;7993;25323;14225;46818
355255;201709;768;2024;440;1361;87;267;139;435;226;702
355260;201709;1077;3123;857;2722;146;561;466;1370;612;1931
355270;201709;1450;4545;1154;3849;263;920;427;1340;690;2260
355280;201709;24976;70424;19264;59193;3592;11903;8151;23963;11743;35866
355290;201709;754;2335;585;1933;152;488;166;516;318;1004
355300;201709;1218;3813;1006;3355;213;758;300;989;513;1747
355310;201709;978;2842;750;2447;98;353;386;1270;484;1623
355320;201709;500;1460;418;1294;77;285;168;442;245;727
355330;201709;1785;5291;1352;4440;220;780;715;2237;935;3017
355340;201709;2730;6658;2401;6180;321;836;1605;4097;1926;4933
355350;201709;1203;3927;933;3325;210;821;283;991;493;1812
355360;201709;1141;3380;1006;3076;109;334;710;2220;819;2554
355365;201709;332;953;182;642;40;120;31;111;71;231
355370;201709;5973;15517;4703;13805;1084;3316;2122;6658;3206;9974
355380;201709;2926;8458;2264;7075;474;1584;619;1681;1093;3265
355385;201709;1025;3232;923;3013;227;787;363;1117;590;1904
355390;201709;730;2127;557;1758;106;357;203;583;309;940
355395;201709;1866;5580;1369;4424;217;715;537;1638;754;2353
355400;201709;8285;26735;7032;24096;2177;8073;1834;5884;4011;13957
355410;201709;18248;55754;13897;47030;3765;13856;2723;9335;6488;23191
355420;201709;676;2400;598;2227;156;681;140;528;296;1209
355430;201709;3475;9346;2788;8142;601;1831;1313;3798;1914;5629
355440;201709;812;2384;568;1839;117;391;165;499;282;890
355450;201709;3421;9631;2100;6819;421;1407;637;1923;1058;3330
355460;201709;537;1420;343;1066;58;219;137;358;195;577
355465;201709;347;1071;252;838;50;181;57;171;107;352
355470;201709;942;2673;558;1827;162;531;166;533;328;1064
355475;201709;200;565;187;532;21;74;141;386;162;460
355480;201709;3019;9920;2696;9296;531;2057;1456;4847;1987;6904
355490;201709;908;2616;538;1780;79;283;176;555;255;838
355495;201709;721;2282;582;2006;117;448;153;510;270;958
355500;201709;6020;17545;3952;12884;694;2434;894;2743;1588;5177
355510;201709;1634;4153;828;2601;116;400;239;667;355;1067
355520;201709;403;939;201;557;21;64;102;264;123;328
355530;201709;441;1017;163;474;19;66;45;100;64;166
355535;201709;539;1573;424;1371;123;461;135;380;258;841
355540;201709;7511;22578;6806;21450;1434;4819;3874;11950;5308;16769
355550;201709;657;2014;525;1735;77;255;215;713;292;968
355560;201709;1032;3041;579;1981;110;401;31;98;141;499
355570;201709;223;689;116;427;23;96;19;69;42;165
355580;201709;1152;3061;766;2356;120;444;343;1010;463;1454
355590;201709;190;509;148;440;23;78;83;242;106;320
355600;201709;1344;3712;969;2965;246;838;324;924;570;1762
355610;201709;1575;4304;1134;3449;176;563;518;1520;694;2083
355620;201709;4124;12415;3239;10427;465;1757;1577;4637;2042;6394
355630;201709;2150;6371;1525;5142;353;1230;508;1744;861;2974
355635;201709;848;2679;742;2503;88;316;489;1710;577;2026
355640;201709;2601;8097;1846;6550;442;1650;342;1218;784;2868
355645;201709;3742;11747;3146;10779;411;1676;1925;6459;2336;8135
355650;201709;6310;18342;5403;16613;1165;3978;3032;8711;4197;12689
355660;201709;1200;3555;903;2941;119;500;455;1302;574;1802
355670;201709;2944;8951;2077;6820;360;1349;897;2592;1257;3941
355680;201709;1824;5646;1036;3645;282;1069;88;280;370;1349
355690;201709;500;1608;338;1241;91;357;13;29;104;386
355695;201709;231;758;135;484;12;50;16;49;28;99
355700;201709;5271;16647;4473;14857;1162;3909;1763;5721;2925;9630
355710;201709;8240;20483;5072;14634;1029;3139;1566;4198;2595;7337
355715;201709;360;1074;221;737;55;201;48;149;103;350
355720;201709;1390;4451;1144;3927;240;879;442;1373;682;2252
355730;201709;775;2479;652;2200;190;633;203;633;393;1266
410010;201709;1198;3606;971;3089;225;782;171;558;396;1340
410020;201709;1068;3445;912;3085;285;954;288;972;573;1926
410030;201709;1159;3768;972;3343;244;875;278;965;522;1840
410040;201709;8906;28197;7583;25696;1726;6399;2462;8160;4188;14559
410045;201709;1003;2745;682;2137;107;385;212;603;319;988
410050;201709;2491;6593;1573;4860;407;1331;220;599;627;1930
410060;201709;2075;6270;1725;5525;395;1313;675;2146;1070;3459
410070;201709;1569;4337;1182;3567;271;898;397;1154;668;2052
410080;201709;1318;3660;1010;3091;182;607;411;1233;593;1840
410090;201709;943;2807;881;2681;129;413;455;1445;584;1858
410100;201709;2199;6762;1627;5323;274;1037;269;826;543;1863
410105;201709;332;1002;211;701;36;148;39;103;75;251
410110;201709;2904;8030;2142;6493;324;1094;739;2167;1063;3261
410115;201709;487;1296;360;1062;69;219;129;355;198;574
410120;201709;2241;7606;2057;7227;845;3099;459;1602;1304;4701
410130;201709;1005;3030;935;2895;345;1216;269;681;614;1897
410140;201709;14939;38377;9599;28697;1995;6508;2028;5682;4023;12190
410150;201709;14554;36643;7415;21935;1457;4598;1192;3402;2649;8000
410160;201709;2747;8241;2431;7627;540;1872;902;2876;1442;4748
410165;201709;700;2043;564;1714;85;279;286;817;371;1096
410170;201709;2083;5860;1544;4654;440;1444;192;549;632;1993
410180;201709;10826;33262;9074;29304;1758;6055;4164;12615;5922;18670
410185;201709;490;1373;359;1122;68;221;101;285;169;506
410190;201709;1873;5311;1483;4518;321;1042;298;861;619;1903
410200;201709;3913;10351;2587;7839;537;1854;463;1370;1000;3224
410210;201709;2437;7079;1713;5470;285;1035;415;1097;700;2132
410220;201709;589;1559;412;1223;50;171;112;339;162;510
410230;201709;1354;4107;1159;3701;233;847;500;1512;733;2359
410240;201709;3989;11738;3451;10651;1062;3679;463;1396;1525;5075
410250;201709;2548;6774;1765;5277;437;1402;394;1160;831;2562
410260;201709;1523;4125;1116;3461;222;779;495;1492;717;2271
410270;201709;497;1349;382;1126;32;106;195;569;227;675
410275;201709;725;2190;486;1611;74;261;203;667;277;928
410280;201709;1986;5658;1375;4380;305;1062;386;1109;691;2171
410290;201709;3173;9431;2496;8063;576;1876;910;2965;1486;4841
410300;201709;660;1770;516;1491;92;293;227;596;319;889
410302;201709;414;1094;219;704;24;85;110;355;134;440
410304;201709;1071;3278;958;3036;216;732;448;1410;664;2142
410305;201709;1612;4263;1212;3588;305;948;527;1539;832;2487
410310;201709;2179;6803;1874;6245;407;1492;600;1997;1007;3489
410315;201709;761;2026;419;1393;90;316;116;366;206;682
410320;201709;1125;3337;730;2432;94;366;105;323;199;689
410322;201709;501;1443;275;907;34;115;77;248;111;363
410330;201709;1313;3572;1011;2970;244;767;245;713;489;1480
410335;201709;821;2388;688;2114;112;408;304;857;416;1265
410337;201709;709;1844;508;1468;77;236;187;504;264;740
410340;201709;488;1370;332;974;48;168;139;339;187;507
410345;201709;1875;5154;1138;3592;251;814;278;833;529;1647
410347;201709;687;1786;500;1450;46;162;162;433;208;595
410350;201709;1125;3277;838;2701;132;457;236;697;368;1154
410360;201709;3787;9809;2962;8394;291;974;1753;4827;2044;5801
410370;201709;10421;29632;7458;22743;1221;4178;2514;6769;3735;10947
410380;201709;1256;3570;1078;3183;139;506;404;1127;543;1633
410390;201709;2397;6895;1673;5380;501;1728;325;942;826;2670
410395;201709;859;2683;710;2364;159;582;318;1067;477;1649
410400;201709;4194;12686;3377;10920;658;2288;1242;3843;1900;6131
410405;201709;757;2051;612;1807;149;457;262;771;411;1228
410410;201709;1063;3272;1037;3238;219;845;606;1837;825;2682
410420;201709;6288;19911;5026;17067;1142;4273;926;2835;2068;7108
410425;201709;2538;7823;1891;6452;358;1303;435;1383;793;2686
410430;201709;12119;32178;8799;26058;1599;5135;2628;7413;4227;12548
410440;201709;2796;9538;2501;8943;448;1673;1324;4939;1772;6612
410442;201709;2321;7589;2050;7005;632;2291;608;2033;1240;4324
410445;201709;2166;6796;1810;6085;429;1568;555;1933;984;3501
410450;201709;1686;4741;1290;3932;270;910;242;601;512;1511
410460;201709;1562;4395;1207;3762;277;934;337;984;614;1918
410465;201709;2157;6806;1770;5981;417;1420;593;1955;1010;3375
410470;201709;1650;5154;1264;4263;302;1111;242;830;544;1941
410480;201709;28657;78266;16735;53932;2613;9282;1390;3880;4003;13162
410490;201709;10405;31072;7670;25136;1651;5840;2236;6818;3887;12658
410500;201709;1453;4421;1112;3658;334;1228;163;448;497;1676
410510;201709;2128;5611;1418;4167;261;775;456;1295;717;2070
410520;201709;2901;9775;2690;9344;744;2653;1206;4256;1950;6909
410530;201709;1382;3832;780;2380;147;463;72;179;219;642
410540;201709;2587;7518;1853;5991;326;1121;761;2438;1087;3559
410550;201709;5705;16285;3965;12461;821;2818;635;1806;1456;4624
410560;201709;1244;3573;983;3063;235;806;361;1020;596;1826
410570;201709;2443;7590;2071;6890;572;2130;360;1275;932;3405
410580;201709;20339;58582;16260;50630;3584;12386;5952;17233;9536;29619
410590;201709;1327;4047;873;2847;154;535;196;565;350;1100
410600;201709;1648;4751;1314;4092;322;984;431;1383;753;2367
410610;201709;713;2002;539;1662;62;210;186;541;248;751
410620;201709;1774;5736;1195;4288;280;1086;111;335;391;1421
410630;201709;2157;6343;1419;4646;293;1063;122;308;415;1371
410640;201709;3619;9685;2686;7990;737;2464;401;1133;1138;3597
410645;201709;1054;3542;969;3392;428;1534;232;874;660;2408
410650;201709;1833;5513;1416;4620;424;1474;314;936;738;2410
410655;201709;1310;4411;1085;3963;50;185;733;2863;783;3048
410657;201709;682;1845;439;1334;90;290;167;466;257;756
410660;201709;2895;7961;1580;5003;319;1019;214;669;533;1688
410670;201709;865;2295;580;1711;109;316;245;714;354;1030
410680;201709;2808;8897;2089;7098;558;1863;480;1742;1038;3605
410685;201709;571;1617;482;1452;81;282;256;730;337;1012
410690;201709;106014;294950;73978;229024;13964;48017;20590;56075;34554;104092
410700;201709;2019;5789;1786;5352;395;1248;804;2278;1199;3526
410710;201709;842;2426;570;1855;99;333;215;656;314;989
410712;201709;678;2036;597;1889;191;649;226;690;417;1339
410715;201709;814;2627;559;1990;115;425;148;515;263;940
410720;201709;2675;7833;2107;6596;372;1323;391;1093;763;2416
410725;201709;1021;2792;671;2108;120;407;108;314;228;721
410730;201709;499;1399;369;1148;97;331;55;170;152;501
410740;201709;905;2639;635;2098;115;420;244;808;359;1228
410750;201709;1655;4681;1358;4079;286;937;474;1347;760;2284
410752;201709;309;814;145;447;22;75;48;124;70;199
410753;201709;247;750;168;563;19;65;28;81;47;146
410754;201709;1039;2957;900;2733;47;135;599;1971;646;2106
410755;201709;702;1742;499;1386;51;161;272;708;323;869
410760;201709;2510;7312;2120;6634;585;1968;586;1847;1171;3815
410765;201709;12086;36303;9471;31133;1628;5995;1032;3205;2660;9200
410770;201709;866;2326;611;1840;118;374;187;542;305;916
410773;201709;1253;3549;1133;3370;174;598;823;2389;997;2987
410775;201709;1325;3700;1185;3474;241;780;430;1223;671;2003
410780;201709;558;1459;337;1005;74;219;78;256;152;475
410785;201709;721;2165;596;1913;152;537;180;543;332;1080
410790;201709;486;1551;411;1362;121;428;41;102;162;530
410800;201709;2644;6350;2090;5491;210;606;901;2353;1111;2959
410810;201709;310;915;247;790;36;134;109;347;145;481
410820;201709;686;2008;482;1530;113;373;69;205;182;578
410830;201709;26736;73568;20855;63199;5642;18975;6670;19237;12312;38212
410832;201709;954;2657;822;2400;106;395;458;1246;564;1641
410840;201709;6684;18705;4267;13726;1022;3651;440;1087;1462;4738
410845;201709;1091;3187;907;2832;202;705;306;913;508;1618
410850;201709;2393;7176;2106;6665;466;1633;804;2570;1270;4203
410855;201709;555;1523;411;1227;47;165;185;513;232;678
410860;201709;3743;10316;2948;8763;536;1715;956;2724;1492;4439
410865;201709;1311;4285;1230;4140;292;1018;672;2345;964;3363
410870;201709;1136;3340;1043;3194;86;277;714;2223;800;2500
410880;201709;3579;10957;2874;9560;552;2009;416;1446;968;3455
410890;201709;865;2739;661;2301;144;549;138;470;282;1019
410895;201709;914;3069;799;2807;320;1216;137;455;457;1671
410900;201709;844;2324;567;1759;90;304;153;403;243;707
410910;201709;352;890;227;639;17;55;116;304;133;359
410920;201709;716;1959;575;1727;138;467;202;590;340;1057
410930;201709;1433;4251;1174;3705;335;1210;267;803;602;2013
410940;201709;19605;60404;15960;53342;4772;17240;2910;10067;7682;27307
410950;201709;1769;5559;1629;5329;86;333;1321;4272;1407;4605
410960;201709;7172;19467;4505;14455;1247;4412;1150;3578;2397;7990
410965;201709;981;2828;754;2360;154;511;309;909;463;1420
410970;201709;3754;10870;2839;9048;711;2649;446;1289;1157;3938
410975;201709;1325;3744;1035;3172;213;765;341;1022;554;1787
410980;201709;6262;17130;4151;13075;640;2213;1490;4514;2130;6727
410990;201709;1022;2879;665;2127;201;715;136;369;337;1084
411000;201709;466;1373;329;1079;43;158;75;207;118;365
411005;201709;421;1217;269;867;52;172;47;146;99;318
411007;201709;2106;6524;1848;5998;484;1692;561;1795;1045;3487
411010;201709;3779;12343;3291;11262;969;3500;338;1076;1307;4576
411020;201709;2266;6866;1966;6321;606;2095;586;1816;1192;3911
411030;201709;656;1735;439;1243;83;252;137;348;220;600
411040;201709;720;1998;319;992;55;178;53;145;108;323
411050;201709;1783;6045;1563;5526;458;1737;236;733;694;2470
411060;201709;1497;4319;1072;3427;224;841;186;519;410;1360
411065;201709;314;911;242;769;47;149;94;305;141;454
411070;201709;5915;16892;4741;14623;1073;3624;1529;4473;2602;8097
411080;201709;1909;5496;1643;5018;486;1572;373;1164;859;2736
411090;201709;759;1999;529;1586;52;179;97;258;149;437
411095;201709;1368;3543;985;2861;167;542;341;931;508;1473
411100;201709;1078;3128;791;2516;107;411;209;660;316;1071
411110;201709;547;1560;253;870;23;80;14;38;37;118
411120;201709;1357;4033;1041;3329;329;1216;201;520;530;1736
411125;201709;4080;12951;3824;12464;949;3205;1648;5491;2597;8696
411130;201709;635;1820;459;1432;103;330;146;494;249;824
411140;201709;2146;7004;1801;6214;428;1549;734;2582;1162;4131
411150;201709;3705;10251;2714;8266;580;1963;233;577;813;2540
411155;201709;906;2434;609;1880;69;228;263;759;332;987
411160;201709;272;739;208;615;36;96;48;154;84;250
411170;201709;706;2156;547;1788;119;407;173;562;292;969
411180;201709;5056;14597;4042;12655;815;2802;1492;4611;2307;7413
411190;201709;1191;3362;964;2873;233;747;226;592;459;1339
411200;201709;4138;12000;3238;10352;890;3028;901;2831;1791;5859
411210;201709;1878;5104;1482;4424;437;1454;167;436;604;1890
411220;201709;794;2243;650;1957;148;490;231;646;379;1136
411230;201709;1053;2942;688;2214;153;525;183;577;336;1102
411240;201709;1541;3650;862;2490;122;371;380;1047;502;1418
411250;201709;1834;5336;1486;4693;375;1322;444;1386;819;2708
411260;201709;338;873;213;638;28;86;87;236;115;322
411270;201709;1625;4953;1396;4471;251;910;627;1929;878;2839
411275;201709;1211;3383;911;2757;192;630;261;744;453;1374
411280;201709;1380;3921;891;2839;167;606;152;419;319;1025
411290;201709;680;1947;492;1581;94;305;184;599;278;904
411295;201709;966;2561;811;2275;131;399;316;866;447;1265
411300;201709;1099;2802;731;2104;72;225;261;675;333;900
411310;201709;796;2122;642;1860;46;141;241;691;287;832
411320;201709;4869;13902;3533;11348;865;2871;759;2284;1624;5155
411325;201709;1441;4469;1277;4123;242;809;650;2141;892;2950
411330;201709;2949;8886;2357;7663;651;2306;568;1888;1219;4194
411340;201709;706;2089;456;1488;53;212;197;620;250;832
411342;201709;596;1647;490;1433;123;380;175;470;298;850
411345;201709;933;2716;781;2424;136;478;431;1330;567;1808
411350;201709;2514;7306;1836;5903;493;1749;167;548;660;2297
411360;201709;584;1468;400;1170;53;189;142;362;195;551
411370;201709;41733;113692;32783;97348;4042;13867;16608;46082;20650;59949
411373;201709;1267;3650;1068;3311;156;531;458;1437;614;1968
411375;201709;1002;2701;749;2232;131;424;247;682;378;1106
411380;201709;1031;2794;668;1941;103;328;230;594;333;922
411390;201709;1646;4871;1304;4039;244;820;406;1138;650;1958
411400;201709;2013;5448;1620;4677;315;1026;579;1585;894;2611
411410;201709;1885;5596;1431;4601;343;1222;298;846;641;2068
411420;201709;3673;9892;2323;7145;366;1270;371;920;737;2190
411430;201709;2998;8823;2503;7972;566;1932;1092;3392;1658;5324
411435;201709;441;1330;328;1094;77;253;116;357;193;610
411440;201709;2519;7892;2154;7116;565;1950;544;1891;1109;3841
411450;201709;2520;7078;1991;6192;365;1141;1014;3246;1379;4387
411460;201709;3357;9527;1878;6244;332;1276;226;674;558;1950
411470;201709;727;2121;501;1605;91;321;91;266;182;587
411480;201709;4012;11861;2926;9695;623;2260;580;1806;1203;4066
411490;201709;1412;4070;1131;3542;202;737;338;927;540;1664
411500;201709;1563;4131;1102;3310;181;625;328;958;509;1583
411510;201709;1891;5515;1583;4885;416;1407;316;985;732;2392
411520;201709;22511;60133;13754;42019;2272;7599;3541;9703;5813;17302
411530;201709;902;2479;610;1932;115;406;204;620;319;1026
411535;201709;448;1355;203;725;23;102;20;54;43;156
411540;201709;2759;7351;2011;5817;443;1389;543;1439;986;2828
411545;201709;959;3008;835;2754;93;320;531;1792;624;2112
411550;201709;660;1775;531;1557;106;347;84;226;190;573
411560;201709;1928;5552;1261;4089;189;681;82;205;271;886
411570;201709;6841;17516;4885;14378;1076;3590;1124;3307;2200;6897
411573;201709;778;2197;697;2068;68;217;444;1307;512;1524
411575;201709;1526;4569;1281;4085;293;1002;379;1195;672;2197
411580;201709;3791;10065;2274;7338;261;1031;286;826;547;1857
411585;201709;721;2266;352;1251;62;233;58;178;120;411
411590;201709;332;977;267;850;37;130;112;321;149;451
411600;201709;276;775;190;623;40;147;70;225;110;372
411605;201709;1423;3930;960;2921;148;525;369;1062;517;1587
411610;201709;2033;5610;1509;4507;323;1040;529;1517;852;2557
411620;201709;2680;8002;2371;7513;453;1579;1332;4175;1785;5754
411630;201709;528;1411;342;1075;79;292;56;130;135;422
411640;201709;449;1353;321;1030;43;126;97;322;140;448
411650;201709;190;575;137;466;30;105;21;72;51;177
411660;201709;864;2299;615;1831;48;148;324;937;372;1085
411670;201709;1038;2834;806;2354;137;404;274;776;411;1180
411680;201709;1481;4266;1218;3774;224;785;571;1746;795;2531
411690;201709;3156;9030;2427;7653;491;1624;670;2192;1161;3816
411695;201709;646;2062;484;1668;77;289;155;555;232;844
411700;201709;1434;4045;978;3131;203;715;141;410;344;1125
411705;201709;1566;5505;1415;5194;327;1157;758;2954;1085;4111
411710;201709;1593;4518;1249;3829;335;1091;188;588;523;1679
411720;201709;867;2363;687;2001;103;332;229;623;332;955
411721;201709;771;2205;608;1843;135;421;105;310;240;731
411722;201709;593;1751;379;1251;72;286;117;306;189;592
411725;201709;1243;3900;784;2767;187;695;147;528;334;1223
411727;201709;1542;4539;1090;3530;300;1002;156;452;456;1454
411729;201709;615;1593;420;1225;95;284;105;262;200;546
411730;201709;4618;13483;3855;11889;1209;3851;1075;3289;2284;7140
411740;201709;563;1555;313;989;59;210;57;151;116;361
411745;201709;820;2400;620;1951;112;372;142;395;254;767
411750;201709;4598;13383;3544;11055;525;1812;1511;4492;2036;6304
411760;201709;6733;19349;5586;17341;1909;6283;1130;3683;3039;9966
411770;201709;3083;9727;2453;8299;687;2462;336;1104;1023;3566
411780;201709;2759;8290;2462;7721;642;2172;1033;3268;1675;5440
411790;201709;2893;7934;1824;5694;441;1522;296;853;737;2375
411800;201709;1005;2905;672;2133;96;334;112;318;208;652
411810;201709;1590;4363;1280;3773;215;698;602;1678;817;2376
411820;201709;10887;34706;9153;31043;3121;10997;2417;8297;5538;19294
411830;201709;557;1393;379;1088;97;314;39;126;136;440
411840;201709;9609;26728;6924;21350;1437;4812;1590;4824;3027;9636
411845;201709;420;1250;239;791;43;166;19;54;62;220
411850;201709;7011;20130;5524;17206;1582;5312;1069;3212;2651;8524
411860;201709;790;2374;609;1984;117;414;164;495;281;909
411870;201709;745;2355;503;1720;99;375;95;293;194;668
411880;201709;1970;5643;1482;4746;396;1374;240;743;636;2117
411885;201709;892;2382;697;2051;107;374;239;665;346;1039
411890;201709;1070;3173;727;2381;115;428;55;150;170;578
411900;201709;860;2637;535;1821;132;454;55;194;187;648
411910;201709;1059;3358;790;2738;227;825;200;664;427;1489
411915;201709;15777;41395;9763;29848;1843;6123;2319;6475;4162;12598
411920;201709;860;2820;744;2545;225;869;109;323;334;1192
411925;201709;575;1585;380;1215;98;333;89;269;187;602
411930;201709;5262;17328;4628;16068;2212;8344;318;1151;2530;9495
411940;201709;2902;9435;2466;8471;640;2301;532;1696;1172;3997
411950;201709;11820;36048;10076;32754;2224;7794;4548;14445;6772;22239
411960;201709;5161;14909;4589;13790;949;3120;1773;5082;2722;8202
411965;201709;479;1336;340;1094;65;245;85;277;150;522
411970;201709;786;2084;660;1906;124;327;357;1153;481;1480
411980;201709;1419;4047;1188;3603;311;990;357;1048;668;2038
411990;201709;31608;94152;23017;76156;5253;19126;6680;21124;11933;40250
411995;201709;2386;6741;1922;5962;540;1898;544;1562;1084;3460
412000;201709;2095;5028;1552;4122;144;464;880;2131;1024;2595
412010;201709;651;2136;496;1766;71;290;112;349;183;639
412015;201709;576;1690;483;1506;75;237;240;761;315;998
412020;201709;394;1183;245;826;42;157;84;261;126;418
412030;201709;690;2072;493;1665;79;291;173;554;252;845
412033;201709;874;2551;620;1982;82;274;218;732;300;1006
412035;201709;832;2269;533;1726;87;314;221;697;308;1011
412040;201709;567;1650;398;1294;68;231;74;236;142;467
412050;201709;1595;4448;1187;3659;218;764;294;908;512;1672
412060;201709;6881;22634;6083;20952;1868;6926;1421;4751;3289;11677
412065;201709;674;1981;507;1642;100;340;153;483;253;823
412070;201709;1202;3147;890;2524;135;416;381;1067;516;1483
412080;201709;1546;4729;955;3318;126;494;32;89;158;583
412085;201709;326;913;108;375;9;34;10;28;19;62
412090;201709;4726;13382;4223;12493;1024;3087;2089;6353;3113;9440
412100;201709;1672;5061;1348;4419;417;1471;264;873;681;2344
412110;201709;901;2513;625;1913;129;427;140;440;269;867
412120;201709;1613;5330;1349;4725;333;1275;366;1073;699;2348
412125;201709;588;1872;498;1656;116;409;152;487;268;896
412130;201709;571;1675;416;1319;69;248;92;307;161;555
412135;201709;533;1509;281;872;46;143;93;265;139;408
412140;201709;1484;4107;1075;3313;233;794;175;480;408;1274
412150;201709;2901;8043;2462;7182;277;933;1557;4410;1834;5343
412160;201709;1086;3484;669;2362;172;676;78;259;250;935
412170;201709;4162;12467;3483;11174;813;2836;1397;4209;2210;7045
412175;201709;1319;4206;1143;3854;242;843;487;1650;729;2493
412180;201709;1586;4649;1192;3916;223;880;472;1382;695;2262
412190;201709;3148;8561;2389;7154;390;1239;879;2764;1269;4003
412200;201709;1904;5942;1379;4605;317;1125;291;962;608;2087
412210;201709;611;1658;363;1132;77;294;56;138;133;432
412215;201709;3543;10129;3092;9266;793;2357;1461;4737;2254;7094
412217;201709;1003;2775;874;2543;72;254;604;1672;676;1926
412220;201709;5313;16170;4758;15147;1175;3690;1969;6636;3144;10326
412230;201709;2655;8511;2225;7591;429;1632;596;1858;1025;3490
412240;201709;7118;18508;4514;13635;868;2924;1032;2910;1900;5834
412250;201709;1845;5215;1463;4435;363;1154;227;623;590;1777
412260;201709;1182;3299;819;2505;114;379;279;776;393;1155
412265;201709;875;2654;757;2425;192;664;290;925;482;1589
412270;201709;757;2329;530;1782;91;339;187;590;278;929
412280;201709;515;1609;404;1378;133;468;61;195;194;663
412290;201709;995;2707;710;2184;123;424;219;625;342;1049
412300;201709;1480;4407;1231;3907;329;1126;256;762;585;1888
412310;201709;802;2389;672;2153;90;385;323;1030;413;1415
412320;201709;787;2101;566;1671;81;312;186;536;267;848
412330;201709;1373;3865;984;3068;176;571;387;1189;563;1760
412340;201709;939;2846;626;2057;104;363;134;407;238;770
412350;201709;2437;6976;1594;5173;311;1133;82;187;393;1320
412360;201709;256;750;162;529;27;100;53;152;80;252
412370;201709;771;2324;582;1952;126;465;63;205;189;670
412380;201709;1523;4611;1139;3717;294;985;230;794;524;1779
412382;201709;595;1608;407;1233;66;213;114;307;180;520
412385;201709;2126;6361;1835;5732;671;2127;458;1534;1129;3661
412390;201709;2036;5588;1764;5150;392;1239;810;2391;1202;3630
412395;201709;695;2027;519;1659;60;201;257;803;317;1004
412400;201709;862;2586;677;2165;155;527;156;521;311;1048
412402;201709;1660;4631;1277;3927;283;974;195;552;478;1526
412405;201709;2976;8641;1885;6161;330;1223;65;179;395;1402
412410;201709;4813;13995;3788;12064;917;3319;840;2565;1757;5884
412420;201709;391;1103;220;695;29;99;86;226;115;325
412430;201709;508;1384;343;1059;43;151;121;364;164;515
412440;201709;2691;7995;1967;6578;498;1839;379;1265;877;3104
412450;201709;269;871;194;676;27;83;12;36;39;119
412460;201709;761;2305;646;2060;145;483;180;554;325;1037
412470;201709;1718;5754;1401;4966;401;1492;276;1019;677;2511
412480;201709;974;2880;623;2013;112;404;80;197;192;601
412490;201709;915;2623;760;2310;158;464;278;822;436;1286
412500;201709;1761;4902;1434;4241;260;846;378;1003;638;1849
412510;201709;1967;6338;1475;5068;402;1470;208;653;610;2123
412520;201709;1284;3678;925;2893;239;760;107;325;346;1085
412530;201709;551;1603;432;1338;77;262;79;226;156;488
412535;201709;966;3028;750;2566;100;331;331;1240;431;1571
412540;201709;1204;3355;855;2598;120;448;243;754;363;1202
412545;201709;701;1917;478;1418;84;259;112;280;196;539
412550;201709;28350;83253;19746;64376;4218;14643;5084;15563;9302;30206
412555;201709;209;603;146;467;21;72;40;106;61;178
412560;201709;4892;14868;3717;12152;777;2844;823;2574;1600;5418
412570;201709;3882;10908;2503;7994;520;1824;332;1099;852;2923
412575;201709;869;2549;701;2148;115;383;282;801;397;1184
412580;201709;1249;3371;889;2653;150;512;351;974;501;1486
412590;201709;446;1280;260;876;54;180;28;89;82;269
412600;201709;1327;3975;1000;3234;191;687;307;946;498;1633
412610;201709;675;1970;426;1348;93;293;141;424;234;717
412620;201709;1175;3497;909;2995;232;904;244;703;476;1607
412625;201709;7556;22023;5399;17615;928;3247;627;2298;1555;5545
412627;201709;905;2727;630;2111;189;686;157;510;346;1196
412630;201709;2852;8930;2172;7356;430;1445;655;2122;1085;3567
412635;201709;387;1100;269;838;52;170;41;105;93;275
412640;201709;953;2737;573;1849;90;324;107;306;197;630
412650;201709;1461;4290;1230;3857;229;830;398;1124;627;1954
412660;201709;2504;6934;1810;5560;338;1156;478;1328;816;2484
412665;201709;554;1417;308;951;65;217;84;240;149;457
412667;201709;1601;4490;1245;3763;211;737;454;1302;665;2039
412670;201709;494;1489;391;1284;93;335;106;344;199;679
412680;201709;1327;3915;831;2825;141;528;231;706;372;1234
412690;201709;751;2196;570;1812;121;390;129;414;250;804
412700;201709;1713;4923;1419;4464;361;1306;508;1550;869;2856
412710;201709;5707;17876;4797;15986;1036;3765;1274;3914;2310;7679
412720;201709;1269;3896;917;3031;140;503;189;530;329;1033
412730;201709;2034;6004;1168;3939;255;916;159;511;414;1427
412740;201709;1490;4536;1033;3501;212;793;128;476;340;1269
412750;201709;3844;11287;3395;10541;510;1832;2056;6190;2566;8022
412760;201709;2405;7301;2209;6933;326;1132;1334;4064;1660;5196
412770;201709;9746;26365;5399;17093;752;2522;983;2829;1735;5351
412780;201709;1202;3577;1014;3210;198;700;421;1282;619;1982
412785;201709;2029;5553;1507;4552;380;1158;617;1866;997;3024
412788;201709;1276;3935;1080;3532;292;1046;379;1159;671;2205
412790;201709;963;2850;641;2149;137;510;148;405;285;915
412795;201709;983;2688;633;1913;113;358;184;537;297;895
412796;201709;2297;6998;2018;6383;404;1362;800;2378;1204;3740
412800;201709;3000;8175;2174;6432;340;1124;811;2223;1151;3347
412810;201709;10632;28460;6280;19162;859;2980;1689;4385;2548;7365
412820;201709;6485;18832;4812;15457;1066;3613;1418;4571;2484;8184
412830;201709;316;932;229;750;33;118;53;165;86;283
412840;201709;1704;4795;1357;4079;223;715;372;1108;595;1823
412850;201709;2857;8115;2205;6909;412;1401;731;2184;1143;3585
412853;201709;1703;4778;1440;4180;155;498;761;2011;916;2509
412855;201709;1203;3475;882;2714;171;595;186;468;357;1063
412860;201709;951;2803;756;2393;170;582;264;785;434;1367
412862;201709;693;1725;444;1285;69;222;146;425;215;647
412863;201709;1113;3666;1082;3612;101;363;832;2746;933;3109
412865;201709;700;2016;511;1641;95;310;168;560;263;870
412870;201709;852;2412;674;2117;235;813;126;412;361;1225
412880;201709;812;2398;586;1871;117;417;82;233;199;650
420005;201709;449;1334;262;892;39;141;96;319;135;460
420010;201709;2935;7919;2259;6931;249;806;1572;4846;1821;5652
420020;201709;562;1813;340;1248;49;228;44;126;93;354
420030;201709;274;732;145;502;34;137;18;68;52;205
420040;201709;614;1931;340;1299;58;244;16;46;74;290
420050;201709;656;1764;422;1303;75;247;211;628;286;875
420055;201709;173;534;98;351;19;84;25;83;44;167
420060;201709;146;484;107;383;19;84;19;46;38;130
420070;201709;1057;3410;788;2745;171;648;272;964;443;1612
420075;201709;137;363;70;215;12;37;11;20;23;57
420080;201709;479;1475;373;1261;111;381;102;330;213;711
420090;201709;367;1284;259;985;65;251;49;193;114;444
420100;201709;1050;3228;960;3091;131;450;665;2133;796;2583
420110;201709;261;875;245;839;74;269;70;217;144;486
420120;201709;251;822;192;682;55;229;60;180;115;409
420125;201709;294;1025;263;961;63;260;128;453;191;713
420127;201709;304;861;104;369;24;97;14;34;38;131
420130;201709;1684;5522;1297;4718;350;1390;307;1022;657;2412
420140;201709;3361;9913;2465;8200;607;2276;361;1077;968;3353
420150;201709;456;1242;309;1003;35;138;157;476;192;614
420160;201709;214;582;110;368;17;67;34;107;51;174
420165;201709;182;546;106;354;25;94;31;96;56;190
420170;201709;198;623;129;473;37;162;14;46;51;208
420180;201709;266;799;147;524;23;89;41;139;64;228
420190;201709;223;747;137;518;31;120;16;54;47;174
420195;201709;1164;3433;933;3004;247;897;153;465;400;1362
420200;201709;2449;7274;1460;5102;285;1154;299;931;584;2085
420205;201709;1134;3480;868;2961;149;552;469;1609;618;2161
420207;201709;1371;3939;914;3026;230;844;222;711;452;1555
420208;201709;486;1290;261;903;48;198;110;391;158;589
420209;201709;190;614;127;461;34;138;51;176;85;314
420210;201709;1960;5580;1261;4401;296;1185;508;1673;804;2858
420213;201709;718;2484;670;2382;183;708;313;1108;496;1816
420215;201709;269;857;176;648;56;200;16;72;72;272
420220;201709;168;591;138;530;41;182;39;139;80;321
420230;201709;3185;9535;2502;8291;482;1852;1081;3400;1563;5252
420240;201709;10252;28418;6650;21441;948;3605;3255;9518;4203;13123
420243;201709;511;1509;394;1283;80;273;143;462;223;735
420245;201709;1171;3319;798;2597;102;402;380;1143;482;1545
420250;201709;448;1409;392;1297;86;314;180;569;266;883
420253;201709;494;1306;368;1119;33;96;195;592;228;688
420257;201709;246;667;143;473;27;90;66;220;93;310
420260;201709;1006;3183;791;2794;139;559;368;1289;507;1848
420270;201709;529;1486;220;723;22;83;65;194;87;277
420280;201709;1686;4564;997;3296;201;718;277;877;478;1595
420285;201709;107;301;51;188;10;39;5;11;15;50
420287;201709;434;1205;326;1032;107;364;95;296;202;660
420290;201709;4315;13212;3211;10615;630;2261;1047;3123;1677;5384
420300;201709;5936;17274;3673;12419;785;2994;781;2363;1566;5357
420310;201709;706;1827;446;1265;56;174;302;828;358;1002
420315;201709;812;2573;625;2180;175;649;224;767;399;1416
420320;201709;3667;11361;3021;10159;996;3691;728;2303;1724;5994
420325;201709;187;615;152;540;37;133;45;158;82;291
420330;201709;819;2696;594;2139;127;498;181;610;308;1108
420340;201709;1177;3553;839;2807;161;577;55;179;216;756
420350;201709;1362;3937;970;3131;174;607;497;1581;671;2188
420360;201709;2501;7526;1463;5187;304;1202;133;479;437;1681
420370;201709;1339;3829;1102;3432;136;508;792;2393;928;2901
420380;201709;4881;14097;3180;10520;740;2626;870;2830;1610;5456
420390;201709;1019;2708;652;1936;114;379;220;487;334;866
420395;201709;1061;3233;703;2440;107;408;76;235;183;643
420400;201709;944;2812;637;2165;124;476;140;441;264;917
420410;201709;567;1552;408;1268;43;158;288;886;331;1044
420415;201709;361;1121;274;927;87;315;74;241;161;556
420417;201709;666;2110;531;1782;115;415;202;661;317;1076
420419;201709;248;840;175;663;56;239;10;35;66;274
420420;201709;9097;26863;7060;23017;2612;9173;1405;4228;4017;13401
420425;201709;880;2317;616;1833;62;236;277;762;339;998
420430;201709;2965;8863;1915;6390;432;1545;567;1742;999;3287
420435;201709;230;696;133;479;36;162;41;129;77;291
420440;201709;692;2050;378;1262;126;472;101;294;227;766
420445;201709;333;957;212;683;43;142;63;192;106;334
420450;201709;654;1991;462;1566;100;369;130;384;230;753
420455;201709;1797;5102;1434;4473;221;803;708;2104;929;2907
420460;201709;7834;22328;5930;18967;1204;4388;2376;7209;3580;11597
420470;201709;850;2233;456;1468;92;324;111;314;203;638
420475;201709;62;189;42;147;13;43;5;16;18;59
420480;201709;4315;12112;2998;9692;666;2319;824;2624;1490;4943
420490;201709;558;1474;295;1012;69;256;62;224;131;480
420500;201709;1281;3919;900;3138;234;887;270;928;504;1815
420510;201709;113;393;87;323;18;74;45;157;63;231
420515;201709;48;138;38;123;6;24;14;44;20;68
420517;201709;724;2141;653;2021;56;183;491;1511;547;1694
420519;201709;374;989;244;767;44;158;67;199;111;357
420520;201709;502;1323;235;796;32;104;28;70;60;174
420530;201709;990;3020;713;2422;153;578;192;572;345;1150
420535;201709;248;706;113;384;26;91;11;38;37;129
420540;201709;19387;52715;13328;40480;2805;9402;4035;10652;6840;20054
420543;201709;295;780;231;660;50;128;117;326;167;454
420545;201709;1288;4023;1043;3495;247;881;336;1095;583;1976
420550;201709;3223;9765;2237;7850;576;2330;544;1953;1120;4283
420555;201709;311;932;233;777;42;143;83;268;125;411
420560;201709;428;1208;313;998;53;166;174;545;227;711
420570;201709;1993;6157;1553;5219;342;1310;596;1847;938;3157
420580;201709;1605;4508;1256;3955;269;987;605;1811;874;2798
420590;201709;2865;8317;1767;5848;353;1283;296;798;649;2081
420600;201709;870;2773;757;2530;135;468;416;1399;551;1867
420610;201709;449;1353;248;894;61;236;54;186;115;422
420620;201709;461;1402;396;1279;121;411;117;370;238;781
420630;201709;754;2323;591;1937;132;478;253;762;385;1240
420640;201709;661;1916;305;1103;85;347;24;69;109;416
420650;201709;2316;6673;1499;4992;273;975;425;1277;698;2252
420660;201709;399;1171;273;911;53;194;65;206;118;400
420665;201709;504;1399;355;1144;60;231;151;445;211;676
420670;201709;1447;4204;1032;3354;189;739;301;861;490;1600
420675;201709;147;480;108;377;27;121;19;47;46;168
420680;201709;323;821;196;635;37;127;78;235;115;362
420690;201709;732;2520;521;1914;91;347;85;253;176;600
420700;201709;2760;8060;2166;6886;398;1420;830;2511;1228;3931
420710;201709;566;1817;427;1510;91;392;159;517;250;909
420720;201709;1384;3944;1056;3470;301;1033;438;1431;739;2464
420730;201709;2629;7597;2092;6710;408;1422;1003;3124;1411;4546
420740;201709;732;2232;525;1798;141;524;122;393;263;917
420750;201709;1743;5507;1278;4465;203;791;420;1321;623;2112
420757;201709;79;183;24;93;4;20;9;31;13;51
420760;201709;366;1132;168;574;36;118;15;54;51;172
420765;201709;479;1534;250;933;48;193;57;211;105;404
420768;201709;1104;3679;929;3332;297;1061;477;1758;774;2819
420770;201709;504;1382;244;890;50;210;52;187;102;397
420775;201709;562;1644;309;1052;69;253;44;128;113;381
420780;201709;1085;3224;637;2197;126;467;142;454;268;921
420785;201709;169;500;129;405;27;87;39;108;66;195
420790;201709;1016;3413;804;2987;213;854;326;1154;539;2008
420800;201709;731;1984;352;1159;79;293;107;330;186;623
420810;201709;1627;5547;1337;4900;442;1826;296;967;738;2793
420820;201709;7964;22476;5466;18377;1291;4822;1680;5395;2971;10217
420830;201709;2635;7965;2123;6987;555;1999;726;2316;1281;4315
420840;201709;824;2386;384;1359;75;286;62;199;137;485
420845;201709;1419;3993;896;3017;214;837;231;761;445;1598
420850;201709;1180;3884;739;2775;182;758;72;238;254;996
420860;201709;290;806;181;610;45;179;41;130;86;309
420870;201709;849;2414;664;2104;256;909;191;552;447;1461
420880;201709;851;2822;667;2365;153;611;138;420;291;1031
420890;201709;7838;21569;4218;14033;747;2740;1004;2921;1751;5661
420895;201709;170;507;100;326;30;109;30;83;60;192
420900;201709;1423;3918;900;2953;181;697;283;815;464;1512
420910;201709;21615;62182;14796;49038;2633;9915;4969;15142;7602;25057
420915;201709;480;1891;335;1443;65;291;148;595;213;886
420917;201709;330;989;184;577;29;95;84;247;113;342
420920;201709;124;365;52;189;4;17;7;22;11;39
420930;201709;16468;45854;12267;38556;2373;8181;5138;15455;7511;23636
420940;201709;2356;6740;1680;5434;446;1574;107;309;553;1883
420945;201709;149;467;109;373;27;105;37;117;64;222
420950;201709;418;1189;228;788;29;127;68;228;97;355
420960;201709;822;2315;614;1933;128;463;218;623;346;1086
420970;201709;2450;7385;1814;6162;552;1991;311;1094;863;3085
420980;201709;369;1111;289;998;115;421;97;362;212;783
420985;201709;380;1110;180;657;34;146;60;204;94;350
420990;201709;520;1522;298;1052;56;209;41;122;97;331
421000;201709;434;1497;299;1140;58;239;56;159;114;398
421003;201709;476;1250;182;602;20;65;23;58;43;123
421005;201709;113;353;83;297;19;77;40;154;59;231
421010;201709;3898;11032;2781;9062;669;2434;609;1786;1278;4220
421020;201709;394;1195;302;1037;27;105;196;682;223;787
421030;201709;688;2362;580;2092;195;778;113;377;308;1155
421040;201709;796;1933;494;1459;62;219;272;783;334;1002
421050;201709;1300;3684;746;2461;155;551;200;604;355;1155
421055;201709;176;490;88;293;20;64;23;73;43;137
421060;201709;492;1559;345;1200;71;283;124;417;195;700
421070;201709;551;1743;350;1233;79;301;45;147;124;448
421080;201709;657;2743;600;2650;74;244;462;2189;536;2433
421085;201709;435;1229;195;684;37;142;44;140;81;282
421090;201709;352;949;164;526;16;52;40;118;56;170
421100;201709;890;2313;450;1377;105;340;46;125;151;465
421105;201709;1292;3835;1038;3433;187;650;466;1623;653;2273
421110;201709;867;2895;767;2692;180;677;379;1287;559;1964
421120;201709;1047;3380;723;2633;103;436;184;579;287;1015
421125;201709;338;912;245;764;69;235;74;196;143;431
421130;201709;2944;9558;2552;8796;702;2613;1113;3840;1815;6453
421140;201709;274;790;206;653;37;115;87;258;124;373
421145;201709;456;1346;278;901;51;176;111;348;162;524
421150;201709;430;1242;313;1050;59;232;120;378;179;610
421160;201709;809;2168;442;1422;79;292;193;606;272;898
421165;201709;194;644;156;556;20;63;76;287;96;350
421170;201709;1123;3123;869;2730;134;438;531;1677;665;2115
421175;201709;1078;3026;734;2396;144;561;266;770;410;1331
421180;201709;430;1105;198;637;46;171;33;96;79;267
421185;201709;323;867;225;682;46;138;108;337;154;475
421187;201709;335;999;224;739;33;112;85;259;118;371
421189;201709;356;1126;279;946;50;182;87;265;137;447
421190;201709;9105;25862;5735;19441;1205;4560;928;2932;2133;7492
421200;201709;762;2432;632;2179;139;514;237;787;376;1301
421205;201709;182;517;133;417;29;111;51;147;80;258
421210;201709;1034;3045;756;2477;191;657;256;835;447;1492
421220;201709;1457;4869;1248;4382;349;1356;184;561;533;1917
421223;201709;430;1333;297;1064;52;200;120;432;172;632
421225;201709;978;3139;835;2824;182;676;390;1345;572;2021
421227;201709;815;2306;567;1855;109;399;295;944;404;1343
421230;201709;413;1290;339;1153;94;341;120;401;214;742
421240;201709;328;1031;158;592;20;97;16;57;36;154
421250;201709;1376;3842;863;2955;219;811;191;657;410;1468
421260;201709;277;782;59;216;10;32;10;39;20;71
421265;201709;695;2086;625;1976;82;311;432;1332;514;1643
421270;201709;452;1279;241;846;46;152;67;233;113;385
421280;201709;1433;4498;1145;3947;265;1038;498;1673;763;2711
421290;201709;831;2341;490;1577;90;314;87;242;177;556
421300;201709;219;654;153;516;42;169;50;153;92;322
421310;201709;170;530;132;435;28;105;45;139;73;244
421315;201709;255;769;151;538;24;86;18;70;42;156
421320;201709;619;1876;364;1230;70;239;65;161;135;400
421330;201709;551;1752;412;1474;106;400;105;375;211;775
421335;201709;388;1308;320;1161;72;306;71;265;143;571
421340;201709;1330;3784;1076;3384;173;634;554;1705;727;2339
421350;201709;961;3067;776;2691;122;527;404;1326;526;1853
421360;201709;2381;6800;1474;4983;332;1346;474;1418;806;2764
421370;201709;426;1472;322;1203;87;343;83;310;170;653
421380;201709;762;2219;659;2035;107;354;352;1032;459;1386
421390;201709;165;459;70;237;19;72;20;61;39;133
421400;201709;241;818;175;689;56;244;67;243;123;487
421410;201709;213;637;118;438;16;70;49;182;65;252
421415;201709;336;1057;151;533;33;128;25;78;58;206
421420;201709;627;1854;484;1572;73;269;230;700;303;969
421430;201709;153;505;119;429;19;71;32;109;51;180
421440;201709;657;1904;457;1559;84;323;213;715;297;1038
421450;201709;377;1157;223;796;34;147;22;75;56;222
421460;201709;471;1366;275;984;61;230;69;245;130;475
421470;201709;279;904;210;762;47;204;61;208;108;412
421480;201709;2551;7091;1720;5677;611;2321;268;720;879;3041
421490;201709;208;590;102;364;20;76;18;55;38;131
421500;201709;1771;5962;1381;5094;401;1630;150;514;551;2144
421505;201709;298;956;264;896;49;167;142;483;191;650
421507;201709;429;1274;284;979;75;280;73;241;148;521
421510;201709;189;593;145;491;33;108;65;194;98;302
421520;201709;602;1692;372;1165;55;202;157;443;212;645
421530;201709;247;807;159;581;35;158;38;111;73;269
421535;201709;504;1489;316;1103;38;152;149;478;187;630
421540;201709;220;595;154;483;35;123;60;175;95;298
421545;201709;672;2066;486;1698;115;456;167;565;282;1021
421550;201709;1871;5708;1603;5258;405;1513;674;2094;1079;3607
421555;201709;251;727;75;273;15;67;9;25;24;92
421560;201709;116;357;61;225;12;45;9;36;21;81
421565;201709;655;1879;516;1654;131;470;227;742;358;1212
421567;201709;487;1749;388;1488;186;744;83;328;269;1072
421568;201709;493;1479;322;1094;61;230;103;335;164;565
421569;201709;221;657;105;375;19;62;17;66;36;128
421570;201709;1059;3082;676;2243;176;613;108;326;284;939
421575;201709;328;1022;284;903;48;164;142;424;190;588
421580;201709;2616;8227;1962;6795;447;1766;596;1824;1043;3590
421590;201709;156;487;128;439;16;60;74;241;90;301
421600;201709;453;1365;326;1071;79;268;75;228;154;496
421605;201709;556;1697;390;1382;75;299;120;409;195;708
421610;201709;1204;3284;797;2503;148;521;225;681;373;1202
421620;201709;3686;10838;2313;8072;668;2497;527;1831;1195;4328
421625;201709;312;861;118;409;23;76;18;61;41;137
421630;201709;2592;7496;1437;4818;284;1093;264;775;548;1868
421635;201709;167;495;92;305;16;63;28;76;44;139
421640;201709;904;2587;627;2066;135;462;204;661;339;1123
421650;201709;2010;6221;1396;4869;323;1302;210;576;533;1878
421660;201709;6410;20568;5382;18502;1078;4081;1899;6062;2977;10143
421670;201709;871;2568;606;1990;153;581;199;615;352;1196
421680;201709;958;3051;777;2666;262;950;203;669;465;1619
421690;201709;1208;3900;894;3152;209;825;167;551;376;1376
421700;201709;443;1447;244;920;45;181;63;212;108;393
421710;201709;192;614;78;270;16;63;26;83;42;146
421715;201709;180;455;88;276;19;63;43;132;62;195
421720;201709;1788;5182;1063;3703;262;1008;230;742;492;1750
421725;201709;146;406;98;317;25;93;33;92;58;185
421730;201709;406;1196;217;697;37;128;62;177;99;305
421740;201709;583;1840;417;1444;101;403;96;310;197;713
421750;201709;853;2154;487;1471;67;216;174;473;241;689
421755;201709;252;705;136;429;18;66;50;143;68;209
421760;201709;909;2671;474;1641;80;289;90;280;170;569
421770;201709;2412;6986;1791;5838;446;1504;611;2124;1057;3628
421775;201709;344;968;232;769;36;129;94;299;130;428
421780;201709;839;2833;620;2315;136;574;165;560;301;1134
421790;201709;634;1680;375;1282;163;591;107;337;270;928
421795;201709;290;853;173;553;27;98;55;163;82;261
421800;201709;2296;6879;1739;5826;403;1469;700;2230;1103;3699
421810;201709;617;1770;437;1417;97;369;147;429;244;798
421820;201709;800;2337;440;1517;81;302;56;167;137;469
421825;201709;1265;3921;1188;3788;157;569;829;2570;986;3139
421830;201709;2210;7387;1933;6819;496;1940;623;2051;1119;3991
421835;201709;182;513;119;409;22;90;65;205;87;295
421840;201709;229;720;162;576;39;154;56;188;95;342
421850;201709;398;1230;225;798;41;162;52;160;93;322
421860;201709;259;815;174;629;32;133;53;162;85;295
421870;201709;3164;8793;2207;6884;555;1917;655;1914;1210;3831
421875;201709;367;1059;162;575;28;101;16;47;44;148
421880;201709;622;1879;460;1541;116;411;84;290;200;701
421885;201709;244;735;192;649;62;225;46;135;108;360
421890;201709;729;2458;608;2212;187;762;204;681;391;1443
421895;201709;325;1002;294;953;46;167;197;635;243;802
421900;201709;825;2257;554;1721;120;406;204;601;324;1007
421910;201709;382;1220;276;978;57;242;57;169;114;411
421915;201709;450;1338;275;920;56;180;42;131;98;311
421917;201709;542;1518;361;1252;118;453;85;294;203;747
421920;201709;554;1617;362;1329;176;647;110;435;286;1082
421930;201709;2417;6449;1243;4218;350;1289;154;486;504;1775
421935;201709;492;1612;385;1399;86;355;164;552;250;907
421940;201709;191;637;117;424;22;98;33;106;55;204
421950;201709;2991;7962;1416;4733;310;1153;192;626;502;1779
421960;201709;157;437;109;359;19;78;23;77;42;155
421970;201709;2018;5421;1113;3584;277;952;260;751;537;1703
421985;201709;352;894;190;584;33;127;53;174;86;301
422000;201709;1407;4100;1184;3693;223;807;623;1899;846;2706
430003;201709;486;1565;411;1426;110;436;129;415;239;851
430005;201709;300;842;196;638;52;172;84;263;136;435
430010;201709;1764;4768;1381;4102;266;876;703;2061;969;2937
430020;201709;594;1468;487;1327;80;252;292;754;372;1006
430030;201709;1000;2545;630;1863;182;560;162;482;344;1042
430040;201709;9616;25432;6294;19043;1597;5426;325;1032;1922;6458
430045;201709;588;1587;418;1223;54;168;195;547;249;715
430047;201709;279;650;123;369;21;67;35;99;56;166
430050;201709;937;2543;536;1669;119;369;124;365;243;734
430055;201709;285;733;129;393;10;33;63;181;73;214
430057;201709;56;141;31;91;8;27;6;11;14;38
430060;201709;15240;47139;12956;43314;3583;12877;4931;16692;8514;29569
430063;201709;866;2530;689;2135;165;502;356;1110;521;1612
430064;201709;1034;3091;787;2560;222;767;211;666;433;1433
430066;201709;133;314;90;244;6;21;56;144;62;165
430070;201709;651;1736;140;474;17;62;10;21;27;83
430080;201709;684;1860;400;1282;81;296;144;405;225;701
430085;201709;897;2253;541;1619;99;317;170;527;269;844
430087;201709;622;1949;527;1775;101;383;250;800;351;1183
430090;201709;648;1706;224;733;23;90;56;186;79;276
430100;201709;714;1827;365;1162;77;253;112;317;189;570
430105;201709;939;2667;638;2115;129;477;269;880;398;1357
430107;201709;197;623;141;478;21;76;36;110;57;186
430110;201709;1788;4960;1432;4419;275;883;709;2118;984;3001
430120;201709;1347;4117;914;3090;209;725;379;1333;588;2058
430130;201709;3832;10792;3213;9818;985;2769;1186;4331;2171;7100
430140;201709;991;2988;637;2172;162;555;215;729;377;1284
430150;201709;674;1753;394;1200;86;292;98;298;184;590
430155;201709;291;804;166;534;26;92;37;107;63;199
430160;201709;15662;44032;13448;40392;3459;10907;4811;15147;8270;26054
430163;201709;1874;5299;1509;4688;206;720;899;2779;1105;3499
430165;201709;395;939;97;316;11;35;10;30;21;65
430170;201709;880;2501;334;1198;67;246;49;156;116;402
430175;201709;708;2285;601;2009;153;503;277;939;430;1442
430180;201709;711;1941;585;1712;98;334;334;933;432;1267
430185;201709;442;1133;276;815;46;146;117;301;163;447
430187;201709;596;1681;461;1431;83;287;191;581;274;868
430190;201709;1369;4145;1181;3761;260;873;534;1664;794;2537
430192;201709;141;434;59;189;9;29;8;24;17;53
430195;201709;368;1113;80;257;11;38;5;12;16;50
430200;201709;1188;3756;991;3351;301;1058;298;989;599;2047
430205;201709;490;1419;389;1209;27;103;298;899;325;1002
430210;201709;5129;13466;3421;9905;509;1682;1320;3111;1829;4793
430215;201709;322;879;223;674;44;147;89;252;133;399
430220;201709;644;1634;205;668;32;106;39;112;71;218
430222;201709;221;684;178;588;26;94;77;234;103;328
430223;201709;290;820;241;726;46;143;115;351;161;494
430225;201709;33;83;12;37;3;7;3;6;6;13
430230;201709;1431;4310;1360;4221;289;818;960;3115;1249;3933
430235;201709;212;674;170;569;23;91;63;206;86;297
430237;201709;523;1323;376;1072;33;110;229;615;262;725
430240;201709;938;2293;641;1823;77;247;362;1003;439;1250
430245;201709;739;2265;572;1935;188;628;234;833;422;1461
430250;201709;1002;2871;856;2629;254;842;54;150;308;992
430258;201709;126;346;93;289;8;29;46;145;54;174
430260;201709;624;1763;460;1431;84;262;223;726;307;988
430265;201709;228;696;172;592;39;134;33;119;72;253
430270;201709;2477;6883;2143;6343;268;873;1369;3975;1637;4848
430280;201709;4417;11546;3453;9848;792;2310;1478;4229;2270;6539
430290;201709;2245;5858;2054;5579;97;317;1762;4723;1859;5040
430300;201709;8080;23036;6681;20437;1407;4637;3083;9421;4490;14058
430310;201709;6213;18033;4754;15194;938;3350;2053;6202;2991;9552
430320;201709;841;2426;491;1639;104;309;217;791;321;1100
430330;201709;622;1591;440;1243;123;359;181;454;304;813
430340;201709;705;1677;360;1089;67;219;174;509;241;728
430350;201709;5619;16584;4690;14654;1480;4809;1648;4960;3128;9769
430355;201709;346;854;119;368;22;74;12;36;34;110
430360;201709;785;2114;597;1765;126;399;206;574;332;973
430367;201709;231;636;148;467;37;138;51;153;88;291
430370;201709;470;1326;274;907;61;219;61;181;122;400
430380;201709;670;1726;372;1176;122;421;95;295;217;716
430390;201709;3037;8249;1768;5630;280;992;122;325;402;1317
430400;201709;1138;2686;859;2242;186;488;477;1212;663;1700
430410;201709;587;1513;411;1210;58;200;232;666;290;866
430420;201709;3003;8617;2335;7105;691;2212;761;2231;1452;4443
430430;201709;592;1600;344;1091;87;301;66;192;153;493
430435;201709;1694;4560;1243;3747;333;1035;339;1044;672;2079
430440;201709;3314;10287;2611;8702;598;2116;1164;3980;1762;6096
430450;201709;6306;17560;5228;15505;1384;4344;1840;5494;3224;9838
430460;201709;23347;68417;17985;59143;4564;16556;5975;19200;10539;35756
430461;201709;463;1201;138;439;18;59;33;97;51;156
430462;201709;273;748;177;584;29;103;36;132;65;235
430463;201709;4038;12462;3396;11302;687;2485;1646;5534;2333;8019
430465;201709;503;1361;419;1206;85;259;245;691;330;950
430466;201709;3432;9023;2918;8218;673;2027;1505;4025;2178;6052
430467;201709;435;1236;359;1086;60;201;165;460;225;661
430468;201709;1181;3309;995;3007;163;542;548;1630;711;2172
430469;201709;539;1524;55;189;6;13;11;27;17;40
430470;201709;6335;17249;4581;14269;1471;4800;850;2752;2321;7552
430471;201709;461;1559;418;1457;103;371;154;529;257;900
430480;201709;901;2435;471;1528;79;271;74;222;153;493
430485;201709;144;422;63;210;9;35;15;44;24;79
430490;201709;306;881;188;619;31;112;84;291;115;403
430495;201709;371;1074;241;807;38;144;88;273;126;417
430500;201709;1050;2865;834;2504;203;686;354;998;557;1684
430510;201709;20858;58787;15860;48959;4180;14042;5026;14471;9206;28513
430511;201709;348;1061;142;498;24;78;14;41;38;119
430512;201709;920;2354;785;2124;217;604;236;669;453;1273
430513;201709;788;2058;423;1250;107;342;150;411;257;753
430515;201709;404;1162;288;926;55;158;135;455;190;613
430517;201709;1044;3273;843;2865;155;538;398;1385;553;1923
430520;201709;1326;3573;762;2391;144;484;154;450;298;934
430530;201709;1099;2876;433;1349;83;255;100;297;183;552
430535;201709;2478;7187;1840;5938;348;1201;754;2395;1102;3596
430537;201709;398;1337;329;1155;42;151;230;806;272;957
430540;201709;600;1348;373;1026;68;186;212;573;280;759
430543;201709;472;1103;394;1017;71;161;265;715;336;876
430544;201709;608;1915;478;1608;120;429;217;698;337;1127
430545;201709;1311;4182;1137;3906;316;1154;503;1756;819;2910
430550;201709;538;1514;303;994;65;226;50;138;115;364
430558;201709;70;217;45;153;12;43;13;37;25;80
430560;201709;404;952;175;529;15;56;49;135;64;191
430570;201709;947;2345;619;1746;91;324;320;805;411;1129
430580;201709;1148;2822;719;2122;114;379;345;984;459;1363
430583;201709;176;459;36;113;4;13;6;21;10;34
430585;201709;256;635;143;414;26;87;60;151;86;238
430587;201709;161;509;124;413;29;103;48;169;77;272
430590;201709;1250;3293;1122;3071;72;231;937;2524;1009;2755
430593;201709;17;63;15;56;4;18;7;25;11;43
430595;201709;277;800;75;271;7;34;11;38;18;72
430597;201709;309;895;212;658;19;71;76;200;95;271
430600;201709;1756;4759;888;2761;157;493;227;667;384;1160
430605;201709;1163;3441;904;2901;149;580;360;1141;509;1721
430607;201709;681;1578;494;1297;46;138;314;838;360;976
430610;201709;6173;16382;4667;14059;1415;4645;832;2577;2247;7222
430613;201709;286;682;96;297;4;15;29;74;33;89
430620;201709;583;1609;474;1397;125;408;206;579;331;987
430630;201709;452;1317;138;450;24;80;25;74;49;154
430632;201709;591;1640;276;865;33;112;103;292;136;404
430635;201709;562;1586;422;1291;73;250;244;724;317;974
430637;201709;434;1213;378;1111;57;198;215;588;272;786
430640;201709;1292;3445;667;2117;95;310;145;410;240;720
430642;201709;404;1094;270;827;47;143;117;360;164;503
430645;201709;273;619;100;279;17;49;28;79;45;128
430650;201709;1604;5149;1362;4634;328;1170;706;2428;1034;3598
430655;201709;140;357;114;320;28;83;50;128;78;211
430660;201709;4837;13418;3859;11708;885;2850;1672;5058;2557;7908
430670;201709;471;1316;394;1174;42;142;261;781;303;923
430673;201709;653;1554;272;822;56;167;82;244;138;411
430675;201709;225;666;59;208;10;45;13;39;23;84
430676;201709;3373;9737;2707;8521;554;1851;1123;3539;1677;5390
430680;201709;961;2696;585;1915;125;405;112;355;237;760
430690;201709;3359;9721;2822;8668;855;2784;725;2230;1580;5014
430692;201709;221;723;170;629;14;59;115;434;129;493
430693;201709;1055;2832;612;1908;135;458;116;325;251;783
430695;201709;534;1355;333;969;49;163;177;493;226;656
430697;201709;401;1103;288;906;60;184;120;411;180;595
430700;201709;7670;19602;4067;12956;818;2873;473;1515;1291;4388
430705;201709;250;740;165;538;30;102;43;135;73;237
430710;201709;1530;3862;1189;3273;234;728;539;1439;773;2167
430720;201709;678;1714;438;1335;115;350;136;428;251;778
430730;201709;1420;3718;909;2838;154;494;410;1321;564;1815
430740;201709;601;1700;338;1135;61;215;80;286;141;501
430745;201709;482;1376;243;796;36;123;45;149;81;272
430750;201709;1387;3761;1044;3174;204;683;522;1546;726;2229
430755;201709;471;1208;297;859;27;88;154;399;181;487
430760;201709;2169;5537;1594;4644;376;1206;613;1857;989;3063
430770;201709;5412;15444;4357;13562;791;2666;2339;7129;3130;9795
430780;201709;2045;5440;1320;4146;251;833;441;1428;692;2261
430781;201709;401;1190;262;869;55;193;59;193;114;386
430783;201709;497;1194;291;841;38;123;141;381;179;504
430786;201709;59;202;42;158;8;28;9;34;17;62
430790;201709;3763;10399;2645;8096;529;1783;1183;3446;1712;5229
430800;201709;800;2190;553;1667;83;291;276;790;359;1081
430805;201709;517;1425;309;945;38;111;153;451;191;562
430807;201709;406;1082;271;820;34;122;105;303;139;425
430810;201709;701;1919;259;903;48;163;62;209;110;372
430820;201709;1263;3541;698;2342;153;538;131;433;284;971
430825;201709;302;821;114;346;28;75;23;56;51;131
430830;201709;1512;4677;1345;4400;160;580;919;3020;1079;3600
430840;201709;871;2598;757;2389;172;530;391;1243;563;1773
430843;201709;108;272;34;102;6;15;9;27;15;42
430845;201709;287;792;212;651;89;292;26;67;115;359
430850;201709;2138;6171;1810;5577;432;1446;837;2564;1269;4010
430860;201709;896;2273;436;1344;75;281;175;489;250;770
430865;201709;533;1403;470;1297;144;419;209;559;353;978
430870;201709;698;1888;323;1071;62;220;79;234;141;454
430880;201709;974;2680;713;2186;201;633;245;754;446;1387
430885;201709;230;546;121;383;11;37;88;278;99;315
430890;201709;1337;3596;896;2716;60;269;128;341;188;610
430900;201709;2556;6494;1887;5414;343;1094;902;2485;1245;3579
430905;201709;811;2318;557;1792;120;423;149;454;269;877
430910;201709;1381;3955;927;2972;194;738;361;1033;555;1771
430912;201709;474;1359;346;1130;40;139;217;719;257;858
430915;201709;525;1631;384;1380;103;374;139;541;242;915
430920;201709;17203;49865;14772;45494;2521;8554;8378;25085;10899;33639
430925;201709;130;292;56;157;8;20;18;56;26;76
430930;201709;8326;22274;5485;17307;1495;4986;1269;4268;2764;9254
430940;201709;1170;3537;668;2273;175;625;94;279;269;904
430950;201709;763;2025;515;1530;99;318;226;613;325;931
430955;201709;157;431;57;183;13;39;9;27;22;66
430957;201709;206;713;183;661;33;113;89;329;122;442
430960;201709;1337;3343;953;2686;199;638;476;1336;675;1974
430965;201709;1475;3955;1190;3446;80;287;922;2567;1002;2854
430970;201709;375;1020;200;646;26;87;88;273;114;360
430975;201709;497;1640;383;1362;88;337;142;502;230;839
430980;201709;363;923;221;672;48;154;81;248;129;402
430990;201709;517;1557;325;1077;60;224;124;395;184;619
430995;201709;614;1712;439;1381;98;309;191;571;289;880
431000;201709;1416;3501;643;1939;107;350;33;80;140;430
431010;201709;2263;6241;1321;4450;224;835;101;292;325;1127
431020;201709;8865;21182;5774;16116;1394;4143;1595;4260;2989;8403
431030;201709;324;910;139;488;33;112;16;61;49;173
431033;201709;2259;6941;1958;6440;520;1787;770;2660;1290;4447
431036;201709;194;511;64;202;5;11;15;41;20;52
431040;201709;900;2427;625;1947;113;416;300;864;413;1280
431041;201709;455;1121;381;1020;73;197;198;529;271;726
431043;201709;426;1129;218;736;83;289;52;165;135;454
431046;201709;127;344;63;186;7;21;13;37;20;58
431050;201709;1550;3898;1100;3163;241;710;513;1481;754;2191
431053;201709;474;1457;369;1242;115;406;86;292;201;698
431055;201709;625;1633;567;1543;52;151;417;1122;469;1273
431057;201709;268;804;161;530;35;126;46;135;81;261
431060;201709;4868;14301;4048;12775;1334;4567;825;2757;2159;7324
431065;201709;486;1351;334;1062;59;192;87;273;146;465
431070;201709;577;1685;322;1075;87;311;46;117;133;428
431075;201709;205;652;154;546;31;119;52;189;83;308
431080;201709;641;1884;442;1445;87;301;136;428;223;729
431085;201709;681;1894;531;1563;81;223;310;910;391;1133
431087;201709;474;1375;404;1227;31;93;275;848;306;941
431090;201709;469;1145;184;579;37;131;38;112;75;243
431100;201709;2977;7914;2381;6944;589;1860;864;2467;1453;4327
431110;201709;1343;3434;1008;2775;269;747;367;962;636;1709
431112;201709;508;1624;448;1504;100;331;228;756;328;1087
431113;201709;393;1144;322;1005;106;342;101;330;207;672
431115;201709;1181;3385;949;2974;163;575;522;1581;685;2156
431120;201709;2418;7259;1794;5957;560;2103;468;1408;1028;3511
431123;201709;402;1151;260;849;63;199;111;376;174;575
431125;201709;1222;3660;855;2860;271;913;205;764;476;1677
431127;201709;262;718;60;202;7;19;11;30;18;49
431130;201709;3026;8705;2066;6756;468;1607;625;2071;1093;3678
431140;201709;4457;11092;2504;7468;356;1152;833;2241;1189;3393
431142;201709;472;1358;378;1186;60;198;225;701;285;899
431150;201709;963;2852;728;2349;169;571;264;859;433;1430
431160;201709;744;2122;598;1841;143;415;218;742;361;1157
431162;201709;489;1180;212;659;26;94;45;121;71;215
431164;201709;155;426;50;172;9;37;6;20;15;57
431170;201709;602;1632;403;1257;111;367;111;329;222;696
431171;201709;661;1845;569;1677;104;321;304;875;408;1196
431173;201709;426;1214;323;1029;127;428;67;212;194;640
431175;201709;865;2390;660;2012;183;576;136;400;319;976
431177;201709;695;2189;505;1824;160;616;172;611;332;1227
431179;201709;335;693;69;191;10;31;14;30;24;61
431180;201709;1937;5293;1262;3971;302;1030;234;733;536;1763
431190;201709;479;1310;268;848;41;140;50;131;91;271
431198;201709;326;1073;291;1001;101;362;88;327;189;689
431200;201709;384;1054;100;335;12;31;0;0;12;31
431205;201709;233;668;98;351;24;89;41;146;65;235
431210;201709;664;1759;560;1605;149;412;275;821;424;1233
431213;201709;220;695;176;605;22;80;104;358;126;438
431215;201709;261;826;181;622;28;107;61;192;89;299
431217;201709;148;439;95;327;16;57;42;141;58;198
431220;201709;716;1972;405;1318;37;142;168;498;205;640
431225;201709;1208;3292;921;2764;183;566;392;1189;575;1755
431230;201709;671;1994;503;1584;93;315;226;698;319;1013
431235;201709;128;354;31;95;7;22;2;4;9;26
431237;201709;421;1253;340;1121;60;232;175;555;235;787
431238;201709;21;70;16;55;6;24;4;11;10;35
431240;201709;3364;9677;2817;8726;693;2362;1157;3467;1850;5829
431242;201709;351;1042;290;921;71;217;115;382;186;599
431244;201709;314;764;163;468;23;83;60;135;83;218
431245;201709;1063;2825;729;2143;150;479;298;852;448;1331
431247;201709;202;578;119;391;21;69;26;78;47;147
431250;201709;1271;3997;1082;3711;257;907;467;1675;724;2582
431260;201709;289;794;142;494;16;74;39;119;55;193
431261;201709;259;849;217;753;44;165;87;293;131;458
431262;201709;397;1128;177;602;14;45;94;325;108;370
431265;201709;1305;3210;602;1823;92;305;180;451;272;756
431267;201709;274;768;153;458;7;27;98;273;105;300
431270;201709;2579;6287;1456;4354;391;1264;404;1237;795;2501
431275;201709;194;576;101;365;22;84;14;40;36;124
431280;201709;270;746;85;294;10;37;13;27;23;64
431290;201709;279;864;204;697;24;97;64;195;88;292
431295;201709;76;214;29;98;3;14;6;15;9;29
431300;201709;351;840;52;189;1;3;7;21;8;24
431301;201709;249;767;72;255;7;20;5;11;12;31
431303;201709;629;1630;359;1087;46;157;127;376;173;533
431306;201709;2030;5116;1212;3656;166;564;403;1117;569;1681
431308;201709;28;94;25;82;12;42;7;22;19;64
431310;201709;615;1793;364;1203;63;216;116;394;179;610
431320;201709;625;1777;315;1093;63;235;49;156;112;391
431330;201709;2028;4998;1021;3162;256;886;142;390;398;1276
431333;201709;347;936;127;383;14;38;35;98;49;136
431335;201709;32;100;22;80;8;29;3;3;11;32
431337;201709;2275;6692;1608;5414;447;1650;264;874;711;2524
431339;201709;492;1336;338;1022;67;217;173;513;240;730
431340;201709;19365;51470;14055;42129;3176;10389;3820;11101;6996;21490
431342;201709;503;1206;374;1004;62;201;260;664;322;865
431344;201709;360;980;240;750;11;39;156;482;167;521
431346;201709;275;694;98;303;14;43;20;63;34;106
431349;201709;734;2029;418;1278;62;200;148;419;210;619
431350;201709;3608;10434;2836;8966;722;2498;918;2785;1640;5283
431360;201709;636;1565;376;1117;79;245;148;426;227;671
431365;201709;1496;4264;1265;3881;154;511;827;2570;981;3081
431370;201709;4201;11588;3288;10040;798;2586;1364;4349;2162;6935
431380;201709;740;2260;655;2111;86;303;394;1270;480;1573
431390;201709;2360;6205;1386;4339;261;913;414;1180;675;2093
431395;201709;1203;3461;921;2969;239;792;362;1194;601;1986
431400;201709;377;1137;183;602;29;90;41;134;70;224
431402;201709;976;2349;645;1768;113;329;356;926;469;1255
431403;201709;151;461;127;416;27;107;69;206;96;313
431405;201709;3677;10301;3025;9317;483;1688;1719;5220;2202;6908
431406;201709;517;1593;418;1410;96;323;226;771;322;1094
431407;201709;456;1290;308;987;66;217;115;352;181;569
431410;201709;12906;36484;8711;28200;2160;7880;2074;6402;4234;14282
431413;201709;161;404;56;184;5;21;11;27;16;48
431415;201709;624;1740;420;1377;99;367;126;372;225;739
431417;201709;464;1196;384;1068;66;202;231;624;297;826
431420;201709;1223;3239;1057;2978;214;619;474;1403;688;2022
431430;201709;505;1330;291;897;51;171;78;224;129;395
431440;201709;19853;53009;15361;45694;4199;13251;4153;13129;8352;26380
431442;201709;98;296;58;197;11;35;3;9;14;44
431445;201709;478;1360;163;541;24;77;31;99;55;176
431446;201709;368;1090;258;822;77;249;52;165;129;414
431447;201709;573;1610;395;1248;79;257;184;566;263;823
431449;201709;712;1937;496;1489;43;138;252;757;295;895
431450;201709;1954;4563;1683;4195;162;452;1267;3056;1429;3508
431454;201709;59;194;51;173;10;36;20;72;30;108
431455;201709;644;1626;336;952;51;152;127;317;178;469
431460;201709;2830;7690;2286;6636;616;1822;745;2215;1361;4037
431470;201709;1616;4636;1172;3677;250;811;414;1300;664;2111
431475;201709;196;560;29;113;3;14;1;1;4;15
431477;201709;577;1483;358;1029;42;120;174;455;216;575
431478;201709;272;714;78;235;15;51;8;19;23;70
431480;201709;2850;7636;2247;6661;369;1204;1228;3592;1597;4796
431490;201709;90484;240332;77381;220548;8657;28408;53937;150306;62594;178714
431500;201709;492;1330;369;1084;79;226;192;556;271;782
431505;201709;429;1075;284;837;27;81;171;508;198;589
431507;201709;335;811;155;442;34;112;59;143;93;255
431510;201709;1577;4451;1211;3709;248;818;465;1405;713;2223
431513;201709;302;766;146;447;17;49;83;254;100;303
431514;201709;84;231;41;129;6;22;12;27;18;49
431515;201709;547;1470;357;1092;75;255;158;445;233;700
431517;201709;72;241;53;185;11;37;10;33;21;70
431520;201709;480;1194;201;652;44;160;43;129;87;289
431530;201709;3833;8911;2475;6925;703;2009;406;1160;1109;3169
431531;201709;205;576;147;468;17;64;46;138;63;202
431532;201709;498;1342;379;1087;86;251;135;389;221;640
431535;201709;248;600;105;320;23;78;42;115;65;193
431540;201709;1892;6233;1747;5999;104;448;1295;4471;1399;4919
431545;201709;369;1016;65;217;5;21;17;52;22;73
431550;201709;1920;5578;1639;5032;379;1245;656;1934;1035;3179
431555;201709;651;1564;444;1224;45;131;272;754;317;885
431560;201709;18475;52054;12875;41965;2729;9859;3294;11443;6023;21302
431570;201709;5286;12963;4090;11371;878;2624;2155;5899;3033;8523
431575;201709;143;457;124;410;24;88;15;34;39;122
431580;201709;474;1292;247;833;50;196;76;253;126;449
431590;201709;836;2200;539;1626;116;367;179;543;295;910
431595;201709;360;1005;250;764;36;96;123;368;159;464
431600;201709;1618;4344;1186;3628;328;1120;264;797;592;1917
431610;201709;1328;3700;964;2994;126;389;452;1439;578;1828
431620;201709;510;1443;220;687;44;134;104;305;148;439
431630;201709;1216;3259;637;2021;167;546;164;477;331;1023
431640;201709;5923;16126;5338;15292;859;2512;3473;10074;4332;12586
431642;201709;495;1306;335;984;39;113;142;408;181;521
431643;201709;349;898;148;434;18;48;44;115;62;163
431645;201709;1564;4336;1305;3880;209;661;807;2413;1016;3074
431647;201709;136;393;85;278;12;46;18;47;30;93
431650;201709;245;733;172;573;31;113;50;157;81;270
431660;201709;935;2567;537;1758;86;321;117;319;203;640
431670;201709;1095;2802;817;2331;145;479;376;1002;521;1481
431673;201709;249;673;96;338;23;76;10;29;33;105
431675;201709;664;1691;132;456;15;58;34;105;49;163
431680;201709;7740;21298;5926;17795;1614;5083;1797;5471;3411;10554
431690;201709;18270;50299;14159;43217;3765;12066;4440;14136;8205;26202
431695;201709;131;368;89;288;20;69;29;71;49;140
431697;201709;439;1169;366;1050;73;215;180;529;253;744
431700;201709;1374;3815;1184;3466;194;568;651;1885;845;2453
431710;201709;10373;29744;8716;27173;2629;8569;2780;9518;5409;18087
431720;201709;5885;16066;4213;12668;996;3182;844;2360;1840;5542
431725;201709;31;89;19;64;2;7;7;23;9;30
431730;201709;3244;9064;2533;7881;705;2386;740;2452;1445;4838
431740;201709;4585;12182;3393;10081;1084;3567;572;1479;1656;5046
431750;201709;7335;20684;6331;19056;1436;4669;2875;8756;4311;13425
431755;201709;317;875;66;240;11;40;12;42;23;82
431760;201709;3884;10439;3078;9048;433;1467;1730;4810;2163;6277
431770;201709;1765;4657;1472;4235;216;658;931;2638;1147;3296
431775;201709;200;544;101;321;23;80;11;28;34;108
431780;201709;1894;5117;1373;4087;303;924;427;1223;730;2147
431790;201709;964;2799;728;2298;147;495;256;786;403;1281
431795;201709;296;796;169;515;33;101;47;139;80;240
431800;201709;7031;20153;5513;17302;1833;6241;645;2104;2478;8345
431805;201709;310;738;94;305;9;32;28;92;37;124
431810;201709;2961;7734;2085;6033;420;1342;855;2321;1275;3663
431820;201709;2086;6348;1814;5849;387;1336;821;2614;1208;3950
431830;201709;9320;22049;7153;18917;1708;4901;2953;7860;4661;12761
431840;201709;2199;6585;1914;6076;405;1331;1004;3255;1409;4586
431842;201709;700;1776;241;769;32;115;62;181;94;296
431843;201709;292;833;236;721;28;94;111;324;139;418
431844;201709;269;727;77;250;21;78;13;28;34;106
431845;201709;470;1325;338;1035;20;56;209;637;229;693
431846;201709;266;791;228;734;18;81;177;561;195;642
431848;201709;186;501;94;310;7;25;13;36;20;61
431849;201709;445;1067;79;231;10;32;12;27;22;59
431850;201709;4066;11831;3394;10404;771;2521;1116;3356;1887;5877
431860;201709;714;1885;475;1409;91;276;223;634;314;910
431861;201709;113;310;52;174;8;26;16;45;24;71
431862;201709;464;1516;381;1364;71;275;185;671;256;946
431870;201709;15972;45844;13095;40577;2677;9156;5542;16816;8219;25972
431880;201709;3617;10397;2907;9045;647;2256;1125;3364;1772;5620
431890;201709;4310;11599;2922;8952;884;2912;474;1531;1358;4443
431900;201709;996;2670;611;1899;138;480;256;754;394;1234
431910;201709;814;2003;349;1018;45;126;97;266;142;392
431912;201709;434;1291;363;1152;77;244;195;629;272;873
431915;201709;1002;2770;772;2369;180;602;353;1051;533;1653
431920;201709;1166;3125;981;2832;96;285;731;2116;827;2401
431930;201709;803;2282;558;1844;138;426;267;921;405;1347
431935;201709;55;178;45;157;11;40;9;29;20;69
431936;201709;305;908;192;635;53;191;47;150;100;341
431937;201709;220;600;129;402;33;107;19;54;52;161
431940;201709;2268;6092;1425;4363;313;1034;419;1206;732;2240
431950;201709;1434;4285;1257;3981;234;788;640;2012;874;2800
431960;201709;2601;7158;2146;6258;573;1758;637;1805;1210;3563
431970;201709;390;1061;179;599;44;150;45;142;89;292
431971;201709;82;228;47;164;7;23;8;25;15;48
431973;201709;451;1520;386;1390;35;124;269;981;304;1105
431975;201709;104;238;24;83;4;15;3;7;7;22
431980;201709;1154;3318;912;2869;214;708;336;1037;550;1745
431990;201709;5767;15384;3836;12291;739;2625;1045;3353;1784;5978
432000;201709;8883;24641;7147;21565;2164;6640;2538;7777;4702;14417
432010;201709;1838;5086;1457;4396;197;657;761;2224;958;2881
432020;201709;1942;4699;1447;3978;350;1050;727;1916;1077;2966
432023;201709;471;1248;275;846;44;166;132;348;176;514
432026;201709;1023;3097;763;2539;159;513;386;1279;545;1792
432030;201709;318;874;213;640;46;139;95;271;141;410
432032;201709;465;1242;311;929;33;113;147;405;180;518
432035;201709;749;2226;664;2085;220;752;205;644;425;1396
432040;201709;838;2016;415;1274;64;208;139;427;203;635
432045;201709;240;666;130;438;30;108;35;123;65;231
432050;201709;530;1474;445;1320;118;355;181;550;299;905
432055;201709;817;2198;544;1676;148;497;197;580;345;1077
432057;201709;345;856;242;671;38;87;120;315;158;402
432060;201709;479;1194;161;529;28;115;49;136;77;251
432065;201709;226;638;163;512;41;136;52;157;93;293
432067;201709;761;2332;610;1998;110;340;311;1030;421;1370
432070;201709;2144;5785;1336;4167;254;844;281;837;535;1681
432080;201709;3501;9603;2891;8532;788;2555;1101;3187;1889;5742
432085;201709;300;844;207;693;68;217;84;287;152;504
432090;201709;1308;3648;1010;3087;264;869;399;1181;663;2050
432100;201709;1196;3395;503;1731;81;308;37;94;118;402
432110;201709;2175;6406;1554;5133;364;1411;118;342;482;1753
432120;201709;3378;9942;2772;8846;962;3272;604;1918;1566;5190
432130;201709;2493;6760;2031;6167;702;2288;750;2307;1452;4595
432132;201709;283;788;141;479;19;64;43;135;62;199
432135;201709;722;2042;558;1706;88;293;349;1038;437;1331
432140;201709;1606;5100;1249;4410;247;899;570;2077;817;2976
432143;201709;1225;3544;1005;3168;161;548;541;1717;702;2265
432145;201709;1183;3553;750;2523;120;450;118;346;238;796
432146;201709;140;434;94;323;29;104;19;62;48;166
432147;201709;371;1259;306;1117;99;377;62;235;161;612
432149;201709;370;1006;226;675;28;91;101;287;129;378
432150;201709;3158;8816;2370;7320;562;1957;664;1971;1226;3928
432160;201709;3963;12205;3366;11176;1008;3538;1034;3460;2042;6998
432162;201709;355;842;53;159;9;25;7;21;16;46
432163;201709;252;683;53;168;4;11;3;11;7;22
432166;201709;569;1700;454;1452;83;314;151;402;234;716
432170;201709;1140;3399;782;2661;181;667;168;551;349;1218
432180;201709;2317;6130;1288;4013;284;948;250;678;534;1626
432183;201709;340;1072;251;858;80;299;47;155;127;454
432185;201709;809;2155;545;1661;50;155;321;952;371;1107
432190;201709;2466;6574;1607;4818;374;1193;532;1517;906;2710
432195;201709;999;2634;679;2086;180;521;213;674;393;1195
432200;201709;2474;7344;1972;6478;490;1713;841;2807;1331;4520
432210;201709;360;1007;253;819;49;185;102;308;151;493
432215;201709;718;2208;630;2057;93;300;389;1318;482;1618
432218;201709;238;623;136;393;20;52;48;129;68;181
432220;201709;3870;9891;2989;8470;451;1468;1683;4545;2134;6013
432225;201709;94;279;68;227;14;43;26;88;40;131
432230;201709;806;2104;457;1374;83;270;120;323;203;593
432232;201709;471;1234;354;1037;57;197;168;479;225;676
432234;201709;272;702;138;425;34;101;23;58;57;159
432235;201709;102;295;38;132;7;25;2;6;9;31
432237;201709;402;1079;353;991;14;49;243;650;257;699
432240;201709;12744;38045;10641;35095;1122;4496;6575;22520;7697;27016
432250;201709;3987;13434;3589;12636;1073;3965;1238;4525;2311;8490
432252;201709;420;1060;272;800;44;146;125;351;169;497
432253;201709;1202;3772;670;2356;158;622;32;94;190;716
432254;201709;733;1961;195;642;40;156;17;41;57;197
432255;201709;178;429;83;255;12;42;24;58;36;100
432260;201709;6079;15494;4392;12639;1047;3136;1672;4997;2719;8133
432270;201709;2140;6349;1805;5716;549;1831;330;1058;879;2889
432280;201709;1204;3207;646;2022;105;338;201;594;306;932
432285;201709;189;586;21;73;2;5;2;5;4;10
432290;201709;410;1222;257;870;68;225;66;216;134;441
432300;201709;21221;61765;18378;56867;2979;10054;10753;32716;13732;42770
432310;201709;690;2044;539;1781;115;373;267;896;382;1269
432320;201709;210;507;77;239;9;29;13;36;22;65
432330;201709;262;671;88;293;11;29;16;59;27;88
432335;201709;164;466;70;248;14;54;12;34;26;88
432340;201709;304;740;154;473;28;100;49;135;77;235
432345;201709;594;1529;543;1457;49;181;384;973;433;1154
432350;201709;358;964;184;604;32;94;52;165;84;259
432360;201709;196;598;37;132;4;20;9;25;13;45
432370;201709;373;1002;254;767;18;65;162;487;180;552
432375;201709;600;1531;445;1259;63;186;258;717;321;903
432377;201709;221;729;29;109;3;14;6;12;9;26
432380;201709;1113;3368;755;2577;173;658;318;1024;491;1682
500020;201709;2073;5808;1614;5064;364;1297;698;2111;1062;3408
500025;201709;1274;2973;770;2114;69;197;437;1178;506;1375
500060;201709;6221;18771;4932;16450;686;2314;2973;10374;3659;12688
500070;201709;3998;11289;3101;9703;687;2361;1199;3882;1886;6243
500080;201709;1279;3650;907;2972;204;767;347;1100;551;1867
500085;201709;1890;4738;1300;3867;148;464;790;2318;938;2782
500090;201709;1990;5608;1385;4506;275;944;515;1790;790;2734
500100;201709;2979;8154;2369;7123;386;1295;1022;2906;1408;4201
500110;201709;6686;19623;5177;17272;1066;3814;2005;7324;3071;11138
500124;201709;1966;6363;1705;5912;429;1422;832;3228;1261;4650
500150;201709;1270;3123;819;2389;164;549;275;700;439;1249
500190;201709;4541;11488;3460;10045;735;2235;1776;5344;2511;7579
500200;201709;2229;5526;1657;4535;339;975;744;1898;1083;2873
500210;201709;4345;12632;3513;11313;865;2930;1542;5045;2407;7975
500215;201709;1221;3691;906;3069;141;526;398;1305;539;1831
500220;201709;2868;8475;2230;7352;376;1324;982;3281;1358;4605
500230;201709;2487;6276;1780;5147;272;812;911;2658;1183;3470
500240;201709;3852;11882;2712;9574;497;2017;715;2694;1212;4711
500260;201709;2927;6795;1817;5135;217;635;931;2572;1148;3207
500270;201709;106407;273951;67197;203411;15181;49424;16503;49152;31684;98576
500280;201709;1261;3243;963;2826;94;309;662;1919;756;2228
500290;201709;4004;8908;2227;6365;364;1150;777;2172;1141;3322
500295;201709;2400;6665;1385;4432;213;737;384;1045;597;1782
500310;201709;795;1986;629;1771;106;313;350;994;456;1307
500315;201709;3123;9639;2571;8718;355;1231;1573;5581;1928;6812
500320;201709;16764;51862;12558;44109;3546;13495;3447;12938;6993;26433
500325;201709;3716;9024;2543;7280;373;1155;1468;4259;1841;5414
500330;201709;6478;16284;4386;12683;479;1511;2178;6402;2657;7913
500345;201709;1760;4529;1324;3916;369;1122;524;1535;893;2657
500348;201709;2153;6088;1819;5544;195;683;1187;3576;1382;4259
500350;201709;1243;3590;664;2228;71;244;222;775;293;1019
500370;201709;19389;56895;14357;47973;2976;11191;5039;17003;8015;28194
500375;201709;2458;6759;1760;5375;356;1197;521;1569;877;2766
500380;201709;3217;8481;2399;7127;622;1955;884;2653;1506;4608
500390;201709;494;1111;292;802;45;132;141;386;186;518
500400;201709;1154;3416;832;2677;196;663;230;703;426;1366
500410;201709;2130;6018;1747;5441;289;905;1057;3395;1346;4300
500430;201709;2521;6824;1834;5812;339;1210;701;2363;1040;3573
500440;201709;1258;3187;795;2399;135;415;299;949;434;1364
500450;201709;1158;3251;719;2354;148;516;89;237;237;753
500460;201709;3620;10379;2440;8071;588;2148;475;1585;1063;3733
500470;201709;2436;6965;1668;5362;492;1719;315;916;807;2635
500480;201709;2125;6452;1952;6217;143;418;1512;5141;1655;5559
500490;201709;805;2189;575;1806;155;547;144;473;299;1020
500500;201709;3730;10780;2803;9411;952;3615;687;2384;1639;5999
500510;201709;790;2037;492;1487;42;147;253;725;295;872
500515;201709;1927;4922;1552;4393;145;417;1035;3051;1180;3468
500520;201709;3113;10578;2619;9591;474;1930;1380;5028;1854;6958
500525;201709;976;3045;790;2729;136;536;389;1393;525;1929
500540;201709;5284;14115;3052;10011;762;2972;299;864;1061;3836
500560;201709;4906;15314;4270;14325;363;1301;3182;10867;3545;12168
500568;201709;3947;9369;2564;7289;613;2106;725;1852;1338;3958
500570;201709;6691;16928;3975;11989;1017;3272;678;1970;1695;5242
500580;201709;3204;9130;2603;8129;348;1098;1636;5138;1984;6236
500600;201709;3379;8706;2221;6738;478;1596;681;2037;1159;3633
500620;201709;7135;20123;5133;16245;792;2685;2375;7635;3167;10320
500625;201709;555;1591;306;1023;58;216;119;382;177;598
500627;201709;711;1864;443;1365;89;262;106;338;195;600
500630;201709;5459;14210;3584;10998;865;2820;997;3099;1862;5919
500635;201709;2536;9291;2116;8664;217;923;1524;6686;1741;7609
500640;201709;1613;3829;1175;3190;63;204;825;2180;888;2384
500660;201709;17417;49814;13228;43064;4193;15014;3214;10714;7407;25728
500690;201709;2250;6575;1701;5706;826;3045;201;659;1027;3704
500710;201709;3032;8772;2399;7608;607;2073;754;2375;1361;4448
500720;201709;5128;13299;3170;10064;903;3208;545;1709;1448;4917
500730;201709;866;2406;563;1804;116;413;173;535;289;948
500740;201709;4220;10979;3181;9097;276;927;1685;4892;1961;5819
500750;201709;904;2474;727;2145;126;420;327;900;453;1320
500755;201709;982;2804;635;2113;123;420;108;304;231;724
500769;201709;5004;12925;2682;8305;484;1685;482;1195;966;2880
500770;201709;1612;4494;1039;3401;184;644;331;1088;515;1732
500780;201709;1225;3307;850;2582;218;673;208;624;426;1297
500790;201709;8423;22664;6913;20296;1363;4398;3631;10618;4994;15016
500793;201709;1929;5357;1398;4425;453;1478;207;591;660;2069
500795;201709;2169;6259;1846;5811;171;455;1405;4726;1576;5181
500797;201709;736;1949;503;1535;98;330;179;526;277;856
500800;201709;2711;6919;1926;5757;676;2292;342;1061;1018;3353
500830;201709;17324;45002;12042;35392;2106;6694;4985;14154;7091;20848
500840;201709;1149;3098;732;2273;89;292;284;824;373;1116
510010;201709;1362;3843;1070;3353;277;864;499;1629;776;2493
510020;201709;3251;8808;1869;6049;411;1389;388;1175;799;2564
510025;201709;6664;18641;4455;14372;894;3150;1252;3835;2146;6985
510030;201709;1755;4317;1317;3730;285;837;593;1701;878;2538
510035;201709;973;2717;657;2226;117;400;373;1340;490;1740
510040;201709;1807;4587;1389;3979;150;439;856;2462;1006;2901
510050;201709;1756;4794;1224;3872;313;1110;498;1475;811;2585
510060;201709;1298;3524;985;3002;160;515;486;1456;646;1971
510080;201709;973;3067;781;2678;227;895;136;374;363;1269
510100;201709;662;1693;455;1299;53;155;209;569;262;724
510120;201709;265;534;158;401;9;25;107;271;116;296
510125;201709;2492;6387;1864;5335;313;1100;769;2023;1082;3123
510130;201709;1443;3947;1160;3459;304;962;347;1016;651;1978
510140;201709;2698;8110;2044;7218;832;3348;570;1787;1402;5135
510160;201709;1231;3961;1064;3704;212;751;656;2325;868;3076
510170;201709;4383;12923;3427;11237;718;2539;1490;4848;2208;7387
510180;201709;11318;28949;7559;22830;2137;6932;1979;6780;4116;13712
510185;201709;1541;4220;1117;3607;304;954;506;1942;810;2896
510190;201709;2258;6279;1566;5211;419;1545;577;1944;996;3489
510250;201709;12970;37728;11266;35302;2783;9219;5546;18057;8329;27276
510260;201709;2028;8467;1659;7727;258;1166;946;5024;1204;6190
510263;201709;3277;9069;2219;7163;506;1775;352;1108;858;2883
510267;201709;5250;15193;3407;11170;773;2671;655;2163;1428;4834
510268;201709;1293;3387;915;2712;134;418;503;1450;637;1868
510269;201709;1020;3035;685;2341;234;880;142;434;376;1314
510270;201709;2706;8661;2113;7499;475;1709;746;2610;1221;4319
510279;201709;1688;5005;1313;4258;300;1065;541;1649;841;2714
510285;201709;1157;3232;838;2695;231;800;236;740;467;1540
510300;201709;3398;9226;2695;8255;251;750;1870;5891;2121;6641
510305;201709;1301;4041;959;3363;217;785;309;1173;526;1958
510310;201709;735;2090;567;1803;195;636;171;562;366;1198
510320;201709;3640;10038;2744;8449;454;1581;996;3020;1450;4601
510325;201709;4635;14311;3817;13132;1065;3801;1899;6847;2964;10648
510330;201709;2635;8446;2001;7317;498;1888;718;2901;1216;4789
510335;201709;4806;14199;3729;12747;411;1492;2394;8698;2805;10190
510336;201709;465;1401;360;1218;62;219;176;609;238;828
510337;201709;1727;5483;1291;4681;497;1906;252;962;749;2868
510340;201709;67691;173590;45609;139000;14765;50811;8490;25919;23255;76730
510343;201709;1001;2939;717;2352;143;483;255;811;398;1294
510345;201709;1387;4120;1049;3459;198;650;413;1351;611;2001
510350;201709;2714;7336;1928;6168;502;1708;732;2422;1234;4130
510360;201709;1544;3724;1050;3110;66;264;786;2326;852;2590
510370;201709;1489;4671;1158;4114;207;768;647;2415;854;3183
510380;201709;500;1402;270;923;75;276;34;120;109;396
510385;201709;907;3451;658;2897;79;392;331;1601;410;1993
510390;201709;1025;3261;845;2961;229;800;380;1416;609;2216
510395;201709;724;1741;498;1394;56;172;247;747;303;919
510410;201709;3752;11825;3096;10580;784;2717;1477;5338;2261;8055
510420;201709;2138;5163;1578;4327;167;550;893;2409;1060;2959
510450;201709;603;1553;368;1133;88;292;57;171;145;463
510452;201709;624;1941;447;1562;83;272;223;792;306;1064
510454;201709;822;2511;655;2197;103;376;360;1229;463;1605
510455;201709;920;2770;678;2231;129;483;231;705;360;1188
510460;201709;2070;5303;1503;4493;161;587;864;2485;1025;3072
510480;201709;4032;10109;2879;8101;456;1353;1314;3525;1770;4878
510490;201709;1456;4433;1207;4075;284;1009;580;1955;864;2964
510500;201709;1426;4094;942;3167;172;686;410;1320;582;2006
510510;201709;2846;9416;2333;8416;714;2825;583;2217;1297;5042
510515;201709;5767;16016;3766;12174;867;3063;907;2657;1774;5720
510517;201709;1322;3885;1038;3360;318;1100;171;530;489;1630
510520;201709;1951;4257;1277;3412;39;110;807;2312;846;2422
510523;201709;865;2438;744;2234;87;262;501;1528;588;1790
510525;201709;4760;14331;3717;12195;780;2787;1212;3592;1992;6379
510530;201709;505;1336;375;1140;27;131;277;783;304;914
510550;201709;2660;8430;2016;7197;519;1957;662;2445;1181;4402
510558;201709;1851;5267;1555;4850;97;325;987;3284;1084;3609
510560;201709;1599;4692;973;3554;239;969;225;865;464;1834
510562;201709;5102;14461;3747;11827;1026;3509;1005;3295;2031;6804
510590;201709;3014;7746;2266;6777;451;1274;1318;4167;1769;5441
510600;201709;1484;3659;963;2808;234;694;324;973;558;1667
510610;201709;2580;7156;2006;6290;210;743;1215;3769;1425;4512
510615;201709;1785;5280;1484;4804;425;1385;642;2221;1067;3606
510617;201709;718;2160;590;1952;27;73;487;1683;514;1756
510618;201709;1342;3794;971;3088;191;698;457;1374;648;2072
510619;201709;716;1935;408;1352;83;316;65;197;148;513
510620;201709;1279;3198;684;2183;177;634;105;313;282;947
510621;201709;890;2792;739;2518;176;663;217;712;393;1375
510622;201709;3544;10549;2614;8522;826;2924;558;1718;1384;4642
510623;201709;3051;8032;2236;6678;489;1717;735;2087;1224;3804
510624;201709;1645;4415;734;2502;123;468;107;303;230;771
510625;201709;1842;5009;1337;4168;370;1315;214;666;584;1981
510626;201709;1504;3800;927;2953;259;922;187;600;446;1522
510627;201709;583;1602;397;1236;107;354;98;310;205;664
510628;201709;1436;3469;979;2838;185;533;555;1673;740;2206
510629;201709;1513;4844;1208;4166;332;1233;385;1365;717;2598
510630;201709;2776;8729;1811;6711;407;1625;308;1231;715;2856
510631;201709;415;1138;330;992;6;16;260;791;266;807
510637;201709;2778;7555;2215;6637;698;2318;699;2046;1397;4364
510642;201709;4667;14791;3851;13570;1108;4206;1577;5819;2685;10025
510645;201709;881;1951;542;1500;155;429;160;466;315;895
510650;201709;6000;18693;5378;17970;965;3332;3739;12991;4704;16323
510665;201709;1701;4333;1042;3146;204;669;360;1117;564;1786
510670;201709;381;833;204;570;20;69;109;309;129;378
510675;201709;5704;17176;4433;14746;1264;4563;955;3155;2219;7718
510677;201709;1951;5116;1455;4445;194;632;904;2839;1098;3471
510680;201709;658;1932;461;1534;111;373;61;193;172;566
510682;201709;1822;5767;1365;4909;382;1484;288;1060;670;2544
510685;201709;863;2337;652;1986;94;321;318;901;412;1222
510700;201709;3788;9746;2542;7959;629;1979;1132;3742;1761;5721
510704;201709;9176;23710;6348;18713;1245;4033;2317;6505;3562;10538
510706;201709;1857;5400;1228;4460;247;963;605;2378;852;3341
510710;201709;2660;7225;1850;5601;377;1166;648;1859;1025;3025
510715;201709;703;1666;486;1310;72;192;188;511;260;703
510718;201709;2390;5476;1367;4247;582;1857;244;992;826;2849
510719;201709;375;845;227;646;35;117;115;323;150;440
510720;201709;1005;2511;694;2067;178;596;214;601;392;1197
510724;201709;690;1987;492;1619;101;363;196;600;297;963
510726;201709;720;1603;467;1231;64;185;308;783;372;968
510729;201709;674;1651;340;1024;61;208;90;248;151;456
510730;201709;2842;7613;1998;6147;552;1773;553;1761;1105;3534
510735;201709;901;2786;690;2479;92;383;429;1548;521;1931
510740;201709;1266;3528;932;3021;101;301;601;2122;702;2423
510757;201709;629;2076;521;1873;215;806;174;616;389;1422
510760;201709;31364;76668;20287;59064;6019;19531;4173;11251;10192;30782
510770;201709;4391;10300;3430;9204;341;809;2222;6649;2563;7458
510774;201709;364;1019;282;841;57;161;132;417;189;578
510775;201709;595;1747;456;1500;110;425;83;246;193;671
510776;201709;454;1285;353;1069;82;238;136;433;218;671
510777;201709;1617;4619;1198;4052;84;312;976;3320;1060;3632
510779;201709;567;1665;455;1467;50;148;278;928;328;1076
510780;201709;3438;9935;2743;8857;684;2294;1069;3823;1753;6117
510785;201709;1868;5112;1173;3858;301;1102;161;539;462;1641
510787;201709;2219;6405;1694;5500;782;2655;192;594;974;3249
510788;201709;637;1589;438;1293;81;224;173;614;254;838
510790;201709;13406;38102;8767;29095;2057;7861;1026;3108;3083;10969
510792;201709;8231;23004;5398;17698;1125;4053;1021;3299;2146;7352
510794;201709;1112;3359;824;2814;249;930;185;572;434;1502
510795;201709;7559;21826;5429;17914;1503;5433;1028;3552;2531;8985
510800;201709;1438;3911;1066;3349;227;762;474;1435;701;2197
510805;201709;1848;5080;1289;4086;269;914;475;1383;744;2297
510810;201709;620;1448;453;1223;113;312;228;597;341;909
510820;201709;713;1574;439;1187;64;212;190;488;254;700
510830;201709;707;1939;535;1687;104;315;278;938;382;1253
510835;201709;588;1629;421;1339;68;232;198;601;266;833
510840;201709;39419;98565;31210;87807;6961;19840;15221;45124;22182;64964
510850;201709;1515;4008;944;3006;310;1125;199;578;509;1703
510860;201709;2586;7639;1783;6161;604;2361;169;575;773;2936
510880;201709;556;1820;472;1661;129;482;206;733;335;1215
510885;201709;564;1520;429;1327;77;278;169;495;246;773
510890;201709;698;2122;577;1951;106;392;331;1133;437;1525
510895;201709;1184;3360;880;2820;216;773;307;916;523;1689
520005;201709;1773;5155;1473;4762;437;1348;658;2369;1095;3717
520010;201709;2034;6412;1488;5230;524;2067;254;779;778;2846
520013;201709;2786;7792;2052;6321;474;1518;613;1994;1087;3512
520015;201709;495;1373;393;1233;109;362;116;385;225;747
520017;201709;1007;2924;821;2617;201;676;379;1200;580;1876
520020;201709;362;919;295;829;78;237;149;401;227;638
520025;201709;30313;88434;27195;84613;3216;10677;19894;62012;23110;72689
520030;201709;4712;13771;3855;12364;548;1891;2138;6955;2686;8846
520050;201709;433;1079;268;772;19;47;155;462;174;509
520055;201709;841;2487;701;2215;104;308;375;1216;479;1524
520060;201709;1330;4007;1074;3529;268;985;304;963;572;1948
520080;201709;1756;4847;1418;4396;262;773;738;2475;1000;3248
520082;201709;1023;2662;889;2438;107;238;568;1609;675;1847
520085;201709;700;2083;597;1911;144;448;206;645;350;1093
520090;201709;838;1893;596;1587;110;258;349;997;459;1255
520110;201709;36864;104517;27696;90258;10122;37493;1961;5914;12083;43407
520120;201709;181;457;103;323;12;37;35;112;47;149
520130;201709;3379;9192;2978;8572;661;2050;1528;4490;2189;6540
520140;201709;33420;103244;27400;92057;10117;36963;3122;10672;13239;47635
520145;201709;390;1065;279;867;64;209;90;263;154;472
520150;201709;478;1219;382;1104;56;162;230;665;286;827
520160;201709;794;2043;631;1801;128;371;269;779;397;1150
520170;201709;4609;10049;3477;8778;236;641;2879;7347;3115;7988
520180;201709;2043;5830;1709;5338;388;1328;775;2368;1163;3696
520215;201709;1868;4700;1453;4030;296;914;699;1884;995;2798
520235;201709;633;1566;434;1265;63;203;171;484;234;687
520250;201709;1512;4102;1073;3408;290;988;190;617;480;1605
520260;201709;768;1927;487;1412;73;224;198;571;271;795
520280;201709;578;1628;481;1446;148;437;188;614;336;1051
520310;201709;1182;2751;808;2159;208;565;271;817;479;1382
520320;201709;1809;5394;1487;4815;164;564;839;2766;1003;3330
520330;201709;2932;8896;2199;7578;573;2204;643;2209;1216;4413
520340;201709;1960;4781;1435;4019;179;444;945;2775;1124;3219
520350;201709;3021;7914;2256;6571;650;2040;748;2091;1398;4131
520355;201709;1522;4359;1245;3920;318;1096;535;1681;853;2777
520357;201709;781;2035;627;1798;50;152;432;1259;482;1411
520360;201709;683;1889;543;1653;176;562;169;532;345;1094
520380;201709;1294;3396;809;2450;108;367;349;966;457;1333
520390;201709;897;2180;549;1687;182;638;131;375;313;1013
520393;201709;515;1233;385;1041;43;115;200;515;243;630
520396;201709;721;2152;616;1960;116;367;384;1225;500;1592
520400;201709;1407;3952;1185;3633;241;780;702;2149;943;2929
520410;201709;1537;3508;1048;2836;143;429;642;1709;785;2138
520420;201709;344;911;255;728;28;83;158;418;186;501
520425;201709;1225;3181;880;2576;232;692;378;1122;610;1814
520430;201709;1910;4945;1121;3482;212;704;76;241;288;945
520440;201709;3347;8443;2220;6481;640;1995;507;1486;1147;3481
520450;201709;10741;28401;7368;22561;2184;7313;438;1396;2622;8709
520455;201709;664;1921;517;1681;188;666;140;464;328;1130
520460;201709;863;2408;729;2209;104;324;493;1514;597;1838
520465;201709;799;2193;687;2017;102;350;441;1224;543;1574
520470;201709;1692;5314;1495;5019;310;1059;939;3305;1249;4364
520480;201709;765;2255;499;1762;104;404;75;250;179;654
520485;201709;1371;4129;1191;3869;185;651;798;2594;983;3245
520490;201709;3653;11115;2905;9930;631;2204;1550;5422;2181;7626
520495;201709;1388;3447;1140;3124;79;236;850;2406;929;2642
520500;201709;1233;3456;1001;3109;248;855;413;1234;661;2089
520505;201709;682;1783;517;1550;120;350;247;747;367;1097
520510;201709;6421;18088;4810;15521;1170;4225;1446;4711;2616;8936
520520;201709;1024;2720;802;2399;247;754;264;866;511;1620
520530;201709;1806;5880;1447;5257;539;1951;329;1399;868;3350
520540;201709;2577;7024;1750;5458;447;1435;338;1119;785;2554
520545;201709;971;2793;774;2453;155;519;245;762;400;1281
520547;201709;641;1958;532;1750;157;521;190;606;347;1127
520549;201709;9809;28761;8168;26289;1904;6345;4091;13484;5995;19829
520551;201709;3839;11327;3378;10639;578;2050;2188;6759;2766;8809
520552;201709;717;2091;643;1999;87;260;461;1480;548;1740
520570;201709;561;1490;407;1246;116;366;139;437;255;803
520580;201709;2705;6383;1951;5386;260;761;1198;3373;1458;4134
520590;201709;1304;3696;974;3093;212;700;211;694;423;1394
520620;201709;7687;21783;6421;20092;1783;5806;2810;8973;4593;14779
520630;201709;973;2472;650;1932;110;348;239;672;349;1020
520640;201709;2429;6495;1958;5703;433;1286;830;2458;1263;3744
520650;201709;861;2207;611;1767;96;293;322;939;418;1232
520660;201709;431;1052;247;750;63;215;52;168;115;383
520670;201709;931;2728;810;2545;59;197;626;1949;685;2146
520680;201709;736;1906;555;1619;122;349;244;730;366;1079
520690;201709;316;786;214;633;63;189;67;208;130;397
520710;201709;546;1388;349;1016;12;33;222;630;234;663
520725;201709;1495;3748;1110;3107;136;442;731;2005;867;2447
520735;201709;782;2038;542;1606;97;288;192;586;289;874
520740;201709;1742;4423;1418;4015;232;659;842;2443;1074;3102
520750;201709;667;1697;514;1470;102;271;230;705;332;976
520753;201709;1415;3647;1251;3416;138;354;839;2423;977;2777
520760;201709;926;2239;831;2114;118;231;622;1702;740;1933
520780;201709;1719;4228;1298;3613;138;398;729;1975;867;2373
520790;201709;3027;7489;2228;6286;177;475;1523;4479;1700;4954
520800;201709;15139;41120;12749;38218;2402;6911;7957;25412;10359;32323
520810;201709;1181;2742;900;2422;139;422;520;1478;659;1900
520815;201709;620;1999;445;1625;137;528;64;326;201;854
520830;201709;1633;3979;1239;3520;64;142;987;2813;1051;2955
520840;201709;1728;5400;1510;5055;577;2049;416;1483;993;3532
520850;201709;607;1713;419;1415;109;416;104;354;213;770
520860;201709;6032;17460;4689;15304;1135;4003;1668;5603;2803;9606
520870;201709;79928;209878;59750;178426;18142;58999;14018;41217;32160;100216
520880;201709;6031;17341;4759;15455;1683;5951;930;3005;2613;8956
520890;201709;3653;9762;2789;8354;593;2012;1233;3616;1826;5628
520910;201709;3597;9726;2452;7692;801;2727;445;1345;1246;4072
520915;201709;631;1823;476;1500;93;316;193;601;286;917
520920;201709;3810;9643;2596;7861;402;1353;1182;3643;1584;4996
520929;201709;636;1661;489;1395;90;215;254;802;344;1017
520940;201709;1088;3007;863;2685;71;237;656;2048;727;2285
520945;201709;553;1290;438;1099;53;118;279;686;332;804
520960;201709;960;2677;762;2337;155;504;360;1093;515;1597
520970;201709;2436;7310;2062;6636;575;2037;480;1581;1055;3618
520980;201709;731;2023;612;1844;154;508;265;784;419;1292
520990;201709;2843;8955;2648;8685;246;868;1883;6402;2129;7270
520993;201709;919;2317;691;1945;36;103;494;1399;530;1502
520995;201709;2106;5639;1764;5185;396;1171;901;2695;1297;3866
521000;201709;6959;20313;5467;17461;1726;5865;1268;4057;2994;9922
521010;201709;3748;10400;2899;8879;521;1572;1416;4348;1937;5920
521015;201709;646;1711;556;1566;77;220;392;1098;469;1318
521020;201709;2706;7585;1827;5792;524;1801;201;597;725;2398
521030;201709;582;1414;420;1156;60;150;195;577;255;727
521040;201709;6452;16791;5174;14788;1639;4902;1652;4927;3291;9829
521056;201709;787;2264;623;1990;194;659;171;591;365;1250
521060;201709;975;2526;773;2214;77;227;446;1309;523;1536
521080;201709;1073;2563;592;1779;69;231;221;584;290;815
521090;201709;2913;7635;2199;6583;686;2178;490;1511;1176;3689
521100;201709;1801;4234;1315;3559;219;584;763;2110;982;2694
521120;201709;4505;11178;3422;9770;594;1751;1582;4911;2176;6662
521130;201709;981;2517;679;1954;51;181;376;1069;427;1250
521140;201709;1027;2923;801;2507;163;537;279;888;442;1425
521150;201709;11018;27001;7238;20904;2238;6974;2165;6466;4403;13440
521160;201709;699;1587;463;1225;85;259;222;552;307;811
521170;201709;1054;2586;785;2166;89;253;495;1321;584;1574
521180;201709;5742;17935;5040;16660;1260;4448;1772;5987;3032;10435
521190;201709;8780;24449;5625;18586;1432;5101;1036;3529;2468;8630
521200;201709;738;1957;562;1660;61;199;311;908;372;1107
521205;201709;594;1613;459;1381;37;117;312;922;349;1039
521210;201709;794;2170;463;1462;112;397;64;162;176;559
521220;201709;4059;10047;2835;8274;610;1879;1076;3124;1686;5003
521225;201709;338;836;275;767;25;62;211;619;236;681
521230;201709;1210;3513;1111;3343;404;1213;540;1653;944;2866
521250;201709;29338;86525;24408;79288;10306;34564;6567;23109;16873;57673
521260;201709;701;1665;544;1443;92;274;305;806;397;1080
521270;201709;1683;4707;1534;4509;152;340;1200;3696;1352;4036
521280;201709;1817;5267;1433;4558;452;1560;436;1382;888;2942
521290;201709;419;1110;324;981;70;247;170;501;240;748
521295;201709;1120;2605;913;2333;91;208;682;1831;773;2039
521300;201709;1746;4724;1477;4347;204;599;994;2991;1198;3590
521305;201709;711;1927;554;1664;92;258;297;931;389;1189
521308;201709;4074;11939;3221;10273;653;2123;1503;4844;2156;6967
521310;201709;7886;21946;5371;17186;1376;4766;1342;4168;2718;8934
521340;201709;340;836;304;790;24;54;250;657;274;711
521350;201709;1965;5200;1563;4578;248;726;993;2920;1241;3646
521370;201709;967;2642;623;2025;195;690;64;214;259;904
521375;201709;1351;3733;1039;3279;265;896;393;1280;658;2176
521377;201709;1196;2841;1000;2606;54;136;869;2270;923;2406
521380;201709;5875;16111;4102;12880;520;1713;1093;3534;1613;5247
521385;201709;565;1420;455;1290;111;316;201;615;312;931
521390;201709;709;1923;557;1706;175;591;174;539;349;1130
521400;201709;1899;5066;1651;4775;245;792;1167;3371;1412;4163
521405;201709;1300;3510;1009;3011;233;723;461;1407;694;2130
521410;201709;675;1982;618;1899;147;404;310;1043;457;1447
521440;201709;1376;3853;1068;3242;279;894;262;731;541;1625
521450;201709;3569;11293;2822;9788;810;2919;667;2398;1477;5317
521460;201709;6374;17835;5079;15538;1538;5038;1665;4976;3203;10014
521470;201709;600;1736;408;1303;82;256;87;269;169;525
521480;201709;366;1044;219;728;41;147;64;204;105;351
521483;201709;2515;6513;1870;5378;480;1423;509;1452;989;2875
521486;201709;1616;3974;1280;3510;80;201;982;2695;1062;2896
521487;201709;460;1202;334;1013;74;235;126;386;200;621
521490;201709;817;2273;620;1928;34;133;423;1280;457;1413
521500;201709;1444;4020;1040;3321;157;587;492;1478;649;2065
521520;201709;789;1806;562;1487;102;271;255;710;357;981
521523;201709;13044;44693;11585;41619;3775;14387;2293;8954;6068;23341
521525;201709;992;2488;802;2208;91;287;498;1329;589;1616
521530;201709;1943;5217;1220;3791;279;922;274;877;553;1799
521540;201709;850;2256;558;1750;96;368;242;745;338;1113
521550;201709;1409;3566;878;2497;172;536;354;1004;526;1540
521560;201709;3446;10635;2686;9577;725;2892;1272;4648;1997;7540
521565;201709;572;1435;479;1318;76;201;312;847;388;1048
521570;201709;3963;10855;2595;8167;581;1986;351;1137;932;3123
521580;201709;530;1271;301;910;52;158;56;176;108;334
521590;201709;599;1572;458;1337;120;399;191;525;311;924
521600;201709;397;1144;258;835;63;199;54;166;117;365
521630;201709;1329;3211;901;2585;224;719;262;692;486;1411
521640;201709;1966;4912;1522;4286;362;991;700;2040;1062;3031
521645;201709;532;1549;368;1218;92;310;101;315;193;625
521680;201709;1186;3783;952;3295;308;1130;99;344;407;1474
521690;201709;470;1341;423;1265;95;300;218;634;313;934
521710;201709;2727;7707;2062;6486;440;1447;427;1335;867;2782
521720;201709;1913;5249;1471;4443;232;730;765;2246;997;2976
521730;201709;3611;11222;2973;9984;1063;3933;473;1393;1536;5326
521740;201709;3500;9741;2793;8696;733;2516;1058;3443;1791;5959
521760;201709;13839;42309;11602;38682;3371;12309;3919;13435;7290;25744
521770;201709;2617;7231;1961;5955;653;2138;460;1331;1113;3469
521800;201709;5812;17277;4883;15689;1473;4973;1599;5528;3072;10501
521805;201709;848;1894;588;1531;180;436;236;677;416;1113
521810;201709;693;1706;492;1406;93;292;210;629;303;921
521830;201709;5004;15078;4284;13991;547;1972;2818;9119;3365;11091
521839;201709;666;1786;479;1436;107;353;182;511;289;864
521850;201709;5494;14628;4088;12327;1137;3704;723;2076;1860;5780
521860;201709;1757;4560;1308;3861;241;794;433;1252;674;2046
521870;201709;479;1534;392;1360;95;353;121;391;216;744
521878;201709;660;1852;468;1474;80;287;157;451;237;738
521880;201709;19371;49101;13333;39628;3453;10826;4059;12659;7512;23485
521890;201709;3096;8905;2213;7099;571;1956;316;958;887;2914
521900;201709;1411;3575;935;2864;224;712;306;907;530;1619
521910;201709;1143;2653;796;2244;98;293;474;1403;572;1696
521920;201709;336;1020;253;844;57;218;70;235;127;453
521925;201709;582;1726;458;1493;99;325;133;417;232;742
521930;201709;3421;10253;2910;9406;974;3191;815;2757;1789;5948
521935;201709;630;1740;515;1514;128;367;215;631;343;998
521940;201709;1048;2671;806;2347;198;655;385;1088;583;1743
521945;201709;573;1752;480;1585;86;299;233;816;319;1115
521950;201709;603;1512;499;1373;41;116;387;1071;428;1187
521960;201709;659;1907;486;1559;77;263;219;673;296;936
521970;201709;2615;6772;2192;6273;169;432;1764;5248;1933;5680
521971;201709;886;2299;596;1815;126;395;150;452;276;847
521973;201709;983;2883;822;2618;130;460;447;1416;577;1876
521975;201709;11919;32558;10540;30814;1827;5584;6744;19693;8571;25277
521980;201709;2254;5860;1851;5334;215;547;1384;4086;1599;4633
521990;201709;1142;3234;918;2871;128;412;537;1738;665;2150
522000;201709;2170;5879;1606;5159;203;658;844;2899;1047;3557
522005;201709;344;841;251;706;75;197;88;264;163;461
522010;201709;3343;8965;2601;7790;884;2749;590;1767;1474;4516
522015;201709;882;2543;708;2249;168;561;280;883;448;1444
522020;201709;4885;12355;3538;10214;877;2620;1482;4309;2359;6929
522026;201709;689;1881;516;1655;86;284;282;962;368;1246
522028;201709;498;1370;361;1074;56;177;169;474;225;651
522040;201709;2385;5516;1750;4737;296;800;1179;3244;1475;4044
522045;201709;14423;45407;11548;39621;3094;11496;2125;7225;5219;18721
522050;201709;1048;2973;742;2373;157;536;226;660;383;1196
522060;201709;2253;6609;1892;6041;342;1144;1049;3407;1391;4551
522068;201709;1593;4829;1420;4618;180;526;1031;3533;1211;4059
522070;201709;589;1712;512;1584;60;250;345;1018;405;1268
522100;201709;528;1480;413;1309;89;301;198;625;287;926
522108;201709;798;2453;666;2232;59;276;500;1604;559;1880
522119;201709;1448;4090;1190;3719;216;681;625;2026;841;2707
522130;201709;333;921;265;827;70;226;126;406;196;632
522140;201709;15281;43237;12001;37446;3836;12773;1938;5936;5774;18709
522145;201709;808;2075;611;1786;144;376;328;1044;472;1420
522150;201709;925;2364;736;2079;207;576;282;828;489;1404
522155;201709;831;2352;714;2169;157;432;361;1163;518;1595
522157;201709;579;1590;489;1455;30;115;357;1038;387;1153
522160;201709;5911;16169;4144;12984;1199;4083;397;1349;1596;5432
522170;201709;2232;6376;1661;5307;554;1895;299;965;853;2860
522180;201709;415;1123;264;850;65;210;50;181;115;391
522185;201709;14713;39723;11589;35721;3906;12746;4344;14261;8250;27007
522190;201709;811;1972;624;1708;119;317;290;836;409;1153
522200;201709;1647;5149;1208;4158;267;968;197;675;464;1643
522205;201709;1325;3452;1048;3036;103;330;726;2116;829;2446
522220;201709;1428;3604;1076;3115;136;370;631;1935;767;2305
522230;201709;1181;3163;985;2868;163;529;561;1640;724;2169
530010;201709;166292;501078;144850;465282;34187;121927;65928;206628;100115;328555
110001;201708;3395;10883;2930;10118;730;2653;1327;4624;2057;7277
110002;201708;13102;36979;10009;31641;3088;10571;3076;9536;6164;20107
110003;201708;766;2345;612;2035;191;671;111;342;302;1013
110004;201708;9396;28884;7566;25253;2340;8282;1347;4856;3687;13138
110005;201708;2027;5973;1572;5147;415;1423;597;1995;1012;3418
110006;201708;1722;5167;1161;3977;353;1279;118;389;471;1668
110007;201708;1361;3987;1132;3566;337;1119;420;1522;757;2641
110008;201708;2498;8161;2276;7861;310;1005;1719;6199;2029;7204
110009;201708;4676;13926;3514;12023;1054;3791;996;3535;2050;7326
110010;201708;7061;22600;6103;21094;1783;6227;2605;10032;4388;16259
110011;201708;6968;21106;5826;18877;2038;6943;1541;4979;3579;11922
110012;201708;15459;43204;11751;36827;3177;10529;2504;7945;5681;18474
110013;201708;5516;17098;4609;15376;1834;6317;993;3588;2827;9905
110014;201708;4105;11519;3327;10227;999;3195;1401;4248;2400;7443
110015;201708;5027;14657;3382;11364;886;3165;469;1578;1355;4743
110018;201708;4028;10984;2834;9061;710;2548;861;2637;1571;5185
110020;201708;71119;186763;51427;159957;11808;39027;20603;67592;32411;106619
110025;201708;4387;12147;3433;10468;577;1888;1988;5909;2565;7797
110026;201708;633;1919;560;1799;166;571;248;798;414;1369
110028;201708;6447;19219;4967;16253;1468;5228;591;1893;2059;7121
110029;201708;1340;3684;1003;3171;278;905;410;1315;688;2220
110030;201708;10568;28543;8031;24870;1903;6584;3054;9414;4957;15998
110032;201708;3685;11365;2960;9866;993;3382;727;2431;1720;5813
110033;201708;4924;15703;4213;14396;1477;5108;1261;4687;2738;9795
110034;201708;3474;9162;2705;8089;875;2775;1245;3723;2120;6498
110037;201708;1871;6273;1608;5705;422;1577;686;2423;1108;4000
110040;201708;3313;10050;2665;8842;845;3012;761;2420;1606;5432
110045;201708;4985;15778;4326;14882;1409;5226;1757;6054;3166;11280
110050;201708;1668;5209;1375;4652;560;1952;350;1214;910;3166
110060;201708;827;2687;646;2291;230;865;87;326;317;1191
110070;201708;1975;6486;1664;5766;575;2114;478;1576;1053;3690
110080;201708;4979;13199;4032;12053;1019;3207;2056;6327;3075;9534
110090;201708;696;1974;501;1620;131;460;212;653;343;1113
110092;201708;1324;4239;1158;3988;213;807;642;2272;855;3079
110094;201708;3449;10106;2832;9131;956;3230;980;3215;1936;6445
110100;201708;2108;6515;1856;6058;417;1472;942;3063;1359;4535
110110;201708;1650;5059;1355;4600;500;1781;309;1111;809;2892
110120;201708;1716;5304;1315;4451;381;1376;260;860;641;2236
110130;201708;2547;6942;1781;5658;512;1785;495;1569;1007;3354
110140;201708;2407;7636;1865;6536;508;1879;450;1504;958;3383
110143;201708;1470;4180;1090;3494;375;1226;324;1058;699;2284
110145;201708;1129;3136;767;2446;186;646;276;858;462;1504
110146;201708;427;1254;345;1130;69;220;166;564;235;784
110147;201708;714;2051;517;1674;138;465;172;521;310;986
110148;201708;1136;3445;726;2486;135;490;87;300;222;790
110149;201708;3268;9543;2501;8327;915;3053;844;2990;1759;6043
110150;201708;2433;6847;1954;6150;781;2756;457;1350;1238;4106
110155;201708;838;2590;717;2324;174;597;273;852;447;1449
110160;201708;1817;5757;1469;5045;524;1817;373;1339;897;3156
110170;201708;2801;7707;1985;6220;441;1453;902;2799;1343;4252
110175;201708;1627;4864;1286;4368;212;778;664;2367;876;3145
110180;201708;1241;3590;1007;3217;298;934;474;1548;772;2482
120001;201708;2892;9459;2558;8942;537;1900;1475;5424;2012;7324
120005;201708;1697;6799;1576;6582;194;859;1137;4953;1331;5812
120010;201708;5038;16604;4743;16136;682;2253;3354;11797;4036;14050
120013;201708;2144;8373;2034;8217;519;2042;1160;5049;1679;7091
120017;201708;2109;7379;1926;7049;463;1704;965;3862;1428;5566
120020;201708;14502;62880;13987;61885;1843;8573;9972;45510;11815;54083
120025;201708;2457;8313;2349;8152;486;1723;1409;5005;1895;6728
120030;201708;6644;25595;6443;25355;312;1553;5643;22236;5955;23789
120032;201708;1554;7414;1483;7239;130;766;1134;5547;1264;6313
120033;201708;3732;14632;3603;14411;186;886;3144;12588;3330;13474
120034;201708;2088;8614;1955;8363;140;854;1559;6557;1699;7411
120035;201708;3205;14088;3101;13899;211;1128;2612;11787;2823;12915
120038;201708;2684;9288;2504;8962;601;2184;1327;4920;1928;7104
120039;201708;1835;8566;1777;8457;201;1238;1266;5979;1467;7217
120040;201708;44643;156136;40943;149563;8976;35390;21448;79744;30424;115134
120042;201708;3137;12611;2961;12226;182;945;2299;9503;2481;10448
120043;201708;1125;5032;1078;4940;71;370;916;4265;987;4635
120045;201708;4870;15687;4613;15400;302;1131;4090;13648;4392;14779
120050;201708;8246;32973;7836;32115;981;4379;5589;23516;6570;27895
120060;201708;8160;35093;7913;34665;704;3665;6338;28028;7042;31693
120070;201708;2786;10031;2677;9816;406;1503;1774;6739;2180;8242
120080;201708;3771;13910;3587;13606;643;2576;2442;9438;3085;12014
130002;201708;3240;13098;3010;12764;146;745;2645;11317;2791;12062
130006;201708;2236;9033;1927;8475;161;850;1457;6429;1618;7279
130008;201708;2365;8933;2162;8555;129;629;1756;6963;1885;7592
130010;201708;3455;10746;3169;10410;132;457;2868;9492;3000;9949
130014;201708;3315;10464;2825;9663;487;1802;1764;6112;2251;7914
130020;201708;2843;10653;2683;10382;124;702;2257;8618;2381;9320
130030;201708;8469;30637;8032;30142;256;762;7444;28554;7700;29316
130040;201708;3809;11505;3310;10868;273;961;2641;8820;2914;9781
130050;201708;6508;25995;6119;25487;289;1128;5340;22928;5629;24056
130060;201708;6389;28460;5993;27796;578;3305;4559;21172;5137;24477
130063;201708;4551;18408;4245;18037;211;1059;3805;16288;4016;17347
130068;201708;3326;13435;2974;12710;248;1242;2202;9464;2450;10706
130070;201708;8383;27538;7512;26535;467;1529;6412;23319;6879;24848
130080;201708;5852;24728;5426;24133;553;2998;4128;18465;4681;21463
130083;201708;2377;9037;2222;8797;243;1137;1679;6625;1922;7762
130090;201708;3005;10093;2820;9822;78;328;2495;8819;2573;9147
130100;201708;6180;21936;5926;21649;150;532;5600;20669;5750;21201
130110;201708;7150;22339;6641;21743;646;1832;5461;18516;6107;20348
130115;201708;4968;16861;4691;16445;154;551;4096;14512;4250;15063
130120;201708;15374;56726;14314;55353;1515;6013;11338;44972;12853;50985
130130;201708;4184;16354;4100;16209;504;2264;3097;12209;3601;14473
130140;201708;6500;25114;6376;24980;282;1178;5889;23159;6171;24337
130150;201708;3499;13886;3430;13801;136;743;3096;12447;3232;13190
130160;201708;4624;18411;4343;18047;417;2049;3515;14735;3932;16784
130165;201708;3055;12262;2909;12016;151;815;2468;10230;2619;11045
130170;201708;10504;34597;8862;32659;860;3406;7023;26535;7883;29941
130180;201708;3679;12082;3608;11994;69;235;3427;11460;3496;11695
130185;201708;13487;39841;11785;37975;632;1553;10121;34294;10753;35847
130190;201708;17565;59890;15300;56850;2232;8277;10578;40976;12810;49253
130195;201708;2047;8552;1981;8466;112;441;1754;7685;1866;8126
130200;201708;2123;7031;1919;6722;248;860;1385;5025;1633;5885
130210;201708;1422;5430;1289;5270;121;681;1010;4059;1131;4740
130220;201708;2072;8213;1911;7919;186;876;1394;5835;1580;6711
130230;201708;3846;17527;3577;17101;382;2080;2792;13626;3174;15706
130240;201708;9689;33844;8506;32150;303;1641;7356;27905;7659;29546
130250;201708;21541;72403;20149;70718;2045;6941;16071;58495;18116;65436
130255;201708;4348;15200;4025;14676;306;1278;3235;11875;3541;13153
130260;201708;258724;825821;230112;778101;68675;248282;93179;317961;161854;566243
130270;201708;7704;31108;7033;30058;864;3905;5133;22658;5997;26563
130280;201708;3394;14091;3259;13932;105;468;3025;13126;3130;13594
130290;201708;11758;41198;11023;40371;220;529;10467;39184;10687;39713
130300;201708;4738;17587;4470;17186;291;1389;3754;14490;4045;15879
130310;201708;5446;20211;5004;19627;425;1706;4045;16220;4470;17926
130320;201708;3216;11348;2924;10944;386;1433;2034;7913;2420;9346
130330;201708;4035;14100;3568;13511;167;871;3076;11598;3243;12469
130340;201708;19366;71303;17692;69274;1857;7173;14311;57906;16168;65079
130350;201708;3597;14224;3448;14011;229;1296;2908;11697;3137;12993
130353;201708;6505;19507;5671;18455;1005;3154;3743;13083;4748;16237
130356;201708;4911;17315;4520;16691;543;2105;3178;12056;3721;14161
130360;201708;3479;9918;3035;9452;102;258;2808;8913;2910;9171
130370;201708;5663;22025;5105;21294;211;1164;4346;18240;4557;19404
130380;201708;8270;33877;7918;33369;555;2858;6667;28079;7222;30937
130390;201708;5449;23796;5122;23181;557;2943;3793;17154;4350;20097
130395;201708;2365;7977;2092;7483;256;939;1451;5238;1707;6177
130400;201708;2270;8156;2111;7927;118;520;1842;6980;1960;7500
130406;201708;11259;41814;10144;40303;1924;7906;6722;27386;8646;35292
130410;201708;4000;14797;3538;13988;1063;4418;1662;6801;2725;11219
130420;201708;11361;46052;10762;45212;1430;6359;8182;35148;9612;41507
130423;201708;3754;13486;3458;13084;209;1029;2957;11085;3166;12114
130426;201708;2533;10445;2454;10320;105;505;2211;9409;2316;9914
130430;201708;3805;12673;3615;12407;363;1206;2890;10158;3253;11364
130440;201708;3949;13633;3627;13256;142;572;3291;12137;3433;12709
140002;201708;1803;5800;1625;5566;126;523;1263;4294;1389;4817
140005;201708;3613;9775;3463;9615;69;193;3327;9268;3396;9461
140010;201708;55388;156584;44720;140966;10942;36501;17509;58572;28451;95073
140015;201708;3164;9974;2898;9666;150;482;2564;8701;2714;9183
140017;201708;3502;11015;3127;10527;307;1031;2304;8118;2611;9149
140020;201708;4837;15574;4273;14799;476;1894;3117;10840;3593;12734
140023;201708;2271;7379;1949;6890;264;1012;1301;4674;1565;5686
140028;201708;2195;5952;1957;5635;215;718;1456;4055;1671;4773
140030;201708;3897;11855;3578;11439;480;1375;2655;8804;3135;10179
140040;201708;1878;8418;1812;8331;89;528;1638;7506;1727;8034
140045;201708;2683;9873;2379;9447;443;1743;1531;6507;1974;8250
140047;201708;5937;17797;5134;16536;1222;3984;2515;8722;3737;12706
140050;201708;1479;4508;1283;4220;199;643;824;2792;1023;3435
140060;201708;1503;4400;1320;4120;171;563;974;3065;1145;3628
140070;201708;1715;9293;1657;9127;154;1066;1283;7042;1437;8108
150010;201708;39376;110090;36668;106433;2097;6844;30419;88075;32516;94919
150013;201708;1778;5068;1576;4840;174;504;1157;3667;1331;4171
150020;201708;12933;42549;12460;41902;1373;3969;10112;35265;11485;39234
150030;201708;7943;32555;7666;32163;506;2141;6586;28149;7092;30290
150034;201708;4267;11649;3784;10957;270;836;3088;8951;3358;9787
150040;201708;13241;40340;11671;38504;1234;3279;9289;32632;10523;35911
150050;201708;6025;23074;5708;22557;213;1066;5030;19934;5243;21000
150060;201708;19261;58287;17154;54930;4133;13136;9234;31005;13367;44141
150070;201708;6301;24965;5653;24262;186;984;5177;22456;5363;23440
150080;201708;84126;209851;71914;193797;16226;45220;30289;89436;46515;134656
150085;201708;6038;19656;5751;19303;300;820;5126;17679;5426;18499
150090;201708;10492;39492;9892;38606;830;3494;7795;30853;8625;34347
150095;201708;5582;17704;5047;16961;332;1064;4043;14004;4375;15068
150100;201708;3274;11826;3002;11336;235;999;2284;8586;2519;9585
150110;201708;3747;17439;3715;17389;253;1183;3271;15539;3524;16722
150120;201708;6999;24533;6804;24253;434;1332;5788;21367;6222;22699
150125;201708;792;2198;671;2051;119;413;416;1245;535;1658
150130;201708;23251;69446;21206;66510;2637;7780;15206;49305;17843;57085
150140;201708;181054;484899;165688;464789;24427;67549;113669;326609;138096;394158
150145;201708;4657;14243;4192;13629;567;1746;3194;10691;3761;12437
150150;201708;13043;37985;11974;36458;1492;4796;8549;26349;10041;31145
150157;201708;3193;9412;2741;8797;326;1152;1865;6105;2191;7257
150160;201708;3162;9815;2961;9518;767;2468;1590;5281;2357;7749
150170;201708;24746;83772;22067;79794;3629;12909;14088;53835;17717;66744
150172;201708;3411;10963;2941;10232;322;1094;2169;7781;2491;8875
150175;201708;1874;5584;1723;5396;146;518;1354;4320;1500;4838
150178;201708;10271;30337;8740;28513;828;2771;6666;22454;7494;25225
150180;201708;19322;75749;18502;74650;1124;4940;15870;64792;16994;69732
150190;201708;7218;24272;6932;23899;207;888;6274;21715;6481;22603
150195;201708;5520;17524;5205;17037;127;421;4770;15753;4897;16174
150200;201708;5465;16850;5135;16469;72;223;4860;15721;4932;15944
150210;201708;25207;93224;24391;92109;1718;6575;20457;79407;22175;85982
150215;201708;7878;24447;6930;22964;2234;7575;2671;9270;4905;16845
150220;201708;11816;35929;10607;34079;2217;7151;5691;19046;7908;26197
150230;201708;12603;37712;10924;35426;1745;5494;7051;24141;8796;29635
150240;201708;35464;103861;30254;94583;10116;32568;7905;25789;18021;58357
150250;201708;4088;16950;3937;16731;671;2834;2761;12243;3432;15077
150260;201708;2224;8392;2116;8217;291;1156;1444;5727;1735;6883
150270;201708;8416;25070;6470;22520;1826;6540;2941;10754;4767;17294
150275;201708;6221;21725;5841;21148;570;2011;4467;16525;5037;18536
150276;201708;2229;6514;1980;6204;276;890;1487;4754;1763;5644
150277;201708;4864;14441;4150;13573;490;1658;3091;10443;3581;12101
150280;201708;6058;26554;5884;26182;649;2925;4567;20694;5216;23619
150285;201708;3161;11816;2893;11386;341;1468;1980;7925;2321;9393
150290;201708;10480;29251;9920;28629;714;1662;8507;25499;9221;27161
150293;201708;9483;24980;7052;21664;2063;6462;2656;9087;4719;15549
150295;201708;7773;22007;6336;20308;1673;5394;3160;11456;4833;16850
150300;201708;2082;6728;1927;6517;81;382;1605;5393;1686;5775
150304;201708;4249;13416;3699;12534;654;2188;2334;8236;2988;10424
150307;201708;6603;21481;6201;20919;369;1268;5263;17907;5632;19175
150309;201708;6262;20657;5510;19534;1380;4848;2781;10581;4161;15429
150310;201708;6599;27560;6278;27116;437;2191;5248;22803;5685;24994
150320;201708;9673;25132;8831;24158;604;1552;7182;19970;7786;21522
150330;201708;14402;47752;13465;46384;1894;6617;9704;34397;11598;41014
150340;201708;2639;8048;2425;7723;224;691;1837;5913;2061;6604
150345;201708;7294;23130;6785;22438;584;2038;5425;18224;6009;20262
150350;201708;8479;24672;7884;23949;1130;2813;5973;19075;7103;21888
150360;201708;22286;67181;19171;63275;2909;9324;12821;44294;15730;53618
150370;201708;10212;35450;9174;34035;1002;3713;6728;25997;7730;29710
150375;201708;3103;13224;2840;12815;317;1488;2255;10323;2572;11811
150380;201708;9823;27790;8539;25989;491;1534;7108;21975;7599;23509
150390;201708;7994;34068;7443;33091;1296;5436;4839;22683;6135;28119
150400;201708;6112;23198;5852;22705;423;1649;4700;18504;5123;20153
150405;201708;8496;24806;7561;23659;640;1540;5842;19411;6482;20951
150410;201708;1676;6080;1535;5805;242;957;955;3674;1197;4631
150420;201708;37197;120410;30664;109922;10203;38916;8474;33882;18677;72798
150430;201708;7856;25293;7417;24650;845;2717;5617;19186;6462;21903
150440;201708;5574;18692;5338;18369;434;1426;4356;15303;4790;16729
150442;201708;22393;62549;19579;58347;3139;9288;11834;36680;14973;45968
150445;201708;5723;19065;5221;18267;418;1469;4113;14666;4531;16135
150450;201708;4504;21049;4329;20766;419;2122;3519;17131;3938;19253
150460;201708;7537;26598;6934;25830;361;1615;5803;22390;6164;24005
150470;201708;18210;54518;17351;53479;1346;3527;14882;46878;16228;50405
150475;201708;4010;13643;3661;13150;274;1041;2959;10824;3233;11865
150480;201708;14438;48623;13130;46568;1886;6856;9323;34034;11209;40890
150490;201708;7420;27838;7189;27496;258;1212;6342;24399;6600;25611
150495;201708;5076;18329;4916;18122;166;667;4508;16749;4674;17416
150497;201708;2670;9478;2359;8879;700;2704;1062;4187;1762;6891
150500;201708;3282;8856;2980;8419;328;895;2309;6537;2637;7432
150503;201708;3946;11928;3198;10851;996;3458;1483;5315;2479;8773
150506;201708;10928;37037;9935;35630;2147;7203;6237;24069;8384;31272
150510;201708;10137;38517;9092;36346;1483;5716;5782;24457;7265;30173
150520;201708;6945;26990;6830;26843;231;944;6367;25230;6598;26174
150530;201708;12558;43040;11277;41007;1330;4260;8371;31627;9701;35887
150540;201708;4807;14139;4204;13283;229;756;3491;11065;3720;11821
150543;201708;6183;18396;5396;17310;1012;3276;3453;11552;4465;14828
150548;201708;9964;31250;9228;30333;377;1126;8364;27808;8741;28934
150549;201708;2089;6566;1894;6345;61;235;1712;5761;1773;5996
150550;201708;20611;64419;17885;59754;5262;17848;6623;23580;11885;41428
150553;201708;24011;79899;19724;71543;6947;26555;5198;20253;12145;46808
150555;201708;1790;5191;1477;4686;94;322;1043;3321;1137;3643
150560;201708;1863;6029;1706;5717;303;1003;962;3304;1265;4307
150563;201708;2616;8555;2379;8130;514;1845;1261;4337;1775;6182
150565;201708;4047;13689;3673;13086;129;608;3046;10937;3175;11545
150570;201708;5934;21204;5748;20894;420;1673;4587;16747;5007;18420
150580;201708;9972;41834;9642;41419;714;3164;8134;35744;8848;38908
150590;201708;6276;24280;6020;23949;192;910;5567;22180;5759;23090
150600;201708;8375;31270;7949;30671;273;1234;7101;27624;7374;28858
150610;201708;2497;8187;2298;7790;183;703;1762;5901;1945;6604
150611;201708;2860;9319;2673;9004;159;572;2203;7455;2362;8027
150613;201708;12847;37299;10223;33101;2592;8726;4339;14584;6931;23310
150616;201708;3257;9622;2453;8247;574;2139;719;2285;1293;4424
150618;201708;6750;22035;5948;20615;1282;4500;3254;11718;4536;16218
150619;201708;5293;17453;4812;16697;482;1842;3556;12305;4038;14147
150620;201708;6552;22801;5806;21851;722;2804;4307;16470;5029;19274
150630;201708;6174;17562;5821;17153;421;1294;4948;14748;5369;16042
150635;201708;4038;12775;3617;11979;893;3010;1611;5559;2504;8569
150640;201708;2100;6071;1955;5912;66;210;1796;5539;1862;5749
150650;201708;11901;35569;10731;33491;3160;9782;4490;14901;7650;24683
150655;201708;5279;16622;4941;16038;415;1366;3933;12860;4348;14226
150658;201708;4574;13363;3900;12449;794;2774;2293;7578;3087;10352
150660;201708;5767;17547;5247;16794;947;2984;3169;10433;4116;13417
150670;201708;7951;20218;6409;18363;705;1965;4922;14545;5627;16510
150680;201708;64818;210258;53657;192324;14768;53660;22495;89557;37263;143217
150690;201708;2124;6268;1904;5938;147;467;1491;4706;1638;5173
150700;201708;6262;19488;5759;18830;693;2200;4126;13987;4819;16187
150710;201708;4330;14353;3868;13631;375;1440;2758;9849;3133;11289
150715;201708;4982;15215;4332;14214;413;1493;3213;10593;3626;12086
150720;201708;6563;25582;6183;24902;614;2693;4710;19348;5324;22041
150730;201708;10689;35493;9797;34006;1229;4432;7217;25606;8446;30038
150740;201708;3724;11536;3321;10822;549;1804;2021;6685;2570;8489
150745;201708;4965;15593;4435;14854;976;3447;2768;9353;3744;12800
150746;201708;1380;4473;1304;4332;103;318;1024;3480;1127;3798
150747;201708;5447;16813;4797;15962;900;2693;2971;10762;3871;13455
150750;201708;3534;11362;3184;10870;212;849;2511;8660;2723;9509
150760;201708;11728;36354;10878;35260;1324;4307;7973;26347;9297;30654
150770;201708;6027;22494;5808;22165;207;645;5200;20776;5407;21421
150775;201708;1056;3147;891;2873;164;653;491;1521;655;2174
150780;201708;3848;12232;3702;12067;123;470;3384;11071;3507;11541
150790;201708;5135;16290;4681;15775;284;899;3827;13844;4111;14743
150795;201708;14858;47847;13432;45571;3090;10139;7617;27324;10707;37463
150796;201708;3340;9340;2982;8914;253;784;2343;7185;2596;7969
150797;201708;3865;12952;3525;12350;138;495;2916;10302;3054;10797
150800;201708;14111;45180;12950;43766;2385;7392;8860;31890;11245;39282
150803;201708;6901;24137;6454;23434;662;2511;4924;18076;5586;20587
150805;201708;2878;9990;2620;9551;345;1235;1882;7001;2227;8236
150808;201708;5883;18852;4689;16575;1761;6774;524;1972;2285;8746
150810;201708;20189;58892;16156;53932;2858;9325;9654;34549;12512;43874
150812;201708;5461;16630;4971;15799;594;2067;3516;10947;4110;13014
150815;201708;8731;28227;7784;27038;839;2866;5942;21258;6781;24124
150820;201708;11631;33178;10415;31813;841;2261;8288;26243;9129;28504
150830;201708;12731;47804;12056;46958;601;3009;10038;40087;10639;43096
150835;201708;2232;7771;2068;7452;481;1739;1061;3970;1542;5709
150840;201708;7667;22959;6216;20463;1383;4865;2727;9097;4110;13962
160005;201708;879;2869;836;2785;37;154;730;2419;767;2573
160010;201708;1436;4752;1433;4749;18;30;1402;4687;1420;4717
160015;201708;1901;6922;1841;6836;99;359;1651;6226;1750;6585
160020;201708;1902;6969;1763;6745;258;1077;1279;4915;1537;5992
160021;201708;1091;4570;1053;4504;111;613;795;3379;906;3992
160023;201708;1031;4240;1010;4202;79;313;845;3588;924;3901
160025;201708;1512;4587;1492;4565;37;97;1433;4411;1470;4508
160027;201708;8385;24484;7792;23824;965;2681;6060;19325;7025;22006
160030;201708;52855;175443;46500;165536;11280;39504;23593;91252;34873;130756
160040;201708;4411;16970;4302;16820;214;1113;3845;14852;4059;15965
160050;201708;3536;12668;3133;12098;1553;5755;952;4320;2505;10075
160053;201708;3100;11300;3008;11165;656;2311;1994;7719;2650;10030
160055;201708;563;2261;556;2251;26;139;506;2027;532;2166
160060;201708;16494;55514;15661;54542;1702;5560;12399;44483;14101;50043
160070;201708;2879;11116;2685;10792;201;928;2178;8858;2379;9786
160080;201708;2620;9631;2551;9545;73;347;2355;8816;2428;9163
170025;201708;559;1726;472;1606;142;481;214;745;356;1226
170030;201708;1213;3899;1023;3548;200;706;483;1751;683;2457
170035;201708;1474;3974;1149;3438;134;436;646;1957;780;2393
170040;201708;1909;5708;1618;5333;173;618;823;2963;996;3581
170070;201708;1665;4327;1253;3784;187;593;716;2199;903;2792
170100;201708;2402;6962;2051;6425;212;673;1471;4657;1683;5330
170105;201708;758;2359;568;1943;147;507;223;752;370;1259
170110;201708;920;2992;787;2739;170;634;341;1218;511;1852
170130;201708;1392;4347;1074;3715;231;832;492;1790;723;2622
170190;201708;1635;4690;1176;3939;378;1219;259;1080;637;2299
170200;201708;1652;4460;1039;3295;297;1027;199;581;496;1608
170210;201708;31198;86965;24629;76487;8108;27455;4138;13835;12246;41290
170215;201708;1274;3822;1081;3536;89;366;776;2498;865;2864
170220;201708;5806;19116;5262;18058;1309;4474;2602;9315;3911;13789
170230;201708;1349;4246;1078;3711;242;869;403;1411;645;2280
170240;201708;2808;8169;2232;7237;203;810;1473;4709;1676;5519
170255;201708;3548;11086;2836;9777;791;2806;1145;4064;1936;6870
170270;201708;1033;2510;674;2011;36;116;456;1336;492;1452
170290;201708;2942;8318;2538;7864;235;513;2030;6806;2265;7319
170300;201708;1924;5695;1578;5136;210;675;967;3255;1177;3930
170305;201708;748;2169;586;1854;83;279;288;889;371;1168
170307;201708;1020;3574;864;3265;188;721;416;1631;604;2352
170310;201708;1543;4274;1162;3602;250;837;551;1685;801;2522
170320;201708;1144;3178;824;2650;146;489;400;1309;546;1798
170330;201708;826;2664;744;2528;47;194;554;1852;601;2046
170360;201708;483;1460;386;1295;61;236;218;695;279;931
170370;201708;1330;3698;1019;3196;167;532;487;1551;654;2083
170380;201708;1846;5837;1457;5173;192;764;798;2913;990;3677
170382;201708;598;1814;480;1618;77;271;287;967;364;1238
170384;201708;1596;6243;1416;5884;406;1793;605;2524;1011;4317
170386;201708;852;2429;590;1905;101;367;130;372;231;739
170388;201708;609;1801;460;1535;84;298;197;642;281;940
170389;201708;915;3025;808;2845;61;249;599;2084;660;2333
170390;201708;1374;3706;1089;3360;97;315;821;2587;918;2902
170410;201708;538;1707;430;1508;26;109;268;938;294;1047
170460;201708;488;1306;343;1065;50;176;173;545;223;721
170510;201708;805;2602;618;2238;86;354;302;1076;388;1430
170550;201708;6666;18633;4873;15522;1523;5405;738;2403;2261;7808
170555;201708;1374;3878;1086;3432;143;483;558;1796;701;2279
170560;201708;1167;3447;881;3051;143;566;460;1742;603;2308
170600;201708;1369;3900;1163;3605;319;908;612;2009;931;2917
170610;201708;1648;4864;1306;4262;125;466;849;2733;974;3199
170625;201708;399;1175;289;929;41;139;99;302;140;441
170650;201708;1265;3948;1007;3476;246;863;372;1395;618;2258
170700;201708;3997;12218;3195;10828;670;2487;1344;4674;2014;7161
170710;201708;1768;5093;1387;4390;297;1043;603;1792;900;2835
170720;201708;1898;4957;1616;4545;127;271;1311;3868;1438;4139
170730;201708;973;2905;771;2562;205;714;337;1145;542;1859
170740;201708;2125;7483;1823;6916;271;1034;1140;4419;1411;5453
170755;201708;856;2567;636;2125;87;330;291;962;378;1292
170765;201708;1284;3462;921;2879;239;769;342;1152;581;1921
170770;201708;1754;5699;1550;5356;266;902;923;3269;1189;4171
170820;201708;4136;14411;3723;13716;612;2175;2157;8513;2769;10688
170825;201708;1014;2555;824;2279;88;215;523;1484;611;1699
170830;201708;1460;4107;1192;3689;59;145;950;2998;1009;3143
170900;201708;2565;8950;2382;8658;206;822;1899;6971;2105;7793
170930;201708;3727;10822;3166;9928;714;2458;1478;4763;2192;7221
170950;201708;14019;40157;10348;33815;3016;11141;1445;4813;4461;15954
170980;201708;507;1404;380;1193;45;153;201;596;246;749
171050;201708;1564;5102;1395;4797;90;417;1063;3592;1153;4009
171070;201708;1405;4276;1262;4065;305;914;737;2570;1042;3484
171090;201708;1135;2895;920;2603;64;186;666;1868;730;2054
171110;201708;589;1721;434;1447;120;451;170;500;290;951
171150;201708;1032;2761;673;2124;78;275;400;1257;478;1532
171180;201708;706;2089;480;1633;95;335;198;712;293;1047
171190;201708;1606;5909;1426;5551;271;1102;734;2994;1005;4096
171195;201708;840;2886;723;2681;97;459;453;1658;550;2117
171200;201708;649;1964;508;1704;140;489;175;588;315;1077
171215;201708;452;1320;341;1104;76;279;143;450;219;729
171240;201708;724;2598;654;2459;73;335;402;1542;475;1877
171245;201708;594;1977;485;1720;103;402;197;679;300;1081
171250;201708;1084;3036;847;2648;199;661;425;1318;624;1979
171270;201708;401;1599;364;1506;111;425;157;734;268;1159
171280;201708;878;2700;708;2391;168;564;303;1117;471;1681
171320;201708;3974;11643;3253;10384;840;2684;1359;4621;2199;7305
171330;201708;2777;7958;2214;7024;557;1888;1023;3310;1580;5198
171360;201708;1431;4447;1264;4211;107;394;988;3304;1095;3698
171370;201708;684;1876;562;1712;72;244;364;1109;436;1353
171380;201708;1317;4131;1070;3685;325;1139;357;1335;682;2474
171395;201708;929;2733;686;2256;107;418;335;1056;442;1474
171420;201708;1877;5843;1428;4937;290;1099;589;2048;879;3147
171430;201708;1066;3181;879;2862;116;396;562;1792;678;2188
171488;201708;2534;7678;2095;6998;404;1363;1116;3898;1520;5261
171500;201708;907;2537;718;2233;73;246;487;1517;560;1763
171510;201708;837;2901;747;2738;65;275;505;1867;570;2142
171515;201708;501;1393;382;1188;37;118;224;687;261;805
171525;201708;617;1936;522;1768;48;201;333;1079;381;1280
171550;201708;369;1142;269;973;55;214;107;395;162;609
171570;201708;1272;3882;1095;3547;202;629;683;2285;885;2914
171575;201708;1937;5264;1331;4177;228;761;580;1789;808;2550
171610;201708;5475;16771;4458;14996;1128;4186;1265;4374;2393;8560
171620;201708;2832;7960;2394;7376;131;474;1944;6038;2075;6512
171630;201708;931;2792;776;2555;188;653;422;1397;610;2050
171650;201708;2234;6793;1665;5616;410;1423;541;1863;951;3286
171660;201708;2433;6627;1789;5471;303;945;909;2759;1212;3704
171665;201708;1492;4257;1147;3726;232;811;512;1722;744;2533
171670;201708;1892;5210;1517;4611;330;1144;724;2130;1054;3274
171700;201708;1121;3473;897;3052;146;478;474;1644;620;2122
171720;201708;789;2238;664;2022;105;323;410;1259;515;1582
171750;201708;1199;3618;883;3002;240;817;229;849;469;1666
171780;201708;1272;3351;923;2849;88;291;568;1753;656;2044
171790;201708;1481;5178;1216;4550;288;1119;544;2136;832;3255
171800;201708;736;2188;597;1980;68;234;373;1272;441;1506
171820;201708;10550;31063;8493;27659;1964;6784;3296;11094;5260;17878
171830;201708;1397;5054;1247;4729;298;1154;588;2322;886;3476
171840;201708;723;2003;609;1837;41;140;440;1293;481;1433
171845;201708;695;1882;537;1629;84;295;276;848;360;1143
171850;201708;891;3157;783;2929;82;345;516;1933;598;2278
171855;201708;1171;3644;1047;3432;86;290;727;2376;813;2666
171865;201708;432;1462;374;1367;76;301;172;620;248;921
171870;201708;736;2149;563;1824;113;363;245;892;358;1255
171875;201708;1266;3930;1050;3576;82;350;750;2495;832;2845
171880;201708;913;3220;873;3165;71;242;724;2701;795;2943
171884;201708;930;2534;680;2160;140;506;199;711;339;1217
171886;201708;1391;4314;1067;3672;317;1181;187;664;504;1845
171888;201708;753;2221;552;1828;57;209;331;1074;388;1283
171889;201708;518;1573;449;1448;78;266;208;708;286;974
171890;201708;1199;3456;964;3107;179;578;538;1765;717;2343
171900;201708;494;1779;388;1513;95;373;149;597;244;970
172000;201708;604;1904;502;1702;83;326;259;840;342;1166
172010;201708;1167;4013;1051;3787;120;543;681;2375;801;2918
172015;201708;337;1296;276;1175;50;207;137;591;187;798
172020;201708;2388;7746;2214;7477;244;907;1577;5360;1821;6267
172025;201708;723;2081;525;1740;73;273;294;998;367;1271
172030;201708;1215;3772;1064;3523;50;210;826;2723;876;2933
172049;201708;1382;3464;957;2773;363;1141;412;1168;775;2309
172065;201708;1428;3677;1162;3373;78;215;1021;3007;1099;3222
172080;201708;2483;7590;2050;6811;168;635;1377;4565;1545;5200
172085;201708;481;1360;332;1047;60;168;107;335;167;503
172090;201708;4030;10725;3242;9595;137;414;2706;8117;2843;8531
172093;201708;556;1672;425;1443;88;351;197;637;285;988
172097;201708;678;1928;516;1656;102;347;204;674;306;1021
172100;201708;39799;109609;29015;91584;7505;26269;7694;25198;15199;51467
172110;201708;1698;6251;1477;5886;172;734;1064;4384;1236;5118
172120;201708;5181;15987;4189;14479;829;2876;2182;7877;3011;10753
172125;201708;285;872;227;765;37;147;110;371;147;518
172130;201708;568;1527;423;1289;30;110;259;769;289;879
172208;201708;2238;6298;1926;5837;247;775;1166;3558;1413;4333
172210;201708;2600;7587;2197;7003;450;1482;1181;3805;1631;5287
210005;201708;21774;66057;18125;60409;5490;19210;6814;23650;12304;42860
210010;201708;1729;5893;1568;5617;58;238;1329;4806;1387;5044
210015;201708;3507;10748;3096;10124;184;474;2581;8720;2765;9194
210020;201708;7316;17100;6793;16493;153;404;6287;15204;6440;15608
210030;201708;5329;17589;5009;17167;309;1429;4175;14191;4484;15620
210040;201708;2202;6489;2032;6298;51;133;1874;5913;1925;6046
210043;201708;7029;18991;5962;17708;800;2198;4127;13103;4927;15301
210047;201708;6673;23356;6063;22487;410;1860;4937;18307;5347;20167
210050;201708;2306;8323;1891;7513;403;1666;963;4031;1366;5697
210055;201708;1748;5980;1591;5726;92;372;1249;4508;1341;4880
210060;201708;7071;27470;6530;26450;958;4005;4370;18237;5328;22242
210070;201708;7508;21474;6973;20836;85;286;6482;19556;6567;19842
210080;201708;3821;13165;3730;13057;23;87;3603;12701;3626;12788
210083;201708;4792;16019;4270;15450;105;478;3989;14516;4094;14994
210087;201708;3078;8848;2763;8440;229;693;2217;6914;2446;7607
210090;201708;10518;32881;9946;32006;372;1328;8860;28551;9232;29879
210095;201708;6154;21410;5838;21005;363;1429;4974;18111;5337;19540
210100;201708;7306;21652;6680;20833;283;1096;5620;17444;5903;18540
210110;201708;2826;9569;2710;9415;78;335;2474;8608;2552;8943
210120;201708;26776;72760;23241;68569;3088;7652;15969;50602;19057;58254
210125;201708;3792;11452;3599;11245;495;1188;2867;9461;3362;10649
210130;201708;4240;12260;3864;11738;236;738;3188;9679;3424;10417
210135;201708;1629;4826;1416;4517;83;255;1140;3687;1223;3942
210140;201708;17430;53946;14705;50233;3127;11272;8052;28322;11179;39594
210150;201708;4679;11589;4143;10919;65;269;3745;9734;3810;10003
210160;201708;17634;54475;16418;52661;1425;4320;12684;41959;14109;46279
210170;201708;14312;48791;13827;48178;721;2580;12276;43166;12997;45746
210173;201708;2463;9408;2325;9196;46;251;2158;8622;2204;8873
210177;201708;3170;9433;2982;9208;81;215;2768;8678;2849;8893
210180;201708;1524;4469;1433;4343;41;155;1242;3745;1283;3900
210190;201708;4893;15138;4475;14378;157;762;3558;11154;3715;11916
210193;201708;1353;4181;1220;3970;63;216;982;3218;1045;3434
210197;201708;2077;6845;1901;6636;230;768;1414;5146;1644;5914
210200;201708;8276;27062;7624;26148;878;2945;5855;20662;6733;23607
210203;201708;6894;21333;6447;20753;359;1058;5645;18531;6004;19589
210207;201708;3376;10799;3183;10465;226;646;2560;8695;2786;9341
210210;201708;8520;28199;8100;27647;119;513;7449;25773;7568;26286
210215;201708;1346;5252;1254;5119;84;416;1028;4243;1112;4659
210220;201708;6053;22211;5748;21706;329;1541;4839;18223;5168;19764
210230;201708;5300;16747;4925;16195;251;792;4313;14312;4564;15104
210232;201708;12979;40853;10832;38106;1693;6081;6818;26050;8511;32131
210235;201708;3865;11591;3392;11004;154;614;2921;9546;3075;10160
210237;201708;2334;8776;2264;8684;27;126;2161;8356;2188;8482
210240;201708;2961;9182;2740;8847;133;483;2309;7445;2442;7928
210250;201708;5387;17091;5035;16637;135;683;4565;14957;4700;15640
210255;201708;2692;8483;2425;8004;339;1171;1671;5520;2010;6691
210260;201708;5254;16768;4815;16104;382;1342;3834;12953;4216;14295
210270;201708;5287;14905;4675;14059;129;603;4046;12029;4175;12632
210275;201708;3620;8846;3402;8608;84;142;3215;8256;3299;8398
210280;201708;5740;17056;4872;15820;270;1267;3590;11399;3860;12666
210290;201708;5889;18891;5418;18331;199;754;4723;16121;4922;16875
210300;201708;38092;103235;31363;94953;2309;7245;23130;73142;25439;80387
210310;201708;3018;8203;2745;7843;86;186;2394;6926;2480;7112
210312;201708;2407;7192;2232;6970;75;337;1976;6144;2051;6481
210315;201708;2856;8625;2482;8160;100;342;2138;7183;2238;7525
210317;201708;4125;12921;3908;12668;151;571;3550;11544;3701;12115
210320;201708;19775;62914;18228;61030;797;3117;15876;53880;16673;56997
210325;201708;3837;11452;3406;10814;155;554;2821;9080;2976;9634
210330;201708;33065;85717;27018;78857;5704;15567;15171;50635;20875;66202
210340;201708;11604;34409;10481;32887;1195;3371;7503;25059;8698;28430
210350;201708;9942;29663;8878;28205;419;1448;7331;23504;7750;24952
210355;201708;4010;14332;3603;13696;163;804;2989;11516;3152;12320
210360;201708;15688;46131;14177;44088;840;3116;11578;35881;12418;38997
210370;201708;9739;23006;8052;21207;344;684;7027;19243;7371;19927
210375;201708;3217;9527;2636;8767;745;2556;1226;4278;1971;6834
210380;201708;5948;16190;5336;15403;375;986;4438;13104;4813;14090
210390;201708;3007;10558;2738;10136;153;738;2240;8303;2393;9041
210400;201708;4937;15273;4592;14849;132;339;4247;13934;4379;14273
210405;201708;7873;21671;6312;19446;1488;4522;3047;10096;4535;14618
210407;201708;1991;7009;1692;6455;174;718;1239;4718;1413;5436
210408;201708;2482;9527;2323;9322;179;874;1845;7591;2024;8465
210409;201708;3826;13622;3587;13275;179;844;3026;11219;3205;12063
210410;201708;3787;11933;3546;11565;311;881;2774;9419;3085;10300
210420;201708;4178;13566;3794;12907;215;763;3101;10658;3316;11421
210430;201708;2221;6660;2126;6557;117;346;1838;5710;1955;6056
210440;201708;4250;12355;4059;12121;101;302;3791;11389;3892;11691
210450;201708;2723;8458;2397;7974;132;455;1903;6320;2035;6775
210455;201708;3949;11159;3485;10608;708;2093;2290;7333;2998;9426
210460;201708;3566;11362;3262;10912;161;673;2681;8934;2842;9607
210462;201708;1402;4969;1283;4755;73;340;1034;3821;1107;4161
210465;201708;2636;8382;2420;8078;122;361;2107;7189;2229;7550
210467;201708;6252;20523;5839;20054;377;1351;5040;17555;5417;18906
210470;201708;2134;5669;1527;4782;95;280;1146;3670;1241;3950
210480;201708;15179;47455;13207;44988;1887;6076;9155;33567;11042;39643
210490;201708;3818;10157;3225;9334;95;349;2775;8001;2870;8350
210500;201708;6176;25567;5948;25142;531;2497;4665;19842;5196;22339
210510;201708;6596;21943;6147;21411;319;972;5297;18995;5616;19967
210515;201708;3688;11390;3503;11186;146;385;3197;10445;3343;10830
210520;201708;2698;8020;2422;7648;141;484;2064;6562;2205;7046
210530;201708;50827;136703;42964;125009;7000;26125;12835;44742;19835;70867
210535;201708;3301;11165;3112;10910;113;423;2748;9765;2861;10188
210540;201708;13617;44019;12067;41882;1844;6206;7955;29296;9799;35502
210542;201708;5992;16445;5370;15770;334;753;4679;14194;5013;14947
210545;201708;2368;7429;2241;7243;47;226;1985;6352;2032;6578
210547;201708;3813;13415;3497;12857;389;1410;2510;9511;2899;10921
210550;201708;6330;18197;5581;17388;322;998;4877;15518;5199;16516
210560;201708;3986;12260;3551;11536;143;562;3005;9697;3148;10259
210565;201708;1473;5261;1261;4924;61;294;997;3986;1058;4280
210570;201708;12400;34156;11344;32979;584;1379;10044;29843;10628;31222
210580;201708;3199;9057;2879;8665;300;614;2282;7265;2582;7879
210590;201708;4115;12956;3764;12490;206;878;3257;10709;3463;11587
210592;201708;2574;7925;2451;7726;48;241;2129;6658;2177;6899
210594;201708;2775;7699;2207;6829;117;332;1619;5169;1736;5501
210596;201708;2630;9633;2476;9324;234;981;1856;7070;2090;8051
210598;201708;1756;5416;1639;5273;68;270;1475;4745;1543;5015
210600;201708;3236;9032;2729;8361;125;405;2166;6652;2291;7057
210610;201708;2561;8155;2346;7878;132;611;2021;6653;2153;7264
210620;201708;2156;6790;1933;6516;50;107;1759;6096;1809;6203
210630;201708;3357;11779;3072;11328;245;1138;2320;8420;2565;9558
210632;201708;4566;15518;4186;14956;443;1739;3180;11418;3623;13157
210635;201708;1896;6620;1782;6432;109;359;1519;5611;1628;5970
210637;201708;2682;9067;2436;8706;157;654;1898;6849;2055;7503
210640;201708;4745;18804;4667;18722;44;178;4532;18314;4576;18492
210650;201708;7294;21285;7035;20954;119;361;6733;20126;6852;20487
210660;201708;8447;24587;7626;23386;295;1102;6625;20098;6920;21200
210663;201708;2762;8390;2627;8228;124;395;2253;7205;2377;7600
210667;201708;1943;6445;1816;6251;69;297;1576;5464;1645;5761
210670;201708;4607;16484;4353;16078;227;1035;3650;13524;3877;14559
210675;201708;5189;14173;4685;13543;414;1041;3800;11379;4214;12420
210680;201708;4153;10906;3542;10177;142;360;3095;9004;3237;9364
210690;201708;7685;25476;7293;25062;325;1095;6352;22619;6677;23714
210700;201708;2738;7779;2434;7431;252;584;1852;6269;2104;6853
210710;201708;4993;16160;4686;15709;201;896;3998;13356;4199;14252
210720;201708;2729;9462;2543;9215;87;418;2297;8288;2384;8706
210725;201708;1119;4204;1019;4001;34;125;785;3234;819;3359
210730;201708;1239;3513;1058;3267;82;248;825;2567;907;2815
210735;201708;4373;14124;3927;13408;413;1457;3011;10493;3424;11950
210740;201708;5220;14960;4859;14590;182;840;4305;12653;4487;13493
210745;201708;4346;12109;4078;11783;213;575;3518;10226;3731;10801
210750;201708;20264;54389;17790;51535;2163;6252;12841;38286;15004;44538
210760;201708;5941;16830;5437;16300;31;81;5270;15898;5301;15979
210770;201708;6048;16319;5202;15345;89;358;4702;13901;4791;14259
210780;201708;7907;26149;7216;24968;825;2764;5124;18331;5949;21095
210790;201708;4884;15071;4477;14584;202;520;3593;12385;3795;12905
210800;201708;4944;13563;4398;12905;102;368;3949;11589;4051;11957
210805;201708;3912;15397;3776;15191;186;946;3237;13060;3423;14006
210810;201708;5385;16037;4972;15511;303;610;4310;14039;4613;14649
210820;201708;7756;22218;6875;20863;844;2452;4600;14351;5444;16803
210825;201708;6049;20174;5763;19801;484;1573;4747;16776;5231;18349
210830;201708;8492;24247;7992;23641;626;1526;6704;20511;7330;22037
210840;201708;3641;9769;3253;9231;92;322;2781;7821;2873;8143
210845;201708;6203;17797;5992;17572;60;128;5835;17252;5895;17380
210850;201708;6210;21311;5538;20251;511;2211;4067;14855;4578;17066
210860;201708;18070;52470;15999;49582;1053;3290;12743;40169;13796;43459
210870;201708;5951;19346;5396;18642;475;1601;4353;15375;4828;16976
210880;201708;4427;14160;4182;13853;287;1079;3435;11394;3722;12473
210890;201708;4851;14470;4453;14012;326;830;3704;12262;4030;13092
210900;201708;4993;14755;4028;13122;1551;5334;954;3431;2505;8765
210905;201708;1900;5749;1658;5406;97;264;1355;4552;1452;4816
210910;201708;8285;26119;7285;24437;969;3426;4826;16282;5795;19708
210920;201708;2911;10506;2755;10244;125;631;2321;8627;2446;9258
210923;201708;1518;5009;1401;4832;125;494;967;3406;1092;3900
210927;201708;4891;15687;4585;15355;112;356;4267;14475;4379;14831
210930;201708;2550;8919;2349;8619;131;674;1912;6890;2043;7564
210940;201708;3280;11303;3138;11079;149;684;2720;9488;2869;10172
210945;201708;5885;17894;5632;17610;287;717;5051;16021;5338;16738
210950;201708;5366;16137;4435;14714;526;1670;3041;10462;3567;12132
210955;201708;1860;5869;1643;5539;170;570;1124;3897;1294;4467
210960;201708;9196;28823;8411;27764;1723;5356;5094;18098;6817;23454
210970;201708;1380;4660;1202;4353;134;561;845;2990;979;3551
210975;201708;1760;5861;1663;5683;151;548;1220;4175;1371;4723
210980;201708;10478;23757;9997;23268;372;691;9226;21851;9598;22542
210990;201708;16669;50503;13741;46329;2603;9042;7591;26784;10194;35826
211000;201708;15610;48177;13767;46087;768;3142;11395;38825;12163;41967
211003;201708;4925;17157;4418;16507;263;1195;3485;13346;3748;14541
211010;201708;6632;24002;6224;23495;86;454;5783;22004;5869;22458
211020;201708;7691;24479;7372;24013;491;1799;6153;20062;6644;21861
211023;201708;2221;7461;2127;7310;157;634;1719;5875;1876;6509
211027;201708;2926;10562;2861;10453;290;1163;2317;8452;2607;9615
211030;201708;3934;11683;3654;11382;427;946;2940;9769;3367;10715
211040;201708;4616;16840;4390;16513;173;968;3791;14244;3964;15212
211050;201708;10140;25753;9586;25145;241;637;8984;23581;9225;24218
211060;201708;6271;21512;6010;21126;427;1647;5084;17981;5511;19628
211065;201708;2090;6377;1837;6028;52;163;1635;5416;1687;5579
211070;201708;8064;27144;7290;25897;454;1684;5855;21109;6309;22793
211080;201708;1358;3955;1166;3665;75;364;888;2630;963;2994
211085;201708;2039;6576;1858;6280;182;604;1412;4870;1594;5474
211090;201708;3467;9861;3200;9498;92;418;2787;8138;2879;8556
211100;201708;6542;17214;6340;16967;33;134;6142;16392;6175;16526
211102;201708;2918;10956;2751;10725;198;796;2320;9229;2518;10025
211105;201708;2523;8249;2150;7623;253;942;1464;5175;1717;6117
211107;201708;4658;14617;4112;13866;271;916;3244;11312;3515;12228
211110;201708;6437;18494;5051;16421;736;2247;3320;11279;4056;13526
211120;201708;37371;105761;34283;102167;4866;13592;24864;77105;29730;90697
211125;201708;2115;6531;1840;6091;104;378;1513;5042;1617;5420
211130;201708;174433;457231;162607;442488;24185;68747;78583;234800;102768;303547
211140;201708;5244;16666;4832;16045;220;824;4077;13548;4297;14372
211150;201708;9885;27888;8762;26520;356;1310;7423;22497;7779;23807
211153;201708;2727;8452;2455;8097;495;1687;1579;5439;2074;7126
211157;201708;1164;3698;993;3427;72;342;661;2305;733;2647
211160;201708;4241;13451;3548;12302;257;1229;2423;8139;2680;9368
211163;201708;1827;6235;1724;6094;42;124;1577;5699;1619;5823
211167;201708;1554;5020;1473;4900;35;145;1374;4577;1409;4722
211170;201708;6264;16233;5997;15910;94;314;5619;14815;5713;15129
211172;201708;2541;7214;2272;6828;97;390;1927;5687;2024;6077
211174;201708;2764;8220;2538;7932;68;342;2299;7117;2367;7459
211176;201708;4275;13103;3613;12223;304;1193;2725;9287;3029;10480
211178;201708;4471;10730;4026;10230;40;125;3803;9575;3843;9700
211180;201708;4264;14587;4001;14194;295;1145;3331;11910;3626;13055
211190;201708;2983;9479;2707;9064;76;374;2299;7619;2375;7993
211195;201708;1498;4382;1263;4075;77;229;1028;3431;1105;3660
211200;201708;2204;7048;1915;6645;305;1080;1189;4319;1494;5399
211210;201708;6874;20742;6451;20187;371;1207;5548;17496;5919;18703
211220;201708;34784;97568;30415;92000;4541;14025;20344;63507;24885;77532
211223;201708;5190;15530;4685;14761;476;1413;3482;11218;3958;12631
211227;201708;1755;6130;1593;5891;61;274;1375;5148;1436;5422
211230;201708;8023;25405;7226;24101;739;2582;5368;18067;6107;20649
211240;201708;8209;27674;7777;27117;241;1219;7011;24138;7252;25357
211245;201708;5795;16782;5746;16732;61;110;5654;16563;5715;16673
211250;201708;14095;42750;13140;41610;870;2646;11107;35859;11977;38505
211260;201708;8544;26135;8018;25446;315;1159;7224;22977;7539;24136
211270;201708;10502;35000;9351;33532;522;2365;7452;27154;7974;29519
211280;201708;13479;39048;12256;37514;932;2263;9975;31785;10907;34048
211285;201708;1780;6437;1561;5990;272;1130;742;2930;1014;4060
211290;201708;7257;23286;6909;22821;364;1250;5943;19824;6307;21074
211300;201708;8303;24396;7704;23597;119;347;7209;22232;7328;22579
211400;201708;11969;36519;10180;33894;2209;7474;5471;19850;7680;27324
220005;201708;1892;5281;1703;4999;63;253;1355;3857;1418;4110
220010;201708;1451;4182;1269;3895;28;118;1006;3035;1034;3153
220020;201708;3353;10404;3119;10021;500;1653;2037;6539;2537;8192
220025;201708;2333;5577;2067;5202;44;134;1688;4145;1732;4279
220027;201708;1374;3595;1209;3379;58;178;961;2677;1019;2855
220030;201708;3294;8702;3172;8508;153;482;2688;7050;2841;7532
220040;201708;7705;23572;7034;22372;1281;4081;4435;14191;5716;18272
220045;201708;1411;4589;1267;4307;59;284;953;3156;1012;3440
220050;201708;4556;13535;3909;12488;190;776;3141;9964;3331;10740
220060;201708;2184;5197;1926;4900;33;79;1746;4435;1779;4514
220070;201708;2443;6889;2184;6481;103;280;1746;5179;1849;5459
220080;201708;712;2127;658;2044;44;176;532;1567;576;1743
220090;201708;1858;4586;1519;4125;41;145;1314;3516;1355;3661
220095;201708;736;1932;690;1869;11;40;638;1713;649;1753
220100;201708;1353;3936;1099;3469;59;252;874;2691;933;2943
220105;201708;2220;6928;1953;6417;157;528;1381;4586;1538;5114
220110;201708;3443;9764;3288;9523;82;311;2856;8153;2938;8464
220115;201708;2661;8651;2541;8448;131;533;2197;7217;2328;7750
220117;201708;1295;3376;1055;3009;38;110;886;2514;924;2624
220120;201708;11963;34621;11111;33579;140;603;10390;31318;10530;31921
220130;201708;910;2939;802;2775;28;171;691;2344;719;2515
220140;201708;1728;4482;1500;4208;137;283;1225;3547;1362;3830
220150;201708;7092;21101;6676;20528;188;843;5753;17438;5941;18281
220155;201708;1113;3332;880;2895;34;131;595;1932;629;2063
220157;201708;1095;2746;933;2476;19;71;756;1945;775;2016
220160;201708;2667;7914;2332;7281;82;390;1869;5704;1951;6094
220170;201708;1410;4082;1192;3734;38;186;987;3025;1025;3211
220173;201708;2053;6058;1641;5256;52;256;1305;4021;1357;4277
220177;201708;1851;5461;1805;5402;26;100;1731;5172;1757;5272
220180;201708;1204;3118;932;2618;16;61;670;1775;686;1836
220190;201708;5036;15399;4572;14788;488;1672;3453;11192;3941;12864
220191;201708;1425;4636;1331;4469;110;462;972;3162;1082;3624
220192;201708;1846;5154;1470;4493;50;175;1121;3389;1171;3564
220194;201708;1836;5370;1620;5033;87;330;1274;3885;1361;4215
220196;201708;2092;5892;1912;5584;98;378;1563;4460;1661;4838
220198;201708;1373;3830;1040;3389;15;50;959;3172;974;3222
220200;201708;4627;14797;4261;14325;341;1225;3401;11475;3742;12700
220202;201708;2195;6353;1892;5818;27;144;1621;4895;1648;5039
220205;201708;2783;7317;2480;6907;44;169;2168;5945;2212;6114
220207;201708;878;2665;749;2438;62;239;501;1606;563;1845
220208;201708;1811;5729;1523;5204;332;1266;701;2379;1033;3645
220209;201708;1606;4716;1383;4329;32;140;1115;3472;1147;3612
220210;201708;1658;4399;1434;4026;37;161;1148;3113;1185;3274
220211;201708;1607;4400;1521;4278;33;131;1329;3708;1362;3839
220213;201708;1721;4793;1563;4484;35;134;1258;3518;1293;3652
220217;201708;2048;6332;1954;6222;39;147;1802;5798;1841;5945
220220;201708;10759;29058;9403;27014;684;1825;6871;20189;7555;22014
220225;201708;1131;3156;927;2877;24;98;762;2334;786;2432
220230;201708;5632;14661;5041;13855;233;626;4322;11934;4555;12560
220240;201708;2921;8850;2684;8405;102;392;2183;6790;2285;7182
220245;201708;1550;4033;1284;3679;19;64;1126;3287;1145;3351
220250;201708;3042;8869;2734;8412;67;287;2365;7277;2432;7564
220253;201708;1630;4672;1375;4221;164;487;1007;3084;1171;3571
220255;201708;1800;4820;1529;4370;35;166;1219;3319;1254;3485
220260;201708;4294;13786;3848;12971;249;890;2957;10034;3206;10924
220265;201708;1344;4532;1227;4338;96;394;856;3021;952;3415
220270;201708;6860;21854;6532;21259;446;1821;5219;16526;5665;18347
220271;201708;1524;4130;1333;3831;69;189;1085;3170;1154;3359
220272;201708;1814;5377;1632;5060;45;179;1237;3763;1282;3942
220273;201708;1234;3553;1054;3220;61;212;788;2394;849;2606
220275;201708;2184;5404;1741;4875;44;173;1478;4090;1522;4263
220277;201708;2250;6050;1947;5577;54;193;1554;4358;1608;4551
220280;201708;1544;4123;1338;3767;70;239;1058;2887;1128;3126
220285;201708;1687;4342;1378;3933;25;103;1252;3570;1277;3673
220290;201708;6153;19904;5213;18536;550;2171;3587;12767;4137;14938
220300;201708;1831;6030;1618;5701;79;437;1275;4349;1354;4786
220310;201708;2587;8212;2279;7849;76;368;1908;6573;1984;6941
220320;201708;3057;9235;2550;8321;241;922;1810;5833;2051;6755
220323;201708;1522;5214;1320;4907;120;479;1024;3821;1144;4300
220325;201708;1208;3750;1024;3388;51;213;785;2583;836;2796
220327;201708;1366;4278;1228;4033;55;254;986;3152;1041;3406
220330;201708;3806;10193;3324;9544;179;548;2766;7921;2945;8469
220335;201708;1797;5433;1611;5218;31;102;1500;4890;1531;4992
220340;201708;1911;5142;1560;4579;69;250;1115;3150;1184;3400
220342;201708;1164;3656;1079;3521;62;238;856;2810;918;3048
220345;201708;2946;7224;2568;6696;29;55;2385;6238;2414;6293
220350;201708;3814;10042;3161;8996;183;623;2350;6561;2533;7184
220360;201708;1280;3392;1084;3102;61;187;842;2347;903;2534
220370;201708;9530;26670;8572;25434;262;1030;7573;22307;7835;23337
220375;201708;1523;4612;1403;4460;14;37;1350;4329;1364;4366
220380;201708;1425;3711;1202;3395;31;107;1009;2797;1040;2904
220385;201708;867;2173;685;1864;13;50;553;1468;566;1518
220390;201708;9039;27152;7951;25272;2018;6570;3221;10598;5239;17168
220400;201708;1519;3801;1178;3251;30;115;921;2445;951;2560
220410;201708;1204;3428;1008;3104;71;220;780;2370;851;2590
220415;201708;843;2299;729;2124;28;97;529;1508;557;1605
220420;201708;2176;6215;1799;5490;102;327;1311;3938;1413;4265
220430;201708;2542;6930;2468;6839;114;338;2181;6005;2295;6343
220435;201708;1765;4985;1590;4702;67;227;1216;3555;1283;3782
220440;201708;2466;7996;2276;7719;158;584;1822;6090;1980;6674
220450;201708;2155;6458;1825;5989;317;1171;1187;3855;1504;5026
220455;201708;1346;4161;1274;4059;35;127;1148;3661;1183;3788
220460;201708;927;2509;840;2401;48;155;710;1983;758;2138
220465;201708;2381;7730;2172;7409;209;753;1624;5583;1833;6336
220470;201708;3699;10757;3349;10196;146;488;2663;7979;2809;8467
220480;201708;2463;6886;2111;6316;149;388;1515;4512;1664;4900
220490;201708;2373;6460;2148;6180;51;177;1868;5328;1919;5505
220500;201708;3145;8399;2709;7678;83;348;2080;5686;2163;6034
220510;201708;2880;8341;2314;7346;112;373;1714;5482;1826;5855
220515;201708;1855;4450;1638;4165;87;221;1404;3556;1491;3777
220520;201708;5207;13820;4764;13232;110;319;4261;11841;4371;12160
220525;201708;1284;3542;1199;3420;37;132;1012;2851;1049;2983
220527;201708;1414;4155;1246;3842;76;236;939;2946;1015;3182
220530;201708;1279;3562;1121;3335;56;225;971;2813;1027;3038
220535;201708;854;2531;809;2469;67;226;616;1859;683;2085
220540;201708;3573;11264;3404;11005;115;502;2938;9433;3053;9935
220545;201708;1429;4624;1345;4471;106;427;1051;3439;1157;3866
220550;201708;9420;29389;8604;28013;686;2508;6373;20494;7059;23002
220551;201708;1495;4541;1315;4243;68;292;1022;3193;1090;3485
220552;201708;1627;4937;1403;4522;68;352;1077;3310;1145;3662
220553;201708;1661;4647;1389;4232;62;220;1052;3273;1114;3493
220554;201708;818;2322;700;2135;44;112;536;1632;580;1744
220555;201708;2129;6801;1975;6576;51;271;1671;5472;1722;5743
220556;201708;1382;4195;1228;3890;56;245;894;2699;950;2944
220557;201708;1599;4976;1395;4576;108;382;987;3196;1095;3578
220558;201708;1162;3454;1008;3221;44;196;803;2500;847;2696
220559;201708;1615;4380;1414;4047;22;73;1172;3348;1194;3421
220560;201708;1654;4031;1336;3600;39;113;1143;3042;1182;3155
220570;201708;7333;23325;6881;22536;746;2572;5007;16579;5753;19151
220580;201708;6778;20207;6553;19845;233;774;5848;17573;6081;18347
220585;201708;2076;6857;1885;6505;105;449;1477;5017;1582;5466
220590;201708;1313;3801;1139;3536;125;401;763;2388;888;2789
220595;201708;2497;7049;2324;6823;32;159;2144;6209;2176;6368
220600;201708;1345;3179;1086;2841;79;124;875;2368;954;2492
220605;201708;1846;5407;1585;4963;47;195;1225;3737;1272;3932
220610;201708;2856;8372;2693;8141;53;224;2429;7293;2482;7517
220620;201708;7787;25321;7457;24870;267;1199;6631;21900;6898;23099
220630;201708;395;1202;322;1067;45;171;173;587;218;758
220635;201708;1697;5579;1504;5171;80;333;1122;3800;1202;4133
220640;201708;2781;7777;2432;7278;97;333;2006;5952;2103;6285
220650;201708;2179;6305;1914;5829;92;317;1420;4300;1512;4617
220660;201708;2878;8450;2577;8083;111;518;2224;6803;2335;7321
220665;201708;1275;4079;1154;3874;26;127;964;3203;990;3330
220667;201708;1690;5482;1523;5186;86;314;1228;4186;1314;4500
220669;201708;1842;5831;1753;5673;127;541;1363;4333;1490;4874
220670;201708;2015;5805;1755;5478;84;254;1507;4741;1591;4995
220672;201708;2581;7269;2327;6950;146;437;2001;6030;2147;6467
220675;201708;1303;3622;1192;3429;69;179;921;2657;990;2836
220680;201708;2546;7545;2415;7381;137;429;2079;6355;2216;6784
220690;201708;1720;4669;1482;4286;129;324;1085;3220;1214;3544
220695;201708;990;2785;891;2598;31;105;719;2077;750;2182
220700;201708;8506;23577;7306;21758;456;1571;5519;16222;5975;17793
220710;201708;843;2448;661;2079;50;145;469;1462;519;1607
220720;201708;2097;5261;1937;5026;57;178;1654;4245;1711;4423
220730;201708;1414;4000;1185;3644;31;132;963;2905;994;3037
220735;201708;1044;2567;814;2187;28;71;658;1742;686;1813
220740;201708;1450;4288;1219;3983;56;191;1009;3342;1065;3533
220750;201708;3996;11030;3624;10473;233;681;2984;8635;3217;9316
220755;201708;1205;3322;1065;3097;50;180;819;2325;869;2505
220760;201708;2986;9308;2681;8895;122;510;2277;7493;2399;8003
220770;201708;21794;71312;19529;66997;6773;24292;6067;21824;12840;46116
220775;201708;1231;3226;1176;3167;14;60;1146;3073;1160;3133
220777;201708;1578;4206;1302;3779;58;160;976;2820;1034;2980
220779;201708;1427;3537;1320;3393;39;144;1162;2931;1201;3075
220780;201708;5767;15475;5099;14433;351;1145;4016;11191;4367;12336
220785;201708;1450;3415;1338;3252;34;49;1244;3025;1278;3074
220790;201708;10532;30785;9570;29336;461;1787;7845;23755;8306;25542
220793;201708;834;2320;738;2172;36;122;601;1766;637;1888
220795;201708;1515;4073;1388;3902;58;199;1215;3403;1273;3602
220800;201708;16626;43780;14517;40569;1028;3202;10130;27493;11158;30695
220810;201708;3237;9195;2794;8438;86;342;2228;6577;2314;6919
220820;201708;5505;14648;4873;13746;449;1217;3763;10613;4212;11830
220830;201708;7455;20718;6877;19826;461;1413;5505;15817;5966;17230
220840;201708;13686;42412;12051;39165;2326;7541;6367;21107;8693;28648
220850;201708;3044;9806;2833;9542;96;460;2529;8456;2625;8916
220855;201708;611;1817;529;1678;26;116;410;1268;436;1384
220860;201708;1001;2585;870;2390;29;96;740;2009;769;2105
220865;201708;2649;7126;2088;6179;62;271;1639;4694;1701;4965
220870;201708;2336;7488;2031;7085;46;228;1829;6359;1875;6587
220880;201708;4874;12718;4470;12250;56;191;4180;11444;4236;11635
220885;201708;1284;4484;1120;4182;73;362;848;3141;921;3503
220887;201708;1427;3396;1238;3126;14;58;1144;2860;1158;2918
220890;201708;1658;5531;1420;5062;116;419;1018;3681;1134;4100
220900;201708;1969;5186;1711;4818;40;122;1476;4111;1516;4233
220910;201708;1530;4501;1325;4188;51;166;1141;3631;1192;3797
220915;201708;1006;2823;860;2542;30;131;662;1890;692;2021
220920;201708;1378;4864;1214;4629;100;493;910;3390;1010;3883
220930;201708;1527;4675;1380;4458;43;206;1184;3777;1227;3983
220935;201708;1049;3083;859;2670;34;133;593;1740;627;1873
220937;201708;1518;4072;1276;3690;38;145;1000;2825;1038;2970
220940;201708;1364;4173;1200;3840;51;222;875;2713;926;2935
220945;201708;425;1545;379;1449;29;153;269;997;298;1150
220950;201708;1343;3229;911;2524;18;77;709;1897;727;1974
220955;201708;1505;4207;1319;3886;62;171;1042;3071;1104;3242
220960;201708;924;2333;729;2013;20;73;569;1551;589;1624
220965;201708;1701;4885;1560;4670;33;192;1352;3914;1385;4106
220970;201708;1924;5103;1499;4415;74;221;1143;3370;1217;3591
220975;201708;740;2331;665;2237;32;190;577;1852;609;2042
220980;201708;1259;3654;1115;3419;46;164;879;2669;925;2833
220985;201708;1225;3517;1127;3366;63;246;846;2412;909;2658
220987;201708;1507;4669;1329;4361;76;308;1049;3399;1125;3707
220990;201708;1817;5205;1544;4757;43;205;1179;3534;1222;3739
220995;201708;1256;3663;965;3198;78;283;668;2259;746;2542
220997;201708;2451;7187;2317;6996;50;209;2129;6368;2179;6577
221000;201708;4239;12504;3952;12031;249;970;3122;9339;3371;10309
221005;201708;1466;4343;1337;4101;152;425;927;2842;1079;3267
221010;201708;1238;3094;1050;2862;27;94;916;2449;943;2543
221020;201708;1701;5276;1571;5024;51;229;1137;3569;1188;3798
221030;201708;1506;4344;1330;4060;54;222;1062;3172;1116;3394
221035;201708;1539;4143;1425;3995;56;131;1288;3698;1344;3829
221037;201708;610;1786;528;1641;12;57;361;1068;373;1125
221038;201708;605;1675;470;1444;32;111;295;899;327;1010
221039;201708;967;2606;845;2425;22;80;692;1933;714;2013
221040;201708;4589;13964;4222;13355;210;715;3307;10531;3517;11246
221050;201708;3660;10467;3350;10073;86;326;2985;8910;3071;9236
221060;201708;8267;23838;7072;21877;386;1346;5417;16707;5803;18053
221062;201708;1310;4451;1166;4154;58;299;890;3118;948;3417
221063;201708;1121;3461;991;3246;87;301;697;2278;784;2579
221065;201708;2833;7424;2485;6871;78;235;2097;5716;2175;5951
221070;201708;3696;11621;3165;10616;186;719;2336;7794;2522;8513
221080;201708;3605;8902;2892;7880;90;339;2316;6222;2406;6561
221090;201708;1412;3836;1205;3480;36;138;997;2815;1033;2953
221093;201708;1584;4645;1482;4437;189;606;915;2624;1104;3230
221095;201708;979;2580;841;2360;11;35;686;1883;697;1918
221097;201708;832;2252;655;1926;25;87;473;1343;498;1430
221100;201708;102967;299041;93345;282390;17686;55826;53145;158566;70831;214392
221110;201708;10650;32427;9847;31443;381;1719;8370;26352;8751;28071
221120;201708;4254;13209;4040;12845;494;1674;2977;9459;3471;11133
221130;201708;4661;13003;3766;11189;1062;3058;1556;4718;2618;7776
221135;201708;1581;4602;1455;4423;65;238;1250;3770;1315;4008
221140;201708;1361;3293;1209;3074;23;60;1062;2663;1085;2723
221150;201708;1217;3034;962;2596;28;109;716;1844;744;1953
221160;201708;787;2026;723;1940;28;73;581;1550;609;1623
221170;201708;1159;3410;1051;3232;36;128;827;2517;863;2645
230010;201708;3392;9051;2720;7885;214;706;2033;5768;2247;6474
230015;201708;2938;9961;2749;9573;293;1188;1807;6187;2100;7375
230020;201708;13908;44512;13451;43769;603;2447;11363;36565;11966;39012
230030;201708;12382;33981;10945;31851;407;1474;9224;26616;9631;28090
230040;201708;4391;11932;3756;10844;199;719;2871;8141;3070;8860
230050;201708;2722;8939;2010;7070;474;1602;600;2176;1074;3778
230060;201708;2376;6622;1986;5940;84;321;1560;4567;1644;4888
230070;201708;4220;12005;3632;10890;232;815;2488;7550;2720;8365
230075;201708;9274;31275;8609;30035;548;2680;6675;22695;7223;25375
230080;201708;2476;6110;1995;5395;62;249;1654;4379;1716;4628
230090;201708;4115;11238;3626;10436;269;905;2616;7389;2885;8294
230100;201708;17329;50112;16047;47947;2424;7678;9514;28547;11938;36225
230110;201708;12439;39013;11340;36712;2146;7308;6047;19467;8193;26775
230120;201708;8013;21908;6955;20291;707;2000;4875;14662;5582;16662
230125;201708;3109;8694;2574;7764;134;472;1896;5678;2030;6150
230130;201708;5795;18576;4901;16667;575;2073;3091;10348;3666;12421
230140;201708;3619;11185;3069;10196;187;744;2135;7047;2322;7791
230150;201708;1683;5127;1462;4652;296;963;755;2431;1051;3394
230160;201708;6529;18179;5762;17050;301;1124;4592;13422;4893;14546
230170;201708;6302;19127;5471;17548;307;1190;3901;12268;4208;13458
230180;201708;1735;4958;1487;4468;57;245;1094;3129;1151;3374
230185;201708;3938;12460;3489;11630;438;1533;2342;7923;2780;9456
230190;201708;12753;39668;11182;36530;1783;6153;5691;18524;7474;24677
230195;201708;5326;16054;4710;14979;309;1140;3585;11214;3894;12354
230200;201708;5191;14577;4631;13529;273;894;3513;10045;3786;10939
230205;201708;4173;13314;3794;12623;252;1059;2664;8743;2916;9802
230210;201708;9247;25369;8011;23422;773;2428;5487;16085;6260;18513
230220;201708;13480;37085;12163;34893;750;2482;9301;26303;10051;28785
230230;201708;7373;22948;6674;21609;624;2118;4651;15052;5275;17170
230240;201708;13746;37084;11953;34186;630;1778;9200;26228;9830;28006
230250;201708;9811;29474;9750;29359;580;2115;7416;21751;7996;23866
230260;201708;14731;47309;13424;44648;1861;6586;7711;25894;9572;32480
230270;201708;7653;21693;6296;19207;722;2313;3965;12180;4687;14493
230280;201708;20425;58439;17680;53643;1048;3912;13320;39433;14368;43345
230290;201708;4942;14463;4216;12977;506;1445;2836;8852;3342;10297
230300;201708;4463;12908;4226;12572;201;791;3521;10273;3722;11064
230310;201708;4976;14489;4286;13296;162;657;3025;9185;3187;9842
230320;201708;7736;22786;6852;21205;444;1736;5081;15425;5525;17161
230330;201708;5007;14125;4171;12517;281;902;2955;8761;3236;9663
230340;201708;3544;11545;3170;10747;290;1094;2158;7211;2448;8305
230350;201708;18939;55112;17111;51963;1408;5063;10568;32463;11976;37526
230360;201708;3267;9035;2520;7670;175;600;1667;5014;1842;5614
230365;201708;3149;8047;2693;7299;85;340;2233;5948;2318;6288
230370;201708;55582;172265;49843;162499;12309;41794;22052;74902;34361;116696
230380;201708;6724;19114;5484;16791;234;853;3821;11492;4055;12345
230390;201708;3382;10517;3030;9901;184;770;2222;7125;2406;7895
230393;201708;3147;10030;2689;9134;142;712;1937;6316;2079;7028
230395;201708;5832;16417;5188;15293;661;1967;3262;9793;3923;11760
230400;201708;5664;16585;5067;15587;234;996;3932;11791;4166;12787
230410;201708;14891;46068;12563;41265;1679;5675;7363;24314;9042;29989
230420;201708;24779;76406;22149;71211;3835;13146;10980;35103;14815;48249
230423;201708;4469;13906;3998;12967;182;736;3145;10065;3327;10801
230425;201708;5641;18250;5155;17217;655;2224;3327;11167;3982;13391
230426;201708;2591;7161;2047;6117;61;265;1501;4386;1562;4651
230427;201708;1848;5384;1338;4227;94;300;857;2607;951;2907
230428;201708;9183;27385;8585;26282;1492;4927;4572;13764;6064;18691
230430;201708;4589;14014;4037;12978;278;1071;2919;9118;3197;10189
230435;201708;5447;16173;4783;14955;625;2103;2787;8710;3412;10813
230440;201708;379023;1063504;338010;994994;67285;208148;166376;491546;233661;699694
230445;201708;4581;12349;3897;11194;227;633;2734;7796;2961;8429
230450;201708;3770;11395;3289;10546;280;1156;2292;7200;2572;8356
230460;201708;1975;6201;1711;5716;134;509;1247;4157;1381;4666
230465;201708;4107;11897;3426;10646;151;608;2408;7259;2559;7867
230470;201708;11064;38982;10175;37204;1102;4746;7056;25466;8158;30212
230480;201708;1494;4533;1258;4069;131;501;861;2721;992;3222
230490;201708;2391;7064;2082;6484;262;841;1128;3407;1390;4248
230495;201708;5771;18294;5225;17216;519;2114;3265;10592;3784;12706
230500;201708;8873;30835;8420;29923;524;2335;6324;22333;6848;24668
230510;201708;1574;5339;1183;4346;245;967;430;1582;675;2549
230520;201708;4455;13370;4082;12661;382;1317;2774;8453;3156;9770
230523;201708;15740;48937;13385;43681;3158;10734;3296;11185;6454;21919
230526;201708;4116;11971;3518;10914;190;824;2693;8124;2883;8948
230530;201708;5557;17377;4903;16341;657;2322;3278;11146;3935;13468
230533;201708;4173;11232;3619;10224;300;819;2649;7544;2949;8363
230535;201708;5662;16222;4858;14755;393;1223;3238;10039;3631;11262
230540;201708;17582;50044;15758;47190;495;2023;13149;38802;13644;40825
230550;201708;19852;57049;17252;52201;2628;8650;9397;28037;12025;36687
230560;201708;7172;19745;6046;17712;180;719;4724;13558;4904;14277
230565;201708;3536;9549;2844;8289;107;394;2084;6010;2191;6404
230570;201708;3703;9760;3226;9132;109;349;2624;7370;2733;7719
230580;201708;10298;29720;9348;28344;515;1910;7728;23160;8243;25070
230590;201708;9293;27693;7829;24919;572;2132;5376;16619;5948;18751
230600;201708;3789;10266;2877;8455;101;328;1854;5512;1955;5840
230610;201708;6414;19324;5806;18335;537;1756;4241;13431;4778;15187
230620;201708;2222;6215;1733;5176;191;611;971;2806;1162;3417
230625;201708;8228;25668;7337;23724;2175;7415;1937;6395;4112;13810
230630;201708;10766;33327;9754;31378;2627;7991;4230;14683;6857;22674
230640;201708;27699;85970;25107;82040;2282;8379;18992;61803;21274;70182
230650;201708;4833;14459;4338;13492;302;1080;3174;9682;3476;10762
230655;201708;9628;34479;9230;33728;706;3039;7134;26152;7840;29191
230660;201708;6327;19216;5351;17306;255;1265;4163;13103;4418;14368
230670;201708;6085;15671;4772;13386;182;601;3656;9971;3838;10572
230680;201708;2671;7724;2297;7005;280;863;1430;4366;1710;5229
230690;201708;6521;20486;6132;19620;650;2277;3689;11611;4339;13888
230700;201708;9810;26651;8600;24442;483;1675;6169;16914;6652;18589
230710;201708;7524;23688;6478;21748;704;2436;4485;15117;5189;17553
230720;201708;1891;5857;1617;5259;202;686;980;3175;1182;3861
230725;201708;3848;12578;3250;11095;804;2817;987;3381;1791;6198
230730;201708;56628;167274;48278;153252;12887;45031;13324;44518;26211;89549
230740;201708;6346;18288;5659;17141;224;854;4381;13116;4605;13970
230750;201708;8376;23625;7220;21697;342;1265;5415;15873;5757;17138
230760;201708;11504;33027;10490;31117;912;3159;7308;21004;8220;24163
230763;201708;4406;13013;3822;11886;232;937;2837;8484;3069;9421
230765;201708;41081;124219;36244;115088;8881;29809;11706;37994;20587;67803
230770;201708;25716;69360;22737;64992;3026;9070;14091;40351;17117;49421
230780;201708;5989;22013;5713;21408;1093;4079;3148;12265;4241;16344
230790;201708;2957;8997;2759;8670;193;675;2124;6672;2317;7347
230800;201708;7750;26350;7088;24920;1110;4279;3802;13145;4912;17424
230810;201708;12207;38349;11383;36929;704;2712;8594;27416;9298;30128
230820;201708;3357;11228;2916;10278;338;1386;1685;5772;2023;7158
230830;201708;7578;22358;6645;20643;315;1243;5076;15480;5391;16723
230835;201708;4020;10321;3252;9092;158;532;2538;6959;2696;7491
230837;201708;3185;10477;2766;9632;194;862;1993;6737;2187;7599
230840;201708;9268;29123;8418;27697;707;2574;6312;20845;7019;23419
230850;201708;9602;29090;8767;27577;760;2616;6081;19077;6841;21693
230860;201708;5282;14452;4587;13390;232;810;3699;10663;3931;11473
230870;201708;18305;46941;15910;43334;713;2177;12190;32926;12903;35103
230880;201708;2030;6617;1883;6334;106;508;1373;4481;1479;4989
230890;201708;4309;14842;3992;14193;425;1672;2687;9467;3112;11139
230900;201708;2958;9459;2502;8451;398;1313;1390;4713;1788;6026
230910;201708;3196;9082;2590;8019;135;581;1935;5853;2070;6434
230920;201708;4794;13423;4405;12915;189;717;3708;10851;3897;11568
230930;201708;6940;20495;6057;18784;522;1737;3929;12083;4451;13820
230940;201708;7796;21767;6979;20410;240;852;5659;16459;5899;17311
230945;201708;6462;18933;5575;17381;469;1576;3756;11858;4225;13434
230950;201708;6628;17185;6039;16445;183;452;5241;14606;5424;15058
230960;201708;14211;43420;12960;40980;2106;7024;6297;20132;8403;27156
230970;201708;13918;40747;12126;37605;2330;7758;5617;17415;7947;25173
230980;201708;2965;8920;2567;8215;586;1850;1330;4447;1916;6297
230990;201708;1834;5235;1506;4622;105;428;986;2893;1091;3321
231000;201708;2637;7176;2188;6281;105;320;1482;4175;1587;4495
231010;201708;3125;8385;2549;7403;224;708;1775;5074;1999;5782
231020;201708;8091;26509;7549;25285;1287;4219;4446;15335;5733;19554
231025;201708;7732;23265;7070;22070;1169;3762;4240;13462;5409;17224
231030;201708;7416;23370;6176;20779;1148;3984;3152;10658;4300;14642
231040;201708;3223;9768;2847;9035;129;545;2105;6514;2234;7059
231050;201708;12095;33085;10125;29591;672;2072;7410;21508;8082;23580
231060;201708;2552;7971;2318;7578;114;544;1738;5577;1852;6121
231070;201708;8544;26271;7602;24395;1311;4288;4026;13149;5337;17437
231080;201708;4128;12380;3703;11637;159;815;2798;8427;2957;9242
231085;201708;5262;15426;4965;15002;507;1450;3573;11207;4080;12657
231090;201708;4202;11506;3308;9723;129;455;2334;6706;2463;7161
231095;201708;2121;6673;1835;6052;167;614;1239;4043;1406;4657
231100;201708;3224;9703;2684;8701;255;818;1801;5861;2056;6679
231110;201708;3526;11277;3478;11193;303;1150;2416;7603;2719;8753
231120;201708;2013;6545;1853;6229;213;749;1183;3969;1396;4718
231123;201708;2055;5500;1776;5010;117;364;1280;3532;1397;3896
231126;201708;6241;17587;5081;15384;236;841;3531;10451;3767;11292
231130;201708;19603;57395;17552;54112;2359;7835;10987;34635;13346;42470
231135;201708;4184;12129;3552;10980;200;723;2519;7690;2719;8413
231140;201708;17679;53032;15012;48030;1083;4513;9942;30829;11025;35342
231150;201708;5698;16250;4933;14806;743;2303;2430;7412;3173;9715
231160;201708;5868;19028;5445;18188;952;3183;3071;10449;4023;13632
231170;201708;4319;13417;3739;12223;276;1049;2557;8131;2833;9180
231180;201708;14557;42460;12628;38463;2507;7753;5897;17771;8404;25524
231190;201708;4661;12886;3866;11651;231;922;2818;8176;3049;9098
231195;201708;4616;15165;3994;13843;310;1342;2745;9286;3055;10628
231200;201708;7989;26173;6963;24041;331;1663;5036;16856;5367;18519
231210;201708;4969;15400;4365;14411;237;1040;3230;10426;3467;11466
231220;201708;12124;33311;10310;29922;555;1872;7443;21005;7998;22877
231230;201708;8914;28971;8095;27708;652;2596;6048;20743;6700;23339
231240;201708;12014;36917;10926;34689;1987;6492;5975;19138;7962;25630
231250;201708;1953;5366;1366;3992;139;400;696;1994;835;2394
231260;201708;3371;9983;3028;9406;412;1244;1923;6119;2335;7363
231270;201708;7213;19252;6254;17725;259;1017;4709;13061;4968;14078
231280;201708;1787;5698;1668;5474;165;549;1122;3699;1287;4248
231290;201708;35952;114984;32068;106601;5888;20732;13947;45736;19835;66468
231300;201708;4326;12382;3543;10802;269;911;2310;6895;2579;7806
231310;201708;7560;21022;6180;18173;778;2334;3630;10506;4408;12840
231320;201708;7235;21240;5912;18599;187;770;4404;13676;4591;14446
231325;201708;2752;7811;2313;7103;461;1387;1171;3707;1632;5094
231330;201708;11193;35065;9623;31866;1856;6139;4943;16664;6799;22803
231335;201708;5679;15585;4826;14100;153;663;3966;11331;4119;11994
231340;201708;18352;58497;16781;55946;1411;4902;12479;42170;13890;47072
231350;201708;15073;42706;14077;41356;492;1423;12479;37002;12971;38425
231355;201708;4669;14399;4179;13547;264;1013;3073;9895;3337;10908
231360;201708;7879;24528;6931;22867;859;2936;4603;15400;5462;18336
231370;201708;2460;6688;1919;5772;57;198;1438;4285;1495;4483
231375;201708;4282;14036;3954;13422;192;876;3132;10461;3324;11337
231380;201708;5669;16347;5363;15963;234;632;4495;13728;4729;14360
231390;201708;3512;10683;3198;10112;293;1081;2219;6864;2512;7945
231395;201708;3973;12640;3549;11839;665;2244;1917;6495;2582;8739
231400;201708;9261;27767;8406;26082;472;1795;6271;19132;6743;20927
231410;201708;15111;48550;13697;46348;1295;4435;9995;34006;11290;38441
240010;201708;2464;7128;2004;6200;242;848;1159;3498;1401;4346
240020;201708;10721;32578;9563;30415;1374;4676;5520;17557;6894;22233
240030;201708;2602;7133;2501;6981;135;449;2169;5975;2304;6424
240040;201708;874;2509;727;2217;23;106;519;1515;542;1621
240050;201708;3492;9295;2898;8246;85;280;2245;6244;2330;6524
240060;201708;1443;4017;1252;3661;59;212;961;2716;1020;2928
240070;201708;2471;7394;2291;7024;281;903;1573;4760;1854;5663
240080;201708;3080;8176;2619;7498;130;439;1939;5497;2069;5936
240090;201708;2309;6040;1902;5324;39;142;1500;4113;1539;4255
240100;201708;8259;22885;7235;20861;588;1807;5166;14536;5754;16343
240110;201708;4768;14590;4175;13405;494;1789;2444;7705;2938;9494
240120;201708;2715;9329;2573;9022;327;1284;1601;5570;1928;6854
240130;201708;2875;7282;2494;6693;96;325;2107;5553;2203;5878
240140;201708;2279;6738;1912;6045;222;800;1172;3655;1394;4455
240145;201708;6018;18225;5294;16970;950;3185;3040;9947;3990;13132
240150;201708;979;2960;829;2650;60;248;592;1824;652;2072
240160;201708;1501;4531;1272;4141;105;400;846;2768;951;3168
240165;201708;898;2724;772;2446;131;390;454;1470;585;1860
240170;201708;2360;6938;2031;6326;305;1025;1163;3551;1468;4576
240180;201708;2810;8634;2446;7884;447;1483;1377;4512;1824;5995
240185;201708;1381;4562;1267;4363;85;361;998;3406;1083;3767
240190;201708;1009;3132;890;2929;41;180;680;2227;721;2407
240200;201708;12397;33027;10534;30070;1955;5731;4623;13528;6578;19259
240210;201708;2871;7864;2583;7395;92;360;2097;5827;2189;6187
240220;201708;7523;24562;6900;23648;681;2897;4841;16514;5522;19411
240230;201708;5861;15244;4943;13784;301;840;3844;10727;4145;11567
240240;201708;1767;5371;1078;3630;178;610;216;679;394;1289
240250;201708;2714;7803;2522;7542;176;505;2027;6093;2203;6598
240260;201708;12593;40906;11811;39633;1652;5960;7665;25948;9317;31908
240270;201708;2357;7231;2161;6908;133;453;1735;5588;1868;6041
240280;201708;1628;4408;1435;4140;61;201;1152;3283;1213;3484
240290;201708;1207;3723;1044;3393;46;224;693;2089;739;2313
240300;201708;2332;6236;1734;5030;133;422;929;2640;1062;3062
240310;201708;9517;26390;8389;24511;1100;3482;4513;13189;5613;16671
240320;201708;2028;5756;1545;4754;41;185;1160;3408;1201;3593
240325;201708;32599;90869;26246;80243;7470;24257;6492;21045;13962;45302
240330;201708;1522;4501;1274;3982;72;291;821;2457;893;2748
240340;201708;2112;5268;1721;4652;124;335;1265;3360;1389;3695
240350;201708;2106;5677;1936;5474;66;222;1684;4744;1750;4966
240360;201708;7201;21699;6423;20495;1607;5060;3103;10511;4710;15571
240370;201708;2083;5681;1640;4811;162;474;1017;2956;1179;3430
240375;201708;862;2273;765;2100;37;143;562;1465;599;1608
240380;201708;2452;7152;1821;5725;185;619;983;3046;1168;3665
240390;201708;941;2547;744;2158;19;59;490;1342;509;1401
240400;201708;1371;3614;1055;3015;51;168;717;1980;768;2148
240410;201708;479;1546;435;1456;60;233;259;845;319;1078
240420;201708;4749;17789;4372;16910;750;3417;2265;8583;3015;12000
240430;201708;3477;9526;3086;8812;188;693;2298;6302;2486;6995
240440;201708;2606;6481;2298;6043;338;913;1437;3742;1775;4655
240450;201708;4145;11997;3431;10618;399;1351;1936;5817;2335;7168
240460;201708;3068;9078;2845;8774;262;958;2201;6690;2463;7648
240470;201708;3569;11100;2791;9430;360;1244;1602;5415;1962;6659
240480;201708;547;1482;415;1230;39;118;197;585;236;703
240485;201708;2086;6335;1787;5737;182;607;1195;3878;1377;4485
240490;201708;1800;4420;1450;3868;25;73;1228;3258;1253;3331
240500;201708;2265;6227;2013;5869;94;326;1642;4744;1736;5070
240510;201708;1687;4848;1595;4704;138;417;1270;3713;1408;4130
240520;201708;1300;3536;1110;3253;54;218;895;2529;949;2747
240530;201708;1986;6348;1845;6121;205;730;1339;4425;1544;5155
240540;201708;1949;5474;1797;5242;86;303;1523;4368;1609;4671
240550;201708;791;2206;674;2004;45;135;484;1431;529;1566
240560;201708;3374;9334;3036;8850;318;823;2284;6809;2602;7632
240570;201708;3082;8383;2220;6435;294;917;999;2631;1293;3548
240580;201708;7980;23934;7351;22870;621;2168;5723;17641;6344;19809
240590;201708;749;2054;645;1866;22;79;503;1423;525;1502
240600;201708;1679;4767;1272;3900;115;406;745;2206;860;2612
240610;201708;4719;13338;4063;12094;327;1069;2723;7957;3050;9026
240615;201708;1006;2926;822;2556;115;388;518;1558;633;1946
240620;201708;1888;5522;1651;5117;127;404;1273;3911;1400;4315
240630;201708;2070;6200;1876;5873;159;439;1271;4065;1430;4504
240640;201708;967;2661;792;2379;63;236;538;1549;601;1785
240650;201708;4064;11664;3621;10960;196;638;2821;8486;3017;9124
240660;201708;2517;7577;2358;7345;138;496;1925;5926;2063;6422
240670;201708;2611;7659;2162;6706;201;692;1287;3858;1488;4550
240680;201708;1553;4426;1248;3887;74;258;847;2591;921;2849
240690;201708;936;2518;793;2274;36;132;632;1741;668;1873
240700;201708;2552;7419;2117;6631;82;350;1618;4920;1700;5270
240710;201708;17847;47351;15441;43360;3083;8574;8025;23061;11108;31635
240720;201708;5242;14605;4715;13673;1076;3227;2345;6655;3421;9882
240725;201708;1047;3129;830;2628;61;209;507;1562;568;1771
240730;201708;2117;6206;1822;5640;123;386;1339;4120;1462;4506
240740;201708;1987;5592;1727;5103;105;403;1205;3391;1310;3794
240750;201708;2155;7921;1977;7567;390;1655;1001;3867;1391;5522
240760;201708;1390;3651;1050;3129;64;170;775;2361;839;2531
240770;201708;3179;8923;2821;8421;163;617;2306;6740;2469;7357
240780;201708;5957;16221;4783;14340;595;1817;2846;8676;3441;10493
240790;201708;914;2683;738;2343;33;122;535;1714;568;1836
240800;201708;35814;100396;31280;92656;6292;19365;13714;41037;20006;60402
240810;201708;85612;242558;78114;229464;19704;58363;35446;106367;55150;164730
240820;201708;5711;17936;5118;16990;1152;3952;2432;8489;3584;12441
240830;201708;9025;26937;8347;25939;416;1684;6788;20784;7204;22468
240840;201708;1139;3065;950;2738;78;246;643;1786;721;2032
240850;201708;1315;3796;969;3021;89;302;517;1597;606;1899
240860;201708;1278;3605;1027;3132;43;188;753;2178;796;2366
240870;201708;1185;3134;931;2699;67;208;610;1694;677;1902
240880;201708;1269;4121;1193;3994;101;388;947;3114;1048;3502
240890;201708;5051;14060;4093;12210;774;2402;1783;5270;2557;7672
240895;201708;2662;9045;2455;8704;260;988;1780;6380;2040;7368
240910;201708;3099;8986;2703;8211;92;338;2146;6457;2238;6795
240920;201708;802;2527;695;2293;97;338;353;1150;450;1488
240930;201708;3563;8865;3086;8276;94;249;2450;6686;2544;6935
240933;201708;1648;4266;1418;3893;54;196;1154;3081;1208;3277
240940;201708;6601;17041;5303;14893;573;1612;3432;9499;4005;11111
240950;201708;968;3069;886;2905;53;231;649;2068;702;2299
240960;201708;815;2466;708;2249;57;197;499;1562;556;1759
240970;201708;1905;5159;1591;4622;82;294;1247;3501;1329;3795
240980;201708;2932;9535;2723;9144;345;1285;1846;6118;2191;7403
240990;201708;2670;7873;2523;7591;387;1230;1659;4926;2046;6156
241000;201708;1030;2806;863;2506;46;159;592;1692;638;1851
241010;201708;2809;9325;2636;8999;306;1256;1837;6036;2143;7292
241020;201708;2054;5632;1593;4675;207;569;910;2664;1117;3233
241025;201708;1696;5039;1461;4614;91;317;929;2948;1020;3265
241030;201708;2423;7842;2099;7174;206;800;1403;4740;1609;5540
241040;201708;2281;7555;2060;7156;150;614;1521;5291;1671;5905
241050;201708;1306;3757;1095;3377;63;218;780;2349;843;2567
241060;201708;845;2403;746;2222;61;185;503;1471;564;1656
241070;201708;694;1982;623;1853;51;192;459;1282;510;1474
241080;201708;1160;3370;935;2923;30;136;688;2106;718;2242
241090;201708;2145;6291;1774;5655;89;388;1315;4124;1404;4512
241100;201708;1160;3390;989;3008;54;188;675;2016;729;2204
241105;201708;1208;3621;1038;3322;267;850;404;1343;671;2193
241110;201708;852;2568;686;2190;38;132;449;1381;487;1513
241120;201708;7461;22330;6688;20946;1579;4751;3341;11155;4920;15906
241140;201708;3406;9089;2894;8096;202;560;2058;5610;2260;6170
241142;201708;782;2231;596;1853;58;199;322;972;380;1171
241150;201708;5675;16078;5053;15039;337;1175;3712;10882;4049;12057
241160;201708;1000;2827;883;2632;167;501;472;1382;639;1883
241170;201708;1202;3342;1099;3165;86;238;863;2440;949;2678
241180;201708;1010;2752;765;2255;91;270;389;1134;480;1404
241190;201708;1199;3268;949;2748;50;183;634;1763;684;1946
241200;201708;19598;54873;17220;51269;4037;12513;7674;23510;11711;36023
241210;201708;1495;4122;1166;3462;122;390;687;1984;809;2374
241220;201708;8187;26181;7490;24891;2244;7588;3143;10879;5387;18467
241230;201708;3094;8684;2830;8263;132;473;2310;6569;2442;7042
241240;201708;1289;3731;793;2564;67;251;364;1182;431;1433
241250;201708;6174;18433;5092;16361;222;1105;3714;11429;3936;12534
241255;201708;1844;6634;1652;6211;249;1064;931;3479;1180;4543
241260;201708;5201;13815;4100;12071;163;699;2953;8474;3116;9173
241270;201708;1895;5661;1636;5146;124;484;1148;3538;1272;4022
241280;201708;1862;5264;1701;4967;150;448;1281;3704;1431;4152
241290;201708;3040;8188;2493;7253;135;480;1852;5263;1987;5743
241300;201708;1516;4247;1287;3833;48;157;857;2510;905;2667
241310;201708;1808;5040;1621;4738;67;256;1324;3804;1391;4060
241320;201708;952;3258;855;3036;115;460;521;1840;636;2300
241330;201708;1484;4422;1383;4290;72;298;1159;3527;1231;3825
241335;201708;2970;8666;2685;8163;139;490;2171;6491;2310;6981
241340;201708;1860;5588;1544;4876;335;1098;643;1987;978;3085
241350;201708;1971;6042;1774;5670;134;519;1296;4023;1430;4542
241355;201708;1446;3946;1145;3399;59;212;862;2520;921;2732
241360;201708;2140;5657;1736;4868;79;237;1258;3444;1337;3681
241370;201708;1397;4047;1131;3523;91;328;722;2158;813;2486
241380;201708;653;1817;545;1610;65;221;327;921;392;1142
241390;201708;2776;8802;2573;8483;242;879;1905;6278;2147;7157
241400;201708;3732;10546;3365;10007;304;961;2544;7626;2848;8587
241410;201708;2489;7459;2176;6955;413;1383;1227;3918;1640;5301
241415;201708;1718;5081;1492;4698;128;444;1098;3372;1226;3816
241420;201708;2299;7813;2039;7367;643;2468;571;2118;1214;4586
241430;201708;575;1681;439;1380;38;139;251;751;289;890
241440;201708;6619;22854;6130;22016;628;2593;4456;15925;5084;18518
241445;201708;1027;2858;973;2794;51;121;826;2488;877;2609
241450;201708;3047;7916;2653;7362;277;767;1901;5273;2178;6040
241460;201708;3506;9950;3063;9044;230;793;2143;6146;2373;6939
241470;201708;1445;3901;1170;3524;79;285;902;2702;981;2987
241475;201708;1273;3747;1044;3292;49;258;742;2206;791;2464
241480;201708;2757;8975;2486;8470;928;3195;646;2525;1574;5720
241490;201708;705;1824;568;1601;27;80;381;1038;408;1118
241500;201708;752;2340;645;2204;21;81;543;1860;564;1941
250010;201708;2823;8638;2343;7576;98;419;1697;5361;1795;5780
250020;201708;1599;4477;1201;3707;64;207;829;2514;893;2721
250030;201708;7048;19940;6446;19080;420;1391;5117;14891;5537;16282
250040;201708;4062;13369;3741;12671;410;1506;2521;8458;2931;9964
250050;201708;3345;10216;3090;9813;413;1351;2064;6470;2477;7821
250053;201708;1246;3710;1132;3538;124;410;776;2447;900;2857
250057;201708;642;2586;625;2568;3;8;596;2499;599;2507
250060;201708;5284;15168;4897;14621;471;1514;3723;11104;4194;12618
250070;201708;3931;11878;3617;11284;95;468;2752;8229;2847;8697
250073;201708;804;2309;692;2118;22;83;520;1535;542;1618
250077;201708;2188;6218;1733;5428;114;371;1196;3723;1310;4094
250080;201708;4352;12150;4095;11710;182;637;3364;9404;3546;10041
250090;201708;2677;7375;2475;7047;144;377;2011;5689;2155;6066
250100;201708;3924;12420;3663;11941;206;849;2937;9335;3143;10184
250110;201708;4876;14303;4572;13857;490;1766;3500;10355;3990;12121
250115;201708;511;1585;465;1505;20;105;344;1070;364;1175
250120;201708;1858;5702;1617;5235;82;342;1245;4010;1327;4352
250130;201708;5362;16257;4804;15234;163;808;3767;11647;3930;12455
250135;201708;1071;3209;1000;3084;32;119;805;2460;837;2579
250140;201708;2156;6845;2078;6719;125;510;1679;5401;1804;5911
250150;201708;5084;16684;4633;15827;244;1113;3450;11532;3694;12645
250153;201708;1489;3933;1242;3560;36;149;1033;2899;1069;3048
250157;201708;1799;5672;1638;5345;237;727;1077;3583;1314;4310
250160;201708;3375;9545;3148;9197;95;320;2829;8248;2924;8568
250170;201708;1639;4682;1489;4451;88;325;1177;3474;1265;3799
250180;201708;16223;45805;15006;44003;1275;4415;10966;31323;12241;35738
250190;201708;4191;11931;3802;11300;595;1690;2366;7079;2961;8769
250200;201708;1969;5678;1637;5169;72;292;1302;4073;1374;4365
250205;201708;846;2859;790;2731;30;157;600;2055;630;2212
250210;201708;1505;4832;1393;4644;74;350;1064;3468;1138;3818
250215;201708;1458;4459;1309;4240;95;391;822;2605;917;2996
250220;201708;751;2165;613;1952;36;129;441;1389;477;1518
250230;201708;1616;3960;1262;3371;43;143;989;2539;1032;2682
250240;201708;2343;7481;2186;7199;103;395;1750;5715;1853;6110
250250;201708;4565;13467;4131;12868;161;558;3388;10548;3549;11106
250260;201708;1734;5051;1486;4630;55;191;1163;3616;1218;3807
250270;201708;1308;3973;1176;3806;98;315;856;2902;954;3217
250280;201708;3614;10451;3137;9680;214;709;2365;7252;2579;7961
250290;201708;1800;4794;1498;4384;18;59;1247;3644;1265;3703
250300;201708;5354;15586;5096;15256;369;1465;4260;12399;4629;13864
250310;201708;1122;3361;998;3146;51;203;753;2299;804;2502
250320;201708;8485;23890;7948;23109;807;2573;5988;17129;6795;19702
250330;201708;2466;7433;2097;6885;142;526;1575;5109;1717;5635
250340;201708;1114;3170;991;2968;25;84;816;2401;841;2485
250350;201708;4224;11602;3793;11063;144;449;3268;9554;3412;10003
250355;201708;2013;6178;1834;5946;34;180;1636;5264;1670;5444
250360;201708;1818;5271;1698;5070;44;147;1393;4136;1437;4283
250370;201708;11952;33537;10565;31849;730;2407;8691;26097;9421;28504
250375;201708;1092;3174;986;3019;27;92;861;2664;888;2756
250380;201708;1699;4710;1609;4592;72;268;1305;3585;1377;3853
250390;201708;1843;4961;1516;4408;210;594;968;2843;1178;3437
250400;201708;74740;196274;58309;169509;15038;45915;20382;60699;35420;106614
250403;201708;1604;5100;1475;4916;190;740;974;3181;1164;3921
250407;201708;1232;3338;1050;3060;83;204;752;2184;835;2388
250410;201708;552;1717;504;1627;18;96;400;1230;418;1326
250415;201708;1946;5698;1727;5307;74;244;1337;4096;1411;4340
250420;201708;1250;3612;1128;3433;23;79;1012;3078;1035;3157
250430;201708;6364;16672;5681;15656;234;749;4600;12407;4834;13156
250435;201708;1359;4089;1210;3822;64;249;896;2791;960;3040
250440;201708;4553;12732;4096;12096;121;453;3442;10044;3563;10497
250450;201708;1908;5307;1651;4952;47;181;1367;4031;1414;4212
250460;201708;6815;19634;6369;19067;388;1209;5387;16336;5775;17545
250470;201708;1565;4148;1305;3774;84;296;941;2627;1025;2923
250480;201708;3807;11213;3495;10790;72;307;3073;9504;3145;9811
250485;201708;667;1603;492;1340;23;75;400;1055;423;1130
250490;201708;4134;11952;3892;11636;410;1295;2999;8975;3409;10270
250500;201708;1832;5369;1646;5060;94;293;1294;3992;1388;4285
250510;201708;5123;13851;4506;13000;101;327;3978;11491;4079;11818
250520;201708;1809;5342;1674;5155;240;839;1039;3112;1279;3951
250523;201708;1875;5281;1778;5151;98;410;1497;4197;1595;4607
250527;201708;1533;4353;1454;4253;37;138;1345;3898;1382;4036
250530;201708;601;1809;530;1717;25;101;456;1463;481;1564
250535;201708;1355;4138;1249;3927;50;228;959;2935;1009;3163
250540;201708;2543;6829;2338;6593;83;235;2034;5713;2117;5948
250550;201708;879;2926;798;2785;39;189;640;2178;679;2367
250560;201708;1683;5095;1579;4922;72;271;1293;3937;1365;4208
250570;201708;2686;8207;2344;7559;111;465;1813;5698;1924;6163
250580;201708;1121;2919;982;2711;54;204;801;2142;855;2346
250590;201708;835;2529;756;2405;31;145;612;1872;643;2017
250600;201708;7274;20730;6711;19876;652;1772;5144;15442;5796;17214
250610;201708;3081;8879;2849;8529;202;674;2237;6625;2439;7299
250620;201708;700;2017;621;1853;62;219;425;1216;487;1435
250625;201708;2497;7597;2354;7361;52;199;2077;6411;2129;6610
250630;201708;9831;29710;8832;27669;1642;5350;4966;15342;6608;20692
250640;201708;3455;10380;3261;10116;153;672;2710;8177;2863;8849
250650;201708;891;2356;772;2198;44;161;595;1609;639;1770
250660;201708;1808;4596;1651;4391;29;66;1517;4038;1546;4104
250670;201708;2337;7734;2215;7515;94;462;1840;6105;1934;6567
250680;201708;5008;13373;4684;13002;178;656;4129;11298;4307;11954
250690;201708;6165;15289;5865;14942;257;659;5335;13559;5592;14218
250700;201708;4594;13384;4192;12780;517;1664;2914;8774;3431;10438
250710;201708;4491;13599;4015;12943;394;1375;2775;9052;3169;10427
250720;201708;2797;7648;2568;7281;59;253;2279;6386;2338;6639
250730;201708;3663;10597;3330;10124;244;852;2636;7825;2880;8677
250740;201708;1967;5434;1679;5002;167;538;1255;3655;1422;4193
250750;201708;98341;270724;89435;257663;10838;34149;58802;166223;69640;200372
250760;201708;2315;6336;2030;5912;130;452;1556;4416;1686;4868
250770;201708;3943;12743;3668;12385;371;1418;2615;8820;2986;10238
250780;201708;1760;5043;1506;4550;169;568;968;2866;1137;3434
250790;201708;2324;7405;2187;7161;393;1304;1302;4355;1695;5659
250800;201708;2654;7260;2318;6710;95;269;1880;5382;1975;5651
250810;201708;1288;3678;1107;3401;52;214;868;2621;920;2835
250820;201708;1911;5886;1836;5796;97;417;1610;5005;1707;5422
250830;201708;5643;17785;5174;16801;464;1777;3546;11252;4010;13029
250840;201708;917;2915;786;2640;37;152;519;1751;556;1903
250850;201708;1991;5932;1774;5577;68;329;1387;4228;1455;4557
250855;201708;1086;3163;947;2927;37;163;702;2106;739;2269
250860;201708;3314;10468;2827;9574;551;1972;1290;4462;1841;6434
250870;201708;1087;3069;942;2794;36;131;740;2169;776;2300
250880;201708;1553;4165;1276;3754;187;552;806;2416;993;2968
250890;201708;9520;27687;9070;27078;906;3293;6874;19969;7780;23262
250900;201708;2775;8707;2430;8047;131;478;1889;6145;2020;6623
250905;201708;2118;6502;2035;6404;137;517;1691;5262;1828;5779
250910;201708;5108;14238;4779;13770;208;720;4051;11601;4259;12321
250915;201708;1509;4391;1443;4315;48;99;1312;4023;1360;4122
250920;201708;3273;9080;3071;8777;338;923;2227;6325;2565;7248
250930;201708;2036;5999;1925;5809;139;513;1515;4464;1654;4977
250933;201708;1124;3633;1011;3402;69;304;676;2203;745;2507
250937;201708;713;2094;605;1897;42;152;444;1373;486;1525
250939;201708;1654;4735;1461;4427;66;258;1131;3330;1197;3588
250940;201708;3831;10982;3567;10543;79;295;3114;9226;3193;9521
250950;201708;1403;4067;1210;3804;43;176;1016;3189;1059;3365
250960;201708;1071;3341;995;3209;39;162;798;2527;837;2689
250970;201708;8599;23353;7468;21544;549;1776;5434;15394;5983;17170
250980;201708;2596;7387;2340;6913;78;318;1816;5190;1894;5508
250990;201708;1990;6537;1753;6016;139;598;1223;4075;1362;4673
251000;201708;2116;6076;1816;5608;50;238;1511;4606;1561;4844
251010;201708;2739;7921;2460;7467;68;258;2149;6508;2217;6766
251020;201708;1712;4689;1562;4501;66;212;1404;4027;1470;4239
251030;201708;1029;2890;923;2670;54;183;639;1785;693;1968
251040;201708;1823;5543;1611;5191;73;348;1260;3930;1333;4278
251050;201708;1069;3066;884;2714;115;366;583;1750;698;2116
251060;201708;1060;2371;777;2002;24;99;614;1540;638;1639
251065;201708;490;1375;400;1248;25;99;260;746;285;845
251070;201708;684;1894;608;1788;25;104;485;1379;510;1483
251080;201708;18847;51743;16814;48574;3380;10147;9042;26581;12422;36728
251090;201708;2929;8814;2559;8089;121;465;1939;5999;2060;6464
251100;201708;928;2897;829;2725;41;190;571;1783;612;1973
251110;201708;1851;5300;1621;4836;88;272;1172;3454;1260;3726
251120;201708;6434;20918;6051;20220;502;2007;4511;14867;5013;16874
251130;201708;3817;9439;3490;9071;369;1018;2957;7622;3326;8640
251140;201708;4339;12844;4025;12351;139;566;3276;9986;3415;10552
251150;201708;2683;8237;2478;7927;161;711;1906;5910;2067;6621
251160;201708;1892;6109;1812;5987;73;271;1614;5348;1687;5619
251170;201708;1503;4386;1419;4289;44;171;1268;3823;1312;3994
251180;201708;2569;7575;2291;7144;284;959;1447;4462;1731;5421
251190;201708;4524;12184;4293;11898;111;369;3872;10567;3983;10936
251200;201708;3973;12659;3738;12359;92;392;3349;11108;3441;11500
251203;201708;1006;3315;961;3218;51;224;703;2294;754;2518
251207;201708;1042;3166;873;2843;24;128;601;1887;625;2015
251210;201708;8010;21922;6778;20299;489;1504;5207;15772;5696;17276
251220;201708;1217;3149;994;2849;60;159;764;2209;824;2368
251230;201708;4821;13579;4322;12942;223;822;3670;10760;3893;11582
251240;201708;3476;10027;3050;9452;298;971;2219;6775;2517;7746
251250;201708;10411;29780;9611;28607;1023;3408;6812;19709;7835;23117
251260;201708;470;1454;430;1385;16;70;321;1012;337;1082
251270;201708;4298;13644;3908;13147;155;691;3298;11076;3453;11767
251272;201708;1336;3761;1252;3639;52;178;1107;3194;1159;3372
251274;201708;940;2807;799;2546;65;278;522;1571;587;1849
251275;201708;1241;3559;1151;3421;55;218;854;2407;909;2625
251276;201708;1232;3694;1167;3592;100;398;876;2639;976;3037
251278;201708;614;1840;540;1698;53;195;356;1114;409;1309
251280;201708;2354;6811;2159;6485;72;312;1705;4942;1777;5254
251290;201708;5723;15273;5384;14847;430;1526;4329;11552;4759;13078
251300;201708;758;2460;710;2381;17;65;580;1936;597;2001
251310;201708;2971;8696;2728;8331;125;554;2154;6361;2279;6915
251315;201708;1687;5547;1586;5368;117;430;1190;3990;1307;4420
251320;201708;1884;5042;1368;4190;73;265;926;2821;999;3086
251330;201708;1840;4739;1528;4335;60;238;1355;3785;1415;4023
251335;201708;1057;3377;960;3221;66;280;702;2282;768;2562
251340;201708;3478;9649;3018;9009;145;523;2253;6579;2398;7102
251350;201708;1180;3700;1099;3553;49;222;865;2690;914;2912
251360;201708;1821;5553;1541;5154;45;187;1304;4402;1349;4589
251365;201708;727;2154;598;1865;15;63;452;1393;467;1456
251370;201708;23665;70763;22628;69341;2046;7262;17241;52015;19287;59277
251380;201708;1329;4019;1143;3705;37;176;942;2936;979;3112
251385;201708;740;1954;593;1717;32;102;410;1124;442;1226
251390;201708;5893;19250;5200;17896;1254;4492;2518;8664;3772;13156
251392;201708;1058;3049;920;2819;59;224;655;1945;714;2169
251394;201708;650;2174;562;2020;32;145;404;1452;436;1597
251396;201708;823;2295;699;2092;50;144;449;1324;499;1468
251398;201708;968;2682;772;2338;39;155;537;1558;576;1713
251400;201708;1157;3217;977;2956;61;215;698;2023;759;2238
251410;201708;1571;3965;1322;3578;30;115;1097;2860;1127;2975
251420;201708;1982;5580;1701;5246;106;404;1273;3837;1379;4241
251430;201708;1636;5352;1507;5149;58;285;1266;4247;1324;4532
251440;201708;1196;3537;975;3103;37;145;750;2370;787;2515
251445;201708;1548;4607;1456;4483;100;395;1134;3396;1234;3791
251450;201708;4666;14389;4256;13807;133;601;3465;11118;3598;11719
251455;201708;1067;3329;946;3090;71;295;671;2146;742;2441
251460;201708;845;2563;768;2434;38;139;625;2002;663;2141
251465;201708;449;1412;382;1257;19;93;282;897;301;990
251470;201708;1173;3343;938;2854;88;289;558;1665;646;1954
251480;201708;946;2605;826;2411;36;149;595;1659;631;1808
251490;201708;1829;5295;1607;4947;148;487;1048;3189;1196;3676
251500;201708;1786;5549;1687;5367;100;400;1374;4280;1474;4680
251510;201708;2563;8243;2296;7694;280;1032;1387;4593;1667;5625
251520;201708;1007;2717;802;2310;89;235;501;1419;590;1654
251530;201708;12552;33667;11620;32388;268;1159;10064;27428;10332;28587
251540;201708;2883;8947;2639;8479;161;627;2015;6350;2176;6977
251550;201708;3517;9027;2902;8211;84;302;2389;6703;2473;7005
251560;201708;666;2057;600;1943;108;386;335;1034;443;1420
251570;201708;971;2827;790;2474;29;115;552;1670;581;1785
251580;201708;1902;5088;1725;4842;227;591;1255;3579;1482;4170
251590;201708;1522;4399;1431;4273;71;214;1121;3341;1192;3555
251593;201708;1004;3020;922;2904;132;435;544;1687;676;2122
251597;201708;1983;5890;1902;5788;37;144;1717;5176;1754;5320
251600;201708;6584;18801;6055;17970;277;917;4914;14443;5191;15360
251610;201708;3351;9729;2945;8973;367;1060;1977;6121;2344;7181
251615;201708;1160;3197;934;2804;36;154;659;1901;695;2055
251620;201708;16219;41288;14273;39027;468;1217;11664;33627;12132;34844
251630;201708;4782;11981;4013;10899;256;734;2985;7979;3241;8713
251640;201708;2217;6557;1999;6135;88;366;1620;4856;1708;5222
251650;201708;4097;11425;3738;10947;191;682;3121;9066;3312;9748
251660;201708;3559;11095;3200;10436;123;589;2604;8258;2727;8847
251670;201708;4502;12886;3959;12199;36;163;3640;11291;3676;11454
251675;201708;704;2144;651;2072;108;373;412;1292;520;1665
251680;201708;2819;7867;2270;7025;77;293;1784;5482;1861;5775
251690;201708;3324;9753;2989;9121;112;410;2153;6383;2265;6793
251700;201708;1931;6117;1796;5942;97;461;1474;4752;1571;5213
251710;201708;875;2296;580;1705;69;248;280;794;349;1042
251720;201708;1426;4242;1209;3828;51;227;893;2727;944;2954
251740;201708;775;2141;610;1863;52;176;371;1104;423;1280
260005;201708;26351;62425;22562;57083;3572;8837;13821;34992;17393;43829
260010;201708;10013;26748;8383;24481;726;2186;5140;15394;5866;17580
260020;201708;6467;16904;5447;15456;184;692;4371;12333;4555;13025
260030;201708;6268;17484;5533;16316;326;1109;4258;12506;4584;13615
260040;201708;9372;23912;7691;21827;844;2403;5365;15748;6209;18151
260050;201708;11374;34333;10637;33449;443;1712;9175;29051;9618;30763
260060;201708;3907;10741;3438;9912;306;837;2505;7351;2811;8188
260070;201708;10014;27909;9072;26398;861;2818;6400;18276;7261;21094
260080;201708;6359;15784;5659;14809;322;918;4483;11501;4805;12419
260090;201708;5352;14051;4942;13491;566;1492;3707;10278;4273;11770
260100;201708;3338;9026;2853;8350;157;561;2280;6631;2437;7192
260105;201708;5010;13794;4736;13359;144;619;4025;11075;4169;11694
260110;201708;22140;59752;20180;57394;1056;3162;17363;49473;18419;52635
260120;201708;13474;38822;11885;36216;2127;6629;6655;20850;8782;27479
260130;201708;3195;8773;2980;8427;320;942;2182;6100;2502;7042
260140;201708;12979;31593;11268;29545;700;2099;9128;23963;9828;26062
260150;201708;3205;8627;2889;8204;210;712;2281;6395;2491;7107
260160;201708;5707;17208;4881;16100;177;816;4036;13369;4213;14185
260170;201708;16727;45254;15788;43945;912;2640;13168;36504;14080;39144
260180;201708;3324;9720;3020;9269;185;644;2506;7627;2691;8271
260190;201708;16872;37722;15100;35569;331;975;13066;30216;13397;31191
260200;201708;11298;28058;10246;26714;444;1268;8928;23228;9372;24496
260210;201708;12079;35262;10609;32910;466;1791;8545;26411;9011;28202
260220;201708;9681;26272;9239;25716;342;1194;8182;22501;8524;23695
260230;201708;9972;27213;9058;25961;451;1547;7210;20514;7661;22061
260240;201708;2986;8713;2588;8120;233;791;1947;6147;2180;6938
260250;201708;2301;6280;2010;5864;108;363;1584;4528;1692;4891
260260;201708;12408;34474;11145;32612;725;2477;8638;25137;9363;27614
260270;201708;3657;10406;3348;9942;231;972;2504;7151;2735;8123
260280;201708;13168;41276;12092;39704;589;2222;10215;33643;10804;35865
260290;201708;34427;99478;32097;95484;4985;15627;19869;58410;24854;74037
260300;201708;9233;26920;8080;25211;353;1479;6298;19608;6651;21087
260310;201708;4577;13140;4140;12506;703;1999;2689;8430;3392;10429
260320;201708;7577;23152;6893;21993;364;1334;5483;17390;5847;18724
260330;201708;2592;8127;2391;7742;133;512;1857;5909;1990;6421
260340;201708;1954;5483;1781;5228;47;175;1548;4499;1595;4674
260345;201708;22943;68713;21275;65645;5013;16860;8784;25979;13797;42839
260350;201708;5056;13103;4618;12491;177;586;3968;10628;4145;11214
260360;201708;2508;6931;2279;6532;96;420;1547;4331;1643;4751
260370;201708;5695;17162;4991;15889;316;1281;3686;11558;4002;12839
260380;201708;4924;15644;4407;14803;259;1074;3204;10650;3463;11724
260390;201708;4353;13535;3736;12300;296;1042;2507;8141;2803;9183
260392;201708;3574;11314;3234;10875;190;926;2645;8689;2835;9615
260400;201708;14157;38406;13293;37038;1372;4231;9648;26366;11020;30597
260410;201708;61927;172112;53196;158370;13256;41916;21083;64301;34339;106217
260415;201708;3761;11439;3286;10491;186;828;2242;6853;2428;7681
260420;201708;12693;28218;11208;26601;184;631;10265;24131;10449;24762
260430;201708;2956;9305;2569;8556;197;719;1730;5742;1927;6461
260440;201708;3421;9881;3021;9128;252;922;2171;6350;2423;7272
260450;201708;5139;14407;4903;14080;182;609;4352;12472;4534;13081
260460;201708;5591;17492;5076;16496;745;2735;2919;9237;3664;11972
260470;201708;4729;13374;4259;12822;138;375;3734;11607;3872;11982
260480;201708;4254;11704;3652;10848;404;1321;2368;7150;2772;8471
260490;201708;5140;13048;4458;11889;162;551;3725;9650;3887;10201
260500;201708;6047;16690;5292;15515;656;1918;3488;10333;4144;12251
260510;201708;9205;23587;8401;22495;329;1030;7333;19441;7662;20471
260515;201708;4822;14007;3633;11674;200;730;2295;7281;2495;8011
260520;201708;16943;42373;15973;41069;1348;3557;12589;32118;13937;35675
260530;201708;9664;29111;8444;27210;325;1342;6997;22445;7322;23787
260540;201708;6098;14900;5504;14244;798;1585;4208;11512;5006;13097
260545;201708;68;241;43;169;11;39;5;20;16;59
260550;201708;2849;8843;2402;7863;264;1019;1347;4343;1611;5362
260560;201708;6410;16471;5615;15389;172;686;4777;12878;4949;13564
260570;201708;6948;21584;6339;20630;664;2285;4662;15214;5326;17499
260580;201708;3905;10385;3531;9807;71;272;3100;8472;3171;8744
260590;201708;6418;15899;5923;15336;260;714;5137;13292;5397;14006
260600;201708;29658;83209;25951;77104;1682;5984;18800;55031;20482;61015
260610;201708;6647;19078;6307;18534;634;1948;4701;13703;5335;15651
260620;201708;15378;45544;14637;44268;2236;7580;9228;27134;11464;34714
260630;201708;2359;6528;2004;6007;67;267;1639;4848;1706;5115
260640;201708;17966;47135;16579;45327;1625;4901;12007;32508;13632;37409
260650;201708;5532;16616;4840;15440;237;958;3878;12347;4115;13305
260660;201708;7729;20939;6891;19861;222;840;5795;16486;6017;17326
260670;201708;2358;6156;1932;5542;113;338;1370;3894;1483;4232
260680;201708;23189;63126;20794;59003;3293;9514;11135;31496;14428;41010
260690;201708;3785;9936;3133;8889;155;464;2458;6957;2613;7421
260700;201708;5868;17390;5704;17212;24;43;5585;17023;5609;17066
260710;201708;1406;3929;1328;3826;86;309;984;2893;1070;3202
260720;201708;18720;56747;17451;54386;3034;9786;10026;31118;13060;40904
260730;201708;6864;22039;6389;21268;531;2051;4956;16232;5487;18283
260740;201708;1283;3778;1137;3533;40;124;929;2899;969;3023
260750;201708;7039;20329;6153;19192;207;615;5441;17310;5648;17925
260760;201708;5020;13087;4640;12618;242;736;3815;10404;4057;11140
260765;201708;7642;25449;7180;24673;937;4011;4688;15563;5625;19574
260770;201708;3826;10164;3405;9489;128;419;2658;7357;2786;7776
260775;201708;5093;14698;4794;14225;369;1411;3474;9969;3843;11380
260780;201708;3761;11633;3506;11142;594;2038;2105;6534;2699;8572
260790;201708;112698;278972;103229;264853;19601;50942;59091;150532;78692;201474
260795;201708;3131;8886;2754;8312;194;675;1974;5987;2168;6662
260800;201708;5339;13198;4878;12572;119;407;4316;10780;4435;11187
260805;201708;3751;11133;3209;10230;285;1053;2171;6831;2456;7884
260810;201708;6620;18341;6274;17749;541;1622;4866;13660;5407;15282
260820;201708;4219;11330;3753;10619;464;1524;2428;6692;2892;8216
260825;201708;2925;9118;2605;8581;141;589;1944;6336;2085;6925
260830;201708;3941;12207;3454;11271;490;1545;2272;7561;2762;9106
260840;201708;4199;11878;3713;11165;234;743;2940;8797;3174;9540
260845;201708;4151;11791;3922;11377;379;1121;2866;8296;3245;9417
260850;201708;5050;15576;4445;14260;656;2235;2405;7579;3061;9814
260860;201708;3685;10858;3159;9807;160;586;2410;7382;2570;7968
260870;201708;4378;11403;3856;10737;180;612;3210;8820;3390;9432
260875;201708;6749;18206;5815;16709;811;2360;3706;10708;4517;13068
260880;201708;10060;29084;9020;27411;447;1472;7212;22005;7659;23477
260890;201708;13107;36868;12171;35412;1007;3339;8701;24891;9708;28230
260900;201708;5723;17308;4912;15769;375;1461;3192;10048;3567;11509
260910;201708;3142;9148;2794;8566;139;487;2089;6397;2228;6884
260915;201708;4747;15232;4422;14778;77;383;4015;13393;4092;13776
260920;201708;3311;9777;3065;9444;170;551;2494;7860;2664;8411
260930;201708;3855;12401;3419;11654;286;1048;2470;8441;2756;9489
260940;201708;14430;37058;13156;34988;1339;3988;9096;23620;10435;27608
260950;201708;6470;19440;5625;17738;859;2986;2777;8305;3636;11291
260960;201708;59619;157328;53388;147413;9377;27718;28777;78060;38154;105778
260970;201708;5010;14635;4583;14070;219;762;3557;10968;3776;11730
260980;201708;4226;13110;3873;12672;103;435;3418;11182;3521;11617
260990;201708;17336;51790;15522;49281;999;3693;11898;37668;12897;41361
261000;201708;16184;42246;13344;38023;1461;4453;8219;23826;9680;28279
261010;201708;2605;6985;2342;6661;96;227;2059;5944;2155;6171
261020;201708;6559;18509;5726;17013;492;1583;4190;12129;4682;13712
261030;201708;3893;11610;3416;10820;160;602;2695;8402;2855;9004
261040;201708;5192;16319;4368;14571;326;1266;3086;10083;3412;11349
261050;201708;7950;22478;7367;21472;872;2542;4786;14005;5658;16547
261060;201708;12816;36002;11788;34239;999;3283;8861;25281;9860;28564
261070;201708;56192;133459;49228;123496;4927;12769;34234;85063;39161;97832
261080;201708;5869;16176;5562;15734;280;772;4846;13842;5126;14614
261090;201708;16932;44720;15473;42712;799;2428;12798;35214;13597;37642
261100;201708;8315;25390;7358;23752;1021;3428;4589;15095;5610;18523
261110;201708;62457;183186;55246;171947;13747;45079;24060;76579;37807;121658
261120;201708;3961;10077;3433;9443;81;259;3041;8379;3122;8638
261130;201708;7348;18294;6749;17621;192;587;5957;15494;6149;16081
261140;201708;3313;8738;3006;8279;325;992;2066;5631;2391;6623
261150;201708;5431;14974;4915;14180;196;692;4176;11943;4372;12635
261153;201708;2074;6109;1761;5606;88;352;1232;3894;1320;4246
261160;201708;201870;518960;184371;492771;46613;130243;78271;211558;124884;341801
261170;201708;5734;15117;5228;14393;295;821;4179;11503;4474;12324
261180;201708;9825;26578;9109;25584;856;2658;6335;17631;7191;20289
261190;201708;5032;15301;4668;14831;474;1847;3240;10081;3714;11928
261200;201708;3654;8714;3240;8217;291;762;2517;6347;2808;7109
261210;201708;1910;4941;1751;4732;94;271;1515;4092;1609;4363
261220;201708;13716;41256;11604;36977;1686;5806;6287;19903;7973;25709
261230;201708;4637;14009;4149;13376;113;459;3461;11293;3574;11752
261240;201708;5052;14006;4560;13201;440;1225;3426;9974;3866;11199
261245;201708;3517;10585;3027;9712;136;623;2345;7287;2481;7910
261247;201708;3167;9609;2692;8737;183;700;1859;6028;2042;6728
261250;201708;19368;50075;17868;48059;3365;8720;11171;31238;14536;39958
261255;201708;4137;12488;3650;11607;219;933;2839;8778;3058;9711
261260;201708;12753;35081;11197;33184;478;1706;9299;27687;9777;29393
261270;201708;3871;11135;3484;10506;285;983;2563;7531;2848;8514
261280;201708;2619;7684;2376;7285;102;415;1898;5672;2000;6087
261290;201708;3000;8332;2680;7911;147;541;2090;6166;2237;6707
261300;201708;11105;34117;9637;31413;890;3455;6424;20434;7314;23889
261310;201708;7330;21804;6800;20886;1534;4791;3811;11701;5345;16492
261320;201708;5987;17810;5415;16804;183;734;4363;13321;4546;14055
261330;201708;5777;15553;5400;15064;258;966;4599;12537;4857;13503
261340;201708;4005;12925;3720;12453;308;1293;2620;8672;2928;9965
261350;201708;8284;26019;7753;25109;224;1170;6285;19820;6509;20990
261360;201708;8443;21513;7346;19992;462;1319;5790;15494;6252;16813
261370;201708;19546;56494;18228;54380;3564;11114;10262;30567;13826;41681
261380;201708;4152;13647;3826;12954;580;2202;2313;7656;2893;9858
261390;201708;16534;49217;14713;46108;1874;6317;8792;27573;10666;33890
261400;201708;4740;15894;4206;14749;242;1071;2985;10270;3227;11341
261410;201708;9235;24780;8095;22983;605;1883;6353;17928;6958;19811
261420;201708;7376;24333;7028;23874;1364;5247;4301;14422;5665;19669
261430;201708;3560;10502;3020;9685;172;570;2378;7660;2550;8230
261440;201708;1578;4844;1397;4527;54;265;1005;3156;1059;3421
261450;201708;14221;39786;13594;38994;384;1466;11765;33460;12149;34926
261460;201708;7219;20792;6703;20060;335;1133;5730;17078;6065;18211
261470;201708;4141;10989;3776;10497;69;289;3134;8717;3203;9006
261480;201708;4120;13874;3712;13169;240;1021;2808;9740;3048;10761
261485;201708;5013;15034;4410;14006;519;1913;2808;8762;3327;10675
261500;201708;5681;15544;5020;14646;487;1377;3576;10725;4063;12102
261510;201708;1911;5947;1683;5557;121;462;1224;4064;1345;4526
261520;201708;2753;8472;2579;8163;117;425;1651;5456;1768;5881
261530;201708;11012;34905;9831;32574;1676;6255;4495;14763;6171;21018
261540;201708;7310;22786;6784;21899;1332;4326;3888;12874;5220;17200
261550;201708;3539;9715;3286;9352;256;896;2457;6798;2713;7694
261560;201708;7483;23521;6725;22486;656;2640;4969;16556;5625;19196
261570;201708;3465;10028;2969;9208;293;1032;1903;5820;2196;6852
261580;201708;6220;18188;5635;17278;221;960;4800;14495;5021;15455
261590;201708;2615;7084;2198;6446;129;394;1659;4891;1788;5285
261600;201708;5260;13921;4468;12762;357;1067;3135;9029;3492;10096
261610;201708;2481;6778;2122;6250;75;280;1679;4931;1754;5211
261618;201708;2518;6802;2275;6482;129;418;1815;5074;1944;5492
261620;201708;4011;12274;3753;11841;879;2642;2173;7178;3052;9820
261630;201708;7551;21539;6329;19254;621;2276;3716;10886;4337;13162
261640;201708;35922;86205;33365;83145;2156;4933;26742;69278;28898;74211
261650;201708;3949;11093;3628;10670;199;740;2698;7983;2897;8723
270010;201708;4398;15828;4029;15121;249;1267;3070;11340;3319;12607
270020;201708;3970;10745;3651;10290;293;993;2920;7991;3213;8984
270030;201708;37418;108981;34375;103962;6207;19191;20382;62108;26589;81299
270040;201708;10876;31843;9966;30654;908;3111;7544;23287;8452;26398
270050;201708;4684;12226;4216;11672;309;837;3528;9912;3837;10749
270060;201708;1957;5531;1795;5320;237;725;1247;3769;1484;4494
270070;201708;4475;13365;4057;12777;190;859;3363;10331;3553;11190
270080;201708;1316;4025;1128;3668;115;404;772;2453;887;2857
270090;201708;2145;6553;1924;6131;94;426;1497;4570;1591;4996
270100;201708;5658;16625;5283;16030;466;1659;4003;11933;4469;13592
270110;201708;3048;8322;2687;7914;272;835;1996;6090;2268;6925
270120;201708;3140;8523;2755;8039;91;337;2418;7029;2509;7366
270130;201708;5289;15359;4866;14889;471;1523;3851;11944;4322;13467
270135;201708;1875;4878;1666;4626;142;291;1418;4076;1560;4367
270140;201708;10701;24492;8945;22239;523;1984;7267;17080;7790;19064
270150;201708;2708;8483;2632;8395;39;119;2554;8173;2593;8292
270160;201708;5025;16222;4594;15692;156;769;3931;13285;4087;14054
270170;201708;3728;11643;3377;11151;397;1629;2260;7253;2657;8882
270180;201708;2331;7370;2138;7099;98;463;1784;5794;1882;6257
270190;201708;1795;5626;1695;5496;81;299;1438;4694;1519;4993
270200;201708;2641;8365;2373;8010;196;830;1718;5615;1914;6445
270210;201708;5074;14029;4682;13519;270;856;4028;11582;4298;12438
270220;201708;1298;4103;1195;3925;266;968;629;2020;895;2988
270230;201708;10815;32886;9360;30559;1110;4321;5607;17726;6717;22047
270235;201708;6155;19627;5744;18976;318;1331;4640;15163;4958;16494
270240;201708;10535;30078;8962;28053;1692;5645;5407;16989;7099;22634
270250;201708;3130;8126;2823;7738;376;975;2107;5841;2483;6816
270255;201708;4830;14452;3906;12748;255;1051;2741;8724;2996;9775
270260;201708;5993;18463;5718;18064;293;1283;4819;14763;5112;16046
270270;201708;1149;3170;1055;3043;187;568;635;1791;822;2359
270280;201708;3585;9728;3095;9045;407;929;2144;6506;2551;7435
270290;201708;8167;27155;7602;26197;477;2194;6087;20585;6564;22779
270300;201708;3809;11545;3374;11024;315;1130;2459;8034;2774;9164
270310;201708;7607;22217;6653;20801;247;1240;5431;16452;5678;17692
270320;201708;5936;17931;5470;17127;768;2593;3665;11296;4433;13889
270330;201708;4132;13892;3833;13492;371;1421;2910;10340;3281;11761
270340;201708;1678;4954;1470;4673;102;406;1172;3631;1274;4037
270350;201708;1950;5038;1727;4748;185;564;1206;3324;1391;3888
270360;201708;2180;6374;2046;6221;136;385;1764;5481;1900;5866
270370;201708;1490;4812;1356;4579;85;356;1012;3402;1097;3758
270375;201708;3016;7813;2631;7324;71;230;2333;6487;2404;6717
270380;201708;5803;17483;5343;16851;450;1467;4034;12961;4484;14428
270390;201708;1274;3415;1093;3145;50;175;839;2359;889;2534
270400;201708;6457;18608;5734;17554;293;1164;4221;12510;4514;13674
270410;201708;4743;14638;4311;13865;345;1269;3133;9929;3478;11198
270420;201708;5957;18433;5671;18060;276;1246;4587;14249;4863;15495
270430;201708;140983;389357;122139;362128;33639;105614;44434;135932;78073;241546
270440;201708;4726;13764;4308;13213;159;654;3517;10734;3676;11388
270450;201708;6510;19325;6119;18810;416;1551;4925;14987;5341;16538
270460;201708;3544;8885;3183;8456;99;339;2810;7328;2909;7667
270470;201708;10632;32816;9727;31396;1141;4070;6571;21389;7712;25459
270480;201708;2913;8583;2539;7959;287;1052;1776;5385;2063;6437
270490;201708;1016;3079;918;2949;59;230;706;2239;765;2469
270500;201708;4912;15869;4551;15424;207;1013;3784;12607;3991;13620
270510;201708;6106;17342;5447;16425;610;2320;3938;11367;4548;13687
270520;201708;3585;11095;3187;10363;1032;3573;993;3437;2025;7010
270530;201708;1303;3960;1204;3815;91;296;859;2761;950;3057
270540;201708;2095;6633;1926;6391;95;478;1597;5127;1692;5605
270550;201708;6860;19790;6158;18923;698;2211;4467;14051;5165;16262
270560;201708;3220;9239;2942;8820;211;727;2212;6554;2423;7281
270570;201708;3847;12081;3471;11443;223;913;2724;8818;2947;9731
270580;201708;2160;6370;2034;6200;97;294;1752;5412;1849;5706
270590;201708;1434;4515;1375;4442;6;27;1348;4359;1354;4386
270600;201708;2895;9315;2612;8838;150;728;2119;6985;2269;7713
270610;201708;3399;9988;3106;9567;151;579;2632;7984;2783;8563
270620;201708;1412;4519;1311;4344;75;332;1060;3392;1135;3724
270630;201708;16060;46018;14583;43655;1668;5220;10239;30943;11907;36163
270640;201708;5785;17382;5173;16426;288;1215;4111;12736;4399;13951
270642;201708;2393;8164;2216;7913;192;950;1690;5836;1882;6786
270644;201708;2943;8292;2545;7756;282;885;1824;5667;2106;6552
270650;201708;3662;11156;3448;10864;480;1957;2382;7146;2862;9103
270660;201708;2129;5413;1680;4784;93;348;1230;3483;1323;3831
270670;201708;17050;42322;14742;39705;1482;3978;11130;30605;12612;34583
270680;201708;4528;12546;4284;12274;82;185;4049;11699;4131;11884
270690;201708;9536;24835;8468;23648;1921;4935;5427;16048;7348;20983
270700;201708;578;1810;508;1686;67;285;334;1061;401;1346
270710;201708;6090;18632;5726;18169;360;1479;4732;14764;5092;16243
270720;201708;3503;11231;3131;10587;125;721;2568;8447;2693;9168
270730;201708;6684;18212;6255;17741;386;1120;5422;15544;5808;16664
270740;201708;2366;6517;2195;6263;140;495;1799;5064;1939;5559
270750;201708;5303;15598;4840;14886;507;1801;3576;10911;4083;12712
270760;201708;3594;10376;3209;9772;117;464;2632;7913;2749;8377
270770;201708;20116;51952;16723;47851;3339;9212;9555;29138;12894;38350
270780;201708;1838;5656;1746;5515;151;525;1346;4259;1497;4784
270790;201708;1600;4954;1464;4753;238;798;895;2922;1133;3720
270800;201708;11248;32438;10409;31299;561;2334;8764;25718;9325;28052
270810;201708;3295;9836;2639;8644;251;965;1739;5647;1990;6612
270820;201708;1789;5592;1556;5196;199;747;1027;3383;1226;4130
270830;201708;5689;14214;5023;13427;391;1103;3974;10892;4365;11995
270840;201708;8040;24794;7343;23854;285;1532;6301;19884;6586;21416
270850;201708;7869;22646;7420;22054;671;2603;5687;16126;6358;18729
270860;201708;11584;31172;9722;28846;972;3292;6845;20010;7817;23302
270870;201708;2254;6640;1899;5929;231;780;1228;3781;1459;4561
270880;201708;8380;25886;7729;24935;426;1780;6201;19660;6627;21440
270890;201708;2504;7457;2311;7123;217;777;1665;4977;1882;5754
270895;201708;2999;10318;2882;10149;121;614;2502;8656;2623;9270
270900;201708;1827;4870;1468;4305;60;211;1158;3308;1218;3519
270910;201708;3607;11357;3274;10774;189;844;2460;7889;2649;8733
270915;201708;9537;30569;8434;28584;1142;4492;5116;16914;6258;21406
270920;201708;6244;19108;5913;18650;279;1339;5057;15462;5336;16801
270930;201708;16866;44129;14302;41056;2653;7338;8887;26581;11540;33919
270940;201708;5655;18025;5299;17633;462;2030;3896;12681;4358;14711
280010;201708;698;1938;598;1762;36;162;418;1121;454;1283
280020;201708;4912;13626;4274;12595;565;1718;2760;8115;3325;9833
280030;201708;74940;191382;63236;174044;17538;50093;22854;65455;40392;115548
280040;201708;3195;9272;2846;8743;311;1037;1982;5995;2293;7032
280050;201708;3793;11741;3496;11228;759;2562;1883;6051;2642;8613
280060;201708;5121;15338;4364;14059;797;2736;2165;7123;2962;9859
280067;201708;7220;19693;6191;18017;803;2339;3860;11241;4663;13580
280070;201708;1964;6213;1883;6083;146;461;1538;4991;1684;5452
280100;201708;3860;11551;3468;10877;483;1642;2241;7042;2724;8684
280110;201708;1370;4045;1250;3857;59;239;1028;3092;1087;3331
280120;201708;7997;24231;7239;22965;1057;3150;5048;16510;6105;19660
280130;201708;8129;21198;7514;20307;813;2346;5490;14887;6303;17233
280140;201708;5888;14923;5342;14170;409;1087;4245;11272;4654;12359
280150;201708;3694;10421;3439;10037;213;757;2738;7880;2951;8637
280160;201708;1321;3835;1105;3450;164;547;677;2065;841;2612
280170;201708;4994;14158;4550;13496;347;1008;3557;10709;3904;11717
280190;201708;1241;3060;1053;2778;80;250;818;2085;898;2335
280200;201708;1231;3557;1108;3368;120;436;778;2282;898;2718
280210;201708;14877;41202;13194;38890;2413;7445;7345;22048;9758;29493
280220;201708;1765;4966;1596;4718;79;302;1295;3803;1374;4105
280230;201708;3418;9793;3067;9257;285;973;2182;6550;2467;7523
280240;201708;3559;9779;3200;9219;123;485;2648;7455;2771;7940
280250;201708;860;2261;681;1964;108;337;329;925;437;1262
280260;201708;2159;5543;2007;5365;65;190;1836;4920;1901;5110
280270;201708;2267;6788;2072;6483;122;434;1698;5241;1820;5675
280280;201708;4197;13492;3798;12834;662;1910;2343;8503;3005;10413
280290;201708;17915;52065;16064;49251;1991;6957;10016;30644;12007;37601
280300;201708;10006;28717;9254;27808;641;2173;6958;21742;7599;23915
280310;201708;1411;3830;1195;3459;46;174;869;2438;915;2612
280320;201708;8783;26640;8018;25402;1270;4354;4626;14502;5896;18856
280330;201708;4782;12717;4276;11937;347;1118;3284;8904;3631;10022
280340;201708;4281;10874;3983;10492;316;789;3218;8769;3534;9558
280350;201708;22797;61479;20012;57383;2771;8266;12919;37269;15690;45535
280360;201708;5869;17717;5395;16914;906;3064;3061;9510;3967;12574
280370;201708;2016;5253;1699;4743;141;357;1249;3490;1390;3847
280380;201708;1082;3184;968;2997;113;427;659;1975;772;2402
280390;201708;3171;8995;2711;8133;200;686;1902;5650;2102;6336
280400;201708;4148;11402;3756;10819;882;2455;1946;5871;2828;8326
280410;201708;2166;6746;1851;6117;207;740;1084;3484;1291;4224
280420;201708;4337;12048;3944;11458;184;543;3375;9865;3559;10408
280430;201708;2266;5704;2017;5344;86;316;1554;4011;1640;4327
280440;201708;4777;13316;4308;12695;347;1104;3346;9748;3693;10852
280445;201708;2490;6601;2237;6151;61;209;1702;4520;1763;4729
280450;201708;9717;24037;8913;23008;538;1132;7584;20090;8122;21222
280460;201708;6992;17577;6373;16703;744;1961;4775;12622;5519;14583
280470;201708;1879;5450;1662;5073;92;287;1231;3764;1323;4051
280480;201708;34171;93835;31654;90194;3988;12743;21432;59964;25420;72707
280490;201708;3937;11577;3444;10762;203;825;2553;7793;2756;8618
280500;201708;967;2484;843;2315;48;152;681;1857;729;2009
280510;201708;2588;7430;2303;7019;144;552;1657;5005;1801;5557
280520;201708;1778;4677;1600;4448;133;364;1293;3606;1426;3970
280530;201708;2569;6614;2348;6341;146;428;1898;5143;2044;5571
280540;201708;9430;25465;8651;24359;237;1013;7514;20603;7751;21616
280550;201708;7049;17570;5786;15673;413;1106;4204;11298;4617;12404
280560;201708;7553;21753;7114;21126;282;1095;6050;17640;6332;18735
280570;201708;6443;16980;5480;15687;399;1332;3841;10862;4240;12194
280580;201708;5545;16594;4779;15205;725;2240;2918;9563;3643;11803
280590;201708;2737;7326;2391;6899;205;799;1603;4480;1808;5279
280600;201708;3593;10502;3278;10042;274;975;2401;7261;2675;8236
280610;201708;2552;6739;2311;6402;153;501;1787;4850;1940;5351
280620;201708;5521;15184;4814;14056;500;1324;3294;9983;3794;11307
280630;201708;3753;11782;3500;11405;293;969;2715;9048;3008;10017
280640;201708;2288;6751;2150;6601;65;193;1992;6167;2057;6360
280650;201708;1138;3324;994;3105;105;359;690;2126;795;2485
280660;201708;2796;7486;2632;7295;203;535;2207;6175;2410;6710
280670;201708;17643;44027;16010;41855;1624;4528;11593;30177;13217;34705
280680;201708;2937;7597;2509;6916;178;494;1857;5021;2035;5515
280690;201708;1026;2714;895;2531;81;247;650;1812;731;2059
280700;201708;1100;3111;996;2924;40;140;742;2142;782;2282
280710;201708;13434;32499;11852;30654;672;1254;10195;27245;10867;28499
280720;201708;2514;6198;2236;5877;189;547;1524;4246;1713;4793
280730;201708;1075;2871;987;2740;56;202;813;2194;869;2396
280740;201708;13517;35172;11568;32139;1379;3788;7413;20786;8792;24574
280750;201708;3545;10386;3223;9840;227;790;2300;6965;2527;7755
280760;201708;5948;17319;5409;16495;779;2459;3335;10487;4114;12946
290010;201708;2933;6506;2124;5255;39;157;1687;3947;1726;4104
290020;201708;4609;14417;4432;14179;289;892;3781;12156;4070;13048
290030;201708;3421;9777;3190;9471;273;814;2566;7637;2839;8451
290035;201708;4747;11537;4118;10702;199;581;3290;8677;3489;9258
290040;201708;4454;11186;3754;10396;211;731;2900;8077;3111;8808
290050;201708;2392;7708;2087;7168;156;636;1437;4893;1593;5529
290060;201708;1319;3293;1081;2970;126;412;746;1972;872;2384
290070;201708;34558;83496;29722;77301;4243;11265;17371;46546;21614;57811
290080;201708;5993;17555;5085;16290;752;2498;3242;10619;3994;13117
290090;201708;2212;4391;1750;3894;64;113;1577;3542;1641;3655
290100;201708;9367;26266;8266;24533;1203;3481;5024;15428;6227;18909
290110;201708;5087;14463;4775;13917;620;1946;3121;8966;3741;10912
290115;201708;4713;13729;4161;12984;188;580;3443;10941;3631;11521
290120;201708;7071;17760;5829;16283;227;802;4808;13222;5035;14024
290130;201708;4789;12129;3854;10970;154;614;3046;8428;3200;9042
290135;201708;4749;11436;3915;10135;277;810;2848;7122;3125;7932
290140;201708;4652;13246;3869;12225;195;709;3225;10224;3420;10933
290150;201708;2276;6587;2153;6414;216;659;1618;4735;1834;5394
290160;201708;3363;8287;3157;8029;239;555;2591;6572;2830;7127
290170;201708;2730;8481;2545;8238;131;548;2190;6981;2321;7529
290180;201708;3000;8434;2528;7693;144;508;1940;5853;2084;6361
290190;201708;3866;12388;3676;12105;216;933;2864;9314;3080;10247
290195;201708;2262;6015;1892;5427;71;311;1504;4234;1575;4545
290200;201708;4026;11950;3496;11147;241;850;2705;8544;2946;9394
290205;201708;3405;9301;3040;8730;159;615;2327;6475;2486;7090
290210;201708;14770;41250;13175;39143;1471;3834;9607;29923;11078;33757
290220;201708;2534;7015;2389;6812;199;604;1888;5352;2087;5956
290225;201708;3217;7375;2797;6908;63;141;2601;6463;2664;6604
290230;201708;2307;7142;2149;6950;110;435;1779;5757;1889;6192
290240;201708;3651;9813;3222;9214;191;622;2520;7073;2711;7695
290250;201708;3972;12037;3664;11630;159;443;3051;10169;3210;10612
290260;201708;5337;14483;4381;13046;298;1050;3328;9828;3626;10878
290265;201708;3683;10943;3116;9911;159;662;2352;7358;2511;8020
290270;201708;12281;43063;11682;42095;1009;4233;8842;31649;9851;35882
290280;201708;5836;17953;5319;17109;402;1390;3895;12516;4297;13906
290290;201708;10274;30854;8908;28542;959;3152;6126;19737;7085;22889
290300;201708;4675;12890;3373;10461;210;713;2293;7196;2503;7909
290310;201708;1501;4246;1294;3919;164;556;833;2492;997;3048
290320;201708;28259;77734;23821;72089;5245;16723;12085;37738;17330;54461
290323;201708;3859;10525;3434;9988;113;362;2841;8150;2954;8512
290327;201708;4632;13446;3960;12246;390;1197;2694;8347;3084;9544
290330;201708;1977;4591;1776;4380;82;188;1573;3939;1655;4127
290340;201708;5480;15743;4820;14930;977;3154;3004;9428;3981;12582
290350;201708;4701;14210;4128;13258;399;1338;2867;9357;3266;10695
290360;201708;4935;14013;4235;13070;135;506;3559;11050;3694;11556
290370;201708;4785;12736;3975;11598;231;648;3115;9194;3346;9842
290380;201708;5677;16007;4934;14905;225;746;4013;12240;4238;12986
290390;201708;15420;45213;13637;42551;1686;5419;8822;28264;10508;33683
290395;201708;2743;8636;2409;7998;104;465;1813;5995;1917;6460
290400;201708;3806;10720;3125;9658;214;708;2231;6792;2445;7500
290405;201708;4883;14696;4099;13278;329;1146;2704;8852;3033;9998
290410;201708;5979;17049;4811;15150;273;1107;3485;10564;3758;11671
290420;201708;3285;9185;2694;8285;220;706;2003;6156;2223;6862
290430;201708;3229;9631;2783;8823;453;1463;1658;5335;2111;6798
290440;201708;3043;7758;2368;6782;117;388;1726;4971;1843;5359
290450;201708;3307;9324;2776;8530;143;550;2081;6249;2224;6799
290460;201708;12755;36207;11350;33741;3244;10017;4123;12130;7367;22147
290470;201708;4292;11882;3297;10334;620;2103;1535;4968;2155;7071
290475;201708;5999;18428;5246;17050;163;790;4055;12890;4218;13680
290480;201708;2292;6054;2110;5786;203;583;1338;3774;1541;4357
290485;201708;4921;14903;4235;13865;212;1041;3462;11102;3674;12143
290490;201708;8757;21960;8178;21215;632;1790;6573;16936;7205;18726
290500;201708;4080;12590;3260;10872;432;1544;1719;5685;2151;7229
290510;201708;3304;9038;2895;8486;115;425;2421;7039;2536;7464
290515;201708;3752;10102;3117;9285;111;305;2661;8101;2772;8406
290520;201708;11575;34842;9251;30235;524;2123;5893;18946;6417;21069
290530;201708;5238;15210;4592;14174;286;916;3654;11277;3940;12193
290540;201708;3858;10860;3588;10464;168;532;3062;8916;3230;9448
290550;201708;4642;11837;4109;11231;81;251;3766;10349;3847;10600
290560;201708;6696;18413;5716;16991;742;2330;3884;11472;4626;13802
290570;201708;44009;116471;40540;111861;3486;9944;30181;83019;33667;92963
290580;201708;7296;23547;6762;22711;717;2384;4994;17202;5711;19586
290590;201708;7235;22727;6244;20987;217;905;5060;17029;5277;17934
290600;201708;18296;53099;16905;51115;1215;3784;13311;41034;14526;44818
290610;201708;2496;8215;2038;7318;117;542;1394;4912;1511;5454
290620;201708;6416;18778;5824;17819;324;1086;4794;14564;5118;15650
290630;201708;8607;21674;7400;20263;578;1590;6001;16589;6579;18179
290640;201708;2722;7618;2181;6754;123;438;1642;5011;1765;5449
290650;201708;11144;31678;10551;30868;2584;7391;5966;18239;8550;25630
290660;201708;3766;10035;3189;9199;127;360;2324;7021;2451;7381
290670;201708;7176;21026;6325;19624;655;2041;4436;13974;5091;16015
290680;201708;10359;30361;9128;28664;342;1578;7323;22552;7665;24130
290682;201708;4791;13160;4174;12272;158;551;3461;10070;3619;10621
290685;201708;3738;8661;2465;6883;243;667;1550;4444;1793;5111
290687;201708;7239;20546;5772;18103;1070;3389;3003;9769;4073;13158
290689;201708;3116;8806;2710;8197;200;689;1929;5943;2129;6632
290690;201708;5574;15369;4816;14325;708;2054;3076;9234;3784;11288
290700;201708;2523;7299;2348;7054;95;335;1980;5969;2075;6304
290710;201708;8096;24408;7384;23399;363;1267;6204;19708;6567;20975
290720;201708;19264;53974;17747;52075;1167;3422;14464;43044;15631;46466
290730;201708;7344;19258;6497;18148;397;1086;4886;13638;5283;14724
290740;201708;983;2803;768;2417;52;186;571;1793;623;1979
290750;201708;10990;29551;9432;26768;1227;3759;5745;15898;6972;19657
290755;201708;2324;6505;1826;5597;102;368;1253;3778;1355;4146
290760;201708;4163;12364;3340;10782;463;1379;1888;6387;2351;7766
290770;201708;2608;8829;2429;8592;96;450;1956;6954;2052;7404
290780;201708;9160;22719;7851;20853;640;1342;5879;16089;6519;17431
290790;201708;4611;13146;4191;12588;213;592;3545;10733;3758;11325
290800;201708;7290;15288;5669;13473;419;847;4318;10628;4737;11475
290810;201708;5693;16326;4632;14607;181;667;3450;10927;3631;11594
290820;201708;5457;14943;4913;14197;332;1121;3620;10481;3952;11602
290830;201708;4631;11456;4218;10906;170;550;3300;8382;3470;8932
290840;201708;17675;49380;15480;46017;1949;5425;9974;31024;11923;36449
290850;201708;6254;17202;5955;16836;640;1604;4568;13399;5208;15003
290860;201708;5436;17472;5030;16994;317;1168;4080;14092;4397;15260
290870;201708;4881;13797;3885;12139;196;756;2736;8512;2932;9268
290880;201708;1471;3795;1166;3337;92;234;788;2304;880;2538
290890;201708;7556;18164;6480;16960;293;749;5735;15117;6028;15866
290900;201708;2394;6644;1837;5663;134;455;1136;3463;1270;3918
290910;201708;5118;13368;4171;11959;76;331;3487;9885;3563;10216
290920;201708;5197;13339;4791;12818;153;410;4255;11367;4408;11777
290930;201708;8471;24252;7189;22216;270;1186;5622;16921;5892;18107
290940;201708;3685;11072;3221;10404;198;660;2386;7844;2584;8504
290950;201708;1603;4284;1386;3946;108;324;970;2775;1078;3099
290960;201708;5714;15746;5136;15010;198;621;4263;12480;4461;13101
290970;201708;3821;11322;3246;10373;229;709;2281;7364;2510;8073
290980;201708;10903;29879;9273;26871;1946;5886;3731;10758;5677;16644
290990;201708;9169;26404;7896;24269;544;1932;5990;18054;6534;19986
291000;201708;3134;8988;2811;8590;293;829;2195;6830;2488;7659
291005;201708;15287;37950;13479;35706;1002;2696;10441;27929;11443;30625
291010;201708;3338;10076;2611;8577;206;699;1653;5417;1859;6116
291020;201708;1309;3426;1058;2972;68;209;661;1755;729;1964
291030;201708;2369;6244;1704;4934;111;334;1054;2964;1165;3298
291040;201708;5665;16370;4953;15317;289;1139;3847;11823;4136;12962
291050;201708;7984;24929;7261;23656;1374;4945;4228;13514;5602;18459
291060;201708;6076;21530;5672;20865;730;3124;3713;13429;4443;16553
291070;201708;16361;45712;14137;42372;732;2621;10973;32636;11705;35257
291072;201708;24249;69005;19176;58918;4311;14140;6661;20640;10972;34780
291075;201708;5160;14185;4543;13196;300;795;3431;9977;3731;10772
291077;201708;1566;4303;1286;3827;62;182;925;2768;987;2950
291080;201708;81120;244428;71192;226790;25274;82049;11531;38224;36805;120273
291085;201708;5829;15013;4947;13808;270;835;4087;11401;4357;12236
291090;201708;1774;3837;1534;3566;141;197;1242;3004;1383;3201
291100;201708;2803;6781;2120;5953;121;436;1617;4438;1738;4874
291110;201708;5494;18079;4837;17016;567;2171;3419;11788;3986;13959
291120;201708;7664;19914;6979;18917;554;1588;5259;14230;5813;15818
291125;201708;2002;3856;1545;3360;70;169;1237;2695;1307;2864
291130;201708;2935;8877;2402;7898;85;396;1795;5728;1880;6124
291140;201708;4303;12459;3579;11068;516;1462;2177;6861;2693;8323
291150;201708;2193;5224;1953;4949;56;168;1661;4155;1717;4323
291160;201708;5100;15759;4506;14733;551;1992;2767;8882;3318;10874
291165;201708;2504;6878;1934;5832;36;153;1363;3987;1399;4140
291170;201708;21483;55769;18363;50962;1360;4177;11443;31671;12803;35848
291180;201708;6193;15956;5063;14180;408;1210;3587;10020;3995;11230
291185;201708;3530;9653;3083;8884;128;394;2490;7084;2618;7478
291190;201708;7600;19741;6555;18266;502;1521;5094;14158;5596;15679
291200;201708;3022;8718;2323;7397;102;334;1495;4762;1597;5096
291210;201708;6737;16142;5727;14915;279;935;4276;10966;4555;11901
291220;201708;4329;12884;3924;12229;440;1556;2634;8080;3074;9636
291230;201708;4085;9926;3637;9430;99;183;3385;8899;3484;9082
291240;201708;4565;12053;3959;10998;118;384;3297;9007;3415;9391
291250;201708;3490;10499;2794;9209;205;668;1867;6227;2072;6895
291260;201708;1157;3116;1016;2930;52;230;854;2366;906;2596
291270;201708;4835;14596;4221;13464;902;2991;2341;7578;3243;10569
291280;201708;2294;6389;1805;5537;264;860;994;3016;1258;3876
291290;201708;5827;15921;4976;14761;679;2042;3130;9470;3809;11512
291300;201708;4155;11708;3180;10014;160;550;2250;7021;2410;7571
291310;201708;5480;15248;4682;13805;225;755;3626;10583;3851;11338
291320;201708;6253;18750;4946;16172;1193;3815;2223;7552;3416;11367
291330;201708;1667;4739;1441;4350;95;311;1014;3020;1109;3331
291340;201708;4058;10916;3403;9958;110;400;2731;7918;2841;8318
291345;201708;3292;10269;3059;9968;191;671;2430;8006;2621;8677
291350;201708;5919;16851;5140;15560;256;768;4064;12520;4320;13288
291360;201708;34317;89654;29035;82501;5909;17168;14998;44052;20907;61220
291370;201708;8238;23110;7741;22467;552;1796;5825;16816;6377;18612
291380;201708;3679;10746;3181;9962;154;601;2405;7471;2559;8072
291390;201708;10909;27972;10056;26932;726;2100;8044;21545;8770;23645
291400;201708;14695;38994;12586;35852;2047;5387;7755;23316;9802;28703
291410;201708;3107;8212;2403;7038;101;442;1767;4963;1868;5405
291420;201708;2038;5279;1716;4879;61;225;1448;4085;1509;4310
291430;201708;3278;9169;2855;8552;125;593;2292;6617;2417;7210
291440;201708;6551;19322;5707;17876;479;1540;4342;13741;4821;15281
291450;201708;8595;23667;7382;22080;242;641;6006;18688;6248;19329
291460;201708;13490;39656;12106;37570;1359;4520;8035;25239;9394;29759
291465;201708;8086;22438;6988;21103;389;1614;5610;16607;5999;18221
291470;201708;15909;40905;13965;38622;807;2203;10484;29850;11291;32053
291480;201708;37100;89035;30029;79583;4081;11736;16531;44127;20612;55863
291490;201708;4494;13568;4197;13158;436;1417;3188;10082;3624;11499
291500;201708;4520;12220;3792;11157;132;527;3191;9334;3323;9861
291510;201708;3808;10906;3374;10275;98;428;2786;8492;2884;8920
291520;201708;3990;10400;3406;9599;271;805;2400;6796;2671;7601
291530;201708;2197;5704;1710;4985;350;946;927;2982;1277;3928
291535;201708;3536;10700;3243;10222;251;800;2365;7573;2616;8373
291540;201708;2161;5159;1734;4674;117;331;1472;3926;1589;4257
291550;201708;5233;13368;4512;12356;676;1744;2754;7733;3430;9477
291560;201708;19179;44275;13544;37619;1003;2707;9180;26920;10183;29627
291570;201708;2220;5561;1968;5260;135;260;1618;4489;1753;4749
291580;201708;5703;16461;4926;15371;506;1811;3383;10499;3889;12310
291590;201708;1802;5461;1630;5188;157;557;1229;3940;1386;4497
291600;201708;5354;14202;4068;12150;814;2523;1999;5883;2813;8406
291610;201708;4934;14979;4761;14784;124;468;4376;13632;4500;14100
291620;201708;3164;7219;2300;6279;151;456;1736;4829;1887;5285
291630;201708;3258;7654;2591;6826;160;435;2036;5381;2196;5816
291640;201708;16648;44400;13131;38989;3080;9518;4024;12779;7104;22297
291650;201708;8633;24101;7849;23129;541;1347;6521;19579;7062;20926
291660;201708;2313;5722;1721;4799;145;525;1082;2807;1227;3332
291670;201708;1945;5289;1746;5004;144;379;1327;3874;1471;4253
291680;201708;3993;11136;3458;10231;467;1468;2282;6747;2749;8215
291685;201708;5013;12232;4058;10983;477;1145;2752;7779;3229;8924
291690;201708;3864;9955;3069;8658;151;430;2303;6424;2454;6854
291700;201708;9215;27644;8153;25747;764;2408;6053;19251;6817;21659
291710;201708;5269;13450;4200;11991;496;1491;2715;7613;3211;9104
291720;201708;4710;14742;3889;13032;313;1195;2621;8567;2934;9762
291730;201708;6383;18022;5727;17132;404;1384;4496;13509;4900;14893
291733;201708;2892;7796;2393;7094;136;432;1687;5163;1823;5595
291735;201708;3052;8114;2556;7391;106;366;2085;5960;2191;6326
291740;201708;3908;10521;3229;9560;161;526;2534;7468;2695;7994
291750;201708;21664;54707;17169;47834;2805;8065;9343;26570;12148;34635
291760;201708;10662;33275;9192;30658;3336;12416;2079;6990;5415;19406
291770;201708;7609;21493;6360;19243;727;2419;4159;12281;4886;14700
291780;201708;4658;13397;4241;12708;188;609;3536;10562;3724;11171
291790;201708;2705;7959;2544;7724;189;579;2000;6070;2189;6649
291800;201708;30502;81153;26216;75190;3494;10191;16298;47758;19792;57949
291810;201708;10947;28109;9205;25962;331;1120;7588;21262;7919;22382
291820;201708;3824;10835;3396;10205;174;595;2586;7784;2760;8379
291830;201708;4221;10839;3871;10327;347;939;2982;8032;3329;8971
291835;201708;6367;19570;5189;17361;1007;3444;2796;9661;3803;13105
291840;201708;48815;134844;42535;127327;5720;17208;28632;88435;34352;105643
291845;201708;2559;7393;2350;7100;148;427;1940;5934;2088;6361
291850;201708;4443;12668;3660;11393;364;1022;2572;8299;2936;9321
291855;201708;1949;4441;1657;4076;110;318;1312;3175;1422;3493
291860;201708;2281;6179;1698;5032;49;175;1138;3231;1187;3406
291870;201708;1397;3663;965;2844;68;244;596;1671;664;1915
291875;201708;2907;8798;2567;8251;140;538;1824;5731;1964;6269
291880;201708;5125;15847;4681;14960;490;1580;3324;10633;3814;12213
291890;201708;1360;3273;1040;2866;230;511;644;1881;874;2392
291900;201708;1279;3322;979;2815;37;154;739;2068;776;2222
291905;201708;2825;7355;2138;6141;92;297;1545;4330;1637;4627
291910;201708;2907;7548;2466;7027;106;356;2070;5927;2176;6283
291915;201708;7099;21322;5950;19282;333;1244;4464;14541;4797;15785
291920;201708;25490;74023;23336;71000;3067;10296;15050;45235;18117;55531
291930;201708;2563;7476;2251;6953;203;767;1573;4701;1776;5468
291940;201708;3396;9390;2483;7798;265;869;1476;4501;1741;5370
291950;201708;8905;28503;7856;26462;1219;4102;4408;15316;5627;19418
291955;201708;12119;33568;11192;32422;2171;6064;7025;21405;9196;27469
291960;201708;3158;8858;2562;7949;154;512;1913;6074;2067;6586
291970;201708;4028;11859;3687;11290;314;1158;2543;7706;2857;8864
291980;201708;11728;32722;9084;28898;689;2232;6098;19700;6787;21932
291990;201708;2132;6243;1968;6042;70;267;1743;5387;1813;5654
291992;201708;3837;9949;3006;8823;372;1063;2246;6655;2618;7718
291995;201708;2177;6021;1796;5473;86;335;1425;4266;1511;4601
292000;201708;2447;6615;2146;6157;204;661;1432;4106;1636;4767
292010;201708;6310;15264;5181;13681;338;908;4045;10699;4383;11607
292020;201708;4260;13489;3907;12871;401;1413;2922;9559;3323;10972
292030;201708;1829;5811;1702;5611;156;586;1000;3208;1156;3794
292040;201708;4441;11639;3763;10857;288;719;3002;9047;3290;9766
292045;201708;3623;10512;3148;9843;93;240;2841;8981;2934;9221
292050;201708;6513;19295;5414;17112;460;1560;3351;10506;3811;12066
292060;201708;12990;31112;11896;29769;793;1996;9862;24337;10655;26333
292070;201708;5301;15087;4819;14520;333;1011;4052;12294;4385;13305
292080;201708;3460;8829;2807;7999;168;554;2352;6701;2520;7255
292090;201708;4140;10033;3403;9169;228;719;2731;7430;2959;8149
292100;201708;10755;28641;9368;26674;1900;5598;4684;13732;6584;19330
292105;201708;3099;9112;2768;8564;108;441;2247;6916;2355;7357
292110;201708;6511;16994;4951;14462;1252;3641;2183;6510;3435;10151
292120;201708;7164;19723;5892;17397;831;2427;3562;10646;4393;13073
292130;201708;3020;8144;2591;7549;294;866;1792;5308;2086;6174
292140;201708;4966;12751;4118;11505;360;949;3084;8708;3444;9657
292145;201708;2273;6906;1972;6373;175;554;1321;4369;1496;4923
292150;201708;13407;38733;12224;36947;431;1609;10076;30340;10507;31949
292160;201708;2425;6895;2176;6561;85;321;1918;5746;2003;6067
292170;201708;8762;24488;7293;21967;742;2348;4768;14410;5510;16758
292180;201708;3125;8685;2368;7397;471;1409;1164;3721;1635;5130
292190;201708;3233;8974;2745;8203;434;1387;1517;4590;1951;5977
292200;201708;7090;20653;5978;18779;1363;4410;2679;8640;4042;13050
292205;201708;3890;11276;3461;10643;128;595;2901;8712;3029;9307
292210;201708;6455;16285;5384;14856;174;605;4607;12562;4781;13167
292220;201708;1893;5064;1690;4755;251;674;1074;3026;1325;3700
292225;201708;3298;9955;2968;9448;114;497;2415;7584;2529;8081
292230;201708;7253;19383;6771;18667;237;980;5557;14845;5794;15825
292240;201708;4930;14725;4327;13484;364;1155;2896;9021;3260;10176
292250;201708;5383;15565;4992;14919;776;2306;3040;9220;3816;11526
292260;201708;3308;9248;3025;8869;208;582;2492;7426;2700;8008
292265;201708;3263;9570;2782;8752;102;470;2152;6594;2254;7064
292270;201708;4089;10171;3396;9329;265;791;2717;7491;2982;8282
292273;201708;2566;5956;2160;5446;124;229;1674;4389;1798;4618
292275;201708;1785;5083;1524;4703;99;239;1203;3896;1302;4135
292280;201708;2436;6302;2040;5835;101;253;1635;4878;1736;5131
292285;201708;2504;6599;2050;5936;137;452;1543;4452;1680;4904
292290;201708;6579;19745;5757;18494;299;1202;4507;14382;4806;15584
292300;201708;9038;25670;7703;23924;1510;4853;4445;14161;5955;19014
292303;201708;2923;8631;2610;8164;88;325;2211;6867;2299;7192
292305;201708;2849;7591;2662;7317;59;241;2381;6451;2440;6692
292310;201708;6358;17794;5802;17016;286;857;4724;13847;5010;14704
292320;201708;6862;18425;5669;16363;367;1161;4265;12089;4632;13250
292330;201708;2378;5919;2167;5647;141;367;1768;4585;1909;4952
292335;201708;5255;13442;4686;12669;345;856;3769;10351;4114;11207
292340;201708;6735;17994;5680;16289;320;928;4220;12026;4540;12954
292350;201708;2318;6655;1980;6181;93;353;1618;5055;1711;5408
292360;201708;5343;13835;4821;12972;397;1213;3501;9413;3898;10626
292370;201708;9291;23988;8099;22438;358;970;6939;19195;7297;20165
292380;201708;7357;21077;6674;19959;584;1696;4938;14851;5522;16547
292390;201708;4043;8394;3084;7359;143;252;2704;6568;2847;6820
292400;201708;21218;64182;19316;60990;2675;8708;12522;39648;15197;48356
292405;201708;4639;11331;3792;10216;216;526;3041;8262;3257;8788
292410;201708;2088;5378;1865;5112;98;264;1567;4317;1665;4581
292420;201708;3814;11877;3580;11516;217;942;2932;9314;3149;10256
292430;201708;5503;15841;4105;13830;357;1308;2611;8875;2968;10183
292440;201708;8687;27816;8043;26895;163;737;7301;24538;7464;25275
292450;201708;4058;11955;3276;10572;214;756;2404;7811;2618;8567
292460;201708;4744;13909;4081;12733;388;1240;2894;9041;3282;10281
292465;201708;2475;7045;2067;6399;129;412;1424;4516;1553;4928
292467;201708;1794;5570;1712;5445;241;752;1184;3873;1425;4625
292470;201708;3027;7761;2452;6844;95;278;1905;5295;2000;5573
292480;201708;6510;16216;5380;14777;125;450;4715;12784;4840;13234
292490;201708;2416;6384;1968;5737;139;413;1456;4267;1595;4680
292500;201708;6564;18864;5584;17114;640;1946;3650;11334;4290;13280
292510;201708;12841;36178;10837;33114;743;2861;7878;23991;8621;26852
292520;201708;6571;17379;5718;16091;1007;2831;3493;10023;4500;12854
292525;201708;5478;13972;4647;13005;210;565;3945;11146;4155;11711
292530;201708;27910;78115;24287;72749;5953;18113;10719;33366;16672;51479
292540;201708;3285;8046;2826;7514;271;674;2253;6090;2524;6764
292550;201708;6970;20602;5874;19191;484;1795;4498;14980;4982;16775
292560;201708;4178;11359;3669;10578;156;626;2909;8263;3065;8889
292570;201708;4316;11578;3804;10920;91;306;3460;9971;3551;10277
292575;201708;6670;20803;6385;20397;310;1048;5382;17253;5692;18301
292580;201708;7126;19861;6405;18804;293;959;5423;15879;5716;16838
292590;201708;7733;21187;7061;20231;335;1120;5945;16671;6280;17791
292593;201708;3019;7591;2555;6856;204;525;1935;5143;2139;5668
292595;201708;5835;15711;5138;14806;278;921;4096;11712;4374;12633
292600;201708;11137;30952;9846;29193;712;1864;7422;22396;8134;24260
292610;201708;4860;12846;3973;11393;227;616;2626;7756;2853;8372
292620;201708;6441;18474;5612;17540;121;349;5202;16498;5323;16847
292630;201708;9150;23054;7564;20541;538;1521;5270;14371;5808;15892
292640;201708;7949;24786;7287;23701;319;1241;5392;17591;5711;18832
292650;201708;4607;12160;4241;11678;260;721;3625;9932;3885;10653
292660;201708;11248;32359;10068;30606;768;2519;7664;23385;8432;25904
292665;201708;2294;7060;2129;6849;31;127;1901;6166;1932;6293
292670;201708;3698;10261;2877;8761;177;643;1877;5621;2054;6264
292680;201708;3863;10834;3331;9883;272;812;2399;6999;2671;7811
292690;201708;2776;7473;1996;6200;169;504;1284;4138;1453;4642
292700;201708;9861;27734;8509;25799;1058;3031;5537;17534;6595;20565
292710;201708;2280;7409;2125;7204;63;248;1905;6480;1968;6728
292720;201708;9629;23525;8245;22002;303;978;6938;18675;7241;19653
292730;201708;3836;10747;3673;10518;146;440;3116;8902;3262;9342
292740;201708;343248;896952;319195;859695;57331;162228;185216;492327;242547;654555
292750;201708;6646;17717;5654;16259;272;837;4324;12495;4596;13332
292760;201708;3974;11899;3585;11206;310;1039;2557;7950;2867;8989
292770;201708;6204;17601;5356;16335;961;3064;3080;9702;4041;12766
292780;201708;1860;4188;1440;3660;81;246;1084;2676;1165;2922
292790;201708;3733;8417;3359;8003;50;123;3203;7638;3253;7761
292800;201708;9771;27191;8862;25699;488;1501;7040;20279;7528;21780
292805;201708;3103;8329;2660;7693;287;781;1912;5600;2199;6381
292810;201708;9915;28069;8004;25242;553;1905;5725;18180;6278;20085
292820;201708;7784;21293;5713;18269;446;1713;4165;13154;4611;14867
292830;201708;2401;6016;2123;5667;59;242;1927;5062;1986;5304
292840;201708;8449;24201;7860;23404;229;1026;6889;19985;7118;21011
292850;201708;3109;8139;2480;7166;211;724;1598;4472;1809;5196
292860;201708;15930;39250;14467;37357;1108;2809;11211;29029;12319;31838
292870;201708;19016;50827;16617;47088;1476;4800;10306;28669;11782;33469
292880;201708;12265;34303;10960;32472;637;2483;8021;22920;8658;25403
292890;201708;5700;18124;5107;17109;525;1899;3624;12130;4149;14029
292895;201708;2984;6881;2190;5683;141;368;1573;4085;1714;4453
292900;201708;2799;8271;2638;8002;129;592;2026;5872;2155;6464
292905;201708;4297;12106;3422;10737;280;852;2303;7358;2583;8210
292910;201708;5090;14651;4606;13786;471;1533;2997;8932;3468;10465
292920;201708;10008;28185;9530;27556;408;1548;8175;23150;8583;24698
292925;201708;5211;15261;4702;14462;278;866;3624;11114;3902;11980
292930;201708;6620;20615;6097;19612;437;1894;4105;12808;4542;14702
292935;201708;2053;5934;1697;5536;71;304;1441;4801;1512;5105
292937;201708;3173;7962;2750;7442;101;294;2315;6279;2416;6573
292940;201708;3221;8588;2641;7731;193;567;1930;5774;2123;6341
292950;201708;9071;25162;8274;23862;448;1552;6187;17476;6635;19028
292960;201708;5534;13529;4711;12438;202;640;3647;9466;3849;10106
292970;201708;4309;12409;3767;11683;146;626;3074;9514;3220;10140
292975;201708;4086;9677;3691;9215;219;489;3243;8142;3462;8631
292980;201708;3277;8438;2601;7404;158;486;1940;5443;2098;5929
292990;201708;11988;33134;10203;30361;482;1639;8018;23845;8500;25484
293000;201708;2898;7105;2617;6766;31;100;1983;5453;2014;5553
293010;201708;18092;48900;15220;44229;2127;6426;9116;26486;11243;32912
293015;201708;7528;24798;6346;22493;683;2805;4126;14534;4809;17339
293020;201708;9142;29310;8617;28580;256;1148;7568;24913;7824;26061
293030;201708;5654;15748;4458;13833;208;664;2992;9625;3200;10289
293040;201708;3855;11878;3620;11497;159;595;3110;9805;3269;10400
293050;201708;21565;56419;19025;53040;2428;6972;11657;33482;14085;40454
293060;201708;3635;9619;2997;8568;225;725;2149;6039;2374;6764
293070;201708;25233;65773;20729;59486;4461;12720;9956;30220;14417;42940
293075;201708;3334;11051;3076;10621;209;920;2393;8261;2602;9181
293076;201708;3721;9849;3280;9263;135;366;2620;7532;2755;7898
293077;201708;5332;15691;4558;14612;634;2074;2877;9514;3511;11588
293080;201708;4782;14515;4264;13677;171;728;3468;10932;3639;11660
293090;201708;3172;9880;2600;8943;226;847;1750;6098;1976;6945
293100;201708;5975;16875;4922;14998;418;1289;3589;11013;4007;12302
293105;201708;3949;12695;3436;11709;351;1256;2293;7814;2644;9070
293110;201708;2174;5756;1883;5354;78;237;1520;4299;1598;4536
293120;201708;3953;12061;3739;11726;186;596;3083;9696;3269;10292
293130;201708;3798;10953;3434;10509;118;455;2960;9068;3078;9523
293135;201708;32160;79541;24352;68361;4966;15631;9465;26933;14431;42564
293140;201708;2070;5406;1933;5224;97;306;1590;4180;1687;4486
293150;201708;5620;17761;4716;16003;577;2016;3017;10345;3594;12361
293160;201708;3878;9709;3454;9203;383;699;2696;7698;3079;8397
293170;201708;3688;9930;3271;9355;185;626;2447;7012;2632;7638
293180;201708;5151;14121;4177;12505;155;643;3257;9466;3412;10109
293190;201708;14159;40754;12672;38516;476;2135;10557;31557;11033;33692
293200;201708;7815;20319;6700;18861;236;851;5099;14404;5335;15255
293210;201708;5301;14560;4589;13403;277;876;3447;10004;3724;10880
293220;201708;5117;14509;4171;12805;1042;3183;1552;4991;2594;8174
293230;201708;3687;10902;3240;10171;452;1510;2112;6657;2564;8167
293240;201708;4365;11990;3524;10559;121;389;2653;8029;2774;8418
293245;201708;4325;11769;3838;11097;196;649;3128;8985;3324;9634
293250;201708;5682;14811;5066;13871;443;1244;3719;10124;4162;11368
293260;201708;4621;13204;3801;11942;189;656;2672;8291;2861;8947
293270;201708;6066;15371;5333;14562;406;983;4448;12471;4854;13454
293280;201708;5291;14268;4437;13111;238;712;3340;9923;3578;10635
293290;201708;14209;45906;13132;43909;3305;11173;5727;20155;9032;31328
293300;201708;6782;15924;5736;14647;383;883;4222;11000;4605;11883
293305;201708;4806;11813;4043;10804;120;401;3366;8955;3486;9356
293310;201708;2375;6156;1894;5324;155;452;1293;3578;1448;4030
293315;201708;4339;10703;3609;9602;219;520;2835;7551;3054;8071
293317;201708;2469;6749;2217;6299;169;467;1572;4496;1741;4963
293320;201708;8026;24806;7708;24405;1014;3200;5887;18955;6901;22155
293325;201708;1758;4884;1458;4391;241;772;883;2628;1124;3400
293330;201708;48889;157079;44184;148434;10018;35256;19681;67024;29699;102280
293340;201708;2583;7318;2074;6427;216;737;1260;3865;1476;4602
293345;201708;3292;9529;2882;9002;290;689;2078;6955;2368;7644
293350;201708;6632;19221;6215;18737;145;347;5698;17616;5843;17963
293360;201708;14146;39988;12714;38221;671;2196;11059;33277;11730;35473
310010;201708;803;2171;661;1958;82;308;299;823;381;1131
310020;201708;2531;7876;2132;7127;528;1951;283;905;811;2856
310030;201708;2199;6684;1820;6031;324;1229;1034;3333;1358;4562
310040;201708;1006;2617;817;2344;69;252;607;1667;676;1919
310050;201708;1790;5991;1663;5725;319;1254;746;2441;1065;3695
310060;201708;3398;9903;2941;9308;198;810;2339;7340;2537;8150
310070;201708;368;981;271;803;10;41;175;488;185;529
310080;201708;782;2225;587;1873;81;312;240;728;321;1040
310090;201708;4802;13669;4071;12436;518;1700;2671;8140;3189;9840
310100;201708;3589;10461;2995;9493;158;622;2279;7155;2437;7777
310110;201708;5081;14011;4200;12451;703;2382;2085;5905;2788;8287
310120;201708;661;1917;495;1609;108;425;189;499;297;924
310130;201708;379;1130;332;1043;65;250;178;493;243;743
310140;201708;175;584;148;541;47;203;45;137;92;340
310150;201708;4698;14017;3948;12545;929;3169;1261;3922;2190;7091
310160;201708;6963;21571;5794;19322;1758;6328;1020;3380;2778;9708
310163;201708;1101;3466;928;3120;310;1126;235;746;545;1872
310170;201708;9286;25053;8070;23326;911;2766;5577;16204;6488;18970
310180;201708;1774;4892;1483;4453;180;658;913;2630;1093;3288
310190;201708;2965;9456;2579;8746;689;2552;310;1003;999;3555
310200;201708;1748;5600;1440;4932;283;1051;519;1718;802;2769
310205;201708;1154;3253;876;2830;120;369;489;1637;609;2006
310210;201708;2842;7757;2397;7111;160;518;1726;5065;1886;5583
310220;201708;1056;3057;901;2802;132;474;562;1669;694;2143
310230;201708;2521;7489;2114;6600;288;1081;1187;3475;1475;4556
310240;201708;913;3241;836;3089;106;478;514;1851;620;2329
310250;201708;897;2790;813;2634;141;560;461;1387;602;1947
310260;201708;3071;9541;2257;7884;527;2078;332;952;859;3030
310270;201708;2687;7190;2150;6443;157;609;1651;4844;1808;5453
310280;201708;2335;5900;1850;5173;185;675;1145;3068;1330;3743
310285;201708;2002;6916;1845;6659;203;814;1236;4576;1439;5390
310290;201708;1132;3292;1048;3147;237;840;554;1491;791;2331
310300;201708;1664;5443;1571;5277;349;1345;761;2410;1110;3755
310310;201708;333;881;234;702;40;115;117;355;157;470
310320;201708;427;1234;321;1044;33;135;161;476;194;611
310330;201708;535;1315;344;954;45;132;129;312;174;444
310340;201708;8327;23966;6758;21241;1376;4276;3058;10064;4434;14340
310350;201708;14080;36385;9855;29365;2561;8285;2361;6879;4922;15164
310360;201708;464;1266;413;1197;20;71;321;912;341;983
310370;201708;1403;4593;1212;4214;260;944;496;1729;756;2673
310375;201708;1247;3359;828;2627;122;425;277;869;399;1294
310380;201708;373;949;212;649;52;166;72;197;124;363
310390;201708;461;1533;393;1396;101;377;84;248;185;625
310400;201708;9969;27058;7530;22965;1638;5480;2563;7652;4201;13132
310410;201708;761;2416;538;2020;136;558;93;332;229;890
310420;201708;4613;12762;3121;9696;623;2151;529;1414;1152;3565
310430;201708;1286;4050;929;3309;237;900;133;438;370;1338
310440;201708;555;1559;412;1274;60;225;196;582;256;807
310445;201708;1332;4096;1037;3546;66;256;711;2409;777;2665
310450;201708;4642;12440;3623;10899;313;1000;2601;7882;2914;8882
310460;201708;1796;5084;1345;4272;315;1110;348;1098;663;2208
310470;201708;4200;9286;3479;8385;299;887;2817;6668;3116;7555
310480;201708;1279;3595;941;2945;187;618;427;1278;614;1896
310490;201708;3040;9411;2542;8444;501;1942;1033;3273;1534;5215
310500;201708;1344;4363;1137;3932;271;1018;436;1462;707;2480
310510;201708;1990;6140;1535;5173;387;1427;306;1014;693;2441
310520;201708;1421;3578;1055;3012;81;221;697;1990;778;2211
310530;201708;946;2756;501;1665;78;288;59;157;137;445
310540;201708;3140;9640;2683;8818;710;2479;1002;3140;1712;5619
310550;201708;1193;3248;936;2839;145;551;569;1612;714;2163
310560;201708;14765;43552;12312;39082;3080;10845;3806;11261;6886;22106
310570;201708;1204;3483;1015;3156;137;537;672;1990;809;2527
310590;201708;4408;12541;3674;11233;500;1696;1964;5868;2464;7564
310600;201708;1498;4713;1259;4181;224;804;540;1675;764;2479
310610;201708;527;1583;396;1346;79;339;155;471;234;810
310620;201708;150525;443689;126764;398177;30216;106122;42225;118763;72441;224885
310630;201708;4548;13198;4003;12230;369;1270;2836;8549;3205;9819
310640;201708;1262;3835;1025;3413;275;1026;285;900;560;1926
310650;201708;2721;8176;2065;6996;265;957;1107;3700;1372;4657
310660;201708;1374;3972;1196;3745;97;324;902;2809;999;3133
310665;201708;1326;3799;1157;3555;78;274;895;2779;973;3053
310670;201708;42405;125681;37226;115303;7994;26476;16129;48244;24123;74720
310680;201708;690;1855;606;1734;62;202;435;1210;497;1412
310690;201708;1464;4487;1180;3991;178;718;564;1812;742;2530
310700;201708;562;1329;430;1163;60;195;267;694;327;889
310710;201708;6320;19843;4764;17420;1039;4448;519;1762;1558;6210
310720;201708;840;2402;753;2275;68;245;536;1598;604;1843
310730;201708;9386;28004;8316;26215;1076;3832;4991;15461;6067;19293
310740;201708;5253;16122;3994;13512;842;3035;897;2932;1739;5967
310750;201708;1497;3683;1094;3133;210;657;425;1115;635;1772
310760;201708;586;1713;472;1513;66;238;201;653;267;891
310770;201708;1024;3070;739;2609;106;428;358;1205;464;1633
310780;201708;3983;10534;3254;9319;303;894;2182;6184;2485;7078
310790;201708;1968;6280;1796;5960;388;1298;804;2801;1192;4099
310800;201708;2661;8395;2030;7109;551;2243;139;447;690;2690
310810;201708;1175;3233;1012;2919;123;397;591;1622;714;2019
310820;201708;1268;3568;875;2797;201;710;230;710;431;1420
310825;201708;2962;10014;2396;9046;114;655;1816;6751;1930;7406
310830;201708;1409;4436;1147;3942;280;1029;389;1300;669;2329
310840;201708;2202;6393;1593;5275;309;1084;379;1176;688;2260
310850;201708;1568;4470;1348;4190;110;448;990;3005;1100;3453
310855;201708;3108;9138;2623;8439;332;1209;1785;5682;2117;6891
310860;201708;7313;21921;6075;19566;623;2168;3619;11729;4242;13897
310870;201708;1109;2837;845;2416;182;549;464;1325;646;1874
310880;201708;1023;3120;831;2743;105;397;478;1559;583;1956
310890;201708;2600;7571;1941;6459;491;1837;333;956;824;2793
310900;201708;4377;13344;3435;11450;690;2583;1359;4201;2049;6784
310910;201708;1918;5345;1211;3958;173;635;125;327;298;962
310920;201708;1910;5409;1504;4746;275;967;740;2295;1015;3262
310925;201708;978;3041;862;2839;202;738;463;1470;665;2208
310930;201708;6143;16795;4745;14667;787;2582;2521;7992;3308;10574
310940;201708;6275;16934;5165;15241;628;1996;3206;9346;3834;11342
310945;201708;1220;3528;1105;3348;93;333;733;2139;826;2472
310950;201708;2139;6524;1537;5238;337;1326;497;1560;834;2886
310960;201708;522;1468;395;1232;79;282;137;437;216;719
310970;201708;1251;3987;936;3315;219;833;210;681;429;1514
310980;201708;411;976;258;711;35;112;144;375;179;487
310990;201708;1220;3768;963;3214;216;762;325;1048;541;1810
311000;201708;3623;11781;3265;11095;943;3504;1172;3770;2115;7274
311010;201708;771;2500;675;2268;243;884;224;737;467;1621
311020;201708;984;2796;749;2365;108;410;351;1042;459;1452
311030;201708;1735;4686;1201;3724;323;1157;345;963;668;2120
311040;201708;439;1436;361;1250;88;312;72;223;160;535
311050;201708;2421;7097;2051;6495;507;1781;772;2376;1279;4157
311060;201708;2696;7748;1962;6173;308;1107;656;1871;964;2978
311070;201708;1487;4717;1249;4273;239;952;545;1771;784;2723
311080;201708;856;2473;718;2217;138;482;324;924;462;1406
311090;201708;1926;6616;1584;5992;425;1837;513;1869;938;3706
311100;201708;2063;6585;1534;5489;445;1762;195;644;640;2406
311110;201708;3577;8333;2504;6795;548;1566;1048;2873;1596;4439
311115;201708;1254;3577;1059;3283;89;344;759;2314;848;2658
311120;201708;7530;20854;5732;17586;1127;3852;1654;4565;2781;8417
311130;201708;2091;6222;1725;5647;260;1047;757;2337;1017;3384
311140;201708;1390;3556;1053;3085;80;263;678;2007;758;2270
311150;201708;1668;5722;1510;5421;248;972;888;3162;1136;4134
311160;201708;3955;12756;3105;11157;1023;4011;664;2329;1687;6340
311170;201708;815;2382;644;2073;56;209;336;1096;392;1305
311180;201708;1194;3334;909;2825;284;936;252;774;536;1710
311190;201708;1124;3165;862;2673;156;561;277;796;433;1357
311200;201708;1851;5498;1432;4635;404;1419;251;746;655;2165
311205;201708;996;3227;845;2927;92;399;428;1468;520;1867
311210;201708;1022;3131;919;2996;142;427;639;2157;781;2584
311220;201708;842;2587;692;2271;153;556;250;767;403;1323
311230;201708;8433;26375;6498;22279;1360;4932;1950;6958;3310;11890
311240;201708;1011;2969;794;2631;186;685;343;1101;529;1786
311250;201708;801;2530;705;2367;193;700;265;835;458;1535
311260;201708;2203;5851;1698;5014;377;1229;599;1690;976;2919
311265;201708;1250;3440;976;2984;104;358;603;1819;707;2177
311270;201708;3419;10530;3009;9951;273;1234;2061;6494;2334;7728
311280;201708;1209;3384;703;2243;127;463;155;465;282;928
311290;201708;2018;6516;1887;6212;256;824;1215;4050;1471;4874
311300;201708;4548;14146;4028;13245;297;1338;3023;9712;3320;11050
311310;201708;633;1986;543;1813;113;385;161;497;274;882
311320;201708;3520;11454;3164;10660;538;2095;1243;3859;1781;5954
311330;201708;4622;13338;4007;12275;702;2362;2015;6192;2717;8554
311340;201708;11836;36472;10011;32947;2993;10433;2449;8183;5442;18616
311350;201708;2324;6306;1777;5279;238;817;860;2339;1098;3156
311360;201708;928;2705;800;2530;391;1298;106;346;497;1644
311370;201708;4051;11532;3310;10228;401;1531;1698;4888;2099;6419
311380;201708;458;1463;370;1285;112;397;105;384;217;781
311390;201708;1814;6259;1599;5939;675;2852;419;1390;1094;4242
311400;201708;1490;4543;1164;3890;204;794;445;1315;649;2109
311410;201708;1715;5800;1559;5596;383;1544;727;2602;1110;4146
311420;201708;1907;6099;1296;4664;222;873;136;383;358;1256
311430;201708;3693;10724;2533;8284;438;1551;476;1509;914;3060
311440;201708;2493;7810;1831;6565;543;2174;352;1279;895;3453
311450;201708;2010;6640;1582;5778;403;1624;281;899;684;2523
311455;201708;1079;2837;837;2427;231;697;294;825;525;1522
311460;201708;602;1907;441;1596;91;402;106;346;197;748
311470;201708;461;1535;367;1329;91;370;59;197;150;567
311480;201708;828;2143;744;2012;117;315;448;1171;565;1486
311490;201708;217;774;190;691;54;218;68;215;122;433
311500;201708;439;1257;350;1101;59;220;168;525;227;745
311510;201708;2845;8429;2126;7090;571;2205;430;1352;1001;3557
311520;201708;606;1903;562;1812;161;573;247;749;408;1322
311530;201708;10690;27072;7675;22210;1883;6331;1878;5162;3761;11493
311535;201708;784;2244;521;1739;116;472;112;339;228;811
311540;201708;600;2013;556;1938;163;575;251;875;414;1450
311545;201708;2198;6365;1943;6048;152;598;1434;4365;1586;4963
311547;201708;1524;4152;1295;3797;68;237;960;2782;1028;3019
311550;201708;2979;8975;2411;7870;403;1533;867;2728;1270;4261
311560;201708;259;669;218;615;31;96;122;316;153;412
311570;201708;2009;5020;1531;4357;67;203;1195;3515;1262;3718
311580;201708;2493;4837;1785;4022;287;565;1093;2655;1380;3220
311590;201708;507;1497;424;1372;96;366;188;590;284;956
311600;201708;1305;3781;1074;3475;149;477;720;2383;869;2860
311610;201708;2735;9373;2409;8714;647;2252;944;3580;1591;5832
311615;201708;3212;9721;2645;8807;242;954;1864;6140;2106;7094
311620;201708;427;1254;374;1169;43;156;255;786;298;942
311630;201708;1376;3930;1137;3501;98;344;790;2363;888;2707
311640;201708;810;2540;655;2272;123;468;296;1024;419;1492
311650;201708;2241;6159;1903;5635;200;705;1166;3362;1366;4067
311660;201708;2764;8546;2111;7228;419;1525;366;1112;785;2637
311670;201708;1660;4610;1344;4114;287;973;527;1625;814;2598
311680;201708;2131;6560;1757;5842;307;1079;1024;3389;1331;4468
311690;201708;573;1368;478;1251;35;99;367;971;402;1070
311700;201708;2338;5897;1810;5198;80;268;1399;3940;1479;4208
311710;201708;1649;4997;1198;4088;361;1351;332;1143;693;2494
311720;201708;412;1335;353;1226;55;216;169;566;224;782
311730;201708;6072;14822;3476;10359;1048;3544;525;1280;1573;4824
311740;201708;799;2433;764;2385;80;218;634;2032;714;2250
311750;201708;4156;12948;3489;11829;491;1927;1970;6455;2461;8382
311760;201708;689;2234;600;2027;127;498;169;463;296;961
311770;201708;2187;6778;1759;5946;399;1472;549;1776;948;3248
311780;201708;1309;4313;1042;3720;251;1052;238;703;489;1755
311783;201708;2088;6492;1747;5843;61;291;1353;4456;1414;4747
311787;201708;641;2104;481;1674;81;306;144;424;225;730
311790;201708;1603;4618;1216;3910;253;925;419;1301;672;2226
311800;201708;5121;16877;4460;15274;833;3147;548;1740;1381;4887
311810;201708;1039;3365;879;3040;69;282;513;1752;582;2034
311820;201708;657;1950;547;1701;106;392;307;860;413;1252
311830;201708;8282;26313;6355;21842;1746;6515;582;1928;2328;8443
311840;201708;2930;8612;2640;8161;468;1645;1628;4956;2096;6601
311850;201708;310;919;268;844;39;129;160;497;199;626
311860;201708;52251;148692;44364;135097;7647;25071;23553;70182;31200;95253
311870;201708;2172;6229;1554;5006;273;1011;511;1468;784;2479
311880;201708;6754;18665;5923;17557;608;1705;4239;12910;4847;14615
311890;201708;1450;4138;1180;3650;232;782;566;1699;798;2481
311900;201708;724;2090;605;1892;84;298;369;1142;453;1440
311910;201708;4183;11964;3476;10942;728;2419;1626;5149;2354;7568
311920;201708;1990;6176;1682;5641;193;743;983;3242;1176;3985
311930;201708;3492;9557;2873;8565;1133;3604;761;2142;1894;5746
311940;201708;13301;38671;10617;33310;1964;6766;3752;11169;5716;17935
311950;201708;2254;6463;1773;5662;135;548;1242;3905;1377;4453
311960;201708;433;1289;383;1192;58;240;201;537;259;777
311970;201708;417;1378;290;1072;53;229;59;195;112;424
311980;201708;552;1566;357;1185;62;225;111;364;173;589
311990;201708;501;1329;371;1143;113;387;141;420;254;807
311995;201708;1162;3476;678;2308;41;160;53;120;94;280
312000;201708;607;1747;538;1640;44;139;370;1151;414;1290
312010;201708;898;2878;736;2495;93;341;348;1145;441;1486
312015;201708;1358;4261;1228;4025;123;491;814;2592;937;3083
312020;201708;1133;3579;991;3334;206;752;431;1405;637;2157
312030;201708;1925;5195;1706;4930;50;226;1534;4385;1584;4611
312040;201708;779;2683;634;2334;121;502;186;649;307;1151
312050;201708;1215;4193;1010;3721;281;1165;206;678;487;1843
312060;201708;802;2341;659;2125;143;494;328;1031;471;1525
312070;201708;1019;3052;677;2311;108;426;297;979;405;1405
312080;201708;2769;7299;2159;6379;237;847;1239;3378;1476;4225
312083;201708;965;2636;799;2380;104;337;556;1619;660;1956
312087;201708;2197;6284;1943;5921;140;427;1493;4656;1633;5083
312090;201708;9310;27317;7542;24359;1902;6515;2895;9240;4797;15755
312100;201708;1491;4682;1144;4093;167;728;511;1746;678;2474
312110;201708;1009;3445;872;3150;251;1020;200;641;451;1661
312120;201708;706;2194;568;1929;133;519;186;547;319;1066
312125;201708;1273;3871;1125;3622;236;721;690;2320;926;3041
312130;201708;899;2467;694;2077;90;303;263;736;353;1039
312140;201708;806;2530;682;2251;175;619;212;638;387;1257
312150;201708;466;1368;395;1202;21;85;252;714;273;799
312160;201708;7690;24612;6547;22204;1328;4990;2563;8259;3891;13249
312170;201708;889;2535;732;2275;58;214;465;1400;523;1614
312180;201708;1388;4156;1193;3764;180;643;543;1618;723;2261
312190;201708;608;1908;456;1589;135;521;69;241;204;762
312200;201708;4938;13779;4089;12405;716;2228;2406;7340;3122;9568
312210;201708;1183;3024;886;2606;130;454;551;1528;681;1982
312220;201708;2031;6597;1864;6393;121;311;1558;5581;1679;5892
312230;201708;11849;35564;9010;30026;2832;10348;1156;3617;3988;13965
312235;201708;1620;4667;1413;4381;146;532;1004;3056;1150;3588
312240;201708;892;2973;711;2581;171;688;170;599;341;1287
312245;201708;2395;6646;2101;6249;97;348;1722;5090;1819;5438
312247;201708;869;2436;655;2079;170;552;271;910;441;1462
312250;201708;1183;3158;845;2567;164;553;323;925;487;1478
312260;201708;977;2906;788;2590;93;349;508;1610;601;1959
312270;201708;662;1947;538;1698;42;179;276;793;318;972
312280;201708;433;1393;370;1260;125;441;43;141;168;582
312290;201708;783;2547;711;2427;150;574;233;783;383;1357
312300;201708;935;2986;721;2456;177;660;83;210;260;870
312310;201708;814;2929;753;2788;154;639;349;1264;503;1903
312320;201708;2044;5636;1557;4751;441;1443;323;914;764;2357
312330;201708;1027;2932;837;2656;122;451;567;1761;689;2212
312340;201708;309;823;241;717;41;141;119;335;160;476
312350;201708;294;712;255;670;28;95;194;491;222;586
312352;201708;1621;4928;1442;4671;210;709;952;3215;1162;3924
312360;201708;2997;9400;2441;8208;542;1971;627;2048;1169;4019
312370;201708;1793;5346;1564;4945;392;1375;655;1956;1047;3331
312380;201708;2146;5330;1894;5006;54;144;1619;4366;1673;4510
312385;201708;1335;3786;1130;3448;138;485;719;2106;857;2591
312390;201708;2127;6626;1669;5731;395;1446;387;1245;782;2691
312400;201708;2960;9335;2440;8290;914;3200;574;2019;1488;5219
312410;201708;10584;33232;9341;30915;1901;6742;4197;13641;6098;20383
312420;201708;3933;11811;3632;11293;632;2085;2107;6572;2739;8657
312430;201708;8252;23295;6939;20960;888;2890;4248;12756;5136;15646
312440;201708;852;2669;704;2393;259;965;184;629;443;1594
312450;201708;1234;3969;965;3424;287;1071;325;1207;612;2278
312460;201708;363;1050;306;975;57;207;171;550;228;757
312470;201708;616;1656;402;1261;71;270;118;329;189;599
312480;201708;1222;3084;894;2700;133;468;524;1514;657;1982
312490;201708;1974;5077;1522;4362;250;771;811;2235;1061;3006
312500;201708;781;2132;644;1929;88;306;347;1007;435;1313
312510;201708;3945;11321;3174;9745;413;1428;1557;4523;1970;5951
312520;201708;239;736;192;660;66;236;70;244;136;480
312530;201708;603;1722;533;1624;43;164;402;1219;445;1383
312540;201708;1448;4408;1019;3472;216;794;431;1447;647;2241
312550;201708;783;2265;621;1906;87;292;316;898;403;1190
312560;201708;2151;5485;1771;4997;97;359;1418;3962;1515;4321
312570;201708;2325;6625;1919;5979;532;1746;697;2193;1229;3939
312580;201708;544;1714;444;1484;59;228;167;548;226;776
312590;201708;1686;5311;1419;4768;203;859;679;2126;882;2985
312595;201708;1873;6137;1727;5818;329;1105;950;3268;1279;4373
312600;201708;846;2541;607;2117;111;475;264;881;375;1356
312610;201708;6774;18541;4884;15104;1080;3636;1044;3036;2124;6672
312620;201708;2259;6341;1735;5591;98;372;1295;4265;1393;4637
312630;201708;319;1026;273;939;68;270;95;321;163;591
312640;201708;534;1662;433;1449;72;245;136;433;208;678
312650;201708;2187;6038;1556;4777;150;523;934;2728;1084;3251
312660;201708;1440;3663;1128;3201;136;449;715;1977;851;2426
312670;201708;5519;15688;4649;14488;743;2748;2503;7523;3246;10271
312675;201708;1330;3983;1100;3527;110;432;784;2463;894;2895
312680;201708;1447;4241;1250;3968;136;552;840;2602;976;3154
312690;201708;2245;5746;1775;5104;208;632;1180;3325;1388;3957
312695;201708;888;2882;821;2776;129;420;551;1910;680;2330
312700;201708;1923;5648;1498;4813;187;644;813;2566;1000;3210
312705;201708;1306;3604;1072;3195;57;206;767;2228;824;2434
312707;201708;1503;4687;1177;4041;120;542;649;2100;769;2642
312710;201708;6757;16500;4344;12769;1334;4380;806;2363;2140;6743
312720;201708;802;2613;694;2383;94;365;336;1095;430;1460
312730;201708;1890;4518;1343;3838;116;379;833;2356;949;2735
312733;201708;1576;4211;1202;3528;54;156;756;2178;810;2334
312735;201708;809;2192;699;2015;119;432;426;1115;545;1547
312737;201708;833;2067;597;1718;140;422;252;712;392;1134
312738;201708;526;1571;370;1257;85;336;133;410;218;746
312740;201708;339;831;198;645;64;219;43;119;107;338
312750;201708;1252;4258;1146;4087;198;822;569;1942;767;2764
312760;201708;1977;6149;1488;5142;319;1168;415;1410;734;2578
312770;201708;41469;109793;29977;90100;7323;23609;8380;24423;15703;48032
312780;201708;2739;9017;2425;8482;360;1410;1365;4786;1725;6196
312790;201708;353;886;214;671;27;98;82;237;109;335
312800;201708;5118;16109;4078;13928;1160;4284;994;3404;2154;7688
312810;201708;2060;6116;1404;4791;350;1300;301;927;651;2227
312820;201708;1937;5401;1620;4851;85;310;1090;3164;1175;3474
312825;201708;1343;3486;1183;3281;64;198;950;2639;1014;2837
312830;201708;2595;7792;1793;6191;458;1716;303;1003;761;2719
312840;201708;1241;3882;970;3341;158;632;307;946;465;1578
312850;201708;774;2248;602;1936;104;381;232;727;336;1108
312860;201708;1454;3841;953;2988;230;776;268;799;498;1575
312870;201708;5705;17223;3840;13132;649;2433;910;2889;1559;5322
312880;201708;1374;3866;1208;3624;79;251;764;2384;843;2635
312890;201708;1949;5634;1251;4145;233;807;444;1496;677;2303
312900;201708;1228;3498;1042;3236;103;339;669;2130;772;2469
312910;201708;1718;3336;1007;2418;148;406;487;1092;635;1498
312920;201708;939;2813;727;2445;159;636;324;1018;483;1654
312930;201708;2153;5976;1803;5430;417;1315;808;2402;1225;3717
312940;201708;904;2818;778;2590;180;633;311;1040;491;1673
312950;201708;3032;8337;2283;7200;767;2626;568;1800;1335;4426
312960;201708;1968;5444;1693;5062;119;347;1289;3919;1408;4266
312965;201708;1819;5562;1535;5033;129;460;958;3130;1087;3590
312970;201708;1005;3218;800;2866;198;806;236;808;434;1614
312980;201708;19210;60962;17424;57475;3964;14275;7494;23603;11458;37878
312990;201708;480;1400;330;1127;93;372;109;364;202;736
313000;201708;484;1558;398;1390;77;360;148;452;225;812
313005;201708;2660;8097;2352;7551;266;917;1595;5066;1861;5983
313010;201708;3962;12271;3376;11233;759;2784;1703;5461;2462;8245
313020;201708;965;3175;698;2516;124;496;81;242;205;738
313030;201708;1466;3799;1059;3183;170;595;505;1469;675;2064
313040;201708;815;2647;699;2373;79;319;338;1071;417;1390
313050;201708;1849;5573;1343;4768;322;1307;330;1047;652;2354
313055;201708;1654;4999;1518;4801;53;189;1293;4090;1346;4279
313060;201708;919;2675;684;2205;204;712;116;347;320;1059
313065;201708;1929;6106;1649;5659;181;728;1165;4003;1346;4731
313070;201708;1005;2849;806;2500;152;523;359;1079;511;1602
313080;201708;443;1306;326;1066;80;313;90;233;170;546
313090;201708;5289;14924;4519;13649;1249;4084;2016;6057;3265;10141
313100;201708;1182;3477;1073;3309;84;286;845;2591;929;2877
313110;201708;1682;4708;1228;3814;163;565;527;1533;690;2098
313115;201708;2468;7984;2271;7554;446;1611;1063;3294;1509;4905
313120;201708;3643;9254;3058;8517;390;1179;1983;5581;2373;6760
313130;201708;26637;77787;22332;69351;4053;14007;9764;28585;13817;42592
313140;201708;535;1351;396;1132;26;92;273;758;299;850
313150;201708;1359;4206;1106;3722;380;1356;271;907;651;2263
313160;201708;1007;2877;824;2543;135;483;456;1335;591;1818
313170;201708;10596;34890;8032;28833;1659;6243;2405;8508;4064;14751
313180;201708;2347;6252;1803;5437;337;1110;805;2345;1142;3455
313190;201708;4113;13245;3216;11151;652;2455;889;2852;1541;5307
313200;201708;1168;3593;1016;3312;75;301;751;2372;826;2673
313210;201708;4037;12166;3384;11115;594;2159;1786;5664;2380;7823
313220;201708;1719;4914;1217;3921;238;871;366;1033;604;1904
313230;201708;2415;7987;2247;7762;137;526;1860;6405;1997;6931
313240;201708;8785;25648;6631;21655;1288;4690;2521;7765;3809;12455
313250;201708;6421;19939;5436;18153;570;2131;2944;9695;3514;11826
313260;201708;680;1911;462;1452;65;250;170;510;235;760
313270;201708;5425;15867;4513;14266;832;2803;2515;7969;3347;10772
313280;201708;373;1205;271;993;55;218;64;229;119;447
313290;201708;789;2753;656;2522;242;1030;96;331;338;1361
313300;201708;1866;5868;1485;5039;413;1528;200;586;613;2114
313310;201708;1002;3331;884;3100;167;663;176;523;343;1186
313320;201708;2354;6546;1696;5509;350;1267;688;2214;1038;3481
313330;201708;4118;12079;3413;10904;288;1245;2154;6610;2442;7855
313340;201708;1686;4113;1305;3550;224;628;748;2039;972;2667
313350;201708;2581;7899;2000;6623;370;1336;537;1656;907;2992
313360;201708;1353;3709;983;3082;203;778;484;1401;687;2179
313370;201708;1219;4043;1128;3822;165;630;593;1941;758;2571
313375;201708;2146;5714;1505;4713;276;1030;440;1292;716;2322
313380;201708;4942;14782;4168;13233;1024;3566;1459;4256;2483;7822
313390;201708;906;3050;836;2934;75;330;549;1873;624;2203
313400;201708;3720;9860;3181;9211;287;817;2546;7453;2833;8270
313410;201708;1248;3453;1031;3102;153;521;690;2027;843;2548
313420;201708;17428;41378;10504;29795;2169;6894;1551;4359;3720;11253
313430;201708;992;3085;742;2565;139;579;262;804;401;1383
313440;201708;6619;14756;4532;12217;337;944;2847;7739;3184;8683
313450;201708;599;1777;463;1497;100;328;143;428;243;756
313460;201708;2126;6984;1834;6478;471;1934;720;2299;1191;4233
313470;201708;3149;8323;2735;7731;341;970;1885;5327;2226;6297
313480;201708;899;2594;645;2109;97;368;199;590;296;958
313490;201708;1682;4513;921;3326;301;1244;78;273;379;1517
313500;201708;429;1407;344;1188;54;210;121;392;175;602
313505;201708;9312;26239;8519;25305;401;1239;7490;22327;7891;23566
313507;201708;1390;3728;1192;3443;99;339;827;2391;926;2730
313510;201708;14634;42090;12772;38895;1708;5678;6667;19875;8375;25553
313520;201708;14330;43097;11882;38749;1194;4450;7658;24699;8852;29149
313530;201708;571;1698;473;1526;40;159;183;549;223;708
313535;201708;2556;7280;2273;6778;194;589;1542;4559;1736;5148
313540;201708;969;3006;713;2337;176;595;199;629;375;1224
313545;201708;1282;4493;1121;4185;189;774;598;2125;787;2899
313550;201708;1863;5820;1632;5374;392;1369;767;2443;1159;3812
313560;201708;2318;5120;1858;4593;135;327;1463;3647;1598;3974
313570;201708;918;3061;765;2731;190;748;288;975;478;1723
313580;201708;5805;16115;4562;14249;785;2583;2338;7520;3123;10103
313590;201708;956;2802;751;2500;317;1147;170;557;487;1704
313600;201708;3767;10962;3273;10146;268;953;2416;7455;2684;8408
313610;201708;993;2812;843;2538;154;477;508;1525;662;2002
313620;201708;5470;16270;4725;14913;1109;3744;1946;6063;3055;9807
313630;201708;8416;22428;6215;19288;988;3377;2883;9293;3871;12670
313640;201708;949;2473;660;2048;186;637;213;619;399;1256
313650;201708;1846;5951;1626;5572;165;677;1050;3567;1215;4244
313652;201708;914;3087;837;2948;124;526;490;1622;614;2148
313655;201708;979;2986;814;2729;89;344;497;1654;586;1998
313657;201708;1360;3845;1082;3422;82;356;768;2261;850;2617
313660;201708;837;2627;720;2389;133;538;348;1074;481;1612
313665;201708;4024;12474;3409;11212;587;2122;1752;5597;2339;7719
313670;201708;46275;130820;33480;106199;7201;24962;10794;32779;17995;57741
313680;201708;1064;3044;932;2829;97;355;570;1682;667;2037
313690;201708;917;3178;767;2851;167;643;229;858;396;1501
313695;201708;1492;4554;1217;4061;111;448;836;2772;947;3220
313700;201708;3544;11716;3061;11113;379;1410;2282;8441;2661;9851
313710;201708;1356;3573;1020;3030;135;435;569;1684;704;2119
313720;201708;5744;17396;4406;14613;818;3042;1482;4507;2300;7549
313730;201708;1315;3314;981;2873;85;273;590;1710;675;1983
313740;201708;1868;6754;1575;5992;422;1739;125;458;547;2197
313750;201708;2169;6363;1721;5475;445;1566;503;1441;948;3007
313753;201708;2041;5416;1535;4546;233;781;748;2150;981;2931
313760;201708;4427;13757;3607;12080;952;3465;1136;3582;2088;7047
313770;201708;3507;10702;2971;9935;415;1471;1825;6130;2240;7601
313780;201708;4136;11316;3162;9764;500;1740;920;2867;1420;4607
313790;201708;466;1548;438;1498;69;251;253;845;322;1096
313800;201708;1261;3242;1079;2969;84;273;790;2211;874;2484
313810;201708;1619;4453;1377;4106;138;459;974;2920;1112;3379
313820;201708;13457;34787;10480;29824;1702;5652;4241;11190;5943;16842
313830;201708;372;1190;330;1115;76;283;145;490;221;773
313835;201708;878;2824;775;2633;78;325;435;1412;513;1737
313840;201708;7423;20870;5751;18035;1416;4829;1223;3787;2639;8616
313850;201708;1089;2907;941;2646;154;539;494;1249;648;1788
313860;201708;2865;8349;2129;6761;434;1464;633;1878;1067;3342
313862;201708;1296;3280;889;2597;110;327;453;1345;563;1672
313865;201708;2321;6848;2065;6460;179;628;1523;4706;1702;5334
313867;201708;1148;3847;996;3531;329;1210;337;1199;666;2409
313868;201708;1744;5743;1484;5220;113;470;1065;3706;1178;4176
313870;201708;844;2498;689;2223;167;599;206;585;373;1184
313880;201708;1330;4037;1121;3669;259;940;404;1169;663;2109
313890;201708;2034;5049;1533;4397;209;645;885;2636;1094;3281
313900;201708;3908;13569;3456;12574;1057;4213;837;3027;1894;7240
313910;201708;705;2303;581;2059;174;656;83;303;257;959
313920;201708;3289;10647;2797;9722;567;2032;1416;5099;1983;7131
313925;201708;1811;4868;1395;4078;222;613;798;2372;1020;2985
313930;201708;6368;22098;5358;20343;605;2160;3450;13942;4055;16102
313940;201708;8912;28162;6928;24812;1755;7036;1793;6919;3548;13955
313950;201708;4261;11341;3194;9669;859;3046;1305;3689;2164;6735
313960;201708;5663;14417;4001;11855;970;3164;1137;3220;2107;6384
313970;201708;1440;4185;1271;3933;119;436;733;2336;852;2772
313980;201708;1358;4048;962;3325;183;721;349;1146;532;1867
313990;201708;1678;6159;1451;5568;478;1967;344;1229;822;3196
314000;201708;8851;26465;7844;24475;880;3340;4808;14583;5688;17923
314010;201708;1243;3285;1019;2979;69;256;745;2123;814;2379
314015;201708;1742;5336;1440;4821;226;896;760;2470;986;3366
314020;201708;516;1508;324;1085;61;249;65;207;126;456
314030;201708;829;2641;654;2223;105;381;267;891;372;1272
314040;201708;749;2134;623;1893;129;427;259;761;388;1188
314050;201708;1688;5061;1313;4299;236;900;555;1664;791;2564
314053;201708;1636;5068;1436;4792;180;604;995;3506;1175;4110
314055;201708;2261;6491;1972;6066;74;301;1605;4927;1679;5228
314060;201708;1196;3549;947;3116;72;282;614;1983;686;2265
314070;201708;4304;13080;3471;11471;876;3089;1069;3348;1945;6437
314080;201708;1804;5512;1309;4395;221;857;340;986;561;1843
314085;201708;2048;6599;1766;6194;449;1721;694;2430;1143;4151
314090;201708;3470;11267;3014;10439;388;1594;1683;5881;2071;7475
314100;201708;3386;8209;2956;7635;140;293;2465;6623;2605;6916
314110;201708;4091;12752;3565;11657;663;2409;1565;4728;2228;7137
314120;201708;1027;2434;486;1544;94;340;107;338;201;678
314130;201708;717;2054;377;1292;62;237;82;271;144;508
314140;201708;4912;14828;3928;12820;732;2514;1685;5454;2417;7968
314150;201708;1555;4203;1234;3654;155;493;699;2031;854;2524
314160;201708;2596;6747;1935;5687;290;925;917;2761;1207;3686
314170;201708;1109;3222;907;2808;127;421;498;1469;625;1890
314180;201708;5267;15925;4595;14868;1006;3441;2224;7203;3230;10644
314190;201708;702;1921;507;1595;116;431;183;513;299;944
314200;201708;2969;8872;2568;8130;218;863;1800;5515;2018;6378
314210;201708;2044;5712;1791;5294;171;587;1088;3135;1259;3722
314220;201708;1486;4501;1103;3758;349;1319;247;737;596;2056
314225;201708;1325;3746;1185;3557;77;268;869;2619;946;2887
314230;201708;706;2176;642;2071;87;337;365;1158;452;1495
314240;201708;1162;3393;938;3035;210;730;413;1376;623;2106
314250;201708;544;1585;383;1222;76;261;115;329;191;590
314260;201708;1047;3609;885;3236;178;775;279;922;457;1697
314270;201708;3053;9301;2513;8342;184;717;1789;5841;1973;6558
314280;201708;3192;8427;2163;6505;430;1474;804;2224;1234;3698
314290;201708;4775;12915;4081;11784;619;1848;2440;6975;3059;8823
314300;201708;1538;4949;1261;4315;352;1277;334;1104;686;2381
314310;201708;5693;16012;4545;13991;1361;4510;1227;3527;2588;8037
314315;201708;824;3150;744;2987;69;332;533;2121;602;2453
314320;201708;3079;8601;2163;7160;561;1998;829;2790;1390;4788
314330;201708;54552;160526;45176;144849;13476;45942;11265;35943;24741;81885
314340;201708;2884;7689;1605;5229;320;1176;163;405;483;1581
314345;201708;1266;4126;1132;3879;164;596;728;2452;892;3048
314350;201708;1193;3409;873;2826;229;802;183;560;412;1362
314360;201708;697;2166;440;1566;89;367;89;308;178;675
314370;201708;595;1806;529;1707;81;301;352;1104;433;1405
314380;201708;1309;3871;919;3067;252;923;135;458;387;1381
314390;201708;13106;36620;9307;29581;2174;7449;2113;6143;4287;13592
314400;201708;4485;13097;3725;11956;1117;3755;1280;4256;2397;8011
314410;201708;2827;8297;2089;6881;441;1622;649;2256;1090;3878
314420;201708;759;2042;583;1780;27;142;431;1265;458;1407
314430;201708;6370;18254;5313;16358;1235;4050;1775;5485;3010;9535
314435;201708;1452;4401;1282;4128;81;361;917;2898;998;3259
314437;201708;1028;2709;832;2406;28;92;587;1715;615;1807
314440;201708;557;1678;460;1525;141;523;137;399;278;922
314450;201708;1530;4403;1289;4013;212;815;669;1912;881;2727
314460;201708;3841;12614;2992;10710;699;2723;485;1673;1184;4396
314465;201708;2304;6954;2098;6578;87;395;1637;5010;1724;5405
314467;201708;1004;2824;851;2562;36;112;630;1904;666;2016
314470;201708;2180;6694;1863;6053;419;1500;705;2118;1124;3618
314480;201708;5907;19228;4263;15021;752;2886;668;2142;1420;5028
314490;201708;852;2500;659;2103;96;347;358;1076;454;1423
314500;201708;1894;5284;1395;4387;276;936;436;1333;712;2269
314505;201708;1956;5279;1744;5005;168;529;1205;3473;1373;4002
314510;201708;1982;5231;1322;4317;316;1116;419;1394;735;2510
314520;201708;3282;11135;2334;8891;455;1994;226;763;681;2757
314530;201708;5839;19890;5438;19146;797;2849;3460;12415;4257;15264
314535;201708;2779;7468;2308;6797;180;590;1700;4997;1880;5587
314537;201708;1150;3469;925;3069;114;456;575;1849;689;2305
314540;201708;359;1054;282;894;53;187;107;316;160;503
314545;201708;1591;4532;1416;4293;83;254;1111;3549;1194;3803
314550;201708;676;1722;472;1436;63;237;198;542;261;779
314560;201708;4341;14455;3592;12740;635;2552;1134;3702;1769;6254
314570;201708;314;922;242;783;34;134;119;367;153;501
314580;201708;513;1692;396;1428;92;361;49;178;141;539
314585;201708;879;2773;639;2238;128;536;215;704;343;1240
314587;201708;1999;5911;1626;5256;299;925;819;2691;1118;3616
314590;201708;3067;10129;2332;8318;459;1790;567;1951;1026;3741
314600;201708;1683;5252;1127;4074;265;1071;119;360;384;1431
314610;201708;7276;23543;6295;21407;1328;5163;2547;8143;3875;13306
314620;201708;1677;4730;1484;4458;85;274;1180;3499;1265;3773
314625;201708;1597;5015;1434;4759;153;703;1039;3280;1192;3983
314630;201708;4869;14003;4216;12964;246;1004;3209;9762;3455;10766
314640;201708;612;1640;457;1365;110;363;155;405;265;768
314650;201708;1065;2902;766;2409;99;379;289;797;388;1176
314655;201708;1582;4555;1131;3660;237;755;444;1445;681;2200
314660;201708;312;812;213;621;17;45;102;284;119;329
314670;201708;1677;4342;1182;3489;129;425;688;1969;817;2394
314675;201708;1875;5380;1617;4936;154;553;1149;3447;1303;4000
314690;201708;2126;6747;1727;5989;520;1972;291;987;811;2959
314700;201708;9631;30872;6708;24397;1746;7033;1046;3726;2792;10759
314710;201708;8637;25527;6124;20161;1150;4200;995;2936;2145;7136
314720;201708;2396;7699;1868;6554;432;1672;445;1540;877;3212
314730;201708;2217;6467;1727;5617;434;1534;522;1558;956;3092
314740;201708;2852;8704;2383;7801;322;1265;1196;3727;1518;4992
314750;201708;347;1036;271;878;33;128;145;443;178;571
314760;201708;1763;5664;1299;4549;183;740;295;852;478;1592
314770;201708;1021;3125;598;2021;50;190;137;383;187;573
314780;201708;324;839;236;711;52;186;106;300;158;486
314790;201708;9978;29747;7651;25408;2854;10534;729;2086;3583;12620
314795;201708;1599;4536;1388;4197;93;380;1019;2935;1112;3315
314800;201708;11870;32928;7675;24580;1865;6459;921;2724;2786;9183
314810;201708;10738;30514;8172;26049;2417;8207;1732;5579;4149;13786
314820;201708;950;2579;696;2146;143;506;307;906;450;1412
314830;201708;1582;5117;1391;4780;311;1207;682;2330;993;3537
314840;201708;932;3174;754;2909;116;568;460;1695;576;2263
314850;201708;1992;5469;1581;4753;150;556;1139;3333;1289;3889
314860;201708;3310;10616;2879;9793;452;1768;1656;5513;2108;7281
314870;201708;5705;16695;4860;15536;457;1695;3554;11350;4011;13045
314875;201708;1765;5597;1653;5445;119;357;1387;4643;1506;5000
314880;201708;918;2338;734;2096;55;135;502;1519;557;1654
314890;201708;555;1682;405;1336;79;301;147;424;226;725
314900;201708;663;1783;524;1572;108;351;198;597;306;948
314910;201708;1716;5367;1366;4796;347;1401;543;1828;890;3229
314915;201708;2403;7486;2068;6875;164;683;1381;4426;1545;5109
314920;201708;530;1436;382;1219;30;111;202;612;232;723
314930;201708;4902;16097;4211;14585;1016;3777;1260;4111;2276;7888
314940;201708;407;1151;364;1074;50;151;218;616;268;767
314950;201708;378;1071;267;901;47;177;87;283;134;460
314960;201708;783;2285;610;1932;104;382;267;767;371;1149
314970;201708;632;2121;550;1955;117;483;185;631;302;1114
314980;201708;1435;4286;1165;3847;345;1257;90;275;435;1532
314990;201708;2623;8101;1924;6484;474;1833;393;1144;867;2977
314995;201708;1641;4958;1411;4589;140;578;859;2687;999;3265
315000;201708;1103;3057;873;2680;83;306;545;1637;628;1943
315010;201708;430;1307;336;1112;69;280;120;350;189;630
315015;201708;2179;6485;1968;6221;246;816;1307;4318;1553;5134
315020;201708;872;2655;643;2169;100;373;276;887;376;1260
315030;201708;622;1849;474;1568;128;453;96;282;224;735
315040;201708;914;2711;841;2577;153;503;493;1487;646;1990
315050;201708;1305;3671;1021;3234;144;527;500;1551;644;2078
315053;201708;1143;3303;959;2947;131;513;490;1479;621;1992
315057;201708;1673;5561;1476;5158;251;872;795;2794;1046;3666
315060;201708;704;2249;491;1779;108;420;69;244;177;664
315070;201708;750;2205;587;1899;172;590;193;581;365;1171
315080;201708;2987;9433;2447;8246;565;1963;1030;3444;1595;5407
315090;201708;793;2679;637;2326;135;535;167;573;302;1108
315100;201708;1222;4024;853;3119;182;753;244;831;426;1584
315110;201708;1371;3920;1107;3466;199;693;465;1441;664;2134
315120;201708;14011;32409;9672;26712;1289;3677;4586;13455;5875;17132
315130;201708;1333;4232;1169;3914;269;1068;393;1204;662;2272
315140;201708;2928;8843;2363;7719;485;1801;956;2839;1441;4640
315150;201708;4562;12018;3332;9977;538;1754;1325;3915;1863;5669
315160;201708;1398;3938;1060;3343;229;764;427;1306;656;2070
315170;201708;1541;4787;1190;4028;254;919;232;751;486;1670
315180;201708;17637;48355;9940;32219;1705;6247;1769;5121;3474;11368
315190;201708;2040;5149;1685;4606;417;1139;993;2706;1410;3845
315200;201708;3794;12360;3105;10900;969;3702;586;2009;1555;5711
315210;201708;8114;23145;6351;19432;962;3251;2404;6839;3366;10090
315213;201708;1154;3358;1041;3187;48;157;838;2553;886;2710
315217;201708;2493;8201;2020;7322;181;843;1259;4434;1440;5277
315220;201708;9565;27103;7947;24270;2427;7701;2325;7234;4752;14935
315230;201708;3027;7725;2692;7337;113;181;2393;6860;2506;7041
315240;201708;3032;9071;2552;8321;645;2274;1220;3869;1865;6143
315250;201708;10720;31715;8344;27183;1769;6331;2879;9187;4648;15518
315260;201708;959;2969;628;2210;128;473;71;216;199;689
315270;201708;712;2235;530;1883;97;413;132;428;229;841
315280;201708;3036;8429;1871;5953;409;1384;298;897;707;2281
315290;201708;1265;3428;847;2741;271;953;187;614;458;1567
315300;201708;588;1589;421;1378;214;734;119;397;333;1131
315310;201708;1281;3913;1012;3392;100;385;586;1877;686;2262
315320;201708;773;2242;593;1974;83;371;261;813;344;1184
315330;201708;745;2679;450;1854;98;436;97;378;195;814
315340;201708;3566;9795;2804;8640;445;1490;1322;4003;1767;5493
315350;201708;1870;5037;1417;4365;105;362;931;2946;1036;3308
315360;201708;1665;5419;1316;4633;253;968;419;1391;672;2359
315370;201708;473;1445;403;1302;78;254;174;560;252;814
315380;201708;210;682;160;563;37;145;36;113;73;258
315390;201708;1248;4011;953;3351;212;825;222;722;434;1547
315400;201708;4372;12784;3516;11154;551;1864;1687;5252;2238;7116
315410;201708;2294;5601;1812;4952;410;1191;811;2192;1221;3383
315415;201708;1116;3452;944;3185;333;1221;301;1040;634;2261
315420;201708;1202;3784;906;3172;207;753;132;422;339;1175
315430;201708;3695;9804;2753;8266;764;2572;755;2142;1519;4714
315440;201708;1000;2927;858;2685;147;562;404;1127;551;1689
315445;201708;2082;5518;1599;4769;227;719;994;2962;1221;3681
315450;201708;2432;7342;2140;6882;324;1023;1307;4307;1631;5330
315460;201708;32175;102780;28778;95923;9796;34623;6437;20746;16233;55369
315470;201708;516;1484;412;1307;31;118;217;668;248;786
315480;201708;1678;5045;1151;3868;257;923;227;761;484;1684
315490;201708;3157;8170;2298;6971;387;1314;733;2083;1120;3397
315500;201708;487;1395;307;980;34;129;132;361;166;490
315510;201708;1381;3865;1183;3547;70;256;931;2752;1001;3008
315520;201708;1085;3146;864;2788;70;280;564;1753;634;2033
315530;201708;660;2158;517;1788;180;690;159;491;339;1181
315540;201708;1126;3374;890;2937;152;584;306;996;458;1580
315550;201708;1937;5324;1456;4599;309;1106;489;1510;798;2616
315560;201708;6542;21215;5862;20228;565;2218;3882;13419;4447;15637
315570;201708;1891;5924;1715;5563;214;801;879;2772;1093;3573
315580;201708;2373;6544;1873;5678;460;1571;553;1603;1013;3174
315590;201708;876;2490;746;2279;105;362;373;1119;478;1481
315600;201708;2445;8450;1928;7382;293;1165;1041;4128;1334;5293
315610;201708;984;2694;789;2317;127;483;327;801;454;1284
315620;201708;312;1087;295;1053;68;238;163;620;231;858
315630;201708;882;2692;710;2349;181;602;160;499;341;1101
315640;201708;455;1312;387;1198;64;245;169;480;233;725
315645;201708;839;2425;663;2081;212;698;190;570;402;1268
315650;201708;1894;5026;1487;4438;96;365;1078;3160;1174;3525
315660;201708;2582;6539;2053;5672;152;415;1389;3780;1541;4195
315670;201708;11354;35905;10017;33263;2369;8529;4063;13022;6432;21551
315680;201708;3023;9764;2318;8344;645;2489;704;2512;1349;5001
315690;201708;3339;9225;2272;7312;551;1910;471;1622;1022;3532
315700;201708;7508;22478;6204;19891;1084;3720;2811;8730;3895;12450
315710;201708;1894;5123;1407;4345;98;411;849;2485;947;2896
315720;201708;3909;12069;3467;11236;239;1080;2252;6992;2491;8072
315725;201708;1596;4844;1419;4587;216;710;1031;3397;1247;4107
315727;201708;629;1828;485;1546;99;357;195;563;294;920
315730;201708;747;2306;689;2177;95;348;332;991;427;1339
315733;201708;1093;3150;958;2912;248;865;350;996;598;1861
315737;201708;1228;3635;961;3140;57;242;623;2005;680;2247
315740;201708;1006;3001;827;2640;154;580;378;1072;532;1652
315750;201708;1210;3486;1056;3223;66;239;775;2359;841;2598
315760;201708;1118;2858;1068;2795;22;49;991;2594;1013;2643
315765;201708;1700;4905;1469;4610;53;170;1277;4067;1330;4237
315770;201708;1465;4595;1258;4257;390;1441;336;1114;726;2555
315780;201708;23241;73258;20877;68274;3723;13506;9280;29104;13003;42610
315790;201708;3733;12058;3214;11046;307;1055;2071;7318;2378;8373
315800;201708;1280;4963;979;4051;211;937;182;707;393;1644
315810;201708;1362;3532;1166;3238;118;377;842;2251;960;2628
315820;201708;2460;7922;2129;7340;416;1515;1197;4120;1613;5635
315830;201708;1208;3830;978;3379;99;422;394;1272;493;1694
315840;201708;784;2048;507;1517;76;237;163;469;239;706
315850;201708;1007;3394;939;3278;224;856;499;1643;723;2499
315860;201708;539;1722;383;1410;84;359;102;337;186;696
315870;201708;454;1298;373;1168;31;111;233;695;264;806
315880;201708;1218;3137;940;2744;123;422;385;1098;508;1520
315890;201708;1548;5109;1364;4750;459;1716;514;1718;973;3434
315895;201708;5838;17431;4818;15285;806;2822;1955;5806;2761;8628
315900;201708;834;2289;762;2184;77;296;591;1592;668;1888
315910;201708;499;1622;452;1549;83;294;289;974;372;1268
315920;201708;1681;4526;864;2758;183;634;165;447;348;1081
315930;201708;1086;2796;793;2301;190;559;258;746;448;1305
315935;201708;894;2909;795;2712;187;716;223;753;410;1469
315940;201708;621;1944;533;1770;94;340;253;830;347;1170
315950;201708;1221;3575;1063;3293;201;613;672;2113;873;2726
315960;201708;3842;11742;2545;9194;839;3518;104;230;943;3748
315970;201708;703;2001;546;1780;61;181;377;1277;438;1458
315980;201708;4055;9751;2477;7145;575;1808;682;1760;1257;3568
315990;201708;4037;11043;3217;9645;449;1527;1631;4792;2080;6319
316000;201708;590;1698;485;1551;112;423;174;535;286;958
316010;201708;665;2079;533;1825;52;225;275;861;327;1086
316020;201708;998;3145;876;2924;100;434;577;1809;677;2243
316030;201708;3186;9102;2329;7539;201;728;1407;4628;1608;5356
316040;201708;3121;9724;2350;8135;382;1499;439;1320;821;2819
316045;201708;2056;6161;1904;5912;198;600;1399;4418;1597;5018
316050;201708;363;1131;284;990;45;190;149;495;194;685
316060;201708;725;2070;567;1822;71;318;330;970;401;1288
316070;201708;6324;19095;5365;17036;1076;3801;2178;6583;3254;10384
316080;201708;764;2638;653;2374;170;674;69;241;239;915
316090;201708;534;1638;390;1331;65;258;127;407;192;665
316095;201708;1465;4570;1241;4172;209;740;652;2183;861;2923
316100;201708;2675;8537;1993;6934;439;1687;503;1608;942;3295
316105;201708;946;2637;714;2242;142;462;325;1039;467;1501
316110;201708;12290;39690;10892;37302;1563;5619;6817;23775;8380;29394
316120;201708;1136;3583;873;2957;202;729;204;597;406;1326
316130;201708;1572;3578;926;2603;142;462;374;999;516;1461
316140;201708;1021;2793;752;2403;99;320;454;1485;553;1805
316150;201708;1587;4158;1349;3755;207;626;689;1845;896;2471
316160;201708;1187;3400;928;2915;125;431;491;1468;616;1899
316165;201708;971;2463;778;2190;145;476;421;1174;566;1650
316170;201708;1290;3589;942;3012;148;526;416;1244;564;1770
316180;201708;1485;4532;1022;3525;224;859;156;446;380;1305
316190;201708;2907;8731;1623;5512;305;1022;389;1166;694;2188
316200;201708;3770;11777;2877;10011;640;2587;655;2147;1295;4734
316210;201708;4871;15151;3859;13028;1282;4622;446;1477;1728;6099
316220;201708;787;2430;557;1944;111;429;56;211;167;640
316225;201708;1275;3314;1035;2923;116;400;675;1816;791;2216
316230;201708;440;1239;360;1106;51;170;158;512;209;682
316240;201708;6606;19597;5797;18477;710;2300;4085;13097;4795;15397
316245;201708;3278;11208;2983;10736;243;1232;2227;7808;2470;9040
316250;201708;10630;29808;8146;25063;2230;7538;1734;5026;3964;12564
316255;201708;2653;7764;2318;7322;364;1277;1511;4801;1875;6078
316257;201708;1323;3510;985;2920;140;461;414;1183;554;1644
316260;201708;1914;5148;1474;4492;78;287;794;2521;872;2808
316265;201708;1354;3729;989;3030;80;273;612;1859;692;2132
316270;201708;3632;12022;3320;11323;795;2907;1309;4261;2104;7168
316280;201708;3196;10060;2892;9446;456;1680;1520;4752;1976;6432
316290;201708;3401;10269;2811;9114;527;1933;981;3140;1508;5073
316292;201708;3911;11709;3403;10873;426;1568;2285;7087;2711;8655
316294;201708;851;2656;634;2236;129;522;84;307;213;829
316295;201708;2023;6347;1875;6075;159;659;1367;4286;1526;4945
316300;201708;1035;3218;860;2896;63;232;523;1800;586;2032
316310;201708;728;2064;500;1654;96;360;177;558;273;918
316320;201708;631;1930;511;1708;87;334;151;475;238;809
316330;201708;1043;3073;800;2533;76;269;518;1590;594;1859
316340;201708;1098;3279;827;2727;114;464;387;1195;501;1659
316350;201708;1304;4044;1158;3793;154;543;705;2300;859;2843
316360;201708;740;1943;586;1711;63;207;399;1135;462;1342
316370;201708;4705;14419;3918;12860;1101;4104;779;2265;1880;6369
316380;201708;1651;4233;1292;3749;62;206;939;2710;1001;2916
316390;201708;892;2493;734;2238;160;550;301;906;461;1456
316400;201708;1319;3982;985;3356;177;640;374;1222;551;1862
316410;201708;1028;3288;933;3147;115;399;695;2344;810;2743
316420;201708;1939;5957;1706;5647;140;557;1251;4056;1391;4613
316430;201708;967;2911;663;2254;161;591;148;478;309;1069
316440;201708;743;2394;600;2166;176;731;98;365;274;1096
316443;201708;638;1865;505;1619;118;425;154;465;272;890
316447;201708;1722;4909;1525;4622;93;327;1240;3740;1333;4067
316450;201708;2196;7117;1823;6363;193;728;1199;4146;1392;4874
316460;201708;863;2555;782;2404;259;822;338;1008;597;1830
316470;201708;7572;23259;5956;20015;1388;5322;1602;5048;2990;10370
316480;201708;191;621;163;558;41;155;53;161;94;316
316490;201708;347;1013;262;835;46;144;99;290;145;434
316500;201708;1219;4171;815;3026;154;629;80;269;234;898
316510;201708;755;2727;673;2574;203;847;202;752;405;1599
316520;201708;1066;3080;874;2753;161;588;344;994;505;1582
316530;201708;862;2687;688;2361;131;556;284;864;415;1420
316540;201708;756;2388;669;2229;106;420;210;650;316;1070
316550;201708;1237;3998;1152;3845;171;623;728;2434;899;3057
316553;201708;2642;8739;1916;6883;558;2140;319;1089;877;3229
316555;201708;2858;9386;2519;8941;169;692;1888;6780;2057;7472
316556;201708;654;1614;485;1338;44;146;283;704;327;850
316557;201708;840;2948;766;2809;338;1313;219;757;557;2070
316560;201708;291;1041;249;953;71;322;53;186;124;508
316570;201708;1228;3900;1079;3598;326;1131;310;1053;636;2184
316580;201708;348;900;225;662;59;188;68;189;127;377
316590;201708;1475;3942;1051;3206;182;625;548;1539;730;2164
316600;201708;1057;3387;943;3169;184;687;440;1455;624;2142
316610;201708;596;2080;513;1914;74;382;309;1076;383;1458
316620;201708;2255;6584;1916;6043;160;610;1298;4065;1458;4675
316630;201708;1556;4877;1252;4268;399;1358;418;1569;817;2927
316640;201708;168;521;144;475;32;131;63;170;95;301
316650;201708;966;3297;801;3046;72;291;536;2094;608;2385
316660;201708;192;495;93;289;7;30;16;41;23;71
316670;201708;1980;5343;1571;4642;487;1542;485;1391;972;2933
316680;201708;1917;5109;1535;4531;160;539;1073;3069;1233;3608
316690;201708;1195;3929;1044;3618;278;1109;318;1057;596;2166
316695;201708;1074;3269;936;3013;80;318;601;1891;681;2209
316700;201708;395;1100;341;1021;26;113;225;617;251;730
316710;201708;2781;10125;2343;9138;792;3194;666;2796;1458;5990
316720;201708;17270;54214;14222;47669;3319;11857;4474;14514;7793;26371
316730;201708;355;1089;312;990;89;314;107;306;196;620
316740;201708;713;2256;651;2151;80;344;428;1396;508;1740
316750;201708;427;1395;340;1207;58;235;117;394;175;629
316760;201708;3651;11755;3057;10838;1366;5131;944;3385;2310;8516
316770;201708;1439;3809;1236;3528;51;185;1034;2966;1085;3151
316780;201708;608;1978;514;1778;160;613;49;135;209;748
316790;201708;780;2233;613;1939;174;591;173;542;347;1133
316800;201708;5351;16783;4557;15228;734;2714;2420;7705;3154;10419
316805;201708;841;2054;803;2002;29;47;706;1861;735;1908
316810;201708;662;1947;510;1632;140;509;187;536;327;1045
316820;201708;398;1008;215;678;36;129;28;96;64;225
316830;201708;594;1961;545;1864;118;464;282;925;400;1389
316840;201708;2832;8358;2450;7664;517;1795;1075;3235;1592;5030
316850;201708;2149;6018;1723;5301;243;870;931;2787;1174;3657
316860;201708;18280;55904;15524;50876;3330;12364;6045;19144;9375;31508
316870;201708;6596;20595;5271;17669;1349;4850;1256;4045;2605;8895
316880;201708;898;2633;774;2425;180;649;284;854;464;1503
316890;201708;1306;2996;907;2465;195;646;512;1265;707;1911
316900;201708;2599;7482;2028;6301;484;1673;594;1622;1078;3295
316905;201708;474;1522;400;1357;112;404;151;507;263;911
316910;201708;989;2906;671;2297;164;637;77;249;241;886
316920;201708;1655;4353;1163;3631;239;845;455;1397;694;2242
316930;201708;7989;26362;6266;22731;1430;5616;1142;3995;2572;9611
316935;201708;4563;13492;3268;10754;787;2766;768;2485;1555;5251
316940;201708;6796;21457;5369;18344;1179;4377;1358;4324;2537;8701
316950;201708;1699;4390;1380;3948;104;342;1017;2855;1121;3197
316960;201708;5032;12477;3872;10828;640;1947;2194;6066;2834;8013
316970;201708;3252;10100;3037;9702;634;2291;1260;3732;1894;6023
316980;201708;918;2748;646;2201;188;691;87;294;275;985
316990;201708;10100;30849;8003;26190;2270;7932;726;2259;2996;10191
317000;201708;2834;9206;2713;9051;228;725;2064;7532;2292;8257
317005;201708;2701;8081;2324;7439;483;1595;1150;3673;1633;5268
317010;201708;27776;68274;17005;51612;4266;14452;3201;10406;7467;24858
317020;201708;68040;179908;40312;125194;7932;26935;7749;21873;15681;48808
317030;201708;711;2045;601;1875;42;176;399;1214;441;1390
317040;201708;10647;29729;8240;25474;2107;6911;2923;9062;5030;15973
317043;201708;778;1997;636;1797;123;369;346;954;469;1323
317047;201708;1188;3048;892;2577;63;201;584;1683;647;1884
317050;201708;1497;4947;1123;4046;206;805;338;1105;544;1910
317052;201708;2305;7264;2112;6944;227;858;1456;4674;1683;5532
317057;201708;1692;4521;1278;3803;91;346;835;2377;926;2723
317060;201708;433;1197;256;814;51;193;68;186;119;379
317065;201708;1326;3834;1149;3533;61;269;870;2573;931;2842
317070;201708;9240;28176;6420;21921;1441;5521;844;2755;2285;8276
317075;201708;1097;3247;839;2693;170;568;164;491;334;1059
317080;201708;6343;16496;5165;14521;1682;4949;1349;3573;3031;8522
317090;201708;4814;15304;4422;14708;443;1521;3125;10513;3568;12034
317100;201708;3047;7999;2194;6574;725;2296;621;1812;1346;4108
317103;201708;1859;6268;1643;5858;200;941;939;3177;1139;4118
317107;201708;1398;4118;1187;3705;93;355;759;2194;852;2549
317110;201708;750;1808;417;1257;70;261;139;433;209;694
317115;201708;1183;3537;990;3127;88;287;671;2124;759;2411
317120;201708;11307;36201;9181;31511;1819;6900;3967;13143;5786;20043
317130;201708;7782;21879;6108;18878;1382;4715;2069;6262;3451;10977
317140;201708;583;1819;521;1709;79;270;302;980;381;1250
317150;201708;1017;2670;857;2478;53;158;666;1908;719;2066
317160;201708;3598;9152;2623;7811;268;852;1689;5016;1957;5868
317170;201708;2003;5307;1483;4416;221;752;519;1359;740;2111
317180;201708;1800;5954;1441;5158;344;1303;327;1132;671;2435
317190;201708;1383;3845;1058;3347;73;253;675;2108;748;2361
317200;201708;4857;14423;3873;12455;943;3322;977;2959;1920;6281
317210;201708;978;2799;840;2607;98;401;566;1726;664;2127
317220;201708;287;976;266;928;75;286;113;383;188;669
320010;201708;4967;15280;4211;13794;643;2255;2303;7393;2946;9648
320013;201708;1940;5781;1347;4476;234;796;539;1844;773;2640
320016;201708;3082;8394;2607;7717;209;588;1970;5850;2179;6438
320020;201708;3838;11661;3133;10283;858;2967;926;3091;1784;6058
320030;201708;1602;4951;1153;3994;335;1222;337;1095;672;2317
320035;201708;1836;5321;1567;4880;518;1792;601;1761;1119;3553
320040;201708;3316;10432;2770;9371;553;2006;1132;3788;1685;5794
320050;201708;1711;4474;1492;4096;367;1042;706;1899;1073;2941
320060;201708;11534;35724;8654;29307;2106;7725;1868;6023;3974;13748
320070;201708;1516;4655;1193;3971;264;951;320;1030;584;1981
320080;201708;5773;16113;4320;13263;924;2939;1455;4523;2379;7462
320090;201708;7955;22637;6216;19160;1586;5129;2270;6837;3856;11966
320100;201708;2613;8097;2101;7055;612;2093;631;2137;1243;4230
320110;201708;1282;3686;1081;3317;271;846;282;894;553;1740
320115;201708;1878;6446;1670;6060;805;3000;439;1664;1244;4664
320120;201708;15736;46043;12082;39066;2908;10361;3261;10319;6169;20680
320130;201708;36797;115153;32913;107696;6298;23165;15870;50264;22168;73429
320140;201708;3420;10555;2456;8434;599;2271;489;1676;1088;3947
320150;201708;14573;40786;10930;33599;3210;10581;1236;3447;4446;14028
320160;201708;5116;15618;4268;13922;969;3440;1715;5435;2684;8875
320170;201708;1698;5303;1384;4608;316;1101;564;1837;880;2938
320180;201708;750;2518;636;2296;226;839;140;540;366;1379
320190;201708;3457;11694;2695;9826;684;2630;436;1527;1120;4157
320200;201708;1024;3057;805;2669;258;943;189;646;447;1589
320210;201708;4684;12918;3882;11391;737;2410;1859;5158;2596;7568
320220;201708;2435;7303;2008;6547;430;1545;963;3123;1393;4668
320225;201708;1295;4282;962;3458;335;1259;131;478;466;1737
320230;201708;4339;13502;3583;12165;998;3676;1301;4443;2299;8119
320240;201708;13559;38605;10839;33917;2541;8541;3764;11827;6305;20368
320245;201708;3234;10721;2935;10033;1057;3795;714;2381;1771;6176
320250;201708;1971;5904;1396;4562;360;1318;233;682;593;2000
320255;201708;1726;5786;1505;5401;577;2152;569;2138;1146;4290
320260;201708;977;2937;740;2399;226;810;199;548;425;1358
320265;201708;2497;7883;2120;7209;855;3031;655;2216;1510;5247
320270;201708;2742;7872;2012;6499;385;1329;900;2986;1285;4315
320280;201708;6445;19559;5552;17788;1434;4980;1501;4521;2935;9501
320290;201708;1449;4583;1015;3515;302;1148;158;511;460;1659
320300;201708;4215;13852;3624;12516;1184;4340;709;2430;1893;6770
320305;201708;4571;14212;3828;12568;953;3296;1362;4393;2315;7689
320310;201708;1926;5702;1574;4978;370;1208;599;1881;969;3089
320313;201708;2200;6154;1483;4617;332;1170;280;820;612;1990
320316;201708;1696;5032;1354;4329;403;1344;445;1416;848;2760
320320;201708;20240;59416;15624;50915;4259;15019;4845;15496;9104;30515
320330;201708;2979;8624;2405;7609;687;2162;945;3179;1632;5341
320332;201708;5623;17511;4810;16004;1308;4640;2026;6694;3334;11334
320334;201708;2133;6591;1477;5161;343;1359;333;1091;676;2450
320335;201708;2258;6598;1417;4637;372;1328;216;650;588;1978
320340;201708;5620;14978;4787;13610;1005;3064;2217;6462;3222;9526
320350;201708;5209;13572;3844;11070;689;2043;1621;4644;2310;6687
320360;201708;1650;4368;1214;3524;204;580;479;1373;683;1953
320370;201708;2843;9271;2279;7959;649;2327;670;2303;1319;4630
320380;201708;2247;6564;1981;6095;411;1380;981;2931;1392;4311
320390;201708;7324;21411;5827;18232;1539;5099;1829;5524;3368;10623
320400;201708;3536;10628;3042;9716;675;2292;1322;4205;1997;6497
320405;201708;4393;12531;3768;11398;677;2159;2066;6147;2743;8306
320410;201708;5400;14604;4047;12589;844;2792;1770;5656;2614;8448
320420;201708;2617;7651;2081;6703;611;2180;464;1474;1075;3654
320425;201708;2072;5233;1601;4454;162;497;970;2618;1132;3115
320430;201708;2672;7292;2230;6391;416;1254;1202;3292;1618;4546
320435;201708;2704;8583;2163;7498;865;3124;533;1930;1398;5054
320440;201708;1055;3393;914;3040;195;728;335;1056;530;1784
320450;201708;1971;6005;1582;5237;413;1503;641;2031;1054;3534
320455;201708;4175;13413;3070;10814;829;3074;682;2354;1511;5428
320460;201708;2660;8321;1922;6627;473;1741;360;1128;833;2869
320465;201708;1556;4664;1174;3838;170;607;534;1758;704;2365
320470;201708;4297;12529;3027;9810;811;2836;616;1919;1427;4755
320480;201708;1719;5274;1478;4781;334;1174;617;1952;951;3126
320490;201708;16142;47971;13542;43314;3383;11831;4629;14770;8012;26601
320495;201708;1363;3942;906;3003;250;864;160;566;410;1430
320500;201708;49375;144784;42569;132668;9025;30351;20351;61921;29376;92272
320501;201708;4749;14241;3636;12326;1066;4076;933;3040;1999;7116
320503;201708;1940;6412;1544;5552;541;2134;430;1415;971;3549
320506;201708;4121;12568;2874;9639;762;2710;99;271;861;2981
320510;201708;8783;26593;7607;24415;1513;5348;3674;11523;5187;16871
320515;201708;1908;5439;1532;4630;457;1441;354;1054;811;2495
320517;201708;2093;6631;1664;5780;562;2125;321;1069;883;3194
320520;201708;37415;110341;30622;98165;7143;25276;10906;34305;18049;59581
320530;201708;28675;84305;23732;75107;4126;15405;11880;35141;16006;50546
330010;201708;21310;63873;18733;59112;3973;13273;9639;30412;13612;43685
330015;201708;1537;4212;1323;3820;218;725;591;1639;809;2364
330020;201708;18724;52664;16923;49742;2942;9639;10443;29789;13385;39428
330022;201708;1982;5672;1627;5098;326;1109;891;2763;1217;3872
330023;201708;3370;10057;2856;9210;777;2704;883;2750;1660;5454
330025;201708;4891;13148;3667;10922;1083;3520;1229;3592;2312;7112
330030;201708;8554;27390;7395;25168;1375;5203;3586;11618;4961;16821
330040;201708;12059;35561;10835;33225;2036;6808;6074;17974;8110;24782
330045;201708;77860;206965;67280;192064;8547;25528;45511;128403;54058;153931
330050;201708;2491;7394;2068;6611;548;1886;772;2313;1320;4199
330060;201708;5704;16025;4829;14655;1155;3877;2053;5990;3208;9867
330070;201708;20931;61925;18665;58118;3925;13172;9097;28305;13022;41477
330080;201708;8319;23054;7613;21943;660;1978;5380;15395;6040;17373
330090;201708;2688;7010;2358;6503;362;1104;1295;3452;1657;4556
330093;201708;2051;5965;1693;5352;267;880;891;2917;1158;3797
330095;201708;1069;3506;909;3156;162;611;358;1179;520;1790
330100;201708;63988;189244;56128;176991;7179;26027;34207;106460;41386;132487
330110;201708;2289;7081;2015;6609;448;1568;726;2320;1174;3888
330115;201708;1815;5201;1573;4826;302;1055;836;2470;1138;3525
330120;201708;2806;7369;2424;6807;322;1046;1593;4380;1915;5426
330130;201708;3435;10809;3058;10161;713;2567;1485;4878;2198;7445
330140;201708;3202;9595;2907;9150;577;2095;1604;4911;2181;7006
330150;201708;2091;6136;1688;5351;421;1384;472;1501;893;2885
330160;201708;1190;3652;1041;3400;266;980;490;1525;756;2505
330170;201708;100530;295908;91099;280797;17140;56199;50686;154606;67826;210805
330180;201708;2131;6081;1783;5460;100;413;1214;3584;1314;3997
330185;201708;8749;26020;7514;23684;1273;4412;4310;13196;5583;17608
330187;201708;3946;11025;3348;10054;562;1878;2003;5877;2565;7755
330190;201708;26582;73362;24667;70466;3622;10831;17587;49998;21209;60829
330200;201708;14162;43138;12596;40528;3046;10011;6296;20635;9342;30646
330205;201708;2101;5704;1826;5233;185;608;1193;3324;1378;3932
330210;201708;3006;8238;2360;6989;553;1703;845;2423;1398;4126
330220;201708;10425;30944;8815;27604;2205;7440;2220;6401;4425;13841
330225;201708;3894;11765;3332;10747;386;1561;2014;6237;2400;7798
330227;201708;17085;48066;15307;45491;2694;8303;9609;28811;12303;37114
330230;201708;1293;3716;1139;3487;150;536;684;2027;834;2563
330240;201708;18579;55093;15778;50032;4530;15475;5495;16835;10025;32310
330245;201708;1287;3755;950;3142;234;832;202;642;436;1474
330250;201708;35764;103422;32271;97673;8904;27203;13195;41438;22099;68641
330260;201708;4459;13337;3735;11971;684;2377;1632;4986;2316;7363
330270;201708;20595;45986;13793;36807;3077;9180;5137;13694;8214;22874
330280;201708;2319;6736;1918;5969;306;1070;924;2717;1230;3787
330285;201708;18629;52278;16587;49113;2742;8866;10039;29096;12781;37962
330290;201708;3365;9574;2954;8893;496;1656;1584;4537;2080;6193
330300;201708;3267;10433;2920;9745;525;1960;1604;5141;2129;7101
330310;201708;2268;6285;1888;5618;206;613;1173;3473;1379;4086
330320;201708;13331;39205;12395;37734;1627;5375;8953;26980;10580;32355
330330;201708;29081;78089;25239;72090;4237;13517;15150;41813;19387;55330
330340;201708;14713;41697;11554;36032;2723;9170;3958;11918;6681;21088
330350;201708;90119;255081;80299;241120;10832;34979;54245;161990;65077;196969
330360;201708;6274;17864;5930;17373;668;2071;4505;13093;5173;15164
330370;201708;3655;12687;3270;11889;1063;3978;1059;3872;2122;7850
330380;201708;5219;16395;4345;14641;1051;3875;1446;4651;2497;8526
330385;201708;3952;13293;3591;12586;1048;3905;1372;4852;2420;8757
330390;201708;22754;72715;19684;66452;4792;17405;7943;26148;12735;43553
330395;201708;3151;8986;2850;8502;235;843;1887;5504;2122;6347
330400;201708;2768;8366;2501;7879;283;1095;1623;4736;1906;5831
330410;201708;2881;8572;2248;7376;429;1555;1001;3099;1430;4654
330411;201708;2442;7384;2127;6738;237;879;1339;4029;1576;4908
330412;201708;1427;4698;1195;4219;211;811;558;1852;769;2663
330414;201708;24518;67560;21118;62749;3781;11177;12457;37275;16238;48452
330415;201708;3518;10513;2863;9362;615;2020;1164;3903;1779;5923
330420;201708;10094;28076;6938;22409;1400;4899;1691;5215;3091;10114
330430;201708;7535;21706;6640;20056;1326;4418;3188;9263;4514;13681
330440;201708;1616;5275;1452;4955;419;1589;463;1454;882;3043
330450;201708;1414;4486;1218;4140;238;929;587;1944;825;2873
330452;201708;14156;40914;11379;35656;2613;8876;4837;14708;7450;23584
330455;201708;529033;1404957;422736;1234687;83507;261102;217076;622750;300583;883852
330460;201708;1185;3756;1025;3461;229;846;435;1422;664;2268
330470;201708;4402;12897;3899;12020;960;3225;1710;5105;2670;8330
330475;201708;7955;23883;6984;22290;2021;7029;2748;8519;4769;15548
330480;201708;5832;16656;5198;15688;851;2799;3102;9117;3953;11916
330490;201708;112770;290288;99621;270712;11527;33587;67552;180855;79079;214442
330500;201708;5568;16507;5269;16003;624;2109;3811;11461;4435;13570
330510;201708;38137;114065;33608;106770;10587;33790;13622;44400;24209;78190
330513;201708;1361;4004;1228;3769;394;1255;471;1443;865;2698
330515;201708;3064;9252;2648;8436;872;2865;728;2311;1600;5176
330520;201708;11202;33493;9962;31227;2014;6781;4560;13922;6574;20703
330530;201708;1505;4227;1260;3785;296;974;542;1538;838;2512
330540;201708;3003;8641;2461;7644;670;2195;849;2521;1519;4716
330550;201708;7933;26018;7003;24215;2838;10221;1296;4596;4134;14817
330555;201708;10053;29094;8953;27455;1670;5302;5334;16598;7004;21900
330560;201708;4340;12845;3828;11882;596;2008;2086;6271;2682;8279
330570;201708;3141;9142;2645;8291;617;2026;1278;3968;1895;5994
330575;201708;5390;15036;4810;13973;626;2084;3257;9066;3883;11150
330580;201708;13549;41712;11252;37091;3088;10759;4127;13435;7215;24194
330590;201708;1587;4715;1473;4549;199;661;1014;3138;1213;3799
330600;201708;11530;33247;9204;29070;1541;5287;4302;13460;5843;18747
330610;201708;8892;27151;7958;25490;1255;4534;4473;13973;5728;18507
330615;201708;1647;5647;1518;5434;563;2113;568;2072;1131;4185
330620;201708;3565;12070;3136;11174;1165;4416;620;2153;1785;6569
330630;201708;24080;67930;19488;59803;2738;9779;11198;32870;13936;42649
350010;201708;1883;5419;1201;4030;298;1032;114;329;412;1361
350020;201708;549;1476;339;1074;44;152;156;445;200;597
350030;201708;4596;13932;3507;11739;952;3448;850;2752;1802;6200
350040;201708;503;1656;359;1318;68;282;105;351;173;633
350050;201708;912;2720;725;2349;169;633;209;569;378;1202
350055;201708;681;1936;577;1763;77;257;379;1150;456;1407
350060;201708;116;353;96;324;22;85;44;149;66;234
350070;201708;4003;11499;2564;8519;497;1751;656;1971;1153;3722
350075;201708;585;1910;454;1634;185;674;66;232;251;906
350080;201708;694;1985;433;1400;62;219;167;523;229;742
350090;201708;619;1603;392;1147;91;255;125;363;216;618
350100;201708;2054;6173;1442;4952;254;1015;504;1603;758;2618
350110;201708;471;1422;354;1164;32;125;192;608;224;733
350115;201708;1277;3794;1106;3444;221;739;521;1487;742;2226
350120;201708;831;2369;511;1691;64;213;257;907;321;1120
350130;201708;3449;9984;2957;9012;375;1272;1641;4720;2016;5992
350140;201708;594;1939;488;1724;48;205;268;912;316;1117
350150;201708;485;1539;415;1399;143;508;101;338;244;846
350160;201708;9786;26719;6352;20281;1119;4026;2836;8390;3955;12416
350170;201708;1578;5203;1318;4573;319;1177;320;1067;639;2244
350180;201708;1159;3140;697;2144;120;401;303;905;423;1306
350190;201708;3339;10061;2559;8431;554;2095;974;2705;1528;4800
350200;201708;381;1147;341;1069;28;94;224;685;252;779
350210;201708;5327;13855;3755;11172;879;2715;1628;4778;2507;7493
350220;201708;2469;7736;2091;6841;437;1661;862;2602;1299;4263
350230;201708;778;2375;689;2211;161;537;296;942;457;1479
350240;201708;578;1749;442;1434;70;244;194;606;264;850
350250;201708;2193;7552;1920;7044;699;2741;513;1899;1212;4640
350260;201708;994;2590;654;1953;118;366;281;803;399;1169
350270;201708;4893;14493;4047;12687;748;2597;1769;5152;2517;7749
350275;201708;2018;6399;1801;6018;461;1625;690;2246;1151;3871
350280;201708;22377;53507;14035;39525;2794;8431;3819;10438;6613;18869
350290;201708;2424;7491;1877;6334;374;1396;621;1991;995;3387
350300;201708;585;1683;427;1347;94;283;147;441;241;724
350310;201708;902;2950;767;2624;107;415;288;929;395;1344
350315;201708;545;1642;399;1327;64;239;120;363;184;602
350320;201708;11232;34221;9810;31606;2763;9394;1805;6056;4568;15450
350330;201708;15235;41139;10404;30435;1791;5186;4407;12159;6198;17345
350335;201708;393;1203;346;1107;18;47;259;843;277;890
350340;201708;1097;3169;742;2442;148;542;223;746;371;1288
350350;201708;734;2213;621;2054;131;459;214;690;345;1149
350360;201708;921;3027;774;2698;211;721;290;1022;501;1743
350370;201708;595;1750;417;1321;113;358;65;193;178;551
350380;201708;4705;13550;3322;10895;768;2738;1000;3074;1768;5812
350390;201708;9649;28790;8216;26068;2397;7798;2880;8929;5277;16727
350395;201708;382;1040;190;646;27;98;58;170;85;268
350400;201708;8266;23125;6391;19695;1629;5477;2006;5851;3635;11328
350410;201708;8858;28394;6995;24500;1810;6914;1562;5107;3372;12021
350420;201708;585;1823;446;1570;90;377;56;189;146;566
350430;201708;702;2147;587;1931;100;398;310;956;410;1354
350440;201708;1350;4118;1116;3572;241;769;463;1436;704;2205
350450;201708;7681;23426;6206;20433;1423;5025;1662;5203;3085;10228
350460;201708;1498;4011;893;2802;179;632;275;808;454;1440
350470;201708;250;652;206;573;21;81;131;331;152;412
350480;201708;766;2232;538;1770;92;341;88;252;180;593
350490;201708;1886;5544;1549;4954;356;1230;479;1399;835;2629
350500;201708;584;1712;501;1562;79;290;271;810;350;1100
350510;201708;1157;3398;865;2773;137;489;379;1161;516;1650
350520;201708;1712;6014;1345;5163;285;1191;395;1462;680;2653
350530;201708;2383;6900;1905;5918;561;1814;450;1332;1011;3146
350535;201708;1331;4135;1225;3967;145;570;839;2624;984;3194
350540;201708;1808;4960;1352;4155;324;1086;497;1534;821;2620
350550;201708;10545;27513;7274;22090;1167;4060;2916;8220;4083;12280
350560;201708;3509;11255;3008;10065;377;1337;1626;5370;2003;6707
350570;201708;19397;61101;17015;56351;4668;16784;6547;20555;11215;37339
350580;201708;1872;5812;1163;4026;230;856;117;323;347;1179
350590;201708;4112;12379;3163;10400;792;2942;1215;3586;2007;6528
350600;201708;44990;108869;28980;80782;4546;13841;12376;31872;16922;45713
350610;201708;7102;20774;5537;17777;1111;3859;2258;7022;3369;10881
350620;201708;431;1196;321;1027;47;184;149;447;196;631
350630;201708;1637;4607;1205;3770;162;603;533;1517;695;2120
350635;201708;7097;20104;5504;17334;1206;4167;2327;7060;3533;11227
350640;201708;844;2561;545;1813;92;337;137;404;229;741
350650;201708;8040;23549;5106;16711;1076;3851;1202;3680;2278;7531
350660;201708;4948;14087;3962;12326;760;2539;1850;5698;2610;8237
350670;201708;1568;4864;1438;4603;326;1072;707;2236;1033;3308
350680;201708;1139;3341;816;2701;183;673;318;1034;501;1707
350690;201708;948;3010;738;2560;152;575;271;883;423;1458
350700;201708;4394;12647;3117;10434;693;2565;1155;3587;1848;6152
350710;201708;2764;8378;2394;7654;365;1311;1335;4133;1700;5444
350715;201708;756;2272;672;2092;87;313;376;1087;463;1400
350720;201708;136;384;122;361;23;76;46;133;69;209
350730;201708;431;1519;397;1434;81;326;172;613;253;939
350740;201708;1800;5370;1256;4155;232;815;325;983;557;1798
350745;201708;548;1669;332;1123;52;191;132;399;184;590
350750;201708;9583;28579;7836;25190;1740;6249;2210;6449;3950;12698
350760;201708;13506;38522;10706;33531;2875;9785;2577;7187;5452;16972
350770;201708;724;2007;494;1545;68;223;235;724;303;947
350775;201708;621;1616;491;1398;52;184;231;624;283;808
350780;201708;1966;5820;1524;4982;390;1420;321;1102;711;2522
350790;201708;1929;5798;1378;4686;305;1124;243;699;548;1823
350800;201708;3094;10033;2876;9607;508;1899;1472;4740;1980;6639
350810;201708;2074;5710;1780;5287;400;1270;877;2701;1277;3971
350820;201708;630;1690;404;1234;58;184;140;396;198;580
350830;201708;861;2646;542;1906;74;279;136;425;210;704
350840;201708;2586;8660;2055;7537;655;2554;506;1763;1161;4317
350850;201708;6132;19884;5049;17541;1497;5439;1256;4353;2753;9792
350860;201708;3290;9813;3074;9468;154;645;2333;7052;2487;7697
350870;201708;2739;8474;2201;7542;482;1844;1107;3772;1589;5616
350880;201708;1337;4329;1070;3689;243;865;265;895;508;1760
350890;201708;679;1887;425;1330;53;175;124;322;177;497
350900;201708;5587;17014;3988;13503;1253;4643;425;1352;1678;5995
350910;201708;900;2554;772;2296;176;602;396;1114;572;1716
350920;201708;11831;32215;10375;29767;832;2784;7646;20993;8478;23777
350925;201708;4533;13812;3554;11866;860;3032;1124;3285;1984;6317
350930;201708;1554;4280;1107;3369;149;484;574;1663;723;2147
350940;201708;1862;5984;1682;5624;290;1113;942;3027;1232;4140
350945;201708;948;2907;776;2583;129;497;362;1127;491;1624
350950;201708;79893;233334;64587;200144;12091;41129;30860;89872;42951;131001
350960;201708;4948;15914;4182;14299;832;3254;2084;6751;2916;10005
350970;201708;4174;14068;3473;12337;1129;4338;529;1663;1658;6001
350980;201708;646;2050;555;1846;223;783;165;533;388;1316
350990;201708;1793;5772;1436;5097;383;1494;420;1384;803;2878
350995;201708;810;2682;757;2568;91;390;455;1449;546;1839
351000;201708;2863;8303;2285;7213;429;1493;847;2498;1276;3991
351010;201708;340;971;201;650;37;123;72;225;109;348
351015;201708;754;2526;632;2292;141;565;250;875;391;1440
351020;201708;8270;24957;7041;22952;1651;5590;3568;11645;5219;17235
351030;201708;2253;7398;1900;6545;393;1519;793;2538;1186;4057
351040;201708;3840;11143;3470;10511;366;1299;2475;7211;2841;8510
351050;201708;16470;44315;11492;35857;2649;9011;3645;11232;6294;20243
351060;201708;42080;116506;33767;101994;5713;18979;17784;52000;23497;70979
351070;201708;1419;3867;901;2914;250;895;91;248;341;1143
351080;201708;2782;7877;2098;7008;497;1814;910;2857;1407;4671
351090;201708;378;1237;281;1049;53;220;48;181;101;401
351100;201708;2478;7363;1681;5418;445;1496;368;1233;813;2729
351110;201708;6515;16507;3823;12013;782;2725;1033;3039;1815;5764
351120;201708;690;2007;515;1645;80;266;201;560;281;826
351130;201708;1080;2970;520;1793;89;300;96;327;185;627
351140;201708;1739;5735;1402;4997;425;1659;289;924;714;2583
351150;201708;1483;5036;1024;3846;221;874;75;223;296;1097
351160;201708;1232;4183;1065;3793;271;1020;345;1071;616;2091
351170;201708;1406;4349;1198;3883;150;542;633;1934;783;2476
351190;201708;860;2686;663;2192;103;341;192;604;295;945
351200;201708;1913;5509;1578;4894;170;589;743;2162;913;2751
351210;201708;1336;3607;897;2709;125;438;375;1006;500;1444
351220;201708;3041;9866;2769;9292;390;1480;1559;5034;1949;6514
351230;201708;1863;5554;1470;4846;318;1174;663;2039;981;3213
351240;201708;1303;3781;941;3011;223;744;373;1133;596;1877
351250;201708;1053;3039;635;2057;105;362;209;649;314;1011
351260;201708;920;2674;774;2373;260;802;173;508;433;1310
351270;201708;329;1053;286;961;71;277;121;344;192;621
351280;201708;5254;14770;3904;12061;726;2490;1435;4184;2161;6674
351290;201708;977;2739;676;2139;152;489;266;799;418;1288
351300;201708;13770;42720;10324;35553;2488;9248;3171;10925;5659;20173
351310;201708;3090;9188;2470;8032;424;1591;1191;3578;1615;5169
351320;201708;900;2916;726;2482;134;497;241;761;375;1258
351330;201708;610;2169;551;2074;73;215;375;1531;448;1746
351340;201708;5796;18869;4890;17066;1313;4758;1796;6257;3109;11015
351350;201708;8198;25199;7121;23075;1535;5204;3315;10267;4850;15471
351360;201708;3987;12069;3604;11330;909;3114;1089;3137;1998;6251
351370;201708;2328;7116;1779;5886;374;1357;651;1950;1025;3307
351380;201708;41694;116261;35913;105628;6855;21449;16446;46852;23301;68301
351385;201708;277;797;192;616;30;101;65;195;95;296
351390;201708;1243;3811;1009;3327;264;1037;427;1252;691;2289
351400;201708;989;3076;886;2890;244;854;383;1227;627;2081
351410;201708;2432;7283;2057;6555;319;1045;1115;3473;1434;4518
351420;201708;311;852;205;648;47;142;52;165;99;307
351430;201708;795;2445;739;2342;96;347;542;1674;638;2021
351440;201708;3302;9701;2396;7711;456;1566;360;1018;816;2584
351450;201708;1563;4348;1211;3721;293;959;344;1091;637;2050
351460;201708;691;2018;601;1849;258;794;192;595;450;1389
351470;201708;1052;3013;894;2699;120;425;474;1339;594;1764
351480;201708;2750;8661;2445;8142;354;1444;1284;4086;1638;5530
351490;201708;1874;6020;1663;5570;163;684;1035;3273;1198;3957
351492;201708;316;986;262;845;20;76;133;396;153;472
351495;201708;214;675;164;542;26;95;71;222;97;317
351500;201708;32846;88702;24576;73806;5747;18356;10048;28916;15795;47272
351510;201708;10206;29544;8086;25302;1651;5582;4030;12213;5681;17795
351512;201708;503;1423;365;1115;53;157;164;480;217;637
351515;201708;2632;7402;1775;5675;387;1423;420;1251;807;2674
351518;201708;2263;6661;1560;5324;321;1226;619;1910;940;3136
351519;201708;764;2227;538;1726;95;345;118;267;213;612
351520;201708;885;2400;391;1332;62;238;119;356;181;594
351530;201708;380;1157;239;788;34;99;60;158;94;257
351535;201708;2363;5960;1784;5037;167;586;1101;2916;1268;3502
351540;201708;1903;5423;1398;4426;471;1609;214;597;685;2206
351550;201708;5412;15741;3813;12082;664;2337;1576;4638;2240;6975
351560;201708;461;1466;397;1321;89;340;82;262;171;602
351565;201708;175;582;155;532;36;123;60;193;96;316
351570;201708;14947;43141;12203;37671;2100;7092;7046;20824;9146;27916
351580;201708;307;846;188;599;31;89;58;196;89;285
351590;201708;481;1208;283;802;32;103;138;365;170;468
351600;201708;1809;4880;1408;4137;195;638;768;2121;963;2759
351610;201708;695;1836;495;1479;53;195;247;630;300;825
351620;201708;19488;60004;15261;51586;2997;11455;4707;14211;7704;25666
351630;201708;23811;70126;20732;64918;4037;13411;11825;36138;15862;49549
351640;201708;14250;41174;11692;36613;1832;6406;6918;20910;8750;27316
351650;201708;446;1320;207;708;37;143;32;91;69;234
351660;201708;809;2515;566;1903;118;426;102;308;220;734
351670;201708;4236;13078;3379;11033;612;2165;1534;4692;2146;6857
351680;201708;564;1727;327;1098;68;217;57;201;125;418
351685;201708;440;1392;376;1255;94;294;151;509;245;803
351690;201708;1068;3099;757;2420;137;472;274;776;411;1248
351700;201708;1093;3172;936;2857;211;626;359;1092;570;1718
351710;201708;593;1903;484;1646;67;271;195;607;262;878
351720;201708;1604;4710;1113;3618;196;682;362;1130;558;1812
351730;201708;1109;3050;848;2615;145;519;368;1083;513;1602
351740;201708;4028;10799;3141;9058;576;1764;1244;3329;1820;5093
351750;201708;1272;3984;807;2908;148;584;252;906;400;1490
351760;201708;3297;10118;2550;8459;626;2266;689;2052;1315;4318
351770;201708;2173;6752;1808;6021;555;1900;623;2009;1178;3909
351780;201708;1428;3963;785;2497;131;461;160;479;291;940
351790;201708;1163;3215;972;2896;177;486;561;1698;738;2184
351800;201708;563;1234;291;750;43;125;102;238;145;363
351810;201708;1064;3007;887;2686;94;262;590;1764;684;2026
351820;201708;2632;8186;1898;6602;377;1429;211;723;588;2152
351830;201708;4513;13362;3457;11196;519;1960;1747;5392;2266;7352
351840;201708;6916;22846;5971;20885;1410;5347;2205;7365;3615;12712
351850;201708;2108;5600;1447;4437;234;870;554;1518;788;2388
351860;201708;3111;9820;2668;8893;590;2085;1215;3988;1805;6073
351870;201708;27398;79235;22459;70350;6977;22877;8237;25654;15214;48531
351880;201708;121359;364481;99952;322475;29150;100691;26172;80033;55322;180724
351885;201708;683;2267;616;2125;165;580;252;835;417;1415
351890;201708;628;1912;512;1688;124;432;74;204;198;636
351900;201708;1206;3636;980;3250;259;896;297;987;556;1883
351905;201708;453;1385;349;1171;46;171;160;488;206;659
351907;201708;20287;57882;16790;51309;1162;4334;11725;34727;12887;39061
351910;201708;1081;3233;859;2731;181;627;341;1006;522;1633
351920;201708;1007;2694;803;2370;107;377;401;1128;508;1505
351925;201708;1007;2955;816;2574;140;460;364;1063;504;1523
351930;201708;2870;8874;2740;8634;372;1543;2082;6222;2454;7765
351940;201708;1039;3011;832;2633;96;338;452;1422;548;1760
351950;201708;1590;4174;1131;3327;102;342;605;1726;707;2068
351960;201708;4744;13386;3513;11025;779;2650;1409;4326;2188;6976
351970;201708;5773;19991;5125;18718;1256;5057;2129;7346;3385;12403
351980;201708;939;2700;699;2182;126;442;306;866;432;1308
351990;201708;1522;4126;1153;3456;198;695;305;816;503;1511
352000;201708;2302;7345;2079;6867;314;1170;1107;3439;1421;4609
352010;201708;1802;5732;1538;5161;363;1318;238;838;601;2156
352020;201708;1502;4537;1265;4069;277;969;513;1544;790;2513
352030;201708;5030;14457;4127;13102;811;2872;2173;6801;2984;9673
352040;201708;2103;6533;1555;5343;328;1203;232;734;560;1937
352042;201708;3611;9638;2175;6666;425;1402;902;2704;1327;4106
352044;201708;1808;5386;1104;3910;185;711;239;800;424;1511
352050;201708;11820;35292;8051;26808;1873;7014;1364;3996;3237;11010
352060;201708;740;2205;580;1860;106;373;231;691;337;1064
352070;201708;858;2043;657;1735;126;361;251;660;377;1021
352080;201708;473;1335;296;931;55;195;81;217;136;412
352090;201708;1356;4522;1084;3854;191;733;294;957;485;1690
352100;201708;3128;9288;2493;8104;581;2026;1033;3208;1614;5234
352110;201708;578;1963;485;1757;124;468;165;558;289;1026
352115;201708;506;1566;433;1422;71;238;236;786;307;1024
352120;201708;841;2639;683;2312;98;398;343;1055;441;1453
352130;201708;1912;5692;1227;4019;271;931;313;987;584;1918
352140;201708;1760;4946;1068;3477;157;552;380;1160;537;1712
352150;201708;777;2265;622;1968;153;493;301;939;454;1432
352160;201708;981;2672;739;2248;163;549;269;754;432;1303
352170;201708;2801;8314;2415;7445;512;1691;1115;3177;1627;4868
352180;201708;3121;8813;2622;7821;654;2082;951;2672;1605;4754
352190;201708;1209;3589;978;3132;158;593;313;866;471;1459
352200;201708;399;1322;301;1117;40;155;92;332;132;487
352210;201708;16603;44163;13669;39758;2099;6489;8621;25191;10720;31680
352215;201708;516;1517;470;1456;53;187;294;890;347;1077
352220;201708;14234;41970;10824;35492;3364;11780;2549;8292;5913;20072
352230;201708;12815;42114;10742;37929;3044;11781;3254;10784;6298;22565
352240;201708;11967;33923;9194;28919;2351;8315;2952;8390;5303;16705
352250;201708;20694;64571;17523;58438;5134;17859;6719;22104;11853;39963
352260;201708;5963;17704;4175;13899;715;2535;1905;6347;2620;8882
352265;201708;883;2696;758;2486;73;315;492;1535;565;1850
352270;201708;1650;5544;1339;4852;333;1265;355;1247;688;2512
352280;201708;2320;6652;1877;5902;255;974;909;2690;1164;3664
352290;201708;1160;3639;975;3193;180;698;406;1193;586;1891
352300;201708;1020;2898;742;2327;128;468;330;921;458;1389
352310;201708;46596;132749;36464;115057;9601;31282;15450;48880;25051;80162
352320;201708;5813;17272;4816;15178;1056;3600;1809;5084;2865;8684
352330;201708;2088;6440;1743;5943;503;1868;602;1955;1105;3823
352340;201708;5240;16113;3999;13761;1080;3983;952;3078;2032;7061
352350;201708;1727;5610;1513;5125;277;1080;542;1678;819;2758
352360;201708;1102;3248;972;3017;176;642;634;1866;810;2508
352370;201708;880;2908;787;2681;81;333;472;1553;553;1886
352380;201708;934;2876;775;2581;215;780;188;597;403;1377
352390;201708;19809;51372;13077;39034;2136;7157;6128;17130;8264;24287
352400;201708;3875;11010;2817;8972;731;2551;1046;3070;1777;5621
352410;201708;2951;8640;2467;7832;449;1560;1139;3463;1588;5023
352420;201708;907;2418;718;2064;133;418;275;766;408;1184
352430;201708;6570;19016;5466;17204;1703;5720;1806;5616;3509;11336
352440;201708;17145;51325;13870;44838;2995;10372;5546;17391;8541;27763
352450;201708;653;1950;418;1413;87;331;114;364;201;695
352460;201708;2526;7812;2043;6871;506;1850;613;1950;1119;3800
352470;201708;3984;10893;2904;8924;360;1243;1335;3789;1695;5032
352480;201708;4130;10869;3029;8866;581;1924;1210;3171;1791;5095
352490;201708;687;2315;528;1926;95;371;159;582;254;953
352500;201708;9082;24988;7285;21946;3633;11734;1264;2997;4897;14731
352510;201708;3120;9415;2449;8165;680;2458;690;2226;1370;4684
352520;201708;2157;7200;1872;6537;475;1765;760;2560;1235;4325
352530;201708;8852;27439;6428;21706;1493;5376;880;2381;2373;7757
352540;201708;513;1595;365;1257;72;263;90;299;162;562
352550;201708;853;2700;618;2188;128;502;136;445;264;947
352560;201708;633;1862;436;1400;81;260;87;241;168;501
352570;201708;1877;5913;1303;4669;345;1374;205;598;550;1972
352580;201708;849;2518;654;2119;105;388;218;634;323;1022
352585;201708;275;862;224;747;38;143;83;269;121;412
352590;201708;12132;36099;9505;30874;3176;10967;3254;9675;6430;20642
352600;201708;1900;5696;1477;4744;302;1042;598;1836;900;2878
352610;201708;3345;10055;2645;8799;626;2315;812;2509;1438;4824
352620;201708;5396;15822;4707;14695;1196;3840;2107;6564;3303;10404
352630;201708;643;1923;580;1787;123;455;257;713;380;1168
352640;201708;2710;7789;2228;6977;209;719;1457;4514;1666;5233
352650;201708;763;2283;559;1789;100;349;141;410;241;759
352660;201708;985;3425;835;3088;175;700;280;1017;455;1717
352670;201708;10984;32277;6647;22636;1531;5747;497;1620;2028;7367
352680;201708;3082;9917;2310;8175;466;1847;875;2856;1341;4703
352690;201708;32086;86568;23172;68991;2738;9180;12418;35017;15156;44197
352700;201708;596;1742;503;1599;158;543;182;550;340;1093
352710;201708;5691;16084;4140;13019;1048;3653;1381;4089;2429;7742
352720;201708;8083;25048;6937;22579;2649;8778;1493;4610;4142;13388
352725;201708;445;1217;223;717;23;90;93;267;116;357
352730;201708;2389;7553;2146;6921;451;1595;970;2801;1421;4396
352740;201708;2224;5765;1713;4960;214;709;960;2663;1174;3372
352750;201708;476;1333;254;847;42;157;56;161;98;318
352760;201708;1369;4465;1114;3814;243;902;410;1303;653;2205
352770;201708;807;2443;650;2103;147;525;222;676;369;1201
352780;201708;668;2202;529;1855;109;422;169;577;278;999
352790;201708;652;1821;448;1428;64;214;138;412;202;626
352800;201708;1154;4010;853;3179;191;751;209;711;400;1462
352810;201708;1087;2819;687;2031;132;397;242;690;374;1087
352820;201708;642;1692;447;1386;96;303;99;314;195;617
352830;201708;571;1616;302;959;40;133;41;103;81;236
352840;201708;4025;13106;3561;12147;1056;3777;1363;4470;2419;8247
352850;201708;10641;29341;7731;24631;2041;7016;2407;7467;4448;14483
352860;201708;872;2882;776;2664;166;619;291;955;457;1574
352870;201708;857;2205;555;1539;55;195;294;730;349;925
352880;201708;2299;6060;1602;4725;244;762;662;1743;906;2505
352885;201708;265;818;218;723;29;93;134;439;163;532
352890;201708;702;1786;465;1289;75;250;182;413;257;663
352900;201708;19758;56463;14311;45409;2830;9915;5212;15420;8042;25335
352910;201708;395;1115;218;722;22;83;41;110;63;193
352920;201708;2476;7135;1856;5870;306;1071;861;2518;1167;3589
352930;201708;5959;18077;4740;15454;935;3247;1662;5151;2597;8398
352940;201708;21815;68129;18050;59777;5932;21478;2091;6231;8023;27709
352950;201708;389;1102;238;794;49;169;28;88;77;257
352960;201708;641;1879;379;1259;64;243;124;368;188;611
352965;201708;372;1058;224;718;58;198;32;82;90;280
352970;201708;3270;8075;2603;7052;279;770;1727;4689;2006;5459
352980;201708;1213;3701;1014;3364;208;734;499;1665;707;2399
352990;201708;4139;12603;3598;11643;865;3179;1597;4842;2462;8021
353000;201708;451;1251;224;731;38;135;54;157;92;292
353010;201708;3005;8183;2160;6506;502;1680;605;1648;1107;3328
353020;201708;4066;10953;2335;7186;347;1155;740;2074;1087;3229
353030;201708;3700;10699;2868;9063;785;2631;554;1719;1339;4350
353040;201708;501;1391;411;1218;82;261;135;368;217;629
353050;201708;4988;16003;3961;13868;1034;3853;1377;4578;2411;8431
353060;201708;44093;124800;37921;114572;3917;14134;26109;75638;30026;89772
353070;201708;10300;31254;7499;25248;1713;6168;2080;6879;3793;13047
353080;201708;4924;15150;3508;12112;827;3120;897;2838;1724;5958
353090;201708;550;1828;494;1702;46;191;295;950;341;1141
353100;201708;302;857;132;456;19;68;22;62;41;130
353110;201708;7484;22645;6510;21049;1122;3995;3962;12783;5084;16778
353120;201708;645;1893;423;1382;77;284;116;329;193;613
353130;201708;2529;7083;1871;6011;567;1952;564;1775;1131;3727
353140;201708;2313;6239;1807;5276;272;880;927;2559;1199;3439
353150;201708;1631;4763;1278;4131;340;1113;358;1143;698;2256
353160;201708;693;1898;454;1436;82;281;147;409;229;690
353170;201708;474;1450;412;1369;88;386;203;616;291;1002
353180;201708;9154;25031;7377;22055;1109;3625;4399;12974;5508;16599
353190;201708;3677;10845;2971;9295;451;1556;1521;4414;1972;5970
353200;201708;1166;3802;830;2876;202;753;201;659;403;1412
353205;201708;358;1194;321;1100;85;329;146;479;231;808
353210;201708;1058;2590;679;1902;40;147;410;1095;450;1242
353215;201708;470;1416;380;1215;66;244;132;355;198;599
353220;201708;602;1829;473;1571;120;412;100;315;220;727
353230;201708;757;2355;677;2227;163;576;237;714;400;1290
353240;201708;2169;6690;1864;6093;275;1053;1080;3384;1355;4437
353250;201708;1105;2945;816;2400;131;403;354;1009;485;1412
353260;201708;923;2539;619;1953;131;453;171;503;302;956
353270;201708;651;1891;547;1672;86;259;244;715;330;974
353280;201708;674;2083;507;1681;111;398;136;422;247;820
353282;201708;1811;5574;1640;5229;232;800;913;2799;1145;3599
353284;201708;375;980;218;657;40;132;56;144;96;276
353286;201708;133;396;97;321;25;84;20;56;45;140
353290;201708;1034;3019;780;2522;90;362;430;1262;520;1624
353300;201708;1590;4761;1268;4065;238;887;458;1305;696;2192
353310;201708;258;727;203;636;41;143;82;237;123;380
353320;201708;619;1747;511;1536;58;188;300;872;358;1060
353325;201708;673;2138;502;1746;88;316;129;450;217;766
353330;201708;614;1719;431;1306;47;164;214;600;261;764
353340;201708;2998;8489;2006;6616;565;1976;550;1832;1115;3808
353350;201708;3405;10032;2474;7989;660;2267;512;1510;1172;3777
353360;201708;466;1507;415;1400;55;210;254;844;309;1054
353370;201708;608;1978;525;1798;60;227;290;946;350;1173
353380;201708;320;1039;261;907;49;180;79;265;128;445
353390;201708;6023;16245;4365;13189;893;2820;1533;4413;2426;7233
353400;201708;492;1493;401;1307;72;259;74;179;146;438
353410;201708;610;1772;508;1572;99;361;246;713;345;1074
353420;201708;592;1645;371;1128;89;269;55;146;144;415
353430;201708;2242;7314;1693;5993;439;1673;330;1086;769;2759
353440;201708;59502;182463;45747;152415;11580;40067;16701;53837;28281;93904
353450;201708;431;1214;312;953;57;203;113;315;170;518
353460;201708;3377;9605;2546;7930;309;1127;1063;3297;1372;4424
353470;201708;7576;22346;5627;18441;1232;4437;1485;4517;2717;8954
353475;201708;1481;4173;1102;3333;167;553;381;1040;548;1593
353480;201708;1394;4217;1238;3897;129;434;856;2633;985;3067
353490;201708;936;2714;692;2174;150;466;254;758;404;1224
353500;201708;1028;2683;838;2374;213;601;431;1221;644;1822
353510;201708;941;2985;696;2353;190;657;96;288;286;945
353520;201708;1165;3221;830;2614;120;426;364;1076;484;1502
353530;201708;2460;7014;2063;6250;265;912;1079;3089;1344;4001
353540;201708;2041;6102;1716;5517;389;1301;774;2427;1163;3728
353550;201708;6197;17280;4994;15166;816;2791;2596;7428;3412;10219
353560;201708;2146;6895;1758;6186;568;2137;400;1338;968;3475
353570;201708;532;1566;381;1251;87;282;166;533;253;815
353580;201708;2404;6858;2050;6231;411;1351;1117;3302;1528;4653
353590;201708;716;2111;480;1562;103;360;159;511;262;871
353600;201708;1806;4914;1548;4409;197;615;795;2164;992;2779
353610;201708;632;2131;478;1773;99;386;87;297;186;683
353620;201708;2383;7283;1893;6312;486;1700;460;1405;946;3105
353625;201708;477;1297;281;887;36;129;132;396;168;525
353630;201708;1422;4893;1112;4107;209;813;169;560;378;1373
353640;201708;1441;4043;1091;3343;138;487;571;1699;709;2186
353650;201708;8955;25808;6751;21181;1137;3772;2861;8533;3998;12305
353657;201708;309;937;258;838;36;116;94;272;130;388
353660;201708;1123;2799;804;2243;194;612;270;629;464;1241
353670;201708;3578;11216;3008;10047;835;3082;1136;3514;1971;6596
353680;201708;719;2202;573;1951;157;580;210;677;367;1257
353690;201708;525;1388;252;836;29;92;39;112;68;204
353700;201708;2040;6047;1743;5458;255;874;934;2763;1189;3637
353710;201708;3549;8438;1758;5419;364;1086;555;1643;919;2729
353715;201708;538;1519;377;1193;27;103;99;279;126;382
353720;201708;1955;5874;1627;5369;319;1169;813;2572;1132;3741
353730;201708;4299;12762;3348;10674;603;2096;1305;3799;1908;5895
353740;201708;1805;5181;1314;4216;333;1161;336;992;669;2153
353750;201708;933;3101;683;2513;156;612;138;501;294;1113
353760;201708;10900;28627;8862;25778;1367;4426;5436;15521;6803;19947
353770;201708;666;2062;338;1199;63;247;33;77;96;324
353780;201708;4217;14154;3636;12893;1085;4145;846;2892;1931;7037
353790;201708;2277;7562;1826;6611;504;2109;435;1414;939;3523
353800;201708;16588;49675;13188;43448;3006;10696;5193;16772;8199;27468
353810;201708;1050;3279;794;2708;145;572;244;789;389;1361
353820;201708;1519;4909;1282;4331;239;942;568;1801;807;2743
353830;201708;638;1707;494;1463;67;211;253;708;320;919
353850;201708;1687;5141;1415;4566;371;1229;479;1525;850;2754
353860;201708;2679;8425;2180;7309;596;2092;629;2048;1225;4140
353870;201708;28567;81704;20091;64396;3499;12433;7503;21862;11002;34295
353880;201708;2815;8686;2361;7813;312;1174;1269;4098;1581;5272
353890;201708;2359;5823;1654;4652;233;729;895;2400;1128;3129
353900;201708;834;2559;623;2146;136;489;180;596;316;1085
353910;201708;1912;6619;1763;6362;250;879;1226;4572;1476;5451
353920;201708;2295;6705;1596;5247;349;1267;290;829;639;2096
353930;201708;4595;13622;3257;11074;867;3216;516;1656;1383;4872
353940;201708;1128;3642;849;2977;167;627;230;753;397;1380
353950;201708;3171;9727;2672;8704;524;1879;1273;3828;1797;5707
353960;201708;604;1840;417;1416;93;307;106;339;199;646
353970;201708;603;1658;481;1450;51;169;291;849;342;1018
353980;201708;13880;40152;11564;35801;2179;7117;5962;17945;8141;25062
353990;201708;536;1525;432;1337;46;158;241;707;287;865
354000;201708;2460;6545;1480;4604;280;942;212;636;492;1578
354010;201708;368;1090;307;970;55;184;165;507;220;691
354020;201708;4122;12700;3486;11297;912;3212;1030;3011;1942;6223
354025;201708;880;2451;607;1915;122;399;177;571;299;970
354030;201708;497;1290;305;907;46;147;122;334;168;481
354040;201708;788;2070;517;1539;44;152;293;802;337;954
354050;201708;987;3046;744;2540;204;761;150;477;354;1238
354060;201708;4821;14697;3305;11274;869;3082;800;2542;1669;5624
354070;201708;2912;9406;2378;8199;606;2249;468;1448;1074;3697
354075;201708;2010;7113;1774;6575;361;1503;851;3039;1212;4542
354080;201708;1473;4372;1023;3375;192;686;295;855;487;1541
354085;201708;385;894;344;840;8;33;258;604;266;637
354090;201708;1408;4106;1311;3913;142;495;881;2593;1023;3088
354100;201708;14676;48060;12102;43002;3045;11576;4774;16548;7819;28124
354105;201708;971;2746;841;2552;135;416;531;1614;666;2030
354110;201708;704;1888;539;1648;165;560;126;333;291;893
354120;201708;1934;5317;1333;4060;223;731;481;1321;704;2052
354130;201708;6307;17757;4518;14258;1548;5232;259;620;1807;5852
354140;201708;26367;66073;16713;48701;3470;10824;4737;12684;8207;23508
354150;201708;3880;10197;2916;8462;596;1855;1164;3264;1760;5119
354160;201708;3458;10941;2665;9128;748;2678;763;2575;1511;5253
354165;201708;538;1718;450;1547;99;395;207;688;306;1083
354170;201708;1424;4438;1129;3717;157;566;528;1639;685;2205
354180;201708;485;1489;402;1300;70;255;155;425;225;680
354190;201708;1535;4742;1232;4085;228;824;387;1265;615;2089
354200;201708;967;2659;754;2274;88;285;361;1012;449;1297
354210;201708;670;2085;554;1865;75;301;293;904;368;1205
354220;201708;3081;8783;2523;7707;472;1543;1228;3621;1700;5164
354230;201708;689;2043;569;1852;85;342;285;841;370;1183
354240;201708;1287;4125;941;3321;171;645;205;681;376;1326
354250;201708;682;1870;440;1461;129;447;107;367;236;814
354260;201708;7589;22144;6125;19553;1603;5388;1865;6064;3468;11452
354270;201708;1177;3851;960;3382;191;721;312;1091;503;1812
354280;201708;715;2015;623;1858;110;408;351;953;461;1361
354290;201708;935;3236;837;2992;162;606;347;1233;509;1839
354300;201708;3796;11929;3452;11279;1081;3689;1237;3865;2318;7554
354310;201708;832;2520;675;2209;136;465;331;1059;467;1524
354320;201708;859;2427;610;1928;126;456;209;600;335;1056
354323;201708;518;1352;357;1042;48;132;129;354;177;486
354325;201708;1239;3977;919;3227;170;629;330;1091;500;1720
354330;201708;6714;19355;5287;16557;1016;3654;2528;7221;3544;10875
354340;201708;24280;72399;19515;63876;5416;19176;6724;21232;12140;40408
354350;201708;1101;3165;955;2871;180;622;536;1496;716;2118
354360;201708;488;1490;298;1065;56;180;28;105;84;285
354370;201708;1115;3666;947;3311;122;519;505;1703;627;2222
354380;201708;792;2357;596;1958;150;571;87;233;237;804
354390;201708;13756;38483;9309;29980;1815;6279;2039;6324;3854;12603
354400;201708;1641;5606;1317;4802;263;1034;395;1418;658;2452
354410;201708;5436;16392;4448;14444;1095;3828;1729;5410;2824;9238
354420;201708;1363;3931;974;3059;167;566;458;1368;625;1934
354425;201708;2224;6296;1852;5555;532;1660;521;1590;1053;3250
354430;201708;1379;4387;1225;4089;229;876;546;1731;775;2607
354440;201708;573;1661;391;1269;47;161;153;459;200;620
354450;201708;407;1168;248;811;33;117;45;133;78;250
354460;201708;1018;2778;697;2140;128;416;290;894;418;1310
354470;201708;603;1562;460;1286;34;127;225;555;259;682
354480;201708;765;2046;616;1795;74;234;361;992;435;1226
354490;201708;756;2468;610;2120;89;341;261;862;350;1203
354500;201708;2154;6723;1878;6277;647;2411;410;1334;1057;3745
354510;201708;836;2311;752;2147;109;293;427;1193;536;1486
354515;201708;267;869;211;747;43;182;80;273;123;455
354520;201708;8118;25749;4727;16011;839;3231;2038;6329;2877;9560
354530;201708;3542;11510;2984;10324;741;2776;1139;3840;1880;6616
354540;201708;1217;3583;959;3093;275;934;241;785;516;1719
354550;201708;483;1383;379;1189;74;251;195;586;269;837
354560;201708;1829;4964;1059;3241;152;485;475;1380;627;1865
354570;201708;1126;3105;504;1581;96;330;79;210;175;540
354580;201708;10851;30060;7370;23440;1289;4454;2844;8479;4133;12933
354600;201708;1689;5263;1403;4712;255;962;712;2309;967;3271
354610;201708;371;1056;207;669;36;126;53;151;89;277
354620;201708;432;1353;338;1178;58;249;138;419;196;668
354625;201708;313;962;195;679;26;98;46;129;72;227
354630;201708;2197;7120;1886;6461;746;2722;214;681;960;3403
354640;201708;3216;10453;2461;8667;499;1954;466;1487;965;3441
354650;201708;888;2600;755;2319;95;323;488;1502;583;1825
354660;201708;2509;6829;1799;5604;147;550;1169;3589;1316;4139
354670;201708;1131;3455;859;2806;215;765;213;629;428;1394
354680;201708;4565;14343;4119;13462;1095;3737;1897;6143;2992;9880
354690;201708;762;2431;518;1848;105;395;113;381;218;776
354700;201708;1062;2965;735;2255;140;475;292;787;432;1262
354710;201708;527;1539;382;1223;37;134;179;522;216;656
354720;201708;270;726;145;453;43;137;21;60;64;197
354730;201708;9523;28850;7123;24194;1308;4956;3387;10908;4695;15864
354740;201708;323;928;132;479;15;72;19;63;34;135
354750;201708;2488;7297;1783;5954;383;1450;636;1968;1019;3418
354760;201708;1893;5868;1497;5026;477;1708;229;758;706;2466
354765;201708;314;875;150;504;15;52;31;98;46;150
354770;201708;2402;6467;1733;5274;504;1635;534;1557;1038;3192
354780;201708;56828;154647;46835;134061;7267;23242;24592;65729;31859;88971
354790;201708;827;2658;719;2438;113;401;352;1157;465;1558
354800;201708;2479;7032;2068;6408;446;1518;966;2882;1412;4400
354805;201708;1063;3103;779;2477;88;318;247;683;335;1001
354810;201708;560;1760;345;1270;60;248;74;245;134;493
354820;201708;956;3157;776;2767;151;607;174;561;325;1168
354830;201708;469;1225;332;974;113;332;103;284;216;616
354840;201708;732;2082;524;1632;91;291;251;752;342;1043
354850;201708;17947;52986;13152;43493;2393;9036;6232;19055;8625;28091
354860;201708;1353;4146;1109;3739;252;964;358;1078;610;2042
354870;201708;47402;134187;40955;121469;7981;25794;19580;55854;27561;81648
354880;201708;4587;12437;2419;7559;364;1303;795;2057;1159;3360
354890;201708;15858;44895;13236;40145;2646;8742;6008;17429;8654;26171
354900;201708;486;1417;322;1060;47;162;71;222;118;384
354910;201708;6346;18585;3748;13093;675;2633;225;716;900;3349
354920;201708;390;1137;234;796;38;156;42;119;80;275
354925;201708;259;784;132;473;33;117;22;70;55;187
354930;201708;336;871;193;617;28;88;85;270;113;358
354940;201708;1707;6013;1401;5208;484;1903;132;454;616;2357
354950;201708;1480;4510;1231;4080;144;605;710;2239;854;2844
354960;201708;810;2341;652;2090;126;455;302;919;428;1374
354970;201708;3975;12670;3411;11509;582;2203;1812;5874;2394;8077
354980;201708;27338;71595;18881;56382;2904;10003;8411;23093;11315;33096
354990;201708;57487;162574;44470;137288;6801;22901;22266;65931;29067;88832
354995;201708;1972;5702;1606;5107;375;1275;792;2441;1167;3716
355000;201708;1369;4302;1209;4001;295;1103;233;638;528;1741
355010;201708;3456;10607;2534;8363;822;2898;395;1295;1217;4193
355020;201708;3130;9905;2378;8378;827;3189;624;2084;1451;5273
355030;201708;1261029;3312949;1011344;2827933;207242;630808;441420;1157021;648662;1787829
355040;201708;2702;8091;2385;7535;408;1366;1467;4588;1875;5954
355050;201708;1094;3182;840;2681;238;770;157;473;395;1243
355060;201708;4700;14827;3779;12921;765;2968;1399;4311;2164;7279
355070;201708;7296;21586;6205;19710;1069;3900;3274;9680;4343;13580
355080;201708;885;2950;611;2311;110;477;35;112;145;589
355090;201708;1109;3625;915;3216;177;647;309;1089;486;1736
355100;201708;17090;50956;14057;45838;3141;11189;7429;23493;10570;34682
355110;201708;1176;3715;967;3326;348;1276;176;581;524;1857
355120;201708;644;1897;485;1596;89;342;183;565;272;907
355130;201708;650;1633;290;854;40;127;90;241;130;368
355140;201708;1243;3884;1147;3724;222;797;677;2208;899;3005
355150;201708;3733;10727;3021;9454;594;1974;1393;4342;1987;6316
355160;201708;1799;5534;1472;4950;407;1495;351;1127;758;2622
355170;201708;8479;23903;6727;20963;2144;7001;2160;6846;4304;13847
355180;201708;2780;8434;2173;7297;501;1995;671;2023;1172;4018
355190;201708;1552;4672;1299;4194;385;1360;473;1597;858;2957
355200;201708;809;2756;717;2577;325;1266;145;470;470;1736
355210;201708;2890;8693;2545;7965;317;1196;1574;4653;1891;5849
355220;201708;39177;115277;31904;100650;9712;32369;8884;25763;18596;58132
355230;201708;1462;3874;847;2582;163;480;194;551;357;1031
355240;201708;24386;68735;16974;53568;3611;12032;5936;18337;9547;30369
355250;201708;31249;93565;25371;82410;6917;23999;8572;27042;15489;51041
355255;201708;888;2392;527;1657;104;340;147;453;251;793
355260;201708;1268;3657;1036;3239;185;675;519;1496;704;2171
355270;201708;1613;4994;1314;4300;271;952;554;1697;825;2649
355280;201708;28349;79656;22228;67544;4159;13821;9154;26358;13313;40179
355290;201708;908;2818;700;2311;174;571;182;558;356;1129
355300;201708;1332;4184;1104;3692;241;859;314;1024;555;1883
355310;201708;1047;3056;810;2635;119;427;412;1346;531;1773
355320;201708;609;1810;515;1620;102;382;189;496;291;878
355330;201708;1975;5843;1450;4798;245;872;723;2288;968;3160
355340;201708;2953;7261;2606;6748;379;983;1666;4277;2045;5260
355350;201708;1346;4343;1033;3648;233;905;299;1026;532;1931
355360;201708;1224;3644;1086;3329;130;405;738;2312;868;2717
355365;201708;346;993;191;669;43;132;34;122;77;254
355370;201708;6957;17751;5403;15671;1260;3862;2309;7092;3569;10954
355380;201708;3183;9274;2477;7783;504;1700;647;1762;1151;3462
355385;201708;1073;3371;960;3137;246;868;363;1111;609;1979
355390;201708;778;2279;596;1890;113;383;215;607;328;990
355395;201708;1925;5752;1414;4551;227;745;567;1726;794;2471
355400;201708;9516;30558;8070;27547;2439;9007;2113;6763;4552;15770
355410;201708;19694;60679;15128;51503;4182;15496;2889;9883;7071;25379
355420;201708;728;2558;641;2363;169;731;153;560;322;1291
355430;201708;3848;10277;3042;8870;616;1915;1418;4046;2034;5961
355440;201708;906;2705;639;2100;121;409;175;522;296;931
355450;201708;3917;11055;2331;7584;472;1597;655;1986;1127;3583
355460;201708;576;1529;373;1156;67;251;139;357;206;608
355465;201708;366;1135;270;902;53;190;60;184;113;374
355470;201708;1013;2896;622;2044;177;594;181;580;358;1174
355475;201708;204;584;191;551;26;95;139;381;165;476
355480;201708;3125;10346;2805;9718;556;2155;1463;4886;2019;7041
355490;201708;1029;2941;635;2061;88;301;196;605;284;906
355495;201708;835;2656;685;2353;149;562;182;601;331;1163
355500;201708;7150;20714;4703;15205;804;2809;971;2939;1775;5748
355510;201708;1888;4988;1031;3262;144;498;273;763;417;1261
355520;201708;428;1007;213;594;23;70;105;276;128;346
355530;201708;481;1119;185;541;19;66;47;112;66;178
355535;201708;627;1862;494;1623;136;510;139;394;275;904
355540;201708;8527;25731;7813;24573;1700;5706;4282;13123;5982;18829
355550;201708;761;2308;619;2017;102;359;238;761;340;1120
355560;201708;1200;3573;711;2434;146;534;44;134;190;668
355570;201708;241;740;129;468;23;99;21;68;44;167
355580;201708;1266;3433;850;2649;144;521;344;1016;488;1537
355590;201708;221;597;172;509;25;86;90;255;115;341
355600;201708;1500;4184;1084;3339;290;989;335;957;625;1946
355610;201708;1712;4684;1252;3804;206;662;549;1605;755;2267
355620;201708;4577;13912;3628;11748;558;2115;1664;4884;2222;6999
355630;201708;2772;8005;1878;6237;405;1411;564;1880;969;3291
355635;201708;1000;3076;842;2819;108;393;538;1862;646;2255
355640;201708;2942;9210;2113;7509;473;1786;366;1274;839;3060
355645;201708;4052;12777;3443;11778;467;1902;2046;6838;2513;8740
355650;201708;7270;21376;6265;19465;1294;4519;3505;10111;4799;14630
355660;201708;1327;4004;1052;3406;153;609;508;1451;661;2060
355670;201708;3085;9439;2198;7264;389;1467;922;2656;1311;4123
355680;201708;1916;6067;1200;4247;322;1212;113;358;435;1570
355690;201708;555;1766;389;1407;116;443;17;36;133;479
355695;201708;249;815;146;526;13;53;16;49;29;102
355700;201708;5877;18601;4988;16594;1285;4345;1932;6253;3217;10598
355710;201708;9714;23916;5809;16720;1145;3486;1627;4347;2772;7833
355715;201708;388;1145;239;786;65;232;51;155;116;387
355720;201708;1506;4855;1247;4297;267;974;444;1376;711;2350
355730;201708;885;2848;742;2508;217;734;212;672;429;1406
410010;201708;1374;4143;1123;3565;254;889;186;588;440;1477
410020;201708;1188;3771;994;3341;308;1034;300;1012;608;2046
410030;201708;1201;3903;996;3434;259;930;255;886;514;1816
410040;201708;10099;32160;8630;29360;2000;7487;2703;9009;4703;16496
410045;201708;1057;2881;718;2241;117;417;212;595;329;1012
410050;201708;2773;7419;1755;5472;437;1437;230;641;667;2078
410060;201708;2277;6811;1893;6010;432;1412;726;2304;1158;3716
410070;201708;1769;4879;1327;3999;317;1055;416;1193;733;2248
410080;201708;1458;4084;1127;3463;200;677;447;1322;647;1999
410090;201708;1025;3054;950;2907;150;485;463;1468;613;1953
410100;201708;2533;7742;1872;6091;325;1213;267;805;592;2018
410105;201708;366;1115;235;794;37;154;39;105;76;259
410110;201708;3209;8980;2401;7341;369;1239;768;2255;1137;3494
410115;201708;544;1454;410;1207;77;243;141;383;218;626
410120;201708;2530;8532;2323;8104;916;3369;525;1805;1441;5174
410130;201708;1067;3243;994;3092;356;1232;272;713;628;1945
410140;201708;17940;45981;11554;34458;2354;7713;2432;6757;4786;14470
410150;201708;16524;41830;8560;25351;1653;5235;1346;3795;2999;9030
410160;201708;2987;8990;2641;8325;584;2037;952;3035;1536;5072
410165;201708;723;2096;580;1758;86;276;287;812;373;1088
410170;201708;2360;6653;1742;5248;472;1557;228;642;700;2199
410180;201708;12107;37397;10238;33163;2023;7023;4543;13743;6566;20766
410185;201708;542;1496;397;1218;80;250;101;286;181;536
410190;201708;2106;6023;1668;5103;355;1173;309;883;664;2056
410200;201708;4182;11129;2829;8566;592;2044;460;1325;1052;3369
410210;201708;2726;7949;1929;6188;306;1110;432;1146;738;2256
410220;201708;676;1805;482;1444;63;223;131;394;194;617
410230;201708;1543;4700;1310;4215;267;969;525;1600;792;2569
410240;201708;4460;13218;3922;12074;1166;4036;535;1596;1701;5632
410250;201708;2805;7492;1926;5765;463;1479;391;1168;854;2647
410260;201708;1707;4662;1287;3961;268;933;547;1621;815;2554
410270;201708;580;1582;445;1313;47;156;204;579;251;735
410275;201708;769;2333;516;1714;80;280;208;687;288;967
410280;201708;2147;6165;1505;4802;322;1130;410;1185;732;2315
410290;201708;3457;10249;2742;8803;612;1993;968;3126;1580;5119
410300;201708;748;2035;584;1697;103;328;250;652;353;980
410302;201708;461;1239;257;827;25;85;133;430;158;515
410304;201708;1277;3926;1148;3641;278;942;480;1522;758;2464
410305;201708;1932;5030;1470;4261;362;1121;649;1835;1011;2956
410310;201708;2359;7304;2044;6740;432;1576;650;2141;1082;3717
410315;201708;794;2119;448;1479;91;323;125;393;216;716
410320;201708;1200;3600;780;2624;103;404;104;316;207;720
410322;201708;594;1710;338;1114;50;165;81;257;131;422
410330;201708;1437;3879;1108;3234;265;818;257;745;522;1563
410335;201708;942;2718;788;2406;126;443;330;909;456;1352
410337;201708;831;2168;586;1697;89;275;206;548;295;823
410340;201708;555;1562;375;1105;54;184;149;369;203;553
410345;201708;2107;5872;1308;4136;288;936;306;921;594;1857
410347;201708;742;1939;538;1566;57;195;166;449;223;644
410350;201708;1196;3518;889;2890;141;497;239;718;380;1215
410360;201708;4147;10772;3215;9131;335;1133;1793;4927;2128;6060
410370;201708;12314;35426;8750;26959;1451;4939;2719;7347;4170;12286
410380;201708;1403;3997;1208;3570;157;573;458;1288;615;1861
410390;201708;2630;7539;1878;5977;562;1904;364;1034;926;2938
410395;201708;956;2992;797;2654;188;704;334;1108;522;1812
410400;201708;4586;13883;3727;12040;737;2571;1345;4137;2082;6708
410405;201708;867;2357;694;2053;168;520;274;792;442;1312
410410;201708;1252;3798;1213;3744;271;1033;664;1966;935;2999
410420;201708;7108;22632;5770;19607;1356;5076;994;2996;2350;8072
410425;201708;2699;8397;2016;6927;385;1410;417;1337;802;2747
410430;201708;14248;37881;10302;30547;1839;5945;2938;8194;4777;14139
410440;201708;3040;10308;2716;9660;504;1859;1379;5171;1883;7030
410442;201708;2649;8631;2319;7911;714;2580;625;2078;1339;4658
410445;201708;2384;7465;1995;6695;478;1745;597;2066;1075;3811
410450;201708;1972;5536;1494;4564;333;1108;250;607;583;1715
410460;201708;1714;4903;1332;4207;331;1124;348;1030;679;2154
410465;201708;2419;7671;1984;6725;453;1569;637;2078;1090;3647
410470;201708;1869;5810;1448;4843;332;1225;271;904;603;2129
410480;201708;32652;89362;19514;62328;3175;11010;1738;4789;4913;15799
410490;201708;11822;35146;8647;28311;1835;6528;2372;7201;4207;13729
410500;201708;1630;4964;1244;4094;388;1431;177;488;565;1919
410510;201708;2477;6507;1653;4843;299;882;532;1463;831;2345
410520;201708;3098;10421;2884;9983;808;2877;1259;4433;2067;7310
410530;201708;1615;4444;945;2860;179;570;115;279;294;849
410540;201708;3003;8714;2132;6870;383;1306;788;2518;1171;3824
410550;201708;6583;18813;4603;14480;909;3138;697;1937;1606;5075
410560;201708;1340;3863;1047;3289;247;849;360;1028;607;1877
410570;201708;2724;8368;2304;7584;631;2310;454;1574;1085;3884
410580;201708;23385;67939;18814;58893;4204;14671;6310;18295;10514;32966
410590;201708;1388;4261;907;2974;155;541;196;571;351;1112
410600;201708;1874;5330;1472;4540;361;1104;469;1484;830;2588
410610;201708;784;2200;597;1837;61;211;213;625;274;836
410620;201708;1881;6123;1285;4627;297;1149;121;373;418;1522
410630;201708;2497;7371;1682;5487;353;1260;152;389;505;1649
410640;201708;3927;10579;2932;8745;785;2631;427;1172;1212;3803
410645;201708;1154;3836;1062;3674;452;1616;249;933;701;2549
410650;201708;2189;6623;1715;5588;512;1765;344;1021;856;2786
410655;201708;1377;4846;1129;4354;57;211;734;3117;791;3328
410657;201708;795;2188;524;1605;108;352;173;469;281;821
410660;201708;3131;8684;1730;5519;341;1101;220;680;561;1781
410670;201708;953;2563;641;1900;123;368;244;703;367;1071
410680;201708;2923;9244;2178;7372;596;1996;491;1769;1087;3765
410685;201708;648;1816;547;1634;88;302;295;841;383;1143
410690;201708;121920;341736;85141;265079;16113;55514;21986;59818;38099;115332
410700;201708;2210;6384;1978;5936;456;1446;851;2419;1307;3865
410710;201708;948;2703;632;2032;123;404;212;630;335;1034
410712;201708;819;2398;695;2163;216;730;241;739;457;1469
410715;201708;936;2975;641;2224;136;492;158;538;294;1030
410720;201708;2963;8737;2330;7362;414;1451;402;1128;816;2579
410725;201708;1134;3150;766;2420;130;439;118;344;248;783
410730;201708;540;1528;413;1281;109;368;69;212;178;580
410740;201708;897;2632;633;2095;114;418;248;817;362;1235
410750;201708;1889;5399;1540;4673;311;1023;498;1409;809;2432
410752;201708;327;861;152;468;23;76;48;123;71;199
410753;201708;361;1063;221;736;25;88;34;96;59;184
410754;201708;1207;3326;1037;3053;62;177;640;2076;702;2253
410755;201708;818;2034;580;1633;65;212;302;790;367;1002
410760;201708;2667;7751;2248;7021;618;2072;614;1914;1232;3986
410765;201708;15025;44688;11624;38025;1951;7185;1127;3457;3078;10642
410770;201708;944;2535;661;1992;135;417;185;552;320;969
410773;201708;1370;3836;1216;3606;191;643;844;2451;1035;3094
410775;201708;1474;4122;1324;3887;265;851;469;1335;734;2186
410780;201708;592;1580;371;1112;89;273;90;296;179;569
410785;201708;794;2377;651;2083;170;596;177;527;347;1123
410790;201708;471;1522;400;1341;119;425;43;109;162;534
410800;201708;3021;7340;2384;6318;265;780;963;2479;1228;3259
410810;201708;342;1012;273;875;41;155;114;360;155;515
410820;201708;809;2385;580;1843;132;443;77;230;209;673
410830;201708;30672;84769;24026;73024;6512;21908;7353;21209;13865;43117
410832;201708;1055;2971;901;2663;121;443;488;1342;609;1785
410840;201708;6921;19455;4443;14330;1041;3719;445;1122;1486;4841
410845;201708;1230;3583;1003;3125;217;759;331;966;548;1725
410850;201708;2650;7832;2314;7244;521;1821;837;2619;1358;4440
410855;201708;597;1628;436;1300;56;195;181;500;237;695
410860;201708;4032;11170;3194;9509;579;1854;1012;2867;1591;4721
410865;201708;1498;4824;1407;4660;347;1191;738;2548;1085;3739
410870;201708;1256;3685;1139;3502;110;372;747;2325;857;2697
410880;201708;3829;11878;3141;10441;609;2211;437;1490;1046;3701
410890;201708;943;3007;727;2537;159;609;134;460;293;1069
410895;201708;1084;3657;954;3355;369;1403;166;545;535;1948
410900;201708;944;2576;629;1942;92;314;161;431;253;745
410910;201708;392;990;260;730;20;67;134;345;154;412
410920;201708;857;2354;684;2064;168;574;219;649;387;1223
410930;201708;1606;4730;1313;4123;363;1316;303;904;666;2220
410940;201708;21866;67722;17960;60109;5371;19468;3323;11345;8694;30813
410950;201708;1868;5836;1717;5588;107;395;1350;4348;1457;4743
410960;201708;7914;21477;4930;15805;1357;4769;1164;3593;2521;8362
410965;201708;1103;3173;855;2663;189;614;328;961;517;1575
410970;201708;4260;12393;3245;10376;827;3078;482;1386;1309;4464
410975;201708;1597;4420;1212;3662;229;807;405;1191;634;1998
410980;201708;6484;17903;4304;13642;670;2325;1449;4411;2119;6736
410990;201708;1056;3023;689;2235;202;734;124;341;326;1075
411000;201708;474;1417;340;1121;46;169;75;201;121;370
411005;201708;492;1432;313;1016;56;195;50;151;106;346
411007;201708;2393;7352;2080;6716;531;1816;598;1905;1129;3721
411010;201708;4195;13709;3687;12595;1045;3794;384;1206;1429;5000
411020;201708;2488;7448;2141;6832;643;2218;611;1862;1254;4080
411030;201708;703;1856;482;1367;89;261;144;373;233;634
411040;201708;793;2211;352;1104;63;212;52;144;115;356
411050;201708;1966;6659;1731;6128;511;1947;244;753;755;2700
411060;201708;1678;4891;1226;3929;252;959;191;532;443;1491
411065;201708;338;979;261;826;54;176;96;312;150;488
411070;201708;6522;18719;5182;16068;1139;3868;1549;4511;2688;8379
411080;201708;2233;6433;1922;5871;545;1769;418;1282;963;3051
411090;201708;845;2181;580;1707;63;214;95;251;158;465
411095;201708;1583;4208;1153;3394;192;621;350;957;542;1578
411100;201708;1190;3445;863;2727;115;436;212;662;327;1098
411110;201708;585;1696;286;983;27;98;18;47;45;145
411120;201708;1624;4822;1217;3901;362;1334;236;628;598;1962
411125;201708;4409;13998;4126;13451;1021;3466;1665;5519;2686;8985
411130;201708;712;2025;513;1592;115;364;157;523;272;887
411140;201708;2291;7469;1916;6603;460;1672;748;2627;1208;4299
411150;201708;4054;11271;2991;9132;646;2166;267;670;913;2836
411155;201708;1002;2730;692;2138;86;286;279;809;365;1095
411160;201708;291;816;221;675;43;127;47;156;90;283
411170;201708;762;2335;601;1960;135;461;190;619;325;1080
411180;201708;5758;16610;4603;14393;919;3139;1568;4847;2487;7986
411190;201708;1453;4111;1168;3502;277;909;250;636;527;1545
411200;201708;4600;13250;3577;11394;962;3287;967;2980;1929;6267
411210;201708;2083;5701;1647;4933;463;1554;181;465;644;2019
411220;201708;960;2682;781;2336;172;574;278;762;450;1336
411230;201708;1249;3431;804;2560;178;600;192;595;370;1195
411240;201708;1616;3843;910;2622;130;388;385;1054;515;1442
411250;201708;2065;5989;1664;5251;434;1526;464;1444;898;2970
411260;201708;358;933;226;686;31;97;88;239;119;336
411270;201708;1804;5488;1556;4969;267;974;680;2067;947;3041
411275;201708;1387;3914;1060;3224;229;735;273;770;502;1505
411280;201708;1573;4468;1007;3208;177;635;170;477;347;1112
411290;201708;754;2141;546;1741;107;336;190;610;297;946
411295;201708;1047;2845;900;2561;155;485;332;922;487;1407
411300;201708;1209;3078;797;2284;76;240;278;719;354;959
411310;201708;871;2307;688;1999;48;145;236;678;284;823
411320;201708;5186;14807;3746;12054;926;3072;765;2319;1691;5391
411325;201708;1538;4752;1361;4375;253;840;673;2208;926;3048
411330;201708;3166;9603;2557;8356;732;2619;603;1992;1335;4611
411340;201708;820;2418;526;1703;56;217;207;643;263;860
411342;201708;711;1965;573;1688;141;444;182;492;323;936
411345;201708;1024;2996;873;2704;163;569;449;1382;612;1951
411350;201708;2854;8325;2082;6715;559;1998;198;625;757;2623
411360;201708;586;1474;408;1184;57;205;147;370;204;575
411370;201708;47282;130101;37165;111357;4855;16751;17531;48710;22386;65461
411373;201708;1488;4364;1265;3973;210;735;448;1421;658;2156
411375;201708;1149;3081;839;2497;152;489;250;684;402;1173
411380;201708;1099;2971;704;2055;111;344;229;597;340;941
411390;201708;1803;5234;1405;4307;254;855;424;1180;678;2035
411400;201708;2235;6099;1770;5168;336;1093;588;1608;924;2701
411410;201708;2179;6468;1640;5249;378;1337;332;928;710;2265
411420;201708;4189;11472;2726;8465;420;1456;414;1022;834;2478
411430;201708;3398;9873;2792;8849;640;2187;1200;3705;1840;5892
411435;201708;513;1556;383;1268;93;311;127;392;220;703
411440;201708;2865;8874;2457;8013;660;2264;567;1938;1227;4202
411450;201708;2719;7639;2173;6712;420;1328;1059;3367;1479;4695
411460;201708;3738;10652;2045;6833;338;1302;200;596;538;1898
411470;201708;811;2384;551;1784;99;347;96;281;195;628
411480;201708;4643;13779;3429;11346;730;2629;624;1940;1354;4569
411490;201708;1517;4367;1223;3817;226;805;342;944;568;1749
411500;201708;1862;4882;1299;3874;230;783;356;1023;586;1806
411510;201708;2062;5994;1700;5260;431;1464;318;989;749;2453
411520;201708;24945;67527;15233;46937;2511;8379;3682;10131;6193;18510
411530;201708;980;2704;668;2111;118;422;219;655;337;1077
411535;201708;490;1468;222;786;25;111;17;42;42;153
411540;201708;3079;8189;2218;6420;477;1494;586;1542;1063;3036
411545;201708;1028;3221;898;2954;105;380;553;1859;658;2239
411550;201708;765;2058;615;1808;136;447;96;261;232;708
411560;201708;2306;6684;1541;4975;233;833;102;248;335;1081
411570;201708;7457;19152;5338;15708;1168;3900;1212;3559;2380;7459
411573;201708;845;2395;768;2269;73;231;476;1398;549;1629
411575;201708;1649;4953;1385;4417;314;1068;401;1250;715;2318
411580;201708;4268;11559;2647;8517;313;1233;330;897;643;2130
411585;201708;839;2628;408;1444;71;259;57;178;128;437
411590;201708;377;1110;307;975;43;150;123;355;166;505
411600;201708;328;903;223;728;49;191;79;247;128;438
411605;201708;1689;4598;1112;3380;177;619;406;1152;583;1771
411610;201708;2278;6338;1717;5175;372;1193;592;1715;964;2908
411620;201708;2958;8816;2635;8300;522;1803;1393;4334;1915;6137
411630;201708;610;1620;389;1228;82;309;57;131;139;440
411640;201708;481;1450;354;1139;48;138;107;343;155;481
411650;201708;223;685;164;564;32;113;25;84;57;197
411660;201708;960;2537;680;2016;67;214;335;959;402;1173
411670;201708;1152;3151;888;2600;158;485;285;789;443;1274
411680;201708;1590;4557;1306;4022;240;834;596;1815;836;2649
411690;201708;3492;10001;2707;8523;576;1891;698;2279;1274;4170
411695;201708;727;2296;550;1874;91;337;165;580;256;917
411700;201708;1668;4730;1133;3640;229;805;154;449;383;1254
411705;201708;1856;6337;1637;5899;387;1360;822;3145;1209;4505
411710;201708;1764;5018;1385;4265;355;1172;206;639;561;1811
411720;201708;956;2619;748;2204;114;361;227;624;341;985
411721;201708;814;2335;634;1941;147;459;103;304;250;763
411722;201708;696;2078;450;1505;89;356;114;297;203;653
411725;201708;1398;4363;863;3025;191;719;152;527;343;1246
411727;201708;1738;5022;1216;3869;334;1111;181;510;515;1621
411729;201708;650;1673;438;1277;100;300;101;249;201;549
411730;201708;5219;15056;4323;13226;1361;4332;1128;3411;2489;7743
411740;201708;651;1828;368;1181;67;239;67;184;134;423
411745;201708;913;2657;694;2175;117;400;160;453;277;853
411750;201708;5202;15253;3988;12539;623;2159;1531;4562;2154;6721
411760;201708;7940;22594;6583;20250;2166;7084;1344;4284;3510;11368
411770;201708;3494;11073;2791;9444;769;2751;392;1280;1161;4031
411780;201708;2980;8879;2678;8307;669;2255;1155;3639;1824;5894
411790;201708;3447;9555;2209;6939;527;1828;366;1070;893;2898
411800;201708;1156;3322;773;2442;106;363;114;324;220;687
411810;201708;1770;4895;1417;4207;253;843;625;1730;878;2573
411820;201708;13317;42413;11181;37846;3784;13257;2754;9457;6538;22714
411830;201708;551;1386;381;1093;96;305;35;118;131;423
411840;201708;10747;30015;7769;24035;1618;5417;1678;5106;3296;10523
411845;201708;523;1581;310;1024;57;221;23;61;80;282
411850;201708;7859;22668;6243;19444;1725;5827;1203;3571;2928;9398
411860;201708;903;2704;697;2252;141;489;181;543;322;1032
411870;201708;862;2747;573;1960;106;394;103;315;209;709
411880;201708;2234;6391;1701;5400;446;1558;275;825;721;2383
411885;201708;1040;2828;826;2459;144;519;258;702;402;1221
411890;201708;1183;3541;799;2638;127;483;61;156;188;639
411900;201708;944;2910;597;2032;143;485;58;208;201;693
411910;201708;1180;3744;885;3068;247;911;219;713;466;1624
411915;201708;18060;47774;11270;34544;2085;6943;2551;7032;4636;13975
411920;201708;931;3065;804;2754;237;923;120;345;357;1268
411925;201708;621;1710;409;1310;105;356;93;279;198;635
411930;201708;5812;19010;5084;17546;2351;8814;374;1326;2725;10140
411940;201708;3241;10592;2755;9507;708;2567;577;1844;1285;4411
411950;201708;13003;39701;11025;35894;2390;8351;4781;15210;7171;23561
411960;201708;5625;16131;5021;14973;1041;3396;1881;5339;2922;8735
411965;201708;551;1522;387;1237;72;269;95;306;167;575
411970;201708;832;2224;703;2038;138;382;369;1180;507;1562
411980;201708;1660;4787;1403;4282;339;1092;418;1249;757;2341
411990;201708;34970;105244;25887;86083;5992;21946;7052;22285;13044;44231
411995;201708;2686;7779;2206;6939;632;2251;569;1650;1201;3901
412000;201708;2363;5756;1763;4734;189;614;944;2288;1133;2902
412010;201708;715;2354;545;1939;78;315;121;374;199;689
412015;201708;644;1875;529;1646;79;244;249;786;328;1030
412020;201708;420;1255;259;869;47;168;76;232;123;400
412030;201708;802;2411;565;1909;81;309;180;567;261;876
412033;201708;933;2746;666;2144;85;285;218;746;303;1031
412035;201708;977;2642;613;1980;111;382;226;709;337;1091
412040;201708;624;1845;441;1457;72;247;79;253;151;500
412050;201708;1746;4897;1297;4013;222;784;297;912;519;1696
412060;201708;7219;23691;6376;21925;1913;7085;1508;5043;3421;12128
412065;201708;803;2361;607;1951;116;399;171;525;287;924
412070;201708;1354;3574;997;2838;146;445;405;1136;551;1581
412080;201708;1612;4912;986;3442;126;510;35;98;161;608
412085;201708;445;1280;154;532;17;62;11;30;28;92
412090;201708;5082;14593;4592;13707;1061;3232;2300;7015;3361;10247
412100;201708;1874;5618;1498;4886;444;1564;295;965;739;2529
412110;201708;961;2677;668;2041;136;454;140;437;276;891
412120;201708;1772;5850;1483;5190;357;1371;400;1193;757;2564
412125;201708;697;2213;597;1982;140;497;179;569;319;1066
412130;201708;622;1828;456;1442;74;259;104;342;178;601
412135;201708;557;1574;300;934;47;148;95;270;142;418
412140;201708;1697;4789;1262;3922;268;918;227;631;495;1549
412150;201708;3100;8628;2625;7677;309;1025;1593;4504;1902;5529
412160;201708;1179;3766;720;2536;181;708;76;251;257;959
412170;201708;4699;13964;3862;12379;925;3219;1462;4395;2387;7614
412175;201708;1485;4712;1267;4260;271;958;514;1738;785;2696
412180;201708;1775;5216;1329;4358;261;1018;494;1438;755;2456
412190;201708;3453;9350;2582;7733;414;1328;908;2839;1322;4167
412200;201708;2115;6604;1524;5114;325;1141;320;1072;645;2213
412210;201708;664;1785;384;1200;81;305;56;143;137;448
412215;201708;3752;10927;3279;10029;812;2479;1592;5175;2404;7654
412217;201708;1108;3062;968;2799;86;301;660;1808;746;2109
412220;201708;5995;18376;5434;17360;1415;4528;2245;7495;3660;12023
412230;201708;2952;9459;2472;8427;477;1827;630;1952;1107;3779
412240;201708;9195;23486;5497;16566;994;3356;1152;3190;2146;6546
412250;201708;1978;5591;1578;4770;362;1160;234;627;596;1787
412260;201708;1373;3777;929;2805;133;458;311;826;444;1284
412265;201708;977;2921;846;2684;221;755;307;969;528;1724
412270;201708;916;2821;617;2081;103;388;203;632;306;1020
412280;201708;629;1911;473;1582;147;513;59;184;206;697
412290;201708;1072;2935;770;2379;138;480;229;659;367;1139
412300;201708;1668;5016;1428;4532;380;1314;282;830;662;2144
412310;201708;980;2840;818;2554;109;448;384;1191;493;1639
412320;201708;854;2271;606;1793;86;332;188;544;274;876
412330;201708;1524;4299;1099;3403;181;598;424;1300;605;1898
412340;201708;1023;3141;684;2279;109;393;134;403;243;796
412350;201708;2667;7710;1773;5798;328;1200;76;150;404;1350
412360;201708;300;880;187;607;28;104;54;156;82;260
412370;201708;903;2675;660;2223;137;505;81;269;218;774
412380;201708;1638;4953;1240;4030;303;1018;248;838;551;1856
412382;201708;676;1855;468;1424;70;233;118;324;188;557
412385;201708;2380;7064;2047;6339;727;2301;494;1623;1221;3924
412390;201708;2286;6263;2000;5802;432;1352;883;2604;1315;3956
412395;201708;793;2267;599;1885;66;229;294;893;360;1122
412400;201708;924;2794;734;2359;170;580;165;555;335;1135
412402;201708;1992;5662;1546;4787;311;1083;237;663;548;1746
412405;201708;3526;10138;2186;7101;349;1289;86;224;435;1513
412410;201708;5232;15288;4152;13243;1011;3694;883;2683;1894;6377
412420;201708;429;1216;246;780;35;119;92;242;127;361
412430;201708;576;1576;394;1225;47;167;125;369;172;536
412440;201708;3138;9316;2334;7743;599;2191;441;1439;1040;3630
412450;201708;279;906;207;718;28;85;15;44;43;129
412460;201708;789;2406;666;2139;153;512;169;523;322;1035
412470;201708;1857;6164;1511;5293;433;1595;290;1064;723;2659
412480;201708;1146;3425;772;2491;125;443;95;240;220;683
412490;201708;945;2713;785;2388;159;479;278;817;437;1296
412500;201708;1958;5475;1594;4738;284;933;402;1070;686;2003
412510;201708;2231;7155;1696;5797;460;1682;262;816;722;2498
412520;201708;1484;4228;1065;3310;268;858;136;392;404;1250
412530;201708;585;1708;458;1416;80;269;83;235;163;504
412535;201708;1054;3305;790;2708;100;332;336;1263;436;1595
412540;201708;1250;3469;889;2695;128;472;243;748;371;1220
412545;201708;781;2142;538;1599;94;287;120;304;214;591
412550;201708;32717;96441;22645;74015;4786;16594;5271;16105;10057;32699
412555;201708;262;769;185;598;26;88;43;113;69;201
412560;201708;5481;16569;4140;13478;842;3070;875;2716;1717;5786
412570;201708;4367;12351;2817;9037;573;2030;356;1152;929;3182
412575;201708;949;2807;751;2324;134;455;271;766;405;1221
412580;201708;1364;3656;960;2860;167;562;365;1005;532;1567
412590;201708;445;1288;264;895;53;174;31;101;84;275
412600;201708;1449;4316;1081;3479;203;735;323;976;526;1711
412610;201708;801;2361;503;1612;106;341;153;462;259;803
412620;201708;1306;3899;1015;3334;260;993;240;680;500;1673
412625;201708;9050;26577;6557;21497;1162;4050;761;2817;1923;6867
412627;201708;1069;3207;722;2420;213;768;155;499;368;1267
412630;201708;3217;10007;2449;8249;479;1605;691;2220;1170;3825
412635;201708;469;1349;324;1019;61;200;43;107;104;307
412640;201708;985;2851;595;1930;95;340;105;306;200;646
412650;201708;1668;4931;1391;4387;267;972;423;1185;690;2157
412660;201708;2771;7707;2048;6282;372;1268;506;1400;878;2668
412665;201708;646;1660;364;1116;75;243;92;262;167;505
412667;201708;1694;4738;1316;3977;235;800;455;1309;690;2109
412670;201708;562;1714;442;1475;106;389;105;338;211;727
412680;201708;1474;4334;932;3132;155;573;247;734;402;1307
412690;201708;817;2391;625;1982;131;413;137;444;268;857
412700;201708;1955;5595;1594;5036;414;1504;510;1551;924;3055
412710;201708;6517;20447;5491;18285;1189;4322;1395;4257;2584;8579
412720;201708;1457;4474;1047;3465;161;566;197;557;358;1123
412730;201708;2233;6621;1290;4374;270;970;166;528;436;1498
412740;201708;1629;5007;1156;3927;240;894;134;496;374;1390
412750;201708;4263;12423;3729;11519;569;2030;2168;6475;2737;8505
412760;201708;2604;7925;2404;7558;359;1274;1414;4279;1773;5553
412770;201708;11134;30317;6233;19852;850;2881;1060;3018;1910;5899
412780;201708;1329;3956;1111;3527;221;782;439;1323;660;2105
412785;201708;2275;6208;1661;5010;412;1256;652;1985;1064;3241
412788;201708;1454;4464;1230;4005;321;1131;396;1199;717;2330
412790;201708;1109;3298;748;2488;158;584;160;444;318;1028
412795;201708;1068;2917;699;2105;125;395;197;562;322;957
412796;201708;2600;7851;2293;7195;472;1585;902;2668;1374;4253
412800;201708;3327;9215;2462;7371;379;1278;852;2323;1231;3601
412810;201708;11848;32013;6977;21523;918;3210;1763;4615;2681;7825
412820;201708;7585;21685;5529;17587;1201;4060;1451;4631;2652;8691
412830;201708;377;1121;277;907;42;146;60;184;102;330
412840;201708;1900;5309;1487;4454;244;777;386;1125;630;1902
412850;201708;3006;8587;2347;7377;455;1547;738;2215;1193;3762
412853;201708;1891;5331;1610;4692;161;510;807;2143;968;2653
412855;201708;1437;4157;1056;3266;202;698;210;522;412;1220
412860;201708;1173;3356;908;2820;207;698;295;861;502;1559
412862;201708;761;1918;499;1443;79;261;149;425;228;686
412863;201708;1182;3881;1149;3825;117;425;853;2801;970;3226
412865;201708;746;2155;547;1762;103;357;164;542;267;899
412870;201708;950;2687;748;2343;259;904;134;425;393;1329
412880;201708;887;2610;656;2077;133;468;86;238;219;706
420005;201708;538;1583;315;1066;47;170;101;326;148;496
420010;201708;3290;8828;2556;7778;315;1007;1705;5216;2020;6223
420020;201708;623;2007;376;1374;55;250;46;128;101;378
420030;201708;442;1143;224;751;51;206;22;78;73;284
420040;201708;684;2169;402;1524;67;291;25;81;92;372
420050;201708;749;2070;494;1544;100;323;219;670;319;993
420055;201708;198;618;115;413;23;99;24;80;47;179
420060;201708;223;710;148;525;23;101;22;60;45;161
420070;201708;1287;4099;961;3303;195;738;328;1135;523;1873
420075;201708;164;439;85;263;15;49;13;27;28;76
420080;201708;604;1839;479;1584;138;470;115;370;253;840
420090;201708;430;1447;299;1105;80;299;51;201;131;500
420100;201708;1222;3738;1116;3586;166;574;732;2342;898;2916
420110;201708;303;1007;282;960;86;309;77;245;163;554
420120;201708;292;984;229;832;67;280;62;190;129;470
420125;201708;325;1139;294;1075;74;301;134;472;208;773
420127;201708;466;1313;168;598;34;142;17;43;51;185
420130;201708;1989;6594;1583;5750;420;1701;369;1208;789;2909
420140;201708;4302;12675;3161;10438;747;2773;462;1354;1209;4127
420150;201708;534;1486;373;1210;45;176;176;521;221;697
420160;201708;256;681;144;468;26;88;41;123;67;211
420165;201708;226;702;136;471;26;100;33;104;59;204
420170;201708;228;694;139;513;39;171;15;50;54;221
420180;201708;364;1084;197;691;25;85;45;153;70;238
420190;201708;259;880;162;618;35;136;19;61;54;197
420195;201708;1386;4036;1119;3544;298;1039;209;621;507;1660
420200;201708;2835;8596;1734;6130;346;1407;314;991;660;2398
420205;201708;1231;3759;948;3215;170;630;505;1704;675;2334
420207;201708;1603;4598;1090;3584;275;1013;249;789;524;1802
420208;201708;592;1568;322;1100;71;275;112;397;183;672
420209;201708;275;852;171;601;39;157;60;199;99;356
420210;201708;2116;6028;1362;4766;308;1251;509;1661;817;2912
420213;201708;822;2806;755;2655;211;803;343;1205;554;2008
420215;201708;329;1035;208;755;56;205;17;71;73;276
420220;201708;183;649;149;577;44;194;41;148;85;342
420230;201708;4388;12851;3335;10938;636;2437;1301;4057;1937;6494
420240;201708;12006;33205;7795;25129;1147;4389;3574;10425;4721;14814
420243;201708;608;1792;471;1523;95;324;158;500;253;824
420245;201708;1388;3993;948;3118;129;497;389;1157;518;1654
420250;201708;523;1660;463;1541;103;388;204;650;307;1038
420253;201708;561;1420;411;1206;39;113;218;642;257;755
420257;201708;296;805;185;600;39;132;80;255;119;387
420260;201708;1182;3730;944;3294;176;697;418;1440;594;2137
420270;201708;695;2013;268;885;30;110;71;206;101;316
420280;201708;2068;5624;1250;4139;257;905;349;1096;606;2001
420285;201708;117;337;57;211;10;39;5;11;15;50
420287;201708;498;1387;381;1201;122;415;104;321;226;736
420290;201708;5990;17772;4114;13447;800;2813;1230;3601;2030;6414
420300;201708;6847;20017;4292;14493;903;3417;847;2555;1750;5972
420310;201708;907;2351;640;1789;78;256;446;1194;524;1450
420315;201708;976;3038;742;2557;204;757;244;827;448;1584
420320;201708;4492;13792;3673;12243;1157;4237;933;2966;2090;7203
420325;201708;224;747;192;676;41;146;63;217;104;363
420330;201708;987;3293;708;2590;145;575;193;659;338;1234
420340;201708;1430;4308;1036;3424;195;694;72;221;267;915
420350;201708;1497;4318;1072;3429;197;691;512;1610;709;2301
420360;201708;3032;9094;1822;6410;380;1485;163;547;543;2032
420370;201708;1794;4985;1430;4358;158;553;1021;3038;1179;3591
420380;201708;5316;15411;3469;11467;812;2882;904;2910;1716;5792
420390;201708;1379;3724;839;2600;150;548;235;523;385;1071
420395;201708;1317;4012;883;3038;133;505;92;271;225;776
420400;201708;1207;3567;840;2812;179;689;173;525;352;1214
420410;201708;721;1902;503;1528;73;261;318;948;391;1209
420415;201708;472;1428;344;1138;97;341;84;268;181;609
420417;201708;735;2309;589;1952;128;452;220;710;348;1162
420419;201708;307;994;215;785;73;294;11;41;84;335
420420;201708;11054;32606;8605;27883;2993;10425;1695;5114;4688;15539
420425;201708;1190;3120;781;2362;84;324;306;849;390;1173
420430;201708;3522;10492;2266;7534;502;1793;632;1946;1134;3739
420435;201708;291;868;173;600;36;155;65;199;101;354
420440;201708;857;2553;469;1552;156;571;110;313;266;884
420445;201708;376;1075;246;778;51;169;70;206;121;375
420450;201708;805;2441;560;1899;111;409;133;398;244;807
420455;201708;2021;5732;1637;5053;254;914;748;2187;1002;3101
420460;201708;9226;26514;7080;22711;1503;5496;2700;8173;4203;13669
420470;201708;1069;2777;585;1840;118;406;146;400;264;806
420475;201708;102;299;54;192;20;69;6;21;26;90
420480;201708;5135;14428;3645;11629;836;2896;859;2666;1695;5562
420490;201708;639;1664;346;1157;79;288;74;256;153;544
420500;201708;1522;4679;1112;3833;319;1205;329;1112;648;2317
420510;201708;127;445;98;371;23;102;47;165;70;267
420515;201708;79;241;63;216;12;47;18;63;30;110
420517;201708;888;2585;784;2408;79;256;544;1663;623;1919
420519;201708;474;1227;306;931;55;191;82;232;137;423
420520;201708;631;1646;323;1059;46;147;55;144;101;291
420530;201708;1245;3842;887;3062;187;720;212;618;399;1338
420535;201708;267;756;120;407;29;101;11;39;40;140
420540;201708;22980;63587;15940;49034;3336;11248;4437;11772;7773;23020
420543;201708;352;904;276;778;45;104;173;506;218;610
420545;201708;1637;5031;1307;4312;301;1061;395;1256;696;2317
420550;201708;4150;12670;2971;10342;744;2996;624;2143;1368;5139
420555;201708;365;1090;271;902;54;188;90;286;144;474
420560;201708;471;1330;349;1111;59;185;185;577;244;762
420570;201708;2284;7044;1763;5908;390;1472;615;1890;1005;3362
420580;201708;1737;4931;1376;4342;297;1113;647;1912;944;3025
420590;201708;3400;9963;2131;7057;421;1503;333;917;754;2420
420600;201708;973;3090;857;2850;158;546;460;1544;618;2090
420610;201708;520;1574;294;1054;67;263;58;198;125;461
420620;201708;568;1728;497;1589;144;494;140;443;284;937
420630;201708;1013;3079;739;2413;169;606;271;807;440;1413
420640;201708;794;2317;380;1358;98;390;27;74;125;464
420650;201708;2581;7445;1667;5577;296;1057;434;1300;730;2357
420660;201708;468;1370;330;1082;61;224;81;246;142;470
420665;201708;720;2005;478;1560;75;285;160;466;235;751
420670;201708;1725;5007;1215;3953;229;900;312;895;541;1795
420675;201708;190;613;145;499;30;129;31;90;61;219
420680;201708;355;899;222;705;41;132;89;269;130;401
420690;201708;893;3063;638;2340;113;442;95;285;208;727
420700;201708;3158;9187;2437;7735;456;1611;870;2609;1326;4220
420710;201708;677;2178;513;1816;129;526;173;567;302;1093
420720;201708;1712;4818;1306;4240;375;1283;549;1759;924;3042
420730;201708;3276;9569;2649;8504;562;1968;1139;3549;1701;5517
420740;201708;849;2552;622;2085;167;613;163;501;330;1114
420750;201708;2161;6837;1585;5520;253;989;498;1519;751;2508
420757;201708;91;207;31;111;7;30;9;29;16;59
420760;201708;414;1283;196;656;39;132;21;64;60;196
420765;201708;548;1743;280;1045;52;213;58;220;110;433
420768;201708;1254;4116;1017;3636;317;1134;474;1755;791;2889
420770;201708;572;1574;280;1012;55;226;57;206;112;432
420775;201708;649;1922;369;1245;77;278;52;152;129;430
420780;201708;1424;4263;842;2884;158;575;147;469;305;1044
420785;201708;175;520;135;427;29;91;42;117;71;208
420790;201708;1235;4140;948;3513;240;952;343;1213;583;2165
420800;201708;927;2577;448;1472;92;336;124;381;216;717
420810;201708;2012;6699;1598;5799;507;2074;331;1078;838;3152
420820;201708;9261;26809;6462;22042;1548;5894;1829;6001;3377;11895
420830;201708;3011;9075;2415;7962;647;2343;791;2539;1438;4882
420840;201708;1012;2942;475;1683;89;345;73;243;162;588
420845;201708;1615;4669;1075;3670;265;1038;243;777;508;1815
420850;201708;1508;4729;909;3356;205;831;75;254;280;1085
420860;201708;402;1124;237;804;60;233;46;151;106;384
420870;201708;1094;3029;849;2633;306;1075;225;624;531;1699
420880;201708;1012;3359;792;2788;182;711;144;431;326;1142
420890;201708;8966;24144;4730;15505;824;2968;1073;3055;1897;6023
420895;201708;216;628;106;354;31;112;28;77;59;189
420900;201708;1835;5080;1181;3852;232;876;316;921;548;1797
420910;201708;24182;70070;16625;55383;2961;11131;5291;16158;8252;27289
420915;201708;577;2228;396;1674;81;352;166;657;247;1009
420917;201708;507;1530;233;757;35;123;91;269;126;392
420920;201708;171;490;76;260;9;37;11;31;20;68
420930;201708;18676;52180;14088;44230;2878;9910;5491;16473;8369;26383
420940;201708;2917;8443;2142;6948;564;2013;162;458;726;2471
420945;201708;216;644;140;463;32;120;40;122;72;242
420950;201708;588;1615;298;1022;34;154;70;229;104;383
420960;201708;981;2737;757;2348;155;556;276;768;431;1324
420970;201708;2672;8034;2004;6754;603;2183;352;1226;955;3409
420980;201708;445;1312;346;1163;131;473;112;417;243;890
420985;201708;504;1406;233;814;50;206;68;220;118;426
420990;201708;770;2161;423;1462;81;303;61;178;142;481
421000;201708;569;1900;371;1395;72;287;61;178;133;465
421003;201708;733;1944;261;872;32;111;26;70;58;181
421005;201708;146;454;111;394;31;120;50;191;81;311
421010;201708;5084;14267;3512;11465;804;2908;697;2083;1501;4991
421020;201708;462;1379;340;1167;32;124;210;721;242;845
421030;201708;777;2681;662;2392;221;885;116;389;337;1274
421040;201708;973;2366;595;1783;84;297;302;871;386;1168
421050;201708;1582;4471;911;3002;184;656;223;663;407;1319
421055;201708;224;619;112;365;21;65;26;77;47;142
421060;201708;592;1884;399;1404;86;333;133;456;219;789
421070;201708;674;2105;430;1498;91;346;52;161;143;507
421080;201708;782;3138;703;3019;93;304;530;2456;623;2760
421085;201708;525;1462;241;846;47;188;58;180;105;368
421090;201708;415;1132;194;625;25;81;42;127;67;208
421100;201708;984;2571;498;1537;115;378;52;139;167;517
421105;201708;1566;4598;1251;4083;223;776;507;1738;730;2514
421110;201708;1003;3427;913;3229;254;947;371;1246;625;2193
421120;201708;1327;4233;883;3159;121;506;213;653;334;1159
421125;201708;415;1130;305;949;85;292;89;246;174;538
421130;201708;3578;11553;3083;10567;891;3303;1220;4197;2111;7500
421140;201708;350;999;252;792;46;143;94;266;140;409
421145;201708;535;1577;333;1073;59;198;118;367;177;565
421150;201708;620;1754;439;1466;90;352;162;508;252;860
421160;201708;1172;3226;596;1935;108;406;214;653;322;1059
421165;201708;238;791;193;683;26;79;87;330;113;409
421170;201708;1319;3730;1053;3317;187;630;592;1858;779;2488
421175;201708;1220;3403;842;2726;164;634;293;833;457;1467
421180;201708;500;1332;237;779;56;212;41;127;97;339
421185;201708;407;1086;286;860;60;175;115;360;175;535
421187;201708;366;1079;250;811;38;122;91;274;129;396
421189;201708;412;1283;323;1087;65;231;89;274;154;505
421190;201708;11719;32817;7151;23927;1386;5164;1072;3287;2458;8451
421200;201708;921;2925;758;2593;167;610;255;830;422;1440
421205;201708;224;648;162;523;39;156;52;142;91;298
421210;201708;1384;4148;1017;3320;249;838;283;933;532;1771
421220;201708;1754;5878;1522;5340;440;1712;247;761;687;2473
421223;201708;526;1624;374;1319;70;262;134;480;204;742
421225;201708;1168;3701;988;3314;216;809;419;1422;635;2231
421227;201708;993;2838;732;2368;154;568;377;1171;531;1739
421230;201708;495;1556;409;1401;110;408;141;469;251;877
421240;201708;372;1164;183;679;21;102;19;61;40;163
421250;201708;1679;4718;1063;3631;283;1050;213;719;496;1769
421260;201708;359;1011;86;308;14;44;14;48;28;92
421265;201708;788;2324;694;2178;101;370;440;1346;541;1716
421270;201708;502;1404;273;931;49;164;75;256;124;420
421280;201708;1681;5229;1335;4590;331;1287;549;1826;880;3113
421290;201708;983;2789;578;1864;99;345;96;269;195;614
421300;201708;297;874;216;708;59;235;81;238;140;473
421310;201708;219;676;170;555;37;139;55;172;92;311
421315;201708;325;962;188;658;30;104;21;79;51;183
421320;201708;689;2114;421;1442;75;257;69;171;144;428
421330;201708;625;1994;468;1683;120;457;106;388;226;845
421335;201708;486;1612;409;1451;91;372;81;291;172;663
421340;201708;1754;4869;1368;4238;200;737;699;2118;899;2855
421350;201708;1152;3632;925;3172;162;672;454;1457;616;2129
421360;201708;2879;8108;1789;5979;378;1511;503;1488;881;2999
421370;201708;563;1907;416;1547;120;484;104;374;224;858
421380;201708;941;2702;794;2426;132;427;387;1130;519;1557
421390;201708;187;524;81;275;17;64;27;85;44;149
421400;201708;311;1029;224;860;65;278;77;277;142;555
421410;201708;312;884;188;635;22;83;74;254;96;337
421415;201708;374;1187;161;578;35;135;26;85;61;220
421420;201708;806;2399;617;1999;96;347;250;749;346;1096
421430;201708;194;618;143;514;26;99;33;110;59;209
421440;201708;865;2449;574;1945;109;426;237;790;346;1216
421450;201708;438;1335;263;929;43;183;24;85;67;268
421460;201708;599;1657;321;1129;62;232;72;257;134;489
421470;201708;390;1263;301;1075;69;281;83;275;152;556
421480;201708;3183;8826;2088;6922;681;2603;312;841;993;3444
421490;201708;278;809;132;475;25;100;20;64;45;164
421500;201708;2122;7092;1692;6150;517;2082;198;662;715;2744
421505;201708;370;1179;323;1079;71;243;149;499;220;742
421507;201708;535;1587;352;1206;84;313;79;262;163;575
421510;201708;223;693;173;583;37;137;77;219;114;356
421520;201708;710;1956;454;1379;66;234;182;491;248;725
421530;201708;345;1067;203;728;41;188;40;114;81;302
421535;201708;679;1943;376;1315;44;171;161;514;205;685
421540;201708;342;916;251;765;57;192;88;245;145;437
421545;201708;856;2622;619;2167;141;557;188;630;329;1187
421550;201708;2174;6618;1842;6047;468;1758;713;2206;1181;3964
421555;201708;276;800;82;293;15;68;11;28;26;96
421560;201708;144;441;76;275;14;52;11;43;25;95
421565;201708;841;2458;699;2233;207;729;293;946;500;1675
421567;201708;632;2250;516;1958;261;1028;104;397;365;1425
421568;201708;528;1591;344;1169;69;255;101;338;170;593
421569;201708;241;724;112;405;21;73;18;68;39;141
421570;201708;1409;4198;833;2836;195;700;128;404;323;1104
421575;201708;400;1257;350;1123;62;219;178;538;240;757
421580;201708;3141;9785;2329;8002;535;2093;646;1964;1181;4057
421590;201708;215;652;169;562;22;75;83;263;105;338
421600;201708;478;1452;351;1158;85;297;75;230;160;527
421605;201708;659;1994;461;1618;86;342;128;434;214;776
421610;201708;1414;3798;965;2948;168;573;331;961;499;1534
421620;201708;4581;13552;2942;10161;817;3026;677;2316;1494;5342
421625;201708;376;1036;150;517;26;90;22;72;48;162
421630;201708;3217;9349;1783;5992;328;1253;297;879;625;2132
421635;201708;229;676;121;399;18;71;38;102;56;173
421640;201708;1101;3140;778;2524;164;563;265;839;429;1402
421650;201708;2282;7068;1635;5635;387;1538;213;572;600;2110
421660;201708;7979;25511;6624;22752;1401;5349;2131;6768;3532;12117
421670;201708;1105;3228;745;2424;172;643;209;635;381;1278
421680;201708;1161;3661;938;3187;308;1112;223;726;531;1838
421690;201708;1500;4759;1109;3863;237;922;182;581;419;1503
421700;201708;484;1566;269;1002;49;201;62;208;111;409
421710;201708;209;675;79;273;15;60;28;89;43;149
421715;201708;235;629;128;413;29;100;51;151;80;251
421720;201708;1991;5807;1209;4202;302;1158;234;756;536;1914
421725;201708;160;461;113;365;31;112;35;96;66;208
421730;201708;588;1663;284;933;44;153;69;194;113;347
421740;201708;753;2377;522;1815;120;473;109;349;229;822
421750;201708;1051;2718;631;1928;94;310;220;604;314;914
421755;201708;319;914;185;588;33;119;62;179;95;298
421760;201708;1017;3078;529;1859;86;311;94;299;180;610
421770;201708;3026;8838;2263;7371;551;1873;722;2461;1273;4334
421775;201708;472;1346;320;1062;55;203;103;327;158;530
421780;201708;1060;3559;789;2906;181;769;202;651;383;1420
421790;201708;826;2155;472;1616;196;717;118;365;314;1082
421795;201708;375;1095;226;714;37;130;65;194;102;324
421800;201708;2792;8270;2084;6929;467;1696;782;2457;1249;4153
421810;201708;710;2047;498;1621;107;402;150;440;257;842
421820;201708;1016;2933;600;2017;101;370;82;221;183;591
421825;201708;1473;4519;1368;4324;182;663;913;2783;1095;3446
421830;201708;2551;8473;2230;7817;560;2166;714;2332;1274;4498
421835;201708;176;516;120;420;22;90;67;219;89;309
421840;201708;290;884;203;704;44;171;63;205;107;376
421850;201708;443;1369;251;877;45;174;57;173;102;347
421860;201708;300;914;191;683;31;125;57;178;88;303
421870;201708;3878;10827;2716;8476;713;2432;700;2063;1413;4495
421875;201708;400;1164;181;640;31;109;18;51;49;160
421880;201708;825;2474;606;2016;141;511;114;366;255;877
421885;201708;310;911;240;802;76;270;53;147;129;417
421890;201708;846;2827;708;2550;218;898;226;736;444;1634
421895;201708;399;1220;355;1147;68;239;212;681;280;920
421900;201708;1022;2802;650;2045;141;477;214;633;355;1110
421910;201708;435;1367;304;1068;60;257;61;176;121;433
421915;201708;484;1429;293;971;59;186;44;139;103;325
421917;201708;628;1741;425;1442;129;489;98;323;227;812
421920;201708;693;1951;439;1587;210;773;120;465;330;1238
421930;201708;3054;7947;1599;5318;410;1491;226;677;636;2168
421935;201708;657;2094;492;1733;99;406;182;595;281;1001
421940;201708;240;804;146;534;28;126;35;111;63;237
421950;201708;3615;9736;1720;5714;372;1364;213;694;585;2058
421960;201708;183;526;128;427;23;88;26;85;49;173
421970;201708;2389;6449;1360;4306;349;1168;297;830;646;1998
421985;201708;434;1122;236;735;38;148;63;210;101;358
422000;201708;1512;4420;1265;3957;240;867;640;1956;880;2823
430003;201708;602;1898;506;1721;136;521;150;479;286;1000
430005;201708;346;998;237;782;61;208;94;293;155;501
430010;201708;2119;5649;1617;4786;329;1065;767;2250;1096;3315
430020;201708;696;1699;571;1529;87;282;346;869;433;1151
430030;201708;1139;2902;751;2173;207;620;193;547;400;1167
430040;201708;11048;29079;7549;22448;1906;6324;710;1932;2616;8256
430045;201708;716;1894;515;1483;70;215;214;592;284;807
430047;201708;303;706;137;406;20;66;42;120;62;186
430050;201708;955;2605;545;1713;122;381;127;380;249;761
430055;201708;307;785;140;423;11;35;67;195;78;230
430057;201708;71;178;39;114;9;28;6;11;15;39
430060;201708;17399;53839;14834;49473;4093;14688;5548;18644;9641;33332
430063;201708;1020;2910;779;2386;189;578;369;1135;558;1713
430064;201708;1254;3673;945;3041;260;888;249;774;509;1662
430066;201708;169;389;114;302;9;28;64;165;73;193
430070;201708;677;1813;159;533;19;68;16;40;35;108
430080;201708;752;2055;448;1444;92;336;151;428;243;764
430085;201708;972;2449;587;1761;104;337;175;547;279;884
430087;201708;811;2521;710;2331;127;477;359;1107;486;1584
430090;201708;719;1867;256;828;29;109;58;190;87;299
430100;201708;919;2398;474;1488;102;333;130;354;232;687
430105;201708;1083;3079;726;2412;166;633;274;887;440;1520
430107;201708;217;695;157;538;24;88;36;111;60;199
430110;201708;1993;5536;1605;4931;321;1035;775;2282;1096;3317
430120;201708;1690;5017;1131;3756;251;875;446;1503;697;2378
430130;201708;4205;11794;3542;10752;1025;2908;1348;4768;2373;7676
430140;201708;1216;3648;786;2649;197;688;246;818;443;1506
430150;201708;750;1981;459;1407;98;334;112;347;210;681
430155;201708;323;889;185;596;25;90;45;132;70;222
430160;201708;17541;49109;15043;44950;3744;11879;5384;16637;9128;28516
430163;201708;2052;5789;1630;5074;231;801;929;2874;1160;3675
430165;201708;479;1174;125;415;15;49;14;38;29;87
430170;201708;976;2765;373;1332;65;248;54;163;119;411
430175;201708;908;2814;749;2431;187;592;321;1086;508;1678
430180;201708;831;2238;681;1977;118;405;376;1033;494;1438
430185;201708;525;1366;314;956;53;180;118;308;171;488
430187;201708;690;1982;535;1671;100;345;206;632;306;977
430190;201708;1633;4872;1404;4406;301;1016;636;1937;937;2953
430192;201708;180;548;77;246;9;28;9;24;18;52
430195;201708;396;1201;95;307;11;38;5;12;16;50
430200;201708;1381;4313;1153;3844;338;1153;318;1055;656;2208
430205;201708;560;1552;418;1268;32;114;296;875;328;989
430210;201708;6256;16340;3992;11620;583;1906;1366;3224;1949;5130
430215;201708;353;954;242;728;49;166;91;250;140;416
430220;201708;657;1685;214;714;35;136;42;122;77;258
430222;201708;270;838;219;724;42;153;87;264;129;417
430223;201708;361;985;294;867;60;180;136;409;196;589
430225;201708;35;92;14;46;4;11;4;11;8;22
430230;201708;1579;4653;1505;4561;322;881;1070;3393;1392;4274
430235;201708;276;875;220;740;43;171;75;238;118;409
430237;201708;570;1428;403;1140;38;126;244;650;282;776
430240;201708;1070;2669;738;2134;92;311;391;1081;483;1392
430245;201708;890;2697;688;2284;221;727;263;918;484;1645
430250;201708;1109;3164;964;2930;286;944;74;194;360;1138
430258;201708;144;403;109;344;10;36;47;148;57;184
430260;201708;699;1970;511;1592;97;316;231;755;328;1071
430265;201708;271;827;209;710;47;153;34;121;81;274
430270;201708;2891;7954;2483;7286;327;1072;1503;4298;1830;5370
430280;201708;4928;12922;3860;11048;879;2581;1585;4536;2464;7117
430290;201708;2457;6311;2247;5999;117;366;1910;5047;2027;5413
430300;201708;9370;26788;7723;23676;1696;5599;3370;10344;5066;15943
430310;201708;7082;20570;5432;17403;1115;3992;2209;6639;3324;10631
430320;201708;875;2508;514;1709;113;328;222;809;335;1137
430330;201708;703;1814;507;1440;133;392;204;516;337;908
430340;201708;728;1739;379;1147;74;241;177;513;251;754
430350;201708;6253;18486;5225;16345;1660;5408;1742;5252;3402;10660
430355;201708;415;1032;153;478;29;97;14;41;43;138
430360;201708;1002;2653;778;2225;165;506;271;714;436;1220
430367;201708;246;668;158;490;38;141;55;158;93;299
430370;201708;548;1512;325;1044;72;247;68;194;140;441
430380;201708;757;1955;420;1322;128;436;99;306;227;742
430390;201708;3912;10723;2388;7598;395;1398;245;703;640;2101
430400;201708;1377;3244;1005;2640;214;567;488;1224;702;1791
430410;201708;613;1586;433;1274;62;209;235;672;297;881
430420;201708;3557;10181;2761;8381;775;2454;861;2501;1636;4955
430430;201708;670;1809;398;1263;100;344;71;207;171;551
430435;201708;2056;5444;1471;4383;374;1151;398;1183;772;2334
430440;201708;4173;12894;3240;10783;715;2510;1347;4595;2062;7105
430450;201708;7056;19470;5797;17075;1577;4888;1870;5593;3447;10481
430460;201708;28934;84483;22270;72657;5700;20532;6870;21773;12570;42305
430461;201708;513;1343;160;504;21;70;35;101;56;171
430462;201708;297;825;195;648;35;123;34;129;69;252
430463;201708;4529;13968;3812;12645;821;2987;1777;5892;2598;8879
430465;201708;615;1654;513;1471;110;339;275;763;385;1102
430466;201708;3857;10164;3290;9260;748;2278;1662;4436;2410;6714
430467;201708;484;1390;405;1232;74;248;168;468;242;716
430468;201708;1432;3952;1215;3602;248;772;589;1740;837;2512
430469;201708;544;1535;59;207;6;13;11;27;17;40
430470;201708;7790;20619;5478;16762;1665;5374;979;3057;2644;8431
430471;201708;551;1813;493;1683;121;427;170;582;291;1009
430480;201708;1046;2801;535;1727;88;306;87;250;175;556
430485;201708;166;475;77;248;13;49;16;42;29;91
430490;201708;351;994;213;696;40;145;87;296;127;441
430495;201708;400;1162;257;870;39;151;86;272;125;423
430500;201708;1165;3162;944;2808;223;742;399;1124;622;1866
430510;201708;23475;66385;18081;55783;4939;16625;5470;15683;10409;32308
430511;201708;382;1174;160;568;29;99;15;42;44;141
430512;201708;1067;2719;910;2453;248;705;259;726;507;1431
430513;201708;826;2130;447;1293;112;354;158;417;270;771
430515;201708;472;1324;336;1048;60;172;150;487;210;659
430517;201708;1165;3630;950;3189;175;610;451;1528;626;2138
430520;201708;1534;4169;910;2842;175;604;189;530;364;1134
430530;201708;1125;2952;456;1416;86;265;105;307;191;572
430535;201708;2676;7776;2010;6469;382;1335;792;2496;1174;3831
430537;201708;450;1480;375;1295;44;158;253;871;297;1029
430540;201708;693;1531;441;1178;76;205;246;654;322;859
430543;201708;524;1261;447;1175;89;219;291;796;380;1015
430544;201708;660;2088;530;1778;131;464;232;743;363;1207
430545;201708;1500;4660;1287;4351;369;1334;562;1920;931;3254
430550;201708;615;1718;353;1143;69;235;68;199;137;434
430558;201708;81;240;50;160;12;42;13;33;25;75
430560;201708;417;991;186;563;15;56;53;148;68;204
430570;201708;1129;2843;736;2100;125;411;334;841;459;1252
430580;201708;1292;3165;799;2361;127;411;351;1021;478;1432
430583;201708;173;454;42;133;5;14;7;25;12;39
430585;201708;312;776;178;505;35;115;71;170;106;285
430587;201708;178;553;140;455;31;110;55;188;86;298
430590;201708;1334;3517;1206;3298;93;296;970;2602;1063;2898
430593;201708;23;87;21;80;5;22;9;31;14;53
430595;201708;318;909;89;313;10;45;11;32;21;77
430597;201708;370;1064;247;765;27;90;77;203;104;293
430600;201708;1956;5283;995;3064;173;549;261;739;434;1288
430605;201708;1297;3794;991;3171;167;634;386;1214;553;1848
430607;201708;778;1815;559;1480;58;170;338;907;396;1077
430610;201708;7621;20146;5772;17227;1674;5438;1102;3290;2776;8728
430613;201708;297;726;111;348;8;29;28;71;36;100
430620;201708;716;1982;586;1728;150;483;246;693;396;1176
430630;201708;493;1450;167;545;24;80;30;87;54;167
430632;201708;658;1813;307;954;39;130;113;314;152;444
430635;201708;624;1741;465;1412;83;275;255;745;338;1020
430637;201708;491;1376;432;1264;68;232;238;646;306;878
430640;201708;1628;4296;807;2547;98;314;137;387;235;701
430642;201708;484;1256;309;923;55;164;127;385;182;549
430645;201708;290;664;111;312;19;56;28;82;47;138
430650;201708;1809;5700;1524;5117;369;1288;752;2565;1121;3853
430655;201708;164;418;142;375;34;109;67;146;101;255
430660;201708;5532;15264;4400;13251;1018;3284;1810;5413;2828;8697
430670;201708;511;1417;439;1286;40;121;289;857;329;978
430673;201708;742;1723;307;907;64;191;89;257;153;448
430675;201708;248;736;73;251;14;58;15;44;29;102
430676;201708;3897;11274;3159;9921;675;2263;1205;3770;1880;6033
430680;201708;1103;3097;667;2175;142;462;118;364;260;826
430690;201708;4060;11443;3276;9918;978;3131;776;2348;1754;5479
430692;201708;245;779;183;662;16;70;122;445;138;515
430693;201708;1245;3322;721;2233;155;525;122;346;277;871
430695;201708;582;1537;370;1097;54;184;167;475;221;659
430697;201708;461;1278;331;1043;70;219;133;446;203;665
430700;201708;9771;24710;5024;15897;900;3186;480;1481;1380;4667
430705;201708;281;830;200;635;44;141;52;158;96;299
430710;201708;1746;4334;1315;3596;249;762;562;1496;811;2258
430720;201708;786;1949;505;1502;127;381;149;463;276;844
430730;201708;1642;4226;1045;3216;191;607;435;1381;626;1988
430740;201708;649;1809;364;1199;70;245;78;272;148;517
430745;201708;508;1438;253;812;39;124;44;144;83;268
430750;201708;1589;4272;1183;3567;232;763;581;1716;813;2479
430755;201708;530;1362;333;965;27;87;160;416;187;503
430760;201708;2952;7152;1959;5729;450;1468;763;2295;1213;3763
430770;201708;6490;18423;5145;15959;944;3193;2626;7910;3570;11103
430780;201708;2520;6681;1597;5005;301;1001;513;1635;814;2636
430781;201708;453;1340;303;1005;72;252;62;201;134;453
430783;201708;550;1332;325;942;44;142;147;398;191;540
430786;201708;78;268;52;202;8;30;11;41;19;71
430790;201708;4670;12782;3190;9719;658;2220;1280;3669;1938;5889
430800;201708;922;2547;633;1914;100;341;284;817;384;1158
430805;201708;570;1565;342;1058;37;109;159;476;196;585
430807;201708;499;1362;330;1017;47;173;110;312;157;485
430810;201708;749;2047;267;936;49;173;61;211;110;384
430820;201708;1446;4069;806;2698;171;594;147;477;318;1071
430825;201708;326;882;129;392;29;80;24;55;53;135
430830;201708;1850;5528;1649;5221;204;716;1117;3525;1321;4241
430840;201708;1010;2972;877;2728;204;625;418;1324;622;1949
430843;201708;108;277;36;111;8;24;9;27;17;51
430845;201708;285;800;219;676;95;313;26;66;121;379
430850;201708;2497;7199;2089;6426;508;1686;890;2707;1398;4393
430860;201708;1067;2717;514;1587;96;350;185;529;281;879
430865;201708;600;1573;530;1460;163;478;229;615;392;1093
430870;201708;772;2121;368;1233;70;249;80;237;150;486
430880;201708;1221;3299;851;2573;230;726;260;784;490;1510
430885;201708;257;588;136;405;11;39;94;277;105;316
430890;201708;1632;4358;1092;3303;74;302;162;408;236;710
430900;201708;2840;7242;2120;6040;399;1258;950;2581;1349;3839
430905;201708;1128;3181;728;2340;148;508;159;494;307;1002
430910;201708;1679;4874;1123;3635;239;889;395;1124;634;2013
430912;201708;505;1441;371;1200;48;166;225;737;273;903
430915;201708;590;1809;424;1511;113;414;142;542;255;956
430920;201708;19083;55392;16470;50659;2991;10076;9015;26932;12006;37008
430925;201708;140;311;61;169;10;28;20;58;30;86
430930;201708;9992;27173;6700;21240;1794;6047;1450;4855;3244;10902
430940;201708;1293;3912;726;2475;183;660;100;292;283;952
430950;201708;913;2436;602;1807;126;406;243;660;369;1066
430955;201708;185;521;73;233;15;49;12;36;27;85
430957;201708;236;776;198;699;35;113;92;337;127;450
430960;201708;1507;3843;1111;3147;238;764;515;1444;753;2208
430965;201708;1618;4291;1309;3750;94;341;991;2720;1085;3061
430970;201708;408;1116;230;735;32;105;90;278;122;383
430975;201708;566;1857;438;1540;103;389;156;550;259;939
430980;201708;398;1011;246;754;54;177;85;256;139;433
430990;201708;612;1854;394;1298;64;235;127;401;191;636
430995;201708;669;1856;479;1489;112;352;204;605;316;957
431000;201708;1617;4013;748;2249;120;390;44;113;164;503
431010;201708;2670;7310;1567;5200;265;982;145;404;410;1386
431020;201708;10566;25336;6880;19135;1650;4859;1774;4675;3424;9534
431030;201708;342;952;151;526;34;116;18;66;52;182
431033;201708;2668;7960;2303;7376;591;1998;954;3200;1545;5198
431036;201708;220;583;78;247;7;16;16;42;23;58
431040;201708;1039;2809;739;2285;140;516;336;967;476;1483
431041;201708;521;1302;452;1207;95;260;222;601;317;861
431043;201708;478;1296;260;879;94;340;61;192;155;532
431046;201708;132;361;70;209;7;21;16;48;23;69
431050;201708;1673;4164;1192;3374;261;768;547;1541;808;2309
431053;201708;588;1823;456;1538;136;490;109;362;245;852
431055;201708;685;1775;617;1670;57;167;448;1197;505;1364
431057;201708;381;1097;218;723;43;156;52;154;95;310
431060;201708;5602;16403;4742;14819;1543;5199;1120;3601;2663;8800
431065;201708;560;1559;393;1234;69;226;109;323;178;549
431070;201708;633;1819;359;1169;92;315;54;134;146;449
431075;201708;252;775;184;629;31;120;58;201;89;321
431080;201708;695;2071;486;1602;92;329;136;426;228;755
431085;201708;772;2105;596;1727;103;294;336;961;439;1255
431087;201708;531;1508;454;1342;41;119;297;892;338;1011
431090;201708;524;1275;204;632;42;148;39;113;81;261
431100;201708;3430;9190;2751;8081;694;2232;948;2716;1642;4948
431110;201708;1504;3891;1131;3148;288;822;392;1022;680;1844
431112;201708;574;1827;512;1704;120;394;248;810;368;1204
431113;201708;475;1381;378;1190;117;389;111;361;228;750
431115;201708;1367;3864;1131;3451;201;685;593;1764;794;2449
431120;201708;2732;8143;2014;6631;625;2334;522;1541;1147;3875
431123;201708;435;1244;283;923;73;232;119;405;192;637
431125;201708;1344;3960;947;3101;283;944;220;801;503;1745
431127;201708;270;739;63;209;7;19;10;25;17;44
431130;201708;3457;9832;2382;7676;537;1823;688;2237;1225;4060
431140;201708;5339;12994;2948;8753;386;1285;895;2393;1281;3678
431142;201708;505;1434;410;1260;63;207;242;740;305;947
431150;201708;1045;3061;792;2520;181;614;278;891;459;1505
431160;201708;843;2377;670;2046;156;457;245;822;401;1279
431162;201708;566;1395;254;797;30;105;52;142;82;247
431164;201708;165;447;51;175;9;38;5;15;14;53
431170;201708;690;1866;469;1445;132;431;129;376;261;807
431171;201708;774;2206;669;2001;136;437;314;906;450;1343
431173;201708;472;1332;359;1132;134;450;84;263;218;713
431175;201708;1016;2777;800;2385;229;713;190;541;419;1254
431177;201708;792;2492;591;2095;187;718;194;674;381;1392
431179;201708;391;845;94;270;13;41;17;35;30;76
431180;201708;2337;6400;1549;4883;369;1267;289;877;658;2144
431190;201708;576;1572;319;1016;43;145;55;142;98;287
431198;201708;359;1172;318;1088;111;401;88;322;199;723
431200;201708;408;1132;110;375;12;34;0;0;12;34
431205;201708;266;766;113;394;26;85;44;157;70;242
431210;201708;723;1909;611;1748;164;460;291;867;455;1327
431213;201708;259;774;194;651;25;91;102;340;127;431
431215;201708;280;882;185;641;33;123;52;166;85;289
431217;201708;165;492;111;375;23;73;44;151;67;224
431220;201708;830;2248;464;1479;40;149;191;545;231;694
431225;201708;1372;3731;1044;3121;212;651;417;1270;629;1921
431230;201708;811;2350;595;1857;103;352;254;768;357;1120
431235;201708;138;385;36;109;8;25;3;5;11;30
431237;201708;477;1408;382;1252;69;260;184;579;253;839
431238;201708;29;101;23;84;8;35;6;20;14;55
431240;201708;3709;10688;3138;9699;801;2713;1219;3665;2020;6378
431242;201708;386;1133;325;1014;83;250;118;391;201;641
431244;201708;373;885;192;545;28;95;67;154;95;249
431245;201708;1247;3198;823;2375;162;508;321;905;483;1413
431247;201708;218;613;135;429;27;87;33;96;60;183
431250;201708;1453;4610;1260;4314;308;1100;515;1820;823;2920
431260;201708;356;986;177;594;21;90;52;155;73;245
431261;201708;272;896;227;792;47;175;89;301;136;476
431262;201708;428;1193;187;623;14;49;96;327;110;376
431265;201708;1446;3594;675;2056;99;324;188;478;287;802
431267;201708;302;848;173;525;10;40;106;297;116;337
431270;201708;2870;6967;1644;4865;429;1370;449;1348;878;2718
431275;201708;228;678;124;446;30;112;16;50;46;162
431280;201708;337;921;121;399;11;38;17;36;28;74
431290;201708;346;1044;253;833;33;129;69;202;102;331
431295;201708;80;226;33;110;3;14;6;15;9;29
431300;201708;391;973;60;226;1;3;5;17;6;20
431301;201708;276;854;86;298;8;25;10;24;18;49
431303;201708;781;2062;453;1376;52;184;147;429;199;613
431306;201708;2314;5899;1409;4267;189;650;426;1151;615;1801
431308;201708;35;116;32;104;15;52;11;34;26;86
431310;201708;727;2122;427;1413;75;259;127;419;202;678
431320;201708;769;2158;391;1320;70;257;61;182;131;439
431330;201708;2584;6381;1295;4010;294;1022;152;408;446;1430
431333;201708;421;1121;154;458;19;47;36;98;55;145
431335;201708;41;124;28;98;8;28;3;3;11;31
431337;201708;2610;7733;1872;6293;497;1826;282;935;779;2761
431339;201708;563;1530;390;1176;75;243;201;594;276;837
431340;201708;23642;62002;17093;50509;3841;12415;4326;12287;8167;24702
431342;201708;555;1343;416;1120;88;271;264;675;352;946
431344;201708;371;999;249;769;10;36;166;506;176;542
431346;201708;284;716;106;324;15;46;21;64;36;110
431349;201708;759;2088;439;1333;62;198;153;427;215;625
431350;201708;4191;12000;3294;10304;788;2731;1091;3204;1879;5935
431360;201708;682;1683;414;1221;87;266;153;439;240;705
431365;201708;1609;4578;1359;4164;189;625;842;2620;1031;3245
431370;201708;4954;13619;3833;11682;938;3032;1456;4600;2394;7632
431380;201708;837;2565;753;2413;103;364;431;1374;534;1738
431390;201708;2785;7282;1614;5043;300;1060;430;1220;730;2280
431395;201708;1292;3729;1005;3206;254;842;391;1268;645;2110
431400;201708;429;1312;208;690;32;104;40;130;72;234
431402;201708;1112;2689;710;1967;127;374;373;976;500;1350
431403;201708;199;593;167;536;41;157;74;210;115;367
431405;201708;4324;11924;3518;10712;600;2049;1876;5631;2476;7680
431406;201708;627;1899;490;1632;102;343;255;853;357;1196
431407;201708;555;1551;371;1185;83;273;127;384;210;657
431410;201708;15035;42382;10102;32627;2528;9155;2141;6590;4669;15745
431413;201708;217;530;79;256;8;32;13;34;21;66
431415;201708;716;2013;497;1615;115;428;141;415;256;843
431417;201708;539;1356;438;1204;72;216;253;674;325;890
431420;201708;1382;3634;1190;3332;232;671;529;1553;761;2224
431430;201708;593;1529;342;1032;65;214;86;231;151;445
431440;201708;22950;61772;17966;53727;5039;15920;5019;16024;10058;31944
431442;201708;121;371;73;251;14;47;3;9;17;56
431445;201708;485;1381;171;564;24;77;32;100;56;177
431446;201708;410;1207;294;927;81;265;62;188;143;453
431447;201708;607;1686;427;1337;79;252;200;611;279;863
431449;201708;804;2165;570;1694;53;165;277;821;330;986
431450;201708;2186;5123;1876;4689;205;596;1364;3264;1569;3860
431454;201708;67;223;59;202;12;45;22;77;34;122
431455;201708;711;1795;369;1043;63;183;127;318;190;501
431460;201708;3132;8449;2526;7277;668;1968;800;2355;1468;4323
431470;201708;1769;5059;1276;3993;271;877;426;1335;697;2212
431475;201708;202;596;35;140;4;19;1;1;5;20
431477;201708;710;1825;449;1289;60;174;197;519;257;693
431478;201708;269;712;81;242;15;51;11;26;26;77
431480;201708;3289;8830;2551;7593;443;1460;1243;3626;1686;5086
431490;201708;111679;296587;95164;271407;11436;37955;64291;178571;75727;216526
431500;201708;576;1552;438;1275;89;244;222;645;311;889
431505;201708;509;1232;331;950;33;91;193;561;226;652
431507;201708;378;908;184;519;40;125;75;186;115;311
431510;201708;1865;5189;1440;4328;291;952;534;1550;825;2502
431513;201708;341;876;165;502;21;61;85;257;106;318
431514;201708;111;299;53;168;6;22;14;35;20;57
431515;201708;600;1641;399;1222;85;287;166;473;251;760
431517;201708;79;272;59;214;13;47;11;36;24;83
431520;201708;527;1313;228;724;46;172;41;118;87;290
431530;201708;4254;9861;2902;7997;810;2315;552;1556;1362;3871
431531;201708;241;681;173;549;22;82;53;151;75;233
431532;201708;517;1410;401;1158;90;260;141;410;231;670
431535;201708;313;801;135;415;28;100;46;123;74;223
431540;201708;2128;6825;1922;6507;133;538;1325;4564;1458;5102
431545;201708;370;1019;64;213;2;9;18;57;20;66
431550;201708;2197;6338;1873;5720;438;1460;727;2110;1165;3570
431555;201708;692;1669;473;1303;51;141;278;773;329;914
431560;201708;21370;60775;14895;48789;3129;11369;3515;12196;6644;23565
431570;201708;6060;14974;4761;13236;1030;3044;2397;6590;3427;9634
431575;201708;157;505;137;457;27;99;22;57;49;156
431580;201708;632;1770;356;1189;74;280;100;321;174;601
431590;201708;952;2482;593;1781;118;376;185;553;303;929
431595;201708;422;1177;295;893;45;130;139;404;184;534
431600;201708;1977;5335;1449;4427;365;1256;297;881;662;2137
431610;201708;1436;3962;1035;3191;131;399;468;1468;599;1867
431620;201708;508;1452;226;714;45;135;105;314;150;449
431630;201708;1388;3720;769;2381;204;657;189;540;393;1197
431640;201708;6434;17349;5760;16399;960;2792;3601;10423;4561;13215
431642;201708;539;1418;373;1090;43;127;149;422;192;549
431643;201708;355;910;153;446;19;49;43;113;62;162
431645;201708;1713;4724;1428;4224;229;723;862;2556;1091;3279
431647;201708;144;417;93;301;14;50;17;44;31;94
431650;201708;315;944;220;727;38;138;57;171;95;309
431660;201708;1031;2879;609;2012;103;370;118;333;221;703
431670;201708;1268;3267;936;2687;177;582;394;1048;571;1630
431673;201708;252;683;97;342;25;86;9;24;34;110
431675;201708;732;1874;147;503;17;64;38;113;55;177
431680;201708;9194;25079;7025;20924;1867;5860;2010;6027;3877;11887
431690;201708;22881;62782;17842;54180;4775;15376;5492;17038;10267;32414
431695;201708;151;443;107;355;21;78;32;83;53;161
431697;201708;490;1314;413;1189;90;269;191;563;281;832
431700;201708;1515;4218;1311;3842;213;631;700;2018;913;2649
431710;201708;12303;34909;10289;31733;3071;10015;3042;10264;6113;20279
431720;201708;7053;19233;5121;15318;1154;3674;1084;3018;2238;6692
431725;201708;33;95;21;70;2;7;7;23;9;30
431730;201708;3837;10808;2997;9351;796;2717;803;2658;1599;5375
431740;201708;5247;14034;3954;11735;1253;4094;632;1640;1885;5734
431750;201708;8557;23916;7345;21930;1699;5477;3183;9588;4882;15065
431755;201708;339;931;73;258;11;36;11;40;22;76
431760;201708;4371;11788;3451;10166;505;1706;1816;5033;2321;6739
431770;201708;1973;5198;1650;4732;263;795;997;2804;1260;3599
431775;201708;199;539;102;319;24;81;10;25;34;106
431780;201708;2201;5908;1590;4709;354;1085;455;1283;809;2368
431790;201708;1187;3429;912;2838;185;614;326;987;511;1601
431795;201708;383;1016;229;691;41;127;60;177;101;304
431800;201708;8442;24140;6634;20784;2155;7329;802;2521;2957;9850
431805;201708;349;849;109;355;9;32;27;91;36;123
431810;201708;3248;8507;2347;6739;468;1472;930;2506;1398;3978
431820;201708;2512;7609;2166;6948;472;1654;928;2911;1400;4565
431830;201708;11185;26476;8545;22630;2070;5971;3317;8804;5387;14775
431840;201708;2550;7554;2197;6911;471;1570;1093;3486;1564;5056
431842;201708;734;1859;257;806;35;119;66;187;101;306
431843;201708;355;1013;283;878;40;145;124;356;164;501
431844;201708;291;792;82;265;22;82;15;33;37;115
431845;201708;507;1426;362;1105;24;71;217;658;241;729
431846;201708;320;938;272;864;26;100;202;636;228;736
431848;201708;236;621;126;396;9;29;17;41;26;70
431849;201708;474;1142;90;254;14;40;14;29;28;69
431850;201708;4625;13423;3872;11835;866;2818;1248;3744;2114;6562
431860;201708;820;2131;551;1620;102;316;241;674;343;990
431861;201708;113;320;57;198;9;30;17;46;26;76
431862;201708;505;1622;409;1446;74;281;186;668;260;949
431870;201708;18691;53502;15182;47029;3264;11092;5828;17677;9092;28769
431880;201708;4197;12074;3333;10368;738;2553;1226;3652;1964;6205
431890;201708;4980;13398;3427;10442;1007;3289;584;1869;1591;5158
431900;201708;1162;3141;734;2266;167;580;289;822;456;1402
431910;201708;975;2358;435;1247;53;143;113;303;166;446
431912;201708;474;1395;392;1236;90;284;196;628;286;912
431915;201708;1234;3338;934;2816;218;712;375;1110;593;1822
431920;201708;1316;3503;1124;3198;117;347;815;2313;932;2660
431930;201708;1105;3063;789;2510;181;556;386;1254;567;1810
431935;201708;66;218;54;192;13;51;11;36;24;87
431936;201708;331;975;216;697;56;199;56;177;112;376
431937;201708;284;762;163;503;39;132;19;53;58;185
431940;201708;2517;6715;1584;4822;347;1130;444;1252;791;2382
431950;201708;1663;4930;1460;4569;279;940;724;2221;1003;3161
431960;201708;2832;7857;2369;6950;642;1977;678;1929;1320;3906
431970;201708;432;1189;202;673;49;165;50;152;99;317
431971;201708;107;299;67;227;8;27;12;36;20;63
431973;201708;468;1568;398;1430;39;137;272;996;311;1133
431975;201708;114;270;27;95;4;15;2;5;6;20
431980;201708;1370;3934;1084;3374;257;835;372;1116;629;1951
431990;201708;7055;18906;4909;15459;919;3235;1467;4517;2386;7752
432000;201708;10550;28924;8453;25288;2544;7760;2942;8923;5486;16683
432010;201708;2205;6017;1753;5205;260;858;847;2439;1107;3297
432020;201708;2319;5469;1677;4557;384;1148;862;2248;1246;3396
432023;201708;522;1389;307;930;49;175;137;349;186;524
432026;201708;1146;3445;865;2840;170;554;422;1369;592;1923
432030;201708;384;1077;269;816;56;178;115;326;171;504
432032;201708;542;1428;359;1056;42;139;157;430;199;569
432035;201708;833;2450;735;2280;237;807;217;670;454;1477
432040;201708;1046;2499;500;1545;75;256;150;443;225;699
432045;201708;263;722;139;467;31;112;37;129;68;241
432050;201708;614;1675;503;1473;125;377;206;621;331;998
432055;201708;938;2566;631;1979;161;550;231;695;392;1245
432057;201708;395;959;276;748;44;107;136;348;180;455
432060;201708;522;1327;185;602;31;126;50;132;81;258
432065;201708;240;681;181;566;48;152;58;179;106;331
432067;201708;915;2738;698;2267;124;386;333;1084;457;1470
432070;201708;2398;6468;1504;4670;281;933;305;907;586;1840
432080;201708;3921;10708;3248;9536;889;2896;1171;3362;2060;6258
432085;201708;344;952;229;766;69;227;88;298;157;525
432090;201708;1542;4276;1189;3602;324;1046;435;1267;759;2313
432100;201708;1385;3913;608;2066;93;346;39;98;132;444
432110;201708;2559;7536;1842;6053;427;1629;156;441;583;2070
432120;201708;4202;12279;3455;10933;1210;4108;755;2354;1965;6462
432130;201708;2794;7548;2268;6876;760;2488;819;2494;1579;4982
432132;201708;320;893;156;530;25;88;41;126;66;214
432135;201708;776;2197;610;1855;99;328;370;1097;469;1425
432140;201708;1870;5839;1446;5024;300;1082;599;2162;899;3244
432143;201708;1422;4059;1151;3597;198;669;574;1813;772;2482
432145;201708;1431;4283;902;3049;142;536;128;388;270;924
432146;201708;177;544;120;412;35;130;24;73;59;203
432147;201708;598;1919;466;1630;139;515;89;317;228;832
432149;201708;392;1059;239;712;30;91;101;285;131;376
432150;201708;3709;10295;2776;8564;646;2239;725;2152;1371;4391
432160;201708;4476;13817;3830;12679;1195;4171;1143;3812;2338;7983
432162;201708;378;915;58;186;12;43;7;21;19;64
432163;201708;297;818;65;211;5;15;2;8;7;23
432166;201708;639;1877;504;1594;90;333;172;463;262;796
432170;201708;1262;3799;869;2974;189;691;175;580;364;1271
432180;201708;2615;6937;1475;4557;344;1123;275;741;619;1864
432183;201708;405;1281;308;1050;101;376;55;182;156;558
432185;201708;910;2419;609;1850;62;188;332;981;394;1169
432190;201708;2983;8003;1898;5714;415;1318;548;1559;963;2877
432195;201708;1070;2826;737;2255;194;560;237;746;431;1306
432200;201708;3051;9023;2441;7941;599;2092;1018;3310;1617;5402
432210;201708;412;1116;286;899;56;200;108;316;164;516
432215;201708;813;2460;702;2279;118;376;404;1358;522;1734
432218;201708;277;702;157;439;25;63;53;129;78;192
432220;201708;4291;10923;3322;9358;499;1621;1818;4875;2317;6496
432225;201708;113;329;86;275;23;71;30;97;53;168
432230;201708;1002;2644;576;1725;100;325;147;385;247;710
432232;201708;551;1474;412;1226;71;249;181;512;252;761
432234;201708;379;1008;220;665;43;128;37;95;80;223
432235;201708;121;356;41;141;7;25;3;7;10;32
432237;201708;445;1180;388;1082;18;64;261;691;279;755
432240;201708;14373;43035;12035;39752;1431;5684;7232;24696;8663;30380
432250;201708;4758;15908;4279;14932;1293;4780;1369;4921;2662;9701
432252;201708;479;1199;310;909;52;170;138;390;190;560
432253;201708;1276;3992;728;2552;170;657;37;111;207;768
432254;201708;934;2508;257;836;50;182;20;50;70;232
432255;201708;207;522;108;341;17;61;33;88;50;149
432260;201708;7589;18677;5318;14959;1224;3566;1945;5701;3169;9267
432270;201708;2560;7556;2157;6798;641;2120;447;1417;1088;3537
432280;201708;1455;3863;758;2378;117;376;205;603;322;979
432285;201708;200;622;25;86;2;5;3;6;5;11
432290;201708;508;1481;307;1026;76;251;75;239;151;490
432300;201708;24583;71229;21225;65401;3577;12051;11961;36166;15538;48217
432310;201708;792;2306;619;2005;133;441;290;946;423;1387
432320;201708;228;562;89;279;13;40;15;42;28;82
432330;201708;291;755;94;315;10;26;17;64;27;90
432335;201708;175;500;75;264;15;57;14;41;29;98
432340;201708;372;900;189;575;34;120;52;142;86;262
432345;201708;658;1741;605;1662;67;245;401;1025;468;1270
432350;201708;373;1005;195;629;32;94;52;163;84;257
432360;201708;197;602;38;136;4;20;9;25;13;45
432370;201708;427;1145;297;883;29;95;173;511;202;606
432375;201708;723;1811;531;1481;81;229;286;789;367;1018
432377;201708;248;825;37;140;5;24;7;13;12;37
432380;201708;1159;3560;808;2786;201;770;325;1053;526;1823
500020;201708;2439;6799;1844;5805;402;1447;730;2212;1132;3659
500025;201708;1460;3361;858;2338;79;221;470;1254;549;1475
500060;201708;7088;20751;5515;17961;784;2604;3255;11034;4039;13638
500070;201708;4448;12476;3465;10739;762;2628;1281;4047;2043;6675
500080;201708;1503;4246;1073;3457;254;926;391;1217;645;2143
500085;201708;2185;5402;1489;4384;167;526;876;2524;1043;3050
500090;201708;2326;6517;1612;5199;326;1102;573;1972;899;3074
500100;201708;3242;8884;2598;7769;456;1519;1070;3025;1526;4544
500110;201708;8116;23588;6311;20730;1256;4425;2464;8783;3720;13208
500124;201708;2169;6831;1864;6307;472;1540;868;3301;1340;4841
500150;201708;1436;3547;929;2706;179;601;305;764;484;1365
500190;201708;5241;13099;3993;11439;823;2499;2037;5989;2860;8488
500200;201708;2557;6293;1877;5098;376;1092;806;2016;1182;3108
500210;201708;4832;13923;3911;12455;923;3132;1687;5415;2610;8547
500215;201708;1311;3975;982;3320;152;569;403;1318;555;1887
500220;201708;3188;9399;2495;8176;434;1515;1037;3444;1471;4959
500230;201708;3007;7487;2109;6071;364;1097;997;2888;1361;3985
500240;201708;4570;13986;3202;11169;575;2301;820;2996;1395;5297
500260;201708;3091;7211;1941;5488;248;730;963;2626;1211;3356
500270;201708;126261;322863;79139;238282;17521;56801;18033;53014;35554;109815
500280;201708;1396;3564;1079;3122;108;350;725;2076;833;2426
500290;201708;4440;9855;2493;7072;419;1317;830;2315;1249;3632
500295;201708;2700;7525;1575;5055;237;832;409;1096;646;1928
500310;201708;869;2214;691;1973;124;385;375;1066;499;1451
500315;201708;3320;10157;2712;9149;377;1313;1627;5733;2004;7046
500320;201708;18723;57478;13981;48643;3879;14671;3634;13430;7513;28101
500325;201708;4611;11253;3187;9095;511;1580;1724;4953;2235;6533
500330;201708;7113;18024;4805;13900;558;1761;2275;6626;2833;8387
500345;201708;2170;5480;1608;4677;410;1256;651;1868;1061;3124
500348;201708;2313;6563;1976;6033;215;791;1267;3778;1482;4569
500350;201708;1320;3811;708;2376;74;254;226;783;300;1037
500370;201708;23107;67787;17129;57016;3559;13318;5432;18182;8991;31500
500375;201708;2947;8011;2096;6333;406;1354;585;1727;991;3081
500380;201708;3610;9546;2702;8017;682;2132;963;2888;1645;5020
500390;201708;582;1284;337;907;51;156;162;418;213;574
500400;201708;1365;4067;997;3204;230;783;249;746;479;1529
500410;201708;2296;6388;1856;5741;311;984;1083;3444;1394;4428
500430;201708;2815;7552;2035;6410;373;1330;750;2502;1123;3832
500440;201708;1511;3844;944;2860;163;513;338;1064;501;1577
500450;201708;1379;3942;886;2955;187;681;119;325;306;1006
500460;201708;4126;11695;2792;9080;667;2422;525;1687;1192;4109
500470;201708;3026;8635;2069;6617;567;1986;334;945;901;2931
500480;201708;2319;6865;2121;6607;177;538;1608;5329;1785;5867
500490;201708;1015;2669;737;2212;192;651;173;537;365;1188
500500;201708;4004;11607;3037;10133;1033;3900;716;2441;1749;6341
500510;201708;870;2231;538;1622;52;184;261;736;313;920
500515;201708;2178;5457;1733;4838;182;508;1088;3196;1270;3704
500520;201708;3379;11333;2857;10275;497;2032;1509;5382;2006;7414
500525;201708;1194;3663;957;3242;175;667;418;1466;593;2133
500540;201708;6505;17263;3714;12064;854;3278;367;1030;1221;4308
500560;201708;5220;16135;4548;15074;417;1475;3299;11164;3716;12639
500568;201708;4305;10327;2826;8116;664;2314;785;2007;1449;4321
500570;201708;7808;19878;4712;14192;1197;3825;778;2242;1975;6067
500580;201708;3722;10273;2939;8987;396;1225;1773;5488;2169;6713
500600;201708;4120;10605;2638;7961;560;1860;738;2183;1298;4043
500620;201708;8147;22683;5861;18253;922;3050;2533;8018;3455;11068
500625;201708;701;2000;385;1275;69;247;131;421;200;668
500627;201708;751;1972;477;1470;97;293;108;338;205;631
500630;201708;6078;15862;4004;12295;983;3224;1102;3367;2085;6591
500635;201708;2733;9851;2235;9099;251;1033;1555;6872;1806;7905
500640;201708;1704;4030;1250;3374;71;232;861;2250;932;2482
500660;201708;19835;56101;15080;48368;4669;16569;3715;12003;8384;28572
500690;201708;2497;7260;1925;6345;906;3273;258;839;1164;4112
500710;201708;3500;10023;2789;8765;679;2345;868;2668;1547;5013
500720;201708;6388;16546;3941;12403;1025;3618;663;1997;1688;5615
500730;201708;1019;2739;664;2054;139;474;191;556;330;1030
500740;201708;4679;12079;3500;9954;336;1135;1770;5061;2106;6196
500750;201708;1023;2745;819;2385;140;461;368;996;508;1457
500755;201708;1180;3351;770;2521;145;489;132;348;277;837
500769;201708;5755;14950;3115;9595;540;1859;549;1353;1089;3212
500770;201708;1765;4946;1154;3765;210;739;349;1137;559;1876
500780;201708;1360;3702;960;2930;237;736;228;691;465;1427
500790;201708;9982;26312;8130;23361;1558;4970;4118;11664;5676;16634
500793;201708;2216;6128;1609;5062;484;1569;255;704;739;2273
500795;201708;2400;6825;2031;6308;213;558;1479;4936;1692;5494
500797;201708;833;2197;556;1688;104;350;183;532;287;882
500800;201708;3132;7981;2246;6674;782;2657;402;1221;1184;3878
500830;201708;20977;54322;14328;42077;2504;8016;5411;15172;7915;23188
500840;201708;1380;3723;881;2727;104;342;303;871;407;1213
510010;201708;1355;3838;1074;3360;279;877;492;1596;771;2473
510020;201708;3689;10055;2141;6914;444;1499;425;1270;869;2769
510025;201708;7474;21022;5157;16494;1047;3653;1468;4421;2515;8074
510030;201708;1827;4580;1421;4021;300;918;636;1782;936;2700
510035;201708;1054;2905;710;2368;124;409;392;1404;516;1813
510040;201708;1974;5042;1507;4357;182;554;882;2548;1064;3102
510050;201708;2002;5508;1401;4434;345;1217;500;1487;845;2704
510060;201708;1644;4486;1233;3734;193;623;554;1622;747;2245
510080;201708;1017;3219;823;2821;233;911;135;367;368;1278
510100;201708;723;1851;490;1401;53;161;214;571;267;732
510120;201708;324;652;200;496;11;28;131;325;142;353
510125;201708;3079;7813;2284;6466;375;1286;861;2239;1236;3525
510130;201708;1734;4714;1397;4132;350;1114;404;1160;754;2274
510140;201708;3068;9223;2338;8205;916;3672;601;1879;1517;5551
510160;201708;1341;4333;1178;4079;230;830;710;2476;940;3306
510170;201708;5228;15416;4149;13517;829;2940;1735;5588;2564;8528
510180;201708;13183;33332;8785;26207;2445;7911;2125;7221;4570;15132
510185;201708;1628;4420;1189;3791;306;940;550;2068;856;3008
510190;201708;2554;6919;1743;5684;424;1512;645;2137;1069;3649
510250;201708;14620;42113;12571;39158;3118;10344;5852;18945;8970;29289
510260;201708;2225;9050;1809;8211;302;1312;965;5085;1267;6397
510263;201708;4079;11109;2830;8909;640;2170;497;1499;1137;3669
510267;201708;5929;17154;3928;12776;877;3014;798;2586;1675;5600
510268;201708;1389;3636;1000;2948;151;494;540;1529;691;2023
510269;201708;1040;3092;709;2402;246;918;143;435;389;1353
510270;201708;2949;9311;2343;8102;520;1805;837;2846;1357;4651
510279;201708;1834;5474;1445;4687;341;1203;535;1618;876;2821
510285;201708;1208;3402;885;2850;247;854;248;779;495;1633
510300;201708;3665;10040;2927;9010;269;855;2029;6393;2298;7248
510305;201708;1524;4686;1140;3934;253;909;354;1306;607;2215
510310;201708;809;2317;637;2025;213;701;194;631;407;1332
510320;201708;4005;11111;3020;9338;495;1744;1036;3127;1531;4871
510325;201708;5215;15937;4334;14712;1145;4047;2245;7989;3390;12036
510330;201708;2883;9149;2189;7910;555;2065;752;3009;1307;5074
510335;201708;5261;15526;4118;13977;477;1667;2647;9578;3124;11245
510336;201708;593;1774;443;1489;80;282;203;690;283;972
510337;201708;1921;6095;1459;5239;563;2127;284;1075;847;3202
510340;201708;80325;207927;54752;167335;17442;60068;9701;29893;27143;89961
510343;201708;1120;3216;810;2593;150;500;314;967;464;1467
510345;201708;1604;4703;1208;3946;248;831;434;1398;682;2229
510350;201708;3266;8722;2385;7431;612;2022;907;2900;1519;4922
510360;201708;1901;4396;1204;3550;95;370;840;2462;935;2832
510370;201708;1570;4929;1218;4322;216;798;666;2484;882;3282
510380;201708;540;1521;301;1024;82;300;38;133;120;433
510385;201708;992;3720;706;3071;85;418;335;1614;420;2032
510390;201708;1105;3479;951;3205;286;938;414;1488;700;2426
510395;201708;821;1945;571;1561;62;182;266;784;328;966
510410;201708;4122;12859;3422;11528;873;3001;1600;5683;2473;8684
510420;201708;2492;6057;1797;4970;194;643;929;2509;1123;3152
510450;201708;723;1853;457;1387;107;358;77;225;184;583
510452;201708;727;2232;516;1775;100;332;245;854;345;1186
510454;201708;896;2730;717;2391;120;440;390;1323;510;1763
510455;201708;977;2960;722;2390;137;520;238;725;375;1245
510460;201708;2378;6075;1725;5140;189;673;930;2665;1119;3338
510480;201708;4536;11486;3231;9191;505;1520;1348;3630;1853;5150
510490;201708;1610;4912;1330;4490;322;1157;617;2072;939;3229
510500;201708;1552;4447;1027;3436;188;753;426;1373;614;2126
510510;201708;3045;10102;2517;9080;759;3026;625;2347;1384;5373
510515;201708;6523;18331;4297;13891;960;3382;976;2825;1936;6207
510517;201708;1565;4573;1240;3980;374;1251;224;692;598;1943
510520;201708;2270;4923;1492;3936;42;110;914;2628;956;2738
510523;201708;996;2802;856;2563;107;310;566;1732;673;2042
510525;201708;5687;16935;4445;14421;933;3277;1412;4165;2345;7442
510530;201708;545;1439;410;1242;31;148;281;787;312;935
510550;201708;2907;9192;2223;7867;571;2131;693;2517;1264;4648
510558;201708;1951;5553;1666;5161;128;434;1018;3355;1146;3789
510560;201708;1748;5156;1084;3958;270;1087;234;889;504;1976
510562;201708;5500;15472;4014;12568;1085;3691;1019;3319;2104;7010
510590;201708;3334;8430;2556;7434;503;1390;1459;4507;1962;5897
510600;201708;1662;4125;1099;3201;254;755;353;1038;607;1793
510610;201708;2952;8138;2317;7180;262;907;1378;4209;1640;5116
510615;201708;2057;6086;1726;5554;502;1661;721;2448;1223;4109
510617;201708;739;2196;599;1960;35;102;478;1632;513;1734
510618;201708;1492;4223;1070;3413;207;763;479;1452;686;2215
510619;201708;796;2152;458;1518;83;316;67;197;150;513
510620;201708;1421;3486;750;2368;187;664;114;327;301;991
510621;201708;976;3118;831;2841;200;764;240;769;440;1533
510622;201708;4389;12896;3122;10175;900;3175;578;1780;1478;4955
510623;201708;3599;9601;2657;8008;581;2029;840;2368;1421;4397
510624;201708;1778;4823;852;2877;147;560;122;329;269;889
510625;201708;2077;5709;1540;4806;429;1521;243;764;672;2285
510626;201708;1670;4198;1022;3243;295;1057;196;622;491;1679
510627;201708;707;1979;477;1495;129;434;111;358;240;792
510628;201708;1585;3818;1060;3083;196;583;596;1768;792;2351
510629;201708;1774;5622;1407;4804;385;1419;410;1436;795;2855
510630;201708;2720;8696;1801;6742;395;1609;307;1215;702;2824
510631;201708;425;1159;340;1008;9;23;265;799;274;822
510637;201708;3123;8563;2508;7546;762;2530;800;2366;1562;4896
510642;201708;5112;16177;4238;14855;1230;4693;1676;6134;2906;10827
510645;201708;984;2148;593;1623;167;460;161;467;328;927
510650;201708;6587;20345;5862;19494;1153;4032;3869;13386;5022;17418
510665;201708;1843;4715;1137;3426;217;716;383;1167;600;1883
510670;201708;389;851;208;581;22;74;108;309;130;383
510675;201708;6531;19763;5106;16983;1431;5200;1077;3498;2508;8698
510677;201708;2074;5437;1562;4739;208;670;964;3025;1172;3695
510680;201708;729;2162;523;1737;125;425;77;237;202;662
510682;201708;2085;6492;1566;5519;432;1664;325;1143;757;2807
510685;201708;936;2494;713;2124;95;322;350;966;445;1288
510700;201708;4314;11038;2901;9040;708;2223;1261;4138;1969;6361
510704;201708;10514;27018;7455;21701;1427;4611;2809;7755;4236;12366
510706;201708;2046;5961;1373;4946;284;1088;646;2498;930;3586
510710;201708;3256;8820;2264;6821;467;1451;698;1950;1165;3401
510715;201708;707;1679;485;1319;71;194;181;502;252;696
510718;201708;2676;6164;1583;4859;674;2170;285;1083;959;3253
510719;201708;415;934;255;721;37;125;123;337;160;462
510720;201708;1129;2761;786;2282;186;607;259;689;445;1296
510724;201708;775;2206;555;1800;115;406;208;630;323;1036
510726;201708;773;1753;510;1367;70;209;324;830;394;1039
510729;201708;735;1811;383;1148;71;237;101;283;172;520
510730;201708;3099;8353;2192;6751;592;1923;595;1854;1187;3777
510735;201708;1035;3188;801;2841;114;466;458;1632;572;2098
510740;201708;1437;3933;1049;3342;126;363;647;2265;773;2628
510757;201708;731;2380;602;2136;245;917;193;653;438;1570
510760;201708;34717;85150;22530;65556;6506;20987;4602;12400;11108;33387
510770;201708;4723;11068;3724;9906;380;929;2374;6992;2754;7921
510774;201708;376;1038;293;859;60;165;131;411;191;576
510775;201708;705;2050;544;1761;142;535;110;322;252;857
510776;201708;558;1549;430;1285;100;294;161;493;261;787
510777;201708;1662;4681;1222;4089;82;289;1000;3394;1082;3683
510779;201708;645;1879;510;1636;62;189;286;943;348;1132
510780;201708;3864;11023;3068;9793;749;2498;1163;4080;1912;6578
510785;201708;1975;5426;1270;4163;335;1211;175;585;510;1796
510787;201708;2557;7421;1961;6367;852;2899;241;753;1093;3652
510788;201708;638;1592;441;1295;93;265;166;586;259;851
510790;201708;16308;46196;10848;35693;2391;9082;1163;3537;3554;12619
510792;201708;9183;25772;6072;19963;1249;4541;1070;3398;2319;7939
510794;201708;1305;3905;963;3258;275;1025;218;674;493;1699
510795;201708;8605;25068;6238;20674;1705;6203;1152;4003;2857;10206
510800;201708;1656;4507;1250;3890;272;916;532;1578;804;2494
510805;201708;2054;5640;1462;4599;298;1003;560;1641;858;2644
510810;201708;690;1618;514;1376;137;370;247;636;384;1006
510820;201708;764;1718;484;1322;70;234;203;516;273;750
510830;201708;724;1994;557;1750;109;340;285;953;394;1293
510835;201708;657;1818;475;1501;76;263;211;630;287;893
510840;201708;47023;115996;37138;103068;8315;23728;17495;50776;25810;74504
510850;201708;1661;4438;1061;3378;332;1218;212;606;544;1824
510860;201708;2846;8442;1977;6818;666;2590;178;590;844;3180
510880;201708;610;1980;519;1811;144;538;215;763;359;1301
510885;201708;658;1761;503;1527;98;336;194;561;292;897
510890;201708;804;2400;652;2184;129;466;351;1197;480;1663
510895;201708;1296;3687;980;3122;233;836;333;974;566;1810
520005;201708;1878;5498;1590;5115;477;1484;691;2450;1168;3934
520010;201708;2080;6577;1530;5393;540;2147;250;764;790;2911
520013;201708;3285;9049;2380;7292;536;1693;675;2168;1211;3861
520015;201708;524;1460;421;1318;113;377;126;417;239;794
520017;201708;1140;3254;912;2883;218;740;394;1224;612;1964
520020;201708;437;1100;340;962;87;259;153;418;240;677
520025;201708;32320;93574;29037;89585;3503;11648;21168;65317;24671;76965
520030;201708;5123;15023;4184;13473;640;2240;2179;7072;2819;9312
520050;201708;459;1132;281;803;23;58;160;472;183;530
520055;201708;890;2654;744;2375;120;369;392;1270;512;1639
520060;201708;1468;4451;1198;3935;297;1096;331;1034;628;2130
520080;201708;1951;5359;1578;4871;302;889;790;2640;1092;3529
520082;201708;1078;2794;935;2555;122;278;583;1649;705;1927
520085;201708;768;2286;658;2100;161;499;218;685;379;1184
520090;201708;970;2181;687;1826;123;283;384;1103;507;1386
520110;201708;43678;122559;32913;105969;11600;42685;2767;8190;14367;50875
520120;201708;195;498;115;359;13;41;39;125;52;166
520130;201708;3673;9897;3252;9257;702;2164;1681;4877;2383;7041
520140;201708;37520;116249;31035;104281;11044;40474;3661;12289;14705;52763
520145;201708;421;1160;314;970;67;218;102;295;169;513
520150;201708;535;1392;430;1268;70;220;250;724;320;944
520160;201708;957;2462;762;2175;163;482;290;827;453;1309
520170;201708;5007;10828;3776;9441;271;746;3088;7767;3359;8513
520180;201708;2309;6528;1930;5969;419;1438;842;2543;1261;3981
520215;201708;2023;5104;1595;4410;308;933;765;2067;1073;3000
520235;201708;703;1754;498;1444;84;277;185;504;269;781
520250;201708;1630;4418;1151;3657;314;1073;208;673;522;1746
520260;201708;830;2069;524;1510;78;234;203;577;281;811
520280;201708;596;1682;498;1499;151;447;194;640;345;1087
520310;201708;1283;2988;896;2376;235;646;297;878;532;1524
520320;201708;2031;6039;1644;5327;187;641;879;2886;1066;3527
520330;201708;3092;9350;2334;8012;611;2352;632;2167;1243;4519
520340;201708;2056;4990;1502;4198;208;524;947;2791;1155;3315
520350;201708;3430;8989;2557;7439;710;2226;809;2244;1519;4470
520355;201708;1586;4560;1303;4108;340;1179;559;1749;899;2928
520357;201708;832;2165;669;1915;62;189;453;1305;515;1494
520360;201708;781;2172;632;1918;194;611;198;620;392;1231
520380;201708;1366;3593;864;2606;119;398;359;1001;478;1399
520390;201708;1044;2500;621;1912;202;716;151;416;353;1132
520393;201708;575;1379;436;1174;53;147;223;570;276;717
520396;201708;755;2262;640;2049;127;398;373;1203;500;1601
520400;201708;1647;4622;1385;4248;285;932;795;2412;1080;3344
520410;201708;1629;3787;1147;3107;172;524;682;1802;854;2326
520420;201708;360;966;268;775;33;103;151;397;184;500
520425;201708;1361;3568;1009;2927;265;783;420;1245;685;2028
520430;201708;1946;5039;1152;3565;222;735;94;280;316;1015
520440;201708;3782;9579;2490;7274;692;2162;521;1525;1213;3687
520450;201708;11499;30439;7840;24056;2225;7486;462;1440;2687;8926
520455;201708;750;2165;580;1887;207;735;156;512;363;1247
520460;201708;953;2602;790;2357;123;401;480;1421;603;1822
520465;201708;849;2290;736;2120;104;354;462;1255;566;1609
520470;201708;1832;5759;1631;5455;345;1189;1005;3524;1350;4713
520480;201708;906;2629;613;2088;128;477;118;357;246;834
520485;201708;1474;4399;1276;4114;212;732;820;2668;1032;3400
520490;201708;4018;12089;3145;10713;684;2397;1623;5665;2307;8062
520495;201708;1485;3671;1220;3327;92;271;885;2505;977;2776
520500;201708;1426;3936;1163;3553;287;974;445;1309;732;2283
520505;201708;805;2115;626;1859;146;422;292;868;438;1290
520510;201708;8936;23979;6279;19848;1424;5075;1789;5680;3213;10755
520520;201708;1160;3094;912;2726;275;844;292;933;567;1777
520530;201708;2055;6532;1643;5814;588;2105;382;1532;970;3637
520540;201708;3058;8347;2109;6545;529;1706;392;1269;921;2975
520545;201708;1075;3106;864;2741;168;575;271;831;439;1406
520547;201708;732;2255;622;2052;190;636;209;673;399;1309
520549;201708;10693;31059;8849;28315;2116;7078;4286;13979;6402;21057
520551;201708;4031;11886;3586;11212;665;2324;2264;6964;2929;9288
520552;201708;795;2313;715;2212;101;313;506;1604;607;1917
520570;201708;613;1636;446;1369;125;400;150;462;275;862
520580;201708;3139;7364;2205;6103;315;933;1263;3524;1578;4457
520590;201708;1478;4161;1110;3500;241;806;227;729;468;1535
520620;201708;8384;23723;7022;21900;1898;6177;3124;9890;5022;16067
520630;201708;1031;2585;700;2047;118;373;264;728;382;1101
520640;201708;2860;7624;2325;6713;556;1649;905;2660;1461;4309
520650;201708;948;2429;666;1920;111;336;322;938;433;1274
520660;201708;430;1051;248;755;64;221;51;166;115;387
520670;201708;1019;2925;882;2722;68;215;671;2058;739;2273
520680;201708;802;2070;604;1758;138;400;256;761;394;1161
520690;201708;345;850;232;675;66;191;79;237;145;428
520710;201708;579;1476;361;1058;12;33;214;612;226;645
520725;201708;1727;4287;1262;3514;170;529;787;2160;957;2689
520735;201708;866;2283;603;1789;104;313;206;621;310;934
520740;201708;1869;4769;1507;4301;241;702;889;2572;1130;3274
520750;201708;697;1775;547;1554;107;284;243;737;350;1021
520753;201708;1560;4009;1394;3787;154;385;936;2723;1090;3108
520760;201708;961;2366;849;2219;147;294;584;1679;731;1973
520780;201708;1881;4562;1409;3880;155;447;790;2121;945;2568
520790;201708;3124;7653;2296;6410;180;477;1582;4603;1762;5080
520800;201708;16873;45648;14202;42430;2736;7905;8726;27773;11462;35678
520810;201708;1231;2857;939;2526;145;435;548;1558;693;1993
520815;201708;636;1967;463;1602;162;639;49;168;211;807
520830;201708;1731;4197;1329;3729;65;149;1048;2939;1113;3088
520840;201708;1842;5744;1589;5337;600;2144;416;1490;1016;3634
520850;201708;665;1910;472;1596;122;469;118;400;240;869
520860;201708;6800;19748;5244;17209;1266;4453;1804;6092;3070;10545
520870;201708;98476;258902;72367;217692;21426;70705;15610;45655;37036;116360
520880;201708;7026;19938;5470;17660;1900;6767;970;3089;2870;9856
520890;201708;3995;10771;3096;9277;659;2241;1354;3983;2013;6224
520910;201708;3860;10657;2666;8439;854;2911;466;1427;1320;4338
520915;201708;665;1921;507;1592;105;360;202;621;307;981
520920;201708;3828;9727;2608;7931;411;1389;1146;3550;1557;4939
520929;201708;654;1696;502;1435;95;232;254;806;349;1038
520940;201708;1171;3196;924;2839;79;264;682;2104;761;2368
520945;201708;657;1528;515;1299;76;179;292;702;368;881
520960;201708;1067;2985;839;2572;166;536;362;1102;528;1638
520970;201708;2802;8364;2383;7604;664;2317;575;1843;1239;4160
520980;201708;805;2214;678;2022;178;580;293;860;471;1440
520990;201708;3067;9560;2852;9262;292;1001;1947;6604;2239;7605
520993;201708;1036;2603;787;2202;50;145;544;1537;594;1682
520995;201708;2335;6245;1982;5775;427;1244;1068;3171;1495;4415
521000;201708;7676;22517;6095;19487;1877;6431;1396;4384;3273;10815
521010;201708;4213;11769;3264;10047;609;1854;1484;4584;2093;6438
521015;201708;730;1915;614;1730;98;276;400;1123;498;1399
521020;201708;2922;8233;1996;6322;561;1920;219;651;780;2571
521030;201708;680;1669;502;1380;75;192;219;634;294;826
521040;201708;6798;17717;5503;15688;1771;5339;1704;5054;3475;10393
521056;201708;884;2548;697;2235;223;770;181;619;404;1389
521060;201708;1063;2717;834;2363;88;259;469;1368;557;1627
521080;201708;1146;2748;639;1918;72;243;230;606;302;849
521090;201708;3110;8098;2345;6993;724;2300;529;1617;1253;3917
521100;201708;1940;4530;1419;3817;230;613;842;2317;1072;2930
521120;201708;4970;12405;3784;10846;703;2078;1633;5068;2336;7146
521130;201708;1084;2778;750;2145;60;215;408;1157;468;1372
521140;201708;1063;3063;844;2655;174;571;279;898;453;1469
521150;201708;12452;30778;8125;23452;2479;7711;2275;6749;4754;14460
521160;201708;911;2083;569;1536;95;287;254;649;349;936
521170;201708;1176;2865;859;2371;110;323;515;1373;625;1696
521180;201708;6536;20303;5747;18895;1472;5185;1894;6332;3366;11517
521190;201708;9087;25446;5911;19515;1491;5345;1094;3672;2585;9017
521200;201708;789;2089;606;1783;67;223;337;973;404;1196
521205;201708;645;1741;500;1491;45;140;322;952;367;1092
521210;201708;901;2470;537;1688;117;419;77;193;194;612
521220;201708;4500;11052;3171;9160;673;2074;1198;3437;1871;5511
521225;201708;397;953;327;876;33;81;240;674;273;755
521230;201708;1380;4040;1256;3822;441;1336;585;1814;1026;3150
521250;201708;31636;93575;26378;85774;10988;37118;6847;23968;17835;61086
521260;201708;728;1731;570;1503;94;280;326;853;420;1133
521270;201708;1865;5163;1686;4923;173;392;1285;3937;1458;4329
521280;201708;2061;5959;1625;5143;498;1716;469;1474;967;3190
521290;201708;479;1267;359;1100;82;292;178;528;260;820
521295;201708;1243;2868;1010;2562;110;258;740;1970;850;2228
521300;201708;1980;5310;1657;4834;227;670;1068;3180;1295;3850
521305;201708;756;2063;592;1788;106;311;314;982;420;1293
521308;201708;4576;13318;3588;11403;747;2436;1616;5182;2363;7618
521310;201708;8871;24988;6132;19733;1530;5343;1423;4392;2953;9735
521340;201708;359;881;322;834;24;55;264;685;288;740
521350;201708;2071;5420;1633;4740;271;760;1001;2951;1272;3711
521370;201708;1056;2910;704;2282;221;771;82;269;303;1040
521375;201708;1480;4106;1145;3607;278;943;444;1409;722;2352
521377;201708;1257;2960;1069;2742;58;137;921;2384;979;2521
521380;201708;6140;16762;4190;13171;556;1830;1057;3415;1613;5245
521385;201708;596;1501;486;1372;126;366;207;627;333;993
521390;201708;762;2060;599;1826;187;634;179;548;366;1182
521400;201708;2131;5742;1873;5432;281;918;1310;3803;1591;4721
521405;201708;1454;3959;1134;3407;282;895;475;1454;757;2349
521410;201708;748;2190;687;2104;177;500;330;1096;507;1596
521440;201708;1493;4150;1163;3500;284;913;319;853;603;1766
521450;201708;4043;12773;3248;11190;914;3287;730;2585;1644;5872
521460;201708;7091;19709;5591;17034;1639;5369;1863;5512;3502;10881
521470;201708;696;1968;471;1481;90;278;92;282;182;560
521480;201708;392;1127;235;786;45;160;69;219;114;379
521483;201708;2844;7250;2071;5896;528;1531;538;1516;1066;3047
521486;201708;1748;4279;1387;3785;97;259;1042;2829;1139;3088
521487;201708;516;1344;374;1128;82;254;131;402;213;656
521490;201708;846;2345;634;1973;34;131;429;1299;463;1430
521500;201708;1512;4408;1149;3720;172;647;476;1444;648;2091
521520;201708;891;2034;637;1676;121;324;279;768;400;1092
521523;201708;13808;47564;12274;44309;3971;15206;2260;8905;6231;24111
521525;201708;1092;2739;882;2431;103;327;535;1426;638;1753
521530;201708;2101;5676;1327;4133;296;986;286;913;582;1899
521540;201708;915;2415;593;1859;100;381;241;736;341;1117
521550;201708;1624;4094;1046;2936;194;595;442;1211;636;1806
521560;201708;3844;12005;3043;10880;864;3420;1370;5059;2234;8479
521565;201708;623;1585;523;1458;82;221;334;924;416;1145
521570;201708;4886;13268;3145;9844;673;2275;409;1305;1082;3580
521580;201708;563;1331;327;967;58;168;66;197;124;365
521590;201708;646;1707;500;1472;132;445;196;541;328;986
521600;201708;446;1285;294;954;73;238;58;175;131;413
521630;201708;1450;3522;988;2849;237;775;267;696;504;1471
521640;201708;2273;5627;1730;4861;410;1130;750;2175;1160;3305
521645;201708;565;1639;401;1307;101;342;118;348;219;690
521680;201708;1305;4128;1053;3610;341;1237;108;370;449;1607
521690;201708;567;1611;497;1494;115;380;232;670;347;1050
521710;201708;2958;8389;2275;7141;490;1612;503;1554;993;3166
521720;201708;2010;5500;1532;4630;257;798;778;2292;1035;3090
521730;201708;3944;12342;3269;11016;1158;4292;509;1482;1667;5774
521740;201708;3865;10593;3051;9402;772;2624;1143;3679;1915;6303
521760;201708;14950;45702;12591;41848;3569;13020;4276;14551;7845;27571
521770;201708;2795;7761;2119;6453;691;2255;482;1388;1173;3643
521800;201708;6831;20208;5752;18355;1759;5921;1895;6410;3654;12331
521805;201708;939;2080;662;1692;193;459;279;780;472;1239
521810;201708;810;2011;580;1676;106;331;238;711;344;1042
521830;201708;5334;16150;4610;15070;623;2240;2939;9546;3562;11786
521839;201708;705;1901;512;1540;118;399;184;511;302;910
521850;201708;6665;17512;4829;14427;1262;4076;886;2476;2148;6552
521860;201708;2010;5267;1495;4449;290;977;462;1336;752;2313
521870;201708;506;1617;421;1442;105;386;130;413;235;799
521878;201708;818;2308;573;1804;100;354;180;513;280;867
521880;201708;22425;57052;15480;46040;3953;12458;4498;13938;8451;26396
521890;201708;3439;9882;2449;7855;618;2125;343;1049;961;3174
521900;201708;1510;3827;1002;3056;237;764;329;960;566;1724
521910;201708;1238;2849;869;2416;114;350;489;1430;603;1780
521920;201708;350;1054;268;886;64;243;73;243;137;486
521925;201708;724;2146;578;1873;114;379;162;500;276;879
521930;201708;3743;11446;3220;10512;1049;3477;820;2804;1869;6281
521935;201708;668;1830;545;1595;132;377;232;671;364;1048
521940;201708;1112;2877;876;2551;219;724;403;1140;622;1864
521945;201708;665;2008;556;1817;98;338;255;885;353;1223
521950;201708;688;1702;546;1505;50;150;399;1107;449;1257
521960;201708;706;2018;527;1668;86;292;226;686;312;978
521970;201708;2806;7140;2309;6548;212;542;1787;5299;1999;5841
521971;201708;1006;2665;697;2120;133;420;166;497;299;917
521973;201708;1068;3146;888;2842;153;536;443;1408;596;1944
521975;201708;13105;35437;11609;33551;2028;6186;7413;21301;9441;27487
521980;201708;2343;6097;1936;5563;241;618;1424;4203;1665;4821
521990;201708;1204;3387;963;2997;136;442;560;1802;696;2244
522000;201708;2389;6369;1731;5513;224;750;859;2922;1083;3672
522005;201708;388;926;275;763;84;217;94;273;178;490
522010;201708;3653;9918;2887;8682;967;3006;640;1932;1607;4938
522015;201708;951;2735;764;2421;180;590;295;921;475;1511
522020;201708;5355;13520;3914;11244;939;2810;1663;4766;2602;7576
522026;201708;754;2034;549;1775;96;334;282;961;378;1295
522028;201708;585;1599;419;1237;65;208;191;527;256;735
522040;201708;2596;6054;1966;5281;353;968;1286;3506;1639;4474
522045;201708;16293;51425;13147;45072;3490;13014;2266;7656;5756;20670
522050;201708;1179;3317;833;2639;177;593;242;691;419;1284
522060;201708;2467;7216;2044;6565;390;1322;1058;3435;1448;4757
522068;201708;1719;5120;1520;4878;192;564;1087;3675;1279;4239
522070;201708;683;1971;597;1823;82;320;380;1102;462;1422
522100;201708;555;1584;447;1422;108;374;202;633;310;1007
522108;201708;859;2613;712;2369;67;299;516;1649;583;1948
522119;201708;1548;4367;1268;3957;237;753;638;2060;875;2813
522130;201708;370;1017;294;916;80;259;140;450;220;709
522140;201708;17275;48956;13650;42381;4189;13959;2319;6892;6508;20851
522145;201708;849;2177;654;1889;155;412;341;1074;496;1486
522150;201708;995;2540;792;2232;212;589;294;855;506;1444
522155;201708;924;2609;787;2392;179;502;399;1277;578;1779
522157;201708;663;1785;555;1627;36;135;401;1154;437;1289
522160;201708;6466;17752;4536;14260;1294;4435;430;1434;1724;5869
522170;201708;2469;7002;1850;5829;601;2035;344;1080;945;3115
522180;201708;422;1155;276;887;70;222;51;185;121;407
522185;201708;16803;45574;13279;41026;4294;14091;5070;16513;9364;30604
522190;201708;895;2168;683;1873;126;336;314;907;440;1243
522200;201708;1790;5623;1329;4586;299;1092;221;750;520;1842
522205;201708;1443;3792;1130;3307;132;430;719;2088;851;2518
522220;201708;1476;3685;1112;3185;143;393;648;1964;791;2357
522230;201708;1326;3526;1099;3178;172;563;615;1770;787;2333
530010;201708;195340;593311;171064;552222;42422;152514;72196;225874;114618;378388
110001;201707;3335;10770;2914;10071;705;2543;1377;4824;2082;7367
110002;201707;12996;36776;9935;31497;3083;10609;3015;9351;6098;19960
110003;201707;741;2280;600;2004;189;670;109;338;298;1008
110004;201707;9339;28771;7548;25230;2353;8364;1339;4825;3692;13189
110005;201707;1962;5822;1557;5101;421;1446;595;1981;1016;3427
110006;201707;1694;5101;1144;3935;348;1262;117;390;465;1652
110007;201707;1366;4004;1136;3582;332;1105;427;1543;759;2648
110008;201707;2474;8124;2267;7846;306;991;1722;6221;2028;7212
110009;201707;4625;13830;3494;11976;1053;3799;983;3507;2036;7306
110010;201707;7010;22371;6080;20927;1779;6211;2616;10005;4395;16216
110011;201707;6933;21067;5827;18913;2029;6925;1598;5190;3627;12115
110012;201707;15289;42866;11683;36661;3154;10485;2543;8098;5697;18583
110013;201707;5480;17049;4590;15359;1819;6276;1009;3666;2828;9942
110014;201707;4084;11472;3332;10234;997;3198;1428;4318;2425;7516
110015;201707;4985;14592;3363;11354;876;3164;486;1643;1362;4807
110018;201707;4013;10930;2825;9021;712;2563;874;2675;1586;5238
110020;201707;70285;185017;50940;158725;11620;38558;20656;67752;32276;106310
110025;201707;4337;12051;3407;10421;537;1766;2035;6088;2572;7854
110026;201707;625;1888;555;1776;164;551;254;828;418;1379
110028;201707;6369;19051;4914;16131;1459;5209;575;1862;2034;7071
110029;201707;1329;3673;1000;3170;277;902;411;1321;688;2223
110030;201707;10385;28128;7899;24555;1903;6599;2963;9183;4866;15782
110032;201707;3672;11322;2952;9835;981;3343;740;2475;1721;5818
110033;201707;4926;15700;4222;14410;1475;5093;1296;4786;2771;9879
110034;201707;3454;9130;2693;8071;850;2702;1264;3787;2114;6489
110037;201707;1856;6251;1606;5708;432;1627;684;2409;1116;4036
110040;201707;3286;10034;2657;8855;843;3003;774;2496;1617;5499
110045;201707;4936;15705;4287;14827;1373;5115;1775;6178;3148;11293
110050;201707;1657;5196;1373;4660;548;1921;379;1308;927;3229
110060;201707;818;2661;642;2277;229;863;90;334;319;1197
110070;201707;1967;6456;1663;5750;562;2055;515;1711;1077;3766
110080;201707;4925;13061;3988;11932;992;3096;2074;6409;3066;9505
110090;201707;696;1980;502;1630;125;447;221;688;346;1135
110092;201707;1327;4267;1166;4024;211;792;657;2342;868;3134
110094;201707;3438;10110;2833;9164;955;3251;990;3255;1945;6506
110100;201707;2106;6522;1862;6085;429;1514;948;3087;1377;4601
110110;201707;1642;5037;1352;4590;504;1781;311;1130;815;2911
110120;201707;1709;5291;1316;4458;383;1376;261;863;644;2239
110130;201707;2484;6846;1750;5601;507;1775;469;1512;976;3287
110140;201707;2396;7624;1866;6555;510;1891;458;1533;968;3424
110143;201707;1449;4135;1078;3465;376;1244;324;1052;700;2296
110145;201707;1106;3085;760;2423;183;641;281;873;464;1514
110146;201707;416;1249;341;1132;71;234;165;558;236;792
110147;201707;711;2044;517;1676;139;470;173;523;312;993
110148;201707;1125;3415;725;2473;133;485;86;294;219;779
110149;201707;3261;9535;2503;8338;906;3022;870;3093;1776;6115
110150;201707;2411;6807;1936;6115;769;2720;456;1361;1225;4081
110155;201707;829;2562;712;2308;172;593;281;873;453;1466
110160;201707;1809;5753;1471;5063;525;1822;384;1381;909;3203
110170;201707;2766;7662;1973;6222;430;1439;914;2851;1344;4290
110175;201707;1637;4909;1298;4417;207;751;688;2459;895;3210
110180;201707;1234;3580;1010;3227;297;934;486;1594;783;2528
120001;201707;2858;9388;2542;8900;534;1902;1477;5426;2011;7328
120005;201707;1686;6757;1566;6542;196;866;1119;4889;1315;5755
120010;201707;5020;16589;4739;16149;675;2229;3379;11896;4054;14125
120013;201707;2135;8355;2027;8201;506;1988;1171;5105;1677;7093
120017;201707;2081;7337;1921;7046;454;1695;954;3833;1408;5528
120020;201707;14455;62821;13951;61849;1827;8544;10000;45661;11827;54205
120025;201707;2394;8181;2294;8032;444;1599;1402;5016;1846;6615
120030;201707;6624;25475;6425;25241;309;1525;5649;22232;5958;23757
120032;201707;1557;7434;1486;7259;132;783;1134;5543;1266;6326
120033;201707;3676;14502;3560;14297;201;940;3099;12466;3300;13406
120034;201707;2072;8587;1948;8350;139;852;1549;6537;1688;7389
120035;201707;3204;14111;3101;13923;212;1151;2615;11807;2827;12958
120038;201707;2661;9239;2483;8914;587;2129;1331;4958;1918;7087
120039;201707;1823;8555;1766;8444;207;1265;1249;5938;1456;7203
120040;201707;44264;155402;40631;148955;8964;35607;21255;79205;30219;114812
120042;201707;3103;12532;2928;12148;183;955;2267;9429;2450;10384
120043;201707;1120;5024;1074;4936;76;399;911;4250;987;4649
120045;201707;4815;15602;4581;15338;307;1167;4059;13573;4366;14740
120050;201707;8217;32907;7813;32056;968;4353;5573;23446;6541;27799
120060;201707;8113;34970;7884;34562;706;3664;6307;27925;7013;31589
120070;201707;2748;9960;2644;9752;400;1487;1754;6696;2154;8183
120080;201707;3743;13847;3570;13561;635;2568;2452;9475;3087;12043
130002;201707;3245;13100;3014;12765;146;746;2648;11315;2794;12061
130006;201707;2224;9007;1925;8472;168;885;1449;6402;1617;7287
130008;201707;2338;8884;2145;8515;143;689;1718;6825;1861;7514
130010;201707;3408;10686;3135;10366;145;503;2819;9389;2964;9892
130014;201707;3286;10432;2809;9648;478;1777;1768;6156;2246;7933
130020;201707;2849;10669;2696;10406;121;689;2278;8680;2399;9369
130030;201707;8390;30480;7975;30008;254;763;7395;28427;7649;29190
130040;201707;3809;11511;3317;10887;267;956;2675;8917;2942;9873
130050;201707;6495;25904;6105;25394;284;1123;5336;22856;5620;23979
130060;201707;6316;28236;5965;27661;575;3246;4608;21427;5183;24673
130063;201707;4453;18229;4168;17882;216;1093;3721;16062;3937;17155
130068;201707;3308;13406;2964;12701;255;1266;2184;9426;2439;10692
130070;201707;8255;27340;7398;26352;462;1524;6308;23151;6770;24675
130080;201707;5822;24655;5401;24069;573;3068;4079;18314;4652;21382
130083;201707;2371;9023;2217;8785;240;1129;1680;6637;1920;7766
130090;201707;2987;10062;2810;9804;82;351;2477;8764;2559;9115
130100;201707;6088;21753;5869;21503;151;550;5547;20499;5698;21049
130110;201707;7049;22125;6574;21570;627;1819;5423;18396;6050;20215
130115;201707;4939;16804;4672;16408;162;590;4072;14441;4234;15031
130120;201707;15328;56637;14275;55271;1491;5957;11349;45030;12840;50987
130130;201707;4148;16323;4065;16181;464;2143;3140;12452;3604;14595
130140;201707;6355;24726;6238;24599;279;1186;5760;22777;6039;23963
130150;201707;3491;13848;3422;13763;136;743;3088;12405;3224;13148
130160;201707;4576;18283;4311;17942;409;2025;3498;14680;3907;16705
130165;201707;3042;12251;2897;12005;153;826;2454;10208;2607;11034
130170;201707;10351;34351;8767;32480;865;3474;6953;26380;7818;29854
130180;201707;3625;11917;3559;11836;68;230;3384;11326;3452;11556
130185;201707;13137;39317;11562;37591;639;1601;9916;33899;10555;35500
130190;201707;17406;59413;15179;56426;2209;8237;10496;40648;12705;48885
130195;201707;2027;8513;1962;8428;110;443;1736;7644;1846;8087
130200;201707;2113;7031;1912;6728;264;926;1368;4991;1632;5917
130210;201707;1418;5403;1283;5241;121;679;1006;4033;1127;4712
130220;201707;2058;8200;1895;7902;196;940;1359;5709;1555;6649
130230;201707;3825;17455;3562;17039;388;2096;2774;13550;3162;15646
130240;201707;9619;33715;8472;32068;308;1658;7337;27875;7645;29533
130250;201707;21250;71797;19907;70167;2131;7278;15700;57468;17831;64746
130255;201707;4335;15144;4016;14631;297;1253;3262;11940;3559;13193
130260;201707;256800;821946;228772;775224;67183;244139;94662;322921;161845;567060
130270;201707;7672;31069;7036;30080;843;3812;5198;22928;6041;26740
130280;201707;3377;13996;3244;13838;107;477;3006;13014;3113;13491
130290;201707;11691;40901;10996;40117;209;513;10458;38964;10667;39477
130300;201707;4718;17542;4454;17149;287;1363;3760;14532;4047;15895
130310;201707;5358;19983;4932;19423;418;1683;3991;16082;4409;17765
130320;201707;3188;11296;2911;10912;382;1432;2021;7873;2403;9305
130330;201707;3989;13977;3540;13416;165;841;3056;11550;3221;12391
130340;201707;19189;70900;17550;68916;1877;7326;14176;57499;16053;64825
130350;201707;3587;14195;3442;13986;230;1309;2903;11662;3133;12971
130353;201707;6468;19447;5651;18417;993;3116;3748;13119;4741;16235
130356;201707;4882;17246;4502;16638;533;2068;3192;12115;3725;14183
130360;201707;3465;9881;3028;9422;100;255;2809;8903;2909;9158
130370;201707;5597;21824;5070;21139;206;1149;4323;18151;4529;19300
130380;201707;8235;33765;7896;33279;536;2766;6674;28128;7210;30894
130390;201707;5435;23709;5111;23103;546;2893;3804;17172;4350;20065
130395;201707;2351;7979;2091;7500;251;934;1458;5276;1709;6210
130400;201707;2248;8140;2092;7916;121;536;1822;6950;1943;7486
130406;201707;11134;41513;10062;40061;1879;7820;6714;27301;8593;35121
130410;201707;3991;14764;3531;13958;1062;4420;1663;6788;2725;11208
130420;201707;11266;45846;10708;45053;1441;6394;8136;35026;9577;41420
130423;201707;3717;13407;3430;13018;218;1089;2932;11011;3150;12100
130426;201707;2494;10345;2416;10223;100;492;2170;9302;2270;9794
130430;201707;3684;12464;3517;12225;287;966;2914;10350;3201;11316
130440;201707;3924;13573;3608;13202;153;620;3260;12029;3413;12649
140002;201707;1792;5777;1624;5555;128;529;1265;4299;1393;4828
140005;201707;3620;9784;3474;9628;66;179;3344;9302;3410;9481
140010;201707;55275;156636;44801;141356;10905;36429;17873;59882;28778;96311
140015;201707;3140;9932;2884;9636;148;474;2559;8695;2707;9169
140017;201707;3459;10912;3097;10441;305;1042;2293;8066;2598;9108
140020;201707;4784;15489;4230;14728;490;1939;3053;10682;3543;12621
140023;201707;2269;7384;1956;6911;240;918;1338;4810;1578;5728
140028;201707;2175;5893;1945;5589;201;686;1471;4079;1672;4765
140030;201707;3862;11773;3553;11370;499;1422;2603;8664;3102;10086
140040;201707;1867;8388;1803;8303;94;568;1627;7449;1721;8017
140045;201707;2658;9813;2375;9424;441;1750;1538;6499;1979;8249
140047;201707;5864;17626;5090;16407;1224;3994;2476;8589;3700;12583
140050;201707;1472;4522;1282;4244;202;666;817;2783;1019;3449
140060;201707;1484;4377;1309;4110;176;587;954;3018;1130;3605
140070;201707;1704;9232;1646;9066;155;1074;1281;7028;1436;8102
150010;201707;39002;109591;36341;106003;2089;6842;30113;87693;32202;94535
150013;201707;1767;5042;1569;4819;178;514;1143;3617;1321;4131
150020;201707;12900;42431;12430;41791;1307;3824;10165;35352;11472;39176
150030;201707;7912;32448;7640;32062;511;2160;6556;28030;7067;30190
150034;201707;4276;11658;3796;10967;286;885;3079;8891;3365;9776
150040;201707;13109;40181;11579;38395;1219;3267;9229;32554;10448;35821
150050;201707;5933;22854;5629;22353;215;1095;4950;19701;5165;20796
150060;201707;19101;57979;17052;54729;4025;12850;9333;31341;13358;44191
150070;201707;6285;24922;5639;24222;185;987;5176;22443;5361;23430
150080;201707;83778;209325;71703;193475;15697;43773;30975;91493;46672;135266
150085;201707;6007;19594;5725;19247;297;797;5098;17626;5395;18423
150090;201707;10485;39510;9890;38633;822;3465;7820;30984;8642;34449
150095;201707;5552;17598;5021;16865;332;1057;4027;13951;4359;15008
150100;201707;3250;11788;2985;11309;221;963;2292;8621;2513;9584
150110;201707;3731;17371;3699;17320;210;1019;3304;15658;3514;16677
150120;201707;6972;24484;6779;24206;446;1361;5755;21297;6201;22658
150125;201707;780;2169;666;2031;108;375;431;1297;539;1672
150130;201707;23106;69086;21099;66214;2549;7606;15229;49296;17778;56902
150140;201707;178559;480144;163684;460696;23433;65124;114077;328200;137510;393324
150145;201707;4654;14259;4205;13670;525;1666;3256;10839;3781;12505
150150;201707;12889;37648;11832;36140;1471;4781;8475;26168;9946;30949
150157;201707;3166;9348;2718;8739;326;1149;1848;6072;2174;7221
150160;201707;3133;9771;2936;9485;763;2484;1580;5261;2343;7745
150170;201707;24570;83349;21932;79438;3410;12241;14267;54451;17677;66692
150172;201707;3330;10820;2890;10133;302;1056;2141;7718;2443;8774
150175;201707;1876;5594;1732;5424;143;507;1378;4408;1521;4915
150178;201707;10246;30358;8727;28553;860;2868;6605;22360;7465;25228
150180;201707;19272;75566;18473;74506;1105;4917;15891;64799;16996;69716
150190;201707;7180;24170;6899;23804;197;883;6268;21691;6465;22574
150195;201707;5540;17582;5224;17094;128;426;4788;15805;4916;16231
150200;201707;5468;16900;5143;16526;73;229;4870;15778;4943;16007
150210;201707;25169;93081;24364;91983;1697;6518;20463;79396;22160;85914
150215;201707;7811;24254;6866;22787;2228;7591;2633;9146;4861;16737
150220;201707;11731;35727;10537;33901;2238;7254;5637;18883;7875;26137
150230;201707;12435;37433;10815;35218;1732;5473;6988;23992;8720;29465
150240;201707;35341;103703;30225;94586;10087;32525;7945;25919;18032;58444
150250;201707;4086;16954;3940;16745;687;2932;2753;12182;3440;15114
150260;201707;2106;8092;2002;7919;308;1246;1321;5357;1629;6603
150270;201707;8383;25052;6466;22553;1770;6344;3047;11139;4817;17483
150275;201707;6178;21671;5807;21109;580;2048;4430;16474;5010;18522
150276;201707;2220;6532;1980;6230;279;907;1485;4769;1764;5676
150277;201707;4835;14438;4131;13581;509;1763;3052;10335;3561;12098
150280;201707;6043;26516;5869;26144;664;2985;4546;20629;5210;23614
150285;201707;3140;11757;2885;11353;323;1364;1996;8010;2319;9374
150290;201707;10414;29120;9871;28518;670;1597;8527;25498;9197;27095
150293;201707;9402;24845;7002;21565;2071;6531;2599;8898;4670;15429
150295;201707;7732;21960;6322;20297;1602;5139;3292;11907;4894;17046
150300;201707;2075;6709;1922;6500;86;396;1595;5364;1681;5760
150304;201707;4235;13378;3692;12506;653;2183;2334;8228;2987;10411
150307;201707;6580;21468;6185;20914;359;1250;5272;17947;5631;19197
150309;201707;6254;20735;5517;19635;1330;4674;2864;10922;4194;15596
150310;201707;6571;27511;6256;27075;449;2258;5220;22714;5669;24972
150320;201707;9653;25001;8818;24038;558;1448;7250;20038;7808;21486
150330;201707;14349;47636;13423;46290;1854;6495;9743;34558;11597;41053
150340;201707;2630;8059;2424;7747;212;677;1852;5969;2064;6646
150345;201707;7209;22961;6715;22286;558;1958;5400;18216;5958;20174
150350;201707;8401;24581;7814;23869;1127;2845;5921;18994;7048;21839
150360;201707;22037;66762;19044;62990;2932;9456;12717;44012;15649;53468
150370;201707;10150;35412;9152;34054;979;3645;6787;26269;7766;29914
150375;201707;3078;13159;2819;12762;270;1295;2299;10530;2569;11825
150380;201707;9788;27804;8537;26055;485;1523;7124;22078;7609;23601
150390;201707;7946;33944;7411;32997;1249;5291;4873;22806;6122;28097
150400;201707;6097;23171;5842;22684;422;1635;4697;18524;5119;20159
150405;201707;8446;24788;7518;23652;656;1627;5789;19355;6445;20982
150410;201707;1660;6040;1520;5767;246;979;945;3643;1191;4622
150420;201707;36729;119327;30344;109097;10079;38627;8454;33803;18533;72430
150430;201707;7764;25104;7334;24478;846;2732;5534;18974;6380;21706
150440;201707;5543;18626;5311;18309;421;1405;4361;15331;4782;16736
150442;201707;22322;62505;19521;58322;3146;9347;11812;36715;14958;46062
150445;201707;5688;18956;5195;18173;424;1486;4087;14573;4511;16059
150450;201707;4470;20959;4297;20679;421;2135;3483;17025;3904;19160
150460;201707;7471;26481;6883;25738;369;1653;5739;22234;6108;23887
150470;201707;18134;54465;17294;53449;1333;3494;14846;46907;16179;50401
150475;201707;3959;13490;3618;13009;269;1015;2926;10713;3195;11728
150480;201707;14401;48512;13111;46486;1740;6336;9481;34557;11221;40893
150490;201707;7366;27717;7143;27383;260;1230;6307;24314;6567;25544
150495;201707;5088;18414;4928;18207;167;674;4520;16828;4687;17502
150497;201707;2643;9451;2346;8883;694;2705;1065;4206;1759;6911
150500;201707;3242;8761;2961;8351;328;892;2297;6498;2625;7390
150503;201707;3848;11631;3141;10631;973;3370;1505;5364;2478;8734
150506;201707;10864;36983;9891;35607;2134;7183;6240;24178;8374;31361
150510;201707;10101;38428;9083;36325;1472;5682;5805;24532;7277;30214
150520;201707;6911;26908;6796;26761;228;939;6344;25180;6572;26119
150530;201707;12526;42988;11266;40989;1301;4221;8399;31670;9700;35891
150540;201707;4744;14010;4163;13195;232;777;3457;10976;3689;11753
150543;201707;6099;18235;5337;17186;1001;3270;3411;11427;4412;14697
150548;201707;9911;31109;9190;30207;363;1062;8353;27792;8716;28854
150549;201707;2080;6559;1886;6341;61;235;1708;5770;1769;6005
150550;201707;20491;64181;17798;59578;5285;17984;6544;23317;11829;41301
150553;201707;23825;79535;19599;71289;6886;26445;5180;20186;12066;46631
150555;201707;1789;5197;1479;4696;90;314;1053;3356;1143;3670
150560;201707;1864;6028;1711;5722;284;931;990;3382;1274;4313
150563;201707;2614;8574;2381;8155;524;1885;1275;4396;1799;6281
150565;201707;4029;13672;3663;13081;129;606;3054;10991;3183;11597
150570;201707;5930;21203;5744;20893;411;1667;4593;16754;5004;18421
150580;201707;9987;41606;9661;41203;667;2947;8230;35853;8897;38800
150590;201707;6232;24109;5985;23788;190;898;5530;22012;5720;22910
150600;201707;8364;31304;7944;30715;265;1203;7110;27727;7375;28930
150610;201707;2458;8104;2267;7724;181;699;1733;5837;1914;6536
150611;201707;2832;9291;2650;8986;152;560;2194;7457;2346;8017
150613;201707;12743;37167;10145;33034;2585;8738;4336;14707;6921;23445
150616;201707;3238;9593;2435;8226;569;2128;725;2327;1294;4455
150618;201707;6711;22005;5927;20619;1295;4577;3235;11683;4530;16260
150619;201707;5279;17450;4804;16702;490;1869;3549;12311;4039;14180
150620;201707;6534;22810;5807;21879;703;2748;4343;16604;5046;19352
150630;201707;6170;17589;5824;17187;419;1289;4950;14783;5369;16072
150635;201707;3996;12687;3576;11896;905;3058;1567;5437;2472;8495
150640;201707;2094;6044;1949;5885;67;200;1790;5521;1857;5721
150650;201707;11845;35503;10684;33439;3090;9617;4519;14999;7609;24616
150655;201707;5207;16557;4874;15978;439;1468;3844;12691;4283;14159
150658;201707;4546;13290;3875;12387;765;2691;2314;7655;3079;10346
150660;201707;5728;17531;5211;16786;974;3093;3111;10303;4085;13396
150670;201707;7916;20182;6390;18343;695;1947;4913;14540;5608;16487
150680;201707;64261;209113;53317;191547;14712;53650;22398;89346;37110;142996
150690;201707;2099;6239;1886;5921;156;498;1463;4646;1619;5144
150700;201707;6227;19398;5722;18739;707;2276;4078;13826;4785;16102
150710;201707;4327;14367;3870;13652;367;1424;2772;9892;3139;11316
150715;201707;5000;15286;4350;14286;410;1496;3237;10669;3647;12165
150720;201707;6520;25554;6157;24904;601;2673;4706;19388;5307;22061
150730;201707;10560;35142;9681;33676;1198;4350;7155;25449;8353;29799
150740;201707;3694;11481;3294;10775;545;1813;2005;6639;2550;8452
150745;201707;4932;15534;4409;14804;992;3507;2726;9244;3718;12751
150746;201707;1368;4451;1295;4314;104;326;1015;3459;1119;3785
150747;201707;5407;16682;4772;15869;785;2369;3082;11076;3867;13445
150750;201707;3522;11292;3177;10810;213;853;2507;8615;2720;9468
150760;201707;11611;36107;10770;35031;1233;4065;7994;26483;9227;30548
150770;201707;6005;22494;5788;22167;210;675;5175;20743;5385;21418
150775;201707;1050;3148;891;2885;167;663;501;1571;668;2234
150780;201707;3774;12007;3630;11845;125;487;3315;10845;3440;11332
150790;201707;5129;16321;4674;15803;278;891;3830;13882;4108;14773
150795;201707;14814;47719;13392;45452;3046;10062;7638;27361;10684;37423
150796;201707;3327;9316;2972;8898;251;775;2339;7182;2590;7957
150797;201707;3828;12909;3505;12335;131;480;2906;10297;3037;10777
150800;201707;14050;45086;12894;43675;2368;7370;8852;31930;11220;39300
150803;201707;6864;24093;6421;23398;668;2551;4895;18029;5563;20580
150805;201707;2829;9893;2592;9500;353;1273;1842;6893;2195;8166
150808;201707;5803;18691;4641;16473;1745;6752;533;2008;2278;8760
150810;201707;20136;58920;16158;54034;2796;9133;9775;35023;12571;44156
150812;201707;5420;16575;4943;15767;568;1992;3515;10986;4083;12978
150815;201707;8704;28168;7776;27000;811;2786;5980;21376;6791;24162
150820;201707;11594;33114;10392;31772;808;2211;8320;26312;9128;28523
150830;201707;12725;47766;12052;46930;590;2969;10058;40151;10648;43120
150835;201707;2186;7611;2025;7296;462;1670;1042;3900;1504;5570
150840;201707;7604;22840;6191;20412;1379;4878;2711;9068;4090;13946
160005;201707;863;2825;821;2747;42;169;708;2356;750;2525
160010;201707;1435;4751;1432;4748;18;30;1401;4686;1419;4716
160015;201707;1884;6854;1827;6772;96;350;1641;6172;1737;6522
160020;201707;1889;6936;1758;6727;249;1050;1274;4898;1523;5948
160021;201707;1080;4549;1042;4483;113;624;785;3357;898;3981
160023;201707;1031;4247;1014;4213;81;328;854;3615;935;3943
160025;201707;1498;4546;1478;4524;37;101;1420;4368;1457;4469
160027;201707;8356;24588;7773;23937;973;2765;6045;19395;7018;22160
160030;201707;52303;174281;46013;164442;11064;39064;23445;90843;34509;129907
160040;201707;4396;16927;4289;16780;223;1180;3822;14739;4045;15919
160050;201707;3446;12470;3050;11912;1509;5622;951;4371;2460;9993
160053;201707;3014;11050;2928;10923;686;2495;1899;7356;2585;9851
160055;201707;560;2249;555;2242;26;140;505;2019;531;2159
160060;201707;16254;54967;15444;54022;1697;5601;12202;43935;13899;49536
160070;201707;2850;11015;2663;10707;199;943;2174;8812;2373;9755
160080;201707;2603;9606;2536;9522;79;380;2344;8790;2423;9170
170025;201707;557;1733;474;1621;142;479;217;769;359;1248
170030;201707;1204;3869;1022;3541;203;708;478;1734;681;2442
170035;201707;1451;3923;1140;3409;141;459;632;1904;773;2363
170040;201707;1912;5732;1638;5381;164;582;844;3022;1008;3604
170070;201707;1649;4302;1248;3775;188;601;712;2193;900;2794
170100;201707;2353;6856;2033;6379;204;642;1465;4631;1669;5273
170105;201707;758;2371;571;1961;144;507;226;763;370;1270
170110;201707;920;3009;791;2762;176;669;338;1202;514;1871
170130;201707;1380;4324;1070;3710;233;843;485;1771;718;2614
170190;201707;1629;4679;1175;3933;377;1213;257;1075;634;2288
170200;201707;1642;4442;1037;3296;294;1014;204;600;498;1614
170210;201707;31112;86881;24624;76565;8108;27422;4298;14412;12406;41834
170215;201707;1274;3823;1081;3536;92;376;777;2506;869;2882
170220;201707;5760;19051;5236;18026;1278;4405;2618;9386;3896;13791
170230;201707;1347;4229;1076;3693;230;846;426;1461;656;2307
170240;201707;2813;8207;2244;7295;209;828;1484;4763;1693;5591
170255;201707;3525;11027;2827;9744;808;2859;1122;3982;1930;6841
170270;201707;1018;2486;672;2010;34;107;460;1356;494;1463
170290;201707;2922;8261;2526;7817;251;546;2003;6729;2254;7275
170300;201707;1898;5651;1559;5104;203;650;962;3260;1165;3910
170305;201707;743;2164;586;1858;83;286;285;877;368;1163
170307;201707;1002;3541;851;3242;179;707;414;1622;593;2329
170310;201707;1545;4294;1167;3630;252;846;557;1713;809;2559
170320;201707;1136;3183;825;2667;153;522;404;1327;557;1849
170330;201707;822;2655;743;2524;44;179;558;1868;602;2047
170360;201707;474;1440;382;1281;62;237;215;688;277;925
170370;201707;1326;3684;1013;3180;162;524;485;1545;647;2069
170380;201707;1834;5820;1457;5176;197;777;795;2912;992;3689
170382;201707;592;1797;475;1602;68;249;289;968;357;1217
170384;201707;1603;6283;1436;5964;404;1779;638;2676;1042;4455
170386;201707;862;2456;618;1980;111;402;131;366;242;768
170388;201707;609;1802;461;1541;86;307;195;634;281;941
170389;201707;906;3009;801;2833;61;250;594;2076;655;2326
170390;201707;1364;3681;1086;3344;89;287;825;2598;914;2885
170410;201707;537;1690;430;1496;24;100;272;947;296;1047
170460;201707;487;1307;344;1068;49;175;173;544;222;719
170510;201707;807;2614;622;2256;92;385;299;1061;391;1446
170550;201707;6640;18583;4865;15511;1522;5418;730;2372;2252;7790
170555;201707;1356;3821;1073;3384;150;505;545;1759;695;2264
170560;201707;1159;3435;878;3047;144;566;461;1756;605;2322
170600;201707;1341;3844;1148;3565;313;885;611;2016;924;2901
170610;201707;1646;4874;1306;4271;129;482;842;2715;971;3197
170625;201707;405;1194;298;962;40;137;101;304;141;441
170650;201707;1241;3879;985;3404;247;884;349;1309;596;2193
170700;201707;3985;12210;3194;10841;659;2446;1375;4804;2034;7250
170710;201707;1768;5107;1387;4401;299;1045;604;1813;903;2858
170720;201707;1877;4916;1605;4518;142;313;1280;3789;1422;4102
170730;201707;958;2857;765;2527;208;727;329;1112;537;1839
170740;201707;2112;7450;1824;6916;274;1065;1154;4460;1428;5525
170755;201707;850;2564;632;2122;83;321;294;977;377;1298
170765;201707;1273;3446;920;2881;241;779;340;1144;581;1923
170770;201707;1740;5684;1541;5351;275;924;916;3286;1191;4210
170820;201707;4113;14475;3730;13826;612;2191;2180;8676;2792;10867
170825;201707;999;2524;816;2255;92;229;511;1448;603;1677
170830;201707;1449;4085;1185;3675;59;145;948;2990;1007;3135
170900;201707;2564;8957;2392;8691;206;832;1916;7023;2122;7855
170930;201707;3720;10816;3167;9935;697;2395;1518;4908;2215;7303
170950;201707;13931;40023;10315;33782;3018;11181;1456;4882;4474;16063
170980;201707;508;1418;382;1211;49;171;197;588;246;759
171050;201707;1553;5175;1391;4876;92;421;1058;3670;1150;4091
171070;201707;1391;4242;1253;4037;277;821;764;2650;1041;3471
171090;201707;1124;2889;915;2604;61;177;674;1910;735;2087
171110;201707;591;1717;433;1438;121;456;168;484;289;940
171150;201707;1026;2751;670;2121;80;279;394;1247;474;1526
171180;201707;700;2079;473;1615;92;327;200;720;292;1047
171190;201707;1567;5776;1390;5426;260;1060;716;2926;976;3986
171195;201707;842;2890;724;2684;96;451;457;1674;553;2125
171200;201707;638;1945;498;1685;137;494;169;563;306;1057
171215;201707;450;1328;341;1113;76;281;144;458;220;739
171240;201707;714;2577;651;2453;73;337;400;1539;473;1876
171245;201707;597;1986;487;1728;104;404;198;684;302;1088
171250;201707;1070;2998;838;2620;193;643;412;1269;605;1912
171270;201707;397;1585;364;1501;117;447;152;708;269;1155
171280;201707;884;2721;720;2424;169;576;315;1144;484;1720
171320;201707;3945;11577;3243;10366;874;2793;1318;4490;2192;7283
171330;201707;2767;7944;2213;7026;553;1883;1029;3326;1582;5209
171360;201707;1415;4422;1253;4193;108;395;977;3283;1085;3678
171370;201707;682;1879;561;1715;73;249;364;1112;437;1361
171380;201707;1306;4124;1068;3693;341;1186;340;1291;681;2477
171395;201707;919;2698;680;2232;111;430;327;1032;438;1462
171420;201707;1878;5837;1428;4930;294;1110;588;2037;882;3147
171430;201707;1056;3175;872;2861;121;410;551;1783;672;2193
171488;201707;2533;7691;2100;7021;410;1380;1109;3880;1519;5260
171500;201707;884;2492;698;2191;72;241;476;1489;548;1730
171510;201707;831;2877;741;2714;65;279;507;1870;572;2149
171515;201707;497;1391;377;1183;37;118;220;682;257;800
171525;201707;612;1931;521;1771;45;188;334;1087;379;1275
171550;201707;366;1141;272;983;59;232;109;397;168;629
171570;201707;1271;3877;1095;3544;204;631;688;2313;892;2944
171575;201707;1931;5265;1340;4213;230;772;592;1835;822;2607
171610;201707;5362;16541;4384;14836;1118;4149;1246;4344;2364;8493
171620;201707;2808;7906;2376;7336;125;461;1934;6024;2059;6485
171630;201707;912;2758;766;2533;194;683;410;1351;604;2034
171650;201707;2214;6744;1652;5585;400;1404;546;1873;946;3277
171660;201707;2416;6593;1782;5452;302;942;905;2742;1207;3684
171665;201707;1490;4263;1151;3747;231;816;521;1752;752;2568
171670;201707;1877;5177;1509;4585;335;1157;709;2087;1044;3244
171700;201707;1117;3468;898;3063;152;498;472;1646;624;2144
171720;201707;784;2248;661;2035;110;340;400;1247;510;1587
171750;201707;1194;3613;884;3006;244;841;227;831;471;1672
171780;201707;1250;3313;910;2822;85;301;558;1716;643;2017
171790;201707;1474;5166;1219;4564;285;1098;559;2212;844;3310
171800;201707;732;2180;593;1972;68;239;371;1265;439;1504
171820;201707;10422;30760;8426;27471;1897;6610;3346;11226;5243;17836
171830;201707;1372;4987;1228;4671;313;1185;557;2239;870;3424
171840;201707;716;1995;603;1829;39;136;439;1300;478;1436
171845;201707;676;1848;532;1611;85;293;275;838;360;1131
171850;201707;892;3158;785;2932;86;369;518;1927;604;2296
171855;201707;1155;3611;1041;3414;78;265;738;2417;816;2682
171865;201707;430;1453;373;1359;71;276;176;640;247;916
171870;201707;721;2115;558;1813;116;375;242;880;358;1255
171875;201707;1252;3895;1041;3550;82;347;747;2492;829;2839
171880;201707;906;3191;869;3140;77;257;717;2670;794;2927
171884;201707;927;2533;681;2165;142;516;199;714;341;1230
171886;201707;1378;4291;1059;3655;316;1181;192;677;508;1858
171888;201707;742;2185;550;1814;56;206;329;1064;385;1270
171889;201707;522;1590;454;1467;81;278;213;727;294;1005
171890;201707;1198;3497;976;3174;172;559;549;1811;721;2370
171900;201707;490;1761;386;1498;93;360;149;598;242;958
172000;201707;598;1886;500;1692;73;283;259;849;332;1132
172010;201707;1173;4037;1058;3814;118;535;703;2459;821;2994
172015;201707;333;1288;273;1169;47;192;137;600;184;792
172020;201707;2377;7713;2205;7454;251;921;1565;5322;1816;6243
172025;201707;722;2085;529;1755;68;251;297;1011;365;1262
172030;201707;1198;3749;1055;3514;49;208;827;2741;876;2949
172049;201707;1366;3440;949;2756;371;1173;398;1120;769;2293
172065;201707;1394;3603;1133;3305;76;215;987;2916;1063;3131
172080;201707;2478;7576;2047;6803;171;655;1372;4540;1543;5195
172085;201707;481;1353;335;1048;60;168;106;328;166;496
172090;201707;4020;10715;3241;9601;139;423;2707;8117;2846;8540
172093;201707;550;1655;421;1425;82;312;198;648;280;960
172097;201707;671;1917;512;1655;101;340;200;671;301;1011
172100;201707;39192;108412;28710;90873;7450;26211;7595;24928;15045;51139
172110;201707;1686;6235;1473;5882;169;722;1058;4373;1227;5095
172120;201707;5164;15936;4176;14431;829;2875;2191;7900;3020;10775
172125;201707;280;862;223;756;37;149;106;359;143;508
172130;201707;559;1518;419;1286;33;123;255;763;288;886
172208;201707;2216;6274;1911;5825;260;823;1137;3493;1397;4316
172210;201707;2584;7540;2190;6973;438;1450;1205;3866;1643;5316
210005;201707;21588;65666;18042;60178;5469;19222;6843;23683;12312;42905
210010;201707;1717;5897;1558;5625;59;239;1318;4803;1377;5042
210015;201707;3498;10746;3094;10130;183;477;2578;8714;2761;9191
210020;201707;7273;17090;6784;16524;155;405;6293;15287;6448;15692
210030;201707;5311;17569;4993;17148;319;1495;4157;14135;4476;15630
210040;201707;2195;6490;2028;6302;51;136;1871;5915;1922;6051
210043;201707;6974;18913;5924;17650;765;2130;4149;13199;4914;15329
210047;201707;6652;23346;6056;22495;422;1917;4916;18248;5338;20165
210050;201707;2293;8318;1886;7521;413;1698;940;3985;1353;5683
210055;201707;1731;5951;1580;5710;96;400;1233;4467;1329;4867
210060;201707;7058;27433;6529;26436;952;4007;4378;18245;5330;22252
210070;201707;7449;21375;6918;20741;84;282;6429;19470;6513;19752
210080;201707;3785;13046;3695;12941;25;97;3566;12573;3591;12670
210083;201707;4761;15964;4249;15405;107;480;3966;14467;4073;14947
210087;201707;3036;8787;2751;8413;243;728;2199;6869;2442;7597
210090;201707;10467;32785;9903;31922;363;1331;8837;28491;9200;29822
210095;201707;6070;21209;5776;20828;364;1435;4923;17948;5287;19383
210100;201707;7270;21593;6655;20797;291;1141;5587;17355;5878;18496
210110;201707;2797;9551;2683;9399;80;345;2447;8594;2527;8939
210120;201707;26630;72676;23155;68563;2991;7404;16012;50844;19003;58248
210125;201707;3768;11419;3584;11221;454;1086;2901;9562;3355;10648
210130;201707;4218;12252;3849;11743;233;731;3176;9681;3409;10412
210135;201707;1616;4794;1406;4489;79;247;1133;3662;1212;3909
210140;201707;17238;53569;14574;49944;2985;10882;8140;28631;11125;39513
210150;201707;4640;11425;4112;10769;66;266;3715;9597;3781;9863
210160;201707;17569;54363;16375;52586;1362;4101;12781;42310;14143;46411
210170;201707;14266;48732;13790;48132;704;2537;12264;43189;12968;45726
210173;201707;2457;9410;2323;9206;48;262;2155;8619;2203;8881
210177;201707;3156;9418;2972;9198;86;237;2756;8656;2842;8893
210180;201707;1514;4460;1428;4339;38;148;1236;3734;1274;3882
210190;201707;4865;15108;4455;14369;157;770;3544;11153;3701;11923
210193;201707;1328;4124;1197;3916;62;209;968;3186;1030;3395
210197;201707;2071;6844;1898;6637;228;756;1419;5171;1647;5927
210200;201707;8242;27075;7605;26182;868;2918;5861;20766;6729;23684
210203;201707;6872;21266;6440;20706;322;948;5689;18645;6011;19593
210207;201707;3339;10795;3150;10465;229;677;2525;8656;2754;9333
210210;201707;8476;28166;8062;27621;113;466;7421;25808;7534;26274
210215;201707;1260;5039;1189;4932;85;425;964;4050;1049;4475
210220;201707;6021;22176;5721;21680;333;1551;4806;18175;5139;19726
210230;201707;5284;16697;4918;16161;247;787;4307;14269;4554;15056
210232;201707;12947;40805;10811;38071;1686;6045;6824;26106;8510;32151
210235;201707;3826;11508;3366;10937;156;620;2886;9446;3042;10066
210237;201707;2313;8736;2245;8646;27;126;2141;8309;2168;8435
210240;201707;2964;9200;2742;8866;133;481;2318;7487;2451;7968
210250;201707;5380;17084;5031;16635;136;693;4560;14943;4696;15636
210255;201707;2681;8453;2418;7982;336;1161;1673;5530;2009;6691
210260;201707;5210;16691;4786;16048;386;1354;3792;12852;4178;14206
210270;201707;5271;14892;4667;14057;133;620;4029;11991;4162;12611
210275;201707;3579;8775;3371;8547;85;144;3180;8188;3265;8332
210280;201707;5707;16986;4851;15773;269;1274;3566;11327;3835;12601
210290;201707;5859;18844;5396;18295;203;768;4703;16091;4906;16859
210300;201707;37834;102852;31194;94703;2278;7242;23081;73090;25359;80332
210310;201707;3008;8190;2737;7833;88;192;2389;6928;2477;7120
210312;201707;2376;7158;2222;6957;72;330;1970;6146;2042;6476
210315;201707;2855;8658;2489;8206;103;349;2141;7213;2244;7562
210317;201707;4071;12815;3880;12590;154;582;3525;11478;3679;12060
210320;201707;19730;62833;18204;60979;810;3155;15844;53805;16654;56960
210325;201707;3826;11431;3398;10798;158;571;2808;9033;2966;9604
210330;201707;33032;85528;27007;78731;5484;14868;15503;51587;20987;66455
210340;201707;11575;34343;10470;32873;1161;3250;7586;25363;8747;28613
210350;201707;9888;29577;8833;28134;432;1508;7286;23414;7718;24922
210355;201707;3999;14322;3603;13704;162;798;2996;11549;3158;12347
210360;201707;15524;45998;14056;44003;846;3139;11455;35761;12301;38900
210370;201707;9714;22969;8058;21205;334;668;7057;19298;7391;19966
210375;201707;3207;9493;2629;8739;746;2566;1218;4242;1964;6808
210380;201707;5928;16175;5322;15397;372;985;4425;13086;4797;14071
210390;201707;3002;10553;2738;10138;159;769;2240;8297;2399;9066
210400;201707;4937;15275;4604;14867;128;333;4267;13964;4395;14297
210405;201707;7857;21659;6308;19451;1497;4575;3038;10066;4535;14641
210407;201707;1990;7009;1694;6458;176;714;1238;4732;1414;5446
210408;201707;2471;9481;2314;9279;180;879;1837;7549;2017;8428
210409;201707;3788;13556;3570;13233;184;851;3006;11183;3190;12034
210410;201707;3782;11935;3549;11579;314;891;2774;9427;3088;10318
210420;201707;4162;13549;3782;12896;221;795;3092;10639;3313;11434
210430;201707;2200;6643;2112;6547;108;336;1836;5719;1944;6055
210440;201707;4190;12292;4010;12072;103;306;3736;11316;3839;11622
210450;201707;2729;8474;2403;7990;134;474;1910;6340;2044;6814
210455;201707;3927;11116;3480;10587;678;1997;2313;7410;2991;9407
210460;201707;3549;11349;3254;10922;158;665;2679;8957;2837;9622
210462;201707;1384;4930;1270;4725;73;345;1024;3800;1097;4145
210465;201707;2612;8379;2402;8086;126;372;2080;7173;2206;7545
210467;201707;6214;20521;5828;20085;370;1343;5048;17623;5418;18966
210470;201707;2126;5649;1522;4767;93;278;1137;3633;1230;3911
210480;201707;15033;47186;13132;44818;1883;6125;9131;33498;11014;39623
210490;201707;3803;10136;3220;9330;87;318;2772;8001;2859;8319
210500;201707;6167;25527;5940;25106;529;2489;4667;19837;5196;22326
210510;201707;6567;21915;6133;21397;324;1001;5282;18970;5606;19971
210515;201707;3682;11398;3501;11197;150;385;3192;10460;3342;10845
210520;201707;2685;7999;2415;7633;141;485;2056;6545;2197;7030
210530;201707;50650;136504;42911;124995;6929;26025;12915;45062;19844;71087
210535;201707;3300;11097;3111;10842;115;435;2752;9709;2867;10144
210540;201707;13281;43370;11858;41394;1814;6199;7882;29089;9696;35288
210542;201707;5925;16345;5326;15694;341;773;4621;14082;4962;14855
210545;201707;2346;7386;2227;7209;41;222;1985;6353;2026;6575
210547;201707;3807;13395;3493;12841;380;1376;2519;9544;2899;10920
210550;201707;6292;18107;5559;17320;319;987;4872;15495;5191;16482
210560;201707;3986;12277;3561;11571;139;553;3025;9764;3164;10317
210565;201707;1466;5220;1258;4891;60;293;999;3969;1059;4262
210570;201707;12234;33966;11228;32841;579;1383;9949;29744;10528;31127
210580;201707;3192;9079;2874;8690;301;620;2279;7289;2580;7909
210590;201707;4074;12876;3740;12434;211;908;3231;10621;3442;11529
210592;201707;2558;7904;2438;7712;51;258;2117;6640;2168;6898
210594;201707;2773;7706;2207;6839;115;327;1622;5188;1737;5515
210596;201707;2616;9615;2476;9338;236;987;1850;7056;2086;8043
210598;201707;1755;5424;1636;5279;76;306;1463;4707;1539;5013
210600;201707;3238;9058;2735;8391;123;397;2168;6667;2291;7064
210610;201707;2542;8128;2334;7858;135;624;2007;6621;2142;7245
210620;201707;2129;6724;1922;6469;48;105;1747;6051;1795;6156
210630;201707;3331;11749;3052;11304;245;1144;2304;8396;2549;9540
210632;201707;4573;15565;4193;15005;437;1730;3205;11514;3642;13244
210635;201707;1899;6625;1787;6441;96;326;1537;5656;1633;5982
210637;201707;2697;9157;2451;8796;151;628;1923;6982;2074;7610
210640;201707;4750;18903;4672;18821;45;184;4535;18404;4580;18588
210650;201707;7222;21207;6967;20878;122;368;6664;20043;6786;20411
210660;201707;8442;24598;7639;23428;297;1097;6643;20178;6940;21275
210663;201707;2769;8418;2640;8262;128;406;2275;7262;2403;7668
210667;201707;1934;6434;1809;6242;71;305;1566;5441;1637;5746
210670;201707;4599;16484;4352;16088;226;1034;3654;13549;3880;14583
210675;201707;5159;14131;4667;13513;416;1052;3771;11313;4187;12365
210680;201707;4072;10805;3513;10133;141;368;3072;8971;3213;9339
210690;201707;7624;25363;7268;24986;325;1109;6337;22568;6662;23677
210700;201707;2704;7734;2423;7414;259;611;1838;6228;2097;6839
210710;201707;4953;16061;4652;15616;194;863;3970;13280;4164;14143
210720;201707;2702;9416;2523;9177;92;451;2275;8226;2367;8677
210725;201707;1112;4203;1013;4000;36;133;779;3223;815;3356
210730;201707;1226;3513;1049;3271;81;252;820;2575;901;2827
210735;201707;4343;14105;3906;13404;418;1487;2984;10451;3402;11938
210740;201707;5167;14929;4821;14574;189;868;4263;12601;4452;13469
210745;201707;4325;12095;4065;11788;220;593;3500;10214;3720;10807
210750;201707;20106;54188;17662;51371;2206;6384;12717;38115;14923;44499
210760;201707;5906;16813;5405;16287;32;85;5239;15889;5271;15974
210770;201707;5996;16236;5156;15267;92;370;4656;13815;4748;14185
210780;201707;7884;26121;7209;24973;820;2770;5131;18353;5951;21123
210790;201707;4874;15068;4470;14583;205;537;3591;12380;3796;12917
210800;201707;4935;13552;4393;12904;105;377;3943;11582;4048;11959
210805;201707;3869;15299;3735;15094;182;929;3206;12994;3388;13923
210810;201707;5367;16008;4969;15506;293;597;4321;14059;4614;14656
210820;201707;7748;22239;6882;20903;816;2372;4690;14646;5506;17018
210825;201707;5982;20063;5702;19692;529;1731;4633;16493;5162;18224
210830;201707;8493;24257;7999;23661;648;1599;6688;20465;7336;22064
210840;201707;3619;9732;3242;9213;91;321;2774;7815;2865;8136
210845;201707;6160;17769;5949;17543;63;134;5789;17217;5852;17351
210850;201707;6227;21381;5558;20329;520;2251;4080;14892;4600;17143
210860;201707;17942;52207;15916;49359;1049;3321;12669;39914;13718;43235
210870;201707;5928;19326;5379;18631;487;1676;4334;15323;4821;16999
210880;201707;4404;14089;4159;13782;282;1067;3423;11351;3705;12418
210890;201707;4842;14471;4448;14018;324;828;3708;12294;4032;13122
210900;201707;4907;14541;3992;13036;1538;5291;966;3480;2504;8771
210905;201707;1883;5729;1645;5392;95;263;1339;4521;1434;4784
210910;201707;8254;26062;7267;24399;924;3313;4875;16446;5799;19759
210920;201707;2887;10456;2737;10200;130;648;2299;8570;2429;9218
210923;201707;1502;4985;1387;4809;128;507;954;3386;1082;3893
210927;201707;4847;15590;4565;15288;113;370;4256;14430;4369;14800
210930;201707;2526;8920;2338;8642;120;636;1925;6991;2045;7627
210940;201707;3233;11239;3103;11030;154;718;2686;9421;2840;10139
210945;201707;5836;17760;5599;17492;283;699;5034;15944;5317;16643
210950;201707;5326;16076;4431;14698;503;1613;3079;10559;3582;12172
210955;201707;1850;5843;1635;5517;154;521;1135;3940;1289;4461
210960;201707;9160;28762;8378;27706;1696;5312;5101;18122;6797;23434
210970;201707;1373;4656;1197;4355;130;557;849;3009;979;3566
210975;201707;1765;5868;1667;5689;153;546;1226;4192;1379;4738
210980;201707;10423;23696;9964;23229;377;706;9180;21782;9557;22488
210990;201707;16517;50238;13622;46101;2725;9499;7313;25966;10038;35465
211000;201707;15605;48254;13777;46180;772;3166;11420;38939;12192;42105
211003;201707;4851;17034;4374;16419;274;1245;3432;13187;3706;14432
211010;201707;6620;23932;6222;23444;81;405;5805;22087;5886;22492
211020;201707;7658;24425;7346;23968;490;1792;6129;20006;6619;21798
211023;201707;2210;7442;2121;7301;158;639;1713;5857;1871;6496
211027;201707;2927;10594;2864;10489;294;1168;2319;8493;2613;9661
211030;201707;3912;11648;3638;11356;437;955;2908;9728;3345;10683
211040;201707;4599;16796;4382;16480;167;939;3791;14248;3958;15187
211050;201707;10108;25690;9566;25104;225;599;9006;23648;9231;24247
211060;201707;6210;21373;5970;21027;424;1618;5063;17967;5487;19585
211065;201707;2067;6332;1830;6004;50;158;1635;5413;1685;5571
211070;201707;8022;27067;7281;25868;428;1608;5894;21232;6322;22840
211080;201707;1347;3946;1163;3668;75;364;888;2643;963;3007
211085;201707;2030;6579;1851;6285;185;631;1404;4856;1589;5487
211090;201707;3449;9810;3191;9457;92;420;2777;8092;2869;8512
211100;201707;6539;17237;6359;17025;35;143;6158;16439;6193;16582
211102;201707;2879;10889;2716;10663;200;815;2284;9139;2484;9954
211105;201707;2514;8243;2151;7634;249;933;1475;5218;1724;6151
211107;201707;4653;14594;4107;13843;270;919;3243;11293;3513;12212
211110;201707;6392;18437;5069;16467;750;2282;3330;11305;4080;13587
211120;201707;37134;105548;34075;101995;4752;13302;24893;77564;29645;90866
211125;201707;2108;6524;1842;6099;108;388;1512;5043;1620;5431
211130;201707;173009;454278;161358;439825;23912;68275;78667;234891;102579;303166
211140;201707;5222;16658;4821;16058;219;838;4070;13564;4289;14402
211150;201707;9744;27580;8646;26248;359;1338;7309;22198;7668;23536
211153;201707;2722;8444;2461;8103;497;1689;1589;5460;2086;7149
211157;201707;1160;3688;991;3419;73;352;667;2327;740;2679
211160;201707;4226;13399;3537;12256;259;1238;2411;8083;2670;9321
211163;201707;1811;6186;1707;6044;44;131;1559;5648;1603;5779
211167;201707;1543;5016;1466;4900;36;146;1367;4576;1403;4722
211170;201707;6248;16233;5983;15912;91;309;5609;14823;5700;15132
211172;201707;2521;7191;2257;6812;95;392;1916;5673;2011;6065
211174;201707;2759;8161;2537;7878;64;330;2310;7090;2374;7420
211176;201707;4274;13114;3616;12243;302;1214;2730;9290;3032;10504
211178;201707;4439;10696;4011;10215;41;134;3793;9572;3834;9706
211180;201707;4253;14525;3994;14139;295;1157;3340;11886;3635;13043
211190;201707;2963;9440;2698;9045;78;383;2288;7596;2366;7979
211195;201707;1496;4379;1263;4074;76;223;1032;3441;1108;3664
211200;201707;2194;7035;1911;6639;305;1062;1191;4354;1496;5416
211210;201707;6843;20676;6442;20151;374;1227;5536;17437;5910;18664
211220;201707;34501;96974;30194;91505;4502;13998;20199;63142;24701;77140
211223;201707;5157;15505;4661;14748;473;1432;3482;11241;3955;12673
211227;201707;1734;6069;1575;5835;63;279;1355;5084;1418;5363
211230;201707;7993;25396;7210;24122;704;2494;5397;18200;6101;20694
211240;201707;8135;27607;7713;27067;243;1228;6949;24094;7192;25322
211245;201707;5758;16733;5714;16689;61;109;5623;16522;5684;16631
211250;201707;13953;42584;13019;41476;874;2657;10998;35778;11872;38435
211260;201707;8516;26097;7999;25424;318;1183;7210;22959;7528;24142
211270;201707;10454;34938;9328;33503;529;2406;7425;27098;7954;29504
211280;201707;13451;39182;12238;37650;907;2244;9966;31894;10873;34138
211285;201707;1772;6423;1555;5982;257;1085;754;2973;1011;4058
211290;201707;7206;23178;6865;22724;369;1262;5903;19729;6272;20991
211300;201707;8272;24393;7695;23619;118;344;7199;22239;7317;22583
211400;201707;11917;36453;10154;33869;2260;7663;5410;19688;7670;27351
220005;201707;1879;5277;1694;5004;64;258;1341;3840;1405;4098
220010;201707;1436;4153;1261;3878;28;122;999;3017;1027;3139
220020;201707;3338;10389;3115;10018;523;1727;2011;6471;2534;8198
220025;201707;2314;5548;2053;5183;40;124;1686;4157;1726;4281
220027;201707;1375;3601;1213;3389;59;180;963;2674;1022;2854
220030;201707;3293;8698;3174;8509;140;452;2707;7095;2847;7547
220040;201707;7658;23454;7004;22289;1258;4034;4466;14288;5724;18322
220045;201707;1417;4601;1275;4326;58;281;963;3179;1021;3460
220050;201707;4544;13496;3902;12454;186;761;3136;9939;3322;10700
220060;201707;2163;5174;1908;4880;32;77;1730;4421;1762;4498
220070;201707;2433;6900;2180;6502;112;309;1733;5175;1845;5484
220080;201707;703;2106;649;2024;39;156;534;1589;573;1745
220090;201707;1853;4575;1516;4119;41;145;1311;3511;1352;3656
220095;201707;735;1933;689;1870;12;42;636;1712;648;1754
220100;201707;1339;3926;1090;3467;58;242;865;2698;923;2940
220105;201707;2224;6949;1965;6451;148;503;1418;4704;1566;5207
220110;201707;3424;9759;3280;9536;83;318;2866;8225;2949;8543
220115;201707;2657;8640;2538;8439;127;517;2198;7218;2325;7735
220117;201707;1289;3369;1049;3003;38;110;880;2507;918;2617
220120;201707;11934;34564;11086;33531;138;611;10367;31257;10505;31868
220130;201707;910;2940;803;2779;29;177;693;2350;722;2527
220140;201707;1720;4472;1493;4200;140;285;1213;3530;1353;3815
220150;201707;7092;21098;6681;20529;189;842;5766;17471;5955;18313
220155;201707;1109;3326;875;2884;34;134;593;1926;627;2060
220157;201707;1091;2735;929;2470;20;75;753;1941;773;2016
220160;201707;2647;7889;2329;7297;80;380;1866;5713;1946;6093
220170;201707;1392;4073;1184;3736;37;180;977;3027;1014;3207
220173;201707;2024;6023;1662;5329;58;295;1304;4045;1362;4340
220177;201707;1844;5438;1800;5381;28;108;1726;5149;1754;5257
220180;201707;1192;3114;926;2622;17;67;666;1782;683;1849
220190;201707;4932;15159;4496;14581;490;1663;3400;11061;3890;12724
220191;201707;1426;4637;1334;4473;113;470;980;3185;1093;3655
220192;201707;1837;5148;1470;4501;53;186;1115;3375;1168;3561
220194;201707;1821;5343;1609;5019;89;338;1260;3846;1349;4184
220196;201707;2074;5862;1899;5561;96;364;1551;4451;1647;4815
220198;201707;1370;3825;1040;3389;13;42;960;3179;973;3221
220200;201707;4588;14732;4231;14272;326;1176;3412;11545;3738;12721
220202;201707;2188;6345;1890;5822;25;136;1623;4910;1648;5046
220205;201707;2770;7280;2469;6875;48;190;2156;5901;2204;6091
220207;201707;865;2647;739;2427;62;251;497;1606;559;1857
220208;201707;1801;5705;1525;5216;299;1164;763;2582;1062;3746
220209;201707;1603;4717;1382;4334;33;144;1113;3472;1146;3616
220210;201707;1647;4369;1429;4010;40;171;1139;3082;1179;3253
220211;201707;1585;4368;1504;4261;34;134;1310;3672;1344;3806
220213;201707;1712;4785;1555;4477;35;134;1253;3515;1288;3649
220217;201707;2042;6327;1947;6215;41;154;1794;5786;1835;5940
220220;201707;10671;28921;9385;26985;670;1787;6881;20240;7551;22027
220225;201707;1130;3158;925;2877;24;98;762;2339;786;2437
220230;201707;5589;14592;5039;13842;230;613;4331;11965;4561;12578
220240;201707;2907;8811;2672;8371;100;386;2182;6786;2282;7172
220245;201707;1545;4023;1287;3678;20;65;1127;3283;1147;3348
220250;201707;3040;8874;2734;8419;68;291;2364;7276;2432;7567
220253;201707;1627;4678;1373;4228;157;482;1011;3093;1168;3575
220255;201707;1784;4812;1522;4374;37;177;1211;3311;1248;3488
220260;201707;4283;13752;3842;12947;250;892;2950;10016;3200;10908
220265;201707;1344;4534;1227;4342;102;413;849;3002;951;3415
220270;201707;6839;21818;6513;21227;444;1800;5201;16507;5645;18307
220271;201707;1514;4117;1327;3821;65;174;1084;3176;1149;3350
220272;201707;1806;5358;1627;5047;45;177;1237;3770;1282;3947
220273;201707;1226;3520;1051;3201;64;222;783;2368;847;2590
220275;201707;2185;5416;1743;4889;44;173;1486;4124;1530;4297
220277;201707;2243;6048;1947;5582;58;212;1556;4358;1614;4570
220280;201707;1527;4117;1325;3767;73;259;1040;2860;1113;3119
220285;201707;1675;4339;1370;3935;25;103;1242;3566;1267;3669
220290;201707;6146;19906;5210;18543;556;2190;3570;12730;4126;14920
220300;201707;1813;6008;1609;5693;81;443;1267;4344;1348;4787
220310;201707;2573;8196;2270;7842;78;382;1900;6559;1978;6941
220320;201707;3035;9183;2545;8302;243;926;1814;5839;2057;6765
220323;201707;1527;5232;1323;4921;126;501;1027;3830;1153;4331
220325;201707;1207;3744;1024;3383;54;225;778;2549;832;2774
220327;201707;1359;4265;1225;4028;59;269;981;3140;1040;3409
220330;201707;3757;10129;3316;9530;158;477;2785;8006;2943;8483
220335;201707;1792;5419;1612;5211;32;109;1503;4887;1535;4996
220340;201707;1899;5122;1552;4563;72;262;1120;3167;1192;3429
220342;201707;1162;3661;1087;3543;64;246;859;2816;923;3062
220345;201707;2936;7191;2571;6684;31;60;2385;6216;2416;6276
220350;201707;3796;10010;3150;8977;182;622;2347;6563;2529;7185
220360;201707;1279;3397;1084;3108;61;191;844;2356;905;2547
220370;201707;9473;26550;8554;25373;259;1021;7566;22305;7825;23326
220375;201707;1512;4590;1399;4447;13;36;1347;4319;1360;4355
220380;201707;1409;3687;1188;3372;33;118;995;2775;1028;2893
220385;201707;867;2176;689;1882;12;49;557;1481;569;1530
220390;201707;8959;27060;7894;25219;2004;6599;3234;10673;5238;17272
220400;201707;1516;3790;1177;3244;29;113;922;2439;951;2552
220410;201707;1206;3435;1016;3131;69;226;788;2387;857;2613
220415;201707;844;2301;732;2129;28;97;530;1504;558;1601
220420;201707;2177;6215;1802;5495;100;318;1317;3961;1417;4279
220430;201707;2510;6880;2442;6795;107;332;2170;5989;2277;6321
220435;201707;1750;4969;1579;4691;63;217;1207;3548;1270;3765
220440;201707;2450;7969;2273;7712;154;571;1822;6087;1976;6658
220450;201707;2103;6314;1775;5850;320;1182;1146;3734;1466;4916
220455;201707;1335;4135;1263;4033;38;139;1135;3626;1173;3765
220460;201707;918;2494;832;2387;50;158;700;1964;750;2122
220465;201707;2384;7744;2175;7423;209;751;1626;5593;1835;6344
220470;201707;3687;10748;3348;10204;142;464;2661;7984;2803;8448
220480;201707;2459;6880;2124;6339;150;383;1523;4525;1673;4908
220490;201707;2337;6411;2126;6150;54;186;1851;5316;1905;5502
220500;201707;3142;8400;2709;7685;84;353;2082;5699;2166;6052
220510;201707;2873;8331;2310;7340;114;388;1707;5456;1821;5844
220515;201707;1845;4433;1630;4150;88;223;1395;3535;1483;3758
220520;201707;5182;13803;4747;13229;108;317;4249;11857;4357;12174
220525;201707;1278;3530;1196;3413;40;147;1010;2845;1050;2992
220527;201707;1392;4117;1227;3810;79;251;913;2883;992;3134
220530;201707;1280;3568;1123;3343;54;216;973;2825;1027;3041
220535;201707;855;2535;810;2473;67;226;617;1862;684;2088
220540;201707;3553;11203;3385;10946;113;496;2932;9422;3045;9918
220545;201707;1419;4606;1339;4460;106;416;1045;3432;1151;3848
220550;201707;9389;29330;8584;27985;683;2506;6372;20507;7055;23013
220551;201707;1498;4566;1320;4274;73;315;1026;3215;1099;3530
220552;201707;1616;4929;1398;4523;73;377;1070;3297;1143;3674
220553;201707;1664;4661;1392;4247;63;228;1055;3284;1118;3512
220554;201707;809;2314;697;2139;46;124;534;1637;580;1761
220555;201707;2128;6801;1975;6578;51;276;1670;5464;1721;5740
220556;201707;1381;4201;1228;3900;51;227;909;2760;960;2987
220557;201707;1589;4962;1402;4597;111;395;997;3237;1108;3632
220558;201707;1140;3387;991;3158;42;194;792;2453;834;2647
220559;201707;1605;4347;1408;4021;21;69;1171;3337;1192;3406
220560;201707;1642;4021;1325;3592;40;123;1134;3021;1174;3144
220570;201707;7274;23218;6843;22460;747;2583;4977;16525;5724;19108
220580;201707;6743;20161;6527;19822;226;749;5845;17617;6071;18366
220585;201707;2067;6837;1883;6502;110;477;1480;5026;1590;5503
220590;201707;1307;3813;1137;3557;118;392;768;2415;886;2807
220595;201707;2467;6986;2298;6765;32;159;2118;6152;2150;6311
220600;201707;1338;3184;1084;2851;77;121;875;2382;952;2503
220605;201707;1846;5416;1588;4978;47;195;1226;3745;1273;3940
220610;201707;2843;8336;2682;8108;52;218;2419;7265;2471;7483
220620;201707;7671;25081;7350;24644;261;1195;6532;21685;6793;22880
220630;201707;393;1197;321;1063;44;167;174;588;218;755
220635;201707;1691;5575;1499;5167;72;307;1134;3846;1206;4153
220640;201707;2772;7770;2432;7286;98;339;2002;5952;2100;6291
220650;201707;2158;6269;1906;5819;93;324;1407;4265;1500;4589
220660;201707;2872;8434;2576;8073;113;531;2232;6815;2345;7346
220665;201707;1260;4059;1144;3864;26;136;958;3202;984;3338
220667;201707;1685;5477;1519;5182;82;303;1230;4194;1312;4497
220669;201707;1818;5785;1731;5632;136;579;1333;4254;1469;4833
220670;201707;2007;5809;1749;5486;89;275;1498;4735;1587;5010
220672;201707;2526;7179;2299;6896;147;451;1967;5953;2114;6404
220675;201707;1297;3625;1192;3444;69;181;922;2668;991;2849
220680;201707;2525;7515;2397;7356;129;407;2070;6364;2199;6771
220690;201707;1721;4677;1483;4294;125;318;1094;3249;1219;3567
220695;201707;988;2777;890;2592;32;103;715;2068;747;2171
220700;201707;8433;23482;7256;21693;457;1580;5492;16210;5949;17790
220710;201707;841;2443;662;2085;49;142;468;1460;517;1602
220720;201707;2097;5263;1938;5029;59;186;1657;4253;1716;4439
220730;201707;1402;3982;1180;3636;31;134;965;2911;996;3045
220735;201707;1046;2567;816;2186;29;75;656;1731;685;1806
220740;201707;1423;4267;1205;3978;52;188;1002;3353;1054;3541
220750;201707;3998;11046;3632;10496;230;678;2997;8666;3227;9344
220755;201707;1205;3325;1070;3109;49;174;826;2348;875;2522
220760;201707;2972;9310;2667;8898;121;508;2263;7493;2384;8001
220770;201707;21674;71030;19436;66780;6654;23928;6134;22094;12788;46022
220775;201707;1233;3227;1179;3169;14;59;1148;3074;1162;3133
220777;201707;1573;4212;1301;3792;57;161;976;2834;1033;2995
220779;201707;1395;3501;1289;3358;39;144;1133;2898;1172;3042
220780;201707;5738;15442;5077;14406;352;1137;4006;11211;4358;12348
220785;201707;1446;3417;1339;3260;35;54;1244;3029;1279;3083
220790;201707;10516;30788;9559;29344;466;1813;7836;23751;8302;25564
220793;201707;825;2307;738;2175;37;124;598;1762;635;1886
220795;201707;1502;4059;1384;3902;58;197;1211;3407;1269;3604
220800;201707;16460;43560;14421;40457;1027;3247;10134;27581;11161;30828
220810;201707;3221;9187;2789;8451;90;353;2227;6605;2317;6958
220820;201707;5492;14630;4866;13739;409;1124;3815;10741;4224;11865
220830;201707;7420;20677;6860;19808;457;1393;5490;15808;5947;17201
220840;201707;13638;42326;12037;39156;2315;7612;6410;21171;8725;28783
220850;201707;3025;9782;2825;9538;96;458;2529;8484;2625;8942
220855;201707;610;1819;529;1681;27;122;410;1268;437;1390
220860;201707;991;2580;864;2389;28;98;732;1993;760;2091
220865;201707;2645;7111;2088;6171;58;259;1651;4723;1709;4982
220870;201707;2250;7335;1989;6987;48;235;1779;6227;1827;6462
220880;201707;4821;12643;4445;12206;54;183;4163;11432;4217;11615
220885;201707;1282;4498;1121;4200;72;352;848;3160;920;3512
220887;201707;1419;3394;1239;3144;14;58;1141;2862;1155;2920
220890;201707;1652;5530;1420;5074;115;417;1015;3690;1130;4107
220900;201707;1959;5163;1710;4809;40;122;1475;4099;1515;4221
220910;201707;1522;4497;1320;4188;49;163;1140;3641;1189;3804
220915;201707;998;2799;855;2524;30;131;658;1878;688;2009
220920;201707;1368;4835;1211;4608;98;483;903;3361;1001;3844
220930;201707;1517;4673;1376;4463;45;213;1173;3756;1218;3969
220935;201707;1051;3091;861;2678;34;133;595;1747;629;1880
220937;201707;1510;4058;1272;3681;40;151;996;2819;1036;2970
220940;201707;1348;4133;1202;3849;55;241;873;2708;928;2949
220945;201707;423;1539;377;1443;32;160;266;990;298;1150
220950;201707;1337;3223;908;2518;19;80;706;1889;725;1969
220955;201707;1493;4189;1309;3870;63;175;1031;3053;1094;3228
220960;201707;921;2330;729;2014;21;76;570;1549;591;1625
220965;201707;1692;4864;1555;4654;31;182;1350;3908;1381;4090
220970;201707;1922;5104;1503;4420;76;238;1146;3367;1222;3605
220975;201707;735;2311;662;2219;32;190;575;1839;607;2029
220980;201707;1261;3668;1118;3434;45;163;882;2681;927;2844
220985;201707;1221;3526;1129;3384;63;244;848;2432;911;2676
220987;201707;1494;4650;1328;4373;80;342;1043;3380;1123;3722
220990;201707;1818;5192;1548;4747;44;208;1186;3529;1230;3737
220995;201707;1255;3669;964;3204;78;281;666;2264;744;2545
220997;201707;2423;7142;2297;6964;51;219;2111;6338;2162;6557
221000;201707;4209;12468;3931;12008;251;972;3113;9354;3364;10326
221005;201707;1456;4345;1329;4109;157;440;914;2827;1071;3267
221010;201707;1235;3080;1048;2849;26;88;917;2450;943;2538
221020;201707;1697;5272;1568;5023;51;230;1131;3554;1182;3784
221030;201707;1490;4308;1321;4035;58;238;1050;3132;1108;3370
221035;201707;1536;4121;1424;3975;55;131;1289;3679;1344;3810
221037;201707;609;1783;534;1655;12;57;363;1072;375;1129
221038;201707;597;1659;465;1435;31;109;295;910;326;1019
221039;201707;968;2611;849;2433;22;77;698;1948;720;2025
221040;201707;4555;13907;4195;13309;203;690;3283;10481;3486;11171
221050;201707;3651;10461;3346;10073;89;329;2976;8902;3065;9231
221060;201707;8219;23768;7044;21830;408;1437;5386;16626;5794;18063
221062;201707;1303;4447;1162;4157;58;298;889;3132;947;3430
221063;201707;1112;3448;984;3235;92;320;690;2269;782;2589
221065;201707;2824;7407;2478;6857;79;236;2089;5698;2168;5934
221070;201707;3685;11614;3170;10636;186;732;2331;7764;2517;8496
221080;201707;3581;8870;2888;7880;89;338;2323;6259;2412;6597
221090;201707;1400;3811;1203;3479;35;136;997;2822;1032;2958
221093;201707;1577;4635;1482;4445;189;611;915;2632;1104;3243
221095;201707;977;2590;844;2379;11;33;695;1923;706;1956
221097;201707;827;2242;656;1931;25;87;473;1343;498;1430
221100;201707;102087;297282;92871;281458;17654;55930;53114;158834;70768;214764
221110;201707;10600;32330;9802;31354;387;1766;8325;26234;8712;28000
221120;201707;4207;13114;4010;12778;498;1686;2957;9416;3455;11102
221130;201707;4615;12930;3750;11183;1051;3026;1577;4807;2628;7833
221135;201707;1575;4591;1449;4413;66;244;1242;3747;1308;3991
221140;201707;1352;3280;1204;3068;23;59;1058;2662;1081;2721
221150;201707;1212;3030;958;2594;28;107;715;1853;743;1960
221160;201707;784;2025;721;1940;29;77;581;1556;610;1633
221170;201707;1160;3419;1055;3249;35;127;833;2534;868;2661
230010;201707;3396;9070;2731;7923;216;716;2040;5790;2256;6506
230015;201707;2929;9944;2745;9561;294;1185;1800;6170;2094;7355
230020;201707;13866;44429;13427;43714;602;2462;11372;36607;11974;39069
230030;201707;12294;33904;10874;31795;429;1571;9126;26447;9555;28018
230040;201707;4379;11951;3751;10869;210;746;2856;8140;3066;8886
230050;201707;2702;8907;1997;7054;465;1591;591;2150;1056;3741
230060;201707;2362;6580;1980;5919;85;326;1551;4534;1636;4860
230070;201707;4206;12003;3635;10921;230;814;2504;7595;2734;8409
230075;201707;9213;31200;8562;29986;553;2734;6638;22635;7191;25369
230080;201707;2451;6100;1982;5403;64;261;1633;4356;1697;4617
230090;201707;4086;11160;3603;10371;278;925;2592;7324;2870;8249
230100;201707;17014;49536;15846;47510;2465;7847;9351;28127;11816;35974
230110;201707;12406;38983;11315;36693;2127;7279;6036;19426;8163;26705
230120;201707;7972;21878;6922;20272;712;2041;4846;14658;5558;16699
230125;201707;3081;8651;2567;7750;130;466;1900;5691;2030;6157
230130;201707;5774;18548;4891;16661;581;2116;3087;10355;3668;12471
230140;201707;3601;11160;3056;10180;188;749;2123;7025;2311;7774
230150;201707;1675;5121;1456;4652;298;969;750;2425;1048;3394
230160;201707;6485;18116;5736;17020;294;1117;4574;13391;4868;14508
230170;201707;6238;19060;5431;17520;308;1206;3868;12258;4176;13464
230180;201707;1718;4936;1487;4478;58;250;1089;3122;1147;3372
230185;201707;3902;12434;3464;11624;461;1606;2288;7801;2749;9407
230190;201707;12583;39354;11073;36308;1772;6150;5644;18421;7416;24571
230195;201707;5311;16012;4696;14938;279;1061;3622;11312;3901;12373
230200;201707;5133;14487;4617;13514;283;941;3503;10014;3786;10955
230205;201707;4152;13289;3782;12614;262;1103;2646;8700;2908;9803
230210;201707;9077;25155;7929;23320;807;2562;5413;15968;6220;18530
230220;201707;13349;36955;12057;34801;765;2592;9182;26105;9947;28697
230230;201707;7354;22962;6690;21700;610;2095;4691;15205;5301;17300
230240;201707;13656;36952;11895;34099;606;1775;9156;26124;9762;27899
230250;201707;9780;29477;9722;29369;578;2121;7403;21791;7981;23912
230260;201707;14651;47208;13373;44605;1848;6533;7715;26009;9563;32542
230270;201707;7639;21721;6314;19294;744;2418;3954;12142;4698;14560
230280;201707;20320;58251;17641;53576;1070;3997;13278;39347;14348;43344
230290;201707;4892;14413;4192;12977;500;1443;2824;8861;3324;10304
230300;201707;4455;12900;4228;12581;212;833;3508;10246;3720;11079
230310;201707;4957;14444;4276;13268;160;657;3019;9175;3179;9832
230320;201707;7533;22363;6744;20968;441;1715;5014;15301;5455;17016
230330;201707;4983;14095;4166;12524;290;954;2945;8729;3235;9683
230340;201707;3529;11521;3164;10742;287;1085;2154;7211;2441;8296
230350;201707;18634;54665;16926;51693;1420;5190;10444;32187;11864;37377
230360;201707;3261;9048;2520;7699;179;628;1660;5001;1839;5629
230365;201707;3139;8044;2693;7314;85;334;2234;5963;2319;6297
230370;201707;55146;171355;49554;161850;12404;42284;21818;74277;34222;116561
230380;201707;6690;19054;5478;16777;239;874;3835;11549;4074;12423
230390;201707;3373;10502;3028;9899;186;792;2224;7122;2410;7914
230393;201707;3120;9983;2667;9098;156;774;1915;6267;2071;7041
230395;201707;5807;16389;5182;15314;678;2040;3231;9705;3909;11745
230400;201707;5636;16530;5038;15530;237;1005;3909;11752;4146;12757
230410;201707;14772;45862;12489;41113;1666;5678;7294;24111;8960;29789
230420;201707;24516;75935;22000;70987;3889;13367;10874;34869;14763;48236
230423;201707;4405;13809;3985;12951;184;747;3131;10057;3315;10804
230425;201707;5616;18190;5133;17166;643;2182;3328;11193;3971;13375
230426;201707;2586;7146;2045;6101;63;274;1502;4371;1565;4645
230427;201707;1875;5448;1352;4268;98;306;848;2582;946;2888
230428;201707;9045;27165;8475;26103;1493;4973;4460;13461;5953;18434
230430;201707;4573;13997;4044;13000;276;1064;2930;9156;3206;10220
230435;201707;5371;16045;4733;14878;616;2121;2777;8693;3393;10814
230440;201707;376138;1059447;336227;992563;67428;209244;165090;489252;232518;698496
230445;201707;4543;12287;3872;11162;222;635;2731;7822;2953;8457
230450;201707;3757;11366;3279;10523;277;1138;2287;7197;2564;8335
230460;201707;1966;6193;1706;5713;138;528;1234;4120;1372;4648
230465;201707;4067;11822;3398;10590;156;631;2385;7215;2541;7846
230470;201707;11049;38998;10170;37237;1106;4775;7048;25475;8154;30250
230480;201707;1484;4517;1255;4068;128;495;862;2729;990;3224
230490;201707;2368;7017;2065;6449;262;830;1105;3360;1367;4190
230495;201707;5723;18274;5191;17228;540;2206;3199;10448;3739;12654
230500;201707;8875;30851;8426;29948;528;2357;6337;22369;6865;24726
230510;201707;1564;5327;1181;4350;255;1010;418;1543;673;2553
230520;201707;4416;13328;4060;12647;386;1349;2757;8431;3143;9780
230523;201707;15401;48192;13219;43293;3114;10689;3272;11100;6386;21789
230526;201707;4096;11934;3509;10899;194;838;2702;8185;2896;9023
230530;201707;5541;17380;4942;16493;674;2387;3285;11211;3959;13598
230533;201707;4166;11221;3614;10213;309;843;2636;7518;2945;8361
230535;201707;5620;16146;4833;14710;426;1338;3181;9891;3607;11229
230540;201707;17462;49961;15685;47187;511;2133;13073;38733;13584;40866
230550;201707;19770;56947;17214;52186;2652;8771;9352;27919;12004;36690
230560;201707;7074;19607;6022;17702;181;736;4667;13471;4848;14207
230565;201707;3521;9527;2850;8324;108;408;2076;5987;2184;6395
230570;201707;3670;9707;3201;9089;109;358;2598;7313;2707;7671
230580;201707;10259;29654;9335;28314;516;1921;7733;23186;8249;25107
230590;201707;9268;27657;7825;24921;561;2102;5390;16682;5951;18784
230600;201707;3769;10234;2877;8464;102;329;1867;5561;1969;5890
230610;201707;6377;19291;5787;18329;530;1741;4241;13455;4771;15196
230620;201707;2207;6194;1722;5161;194;615;957;2771;1151;3386
230625;201707;8021;25192;7184;23352;2136;7370;1952;6457;4088;13827
230630;201707;10727;33278;9745;31416;2593;7901;4302;14944;6895;22845
230640;201707;27501;85498;24970;81676;2278;8402;18891;61496;21169;69898
230650;201707;4832;14497;4347;13548;289;1059;3210;9788;3499;10847
230655;201707;9594;34446;9214;33728;704;3027;7140;26215;7844;29242
230660;201707;6300;19175;5336;17289;262;1293;4159;13106;4421;14399
230670;201707;6070;15686;4794;13470;175;583;3670;10023;3845;10606
230680;201707;2648;7695;2293;6998;278;854;1425;4361;1703;5215
230690;201707;6522;20543;6151;19718;645;2285;3718;11706;4363;13991
230700;201707;9767;26598;8578;24440;501;1741;6148;16890;6649;18631
230710;201707;7521;23699;6485;21777;732;2537;4451;14995;5183;17532
230720;201707;1875;5826;1604;5233;203;697;970;3158;1173;3855
230725;201707;3803;12492;3220;11030;780;2742;992;3407;1772;6149
230730;201707;55565;165549;47611;152069;12992;45704;12509;42177;25501;87881
230740;201707;6332;18305;5657;17177;234;896;4375;13122;4609;14018
230750;201707;8343;23616;7217;21738;344;1276;5418;15933;5762;17209
230760;201707;11413;32897;10433;31036;914;3199;7274;20939;8188;24138
230763;201707;4369;12952;3821;11895;236;975;2833;8461;3069;9436
230765;201707;40590;123252;35905;114366;8902;30024;11447;37340;20349;67364
230770;201707;25552;69134;22681;64935;2995;9019;14116;40424;17111;49443
230780;201707;5960;21974;5694;21390;1124;4200;3108;12145;4232;16345
230790;201707;2941;8977;2741;8648;196;688;2109;6658;2305;7346
230800;201707;7666;26139;7022;24743;1117;4360;3760;12992;4877;17352
230810;201707;12130;38232;11321;36842;713;2788;8564;27393;9277;30181
230820;201707;3329;11193;2902;10266;340;1396;1674;5753;2014;7149
230830;201707;7545;22325;6633;20650;328;1279;5053;15451;5381;16730
230835;201707;3988;10254;3237;9056;150;503;2520;6921;2670;7424
230837;201707;3178;10495;2766;9659;191;851;1995;6771;2186;7622
230840;201707;9119;28891;8376;27651;702;2635;6345;20962;7047;23597
230850;201707;9562;29063;8755;27619;780;2697;6059;19065;6839;21762
230860;201707;5236;14371;4568;13348;237;823;3675;10597;3912;11420
230870;201707;18252;46955;15887;43391;668;2085;12216;33069;12884;35154
230880;201707;2019;6607;1875;6328;110;527;1364;4461;1474;4988
230890;201707;4272;14756;3957;14106;422;1666;2662;9395;3084;11061
230900;201707;2899;9342;2455;8359;415;1365;1314;4529;1729;5894
230910;201707;3172;9052;2581;8014;140;618;1919;5812;2059;6430
230920;201707;4777;13392;4406;12911;184;702;3726;10896;3910;11598
230930;201707;6915;20475;6059;18818;527;1749;3950;12183;4477;13932
230940;201707;7721;21672;6930;20357;242;892;5610;16373;5852;17265
230945;201707;6392;18765;5546;17299;472;1581;3749;11836;4221;13417
230950;201707;6601;17160;6019;16430;183;457;5226;14596;5409;15053
230960;201707;14106;43223;12898;40872;2078;6945;6309;20198;8387;27143
230970;201707;13755;40424;12001;37349;2294;7685;5587;17367;7881;25052
230980;201707;2954;8927;2559;8227;577;1817;1344;4511;1921;6328
230990;201707;1822;5202;1498;4597;106;434;976;2862;1082;3296
231000;201707;2608;7102;2165;6219;106;334;1466;4122;1572;4456
231010;201707;3111;8389;2546;7424;223;703;1761;5062;1984;5765
231020;201707;8066;26496;7532;25297;1272;4190;4467;15423;5739;19613
231025;201707;7727;23297;7080;22124;1095;3558;4367;13834;5462;17392
231030;201707;7390;23369;6174;20840;1123;3896;3193;10858;4316;14754
231040;201707;3201;9739;2833;9015;130;559;2096;6495;2226;7054
231050;201707;12019;33052;10088;29628;665;2079;7398;21585;8063;23664
231060;201707;2530;7935;2299;7547;113;549;1725;5557;1838;6106
231070;201707;8527;26276;7610;24465;1312;4324;4090;13384;5402;17708
231080;201707;4113;12358;3700;11636;157;800;2793;8411;2950;9211
231085;201707;5138;15250;4875;14870;491;1441;3527;11142;4018;12583
231090;201707;4194;11505;3307;9737;133;464;2325;6693;2458;7157
231095;201707;2116;6668;1830;6049;169;615;1239;4058;1408;4673
231100;201707;3212;9668;2681;8686;259;836;1787;5815;2046;6651
231110;201707;3518;11290;3470;11206;316;1203;2405;7591;2721;8794
231120;201707;1997;6540;1856;6260;219;771;1186;3997;1405;4768
231123;201707;2036;5486;1773;5027;117;365;1280;3556;1397;3921
231126;201707;6216;17542;5077;15380;238;846;3527;10451;3765;11297
231130;201707;19433;57214;17437;54016;2400;8031;10852;34376;13252;42407
231135;201707;4158;12091;3534;10948;204;731;2505;7669;2709;8400
231140;201707;17656;52981;15021;48039;1087;4520;9957;30856;11044;35376
231150;201707;5677;16208;4920;14772;735;2285;2449;7480;3184;9765
231160;201707;5854;19041;5439;18221;892;3077;3118;10543;4010;13620
231170;201707;4308;13403;3740;12239;267;1039;2577;8196;2844;9235
231180;201707;14533;42457;12634;38527;2470;7704;6047;18272;8517;25976
231190;201707;4657;12891;3865;11661;224;910;2834;8239;3058;9149
231195;201707;4598;15128;3989;13838;317;1384;2738;9273;3055;10657
231200;201707;7950;26166;6953;24089;338;1739;5024;16846;5362;18585
231210;201707;4960;15388;4360;14411;241;1071;3225;10414;3466;11485
231220;201707;12044;33257;10308;30029;555;1932;7464;21135;8019;23067
231230;201707;8824;28767;8029;27551;658;2631;6002;20640;6660;23271
231240;201707;11900;36692;10850;34536;1974;6512;5933;19024;7907;25536
231250;201707;1939;5350;1358;3984;139;401;683;1970;822;2371
231260;201707;3370;9991;3031;9416;417;1274;1917;6096;2334;7370
231270;201707;7172;19194;6275;17793;260;1049;4750;13179;5010;14228
231280;201707;1786;5690;1668;5468;163;544;1123;3694;1286;4238
231290;201707;35474;114081;31741;106018;5839;20763;13799;45376;19638;66139
231300;201707;4317;12384;3542;10819;262;906;2325;6952;2587;7858
231310;201707;7521;20960;6171;18171;792;2372;3617;10497;4409;12869
231320;201707;7150;21120;5864;18545;204;855;4348;13574;4552;14429
231325;201707;2751;7810;2313;7101;467;1410;1172;3709;1639;5119
231330;201707;11144;35004;9606;31868;1813;6023;5000;16857;6813;22880
231335;201707;5642;15515;4809;14058;152;651;3931;11231;4083;11882
231340;201707;18209;58251;16663;55746;1323;4664;12545;42542;13868;47206
231350;201707;15008;42571;14026;41242;487;1418;12435;36906;12922;38324
231355;201707;4657;14398;4172;13546;267;1023;3064;9879;3331;10902
231360;201707;7841;24444;6906;22799;896;3077;4547;15219;5443;18296
231370;201707;2455;6699;1921;5797;58;205;1434;4286;1492;4491
231375;201707;4238;13994;3917;13385;197;917;3091;10393;3288;11310
231380;201707;5577;16238;5282;15872;231;648;4424;13643;4655;14291
231390;201707;3490;10629;3183;10072;291;1083;2216;6854;2507;7937
231395;201707;3945;12595;3533;11818;632;2155;1944;6580;2576;8735
231400;201707;9206;27703;8378;26067;478;1832;6252;19116;6730;20948
231410;201707;15051;48544;13679;46432;1307;4494;9960;34047;11267;38541
240010;201707;2462;7125;2004;6199;247;867;1155;3479;1402;4346
240020;201707;10566;32231;9455;30151;1415;4801;5364;17111;6779;21912
240030;201707;2595;7125;2495;6974;133;449;2167;5973;2300;6422
240040;201707;874;2512;729;2223;26;121;518;1511;544;1632
240050;201707;3477;9255;2894;8230;88;286;2251;6265;2339;6551
240060;201707;1438;4009;1246;3650;58;210;960;2717;1018;2927
240070;201707;2463;7377;2286;7016;284;921;1573;4753;1857;5674
240080;201707;3070;8132;2612;7458;133;449;1940;5483;2073;5932
240090;201707;2301;6027;1895;5313;39;146;1500;4119;1539;4265
240100;201707;8165;22722;7194;20779;582;1798;5141;14485;5723;16283
240110;201707;4745;14555;4160;13382;497;1804;2408;7618;2905;9422
240120;201707;2706;9290;2568;8997;324;1290;1613;5587;1937;6877
240130;201707;2868;7284;2495;6713;92;307;2108;5576;2200;5883
240140;201707;2273;6696;1906;6005;216;766;1179;3676;1395;4442
240145;201707;5950;18119;5243;16894;977;3301;2972;9755;3949;13056
240150;201707;974;2946;824;2637;59;246;589;1817;648;2063
240160;201707;1488;4512;1265;4128;111;419;833;2739;944;3158
240165;201707;893;2715;766;2434;142;429;438;1421;580;1850
240170;201707;2346;6917;2021;6313;311;1048;1151;3528;1462;4576
240180;201707;2787;8573;2431;7844;437;1459;1390;4555;1827;6014
240185;201707;1381;4567;1269;4372;85;364;1007;3436;1092;3800
240190;201707;1006;3114;886;2906;42;183;677;2213;719;2396
240200;201707;12382;33062;10529;30143;1977;5802;4592;13509;6569;19311
240210;201707;2860;7843;2576;7385;93;362;2091;5817;2184;6179
240220;201707;7486;24474;6875;23589;697;2947;4802;16408;5499;19355
240230;201707;5839;15214;4940;13781;271;778;3902;10876;4173;11654
240240;201707;1769;5387;1098;3687;178;611;213;668;391;1279
240250;201707;2694;7755;2505;7500;176;512;2008;6041;2184;6553
240260;201707;12391;40484;11659;39303;1606;5889;7639;25898;9245;31787
240270;201707;2338;7206;2144;6883;129;437;1728;5596;1857;6033
240280;201707;1606;4374;1416;4114;60;198;1138;3264;1198;3462
240290;201707;1198;3712;1039;3391;49;238;691;2096;740;2334
240300;201707;2326;6242;1727;5031;131;413;925;2646;1056;3059
240310;201707;9473;26368;8404;24600;1118;3566;4532;13270;5650;16836
240320;201707;2016;5752;1542;4765;41;184;1151;3399;1192;3583
240325;201707;32484;90563;26192;80081;7455;24235;6506;21077;13961;45312
240330;201707;1509;4485;1267;3976;72;296;813;2442;885;2738
240340;201707;2092;5248;1706;4640;123;331;1260;3375;1383;3706
240350;201707;2086;5636;1923;5441;66;224;1698;4787;1764;5011
240360;201707;7000;21221;6278;20108;1616;5103;3005;10215;4621;15318
240370;201707;2073;5657;1636;4806;158;462;1023;2982;1181;3444
240375;201707;860;2269;764;2097;42;160;559;1454;601;1614
240380;201707;2431;7125;1810;5719;191;629;966;3012;1157;3641
240390;201707;936;2534;742;2152;21;62;490;1343;511;1405
240400;201707;1368;3598;1050;2999;52;167;721;1988;773;2155
240410;201707;464;1500;419;1408;56;226;253;828;309;1054
240420;201707;4739;17791;4373;16942;751;3436;2281;8640;3032;12076
240430;201707;3454;9497;3087;8827;172;654;2328;6376;2500;7030
240440;201707;2580;6440;2281;6013;331;907;1429;3719;1760;4626
240450;201707;4103;11916;3406;10576;403;1371;1915;5790;2318;7161
240460;201707;3023;8971;2815;8689;232;887;2213;6707;2445;7594
240470;201707;3547;11060;2771;9387;357;1241;1593;5388;1950;6629
240480;201707;546;1477;413;1223;40;120;195;579;235;699
240485;201707;2060;6277;1769;5699;178;591;1187;3875;1365;4466
240490;201707;1781;4381;1441;3846;26;79;1224;3246;1250;3325
240500;201707;2244;6207;1999;5858;92;327;1633;4746;1725;5073
240510;201707;1687;4873;1604;4744;142;419;1276;3751;1418;4170
240520;201707;1287;3510;1102;3233;54;216;887;2512;941;2728
240530;201707;1972;6326;1833;6105;219;779;1321;4389;1540;5168
240540;201707;1909;5398;1770;5185;91;321;1496;4304;1587;4625
240550;201707;788;2195;671;1992;44;129;484;1431;528;1560
240560;201707;3352;9297;3023;8828;311;814;2311;6887;2622;7701
240570;201707;3076;8371;2225;6445;298;927;1000;2624;1298;3551
240580;201707;7958;23887;7341;22852;576;2055;5789;17834;6365;19889
240590;201707;748;2068;646;1883;20;73;501;1430;521;1503
240600;201707;1674;4768;1271;3907;116;414;747;2209;863;2623
240610;201707;4688;13287;4047;12076;328;1073;2710;7938;3038;9011
240615;201707;1002;2915;822;2557;114;389;519;1559;633;1948
240620;201707;1884;5527;1652;5131;127;406;1274;3924;1401;4330
240630;201707;2064;6195;1876;5879;165;466;1267;4059;1432;4525
240640;201707;966;2645;795;2371;54;208;552;1581;606;1789
240650;201707;4030;11609;3598;10928;181;626;2835;8542;3016;9168
240660;201707;2470;7530;2317;7305;144;521;1866;5825;2010;6346
240670;201707;2603;7642;2157;6705;200;701;1288;3866;1488;4567
240680;201707;1545;4410;1242;3875;79;274;837;2565;916;2839
240690;201707;934;2516;793;2275;36;132;632;1741;668;1873
240700;201707;2550;7421;2121;6647;82;355;1623;4939;1705;5294
240710;201707;17793;47308;15406;43356;3051;8480;8064;23239;11115;31719
240720;201707;5229;14646;4711;13732;1090;3275;2338;6678;3428;9953
240725;201707;1049;3135;835;2643;62;211;510;1568;572;1779
240730;201707;2101;6191;1819;5660;128;409;1337;4131;1465;4540
240740;201707;1969;5577;1727;5115;101;389;1219;3456;1320;3845
240750;201707;2152;7921;1974;7567;390;1660;1007;3884;1397;5544
240760;201707;1378;3642;1050;3140;63;175;774;2362;837;2537
240770;201707;3145;8854;2804;8381;161;614;2298;6731;2459;7345
240780;201707;5947;16200;4787;14345;588;1799;2865;8736;3453;10535
240790;201707;911;2678;741;2359;33;127;533;1705;566;1832
240800;201707;35373;99564;31005;92120;6310;19539;13486;40442;19796;59981
240810;201707;85096;241481;77790;228747;19643;58337;35572;106742;55215;165079
240820;201707;5710;17941;5119;17001;1153;3963;2426;8469;3579;12432
240830;201707;8977;26872;8323;25917;420;1720;6785;20785;7205;22505
240840;201707;1133;3053;949;2736;79;248;641;1779;720;2027
240850;201707;1306;3777;966;3015;96;322;510;1584;606;1906
240860;201707;1276;3607;1028;3140;42;179;758;2208;800;2387
240870;201707;1181;3126;935;2701;67;203;615;1707;682;1910
240880;201707;1261;4103;1188;3981;98;385;947;3107;1045;3492
240890;201707;5024;14001;4092;12203;785;2445;1774;5248;2559;7693
240895;201707;2638;9031;2433;8692;249;955;1772;6404;2021;7359
240910;201707;3049;8872;2676;8154;96;361;2132;6429;2228;6790
240920;201707;796;2515;692;2286;104;363;340;1106;444;1469
240930;201707;3544;8856;3080;8285;96;263;2451;6699;2547;6962
240933;201707;1631;4229;1405;3868;54;192;1145;3064;1199;3256
240940;201707;6545;16961;5269;14839;604;1685;3366;9355;3970;11040
240950;201707;959;3056;880;2900;54;236;644;2057;698;2293
240960;201707;809;2464;703;2248;54;189;498;1572;552;1761
240970;201707;1895;5153;1594;4637;81;292;1248;3504;1329;3796
240980;201707;2899;9459;2693;9074;366;1362;1804;5993;2170;7355
240990;201707;2655;7828;2513;7554;382;1218;1653;4900;2035;6118
241000;201707;1034;2820;869;2523;48;163;596;1709;644;1872
241010;201707;2792;9290;2621;8964;307;1258;1826;6006;2133;7264
241020;201707;2044;5609;1602;4702;205;566;910;2660;1115;3226
241025;201707;1703;5053;1475;4641;91;312;937;2966;1028;3278
241030;201707;2415;7822;2100;7174;205;793;1400;4730;1605;5523
241040;201707;2268;7533;2052;7139;150;621;1517;5289;1667;5910
241050;201707;1297;3735;1092;3365;65;227;781;2350;846;2577
241060;201707;843;2405;746;2228;61;192;502;1466;563;1658
241070;201707;698;1993;625;1862;53;202;462;1291;515;1493
241080;201707;1152;3357;937;2934;30;136;687;2107;717;2243
241090;201707;2151;6319;1787;5696;93;404;1329;4172;1422;4576
241100;201707;1164;3402;991;3017;57;199;676;2020;733;2219
241105;201707;1200;3604;1034;3313;262;840;414;1376;676;2216
241110;201707;843;2559;689;2215;39;138;444;1368;483;1506
241120;201707;7420;22211;6670;20871;1593;4800;3320;11054;4913;15854
241140;201707;3411;9116;2911;8144;209;581;2072;5641;2281;6222
241142;201707;778;2224;596;1859;62;211;314;952;376;1163
241150;201707;5610;15968;5004;14952;340;1200;3649;10736;3989;11936
241160;201707;989;2805;883;2624;164;492;479;1395;643;1887
241170;201707;1186;3301;1094;3148;99;285;856;2431;955;2716
241180;201707;999;2734;766;2268;78;231;410;1198;488;1429
241190;201707;1193;3258;949;2747;51;185;634;1762;685;1947
241200;201707;19429;54507;17081;50950;4019;12515;7616;23395;11635;35910
241210;201707;1484;4093;1162;3446;128;422;686;1965;814;2387
241220;201707;8136;26032;7454;24774;2207;7468;3168;10949;5375;18417
241230;201707;3082;8671;2828;8269;131;472;2320;6617;2451;7089
241240;201707;1290;3730;834;2686;73;264;369;1196;442;1460
241250;201707;6147;18406;5090;16375;223;1107;3717;11471;3940;12578
241255;201707;1817;6577;1632;6166;260;1115;904;3394;1164;4509
241260;201707;5160;13766;4085;12065;162;692;2936;8454;3098;9146
241270;201707;1894;5669;1637;5157;121;480;1150;3545;1271;4025
241280;201707;1856;5251;1696;4955;155;464;1263;3660;1418;4124
241290;201707;3029;8164;2491;7251;141;499;1846;5248;1987;5747
241300;201707;1510;4227;1280;3814;47;160;855;2504;902;2664
241310;201707;1795;4995;1611;4696;70;259;1313;3768;1383;4027
241320;201707;947;3234;852;3015;116;458;525;1849;641;2307
241330;201707;1476;4390;1379;4263;75;312;1163;3534;1238;3846
241335;201707;2954;8645;2672;8146;141;499;2157;6468;2298;6967
241340;201707;1849;5574;1536;4870;332;1104;632;1949;964;3053
241350;201707;1949;5987;1755;5622;120;471;1310;4085;1430;4556
241355;201707;1442;3936;1148;3405;56;206;867;2531;923;2737
241360;201707;2130;5646;1734;4879;80;245;1258;3457;1338;3702
241370;201707;1389;4052;1130;3543;92;336;717;2156;809;2492
241380;201707;650;1813;544;1609;62;208;329;934;391;1142
241390;201707;2778;8810;2576;8496;242;896;1917;6297;2159;7193
241400;201707;3727;10533;3361;9998;306;981;2547;7628;2853;8609
241410;201707;2478;7443;2185;6987;387;1303;1303;4176;1690;5479
241415;201707;1710;5045;1496;4683;131;449;1102;3366;1233;3815
241420;201707;2284;7779;2031;7342;639;2456;557;2060;1196;4516
241430;201707;574;1676;439;1378;39;142;253;754;292;896
241440;201707;6446;22514;6021;21788;624;2615;4379;15791;5003;18406
241445;201707;1012;2837;959;2774;51;121;816;2472;867;2593
241450;201707;3025;7897;2634;7342;287;800;1869;5203;2156;6003
241460;201707;3471;9900;3041;9021;226;785;2132;6139;2358;6924
241470;201707;1441;3895;1172;3526;79;286;904;2706;983;2992
241475;201707;1273;3741;1044;3286;50;262;740;2193;790;2455
241480;201707;2730;8929;2469;8448;939;3257;644;2522;1583;5779
241490;201707;704;1822;577;1627;28;81;379;1031;407;1112
241500;201707;749;2330;640;2189;26;105;527;1794;553;1899
250010;201707;2816;8619;2340;7568;92;393;1714;5413;1806;5806
250020;201707;1601;4483;1205;3718;60;197;837;2529;897;2726
250030;201707;7017;19883;6436;19060;406;1343;5147;15010;5553;16353
250040;201707;4019;13341;3703;12650;411;1509;2487;8455;2898;9964
250050;201707;3318;10189;3074;9801;446;1457;1969;6205;2415;7662
250053;201707;1245;3704;1131;3532;126;407;778;2456;904;2863
250057;201707;636;2580;618;2561;2;2;590;2498;592;2500
250060;201707;5253;15144;4870;14601;434;1407;3741;11192;4175;12599
250070;201707;3919;11873;3623;11313;98;484;2761;8269;2859;8753
250073;201707;803;2309;694;2124;23;83;522;1542;545;1625
250077;201707;2170;6192;1726;5420;110;359;1196;3735;1306;4094
250080;201707;4284;12016;4048;11611;189;661;3315;9293;3504;9954
250090;201707;2654;7352;2455;7032;139;372;1998;5678;2137;6050
250100;201707;3911;12399;3653;11930;201;855;2940;9349;3141;10204
250110;201707;4837;14236;4543;13808;479;1716;3484;10355;3963;12071
250115;201707;508;1579;464;1503;20;105;347;1081;367;1186
250120;201707;1850;5685;1614;5222;85;352;1243;4004;1328;4356
250130;201707;5328;16236;4788;15243;166;816;3762;11697;3928;12513
250135;201707;1057;3181;987;3057;34;134;789;2418;823;2552
250140;201707;2133;6810;2057;6688;134;556;1652;5322;1786;5878
250150;201707;5059;16638;4619;15808;250;1140;3441;11524;3691;12664
250153;201707;1486;3938;1244;3572;38;160;1035;2908;1073;3068
250157;201707;1788;5664;1633;5352;239;737;1066;3557;1305;4294
250160;201707;3355;9532;3136;9200;100;348;2815;8237;2915;8585
250170;201707;1625;4664;1480;4444;83;305;1171;3473;1254;3778
250180;201707;16067;45551;14881;43806;1283;4479;10847;31079;12130;35558
250190;201707;4154;11844;3781;11250;543;1589;2397;7143;2940;8732
250200;201707;1965;5681;1637;5178;73;288;1302;4091;1375;4379
250205;201707;837;2852;784;2732;33;170;590;2033;623;2203
250210;201707;1504;4845;1394;4661;75;361;1066;3485;1141;3846
250215;201707;1447;4447;1308;4247;93;385;827;2623;920;3008
250220;201707;742;2160;613;1959;37;135;446;1409;483;1544
250230;201707;1602;3937;1261;3371;43;144;987;2533;1030;2677
250240;201707;2341;7495;2191;7225;103;399;1757;5743;1860;6142
250250;201707;4548;13466;4126;12887;167;594;3384;10559;3551;11153
250260;201707;1711;5028;1475;4631;51;195;1155;3608;1206;3803
250270;201707;1308;3977;1177;3811;97;318;857;2903;954;3221
250280;201707;3604;10450;3133;9693;218;719;2363;7273;2581;7992
250290;201707;1796;4795;1500;4391;17;58;1253;3664;1270;3722
250300;201707;5318;15540;5064;15216;369;1453;4257;12455;4626;13908
250310;201707;1121;3364;997;3149;52;208;756;2317;808;2525
250320;201707;8402;23801;7876;23042;830;2674;5887;16923;6717;19597
250330;201707;2447;7415;2083;6874;138;516;1569;5119;1707;5635
250340;201707;1103;3168;988;2974;26;90;806;2380;832;2470
250350;201707;4178;11496;3757;10977;141;460;3241;9479;3382;9939
250355;201707;2001;6149;1824;5920;36;192;1624;5225;1660;5417
250360;201707;1814;5271;1694;5071;44;152;1391;4136;1435;4288
250370;201707;11843;33281;10500;31677;755;2480;8653;26003;9408;28483
250375;201707;1088;3184;982;3029;31;105;851;2651;882;2756
250380;201707;1687;4691;1598;4574;75;285;1309;3613;1384;3898
250390;201707;1831;4946;1506;4396;214;600;956;2820;1170;3420
250400;201707;74368;195368;58105;168968;14738;45117;20760;61703;35498;106820
250403;201707;1593;5076;1469;4897;197;765;956;3113;1153;3878
250407;201707;1208;3308;1038;3054;79;211;750;2191;829;2402
250410;201707;549;1709;502;1620;20;105;402;1241;422;1346
250415;201707;1939;5688;1725;5307;81;267;1325;4062;1406;4329
250420;201707;1244;3592;1121;3412;22;76;1008;3064;1030;3140
250430;201707;6288;16593;5650;15628;237;774;4579;12388;4816;13162
250435;201707;1348;4072;1207;3822;66;261;889;2762;955;3023
250440;201707;4484;12609;4045;11999;109;413;3419;10033;3528;10446
250450;201707;1904;5297;1648;4945;48;180;1363;4027;1411;4207
250460;201707;6768;19532;6326;18970;387;1211;5345;16232;5732;17443
250470;201707;1568;4152;1311;3786;87;304;945;2634;1032;2938
250480;201707;3784;11177;3483;10764;70;309;3055;9449;3125;9758
250485;201707;664;1594;494;1337;18;61;410;1075;428;1136
250490;201707;4043;11850;3843;11582;437;1397;2944;8859;3381;10256
250500;201707;1810;5335;1628;5032;94;300;1280;3969;1374;4269
250510;201707;5048;13737;4462;12930;107;342;3930;11394;4037;11736
250520;201707;1794;5325;1663;5147;229;814;1040;3126;1269;3940
250523;201707;1830;5230;1751;5126;102;423;1470;4165;1572;4588
250527;201707;1505;4290;1430;4197;37;142;1322;3837;1359;3979
250530;201707;594;1807;526;1720;25;104;458;1483;483;1587
250535;201707;1353;4136;1254;3943;53;242;966;2958;1019;3200
250540;201707;2526;6808;2332;6587;107;297;2006;5641;2113;5938
250550;201707;880;2925;805;2801;39;186;647;2197;686;2383
250560;201707;1661;5056;1561;4891;72;275;1276;3908;1348;4183
250570;201707;2679;8213;2345;7578;113;488;1816;5701;1929;6189
250580;201707;1119;2918;981;2711;50;186;811;2171;861;2357
250590;201707;828;2534;751;2411;32;150;605;1873;637;2023
250600;201707;7108;20567;6609;19792;636;1799;5076;15357;5712;17156
250610;201707;3062;8839;2833;8494;219;715;2207;6555;2426;7270
250620;201707;695;2006;621;1853;64;219;425;1221;489;1440
250625;201707;2475;7558;2339;7334;53;200;2069;6400;2122;6600
250630;201707;9762;29581;8797;27612;1664;5436;4919;15247;6583;20683
250640;201707;3435;10347;3242;10082;154;681;2694;8152;2848;8833
250650;201707;879;2347;765;2196;44;173;587;1595;631;1768
250660;201707;1804;4623;1656;4422;32;75;1523;4074;1555;4149
250670;201707;2335;7732;2215;7521;99;481;1854;6164;1953;6645
250680;201707;4962;13319;4662;12978;169;622;4165;11464;4334;12086
250690;201707;6124;15251;5831;14914;258;672;5311;13541;5569;14213
250700;201707;4564;13328;4163;12724;543;1756;2866;8649;3409;10405
250710;201707;4465;13542;3997;12899;393;1366;2760;9011;3153;10377
250720;201707;2790;7652;2569;7302;58;250;2278;6403;2336;6653
250730;201707;3606;10499;3289;10051;237;809;2594;7760;2831;8569
250740;201707;1948;5415;1670;5000;154;517;1254;3652;1408;4169
250750;201707;97888;270039;89102;257180;10701;33884;58823;166587;69524;200471
250760;201707;2298;6315;2019;5901;129;464;1552;4412;1681;4876
250770;201707;3921;12703;3660;12367;370;1436;2621;8831;2991;10267
250780;201707;1756;5047;1504;4557;163;553;982;2913;1145;3466
250790;201707;2324;7426;2193;7192;405;1336;1297;4354;1702;5690
250800;201707;2646;7244;2319;6711;93;266;1883;5388;1976;5654
250810;201707;1287;3674;1107;3398;51;209;871;2630;922;2839
250820;201707;1903;5874;1828;5784;97;414;1609;5021;1706;5435
250830;201707;5628;17788;5165;16816;467;1809;3547;11268;4014;13077
250840;201707;915;2908;787;2641;37;152;518;1746;555;1898
250850;201707;1984;5944;1770;5594;68;329;1389;4263;1457;4592
250855;201707;1087;3162;953;2940;40;179;701;2094;741;2273
250860;201707;3289;10425;2807;9541;553;1982;1262;4396;1815;6378
250870;201707;1085;3068;942;2796;36;131;738;2162;774;2293
250880;201707;1535;4133;1263;3730;189;568;792;2375;981;2943
250890;201707;9407;27549;8955;26933;931;3388;6732;19707;7663;23095
250900;201707;2753;8673;2417;8031;128;464;1875;6128;2003;6592
250905;201707;2077;6430;1999;6338;149;570;1641;5130;1790;5700
250910;201707;5087;14213;4764;13758;222;769;4020;11535;4242;12304
250915;201707;1495;4366;1436;4299;53;123;1306;3998;1359;4121
250920;201707;3263;9059;3069;8771;324;883;2243;6374;2567;7257
250930;201707;2016;5965;1909;5782;143;545;1500;4427;1643;4972
250933;201707;1128;3658;1018;3431;72;315;676;2207;748;2522
250937;201707;695;2071;596;1886;43;154;441;1374;484;1528
250939;201707;1647;4726;1454;4422;67;259;1119;3299;1186;3558
250940;201707;3817;10956;3554;10519;81;311;3101;9195;3182;9506
250950;201707;1386;4038;1197;3779;41;168;1003;3160;1044;3328
250960;201707;1041;3303;976;3184;37;160;784;2513;821;2673
250970;201707;8508;23222;7404;21455;527;1706;5398;15376;5925;17082
250980;201707;2576;7364;2323;6898;81;333;1795;5155;1876;5488
250990;201707;1970;6512;1735;5995;144;622;1199;4021;1343;4643
251000;201707;2108;6055;1818;5600;52;247;1517;4607;1569;4854
251010;201707;2730;7916;2456;7467;75;292;2142;6496;2217;6788
251020;201707;1691;4655;1541;4467;65;211;1388;4008;1453;4219
251030;201707;1021;2871;920;2663;53;186;642;1793;695;1979
251040;201707;1809;5508;1600;5159;72;336;1250;3902;1322;4238
251050;201707;1059;3050;878;2705;115;364;577;1746;692;2110
251060;201707;1056;2369;780;2011;24;99;614;1542;638;1641
251065;201707;484;1366;399;1246;25;98;259;746;284;844
251070;201707;672;1883;599;1780;26;105;479;1380;505;1485
251080;201707;18751;51633;16752;48532;3482;10472;8897;26248;12379;36720
251090;201707;2914;8794;2546;8072;122;476;1931;5988;2053;6464
251100;201707;947;2941;851;2776;40;189;601;1864;641;2053
251110;201707;1837;5286;1614;4841;90;283;1167;3454;1257;3737
251120;201707;6383;20816;6015;20146;509;2052;4494;14811;5003;16863
251130;201707;3829;9510;3523;9176;275;776;3128;8108;3403;8884
251140;201707;4302;12795;4013;12332;142;592;3269;9961;3411;10553
251150;201707;2673;8212;2469;7905;167;736;1894;5879;2061;6615
251160;201707;1873;6059;1798;5946;71;263;1608;5333;1679;5596
251170;201707;1492;4354;1413;4262;42;170;1270;3817;1312;3987
251180;201707;2560;7573;2287;7150;294;985;1447;4487;1741;5472
251190;201707;4510;12182;4288;11914;112;367;3873;10609;3985;10976
251200;201707;3960;12652;3738;12373;97;413;3351;11120;3448;11533
251203;201707;1000;3295;956;3201;52;226;698;2276;750;2502
251207;201707;1036;3167;880;2869;26;134;607;1908;633;2042
251210;201707;7949;21838;6745;20259;505;1561;5163;15686;5668;17247
251220;201707;1205;3121;983;2821;56;149;757;2184;813;2333
251230;201707;4774;13519;4304;12925;225;827;3659;10774;3884;11601
251240;201707;3375;9874;3021;9387;306;986;2239;6899;2545;7885
251250;201707;10386;29742;9610;28614;994;3307;6871;19907;7865;23214
251260;201707;467;1452;428;1386;18;76;321;1017;339;1093
251270;201707;4301;13682;3919;13195;146;655;3322;11165;3468;11820
251272;201707;1341;3780;1259;3662;51;174;1123;3237;1174;3411
251274;201707;937;2808;807;2572;70;297;525;1580;595;1877
251275;201707;1234;3532;1148;3399;49;199;863;2428;912;2627
251276;201707;1208;3643;1149;3547;108;415;846;2563;954;2978
251278;201707;604;1820;532;1682;53;195;349;1101;402;1296
251280;201707;2337;6786;2147;6467;73;314;1694;4920;1767;5234
251290;201707;5704;15261;5364;14837;441;1568;4291;11477;4732;13045
251300;201707;756;2455;708;2376;17;65;579;1935;596;2000
251310;201707;2951;8674;2721;8335;128;564;2146;6365;2274;6929
251315;201707;1670;5530;1577;5363;117;445;1185;3992;1302;4437
251320;201707;1877;5044;1373;4227;69;251;937;2878;1006;3129
251330;201707;1817;4713;1517;4325;60;236;1344;3771;1404;4007
251335;201707;1057;3396;961;3239;68;293;701;2290;769;2583
251340;201707;3460;9648;3015;9036;160;574;2242;6576;2402;7150
251350;201707;1184;3722;1105;3578;47;213;872;2719;919;2932
251360;201707;1809;5533;1535;5147;47;197;1298;4393;1345;4590
251365;201707;722;2144;601;1874;16;68;450;1383;466;1451
251370;201707;23495;70448;22498;69082;1933;6945;17361;52442;19294;59387
251380;201707;1327;4022;1144;3713;37;178;947;2954;984;3132
251385;201707;740;1953;599;1726;36;113;410;1115;446;1228
251390;201707;5832;19219;5156;17897;1266;4564;2492;8678;3758;13242
251392;201707;1055;3053;916;2820;60;234;655;1955;715;2189
251394;201707;644;2204;557;2053;30;134;400;1492;430;1626
251396;201707;819;2285;695;2082;55;156;448;1329;503;1485
251398;201707;949;2660;771;2348;38;154;536;1561;574;1715
251400;201707;1155;3208;978;2952;61;214;696;2011;757;2225
251410;201707;1564;3944;1315;3556;31;121;1096;2856;1127;2977
251420;201707;1980;5582;1700;5250;122;455;1261;3818;1383;4273
251430;201707;1632;5350;1502;5144;59;291;1265;4252;1324;4543
251440;201707;1192;3526;977;3106;38;146;750;2367;788;2513
251445;201707;1539;4603;1448;4480;100;398;1128;3394;1228;3792
251450;201707;4656;14393;4255;13831;131;602;3473;11178;3604;11780
251455;201707;1069;3338;948;3099;72;297;670;2147;742;2444
251460;201707;832;2549;761;2433;43;162;619;1989;662;2151
251465;201707;446;1400;383;1259;19;95;288;915;307;1010
251470;201707;1156;3318;937;2857;90;303;557;1666;647;1969
251480;201707;929;2582;815;2397;35;147;594;1674;629;1821
251490;201707;1810;5250;1599;4918;154;511;1037;3151;1191;3662
251500;201707;1776;5539;1681;5365;100;400;1366;4270;1466;4670
251510;201707;2550;8215;2287;7682;293;1073;1378;4589;1671;5662
251520;201707;958;2644;804;2320;80;220;512;1445;592;1665
251530;201707;12431;33523;11544;32313;269;1172;9960;27219;10229;28391
251540;201707;2866;8915;2631;8471;164;638;2001;6316;2165;6954
251550;201707;3473;8979;2886;8200;86;312;2373;6688;2459;7000
251560;201707;660;2033;594;1919;105;375;331;1020;436;1395
251570;201707;972;2838;793;2489;35;139;551;1668;586;1807
251580;201707;1892;5102;1717;4862;231;592;1244;3594;1475;4186
251590;201707;1508;4393;1424;4274;70;215;1116;3348;1186;3563
251593;201707;1004;3022;921;2903;126;418;553;1715;679;2133
251597;201707;1971;5866;1890;5759;38;146;1708;5159;1746;5305
251600;201707;6545;18739;6039;17945;285;955;4906;14428;5191;15383
251610;201707;3345;9720;2952;8994;380;1110;1977;6117;2357;7227
251615;201707;1154;3190;937;2814;35;148;660;1918;695;2066
251620;201707;16089;41136;14228;38970;487;1286;11608;33520;12095;34806
251630;201707;4744;11952;3997;10893;254;736;2974;7971;3228;8707
251640;201707;2216;6562;1999;6145;84;350;1628;4895;1712;5245
251650;201707;4058;11352;3709;10890;188;669;3091;8993;3279;9662
251660;201707;3531;11037;3186;10411;132;617;2572;8178;2704;8795
251670;201707;4485;12877;3949;12197;36;163;3633;11297;3669;11460
251675;201707;703;2147;649;2072;101;354;419;1318;520;1672
251680;201707;2796;7842;2258;7024;84;324;1763;5444;1847;5768
251690;201707;3306;9712;2982;9102;117;417;2145;6373;2262;6790
251700;201707;1922;6112;1790;5934;95;447;1476;4772;1571;5219
251710;201707;876;2300;589;1727;69;245;281;794;350;1039
251720;201707;1427;4253;1214;3848;50;225;906;2774;956;2999
251740;201707;764;2118;605;1850;47;153;375;1115;422;1268
260005;201707;25941;61748;22254;56551;3686;9182;13412;34145;17098;43327
260010;201707;9968;26744;8370;24513;758;2298;5132;15411;5890;17709
260020;201707;6421;16897;5418;15465;187;708;4340;12316;4527;13024
260030;201707;6213;17423;5497;16286;335;1169;4219;12434;4554;13603
260040;201707;9389;23939;7761;21965;861;2443;5488;16102;6349;18545
260050;201707;11340;34311;10612;33439;450;1733;9150;29034;9600;30767
260060;201707;3894;10736;3432;9916;314;874;2490;7314;2804;8188
260070;201707;9953;27896;9038;26431;853;2825;6388;18331;7241;21156
260080;201707;6303;15729;5617;14768;356;999;4408;11391;4764;12390
260090;201707;5295;13984;4893;13431;553;1466;3683;10262;4236;11728
260100;201707;3324;9017;2849;8359;155;552;2288;6679;2443;7231
260105;201707;4993;13750;4726;13327;150;642;4018;11048;4168;11690
260110;201707;21905;59400;20017;57146;1014;3080;17340;49563;18354;52643
260120;201707;13342;38558;11802;36019;2116;6576;6618;20767;8734;27343
260130;201707;3165;8726;2961;8397;311;924;2184;6114;2495;7038
260140;201707;12837;31385;11142;29358;691;2109;9010;23748;9701;25857
260150;201707;3179;8597;2867;8182;218;721;2242;6330;2460;7051
260160;201707;5643;17155;4839;16079;185;842;3978;13265;4163;14107
260170;201707;16655;45202;15737;43924;815;2453;13277;36822;14092;39275
260180;201707;3306;9690;3007;9256;183;644;2498;7620;2681;8264
260190;201707;16657;37518;14978;35470;328;978;12989;30211;13317;31189
260200;201707;11180;27845;10245;26664;413;1200;8963;23280;9376;24480
260210;201707;12016;35177;10600;32924;462;1765;8573;26536;9035;28301
260220;201707;9604;26240;9187;25718;340;1221;8160;22533;8500;23754
260230;201707;9934;27257;9050;26042;445;1547;7216;20626;7661;22173
260240;201707;2979;8701;2584;8117;230;785;1945;6142;2175;6927
260250;201707;2287;6261;2002;5854;104;350;1588;4554;1692;4904
260260;201707;12347;34386;11097;32550;745;2529;8597;25101;9342;27630
260270;201707;3654;10399;3348;9939;233;977;2508;7152;2741;8129
260280;201707;13075;41206;12017;39655;596;2260;10130;33553;10726;35813
260290;201707;33786;98090;31575;94300;4915;15587;19543;57577;24458;73164
260300;201707;9176;26839;8045;25159;366;1531;6243;19478;6609;21009
260310;201707;4530;13037;4102;12414;724;2032;2643;8325;3367;10357
260320;201707;7547;23164;6872;22012;366;1351;5467;17409;5833;18760
260330;201707;2591;8126;2392;7748;133;517;1863;5923;1996;6440
260340;201707;1936;5461;1764;5208;48;178;1534;4480;1582;4658
260345;201707;22707;68233;21077;65221;5042;17067;8634;25531;13676;42598
260350;201707;5003;13022;4584;12434;168;565;3954;10622;4122;11187
260360;201707;2476;6875;2251;6487;97;430;1540;4337;1637;4767
260370;201707;5633;17098;4958;15879;321;1318;3662;11554;3983;12872
260380;201707;4893;15612;4388;14795;263;1098;3206;10701;3469;11799
260390;201707;4314;13464;3710;12250;290;1024;2511;8194;2801;9218
260392;201707;3549;11259;3212;10825;189;920;2621;8623;2810;9543
260400;201707;14013;38228;13172;36900;1353;4172;9587;26397;10940;30569
260410;201707;61403;171252;52899;157845;13318;42227;20829;63660;34147;105887
260415;201707;3748;11433;3280;10498;187;837;2234;6832;2421;7669
260420;201707;12550;28000;11082;26406;185;631;10149;23953;10334;24584
260430;201707;2932;9289;2559;8574;204;749;1711;5724;1915;6473
260440;201707;3360;9785;2974;9047;265;956;2118;6254;2383;7210
260450;201707;5110;14381;4886;14071;169;583;4344;12478;4513;13061
260460;201707;5569;17404;5069;16447;748;2754;2935;9266;3683;12020
260470;201707;4680;13319;4223;12780;134;375;3705;11565;3839;11940
260480;201707;4188;11624;3656;10862;412;1340;2354;7136;2766;8476
260490;201707;5084;12951;4415;11816;170;572;3672;9543;3842;10115
260500;201707;5945;16570;5238;15467;661;1959;3452;10303;4113;12262
260510;201707;9087;23411;8324;22375;332;1036;7249;19287;7581;20323
260515;201707;4792;13983;3626;11691;201;740;2278;7271;2479;8011
260520;201707;16798;42130;15865;40870;1400;3715;12462;31836;13862;35551
260530;201707;9612;29017;8420;27172;326;1352;6990;22448;7316;23800
260540;201707;6031;14795;5458;14171;761;1514;4205;11524;4966;13038
260545;201707;68;242;43;170;12;44;5;20;17;64
260550;201707;2812;8800;2368;7825;275;1059;1299;4227;1574;5286
260560;201707;6388;16439;5606;15376;175;708;4778;12882;4953;13590
260570;201707;6847;21564;6273;20652;652;2348;4621;15209;5273;17557
260580;201707;3874;10354;3515;9794;72;266;3075;8436;3147;8702
260590;201707;6358;15800;5896;15273;271;742;5099;13192;5370;13934
260600;201707;29502;83012;25881;77050;1692;6050;18811;55227;20503;61277
260610;201707;6539;18877;6211;18349;628;1968;4633;13531;5261;15499
260620;201707;15259;45397;14557;44173;2182;7499;9235;27184;11417;34683
260630;201707;2343;6516;2004;6023;69;275;1636;4851;1705;5126
260640;201707;17714;46887;16436;45192;1711;5139;11783;32124;13494;37263
260650;201707;5516;16574;4824;15395;242;963;3863;12310;4105;13273
260660;201707;7690;20911;6875;19867;227;868;5777;16465;6004;17333
260670;201707;2348;6158;1926;5548;111;339;1370;3909;1481;4248
260680;201707;22852;62551;20542;58574;3309;9606;10941;31112;14250;40718
260690;201707;3767;9921;3120;8876;158;477;2440;6924;2598;7401
260700;201707;5854;17355;5693;17181;24;41;5575;16997;5599;17038
260710;201707;1396;3924;1321;3822;88;310;979;2901;1067;3211
260720;201707;18448;56257;17222;53961;3020;9867;9901;30822;12921;40689
260730;201707;6850;22050;6384;21296;547;2126;4942;16210;5489;18336
260740;201707;1265;3744;1124;3504;41;133;922;2882;963;3015
260750;201707;7026;20323;6145;19195;209;622;5433;17306;5642;17928
260760;201707;4961;12989;4602;12544;227;712;3811;10397;4038;11109
260765;201707;7577;25374;7157;24675;934;4017;4695;15608;5629;19625
260770;201707;3813;10125;3397;9460;130;424;2659;7350;2789;7774
260775;201707;5014;14574;4727;14130;372;1439;3422;9891;3794;11330
260780;201707;3733;11577;3484;11101;622;2119;2050;6374;2672;8493
260790;201707;111883;277686;102665;263921;19208;50191;59282;151165;78490;201356
260795;201707;3126;8898;2752;8327;200;694;1961;5969;2161;6663
260800;201707;5250;13113;4834;12542;125;444;4269;10730;4394;11174
260805;201707;3751;11132;3213;10241;298;1105;2179;6849;2477;7954
260810;201707;6618;18325;6294;17783;491;1472;4981;13982;5472;15454
260820;201707;4153;11262;3684;10540;469;1542;2343;6548;2812;8090
260825;201707;2903;9096;2586;8566;135;568;1938;6366;2073;6934
260830;201707;3886;12098;3433;11230;473;1506;2269;7551;2742;9057
260840;201707;4186;11879;3709;11182;230;745;2939;8805;3169;9550
260845;201707;4129;11768;3905;11366;384;1144;2875;8352;3259;9496
260850;201707;4984;15497;4400;14211;660;2279;2348;7463;3008;9742
260860;201707;3665;10847;3146;9807;162;600;2400;7387;2562;7987
260870;201707;4332;11349;3819;10696;184;632;3174;8772;3358;9404
260875;201707;6695;18152;5796;16717;809;2352;3694;10710;4503;13062
260880;201707;10003;29017;9002;27408;448;1500;7212;22035;7660;23535
260890;201707;13047;36775;12125;35348;957;3214;8719;24978;9676;28192
260900;201707;5717;17291;4916;15770;352;1379;3219;10132;3571;11511
260910;201707;3115;9117;2773;8546;133;481;2079;6397;2212;6878
260915;201707;4709;15136;4391;14693;84;419;3981;13282;4065;13701
260920;201707;3307;9770;3061;9434;177;567;2474;7810;2651;8377
260930;201707;3842;12406;3412;11673;292;1084;2459;8439;2751;9523
260940;201707;14308;36836;13070;34826;1340;4041;9034;23450;10374;27491
260950;201707;6366;19217;5588;17630;852;2994;2782;8331;3634;11325
260960;201707;58382;155233;52394;145693;9193;27399;28307;77428;37500;104827
260970;201707;4989;14620;4561;14054;219;795;3546;10957;3765;11752
260980;201707;4193;13027;3850;12598;100;428;3399;11114;3499;11542
260990;201707;17294;51774;15500;49283;973;3672;11868;37596;12841;41268
261000;201707;16027;42046;13227;37862;1503;4593;8028;23429;9531;28022
261010;201707;2587;6963;2332;6648;97;224;2051;5946;2148;6170
261020;201707;6540;18488;5719;17019;488;1578;4188;12149;4676;13727
261030;201707;3863;11551;3393;10770;164;606;2674;8365;2838;8971
261040;201707;5178;16299;4362;14573;321;1238;3092;10136;3413;11374
261050;201707;7887;22433;7320;21453;887;2619;4760;13997;5647;16616
261060;201707;12728;35826;11711;34082;1024;3432;8760;24952;9784;28384
261070;201707;55582;132330;48753;122570;4885;12763;33958;84524;38843;97287
261080;201707;5825;16121;5518;15678;276;756;4813;13819;5089;14575
261090;201707;16875;44671;15431;42682;836;2523;12715;35069;13551;37592
261100;201707;8308;25437;7361;23823;1040;3533;4584;15084;5624;18617
261110;201707;61855;181657;54778;170669;13644;44901;23846;75982;37490;120883
261120;201707;3923;10025;3411;9409;82;275;3017;8330;3099;8605
261130;201707;7323;18281;6738;17623;194;591;5942;15477;6136;16068
261140;201707;3246;8647;2941;8184;349;1080;1964;5407;2313;6487
261150;201707;5404;14886;4908;14131;194;679;4174;11920;4368;12599
261153;201707;2071;6106;1763;5616;96;390;1235;3898;1331;4288
261160;201707;199496;514475;182589;489193;45674;128040;78815;213364;124489;341404
261170;201707;5705;15097;5208;14385;286;795;4165;11508;4451;12303
261180;201707;9789;26523;9075;25540;865;2697;6284;17499;7149;20196
261190;201707;5001;15226;4644;14779;479;1893;3217;9998;3696;11891
261200;201707;3634;8714;3235;8234;301;784;2503;6343;2804;7127
261210;201707;1898;4920;1743;4719;97;281;1508;4080;1605;4361
261220;201707;13658;41166;11570;36928;1664;5756;6324;20054;7988;25810
261230;201707;4639;14003;4161;13393;116;465;3482;11339;3598;11804
261240;201707;4996;13965;4539;13205;455;1258;3392;9948;3847;11206
261245;201707;3505;10591;3025;9733;138;631;2346;7322;2484;7953
261247;201707;3156;9578;2684;8709;175;678;1866;6045;2041;6723
261250;201707;19254;50045;17762;48038;3295;8574;11163;31384;14458;39958
261255;201707;4119;12445;3645;11600;211;909;2851;8832;3062;9741
261260;201707;12704;34972;11196;33153;490;1752;9283;27628;9773;29380
261270;201707;3824;11054;3442;10431;287;997;2515;7415;2802;8412
261280;201707;2598;7648;2366;7270;101;407;1888;5666;1989;6073
261290;201707;2987;8306;2674;7898;154;559;2067;6102;2221;6661
261300;201707;11048;34032;9601;31377;910;3557;6366;20303;7276;23860
261310;201707;7279;21701;6760;20804;1545;4840;3769;11585;5314;16425
261320;201707;5937;17718;5397;16774;195;771;4342;13275;4537;14046
261330;201707;5775;15579;5401;15094;268;993;4589;12539;4857;13532
261340;201707;3979;12893;3701;12428;318;1320;2591;8604;2909;9924
261350;201707;8220;25936;7703;25055;226;1185;6252;19813;6478;20998
261360;201707;8354;21407;7336;20010;479;1367;5791;15545;6270;16912
261370;201707;19427;56272;18140;54209;3541;11071;10227;30541;13768;41612
261380;201707;4129;13624;3808;12941;572;2196;2323;7722;2895;9918
261390;201707;16427;49018;14651;45990;1871;6344;8767;27536;10638;33880
261400;201707;4725;15898;4197;14770;245;1087;2977;10281;3222;11368
261410;201707;9183;24659;8072;22913;599;1870;6349;17912;6948;19782
261420;201707;7340;24296;6997;23841;1354;5188;4288;14438;5642;19626
261430;201707;3512;10438;2989;9648;165;570;2355;7635;2520;8205
261440;201707;1570;4847;1395;4540;52;258;1013;3196;1065;3454
261450;201707;14145;39591;13534;38828;347;1360;11796;33525;12143;34885
261460;201707;7169;20709;6667;19988;341;1157;5713;17068;6054;18225
261470;201707;4108;10960;3758;10487;76;314;3121;8715;3197;9029
261480;201707;4039;13696;3655;13027;241;1026;2766;9649;3007;10675
261485;201707;5003;15027;4422;14043;531;1946;2789;8705;3320;10651
261500;201707;5629;15491;4995;14634;480;1378;3584;10785;4064;12163
261510;201707;1903;5931;1680;5551;122;470;1224;4060;1346;4530
261520;201707;2738;8484;2570;8184;122;440;1637;5452;1759;5892
261530;201707;10964;34844;9816;32576;1686;6313;4541;14944;6227;21257
261540;201707;7206;22618;6697;21756;1354;4450;3824;12729;5178;17179
261550;201707;3520;9662;3272;9306;240;857;2471;6828;2711;7685
261560;201707;7434;23464;6686;22448;663;2680;4933;16494;5596;19174
261570;201707;3469;10070;2975;9253;296;1044;1903;5835;2199;6879
261580;201707;6185;18161;5602;17251;227;1001;4756;14414;4983;15415
261590;201707;2576;7034;2179;6422;132;401;1642;4867;1774;5268
261600;201707;5259;13959;4481;12829;305;955;3242;9298;3547;10253
261610;201707;2476;6783;2121;6261;73;274;1688;4976;1761;5250
261618;201707;2504;6782;2266;6470;125;409;1815;5083;1940;5492
261620;201707;3990;12251;3734;11823;863;2617;2186;7221;3049;9838
261630;201707;7513;21501;6311;19253;634;2326;3691;10855;4325;13181
261640;201707;35696;86044;33232;83105;2114;4833;26730;69527;28844;74360
261650;201707;3895;11031;3598;10639;209;773;2680;7984;2889;8757
270010;201707;4347;15729;3981;15028;249;1274;3025;11251;3274;12525
270020;201707;3953;10749;3641;10307;287;982;2912;8001;3199;8983
270030;201707;37302;108814;34308;103878;6323;19574;20233;61739;26556;81313
270040;201707;10788;31696;9892;30524;998;3436;7358;22761;8356;26197
270050;201707;4637;12165;4184;11630;309;862;3498;9849;3807;10711
270060;201707;1928;5461;1772;5257;233;711;1231;3726;1464;4437
270070;201707;4457;13339;4048;12765;183;840;3355;10313;3538;11153
270080;201707;1301;3998;1117;3645;115;407;761;2431;876;2838
270090;201707;2141;6556;1927;6146;97;445;1497;4575;1594;5020
270100;201707;5637;16625;5266;16039;475;1701;3985;11919;4460;13620
270110;201707;2985;8232;2656;7857;286;873;1954;5992;2240;6865
270120;201707;3130;8510;2751;8031;88;328;2413;7013;2501;7341
270130;201707;5250;15307;4830;14842;488;1587;3797;11829;4285;13416
270135;201707;1857;4860;1652;4611;144;292;1399;4052;1543;4344
270140;201707;10684;24434;8955;22220;518;1961;7297;17130;7815;19091
270150;201707;2693;8462;2617;8374;40;129;2538;8140;2578;8269
270160;201707;4990;16192;4577;15681;156;769;3915;13265;4071;14034
270170;201707;3718;11664;3389;11207;417;1696;2262;7277;2679;8973
270180;201707;2319;7350;2127;7079;102;483;1770;5759;1872;6242
270190;201707;1766;5597;1670;5472;82;292;1412;4682;1494;4974
270200;201707;2528;8243;2349;7980;199;853;1717;5633;1916;6486
270210;201707;5010;13942;4626;13438;292;912;3950;11451;4242;12363
270220;201707;1295;4102;1192;3923;270;987;623;2002;893;2989
270230;201707;10780;32897;9342;30614;1098;4313;5612;17799;6710;22112
270235;201707;6154;19615;5745;18966;316;1310;4657;15226;4973;16536
270240;201707;10315;29707;8770;27707;1765;5913;5103;16299;6868;22212
270250;201707;3131;8148;2826;7763;391;1029;2095;5822;2486;6851
270255;201707;4819;14426;3893;12718;256;1063;2737;8716;2993;9779
270260;201707;5969;18423;5712;18056;297;1311;4820;14763;5117;16074
270270;201707;1147;3169;1054;3043;190;579;629;1772;819;2351
270280;201707;3547;9684;3063;9007;401;947;2108;6421;2509;7368
270290;201707;8093;27039;7541;26103;479;2206;6021;20451;6500;22657
270300;201707;3782;11533;3379;11057;338;1211;2442;7993;2780;9204
270310;201707;7598;22230;6654;20834;251;1251;5427;16470;5678;17721
270320;201707;5876;17810;5438;17072;788;2672;3621;11193;4409;13865
270330;201707;4127;13893;3834;13502;363;1387;2935;10445;3298;11832
270340;201707;1658;4928;1460;4658;107;427;1161;3609;1268;4036
270350;201707;1934;5020;1714;4734;177;548;1202;3320;1379;3868
270360;201707;2138;6313;2025;6181;136;380;1741;5432;1877;5812
270370;201707;1471;4768;1337;4538;87;366;994;3352;1081;3718
270375;201707;2996;7802;2622;7325;72;232;2318;6454;2390;6686
270380;201707;5782;17439;5332;16824;448;1463;4044;12995;4492;14458
270390;201707;1268;3405;1089;3134;52;186;834;2340;886;2526
270400;201707;6424;18644;5710;17605;297;1175;4205;12572;4502;13747
270410;201707;4742;14684;4319;13923;345;1286;3128;9933;3473;11219
270420;201707;5958;18459;5672;18085;280;1260;4591;14286;4871;15546
270430;201707;139853;388013;121366;361238;33825;106605;43712;134432;77537;241037
270440;201707;4698;13727;4287;13184;152;645;3505;10717;3657;11362
270450;201707;6463;19249;6089;18757;411;1553;4905;14937;5316;16490
270460;201707;3505;8848;3156;8435;99;342;2783;7297;2882;7639
270470;201707;10504;32599;9620;31220;1114;4032;6494;21212;7608;25244
270480;201707;2901;8576;2528;7951;289;1065;1763;5350;2052;6415
270490;201707;1011;3064;913;2933;58;230;705;2230;763;2460
270500;201707;4885;15866;4527;15424;211;1032;3763;12618;3974;13650
270510;201707;6087;17321;5438;16414;590;2261;3995;11559;4585;13820
270520;201707;3549;11003;3166;10307;1027;3572;1013;3499;2040;7071
270530;201707;1299;3965;1205;3825;96;316;863;2782;959;3098
270540;201707;2057;6565;1896;6335;93;461;1566;5072;1659;5533
270550;201707;6811;19743;6127;18898;704;2264;4447;14006;5151;16270
270560;201707;3162;9145;2898;8741;200;717;2182;6469;2382;7186
270570;201707;3791;11991;3421;11363;225;937;2683;8746;2908;9683
270580;201707;2143;6313;2022;6151;97;297;1742;5367;1839;5664
270590;201707;1418;4503;1366;4437;6;31;1341;4357;1347;4388
270600;201707;2893;9310;2611;8836;151;729;2121;6993;2272;7722
270610;201707;3376;9952;3093;9545;147;568;2626;7987;2773;8555
270620;201707;1397;4488;1298;4319;76;335;1049;3375;1125;3710
270630;201707;16065;46090;14593;43741;1681;5249;10245;31033;11926;36282
270640;201707;5785;17417;5181;16474;294;1248;4117;12771;4411;14019
270642;201707;2386;8164;2213;7919;193;956;1696;5873;1889;6829
270644;201707;2890;8180;2501;7650;278;862;1796;5621;2074;6483
270650;201707;3664;11181;3454;10895;452;1932;2426;7232;2878;9164
270660;201707;2117;5398;1669;4764;82;329;1228;3466;1310;3795
270670;201707;16932;42177;14655;39599;1503;4045;11024;30446;12527;34491
270680;201707;4482;12468;4246;12205;82;196;4013;11632;4095;11828
270690;201707;9473;24720;8415;23544;1968;5077;5329;15814;7297;20891
270700;201707;576;1807;507;1684;68;290;335;1064;403;1354
270710;201707;6068;18648;5711;18196;347;1460;4744;14831;5091;16291
270720;201707;3483;11228;3118;10592;126;719;2555;8455;2681;9174
270730;201707;6634;18154;6204;17680;389;1145;5366;15452;5755;16597
270740;201707;2351;6506;2186;6257;149;517;1792;5071;1941;5588
270750;201707;5285;15574;4830;14875;521;1836;3543;10820;4064;12656
270760;201707;3571;10328;3190;9726;123;488;2608;7847;2731;8335
270770;201707;19773;51159;16466;47166;3263;9072;9508;28959;12771;38031
270780;201707;1830;5645;1741;5509;157;555;1336;4224;1493;4779
270790;201707;1593;4937;1463;4744;244;818;891;2902;1135;3720
270800;201707;11209;32377;10384;31268;554;2306;8757;25740;9311;28046
270810;201707;3282;9813;2630;8623;241;939;1747;5675;1988;6614
270820;201707;1784;5600;1559;5215;221;847;1011;3325;1232;4172
270830;201707;5626;14180;4976;13415;386;1095;3942;10923;4328;12018
270840;201707;8018;24794;7339;23886;285;1514;6301;19943;6586;21457
270850;201707;7790;22618;7355;22052;673;2650;5611;16032;6284;18682
270860;201707;11524;31089;9689;28800;960;3295;6823;19938;7783;23233
270870;201707;2241;6605;1889;5901;212;705;1235;3813;1447;4518
270880;201707;8324;25812;7689;24880;435;1823;6161;19581;6596;21404
270890;201707;2487;7424;2300;7102;220;790;1655;4957;1875;5747
270895;201707;2994;10314;2878;10147;122;617;2498;8652;2620;9269
270900;201707;1819;4861;1468;4310;63;213;1156;3307;1219;3520
270910;201707;3622;11441;3296;10871;191;874;2474;7949;2665;8823
270915;201707;9477;30538;8399;28613;1134;4491;5101;16952;6235;21443
270920;201707;6245;19140;5920;18692;290;1397;5080;15536;5370;16933
270930;201707;16765;44027;14227;40978;2652;7374;8823;26471;11475;33845
270940;201707;5595;17914;5259;17550;482;2116;3864;12601;4346;14717
280010;201707;690;1935;591;1760;34;161;417;1128;451;1289
280020;201707;4892;13624;4263;12602;552;1702;2769;8156;3321;9858
280030;201707;74452;190432;62921;173388;17517;50084;22936;65803;40453;115887
280040;201707;3182;9279;2841;8763;300;1001;2001;6092;2301;7093
280050;201707;3760;11685;3466;11178;768;2617;1840;5938;2608;8555
280060;201707;5089;15298;4339;14030;802;2772;2153;7099;2955;9871
280067;201707;7172;19632;6156;17989;809;2384;3836;11210;4645;13594
280070;201707;1957;6204;1878;6078;151;475;1529;4976;1680;5451
280100;201707;3833;11511;3443;10840;471;1620;2246;7077;2717;8697
280110;201707;1363;4036;1248;3857;56;227;1030;3107;1086;3334
280120;201707;7939;24148;7194;22908;1044;3128;5014;16477;6058;19605
280130;201707;8051;21082;7451;20215;804;2359;5445;14801;6249;17160
280140;201707;5868;15010;5344;14283;413;1108;4254;11389;4667;12497
280150;201707;3648;10349;3413;9989;212;755;2718;7836;2930;8591
280160;201707;1321;3823;1109;3454;162;534;681;2080;843;2614
280170;201707;4909;14083;4472;13435;335;1019;3508;10670;3843;11689
280190;201707;1232;3052;1048;2776;74;240;819;2095;893;2335
280200;201707;1230;3553;1108;3363;115;419;785;2299;900;2718
280210;201707;14743;40972;13079;38692;2351;7307;7315;22031;9666;29338
280220;201707;1756;4944;1589;4699;79;308;1292;3792;1371;4100
280230;201707;3370;9717;3030;9193;297;1007;2132;6448;2429;7455
280240;201707;3531;9740;3180;9195;124;489;2623;7415;2747;7904
280250;201707;853;2243;677;1950;117;361;322;911;439;1272
280260;201707;2145;5492;1996;5317;62;186;1831;4882;1893;5068
280270;201707;2243;6730;2053;6433;121;430;1678;5183;1799;5613
280280;201707;4181;13446;3783;12791;681;1961;2309;8413;2990;10374
280290;201707;17791;51973;15976;49207;1915;6727;10049;30946;11964;37673
280300;201707;9892;28660;9165;27777;628;2165;6941;21827;7569;23992
280310;201707;1406;3822;1191;3453;47;183;867;2433;914;2616
280320;201707;8751;26603;7988;25361;1270;4385;4612;14486;5882;18871
280330;201707;4744;12660;4251;11896;348;1128;3267;8864;3615;9992
280340;201707;4251;10854;3956;10475;318;815;3195;8741;3513;9556
280350;201707;22610;61275;19868;57243;2682;8131;12921;37395;15603;45526
280360;201707;5837;17657;5366;16855;889;3031;3053;9476;3942;12507
280370;201707;1982;5201;1676;4706;153;393;1213;3409;1366;3802
280380;201707;1075;3175;966;2995;112;424;659;1983;771;2407
280390;201707;3154;8989;2695;8125;204;686;1879;5629;2083;6315
280400;201707;4131;11389;3746;10821;890;2496;1938;5867;2828;8363
280410;201707;2167;6753;1858;6141;205;737;1094;3514;1299;4251
280420;201707;4309;12022;3930;11452;190;548;3348;9829;3538;10377
280430;201707;2259;5695;2014;5341;94;346;1546;3994;1640;4340
280440;201707;4767;13318;4312;12728;337;1078;3375;9867;3712;10945
280445;201707;2485;6609;2237;6166;60;205;1724;4610;1784;4815
280450;201707;9606;23996;8821;22990;560;1190;7455;19982;8015;21172
280460;201707;6975;17522;6355;16647;737;1925;4763;12602;5500;14527
280470;201707;1870;5430;1652;5052;91;287;1227;3757;1318;4044
280480;201707;33791;92938;31354;89398;4019;12897;21211;59310;25230;72207
280490;201707;3908;11522;3435;10750;210;853;2550;7796;2760;8649
280500;201707;961;2475;839;2310;46;148;679;1855;725;2003
280510;201707;2570;7431;2289;7029;140;536;1657;5051;1797;5587
280520;201707;1762;4649;1594;4436;105;293;1330;3720;1435;4013
280530;201707;2534;6569;2316;6293;146;434;1874;5107;2020;5541
280540;201707;9404;25448;8631;24344;241;1031;7497;20587;7738;21618
280550;201707;7039;17565;5789;15685;420;1120;4200;11295;4620;12415
280560;201707;7546;21763;7111;21144;286;1112;6046;17653;6332;18765
280570;201707;6416;16957;5471;15685;420;1391;3811;10794;4231;12185
280580;201707;5489;16520;4742;15170;718;2243;2900;9548;3618;11791
280590;201707;2714;7284;2379;6869;206;804;1590;4451;1796;5255
280600;201707;3576;10513;3266;10061;273;982;2418;7354;2691;8336
280610;201707;2524;6717;2286;6383;158;528;1755;4802;1913;5330
280620;201707;5462;15145;4772;14037;497;1340;3265;9986;3762;11326
280630;201707;3697;11701;3447;11331;285;972;2686;8998;2971;9970
280640;201707;2265;6721;2132;6575;67;202;1976;6141;2043;6343
280650;201707;1127;3329;998;3134;116;394;683;2112;799;2506
280660;201707;2776;7455;2617;7272;213;574;2187;6130;2400;6704
280670;201707;17513;43822;15917;41703;1622;4547;11533;30055;13155;34602
280680;201707;2925;7594;2500;6917;180;501;1853;5043;2033;5544
280690;201707;1011;2701;892;2537;87;274;645;1804;732;2078
280700;201707;1091;3096;989;2915;44;150;733;2128;777;2278
280710;201707;13315;32349;11793;30576;690;1297;10130;27118;10820;28415
280720;201707;2483;6181;2229;5890;193;544;1525;4289;1718;4833
280730;201707;1064;2849;979;2721;54;195;813;2202;867;2397
280740;201707;13400;34979;11491;32000;1348;3751;7404;20800;8752;24551
280750;201707;3505;10287;3200;9788;230;805;2283;6943;2513;7748
280760;201707;5868;17200;5351;16409;767;2458;3300;10410;4067;12868
290010;201707;2907;6463;2112;5232;41;168;1676;3924;1717;4092
290020;201707;4561;14345;4392;14121;296;913;3735;12080;4031;12993
290030;201707;3364;9695;3144;9405;283;841;2506;7524;2789;8365
290035;201707;4704;11498;4087;10675;202;587;3261;8651;3463;9238
290040;201707;4358;11098;3675;10329;206;749;2834;7996;3040;8745
290050;201707;2379;7689;2085;7169;155;640;1440;4894;1595;5534
290060;201707;1313;3284;1079;2966;128;418;749;1983;877;2401
290070;201707;34229;82993;29524;76953;4308;11510;17106;45943;21414;57453
290080;201707;5976;17524;5074;16269;726;2421;3273;10736;3999;13157
290090;201707;2140;4318;1747;3892;63;114;1574;3539;1637;3653
290100;201707;9285;26160;8217;24476;1167;3418;5065;15549;6232;18967
290110;201707;5052;14404;4755;13885;630;1974;3086;8904;3716;10878
290115;201707;4677;13691;4138;12964;189;589;3454;11019;3643;11608
290120;201707;6986;17644;5775;16209;234;827;4742;13105;4976;13932
290130;201707;4750;12107;3835;10972;157;634;3037;8439;3194;9073
290135;201707;4728;11385;3905;10109;282;821;2838;7094;3120;7915
290140;201707;4615;13157;3845;12153;192;711;3204;10155;3396;10866
290150;201707;2259;6544;2139;6373;216;662;1610;4713;1826;5375
290160;201707;3376;8319;3170;8060;235;551;2613;6622;2848;7173
290170;201707;2689;8420;2513;8186;135;568;2156;6913;2291;7481
290180;201707;2975;8384;2523;7680;147;526;1930;5813;2077;6339
290190;201707;3853;12373;3668;12101;212;927;2863;9326;3075;10253
290195;201707;2246;5974;1876;5384;70;303;1489;4196;1559;4499
290200;201707;4004;11931;3482;11143;236;834;2707;8592;2943;9426
290205;201707;3396;9312;3035;8739;162;627;2310;6437;2472;7064
290210;201707;14738;41203;13169;39131;1465;3813;9628;29989;11093;33802
290220;201707;2511;6993;2373;6799;206;628;1867;5314;2073;5942
290225;201707;3159;7300;2778;6873;67;154;2584;6427;2651;6581
290230;201707;2282;7087;2131;6909;112;447;1768;5735;1880;6182
290240;201707;3591;9797;3225;9268;203;659;2523;7122;2726;7781
290250;201707;3951;11976;3651;11578;149;404;3061;10178;3210;10582
290260;201707;5248;14380;4311;12975;299;1060;3258;9752;3557;10812
290265;201707;3652;10874;3098;9867;158;663;2348;7359;2506;8022
290270;201707;12216;42975;11643;42052;997;4198;8823;31643;9820;35841
290280;201707;5754;17804;5262;17010;378;1337;3880;12514;4258;13851
290290;201707;10200;30734;8877;28507;949;3119;6128;19824;7077;22943
290300;201707;4651;12874;3359;10460;211;712;2283;7212;2494;7924
290310;201707;1501;4276;1295;3950;161;541;829;2511;990;3052
290320;201707;28241;77911;23841;72337;5031;16195;12384;38705;17415;54900
290323;201707;3837;10447;3424;9928;117;385;2850;8139;2967;8524
290327;201707;4609;13409;3943;12216;402;1237;2657;8232;3059;9469
290330;201707;1957;4557;1757;4347;85;196;1554;3910;1639;4106
290340;201707;5267;15490;4783;14896;1000;3232;2983;9416;3983;12648
290350;201707;4656;14220;4107;13314;405;1361;2866;9464;3271;10825
290360;201707;4893;13938;4208;13016;132;507;3527;10964;3659;11471
290370;201707;4777;12733;3982;11618;245;692;3116;9189;3361;9881
290380;201707;5636;15946;4911;14868;245;819;3950;12063;4195;12882
290390;201707;15341;45095;13594;42495;1693;5499;8817;28276;10510;33775
290395;201707;2718;8606;2397;7995;102;454;1807;6011;1909;6465
290400;201707;3796;10686;3122;9643;215;722;2242;6821;2457;7543
290405;201707;4851;14659;4079;13256;335;1163;2668;8767;3003;9930
290410;201707;5940;17016;4806;15168;276;1116;3474;10565;3750;11681
290420;201707;3272;9178;2695;8317;213;692;2029;6269;2242;6961
290430;201707;3221;9646;2788;8869;446;1434;1678;5429;2124;6863
290440;201707;3039;7763;2369;6796;119;394;1731;4998;1850;5392
290450;201707;3292;9291;2773;8518;145;561;2081;6240;2226;6801
290460;201707;12665;36041;11305;33666;3233;9971;4106;12152;7339;22123
290470;201707;4223;11754;3259;10246;630;2164;1503;4852;2133;7016
290475;201707;5970;18314;5230;16965;161;780;4054;12862;4215;13642
290480;201707;2326;6193;2154;5942;211;614;1389;3945;1600;4559
290485;201707;4892;14889;4223;13885;221;1081;3437;11068;3658;12149
290490;201707;8679;21847;8136;21152;608;1764;6579;16956;7187;18720
290500;201707;4066;12557;3286;10951;432;1562;1734;5726;2166;7288
290510;201707;3267;9013;2879;8487;117;448;2420;7066;2537;7514
290515;201707;3723;10059;3098;9256;116;302;2646;8089;2762;8391
290520;201707;11567;34852;9260;30281;533;2191;5850;18789;6383;20980
290530;201707;5222;15148;4578;14117;283;913;3651;11245;3934;12158
290540;201707;3759;10706;3518;10334;177;560;2975;8729;3152;9289
290550;201707;4613;11778;4104;11205;81;252;3766;10343;3847;10595
290560;201707;6558;18156;5669;16865;778;2417;3845;11387;4623;13804
290570;201707;43511;115561;40083;111017;3410;9817;29825;82362;33235;92179
290580;201707;7189;23394;6698;22626;677;2312;4975;17185;5652;19497
290590;201707;7203;22651;6231;20948;225;946;5046;16971;5271;17917
290600;201707;18201;52940;16823;50976;1244;3915;13228;40843;14472;44758
290610;201707;2489;8208;2036;7324;114;537;1404;4949;1518;5486
290620;201707;6352;18705;5779;17780;324;1100;4761;14527;5085;15627
290630;201707;8510;21496;7353;20165;522;1421;6042;16744;6564;18165
290640;201707;2695;7572;2172;6750;119;444;1644;5022;1763;5466
290650;201707;11035;31492;10452;30691;2460;7111;6056;18471;8516;25582
290660;201707;3737;9981;3180;9169;132;381;2325;7017;2457;7398
290670;201707;7121;20950;6298;19596;633;1989;4434;14001;5067;15990
290680;201707;10316;30331;9098;28652;345;1599;7296;22533;7641;24132
290682;201707;4740;13097;4136;12232;170;612;3411;9967;3581;10579
290685;201707;3706;8647;2462;6904;249;686;1549;4456;1798;5142
290687;201707;7163;20384;5713;17970;1084;3444;2944;9616;4028;13060
290689;201707;3103;8790;2720;8217;211;727;1927;5942;2138;6669
290690;201707;5549;15340;4810;14334;710;2069;3081;9264;3791;11333
290700;201707;2512;7308;2340;7060;105;368;1962;5941;2067;6309
290710;201707;7952;24181;7293;23234;387;1342;6097;19471;6484;20813
290720;201707;19061;53638;17586;51802;1166;3438;14371;42926;15537;46364
290730;201707;7279;19202;6474;18147;407;1128;4869;13638;5276;14766
290740;201707;973;2775;761;2392;55;190;563;1769;618;1959
290750;201707;10899;29367;9358;26615;1244;3838;5662;15679;6906;19517
290755;201707;2314;6493;1821;5594;106;384;1251;3775;1357;4159
290760;201707;4131;12305;3311;10730;452;1349;1872;6361;2324;7710
290770;201707;2593;8793;2417;8560;101;469;1938;6902;2039;7371
290780;201707;9123;22636;7846;20814;648;1369;5883;16082;6531;17451
290790;201707;4573;13087;4174;12558;217;609;3535;10720;3752;11329
290800;201707;7255;15164;5657;13402;418;834;4348;10696;4766;11530
290810;201707;5635;16233;4609;14575;194;716;3426;10874;3620;11590
290820;201707;5419;14934;4880;14193;337;1144;3605;10499;3942;11643
290830;201707;4609;11443;4199;10897;174;570;3284;8363;3458;8933
290840;201707;17576;49228;15410;45904;1910;5379;9986;31070;11896;36449
290850;201707;6229;17179;5933;16818;665;1676;4498;13247;5163;14923
290860;201707;5421;17440;5017;16963;331;1223;4055;14024;4386;15247
290870;201707;4843;13751;3878;12143;194;768;2743;8539;2937;9307
290880;201707;1460;3790;1160;3335;90;226;783;2301;873;2527
290890;201707;7462;18065;6400;16879;300;768;5658;15039;5958;15807
290900;201707;2385;6639;1836;5671;137;466;1135;3468;1272;3934
290910;201707;5086;13333;4161;11961;80;348;3476;9870;3556;10218
290920;201707;5167;13306;4769;12797;159;436;4219;11293;4378;11729
290930;201707;8428;24214;7166;22216;264;1170;5618;16982;5882;18152
290940;201707;3675;11061;3218;10400;194;648;2390;7855;2584;8503
290950;201707;1599;4283;1389;3957;109;335;970;2769;1079;3104
290960;201707;5695;15740;5131;15035;191;620;4274;12539;4465;13159
290970;201707;3803;11303;3241;10382;243;760;2269;7341;2512;8101
290980;201707;10779;29664;9174;26711;2038;6151;3518;10259;5556;16410
290990;201707;9141;26461;7871;24330;562;1976;5942;18043;6504;20019
291000;201707;3119;8959;2798;8565;278;798;2206;6853;2484;7651
291005;201707;15096;37678;13343;35484;1007;2733;10301;27660;11308;30393
291010;201707;3319;10050;2600;8568;205;696;1652;5440;1857;6136
291020;201707;1300;3404;1055;2966;64;202;655;1736;719;1938
291030;201707;2365;6237;1704;4939;114;355;1045;2929;1159;3284
291040;201707;5630;16326;4930;15287;289;1149;3839;11832;4128;12981
291050;201707;7940;24897;7234;23649;1367;4948;4215;13513;5582;18461
291060;201707;6036;21476;5644;20830;737;3177;3684;13348;4421;16525
291070;201707;16274;45550;14114;42308;683;2484;11031;32778;11714;35262
291072;201707;24003;68680;19142;58974;4334;14230;6651;20711;10985;34941
291075;201707;5125;14142;4521;13183;300;799;3411;9971;3711;10770
291077;201707;1549;4279;1273;3810;62;191;917;2748;979;2939
291080;201707;80001;242145;70416;225027;24815;80723;11638;38692;36453;119415
291085;201707;5765;14912;4913;13748;275;863;4041;11293;4316;12156
291090;201707;1762;3825;1529;3561;136;192;1248;3018;1384;3210
291100;201707;2774;6744;2104;5939;120;440;1610;4444;1730;4884
291110;201707;5446;18037;4819;17040;550;2100;3423;11873;3973;13973
291120;201707;7583;19789;6930;18818;582;1652;5197;14100;5779;15752
291125;201707;1984;3832;1536;3348;58;147;1260;2742;1318;2889
291130;201707;2921;8858;2404;7905;85;390;1797;5738;1882;6128
291140;201707;4288;12437;3605;11137;509;1456;2204;6934;2713;8390
291150;201707;2155;5171;1944;4930;54;167;1654;4127;1708;4294
291160;201707;5073;15748;4495;14736;557;2032;2756;8861;3313;10893
291165;201707;2494;6867;1930;5829;40;167;1352;3967;1392;4134
291170;201707;21358;55547;18297;50863;1343;4115;11441;31726;12784;35841
291180;201707;6153;15877;5043;14137;377;1136;3622;10128;3999;11264
291185;201707;3523;9649;3095;8923;129;406;2504;7124;2633;7530
291190;201707;7534;19667;6532;18249;521;1571;5066;14117;5587;15688
291200;201707;3013;8723;2328;7431;106;350;1498;4787;1604;5137
291210;201707;6719;16126;5722;14919;276;940;4290;11006;4566;11946
291220;201707;4313;12851;3913;12205;449;1606;2612;7998;3061;9604
291230;201707;4051;9882;3618;9403;90;166;3380;8895;3470;9061
291240;201707;4551;12039;3959;11007;123;404;3290;8988;3413;9392
291250;201707;3468;10467;2784;9192;207;676;1856;6219;2063;6895
291260;201707;1130;3091;996;2916;54;243;836;2344;890;2587
291270;201707;4782;14487;4177;13379;891;2974;2316;7526;3207;10500
291280;201707;2272;6370;1804;5559;267;880;987;3007;1254;3887
291290;201707;5754;15761;4917;14626;691;2076;3081;9352;3772;11428
291300;201707;4118;11652;3158;9989;152;542;2243;7018;2395;7560
291310;201707;5442;15258;4682;13885;231;774;3624;10667;3855;11441
291320;201707;6221;18705;4928;16146;1190;3841;2215;7519;3405;11360
291330;201707;1655;4726;1433;4343;94;305;1007;3013;1101;3318
291340;201707;4018;10841;3371;9898;107;398;2716;7891;2823;8289
291345;201707;3287;10255;3058;9960;189;672;2449;8056;2638;8728
291350;201707;5867;16756;5111;15500;261;785;4020;12407;4281;13192
291360;201707;34112;89342;28906;82288;5845;17001;15027;44213;20872;61214
291370;201707;8226;23090;7731;22449;554;1806;5829;16838;6383;18644
291380;201707;3656;10723;3172;9960;142;552;2399;7483;2541;8035
291390;201707;10838;27863;10025;26870;723;2090;8034;21517;8757;23607
291400;201707;14581;38895;12549;35866;2010;5325;7830;23570;9840;28895
291410;201707;3099;8203;2400;7036;101;448;1762;4952;1863;5400
291420;201707;2016;5271;1707;4887;63;230;1436;4082;1499;4312
291430;201707;3271;9147;2853;8537;128;610;2288;6587;2416;7197
291440;201707;6484;19222;5652;17780;479;1563;4307;13672;4786;15235
291450;201707;8539;23630;7343;22063;251;670;5961;18629;6212;19299
291460;201707;13407;39512;12035;37443;1313;4431;8044;25259;9357;29690
291465;201707;8060;22389;6973;21074;384;1607;5618;16642;6002;18249
291470;201707;15818;40867;13905;38622;813;2230;10458;29923;11271;32153
291480;201707;36803;88490;29839;79219;3955;11394;16589;44410;20544;55804
291490;201707;4372;13405;4080;13003;460;1494;3023;9763;3483;11257
291500;201707;4466;12148;3761;11116;138;538;3137;9203;3275;9741
291510;201707;3801;10916;3384;10312;94;417;2805;8562;2899;8979
291520;201707;3979;10397;3407;9615;278;828;2387;6770;2665;7598
291530;201707;2178;5701;1715;5021;359;981;916;2965;1275;3946
291535;201707;3537;10710;3247;10234;238;777;2404;7673;2642;8450
291540;201707;2127;5091;1742;4655;119;316;1475;3902;1594;4218
291550;201707;5234;13392;4519;12385;682;1758;2765;7781;3447;9539
291560;201707;19063;44092;13465;37483;948;2557;9148;26921;10096;29478
291570;201707;2197;5560;1963;5280;138;274;1619;4523;1757;4797
291580;201707;5569;16242;4873;15248;505;1861;3362;10422;3867;12283
291590;201707;1791;5449;1625;5184;148;529;1232;3957;1380;4486
291600;201707;5309;14266;4056;12250;797;2491;2015;6037;2812;8528
291610;201707;4864;14855;4700;14665;130;495;4307;13456;4437;13951
291620;201707;3125;7166;2285;6251;150;460;1732;4825;1882;5285
291630;201707;3239;7645;2589;6835;169;468;2032;5372;2201;5840
291640;201707;16538;44240;13061;38890;3100;9634;3917;12480;7017;22114
291650;201707;8555;24002;7790;23060;536;1359;6481;19532;7017;20891
291660;201707;2300;5714;1716;4807;146;518;1075;2813;1221;3331
291670;201707;1914;5219;1726;4957;134;363;1325;3875;1459;4238
291680;201707;3968;11111;3447;10229;477;1517;2267;6725;2744;8242
291685;201707;4952;12157;4055;10976;481;1167;2736;7733;3217;8900
291690;201707;3815;9893;3046;8632;158;447;2270;6369;2428;6816
291700;201707;9144;27532;8111;25692;764;2422;6009;19185;6773;21607
291710;201707;5249;13431;4191;11991;477;1436;2741;7720;3218;9156
291720;201707;4703;14715;3892;13039;299;1145;2651;8667;2950;9812
291730;201707;6348;17980;5703;17110;400;1385;4487;13521;4887;14906
291733;201707;2868;7778;2377;7095;146;457;1647;5081;1793;5538
291735;201707;3032;8106;2542;7393;107;371;2069;5954;2176;6325
291740;201707;3889;10523;3233;9605;164;543;2559;7579;2723;8122
291750;201707;21559;54562;17135;47798;2827;8163;9322;26537;12149;34700
291760;201707;10614;33229;9210;30747;3391;12570;2144;7251;5535;19821
291770;201707;7576;21478;6343;19252;722;2423;4152;12287;4874;14710
291780;201707;4600;13336;4200;12673;191;627;3491;10503;3682;11130
291790;201707;2685;7934;2538;7721;138;473;2055;6183;2193;6656
291800;201707;30304;80742;26218;75082;3459;10081;16520;48370;19979;58451
291810;201707;10879;28037;9163;25932;334;1138;7546;21208;7880;22346
291820;201707;3804;10827;3390;10209;177;602;2582;7798;2759;8400
291830;201707;4196;10803;3855;10302;345;932;2975;8032;3320;8964
291835;201707;6312;19494;5160;17337;1005;3448;2781;9652;3786;13100
291840;201707;48592;134325;42374;126910;5693;17192;28596;88372;34289;105564
291845;201707;2550;7412;2352;7138;130;376;1979;6085;2109;6461
291850;201707;4435;12646;3654;11373;352;990;2584;8332;2936;9322
291855;201707;1946;4441;1659;4085;114;327;1313;3186;1427;3513
291860;201707;2272;6166;1699;5046;54;196;1136;3226;1190;3422
291870;201707;1389;3667;966;2859;66;234;600;1697;666;1931
291875;201707;2886;8767;2549;8222;131;509;1818;5744;1949;6253
291880;201707;5085;15808;4650;14949;489;1577;3283;10586;3772;12163
291890;201707;1335;3238;1040;2862;236;523;636;1864;872;2387
291900;201707;1279;3324;979;2822;38;158;742;2083;780;2241
291905;201707;2813;7336;2131;6127;85;271;1551;4356;1636;4627
291910;201707;2879;7507;2444;6994;112;371;2047;5877;2159;6248
291915;201707;7066;21299;5929;19277;339;1266;4455;14552;4794;15818
291920;201707;25141;73353;23109;70492;2997;10188;14985;45126;17982;55314
291930;201707;2552;7455;2247;6944;201;764;1582;4728;1783;5492
291940;201707;3379;9356;2481;7793;265;865;1476;4508;1741;5373
291950;201707;8832;28358;7825;26416;1184;4023;4447;15471;5631;19494
291955;201707;11884;33033;11001;31943;2175;6082;6807;20828;8982;26910
291960;201707;3138;8832;2545;7927;173;573;1879;5996;2052;6569
291970;201707;4012;11857;3681;11303;322;1193;2534;7698;2856;8891
291980;201707;11680;32677;9104;28985;703;2284;6238;20188;6941;22472
291990;201707;2129;6253;1970;6057;73;277;1742;5389;1815;5666
291992;201707;3429;9267;2851;8477;367;1047;2148;6454;2515;7501
291995;201707;2161;5995;1787;5458;78;311;1424;4268;1502;4579
292000;201707;2425;6595;2131;6152;204;662;1433;4136;1637;4798
292010;201707;6270;15220;5160;13669;350;941;4010;10647;4360;11588
292020;201707;4212;13433;3890;12883;400;1429;2910;9570;3310;10999
292030;201707;1813;5788;1692;5597;157;588;991;3187;1148;3775
292040;201707;4418;11608;3748;10845;280;693;3002;9088;3282;9781
292045;201707;3605;10481;3139;9824;98;249;2830;8955;2928;9204
292050;201707;6479;19226;5408;17108;471;1608;3333;10461;3804;12069
292060;201707;12930;31115;11877;29817;733;1879;9912;24533;10645;26412
292070;201707;5229;15074;4783;14556;330;990;4026;12361;4356;13351
292080;201707;3451;8814;2807;7993;161;542;2366;6723;2527;7265
292090;201707;4082;9974;3386;9158;224;711;2722;7428;2946;8139
292100;201707;10693;28516;9315;26564;1897;5611;4648;13662;6545;19273
292105;201707;3079;9106;2756;8574;112;454;2228;6901;2340;7355
292110;201707;6464;16943;4936;14476;1273;3727;2164;6492;3437;10219
292120;201707;7142;19722;5887;17432;845;2476;3543;10629;4388;13105
292130;201707;2989;8076;2569;7488;304;877;1757;5235;2061;6112
292140;201707;4928;12708;4096;11482;372;986;3048;8650;3420;9636
292145;201707;2250;6855;1959;6345;179;552;1311;4348;1490;4900
292150;201707;13331;38644;12168;36893;437;1643;10042;30355;10479;31998
292160;201707;2398;6866;2166;6558;85;327;1916;5763;2001;6090
292170;201707;8738;24468;7289;21985;738;2332;4778;14464;5516;16796
292180;201707;3091;8628;2363;7390;472;1415;1163;3733;1635;5148
292190;201707;3209;8919;2723;8148;439;1399;1483;4491;1922;5890
292200;201707;7004;20505;5920;18673;1375;4481;2625;8492;4000;12973
292205;201707;3878;11301;3457;10677;135;638;2886;8690;3021;9328
292210;201707;6437;16276;5379;14861;179;629;4601;12540;4780;13169
292220;201707;1869;5029;1670;4727;251;673;1053;2997;1304;3670
292225;201707;3283;9944;2960;9441;118;519;2423;7615;2541;8134
292230;201707;7142;19184;6686;18501;247;1021;5458;14621;5705;15642
292240;201707;4898;14665;4303;13445;358;1136;2881;8991;3239;10127
292250;201707;5330;15487;4958;14878;764;2296;3017;9181;3781;11477
292260;201707;3247;9171;2978;8809;190;555;2474;7415;2664;7970
292265;201707;3246;9540;2771;8732;102;469;2141;6562;2243;7031
292270;201707;4056;10138;3375;9312;263;799;2703;7474;2966;8273
292273;201707;2558;5940;2154;5433;128;238;1676;4398;1804;4636
292275;201707;1754;5047;1514;4694;97;238;1209;3925;1306;4163
292280;201707;2404;6264;2020;5811;105;278;1612;4841;1717;5119
292285;201707;2486;6563;2051;5938;129;413;1570;4540;1699;4953
292290;201707;6462;19554;5667;18347;302;1208;4424;14265;4726;15473
292300;201707;8871;25356;7612;23722;1553;5008;4351;13909;5904;18917
292303;201707;2912;8610;2604;8157;87;314;2204;6859;2291;7173
292305;201707;2832;7576;2656;7317;55;227;2382;6475;2437;6702
292310;201707;6265;17703;5724;16945;276;838;4661;13809;4937;14647
292320;201707;6874;18464;5694;16431;369;1162;4304;12217;4673;13379
292330;201707;2333;5869;2132;5607;112;330;1768;4589;1880;4919
292335;201707;5231;13398;4673;12644;337;833;3774;10381;4111;11214
292340;201707;6707;17920;5674;16259;315;905;4229;12056;4544;12961
292350;201707;2308;6629;1977;6164;87;334;1623;5061;1710;5395
292360;201707;5330;13758;4820;12928;383;1152;3529;9477;3912;10629
292370;201707;9115;23841;7956;22337;363;987;6764;18986;7127;19973
292380;201707;7330;21046;6655;19941;578;1686;4963;14955;5541;16641
292390;201707;3994;8331;3048;7309;138;248;2682;6543;2820;6791
292400;201707;21105;63948;19257;60837;2704;8804;12444;39488;15148;48292
292405;201707;4593;11252;3761;10155;210;516;3023;8220;3233;8736
292410;201707;2084;5372;1866;5114;101;270;1562;4298;1663;4568
292420;201707;3786;11843;3554;11485;211;928;2912;9295;3123;10223
292430;201707;5490;15874;4109;13895;352;1324;2644;9006;2996;10330
292440;201707;8604;27723;7975;26823;165;742;7248;24513;7413;25255
292450;201707;4042;11908;3268;10542;215;772;2398;7791;2613;8563
292460;201707;4653;13746;4021;12624;386;1262;2835;8922;3221;10184
292465;201707;2443;6987;2039;6348;133;438;1395;4437;1528;4875
292467;201707;1780;5567;1703;5448;238;765;1183;3882;1421;4647
292470;201707;2992;7701;2447;6828;96;272;1902;5297;1998;5569
292480;201707;6468;16183;5357;14764;123;432;4718;12849;4841;13281
292490;201707;2413;6386;1971;5751;136;414;1462;4285;1598;4699
292500;201707;6514;18782;5577;17112;680;2069;3619;11270;4299;13339
292510;201707;12781;36087;10824;33093;764;2915;7857;23944;8621;26859
292520;201707;6487;17198;5635;15911;1012;2873;3403;9808;4415;12681
292525;201707;5446;13946;4632;13001;214;569;3929;11163;4143;11732
292530;201707;27736;77829;24245;72693;5815;17684;11030;34327;16845;52011
292540;201707;3218;7992;2803;7507;281;713;2218;6042;2499;6755
292550;201707;6916;20491;5835;19095;483;1800;4472;14899;4955;16699
292560;201707;4148;11306;3649;10545;164;665;2879;8182;3043;8847
292570;201707;4296;11602;3806;10987;85;286;3482;10115;3567;10401
292575;201707;6584;20712;6320;20340;313;1052;5319;17186;5632;18238
292580;201707;7032;19748;6363;18773;311;994;5367;15831;5678;16825
292590;201707;7699;21165;7057;20251;338;1138;5953;16721;6291;17859
292593;201707;2992;7568;2543;6852;218;562;1908;5093;2126;5655
292595;201707;5823;15689;5129;14788;270;910;4103;11729;4373;12639
292600;201707;11050;30759;9790;29049;720;1864;7400;22386;8120;24250
292610;201707;4823;12819;3943;11375;224;609;2600;7740;2824;8349
292620;201707;6377;18417;5586;17523;119;347;5179;16479;5298;16826
292630;201707;9094;22975;7526;20487;523;1487;5251;14364;5774;15851
292640;201707;7883;24721;7259;23686;325;1272;5393;17644;5718;18916
292650;201707;4546;12072;4200;11615;256;722;3598;9903;3854;10625
292660;201707;11182;32325;10060;30666;774;2532;7673;23493;8447;26025
292665;201707;2280;7057;2121;6854;28;118;1898;6188;1926;6306
292670;201707;3668;10182;2870;8726;183;656;1854;5562;2037;6218
292680;201707;3834;10805;3329;9895;261;774;2405;7040;2666;7814
292690;201707;2757;7449;1989;6190;158;473;1296;4173;1454;4646
292700;201707;9805;27681;8494;25816;1057;3027;5514;17527;6571;20554
292710;201707;2265;7344;2109;7136;69;266;1883;6397;1952;6663
292720;201707;9548;23427;8209;21952;303;972;6919;18683;7222;19655
292730;201707;3772;10678;3614;10457;159;477;3040;8792;3199;9269
292740;201707;340568;891888;317111;855637;56622;161018;184915;492392;241537;653410
292750;201707;6595;17625;5622;16200;275;877;4293;12404;4568;13281
292760;201707;3966;11913;3580;11223;314;1057;2555;7959;2869;9016
292770;201707;6150;17486;5316;16237;940;3011;3087;9745;4027;12756
292780;201707;1849;4149;1431;3623;80;239;1075;2644;1155;2883
292790;201707;3665;8337;3346;7980;47;103;3213;7691;3260;7794
292800;201707;9668;27066;8815;25686;493;1521;6998;20279;7491;21800
292805;201707;3065;8279;2653;7686;253;704;1944;5706;2197;6410
292810;201707;9792;27816;7912;25053;585;2017;5630;17982;6215;19999
292820;201707;7725;21180;5684;18203;404;1604;4198;13263;4602;14867
292830;201707;2282;5864;2041;5552;64;287;1851;4926;1915;5213
292840;201707;8299;24057;7770;23339;237;1044;6799;19911;7036;20955
292850;201707;3100;8125;2473;7160;205;696;1599;4494;1804;5190
292860;201707;15729;38947;14347;37159;1018;2605;11246;29197;12264;31802
292870;201707;18915;50654;16533;46946;1464;4782;10256;28577;11720;33359
292880;201707;12216;34213;10935;32412;631;2480;8016;22895;8647;25375
292890;201707;5619;17936;5040;16941;535;1937;3543;11900;4078;13837
292895;201707;2951;6835;2175;5662;144;371;1558;4074;1702;4445
292900;201707;2777;8229;2624;7980;130;596;2021;5875;2151;6471
292905;201707;4262;12056;3393;10682;283;859;2279;7310;2562;8169
292910;201707;5044;14581;4568;13729;466;1507;2953;8846;3419;10353
292920;201707;9957;28084;9489;27469;413;1561;8130;23051;8543;24612
292925;201707;5176;15229;4696;14493;279;876;3630;11186;3909;12062
292930;201707;6591;20553;6086;19586;439;1901;4103;12813;4542;14714
292935;201707;2027;5844;1680;5456;68;284;1428;4739;1496;5023
292937;201707;3144;7917;2728;7406;99;289;2306;6274;2405;6563
292940;201707;3149;8507;2592;7700;185;559;1894;5741;2079;6300
292950;201707;8806;24678;8076;23482;428;1541;6062;17246;6490;18787
292960;201707;5488;13451;4680;12386;203;651;3621;9427;3824;10078
292970;201707;4291;12378;3756;11661;149;634;3055;9466;3204;10100
292975;201707;3909;9492;3560;9077;222;492;3112;7991;3334;8483
292980;201707;3247;8402;2583;7384;158;499;1931;5431;2089;5930
292990;201707;11915;33006;10185;30345;468;1600;8044;23964;8512;25564
293000;201707;2869;7089;2601;6765;31;103;1973;5449;2004;5552
293010;201707;17918;48590;15133;44080;2084;6357;9103;26480;11187;32837
293015;201707;7522;24926;6374;22669;698;2879;4141;14601;4839;17480
293020;201707;9034;29175;8578;28533;254;1153;7540;24888;7794;26041
293030;201707;5633;15725;4447;13827;210;689;2994;9638;3204;10327
293040;201707;3783;11796;3570;11459;158;591;3076;9813;3234;10404
293050;201707;21371;56200;18863;52861;2513;7216;11367;32919;13880;40135
293060;201707;3609;9568;2974;8521;223;718;2134;6021;2357;6739
293070;201707;24914;65165;20488;58993;4417;12654;9778;29835;14195;42489
293075;201707;3300;11004;3048;10586;195;895;2382;8266;2577;9161
293076;201707;3706;9843;3270;9264;139;373;2614;7545;2753;7918
293077;201707;5284;15559;4524;14499;647;2113;2840;9392;3487;11505
293080;201707;4734;14425;4245;13653;171;739;3451;10903;3622;11642
293090;201707;3169;9892;2605;8976;229;856;1764;6165;1993;7021
293100;201707;5950;16851;4912;15001;418;1295;3582;11017;4000;12312
293105;201707;3931;12687;3427;11717;358;1284;2281;7813;2639;9097
293110;201707;2118;5685;1834;5292;82;244;1468;4239;1550;4483
293120;201707;3920;12053;3719;11741;188;598;3085;9775;3273;10373
293130;201707;3805;11000;3442;10557;117;460;2985;9149;3102;9609
293135;201707;31876;79034;24165;67998;4957;15670;9365;26723;14322;42393
293140;201707;2054;5397;1923;5222;93;297;1585;4189;1678;4486
293150;201707;5542;17579;4680;15905;585;2053;2989;10272;3574;12325
293160;201707;3851;9680;3437;9186;386;714;2679;7665;3065;8379
293170;201707;3588;9831;3217;9305;193;663;2392;6934;2585;7597
293180;201707;5122;14089;4171;12507;159;665;3256;9473;3415;10138
293190;201707;14110;40770;12655;38586;484;2170;10526;31557;11010;33727
293200;201707;7757;20226;6663;18804;232;860;5063;14330;5295;15190
293210;201707;5254;14504;4562;13370;275;874;3430;9994;3705;10868
293220;201707;5066;14500;4180;12885;1053;3245;1550;5018;2603;8263
293230;201707;3659;10844;3229;10146;450;1524;2103;6613;2553;8137
293240;201707;4345;11930;3512;10511;124;401;2640;7963;2764;8364
293245;201707;4311;11757;3827;11090;200;651;3120;8986;3320;9637
293250;201707;5668;14832;5057;13897;430;1219;3725;10178;4155;11397
293260;201707;4591;13149;3794;11935;207;719;2656;8263;2863;8982
293270;201707;5970;15223;5257;14432;411;1020;4368;12283;4779;13303
293280;201707;5265;14241;4437;13115;234;692;3364;10015;3598;10707
293290;201707;14162;45901;13094;43919;3294;11205;5715;20143;9009;31348
293300;201707;6729;15823;5695;14558;374;876;4211;10985;4585;11861
293305;201707;4809;11818;4047;10810;123;412;3368;8954;3491;9366
293310;201707;2377;6168;1895;5335;163;475;1288;3575;1451;4050
293315;201707;4321;10671;3605;9597;214;512;2838;7569;3052;8081
293317;201707;2448;6722;2199;6279;174;486;1551;4454;1725;4940
293320;201707;7877;24603;7574;24228;1062;3351;5680;18530;6742;21881
293325;201707;1746;4868;1448;4379;228;738;894;2676;1122;3414
293330;201707;48755;156890;44089;148320;9977;35196;19784;67563;29761;102759
293340;201707;2562;7287;2057;6400;221;737;1238;3841;1459;4578
293345;201707;3292;9542;2888;9023;272;628;2106;7044;2378;7672
293350;201707;6557;19067;6172;18615;143;338;5661;17512;5804;17850
293360;201707;13909;39642;12513;37919;679;2253;10857;32949;11536;35202
310010;201707;803;2182;662;1970;81;304;303;841;384;1145
310020;201707;2538;7880;2130;7127;531;1974;273;868;804;2842
310030;201707;2184;6659;1815;6025;332;1268;1033;3324;1365;4592
310040;201707;999;2610;813;2343;70;262;607;1678;677;1940
310050;201707;1794;6003;1667;5737;321;1268;753;2466;1074;3734
310060;201707;3387;9898;2936;9309;201;811;2333;7342;2534;8153
310070;201707;363;970;269;797;10;40;173;479;183;519
310080;201707;765;2201;584;1870;83;326;234;716;317;1042
310090;201707;4783;13639;4065;12424;514;1694;2668;8145;3182;9839
310100;201707;3568;10417;2986;9482;164;635;2264;7133;2428;7768
310110;201707;5037;13900;4184;12396;691;2325;2126;6047;2817;8372
310120;201707;656;1908;491;1601;107;425;189;498;296;923
310130;201707;379;1128;332;1041;64;243;177;489;241;732
310140;201707;175;584;148;541;47;203;46;141;93;344
310150;201707;4682;13983;3946;12541;929;3176;1260;3907;2189;7083
310160;201707;6850;21294;5707;19093;1767;6355;957;3184;2724;9539
310163;201707;1098;3453;927;3109;313;1130;237;750;550;1880
310170;201707;9137;24861;8041;23290;901;2761;5599;16301;6500;19062
310180;201707;1760;4856;1470;4420;183;662;904;2610;1087;3272
310190;201707;2957;9463;2590;8795;709;2630;319;1036;1028;3666
310200;201707;1739;5595;1447;4964;276;1039;533;1773;809;2812
310205;201707;1144;3227;867;2806;118;363;482;1615;600;1978
310210;201707;2818;7697;2395;7085;160;532;1728;5038;1888;5570
310220;201707;1048;3050;900;2803;132;479;562;1671;694;2150
310230;201707;2507;7469;2103;6574;282;1063;1180;3454;1462;4517
310240;201707;907;3229;831;3079;105;472;509;1843;614;2315
310250;201707;895;2789;814;2638;142;563;464;1392;606;1955
310260;201707;3055;9496;2247;7852;526;2092;338;954;864;3046
310270;201707;2665;7158;2138;6420;153;589;1651;4854;1804;5443
310280;201707;2332;5892;1849;5166;157;602;1165;3108;1322;3710
310285;201707;1969;6838;1818;6588;188;772;1221;4529;1409;5301
310290;201707;1128;3296;1045;3152;236;839;554;1501;790;2340
310300;201707;1656;5445;1568;5285;359;1395;763;2423;1122;3818
310310;201707;332;880;233;701;38;110;118;359;156;469
310320;201707;401;1189;314;1031;33;138;155;462;188;600
310330;201707;531;1303;341;943;43;129;127;305;170;434
310340;201707;8276;23892;6730;21201;1383;4317;3044;10042;4427;14359
310350;201707;13990;36159;9787;29180;2536;8246;2323;6770;4859;15016
310360;201707;461;1259;412;1192;20;71;322;912;342;983
310370;201707;1390;4571;1210;4227;263;957;510;1791;773;2748
310375;201707;1242;3350;827;2624;128;442;274;859;402;1301
310380;201707;372;953;213;652;57;179;64;175;121;354
310390;201707;461;1542;395;1411;100;374;85;250;185;624
310400;201707;9892;26936;7501;22912;1659;5577;2517;7507;4176;13084
310410;201707;720;2307;511;1942;125;521;89;323;214;844
310420;201707;4540;12590;3084;9595;614;2117;523;1405;1137;3522
310430;201707;1288;4060;931;3320;239;905;129;427;368;1332
310440;201707;543;1559;404;1280;64;241;185;577;249;818
310445;201707;1332;4099;1038;3549;67;260;711;2416;778;2676
310450;201707;4584;12353;3600;10874;303;974;2591;7892;2894;8866
310460;201707;1775;5043;1339;4263;319;1135;352;1116;671;2251
310470;201707;4184;9247;3486;8372;289;851;2863;6757;3152;7608
310480;201707;1276;3593;939;2943;191;634;423;1265;614;1899
310490;201707;3025;9403;2545;8473;511;1985;1035;3285;1546;5270
310500;201707;1330;4330;1131;3914;262;985;443;1491;705;2476
310510;201707;1956;6099;1532;5172;393;1441;298;992;691;2433
310520;201707;1417;3574;1054;3012;78;220;705;2000;783;2220
310530;201707;937;2733;497;1652;79;291;54;140;133;431
310540;201707;3121;9618;2682;8828;707;2468;1006;3172;1713;5640
310550;201707;1176;3220;933;2834;144;554;561;1590;705;2144
310560;201707;14664;43361;12250;38942;3083;10877;3789;11220;6872;22097
310570;201707;1191;3454;1003;3133;134;531;669;1994;803;2525
310590;201707;4373;12478;3647;11191;501;1691;1928;5790;2429;7481
310600;201707;1486;4696;1252;4174;230;833;530;1656;760;2489
310610;201707;484;1482;385;1301;85;360;153;461;238;821
310620;201707;148788;440178;125792;396076;30057;105882;41975;118476;72032;224358
310630;201707;4509;13098;3983;12175;362;1251;2848;8587;3210;9838
310640;201707;1260;3836;1028;3431;277;1035;290;921;567;1956
310650;201707;2716;8186;2072;7032;268;972;1107;3711;1375;4683
310660;201707;1357;3951;1184;3731;93;311;895;2807;988;3118
310665;201707;1325;3802;1158;3562;75;256;904;2821;979;3077
310670;201707;41662;124010;36730;114050;8068;26748;15614;46883;23682;73631
310680;201707;677;1834;595;1717;60;194;427;1202;487;1396
310690;201707;1433;4424;1164;3954;182;737;557;1795;739;2532
310700;201707;557;1330;428;1167;62;200;262;688;324;888
310710;201707;6271;19749;4731;17339;1058;4548;507;1703;1565;6251
310720;201707;827;2379;748;2265;69;248;527;1573;596;1821
310730;201707;9313;27865;8258;26102;1123;4000;4887;15196;6010;19196
310740;201707;5221;16058;3967;13455;847;3052;874;2873;1721;5925
310750;201707;1490;3678;1090;3134;215;668;416;1097;631;1765
310760;201707;580;1705;469;1514;64;228;206;688;270;916
310770;201707;1007;3030;732;2581;105;424;361;1213;466;1637
310780;201707;3959;10499;3248;9307;305;902;2174;6171;2479;7073
310790;201707;1957;6233;1787;5922;382;1282;813;2819;1195;4101
310800;201707;2653;8352;2024;7087;553;2255;137;443;690;2698
310810;201707;1170;3200;1009;2912;130;423;582;1591;712;2014
310820;201707;1261;3549;875;2796;198;693;228;708;426;1401
310825;201707;2945;9987;2389;9035;116;663;1810;6747;1926;7410
310830;201707;1385;4385;1129;3904;282;1043;381;1291;663;2334
310840;201707;2196;6371;1587;5253;313;1096;381;1186;694;2282
310850;201707;1568;4478;1350;4200;112;453;994;3020;1106;3473
310855;201707;3088;9099;2613;8416;339;1233;1767;5643;2106;6876
310860;201707;7271;21856;6048;19542;611;2133;3632;11821;4243;13954
310870;201707;1095;2827;833;2406;189;575;443;1279;632;1854
310880;201707;1014;3103;823;2727;104;396;471;1537;575;1933
310890;201707;2588;7526;1944;6446;493;1842;346;998;839;2840
310900;201707;4320;13200;3388;11331;680;2564;1330;4132;2010;6696
310910;201707;1921;5355;1213;3967;172;631;127;335;299;966
310920;201707;1899;5385;1494;4722;277;973;727;2258;1004;3231
310925;201707;974;3037;859;2835;202;742;461;1465;663;2207
310930;201707;6076;16738;4755;14704;771;2534;2567;8133;3338;10667
310940;201707;6250;16910;5153;15240;609;1950;3203;9354;3812;11304
310945;201707;1242;3688;1127;3508;95;344;759;2306;854;2650
310950;201707;2127;6495;1536;5237;334;1318;498;1570;832;2888
310960;201707;472;1354;370;1171;78;277;131;422;209;699
310970;201707;1235;3959;926;3302;226;861;203;664;429;1525
310980;201707;402;962;251;702;34;110;139;369;173;479
310990;201707;1210;3755;962;3220;208;740;325;1045;533;1785
311000;201707;3586;11701;3243;11038;951;3535;1152;3717;2103;7252
311010;201707;754;2449;670;2243;237;861;230;748;467;1609
311020;201707;974;2772;749;2365;113;428;354;1049;467;1477
311030;201707;1729;4669;1198;3714;320;1150;348;969;668;2119
311040;201707;439;1436;362;1252;85;300;75;235;160;535
311050;201707;2403;7075;2040;6489;497;1749;769;2391;1266;4140
311060;201707;2675;7679;1951;6128;304;1103;658;1867;962;2970
311070;201707;1471;4688;1242;4270;241;962;541;1763;782;2725
311080;201707;840;2460;707;2209;138;490;307;876;445;1366
311090;201707;1913;6572;1580;5974;423;1818;516;1888;939;3706
311100;201707;2007;6558;1548;5555;454;1809;199;663;653;2472
311110;201707;3549;8290;2493;6774;525;1516;1070;2924;1595;4440
311115;201707;1247;3559;1053;3264;88;343;754;2298;842;2641
311120;201707;7505;20791;5734;17600;1117;3817;1668;4617;2785;8434
311130;201707;2082;6196;1720;5628;261;1053;756;2328;1017;3381
311140;201707;1378;3535;1044;3068;82;269;666;1977;748;2246
311150;201707;1653;5688;1498;5397;251;989;880;3147;1131;4136
311160;201707;3931;12734;3106;11181;1032;4043;668;2377;1700;6420
311170;201707;803;2357;634;2050;57;215;335;1098;392;1313
311180;201707;1157;3272;889;2783;273;907;242;750;515;1657
311190;201707;1119;3148;859;2664;155;553;269;777;424;1330
311200;201707;1844;5476;1428;4618;406;1429;254;749;660;2178
311205;201707;989;3207;844;2925;93;409;425;1457;518;1866
311210;201707;1017;3124;918;2995;137;414;644;2172;781;2586
311220;201707;836;2573;689;2262;156;565;244;747;400;1312
311230;201707;8413;26338;6498;22294;1342;4886;1970;7019;3312;11905
311240;201707;1003;2958;791;2627;180;660;344;1107;524;1767
311250;201707;789;2499;693;2334;190;701;259;807;449;1508
311260;201707;2186;5834;1692;5012;389;1264;584;1657;973;2921
311265;201707;1239;3408;970;2963;108;369;594;1787;702;2156
311270;201707;3383;10451;2981;9889;267;1210;2045;6467;2312;7677
311280;201707;1194;3349;704;2248;133;486;157;474;290;960
311290;201707;2017;6516;1885;6210;257;823;1205;4026;1462;4849
311300;201707;4503;14119;4003;13233;304;1382;2991;9648;3295;11030
311310;201707;629;1984;539;1811;115;396;159;498;274;894
311320;201707;3498;11421;3150;10644;548;2136;1220;3804;1768;5940
311330;201707;4556;13239;3963;12212;722;2441;1974;6078;2696;8519
311340;201707;11768;36317;9990;32907;2977;10405;2489;8307;5466;18712
311350;201707;2318;6286;1773;5266;232;802;861;2336;1093;3138
311360;201707;916;2693;793;2526;391;1298;113;381;504;1679
311370;201707;4000;11428;3277;10151;417;1575;1644;4737;2061;6312
311380;201707;454;1464;368;1288;111;406;108;392;219;798
311390;201707;1808;6256;1596;5941;680;2873;420;1402;1100;4275
311400;201707;1478;4515;1159;3875;203;801;449;1329;652;2130
311410;201707;1716;5805;1560;5601;378;1537;745;2669;1123;4206
311420;201707;1894;6061;1298;4648;226;880;136;377;362;1257
311430;201707;3621;10577;2505;8218;441;1558;446;1442;887;3000
311440;201707;2456;7738;1827;6552;548;2210;342;1242;890;3452
311450;201707;2000;6614;1578;5764;411;1659;275;882;686;2541
311455;201707;1055;2784;817;2385;225;679;286;814;511;1493
311460;201707;603;1915;441;1602;91;402;107;353;198;755
311470;201707;465;1545;372;1345;97;400;61;199;158;599
311480;201707;821;2128;742;2007;126;340;446;1172;572;1512
311490;201707;213;767;187;688;54;221;64;208;118;429
311500;201707;437;1254;348;1098;55;201;173;549;228;750
311510;201707;2827;8388;2124;7090;576;2223;427;1348;1003;3571
311520;201707;603;1895;562;1810;162;576;245;743;407;1319
311530;201707;10643;27002;7686;22265;1898;6394;1888;5185;3786;11579
311535;201707;774;2216;514;1718;116;469;106;323;222;792
311540;201707;601;2026;559;1956;148;534;267;923;415;1457
311545;201707;2188;6361;1936;6052;151;595;1435;4386;1586;4981
311547;201707;1520;4136;1293;3786;69;241;954;2760;1023;3001
311550;201707;2969;8960;2407;7864;386;1474;884;2788;1270;4262
311560;201707;259;669;218;615;31;96;122;316;153;412
311570;201707;2003;5023;1530;4371;65;193;1198;3543;1263;3736
311580;201707;2480;4816;1776;4006;286;563;1087;2641;1373;3204
311590;201707;503;1485;424;1365;99;374;187;584;286;958
311600;201707;1285;3746;1067;3454;151;485;714;2367;865;2852
311610;201707;2727;9369;2414;8754;664;2331;939;3568;1603;5899
311615;201707;3209;9730;2648;8829;241;967;1881;6189;2122;7156
311620;201707;426;1254;373;1169;42;152;255;793;297;945
311630;201707;1370;3932;1132;3503;94;329;792;2389;886;2718
311640;201707;804;2531;651;2270;123;468;299;1048;422;1516
311650;201707;2234;6157;1901;5642;199;708;1172;3390;1371;4098
311660;201707;2836;8815;2179;7479;431;1554;362;1119;793;2673
311670;201707;1647;4576;1338;4093;295;1003;515;1583;810;2586
311680;201707;2118;6541;1753;5843;314;1105;1014;3371;1328;4476
311690;201707;551;1337;464;1225;31;90;360;962;391;1052
311700;201707;2323;5877;1803;5197;81;276;1392;3932;1473;4208
311710;201707;1642;4984;1193;4085;367;1380;325;1125;692;2505
311720;201707;407;1333;359;1249;55;218;174;581;229;799
311730;201707;6043;14768;3470;10366;1060;3593;523;1277;1583;4870
311740;201707;797;2423;762;2375;94;265;614;1962;708;2227
311750;201707;4130;12926;3488;11853;506;2000;1953;6393;2459;8393
311760;201707;688;2235;599;2027;127;498;164;450;291;948
311770;201707;2176;6751;1759;5952;398;1478;547;1769;945;3247
311780;201707;1292;4290;1031;3710;254;1062;227;688;481;1750
311783;201707;2081;6484;1742;5836;63;298;1343;4433;1406;4731
311787;201707;632;2096;480;1678;84;323;143;421;227;744
311790;201707;1585;4577;1206;3884;257;940;410;1278;667;2218
311800;201707;5076;16734;4428;15170;813;3076;535;1704;1348;4780
311810;201707;1039;3358;878;3031;71;288;512;1746;583;2034
311820;201707;656;1952;549;1707;104;387;313;877;417;1264
311830;201707;8181;26093;6313;21728;1747;6539;591;1934;2338;8473
311840;201707;2896;8556;2621;8128;488;1723;1592;4852;2080;6575
311850;201707;304;908;264;837;42;138;152;481;194;619
311860;201707;51653;147323;43919;134013;7487;24740;23420;69906;30907;94646
311870;201707;2143;6178;1543;4986;275;1020;506;1476;781;2496
311880;201707;6728;18659;5905;17564;618;1764;4231;12915;4849;14679
311890;201707;1442;4147;1180;3668;230;774;568;1728;798;2502
311900;201707;717;2090;602;1898;82;293;363;1134;445;1427
311910;201707;4140;11876;3449;10875;725;2426;1607;5095;2332;7521
311920;201707;1961;6129;1666;5620;192;745;974;3238;1166;3983
311930;201707;3476;9538;2872;8573;1137;3632;758;2127;1895;5759
311940;201707;13124;38293;10540;33134;1981;6848;3687;10963;5668;17811
311950;201707;2235;6436;1763;5651;133;540;1245;3934;1378;4474
311960;201707;404;1216;362;1130;59;244;178;470;237;714
311970;201707;411;1359;289;1065;56;239;58;195;114;434
311980;201707;551;1562;359;1189;64;234;111;365;175;599
311990;201707;482;1289;364;1118;113;388;142;422;255;810
311995;201707;1158;3482;686;2346;41;160;53;125;94;285
312000;201707;606;1752;538;1646;45;142;370;1154;415;1296
312010;201707;892;2862;730;2478;94;350;339;1114;433;1464
312015;201707;1351;4243;1223;4013;127;506;808;2577;935;3083
312020;201707;1130;3571;989;3327;197;724;440;1432;637;2156
312030;201707;1913;5180;1698;4919;54;235;1522;4361;1576;4596
312040;201707;769;2660;626;2314;123;516;179;629;302;1145
312050;201707;1180;4131;1016;3739;283;1169;202;664;485;1833
312060;201707;743;2267;662;2125;136;473;343;1068;479;1541
312070;201707;1022;3063;679;2322;112;439;292;969;404;1408
312080;201707;2744;7260;2144;6351;239;873;1238;3381;1477;4254
312083;201707;959;2622;801;2383;98;318;575;1684;673;2002
312087;201707;2187;6287;1940;5939;150;476;1485;4641;1635;5117
312090;201707;9132;27019;7487;24234;1890;6472;2884;9219;4774;15691
312100;201707;1486;4675;1145;4100;167;724;518;1780;685;2504
312110;201707;1004;3459;863;3152;263;1074;182;586;445;1660
312120;201707;695;2160;563;1907;128;499;188;547;316;1046
312125;201707;1252;3834;1109;3592;237;717;666;2262;903;2979
312130;201707;887;2438;692;2065;90;301;264;736;354;1037
312140;201707;794;2514;678;2243;180;633;206;623;386;1256
312150;201707;463;1359;392;1193;23;96;249;705;272;801
312160;201707;7602;24462;6516;22170;1333;5011;2573;8343;3906;13354
312170;201707;884;2522;731;2267;60;225;473;1418;533;1643
312180;201707;1385;4148;1191;3757;182;652;544;1621;726;2273
312190;201707;605;1902;457;1597;134;519;68;236;202;755
312200;201707;4889;13690;4072;12383;719;2244;2412;7389;3131;9633
312210;201707;1172;3011;879;2600;132;459;545;1521;677;1980
312220;201707;2016;6563;1855;6371;121;316;1565;5610;1686;5926
312230;201707;11742;35255;8942;29812;2833;10338;1131;3567;3964;13905
312235;201707;1610;4642;1409;4364;149;544;1005;3055;1154;3599
312240;201707;890;2967;710;2576;175;705;172;600;347;1305
312245;201707;2373;6613;2094;6238;98;359;1714;5071;1812;5430
312247;201707;839;2382;638;2044;164;543;264;891;428;1434
312250;201707;1172;3148;836;2558;170;588;313;895;483;1483
312260;201707;973;2902;788;2591;95;362;505;1593;600;1955
312270;201707;656;1941;539;1699;40;174;279;801;319;975
312280;201707;428;1390;370;1263;127;455;41;132;168;587
312290;201707;781;2536;709;2416;150;569;235;792;385;1361
312300;201707;916;2938;713;2441;181;678;73;176;254;854
312310;201707;804;2903;747;2771;162;669;339;1235;501;1904
312320;201707;2000;5573;1551;4740;427;1397;328;937;755;2334
312330;201707;1024;2932;835;2658;126;465;563;1746;689;2211
312340;201707;305;818;239;714;42;146;116;322;158;468
312350;201707;293;715;255;674;26;91;197;500;223;591
312352;201707;1616;4933;1438;4676;212;725;959;3247;1171;3972
312360;201707;2987;9380;2443;8222;546;1985;637;2093;1183;4078
312370;201707;1790;5365;1564;4970;387;1368;660;1997;1047;3365
312380;201707;2120;5313;1875;4998;59;163;1603;4361;1662;4524
312385;201707;1327;3763;1129;3446;101;352;767;2272;868;2624
312390;201707;2127;6617;1671;5726;401;1460;388;1241;789;2701
312400;201707;2923;9262;2426;8264;904;3169;575;2020;1479;5189
312410;201707;10419;32815;9222;30593;1860;6626;4166;13592;6026;20218
312420;201707;3902;11737;3625;11282;596;1962;2173;6805;2769;8767
312430;201707;8223;23231;6934;20957;919;2988;4230;12719;5149;15707
312440;201707;844;2644;699;2379;264;984;194;661;458;1645
312450;201707;1229;3960;961;3417;287;1077;327;1214;614;2291
312460;201707;361;1043;305;970;55;197;173;558;228;755
312470;201707;616;1660;405;1270;74;281;119;332;193;613
312480;201707;1206;3050;885;2680;140;496;514;1481;654;1977
312490;201707;1978;5087;1524;4371;252;777;815;2246;1067;3023
312500;201707;749;2086;636;1916;90;319;327;955;417;1274
312510;201707;3877;11138;3125;9596;393;1374;1586;4607;1979;5981
312520;201707;236;725;189;650;64;230;72;250;136;480
312530;201707;594;1694;524;1598;41;156;394;1200;435;1356
312540;201707;1431;4388;1024;3503;216;798;436;1473;652;2271
312550;201707;780;2255;621;1901;90;304;319;906;409;1210
312560;201707;2136;5459;1755;4967;96;361;1414;3952;1510;4313
312570;201707;2312;6615;1914;5977;533;1753;698;2194;1231;3947
312580;201707;538;1711;442;1491;61;240;168;552;229;792
312590;201707;1682;5306;1417;4769;199;843;681;2129;880;2972
312595;201707;1864;6126;1721;5806;326;1103;949;3265;1275;4368
312600;201707;840;2536;609;2132;109;476;271;899;380;1375
312610;201707;6691;18342;4830;14964;1094;3698;1007;2919;2101;6617
312620;201707;2248;6331;1728;5589;94;356;1296;4290;1390;4646
312630;201707;316;1017;270;930;66;266;96;324;162;590
312640;201707;530;1658;430;1445;76;260;128;404;204;664
312650;201707;2173;6027;1552;4793;152;541;926;2725;1078;3266
312660;201707;1429;3645;1122;3194;136;451;714;1983;850;2434
312670;201707;5494;15666;4636;14482;781;2877;2449;7386;3230;10263
312675;201707;1305;3948;1096;3522;107;407;779;2466;886;2873
312680;201707;1440;4223;1242;3946;140;559;829;2575;969;3134
312690;201707;2218;5696;1763;5070;208;642;1176;3306;1384;3948
312695;201707;870;2862;811;2763;133;434;539;1888;672;2322
312700;201707;1890;5584;1475;4760;184;639;799;2531;983;3170
312705;201707;1294;3590;1066;3188;55;195;768;2245;823;2440
312707;201707;1488;4673;1167;4033;124;550;641;2091;765;2641
312710;201707;6676;16400;4321;12738;1329;4371;797;2357;2126;6728
312720;201707;790;2588;682;2356;94;374;328;1072;422;1446
312730;201707;1887;4519;1346;3851;116;381;840;2382;956;2763
312733;201707;1567;4199;1196;3525;53;155;745;2159;798;2314
312735;201707;808;2188;701;2017;118;432;431;1120;549;1552
312737;201707;827;2053;598;1716;141;418;252;714;393;1132
312738;201707;521;1570;368;1263;85;338;131;418;216;756
312740;201707;333;819;198;651;65;221;43;123;108;344
312750;201707;1240;4224;1140;4067;193;803;567;1938;760;2741
312760;201707;1963;6110;1484;5129;323;1184;417;1416;740;2600
312770;201707;42325;112546;30793;92809;7567;24520;8554;25048;16121;49568
312780;201707;2724;8996;2411;8461;361;1406;1362;4795;1723;6201
312790;201707;341;859;211;658;27;95;83;239;110;334
312800;201707;5061;15980;4034;13832;1175;4349;944;3242;2119;7591
312810;201707;2036;6098;1414;4835;356;1323;300;930;656;2253
312820;201707;1938;5407;1623;4860;85;310;1091;3167;1176;3477
312825;201707;1328;3461;1168;3255;66;202;933;2607;999;2809
312830;201707;2589;7797;1793;6214;458;1722;305;1017;763;2739
312840;201707;1231;3843;971;3329;158;636;309;940;467;1576
312850;201707;762;2224;597;1921;105;381;228;720;333;1101
312860;201707;1436;3814;947;2984;224;769;269;796;493;1565
312870;201707;5716;17241;3880;13234;645;2383;919;2948;1564;5331
312880;201707;1364;3858;1205;3623;85;273;758;2368;843;2641
312890;201707;1920;5585;1231;4104;226;790;444;1498;670;2288
312900;201707;1216;3487;1039;3234;104;340;676;2155;780;2495
312910;201707;1697;3313;1001;2412;154;427;484;1079;638;1506
312920;201707;919;2782;723;2432;153;615;323;1019;476;1634
312930;201707;2150;5973;1810;5457;420;1326;807;2403;1227;3729
312940;201707;901;2823;777;2599;177;629;305;1028;482;1657
312950;201707;2993;8242;2266;7139;775;2647;535;1699;1310;4346
312960;201707;1940;5398;1681;5036;115;333;1293;3937;1408;4270
312965;201707;1811;5548;1532;5028;133;474;954;3120;1087;3594
312970;201707;990;3177;787;2828;192;784;232;799;424;1583
312980;201707;19000;60507;17262;57085;3982;14382;7380;23279;11362;37661
312990;201707;479;1397;330;1126;91;365;113;376;204;741
313000;201707;483;1557;397;1389;79;371;148;449;227;820
313005;201707;2643;8072;2337;7528;272;937;1571;5016;1843;5953
313010;201707;3926;12203;3349;11185;783;2872;1648;5308;2431;8180
313020;201707;961;3166;702;2527;126;511;83;249;209;760
313030;201707;1461;3785;1059;3182;172;610;506;1464;678;2074
313040;201707;805;2612;688;2338;74;298;341;1085;415;1383
313050;201707;1829;5544;1338;4764;329;1337;328;1044;657;2381
313055;201707;1635;4960;1502;4765;54;196;1276;4051;1330;4247
313060;201707;862;2597;663;2169;197;688;112;342;309;1030
313065;201707;1916;6079;1641;5640;188;763;1157;3973;1345;4736
313070;201707;997;2841;802;2498;149;513;358;1081;507;1594
313080;201707;440;1301;327;1066;81;315;91;239;172;554
313090;201707;5265;14874;4515;13645;1220;3989;2045;6156;3265;10145
313100;201707;1176;3453;1067;3285;86;287;839;2575;925;2862
313110;201707;1677;4700;1226;3812;172;594;519;1508;691;2102
313115;201707;2427;7875;2241;7479;436;1577;1044;3265;1480;4842
313120;201707;3612;9206;3061;8509;394;1202;2041;5741;2435;6943
313130;201707;26283;77065;22200;69030;4059;14062;9685;28411;13744;42473
313140;201707;528;1338;390;1119;25;89;272;759;297;848
313150;201707;1332;4138;1096;3693;393;1409;259;865;652;2274
313160;201707;974;2843;821;2549;142;516;454;1338;596;1854
313170;201707;10489;34601;7959;28620;1679;6337;2339;8290;4018;14627
313180;201707;2339;6262;1803;5461;337;1115;802;2346;1139;3461
313190;201707;4064;13126;3186;11080;652;2461;868;2807;1520;5268
313200;201707;1159;3585;1014;3312;78;315;747;2365;825;2680
313210;201707;4005;12117;3366;11103;604;2217;1754;5559;2358;7776
313220;201707;1708;4900;1212;3920;244;894;349;990;593;1884
313230;201707;2366;7897;2218;7696;147;573;1809;6250;1956;6823
313240;201707;8689;25447;6586;21540;1274;4666;2525;7781;3799;12447
313250;201707;6407;19935;5436;18174;565;2127;2958;9756;3523;11883
313260;201707;675;1910;458;1448;71;267;161;491;232;758
313270;201707;5405;15806;4498;14218;821;2783;2513;7935;3334;10718
313280;201707;370;1203;271;993;56;221;64;227;120;448
313290;201707;778;2727;647;2496;237;1018;90;311;327;1329
313300;201707;1852;5834;1480;5028;412;1534;201;586;613;2120
313310;201707;991;3310;876;3086;170;682;171;506;341;1188
313320;201707;2347;6544;1689;5506;345;1253;688;2223;1033;3476
313330;201707;4088;12037;3412;10890;287;1237;2154;6593;2441;7830
313340;201707;1683;4128;1308;3573;221;618;756;2078;977;2696
313350;201707;2554;7850;2006;6634;382;1370;531;1633;913;3003
313360;201707;1345;3706;985;3097;205;791;498;1448;703;2239
313370;201707;1210;4013;1121;3796;165;631;585;1908;750;2539
313375;201707;2141;5690;1508;4719;275;1035;453;1328;728;2363
313380;201707;4889;14654;4132;13139;1038;3623;1427;4171;2465;7794
313390;201707;905;3041;837;2926;73;318;554;1886;627;2204
313400;201707;3663;9774;3152;9163;282;793;2540;7482;2822;8275
313410;201707;1230;3410;1017;3071;158;541;674;1982;832;2523
313420;201707;17290;41116;10491;29767;2163;6872;1572;4447;3735;11319
313430;201707;990;3094;743;2582;138;574;263;816;401;1390
313440;201707;6523;14601;4478;12121;323;895;2806;7676;3129;8571
313450;201707;597;1764;469;1501;97;324;148;441;245;765
313460;201707;2111;6951;1820;6442;464;1908;720;2310;1184;4218
313470;201707;3114;8283;2719;7715;347;997;1869;5294;2216;6291
313480;201707;847;2465;643;2090;99;369;210;626;309;995
313490;201707;1639;4437;900;3284;295;1226;77;274;372;1500
313500;201707;422;1383;338;1165;53;204;117;381;170;585
313505;201707;9220;26121;8460;25224;375;1121;7505;22509;7880;23630
313507;201707;1389;3730;1193;3449;102;344;822;2377;924;2721
313510;201707;14583;41983;12747;38845;1659;5547;6759;20161;8418;25708
313520;201707;14277;42986;11857;38700;1191;4475;7647;24651;8838;29126
313530;201707;567;1701;470;1530;46;184;171;512;217;696
313535;201707;2546;7263;2270;6774;187;569;1551;4587;1738;5156
313540;201707;967;3002;714;2339;179;613;195;613;374;1226
313545;201707;1272;4481;1120;4185;188;783;607;2151;795;2934
313550;201707;1860;5811;1629;5363;383;1336;785;2506;1168;3842
313560;201707;2289;5081;1840;4574;142;348;1444;3618;1586;3966
313570;201707;896;3014;751;2712;195;785;287;982;482;1767
313580;201707;5708;15963;4473;14113;764;2579;2321;7511;3085;10090
313590;201707;949;2772;746;2472;311;1118;173;566;484;1684
313600;201707;3754;10990;3284;10228;283;1012;2429;7539;2712;8551
313610;201707;987;2802;838;2529;158;489;501;1511;659;2000
313620;201707;5408;16130;4672;14792;1116;3765;1896;5943;3012;9708
313630;201707;8327;22260;6175;19212;961;3288;2907;9423;3868;12711
313640;201707;944;2478;661;2059;190;648;212;619;402;1267
313650;201707;1823;5910;1619;5560;174;721;1045;3552;1219;4273
313652;201707;909;3079;834;2945;122;522;492;1635;614;2157
313655;201707;969;2966;806;2712;94;361;484;1613;578;1974
313657;201707;1357;3851;1083;3431;81;348;772;2282;853;2630
313660;201707;824;2607;708;2374;131;535;341;1062;472;1597
313665;201707;3965;12367;3379;11154;582;2119;1742;5584;2324;7703
313670;201707;45811;129930;33283;105808;7213;25095;10687;32577;17900;57672
313680;201707;1060;3045;932;2837;102;371;570;1693;672;2064
313690;201707;907;3142;761;2829;164;623;235;888;399;1511
313695;201707;1472;4523;1211;4051;114;460;828;2749;942;3209
313700;201707;3519;11697;3043;11101;377;1427;2269;8425;2646;9852
313710;201707;1347;3554;1013;3019;146;481;554;1637;700;2118
313720;201707;5682;17238;4376;14521;809;3001;1498;4563;2307;7564
313730;201707;1302;3306;973;2868;84;272;582;1697;666;1969
313740;201707;1855;6711;1568;5971;423;1738;119;435;542;2173
313750;201707;2155;6330;1714;5458;445;1557;497;1432;942;2989
313753;201707;2027;5388;1530;4534;227;763;757;2185;984;2948
313760;201707;4389;13686;3584;12064;955;3494;1123;3555;2078;7049
313770;201707;3462;10610;2946;9880;432;1546;1797;6045;2229;7591
313780;201707;4106;11230;3139;9682;487;1698;937;2898;1424;4596
313790;201707;462;1536;435;1487;72;261;250;834;322;1095
313800;201707;1248;3210;1069;2942;84;274;784;2195;868;2469
313810;201707;1611;4436;1381;4112;138;450;972;2911;1110;3361
313820;201707;13235;34284;10354;29513;1696;5685;4252;11258;5948;16943
313830;201707;374;1194;331;1118;76;285;146;491;222;776
313835;201707;876;2822;777;2644;83;343;439;1427;522;1770
313840;201707;7350;20721;5736;17996;1429;4896;1217;3773;2646;8669
313850;201707;1090;2917;946;2660;158;553;499;1262;657;1815
313860;201707;2833;8305;2120;6763;430;1455;618;1851;1048;3306
313862;201707;1268;3232;880;2577;109;327;452;1346;561;1673
313865;201707;2314;6839;2063;6458;178;626;1526;4724;1704;5350
313867;201707;1140;3828;993;3521;329;1196;331;1188;660;2384
313868;201707;1745;5752;1488;5236;113;482;1069;3704;1182;4186
313870;201707;832;2481;685;2218;168;601;206;589;374;1190
313880;201707;1317;4007;1108;3639;262;958;391;1129;653;2087
313890;201707;2003;5012;1523;4385;209;633;878;2642;1087;3275
313900;201707;3880;13523;3438;12548;1053;4202;850;3095;1903;7297
313910;201707;701;2292;577;2048;172;650;84;308;256;958
313920;201707;3269;10609;2790;9722;558;1990;1433;5171;1991;7161
313925;201707;1810;4862;1396;4076;219;601;800;2373;1019;2974
313930;201707;6361;22223;5355;20468;616;2233;3435;13983;4051;16216
313940;201707;8813;27944;6893;24738;1757;7045;1822;7043;3579;14088
313950;201707;4174;11213;3160;9611;867;3082;1272;3619;2139;6701
313960;201707;5609;14294;3964;11773;957;3143;1134;3221;2091;6364
313970;201707;1434;4180;1268;3941;125;458;728;2331;853;2789
313980;201707;1303;3955;950;3294;191;761;341;1126;532;1887
313990;201707;1657;6118;1443;5561;478;1976;345;1236;823;3212
314000;201707;8734;26231;7751;24285;901;3434;4736;14375;5637;17809
314010;201707;1223;3250;1006;2955;72;263;730;2096;802;2359
314015;201707;1704;5260;1405;4747;232;907;731;2407;963;3314
314020;201707;515;1509;325;1089;61;246;67;216;128;462
314030;201707;824;2623;649;2208;100;370;269;897;369;1267
314040;201707;748;2126;624;1891;135;438;255;753;390;1191
314050;201707;1672;5011;1302;4260;235;900;547;1633;782;2533
314053;201707;1628;5050;1430;4778;178;594;991;3501;1169;4095
314055;201707;2236;6441;1949;6018;79;321;1583;4880;1662;5201
314060;201707;1179;3537;938;3119;73;288;600;1961;673;2249
314070;201707;4278;13032;3449;11429;877;3101;1048;3292;1925;6393
314080;201707;1784;5477;1294;4369;216;836;331;965;547;1801
314085;201707;2033;6555;1754;6152;451;1736;686;2394;1137;4130
314090;201707;3403;11121;2961;10302;400;1640;1616;5690;2016;7330
314100;201707;3359;8179;2941;7618;146;306;2468;6652;2614;6958
314110;201707;4023;12577;3514;11520;662;2412;1540;4681;2202;7093
314120;201707;1027;2438;488;1552;96;345;109;343;205;688
314130;201707;715;2046;375;1283;60;231;80;263;140;494
314140;201707;4893;14804;3926;12840;711;2479;1712;5533;2423;8012
314150;201707;1515;4136;1206;3609;149;493;680;1993;829;2486
314160;201707;2582;6712;1940;5690;297;940;918;2767;1215;3707
314170;201707;1094;3177;897;2777;120;401;497;1464;617;1865
314180;201707;5199;15815;4548;14790;1049;3603;2152;7018;3201;10621
314190;201707;697;1903;506;1587;118;438;180;502;298;940
314200;201707;2947;8849;2571;8171;234;932;1785;5475;2019;6407
314210;201707;2035;5705;1787;5296;166;579;1089;3141;1255;3720
314220;201707;1474;4469;1094;3730;345;1302;236;706;581;2008
314225;201707;1322;3745;1184;3561;76;265;871;2632;947;2897
314230;201707;699;2171;641;2074;91;358;360;1139;451;1497
314240;201707;1146;3381;929;3031;209;732;416;1407;625;2139
314250;201707;540;1583;386;1237;76;266;117;332;193;598
314260;201707;1045;3608;884;3234;177;770;278;921;455;1691
314270;201707;3010;9221;2480;8283;189;734;1755;5771;1944;6505
314280;201707;3182;8414;2157;6500;437;1524;815;2255;1252;3779
314290;201707;4750;12870;4063;11752;630;1882;2411;6907;3041;8789
314300;201707;1519;4900;1252;4288;342;1241;339;1125;681;2366
314310;201707;5655;15889;4533;13928;1331;4392;1269;3647;2600;8039
314315;201707;818;3137;743;2988;73;351;532;2121;605;2472
314320;201707;3068;8582;2166;7172;554;1965;841;2845;1395;4810
314330;201707;54234;159658;44993;144228;13336;45596;11512;36570;24848;82166
314340;201707;2858;7640;1606;5238;311;1149;153;374;464;1523
314345;201707;1259;4121;1130;3886;168;603;725;2457;893;3060
314350;201707;1189;3391;878;2835;229;796;187;576;416;1372
314360;201707;689;2163;438;1570;87;360;93;325;180;685
314370;201707;580;1773;520;1684;82;314;365;1141;447;1455
314380;201707;1301;3873;915;3078;254;931;132;449;386;1380
314390;201707;12996;36354;9276;29521;2180;7485;2104;6148;4284;13633
314400;201707;4455;13004;3706;11899;1111;3747;1304;4347;2415;8094
314410;201707;2796;8256;2086;6893;442;1630;649;2262;1091;3892
314420;201707;759;2044;583;1782;26;139;431;1267;457;1406
314430;201707;6294;18201;5291;16352;1249;4138;1769;5494;3018;9632
314435;201707;1431;4354;1266;4094;78;353;895;2838;973;3191
314437;201707;1022;2687;832;2396;28;94;600;1746;628;1840
314440;201707;556;1678;461;1529;144;537;136;396;280;933
314450;201707;1528;4410;1288;4020;206;793;665;1898;871;2691
314460;201707;3853;12598;2989;10713;701;2744;490;1691;1191;4435
314465;201707;2290;6945;2100;6611;90;409;1638;5029;1728;5438
314467;201707;971;2718;828;2482;45;131;607;1848;652;1979
314470;201707;2163;6679;1855;6051;423;1510;692;2101;1115;3611
314480;201707;5873;19123;4262;15017;757;2896;665;2133;1422;5029
314490;201707;843;2480;650;2082;96;353;351;1053;447;1406
314500;201707;1867;5208;1373;4316;267;907;434;1319;701;2226
314505;201707;1922;5226;1721;4969;168;529;1194;3480;1362;4009
314510;201707;1969;5203;1317;4301;318;1126;412;1369;730;2495
314520;201707;3156;10821;2268;8696;441;1941;218;737;659;2678
314530;201707;5809;19833;5424;19119;812;2894;3439;12361;4251;15255
314535;201707;2760;7434;2296;6775;189;613;1670;4920;1859;5533
314537;201707;1143;3465;925;3073;118;469;573;1841;691;2310
314540;201707;357;1052;284;904;54;191;105;313;159;504
314545;201707;1577;4479;1402;4240;82;258;1101;3499;1183;3757
314550;201707;653;1687;469;1423;57;217;204;556;261;773
314560;201707;4316;14386;3571;12676;635;2549;1127;3679;1762;6228
314570;201707;311;915;242;779;36;137;121;373;157;510
314580;201707;510;1684;395;1425;91;360;47;172;138;532
314585;201707;874;2767;638;2248;130;545;209;691;339;1236
314587;201707;1991;5908;1634;5284;300;933;831;2734;1131;3667
314590;201707;3013;9994;2289;8202;452;1772;553;1915;1005;3687
314600;201707;1672;5234;1126;4072;266;1076;124;379;390;1455
314610;201707;7159;23386;6248;21384;1321;5169;2563;8225;3884;13394
314620;201707;1647;4700;1464;4440;94;307;1155;3462;1249;3769
314625;201707;1584;4988;1424;4738;165;774;1013;3171;1178;3945
314630;201707;4842;13975;4203;12953;251;1034;3183;9698;3434;10732
314640;201707;609;1631;458;1361;111;363;157;411;268;774
314650;201707;1058;2885;762;2402;100;384;295;811;395;1195
314655;201707;1560;4533;1131;3679;237;758;450;1477;687;2235
314660;201707;308;810;211;619;17;44;101;286;118;330
314670;201707;1669;4333;1179;3483;131;437;691;1976;822;2413
314675;201707;1851;5328;1604;4897;141;514;1157;3471;1298;3985
314690;201707;2113;6727;1728;5993;518;1967;294;993;812;2960
314700;201707;9527;30611;6663;24268;1744;7000;1022;3659;2766;10659
314710;201707;8582;25365;6086;20035;1137;4165;971;2866;2108;7031
314720;201707;2376;7649;1866;6541;429;1664;455;1574;884;3238
314730;201707;2198;6434;1726;5623;447;1583;534;1594;981;3177
314740;201707;2820;8679;2380;7813;319;1267;1217;3798;1536;5065
314750;201707;340;1030;269;877;32;124;142;438;174;562
314760;201707;1757;5654;1299;4558;183;732;291;845;474;1577
314770;201707;1036;3174;614;2070;51;195;136;382;187;577
314780;201707;322;833;235;706;53;192;107;302;160;494
314790;201707;9872;29528;7611;25306;2871;10572;678;1943;3549;12515
314795;201707;1597;4538;1388;4201;89;363;1023;2953;1112;3316
314800;201707;11654;32569;7639;24503;1869;6486;901;2674;2770;9160
314810;201707;10654;30346;8120;25936;2408;8192;1707;5517;4115;13709
314820;201707;930;2545;685;2125;142;503;297;882;439;1385
314830;201707;1567;5092;1384;4770;315;1214;674;2324;989;3538
314840;201707;923;3158;750;2902;121;593;456;1677;577;2270
314850;201707;1974;5444;1565;4728;151;568;1118;3275;1269;3843
314860;201707;3298;10629;2867;9806;440;1737;1665;5574;2105;7311
314870;201707;5635;16644;4822;15528;446;1709;3542;11360;3988;13069
314875;201707;1758;5582;1656;5447;124;375;1394;4660;1518;5035
314880;201707;913;2331;736;2101;55;138;500;1509;555;1647
314890;201707;554;1684;407;1341;79;301;147;426;226;727
314900;201707;649;1764;519;1568;98;324;215;661;313;985
314910;201707;1695;5344;1361;4797;355;1430;538;1824;893;3254
314915;201707;2461;7610;2113;6986;166;690;1427;4544;1593;5234
314920;201707;534;1451;385;1233;30;106;205;626;235;732
314930;201707;4812;15837;4153;14406;1021;3807;1231;4016;2252;7823
314940;201707;402;1151;363;1082;50;155;217;621;267;776
314950;201707;373;1068;264;899;49;184;80;266;129;450
314960;201707;772;2270;602;1923;108;394;254;738;362;1132
314970;201707;624;2090;537;1921;120;494;176;607;296;1101
314980;201707;1420;4251;1158;3822;342;1246;81;248;423;1494
314990;201707;2551;7880;1919;6488;486;1876;398;1163;884;3039
314995;201707;1634;4940;1409;4581;142;581;857;2687;999;3268
315000;201707;1098;3056;872;2689;81;303;547;1647;628;1950
315010;201707;430;1306;336;1111;65;269;122;354;187;623
315015;201707;2167;6479;1962;6230;245;812;1323;4385;1568;5197
315020;201707;862;2607;640;2149;96;354;275;881;371;1235
315030;201707;616;1835;471;1560;126;447;96;286;222;733
315040;201707;911;2709;841;2580;151;496;495;1498;646;1994
315050;201707;1294;3646;1013;3215;151;555;492;1526;643;2081
315053;201707;1129;3263;953;2920;133;519;486;1468;619;1987
315057;201707;1669;5548;1484;5179;255;895;796;2797;1051;3692
315060;201707;707;2250;489;1772;111;432;67;237;178;669
315070;201707;741;2167;586;1882;173;594;203;600;376;1194
315080;201707;2921;9280;2421;8195;560;1999;1040;3468;1600;5467
315090;201707;788;2663;634;2312;138;543;160;546;298;1089
315100;201707;1206;3984;845;3095;186;773;230;782;416;1555
315110;201707;1362;3908;1104;3465;205;713;452;1407;657;2120
315120;201707;13976;32400;9665;26736;1307;3733;4565;13427;5872;17160
315130;201707;1307;4202;1168;3922;271;1075;402;1245;673;2320
315140;201707;2894;8772;2339;7667;480;1768;946;2839;1426;4607
315150;201707;4537;12004;3320;9981;525;1727;1334;3967;1859;5694
315160;201707;1371;3909;1048;3337;231;775;420;1307;651;2082
315170;201707;1528;4746;1182;4012;252;914;238;777;490;1691
315180;201707;17521;48149;9895;32135;1703;6241;1738;5064;3441;11305
315190;201707;2019;5124;1672;4594;396;1089;1004;2751;1400;3840
315200;201707;3743;12307;3091;10912;962;3710;593;2044;1555;5754
315210;201707;8066;23054;6345;19438;989;3348;2387;6797;3376;10145
315213;201707;1149;3367;1039;3201;45;154;837;2558;882;2712
315217;201707;2469;8188;2004;7323;186;872;1251;4449;1437;5321
315220;201707;9541;27081;7948;24306;2453;7776;2344;7340;4797;15116
315230;201707;2975;7648;2647;7268;116;177;2349;6794;2465;6971
315240;201707;3024;9063;2555;8336;651;2283;1215;3876;1866;6159
315250;201707;10624;31466;8297;27052;1771;6358;2843;9109;4614;15467
315260;201707;957;2957;627;2199;137;506;74;226;211;732
315270;201707;695;2200;525;1872;99;417;135;446;234;863
315280;201707;3007;8391;1867;5960;408;1376;297;899;705;2275
315290;201707;1259;3428;849;2753;273;961;189;630;462;1591
315300;201707;570;1524;406;1319;191;658;132;430;323;1088
315310;201707;1272;3918;1009;3404;104;396;587;1899;691;2295
315320;201707;754;2214;592;1973;87;382;269;848;356;1230
315330;201707;742;2665;456;1880;103;459;96;373;199;832
315340;201707;3535;9736;2777;8580;447;1500;1281;3890;1728;5390
315350;201707;1865;5033;1420;4381;106;366;939;2978;1045;3344
315360;201707;1662;5425;1317;4651;255;979;419;1386;674;2365
315370;201707;473;1451;406;1313;80;263;174;558;254;821
315380;201707;204;662;158;550;37;147;36;102;73;249
315390;201707;1229;3964;939;3316;212;827;213;700;425;1527
315400;201707;4343;12756;3503;11160;552;1877;1703;5319;2255;7196
315410;201707;2268;5562;1812;4950;402;1172;843;2285;1245;3457
315415;201707;1081;3375;921;3133;340;1243;283;997;623;2240
315420;201707;1193;3763;900;3153;207;754;133;424;340;1178
315430;201707;3660;9729;2746;8242;758;2554;738;2089;1496;4643
315440;201707;992;2910;854;2675;147;562;402;1129;549;1691
315445;201707;2070;5526;1594;4785;228;731;987;2962;1215;3693
315450;201707;2428;7343;2140;6886;320;1011;1311;4329;1631;5340
315460;201707;31782;101818;28466;95129;9871;34986;6119;19795;15990;54781
315470;201707;491;1449;407;1295;31;118;214;662;245;780
315480;201707;1670;5024;1151;3860;257;931;223;743;480;1674
315490;201707;3146;8166;2302;7000;398;1357;736;2090;1134;3447
315500;201707;485;1393;306;980;34;131;128;347;162;478
315510;201707;1385;3880;1187;3562;71;258;938;2776;1009;3034
315520;201707;1084;3140;867;2795;73;279;560;1745;633;2024
315530;201707;656;2146;512;1775;175;673;158;488;333;1161
315540;201707;1096;3309;881;2913;151;584;302;979;453;1563
315550;201707;1926;5282;1449;4564;306;1096;489;1507;795;2603
315560;201707;6503;21117;5830;20140;585;2310;3837;13274;4422;15584
315570;201707;1874;5901;1706;5560;214;801;874;2768;1088;3569
315580;201707;2328;6462;1858;5677;462;1582;552;1620;1014;3202
315590;201707;872;2491;749;2288;104;356;382;1145;486;1501
315600;201707;2422;8410;1924;7380;288;1146;1046;4150;1334;5296
315610;201707;980;2689;789;2322;130;502;328;804;458;1306
315620;201707;314;1097;297;1063;68;240;167;636;235;876
315630;201707;877;2688;705;2340;181;606;154;481;335;1087
315640;201707;452;1310;384;1196;62;241;169;489;231;730
315645;201707;829;2409;660;2078;214;716;190;573;404;1289
315650;201707;1873;4989;1473;4407;93;361;1067;3129;1160;3490
315660;201707;2581;6517;2056;5661;155;411;1390;3779;1545;4190
315670;201707;11208;35490;9903;32927;2371;8540;3994;12843;6365;21383
315680;201707;3010;9744;2325;8369;650;2497;702;2511;1352;5008
315690;201707;3315;9160;2255;7263;544;1896;462;1589;1006;3485
315700;201707;7461;22411;6187;19879;1078;3702;2824;8791;3902;12493
315710;201707;1876;5096;1407;4360;102;431;849;2488;951;2919
315720;201707;3882;12013;3455;11211;245;1097;2222;6913;2467;8010
315725;201707;1585;4820;1411;4568;210;694;1040;3428;1250;4122
315727;201707;624;1817;481;1540;97;351;195;569;292;920
315730;201707;743;2300;687;2173;94;346;342;1024;436;1370
315733;201707;1083;3131;949;2895;247;854;353;1016;600;1870
315737;201707;1218;3621;960;3151;60;250;622;2020;682;2270
315740;201707;997;2987;827;2647;139;541;399;1149;538;1690
315750;201707;1198;3474;1052;3221;61;227;785;2399;846;2626
315760;201707;1109;2838;1059;2773;27;70;978;2555;1005;2625
315765;201707;1696;4881;1472;4594;57;190;1274;4032;1331;4222
315770;201707;1449;4562;1247;4231;369;1367;337;1135;706;2502
315780;201707;22909;72453;20589;67540;3783;13716;8992;28355;12775;42071
315790;201707;3719;12027;3209;11030;289;998;2102;7425;2391;8423
315800;201707;1273;4923;980;4043;208;933;180;696;388;1629
315810;201707;1353;3521;1165;3238;121;382;837;2242;958;2624
315820;201707;2440;7903;2117;7333;440;1603;1163;4029;1603;5632
315830;201707;1197;3802;971;3359;96;412;390;1263;486;1675
315840;201707;778;2033;500;1499;79;245;156;458;235;703
315850;201707;997;3375;933;3268;224;871;508;1682;732;2553
315860;201707;535;1715;381;1406;84;359;100;332;184;691
315870;201707;454;1304;377;1180;32;112;236;707;268;819
315880;201707;1211;3114;946;2754;136;472;394;1112;530;1584
315890;201707;1531;5100;1356;4766;465;1756;518;1760;983;3516
315895;201707;5769;17326;4774;15228;814;2864;1904;5695;2718;8559
315900;201707;805;2251;759;2176;71;278;600;1613;671;1891
315910;201707;484;1602;448;1543;89;327;287;967;376;1294
315920;201707;1659;4488;917;2918;207;713;169;466;376;1179
315930;201707;1075;2784;786;2290;189;565;254;740;443;1305
315935;201707;891;2915;792;2718;190;735;219;742;409;1477
315940;201707;614;1929;531;1768;92;339;250;819;342;1158
315950;201707;1209;3563;1057;3289;208;633;661;2095;869;2728
315960;201707;3821;11713;2537;9193;838;3531;102;220;940;3751
315970;201707;702;1988;547;1772;57;170;378;1269;435;1439
315980;201707;3961;9596;2466;7114;594;1889;657;1679;1251;3568
315990;201707;4016;11008;3209;9633;454;1559;1624;4767;2078;6326
316000;201707;592;1703;487;1556;115;435;176;540;291;975
316010;201707;658;2065;527;1814;53;231;267;838;320;1069
316020;201707;993;3139;874;2924;96;414;578;1829;674;2243
316030;201707;3170;9090;2324;7553;195;724;1406;4633;1601;5357
316040;201707;3099;9664;2335;8089;393;1543;431;1292;824;2835
316045;201707;2049;6146;1898;5898;202;608;1389;4397;1591;5005
316050;201707;361;1125;284;989;43;181;149;496;192;677
316060;201707;720;2070;566;1825;69;313;332;983;401;1296
316070;201707;6287;19009;5345;16994;1069;3784;2188;6638;3257;10422
316080;201707;755;2626;651;2378;165;658;71;252;236;910
316090;201707;529;1625;388;1328;65;260;125;398;190;658
316095;201707;1458;4541;1238;4151;195;692;676;2258;871;2950
316100;201707;2666;8530;1989;6952;447;1732;496;1595;943;3327
316105;201707;944;2635;712;2240;150;493;309;985;459;1478
316110;201707;12191;39565;10849;37287;1536;5523;6840;24007;8376;29530
316120;201707;1129;3559;868;2941;199;714;212;628;411;1342
316130;201707;1548;3528;908;2563;140;451;362;972;502;1423
316140;201707;1005;2751;742;2370;98;316;446;1458;544;1774
316150;201707;1575;4138;1345;3750;205;624;699;1880;904;2504
316160;201707;1181;3392;926;2919;125;433;488;1463;613;1896
316165;201707;963;2453;777;2191;142;468;426;1190;568;1658
316170;201707;1283;3588;938;3010;146;520;412;1237;558;1757
316180;201707;1478;4511;1025;3537;224;860;161;464;385;1324
316190;201707;2894;8705;1604;5475;298;995;372;1128;670;2123
316200;201707;3768;11787;2882;10031;636;2600;685;2247;1321;4847
316210;201707;4836;15038;3837;12962;1274;4595;447;1477;1721;6072
316220;201707;789;2432;556;1942;113;436;57;213;170;649
316225;201707;1257;3300;1025;2923;122;416;656;1787;778;2203
316230;201707;442;1242;361;1108;51;170;158;511;209;681
316240;201707;6570;19581;5777;18488;694;2268;4115;13245;4809;15513
316245;201707;3269;11112;2981;10658;250;1268;2235;7763;2485;9031
316250;201707;10570;29721;8107;24999;2206;7457;1722;4996;3928;12453
316255;201707;2646;7741;2312;7302;332;1153;1551;4955;1883;6108
316257;201707;1310;3487;977;2902;145;483;401;1141;546;1624
316260;201707;1904;5135;1473;4491;83;306;792;2522;875;2828
316265;201707;1353;3734;992;3046;81;279;618;1873;699;2152
316270;201707;3617;12006;3318;11332;798;2930;1299;4244;2097;7174
316280;201707;3173;10016;2879;9429;450;1647;1515;4765;1965;6412
316290;201707;3391;10253;2803;9102;536;1959;977;3147;1513;5106
316292;201707;3853;11555;3354;10733;430;1599;2252;6979;2682;8578
316294;201707;831;2606;622;2194;132;529;81;297;213;826
316295;201707;1988;6268;1845;6008;160;668;1340;4234;1500;4902
316300;201707;1018;3187;853;2879;64;238;516;1778;580;2016
316310;201707;717;2039;492;1633;92;343;166;535;258;878
316320;201707;623;1922;504;1695;91;354;144;456;235;810
316330;201707;1027;3041;794;2525;78;274;513;1586;591;1860
316340;201707;1074;3230;817;2710;126;510;374;1160;500;1670
316350;201707;1285;4013;1154;3786;153;542;707;2308;860;2850
316360;201707;732;1934;581;1707;61;197;397;1146;458;1343
316370;201707;4662;14354;3889;12837;1092;4057;745;2231;1837;6288
316380;201707;1648;4226;1291;3744;63;207;945;2741;1008;2948
316390;201707;881;2459;729;2220;149;497;326;1001;475;1498
316400;201707;1320;3992;986;3365;179;650;373;1226;552;1876
316410;201707;1027;3289;935;3154;112;384;695;2342;807;2726
316420;201707;1939;5954;1706;5644;142;573;1251;4050;1393;4623
316430;201707;953;2872;660;2243;155;577;155;494;310;1071
316440;201707;738;2373;595;2147;179;739;106;393;285;1132
316443;201707;636;1854;504;1610;122;440;153;460;275;900
316447;201707;1704;4889;1518;4623;97;344;1235;3741;1332;4085
316450;201707;2187;7106;1820;6362;192;739;1211;4184;1403;4923
316460;201707;851;2529;772;2382;254;802;335;1001;589;1803
316470;201707;7523;23156;5936;19985;1393;5352;1586;4991;2979;10343
316480;201707;184;608;157;546;42;158;46;145;88;303
316490;201707;345;1004;263;834;46;143;100;291;146;434
316500;201707;1213;4154;809;3013;151;626;74;246;225;872
316510;201707;749;2713;668;2561;208;871;191;708;399;1579
316520;201707;1064;3091;875;2769;159;581;352;1015;511;1596
316530;201707;856;2683;695;2389;133;565;285;870;418;1435
316540;201707;751;2377;665;2220;105;421;205;632;310;1053
316550;201707;1232;3996;1154;3853;178;641;720;2411;898;3052
316553;201707;2475;8209;1829;6574;538;2074;313;1068;851;3142
316555;201707;2843;9368;2504;8924;181;732;1850;6703;2031;7435
316556;201707;651;1612;485;1339;52;167;277;693;329;860
316557;201707;817;2888;753;2778;336;1306;213;738;549;2044
316560;201707;288;1033;246;945;70;319;54;190;124;509
316570;201707;1219;3886;1072;3587;302;1054;325;1105;627;2159
316580;201707;348;901;225;663;59;188;67;188;126;376
316590;201707;1468;3934;1042;3194;182;636;547;1544;729;2180
316600;201707;1049;3365;936;3150;192;703;425;1415;617;2118
316610;201707;595;2080;513;1915;75;389;311;1080;386;1469
316620;201707;2247;6568;1911;6030;162;619;1295;4048;1457;4667
316630;201707;1536;4830;1239;4233;407;1381;409;1550;816;2931
316640;201707;169;522;145;476;32;131;63;170;95;301
316650;201707;958;3272;799;3032;74;300;535;2083;609;2383
316660;201707;193;499;94;293;7;30;16;41;23;71
316670;201707;1996;5380;1579;4669;492;1561;493;1422;985;2983
316680;201707;1883;5036;1526;4503;157;530;1073;3076;1230;3606
316690;201707;1185;3912;1042;3614;275;1098;312;1039;587;2137
316695;201707;1069;3266;931;3007;79;316;601;1899;680;2215
316700;201707;393;1104;340;1027;27;119;221;614;248;733
316710;201707;2752;10035;2330;9094;795;3208;658;2780;1453;5988
316720;201707;17081;53779;14087;47341;3315;11870;4385;14303;7700;26173
316730;201707;351;1080;308;980;88;309;105;307;193;616
316740;201707;705;2242;643;2137;79;339;423;1393;502;1732
316750;201707;423;1388;338;1206;58;239;114;385;172;624
316760;201707;3631;11697;3058;10850;1390;5208;959;3449;2349;8657
316770;201707;1425;3792;1232;3521;52;191;1033;2960;1085;3151
316780;201707;605;1967;511;1767;158;605;51;140;209;745
316790;201707;774;2221;611;1936;175;602;174;545;349;1147
316800;201707;5290;16714;4524;15207;762;2823;2374;7606;3136;10429
316805;201707;831;2045;796;1998;31;54;697;1844;728;1898
316810;201707;664;1957;512;1644;139;509;190;546;329;1055
316820;201707;398;1007;215;678;35;127;28;96;63;223
316830;201707;583;1936;542;1851;120;473;282;923;402;1396
316840;201707;2805;8319;2450;7682;504;1743;1100;3325;1604;5068
316850;201707;2138;5970;1721;5280;231;819;967;2899;1198;3718
316860;201707;18130;55626;15436;50713;3311;12326;6054;19178;9365;31504
316870;201707;6509;20367;5221;17529;1365;4903;1211;3911;2576;8814
316880;201707;889;2612;768;2407;183;665;274;818;457;1483
316890;201707;1308;2999;909;2468;195;646;514;1268;709;1914
316900;201707;2588;7455;2016;6268;477;1663;596;1621;1073;3284
316905;201707;467;1500;398;1348;115;409;147;497;262;906
316910;201707;973;2869;668;2276;163;636;84;261;247;897
316920;201707;1642;4323;1158;3623;239;838;454;1404;693;2242
316930;201707;7935;26253;6245;22691;1431;5643;1092;3815;2523;9458
316935;201707;4518;13447;3259;10779;794;2812;731;2389;1525;5201
316940;201707;6786;21474;5364;18381;1182;4372;1339;4314;2521;8686
316950;201707;1676;4337;1368;3915;109;351;994;2800;1103;3151
316960;201707;5014;12416;3854;10771;643;1963;2179;6010;2822;7973
316970;201707;3229;10062;3023;9680;630;2289;1265;3764;1895;6053
316980;201707;920;2727;646;2204;196;725;88;305;284;1030
316990;201707;10038;30748;8009;26243;2319;8142;739;2300;3058;10442
317000;201707;2822;9217;2708;9074;224;704;2073;7624;2297;8328
317005;201707;2686;8064;2318;7443;496;1648;1137;3646;1633;5294
317010;201707;27594;67859;16889;51323;4211;14310;3168;10309;7379;24619
317020;201707;67141;177989;39925;124233;7861;26757;7602;21578;15463;48335
317030;201707;715;2061;606;1892;43;180;401;1222;444;1402
317040;201707;10534;29552;8197;25429;2074;6809;2945;9192;5019;16001
317043;201707;760;1971;625;1781;123;363;335;943;458;1306
317047;201707;1170;3007;882;2545;64;205;570;1638;634;1843
317050;201707;1481;4896;1116;4015;205;790;338;1101;543;1891
317052;201707;2281;7264;2108;6971;208;814;1485;4780;1693;5594
317057;201707;1653;4456;1252;3751;92;350;810;2321;902;2671
317060;201707;425;1179;253;805;50;185;66;182;116;367
317065;201707;1312;3808;1139;3516;60;274;864;2564;924;2838
317070;201707;9177;28056;6364;21828;1429;5515;816;2676;2245;8191
317075;201707;1097;3254;843;2712;173;583;171;517;344;1100
317080;201707;6299;16432;5139;14494;1653;4866;1377;3677;3030;8543
317090;201707;4805;15296;4426;14725;442;1531;3145;10566;3587;12097
317100;201707;3032;7983;2185;6566;709;2257;632;1852;1341;4109
317103;201707;1850;6244;1634;5836;203;948;928;3138;1131;4086
317107;201707;1396;4117;1187;3714;96;377;759;2196;855;2573
317110;201707;746;1802;417;1261;73;272;141;440;214;712
317115;201707;1173;3533;987;3132;88;285;673;2139;761;2424
317120;201707;11136;35756;9058;31151;1835;6983;3871;12844;5706;19827
317130;201707;7646;21643;6052;18777;1342;4596;2102;6408;3444;11004
317140;201707;578;1807;520;1709;77;266;303;984;380;1250
317150;201707;1023;2690;863;2499;54;163;675;1940;729;2103
317160;201707;3591;9140;2627;7816;262;830;1702;5056;1964;5886
317170;201707;1995;5270;1485;4406;224;755;518;1346;742;2101
317180;201707;1787;5925;1440;5163;351;1326;323;1119;674;2445
317190;201707;1382;3835;1059;3345;67;231;680;2122;747;2353
317200;201707;4740;14116;3835;12323;950;3351;968;2915;1918;6266
317210;201707;972;2781;836;2595;100;404;560;1709;660;2113
317220;201707;289;987;268;939;76;291;114;385;190;676
320010;201707;4933;15191;4180;13710;649;2274;2284;7347;2933;9621
320013;201707;1926;5770;1335;4468;235;802;530;1825;765;2627
320016;201707;3056;8359;2587;7692;213;602;1950;5822;2163;6424
320020;201707;3806;11597;3113;10244;855;2968;937;3151;1792;6119
320030;201707;1739;5390;1283;4409;364;1326;370;1204;734;2530
320035;201707;1814;5273;1550;4843;513;1777;597;1752;1110;3529
320040;201707;3284;10360;2749;9317;551;2013;1108;3712;1659;5725
320050;201707;1704;4468;1483;4086;374;1045;682;1855;1056;2900
320060;201707;11431;35472;8585;29138;2113;7773;1784;5788;3897;13561
320070;201707;1496;4614;1183;3952;262;951;320;1031;582;1982
320080;201707;5722;16012;4288;13196;915;2914;1435;4492;2350;7406
320090;201707;7875;22459;6202;19112;1574;5096;2265;6811;3839;11907
320100;201707;2591;8024;2095;7012;622;2131;629;2122;1251;4253
320110;201707;1265;3648;1075;3295;271;845;279;876;550;1721
320115;201707;1875;6465;1670;6087;809;3017;441;1693;1250;4710
320120;201707;15588;45698;11971;38805;2897;10361;3208;10223;6105;20584
320130;201707;36550;114651;32766;107362;6310;23207;15789;50157;22099;73364
320140;201707;3389;10498;2439;8403;616;2358;478;1626;1094;3984
320150;201707;14490;40642;10925;33620;3208;10592;1242;3490;4450;14082
320160;201707;5087;15541;4254;13888;989;3548;1665;5260;2654;8808
320170;201707;1656;5211;1362;4559;303;1059;573;1887;876;2946
320180;201707;744;2510;633;2297;221;828;147;569;368;1397
320190;201707;3476;11797;2725;9950;704;2711;437;1539;1141;4250
320200;201707;1001;2999;796;2638;249;916;195;666;444;1582
320210;201707;4647;12858;3866;11361;738;2412;1851;5126;2589;7538
320220;201707;2315;7020;1933;6346;429;1562;902;2939;1331;4501
320225;201707;1289;4248;957;3424;327;1225;139;498;466;1723
320230;201707;4289;13428;3563;12132;998;3673;1309;4486;2307;8159
320240;201707;13375;38188;10695;33555;2539;8601;3668;11591;6207;20192
320245;201707;3190;10615;2909;9961;1023;3695;721;2408;1744;6103
320250;201707;1949;5846;1384;4525;358;1313;226;664;584;1977
320255;201707;1708;5728;1490;5346;563;2105;568;2129;1131;4234
320260;201707;1002;3000;755;2447;229;823;197;537;426;1360
320265;201707;2490;7872;2108;7182;831;2958;680;2309;1511;5267
320270;201707;2727;7835;2000;6462;392;1345;887;2948;1279;4293
320280;201707;6381;19439;5497;17687;1420;4967;1451;4390;2871;9357
320290;201707;1444;4586;1022;3552;304;1154;156;513;460;1667
320300;201707;4183;13759;3613;12464;1186;4348;711;2423;1897;6771
320305;201707;4561;14232;3834;12615;947;3292;1395;4512;2342;7804
320310;201707;1901;5653;1568;4962;377;1235;594;1862;971;3097
320313;201707;2177;6109;1479;4594;329;1145;280;817;609;1962
320316;201707;1687;5014;1346;4311;405;1355;426;1354;831;2709
320320;201707;20042;58981;15517;50667;4252;15059;4793;15366;9045;30425
320330;201707;2964;8639;2397;7635;662;2106;947;3205;1609;5311
320332;201707;5547;17336;4770;15882;1321;4684;1962;6470;3283;11154
320334;201707;2098;6511;1453;5105;345;1379;324;1066;669;2445
320335;201707;2249;6583;1415;4636;381;1364;203;604;584;1968
320340;201707;5574;14917;4772;13598;1001;3067;2221;6482;3222;9549
320350;201707;5164;13500;3825;11049;688;2048;1614;4640;2302;6688
320360;201707;1643;4354;1210;3517;204;579;475;1368;679;1947
320370;201707;2828;9245;2271;7952;644;2317;681;2351;1325;4668
320380;201707;2207;6480;1950;6031;402;1362;986;2960;1388;4322
320390;201707;7261;21294;5797;18186;1544;5159;1791;5401;3335;10560
320400;201707;3519;10596;3041;9718;668;2276;1332;4236;2000;6512
320405;201707;4369;12457;3751;11346;681;2184;2066;6123;2747;8307
320410;201707;5362;14500;4026;12519;855;2838;1791;5714;2646;8552
320420;201707;2564;7531;2045;6604;602;2164;464;1479;1066;3643
320425;201707;2056;5209;1600;4455;165;507;968;2615;1133;3122
320430;201707;2632;7217;2209;6352;412;1255;1199;3294;1611;4549
320435;201707;2679;8515;2152;7472;873;3152;534;1936;1407;5088
320440;201707;1047;3374;908;3023;194;728;326;1035;520;1763
320450;201707;1959;5973;1576;5220;408;1496;652;2070;1060;3566
320455;201707;4158;13364;3069;10800;821;3049;698;2395;1519;5444
320460;201707;2641;8276;1921;6626;473;1748;362;1132;835;2880
320465;201707;1545;4665;1173;3858;169;606;541;1790;710;2396
320470;201707;4268;12466;3014;9784;817;2865;605;1885;1422;4750
320480;201707;1704;5250;1474;4777;319;1138;626;1980;945;3118
320490;201707;15844;47257;13336;42795;3426;12051;4448;14225;7874;26276
320495;201707;1350;3907;895;2971;256;884;148;530;404;1414
320500;201707;48898;143746;42296;131977;8991;30303;20259;61787;29250;92090
320501;201707;4672;14082;3591;12226;1075;4116;918;3034;1993;7150
320503;201707;1927;6369;1538;5526;544;2161;425;1388;969;3549
320506;201707;4123;12566;2903;9726;762;2712;103;271;865;2983
320510;201707;8643;26270;7501;24156;1501;5316;3648;11522;5149;16838
320515;201707;1895;5425;1530;4640;458;1439;352;1068;810;2507
320517;201707;2060;6540;1640;5703;547;2070;328;1101;875;3171
320520;201707;36902;109071;30275;97201;7140;25331;10761;33947;17901;59278
320530;201707;28317;83603;23526;74665;4119;15338;11772;35048;15891;50386
330010;201707;20883;62924;18517;58572;3928;13152;9680;30672;13608;43824
330015;201707;1519;4171;1305;3781;208;701;599;1675;807;2376
330020;201707;18516;52317;16777;49480;2911;9532;10353;29736;13264;39268
330022;201707;1933;5601;1607;5058;310;1074;888;2756;1198;3830
330023;201707;3280;9859;2814;9098;769;2687;866;2696;1635;5383
330025;201707;4818;12939;3639;10801;1027;3291;1339;3952;2366;7243
330030;201707;8417;27104;7342;25033;1374;5215;3556;11511;4930;16726
330040;201707;11863;35149;10717;32939;2045;6858;5997;17828;8042;24686
330045;201707;76618;204871;66293;190311;8317;25215;44880;127341;53197;152556
330050;201707;2462;7326;2050;6571;545;1877;760;2293;1305;4170
330060;201707;5692;16020;4824;14663;1128;3808;2103;6153;3231;9961
330070;201707;20602;61234;18423;57585;3916;13200;9000;28131;12916;41331
330080;201707;8251;22874;7565;21794;678;2021;5354;15321;6032;17342
330090;201707;2666;6973;2348;6489;358;1100;1299;3473;1657;4573
330093;201707;2021;5929;1672;5329;277;912;854;2839;1131;3751
330095;201707;1038;3433;884;3095;159;609;345;1151;504;1760
330100;201707;63180;187836;55711;176170;7280;26432;33821;105555;41101;131987
330110;201707;2273;7033;1998;6556;454;1611;715;2274;1169;3885
330115;201707;1798;5150;1562;4783;294;1023;841;2483;1135;3506
330120;201707;2778;7338;2407;6800;331;1083;1565;4333;1896;5416
330130;201707;3355;10615;2985;9973;691;2534;1433;4699;2124;7233
330140;201707;3144;9477;2859;9045;549;2006;1586;4903;2135;6909
330150;201707;2092;6145;1689;5357;436;1437;460;1462;896;2899
330160;201707;1178;3622;1030;3371;262;979;488;1512;750;2491
330170;201707;99978;295140;90789;280374;17245;56741;50338;153723;67583;210464
330180;201707;2123;6069;1773;5445;104;432;1198;3545;1302;3977
330185;201707;8612;25738;7421;23482;1274;4432;4237;13025;5511;17457
330187;201707;3914;10968;3324;10008;547;1840;2010;5919;2557;7759
330190;201707;26333;72872;24454;70031;3664;10980;17333;49414;20997;60394
330200;201707;14089;43077;12545;40507;3040;10023;6261;20586;9301;30609
330205;201707;2081;5675;1808;5207;197;647;1177;3297;1374;3944
330210;201707;3013;8259;2382;7055;556;1703;842;2421;1398;4124
330220;201707;10347;30769;8771;27499;2191;7417;2202;6371;4393;13788
330225;201707;3795;11559;3250;10568;383;1566;1935;6032;2318;7598
330227;201707;16914;47809;15167;45269;2747;8461;9433;28497;12180;36958
330230;201707;1276;3687;1138;3485;154;560;685;2026;839;2586
330240;201707;18289;54458;15554;49477;4560;15629;5277;16215;9837;31844
330245;201707;1266;3718;942;3134;229;814;201;642;430;1456
330250;201707;35476;102819;32083;97243;8933;27402;13054;41000;21987;68402
330260;201707;4317;12990;3634;11700;653;2290;1587;4883;2240;7173
330270;201707;20243;45347;13615;36437;3056;9154;5066;13549;8122;22703
330280;201707;2301;6689;1910;5933;313;1100;920;2684;1233;3784
330285;201707;18501;51985;16507;48890;2754;8926;10004;28977;12758;37903
330290;201707;3323;9473;2919;8816;483;1618;1584;4570;2067;6188
330300;201707;3237;10360;2904;9704;519;1947;1599;5136;2118;7083
330310;201707;2240;6232;1868;5578;215;652;1159;3450;1374;4102
330320;201707;13140;38893;12245;37486;1593;5353;8880;26866;10473;32219
330330;201707;28732;77295;24979;71460;4232;13527;14978;41387;19210;54914
330340;201707;14562;41401;11441;35794;2712;9153;3867;11743;6579;20896
330350;201707;88998;252977;79421;239319;10761;34839;53550;160548;64311;195387
330360;201707;6220;17748;5875;17247;647;2020;4461;12997;5108;15017
330370;201707;3622;12595;3239;11799;1064;3988;1023;3749;2087;7737
330380;201707;5135;16217;4296;14515;1036;3871;1441;4640;2477;8511
330385;201707;3920;13252;3570;12562;1033;3851;1380;4912;2413;8763
330390;201707;22564;72290;19578;66187;4801;17495;7920;26141;12721;43636
330395;201707;3094;8879;2812;8425;231;833;1863;5469;2094;6302
330400;201707;2737;8311;2478;7839;284;1105;1606;4703;1890;5808
330410;201707;2877;8564;2253;7390;425;1548;1017;3148;1442;4696
330411;201707;2402;7292;2090;6639;239;889;1305;3932;1544;4821
330412;201707;1414;4662;1183;4182;215;833;553;1830;768;2663
330414;201707;24136;66783;20889;62200;3798;11234;12295;36908;16093;48142
330415;201707;3442;10337;2828;9267;633;2093;1129;3771;1762;5864
330420;201707;10032;27934;6881;22273;1397;4908;1646;5083;3043;9991
330430;201707;7444;21560;6571;19944;1324;4412;3129;9133;4453;13545
330440;201707;1567;5144;1404;4827;416;1604;422;1312;838;2916
330450;201707;1378;4422;1211;4129;242;957;595;1967;837;2924
330452;201707;14137;40944;11389;35746;2634;8979;4833;14715;7467;23694
330455;201707;518207;1385957;417202;1223292;82964;260383;213891;616382;296855;876765
330460;201707;1179;3754;1024;3469;222;821;434;1422;656;2243
330470;201707;4336;12743;3845;11881;899;3028;1734;5206;2633;8234
330475;201707;7881;23783;6942;22233;2012;6988;2716;8481;4728;15469
330480;201707;5781;16544;5161;15609;845;2762;3069;9055;3914;11817
330490;201707;111798;288446;98916;269294;11307;32967;67289;180592;78596;213559
330500;201707;5456;16267;5193;15819;655;2215;3714;11196;4369;13411
330510;201707;37827;113280;33376;106131;10399;33250;13681;44633;24080;77883
330513;201707;1349;4003;1231;3794;387;1238;486;1500;873;2738
330515;201707;3040;9209;2627;8398;877;2887;706;2243;1583;5130
330520;201707;11148;33432;9929;31210;1998;6749;4559;13981;6557;20730
330530;201707;1480;4191;1251;3772;297;985;537;1525;834;2510
330540;201707;2967;8540;2434;7563;657;2157;842;2507;1499;4664
330550;201707;7860;25880;6945;24110;2824;10185;1247;4481;4071;14666
330555;201707;9928;28874;8860;27289;1650;5283;5298;16547;6948;21830
330560;201707;4322;12803;3817;11857;595;2010;2072;6227;2667;8237
330570;201707;3131;9156;2647;8329;617;2038;1266;3960;1883;5998
330575;201707;5346;14931;4770;13882;617;2062;3228;8995;3845;11057
330580;201707;13463;41554;11207;37011;3066;10709;4154;13580;7220;24289
330590;201707;1567;4689;1459;4531;201;673;1004;3129;1205;3802
330600;201707;11477;33116;9169;28984;1552;5360;4274;13365;5826;18725
330610;201707;8831;27011;7918;25393;1265;4583;4446;13889;5711;18472
330615;201707;1637;5633;1509;5422;564;2123;558;2053;1122;4176
330620;201707;3542;12032;3120;11146;1142;4367;625;2174;1767;6541
330630;201707;23826;67407;19306;59424;2727;9757;11074;32631;13801;42388
350010;201707;1870;5391;1196;4029;301;1044;120;359;421;1403
350020;201707;506;1393;338;1064;44;148;158;457;202;605
350030;201707;4548;13854;3482;11701;953;3470;849;2760;1802;6230
350040;201707;481;1581;346;1267;68;277;105;351;173;628
350050;201707;896;2679;715;2322;169;637;211;578;380;1215
350055;201707;684;1950;581;1779;81;270;380;1155;461;1425
350060;201707;115;349;95;320;23;87;44;149;67;236
350070;201707;3966;11434;2543;8494;498;1759;643;1949;1141;3708
350075;201707;576;1871;442;1586;180;653;69;235;249;888
350080;201707;682;1943;424;1368;62;220;162;504;224;724
350090;201707;615;1604;393;1158;90;250;127;373;217;623
350100;201707;2035;6130;1431;4926;260;1045;500;1600;760;2645
350110;201707;467;1411;350;1153;33;127;189;599;222;726
350115;201707;1271;3767;1106;3434;222;744;527;1494;749;2238
350120;201707;838;2399;519;1722;69;221;257;916;326;1137
350130;201707;3434;9948;2956;9011;381;1298;1640;4718;2021;6016
350140;201707;589;1926;487;1718;52;232;267;903;319;1135
350150;201707;482;1535;415;1398;141;506;103;342;244;848
350160;201707;9670;26476;6283;20110;1121;4049;2774;8221;3895;12270
350170;201707;1556;5153;1300;4532;318;1178;309;1030;627;2208
350180;201707;1151;3117;693;2130;116;389;306;913;422;1302
350190;201707;3302;9969;2548;8397;545;2072;982;2728;1527;4800
350200;201707;381;1148;340;1068;29;99;222;680;251;779
350210;201707;5239;13640;3696;11006;878;2713;1592;4675;2470;7388
350220;201707;2453;7683;2102;6869;446;1708;900;2714;1346;4422
350230;201707;775;2386;689;2219;161;550;298;941;459;1491
350240;201707;566;1691;435;1396;64;218;204;629;268;847
350250;201707;2169;7511;1913;7029;688;2709;536;1973;1224;4682
350260;201707;993;2586;656;1959;121;371;278;803;399;1174
350270;201707;4878;14501;4046;12730;764;2667;1742;5082;2506;7749
350275;201707;1986;6312;1777;5952;466;1662;673;2203;1139;3865
350280;201707;22238;53226;13936;39326;2805;8486;3753;10276;6558;18762
350290;201707;2364;7331;1840;6221;363;1371;606;1949;969;3320
350300;201707;580;1675;425;1342;89;265;148;445;237;710
350310;201707;900;2939;766;2615;106;409;292;939;398;1348
350315;201707;538;1632;394;1319;65;242;111;341;176;583
350320;201707;10997;33753;9716;31354;2765;9425;1735;5842;4500;15267
350330;201707;15020;40668;10325;30311;1802;5227;4274;11834;6076;17061
350335;201707;392;1202;346;1109;19;52;253;823;272;875
350340;201707;1094;3165;745;2455;146;543;230;756;376;1299
350350;201707;729;2208;617;2050;125;440;210;683;335;1123
350360;201707;907;2985;763;2660;205;698;288;1017;493;1715
350370;201707;588;1721;418;1324;110;350;72;210;182;560
350380;201707;4583;13233;3260;10725;750;2697;984;3018;1734;5715
350390;201707;9592;28672;8196;26032;2381;7742;2890;8985;5271;16727
350395;201707;376;1033;190;646;28;103;57;170;85;273
350400;201707;8190;22959;6345;19596;1608;5421;2032;5945;3640;11366
350410;201707;8678;27951;6854;24165;1800;6925;1458;4792;3258;11717
350420;201707;582;1816;443;1564;90;377;57;193;147;570
350430;201707;694;2118;585;1916;99;383;312;970;411;1353
350440;201707;1321;4060;1096;3530;253;799;444;1392;697;2191
350450;201707;7606;23284;6174;20364;1424;5013;1640;5156;3064;10169
350460;201707;1468;3949;886;2777;177;624;276;813;453;1437
350470;201707;249;649;205;570;21;76;129;327;150;403
350480;201707;766;2242;541;1786;89;337;93;273;182;610
350490;201707;1861;5493;1543;4947;355;1218;490;1450;845;2668
350500;201707;574;1685;492;1533;80;293;264;784;344;1077
350510;201707;1121;3313;840;2715;127;462;367;1141;494;1603
350520;201707;1675;5906;1317;5068;280;1156;384;1429;664;2585
350530;201707;2343;6796;1878;5845;553;1794;447;1315;1000;3109
350535;201707;1303;4108;1210;3952;153;608;822;2586;975;3194
350540;201707;1803;4949;1348;4149;324;1083;497;1539;821;2622
350550;201707;10543;27527;7294;22155;1190;4136;2896;8206;4086;12342
350560;201707;3445;11093;2989;9987;388;1388;1621;5332;2009;6720
350570;201707;19088;60319;16762;55698;4618;16701;6481;20404;11099;37105
350580;201707;1843;5732;1164;4018;229;847;118;324;347;1171
350590;201707;4062;12290;3149;10396;800;2988;1201;3566;2001;6554
350600;201707;44288;107631;28772;80347;4522;13830;12328;31821;16850;45651
350610;201707;6997;20495;5500;17658;1113;3888;2263;7052;3376;10940
350620;201707;419;1170;310;1002;44;176;142;432;186;608
350630;201707;1632;4588;1206;3763;167;621;527;1496;694;2117
350635;201707;7049;20023;5483;17301;1197;4143;2331;7106;3528;11249
350640;201707;831;2535;550;1830;92;336;141;421;233;757
350650;201707;7956;23344;5046;16540;1059;3817;1175;3596;2234;7413
350660;201707;4914;14041;3958;12323;754;2503;1847;5718;2601;8221
350670;201707;1555;4828;1423;4564;324;1087;701;2203;1025;3290
350680;201707;1120;3289;809;2676;180;670;324;1055;504;1725
350690;201707;921;2941;722;2516;153;580;266;866;419;1446
350700;201707;4346;12504;3081;10321;674;2515;1141;3519;1815;6034
350710;201707;2735;8337;2370;7624;364;1310;1319;4124;1683;5434
350715;201707;749;2250;667;2073;89;313;371;1077;460;1390
350720;201707;132;374;119;353;23;78;44;125;67;203
350730;201707;426;1509;391;1420;83;335;175;623;258;958
350740;201707;1791;5348;1259;4154;230;800;330;994;560;1794
350745;201707;538;1639;324;1099;52;191;131;403;183;594
350750;201707;9461;28276;7740;24921;1741;6264;2163;6328;3904;12592
350760;201707;13404;38336;10647;33435;2852;9734;2596;7258;5448;16992
350770;201707;685;1936;470;1499;65;213;223;709;288;922
350775;201707;618;1623;494;1414;52;184;235;642;287;826
350780;201707;1930;5754;1495;4925;392;1435;312;1069;704;2504
350790;201707;1902;5732;1366;4654;313;1149;240;695;553;1844
350800;201707;3063;9972;2855;9573;504;1890;1473;4772;1977;6662
350810;201707;2051;5663;1757;5242;403;1286;860;2668;1263;3954
350820;201707;631;1694;407;1242;59;186;142;403;201;589
350830;201707;859;2638;543;1899;74;272;136;426;210;698
350840;201707;2586;8673;2059;7556;652;2545;495;1735;1147;4280
350850;201707;6023;19604;4988;17358;1486;5424;1237;4284;2723;9708
350860;201707;3276;9797;3068;9467;149;628;2343;7103;2492;7731
350870;201707;2736;8461;2209;7557;472;1805;1157;3954;1629;5759
350880;201707;1322;4291;1057;3656;246;886;260;874;506;1760
350890;201707;676;1873;425;1326;49;161;127;324;176;485
350900;201707;5499;16722;3933;13308;1222;4544;436;1379;1658;5923
350910;201707;895;2541;768;2284;176;594;390;1103;566;1697
350920;201707;11694;31923;10267;29530;824;2753;7573;20871;8397;23624
350925;201707;4505;13756;3544;11847;841;2964;1138;3339;1979;6303
350930;201707;1545;4267;1104;3367;139;455;586;1706;725;2161
350940;201707;1831;5906;1661;5561;285;1100;930;2995;1215;4095
350945;201707;934;2872;771;2567;134;521;359;1110;493;1631
350950;201707;78999;231345;64000;198814;12083;41189;30394;88837;42477;130026
350960;201707;4869;15719;4139;14192;819;3193;2094;6837;2913;10030
350970;201707;4154;14006;3459;12291;1128;4353;533;1661;1661;6014
350980;201707;633;2025;544;1826;219;773;159;520;378;1293
350990;201707;1767;5711;1422;5062;370;1460;419;1384;789;2844
350995;201707;793;2631;747;2535;90;391;461;1473;551;1864
351000;201707;2832;8253;2275;7194;414;1450;871;2577;1285;4027
351010;201707;339;968;200;651;37;125;72;228;109;353
351015;201707;752;2519;633;2293;148;582;247;869;395;1451
351020;201707;8170;24843;7007;22935;1669;5693;3508;11490;5177;17183
351030;201707;2206;7292;1870;6472;389;1506;771;2482;1160;3988
351040;201707;3764;10963;3406;10358;381;1341;2401;7028;2782;8369
351050;201707;16248;43919;11386;35660;2644;9032;3607;11182;6251;20214
351060;201707;41518;115271;33387;101094;5686;18919;17584;51583;23270;70502
351070;201707;1400;3822;894;2895;244;875;90;243;334;1118
351080;201707;2774;7848;2096;6992;501;1834;918;2875;1419;4709
351090;201707;357;1212;280;1053;52;218;48;176;100;394
351100;201707;2458;7348;1683;5440;439;1474;415;1378;854;2852
351110;201707;6475;16392;3793;11945;772;2705;1010;2970;1782;5675
351120;201707;685;1995;513;1642;82;281;203;558;285;839
351130;201707;1070;2949;517;1786;88;303;96;321;184;624
351140;201707;1721;5677;1394;4961;417;1625;291;922;708;2547
351150;201707;1439;4921;1008;3807;212;849;81;247;293;1096
351160;201707;1228;4155;1065;3774;271;1022;348;1063;619;2085
351170;201707;1387;4301;1187;3858;153;559;624;1907;777;2466
351190;201707;850;2667;659;2191;106;349;196;633;302;982
351200;201707;1889;5453;1569;4880;175;608;728;2117;903;2725
351210;201707;1324;3591;900;2732;124;434;371;1010;495;1444
351220;201707;3006;9822;2750;9278;393;1501;1534;4972;1927;6473
351230;201707;1834;5514;1465;4839;311;1155;671;2081;982;3236
351240;201707;1260;3662;920;2950;220;731;354;1073;574;1804
351250;201707;1037;3003;629;2039;102;351;208;648;310;999
351260;201707;917;2669;771;2366;258;802;175;511;433;1313
351270;201707;329;1061;287;971;73;282;120;347;193;629
351280;201707;5216;14678;3859;11973;717;2479;1423;4167;2140;6646
351290;201707;967;2718;671;2125;152;490;264;800;416;1290
351300;201707;13544;42164;10170;35141;2445;9153;3145;10875;5590;20028
351310;201707;3061;9137;2455;8002;427;1601;1186;3575;1613;5176
351320;201707;899;2915;727;2484;131;494;245;773;376;1267
351330;201707;610;2174;551;2079;72;214;375;1536;447;1750
351340;201707;5736;18699;4845;16938;1298;4747;1801;6255;3099;11002
351350;201707;7806;24275;6780;22216;1556;5344;2976;9297;4532;14641
351360;201707;3963;12028;3597;11326;917;3145;1095;3164;2012;6309
351370;201707;2306;7065;1773;5880;375;1375;655;1964;1030;3339
351380;201707;41124;115151;35651;105097;6809;21335;16330;46700;23139;68035
351385;201707;267;781;188;609;28;97;62;182;90;279
351390;201707;1223;3780;1001;3316;262;1031;422;1230;684;2261
351400;201707;958;3050;882;2893;248;868;394;1283;642;2151
351410;201707;2414;7248;2050;6538;313;1029;1130;3520;1443;4549
351420;201707;309;852;203;649;47;149;52;165;99;314
351430;201707;790;2427;737;2331;89;319;555;1721;644;2040
351440;201707;3257;9601;2387;7688;463;1577;354;1012;817;2589
351450;201707;1555;4329;1211;3723;290;947;367;1170;657;2117
351460;201707;684;2008;596;1843;266;827;184;571;450;1398
351470;201707;1048;3008;895;2708;125;445;473;1332;598;1777
351480;201707;2744;8625;2451;8127;366;1512;1308;4137;1674;5649
351490;201707;1844;5937;1638;5496;167;709;1009;3191;1176;3900
351492;201707;310;964;258;829;19;73;133;394;152;467
351495;201707;210;670;160;537;28;106;68;218;96;324
351500;201707;32372;87606;24251;73035;5681;18215;9842;28415;15523;46630
351510;201707;10090;29273;8014;25138;1671;5656;3973;12081;5644;17737
351512;201707;503;1422;365;1114;54;157;164;484;218;641
351515;201707;2550;7282;1735;5605;386;1431;418;1249;804;2680
351518;201707;2232;6602;1536;5281;321;1239;609;1894;930;3133
351519;201707;765;2237;545;1745;91;324;128;300;219;624
351520;201707;828;2245;378;1301;61;234;111;339;172;573
351530;201707;376;1143;237;777;34;96;57;148;91;244
351535;201707;2351;5965;1773;5046;161;567;1105;2960;1266;3527
351540;201707;1873;5349;1377;4369;478;1647;194;529;672;2176
351550;201707;5301;15483;3742;11924;651;2300;1540;4553;2191;6853
351560;201707;451;1434;388;1289;86;324;78;246;164;570
351565;201707;168;564;149;516;31;107;59;191;90;298
351570;201707;14704;42512;12022;37171;2066;6991;6939;20542;9005;27533
351580;201707;307;844;188;597;32;91;57;194;89;285
351590;201707;481;1215;284;810;32;103;140;374;172;477
351600;201707;1793;4870;1414;4171;191;635;782;2164;973;2799
351610;201707;695;1841;496;1485;52;191;248;637;300;828
351620;201707;19183;59315;15114;51176;3000;11488;4618;13982;7618;25470
351630;201707;23424;69314;20497;64370;3988;13299;11765;36110;15753;49409
351640;201707;14482;41884;11916;37337;1881;6574;7030;21296;8911;27870
351650;201707;443;1314;209;712;35;135;33;95;68;230
351660;201707;803;2497;568;1902;119;426;106;312;225;738
351670;201707;4097;12727;3282;10772;580;2098;1497;4587;2077;6685
351680;201707;553;1697;327;1108;69;227;65;221;134;448
351685;201707;427;1358;368;1233;88;275;154;520;242;795
351690;201707;1064;3089;757;2424;136;477;277;790;413;1267
351700;201707;1084;3158;932;2856;210;621;357;1099;567;1720
351710;201707;584;1880;476;1622;67;276;191;590;258;866
351720;201707;1582;4652;1097;3566;202;713;349;1083;551;1796
351730;201707;1099;3022;842;2594;150;539;361;1060;511;1599
351740;201707;4040;10860;3163;9133;583;1792;1242;3330;1825;5122
351750;201707;1246;3923;796;2865;148;578;241;866;389;1444
351760;201707;3280;10061;2544;8432;628;2274;688;2037;1316;4311
351770;201707;2162;6742;1802;6027;550;1908;625;2006;1175;3914
351780;201707;1429;3961;788;2501;130;462;158;464;288;926
351790;201707;1155;3194;968;2887;180;499;553;1679;733;2178
351800;201707;555;1223;288;742;41;116;102;243;143;359
351810;201707;1054;2991;879;2672;92;259;586;1751;678;2010
351820;201707;2589;8074;1879;6544;379;1436;196;673;575;2109
351830;201707;4472;13282;3434;11141;520;1965;1724;5319;2244;7284
351840;201707;6856;22662;5931;20741;1411;5353;2183;7279;3594;12632
351850;201707;2102;5600;1445;4445;229;862;569;1566;798;2428
351860;201707;3104;9811;2665;8892;593;2091;1205;3965;1798;6056
351870;201707;27213;78945;22326;70128;6925;22878;8230;25594;15155;48472
351880;201707;120328;362283;99389;321163;28837;99873;26237;80405;55074;180278
351885;201707;665;2211;600;2075;164;584;243;804;407;1388
351890;201707;623;1916;508;1692;122;429;72;205;194;634
351900;201707;1193;3599;969;3216;254;881;296;984;550;1865
351905;201707;452;1383;349;1174;47;178;163;497;210;675
351907;201707;19872;56863;16515;50558;1175;4402;11463;34001;12638;38403
351910;201707;1075;3229;857;2734;183;641;339;1002;522;1643
351920;201707;989;2635;792;2328;109;378;396;1114;505;1492
351925;201707;1001;2939;814;2566;137;449;366;1063;503;1512
351930;201707;2845;8826;2715;8585;369;1531;2063;6191;2432;7722
351940;201707;1025;2984;823;2615;100;352;441;1394;541;1746
351950;201707;1575;4161;1118;3316;105;356;595;1716;700;2072
351960;201707;4700;13298;3484;10970;757;2581;1408;4345;2165;6926
351970;201707;5704;19796;5063;18531;1251;5036;2103;7295;3354;12331
351980;201707;924;2662;686;2145;129;450;293;827;422;1277
351990;201707;1509;4113;1156;3468;207;734;302;805;509;1539
352000;201707;2288;7345;2071;6883;323;1208;1092;3421;1415;4629
352010;201707;1765;5635;1523;5127;359;1301;235;837;594;2138
352020;201707;1485;4492;1256;4044;285;1008;501;1503;786;2511
352030;201707;4992;14364;4109;13049;819;2890;2154;6750;2973;9640
352040;201707;2070;6448;1544;5304;315;1168;238;754;553;1922
352042;201707;3612;9661;2184;6703;421;1393;918;2756;1339;4149
352044;201707;1813;5439;1130;4006;183;703;241;807;424;1510
352050;201707;11631;34882;7945;26568;1841;6932;1360;4032;3201;10964
352060;201707;728;2169;574;1840;104;366;230;685;334;1051
352070;201707;829;2017;653;1736;128;375;245;645;373;1020
352080;201707;466;1324;292;926;55;194;77;214;132;408
352090;201707;1348;4521;1083;3864;183;717;297;976;480;1693
352100;201707;3079;9170;2454;7995;574;2018;1026;3183;1600;5201
352110;201707;572;1953;480;1748;124;466;164;561;288;1027
352115;201707;498;1541;426;1401;62;211;246;812;308;1023
352120;201707;841;2639;688;2329;101;418;341;1051;442;1469
352130;201707;1890;5625;1222;4002;276;948;308;970;584;1918
352140;201707;1750;4928;1067;3480;155;548;378;1156;533;1704
352150;201707;785;2288;621;1971;154;505;299;930;453;1435
352160;201707;970;2651;738;2242;169;565;260;726;429;1291
352170;201707;2775;8240;2409;7416;512;1699;1108;3156;1620;4855
352180;201707;3089;8746;2603;7786;659;2092;924;2615;1583;4707
352190;201707;1192;3536;961;3081;149;566;314;863;463;1429
352200;201707;390;1304;296;1103;40;157;87;312;127;469
352210;201707;16410;43794;13539;39494;2100;6529;8503;24920;10603;31449
352215;201707;510;1524;467;1466;52;193;290;882;342;1075
352220;201707;13540;40602;10517;34759;3318;11728;2448;8044;5766;19772
352230;201707;12601;41577;10637;37612;3002;11632;3240;10766;6242;22398
352240;201707;11921;33818;9174;28887;2342;8300;2937;8360;5279;16660
352250;201707;21351;66963;18197;60798;5390;18825;6771;22300;12161;41125
352260;201707;5937;17673;4160;13891;705;2501;1900;6380;2605;8881
352265;201707;884;2707;758;2494;70;308;498;1562;568;1870
352270;201707;1629;5486;1337;4834;327;1239;364;1267;691;2506
352280;201707;2285;6589;1849;5844;258;986;882;2624;1140;3610
352290;201707;1154;3613;968;3164;176;683;410;1210;586;1893
352300;201707;996;2815;735;2291;138;503;323;891;461;1394
352310;201707;46400;132533;36363;115004;9553;31215;15515;49221;25068;80436
352320;201707;5706;17056;4770;15096;1064;3627;1755;4967;2819;8594
352330;201707;2046;6362;1714;5874;505;1876;571;1879;1076;3755
352340;201707;5159;15921;3946;13620;1076;3972;921;3004;1997;6976
352350;201707;1698;5564;1504;5116;272;1064;539;1675;811;2739
352360;201707;1076;3176;952;2955;170;608;630;1872;800;2480
352370;201707;872;2889;779;2662;85;354;456;1496;541;1850
352380;201707;924;2863;774;2581;217;792;191;606;408;1398
352390;201707;19685;51139;13007;38889;2130;7149;6081;17060;8211;24209
352400;201707;3791;10779;2747;8776;746;2575;963;2843;1709;5418
352410;201707;2915;8577;2442;7789;464;1622;1102;3363;1566;4985
352420;201707;905;2421;717;2071;134;422;275;774;409;1196
352430;201707;6412;18789;5405;17122;1691;5709;1798;5658;3489;11367
352440;201707;16985;51002;13777;44647;3000;10452;5511;17300;8511;27752
352450;201707;646;1944;415;1418;85;327;115;381;200;708
352460;201707;2482;7707;2028;6817;505;1844;607;1919;1112;3763
352470;201707;3940;10823;2898;8922;361;1254;1335;3799;1696;5053
352480;201707;4087;10782;3005;8822;578;1905;1197;3158;1775;5063
352490;201707;673;2283;517;1898;95;369;152;561;247;930
352500;201707;8945;24643;7183;21664;3587;11592;1263;3021;4850;14613
352510;201707;3064;9299;2400;8057;675;2435;666;2211;1341;4646
352520;201707;2107;7091;1841;6464;465;1723;740;2530;1205;4253
352530;201707;8816;27366;6458;21831;1516;5485;872;2409;2388;7894
352540;201707;520;1614;368;1265;67;242;100;338;167;580
352550;201707;845;2705;617;2195;138;539;130;434;268;973
352560;201707;629;1858;432;1397;77;248;91;256;168;504
352570;201707;1824;5799;1299;4652;347;1397;203;596;550;1993
352580;201707;847;2515;652;2115;101;370;221;649;322;1019
352585;201707;270;850;219;736;38;145;81;264;119;409
352590;201707;11953;35677;9414;30646;3164;10954;3207;9551;6371;20505
352600;201707;1850;5602;1475;4746;303;1046;601;1843;904;2889
352610;201707;3318;9997;2628;8750;630;2323;805;2506;1435;4829
352620;201707;5343;15773;4698;14718;1192;3847;2127;6631;3319;10478
352630;201707;624;1889;573;1768;122;449;253;709;375;1158
352640;201707;2669;7733;2207;6942;207;717;1443;4489;1650;5206
352650;201707;758;2269;560;1788;98;340;144;422;242;762
352660;201707;972;3393;825;3062;175;707;269;980;444;1687
352670;201707;10919;32177;6643;22678;1543;5807;491;1616;2034;7423
352680;201707;3040;9803;2286;8108;457;1803;857;2802;1314;4605
352690;201707;31775;85921;22985;68547;2767;9264;12245;34602;15012;43866
352700;201707;595;1749;506;1610;158;545;188;562;346;1107
352710;201707;5592;15916;4120;12990;1038;3630;1386;4132;2424;7762
352720;201707;8028;24985;6915;22569;2586;8604;1554;4833;4140;13437
352725;201707;439;1195;222;713;23;90;95;273;118;363
352730;201707;2340;7439;2098;6804;442;1577;938;2728;1380;4305
352740;201707;2204;5724;1700;4931;217;728;956;2655;1173;3383
352750;201707;472;1328;250;839;39;149;54;157;93;306
352760;201707;1339;4385;1093;3760;248;919;391;1257;639;2176
352770;201707;801;2431;648;2098;147;522;228;698;375;1220
352780;201707;661;2175;522;1828;109;424;164;557;273;981
352790;201707;649;1819;447;1431;65;217;140;426;205;643
352800;201707;1138;3964;843;3155;180;719;215;727;395;1446
352810;201707;1075;2789;675;2003;132;397;237;683;369;1080
352820;201707;630;1672;440;1372;93;299;100;318;193;617
352830;201707;547;1543;299;940;40;130;40;101;80;231
352840;201707;3993;13073;3541;12132;1032;3702;1373;4537;2405;8239
352850;201707;10510;29039;7653;24431;2010;6916;2452;7639;4462;14555
352860;201707;849;2839;771;2657;160;605;297;969;457;1574
352870;201707;852;2202;555;1544;56;197;293;730;349;927
352880;201707;2293;6080;1609;4766;247;781;671;1782;918;2563
352885;201707;263;817;220;729;28;88;137;449;165;537
352890;201707;686;1748;459;1278;71;238;185;430;256;668
352900;201707;19601;56102;14220;45202;2821;9901;5167;15339;7988;25240
352910;201707;395;1115;218;722;22;83;41;110;63;193
352920;201707;2445;7084;1847;5849;310;1091;854;2496;1164;3587
352930;201707;5867;17834;4676;15286;916;3184;1636;5097;2552;8281
352940;201707;21710;67918;17977;59634;5958;21669;1945;5725;7903;27394
352950;201707;371;1049;230;772;49;173;28;88;77;261
352960;201707;624;1823;367;1209;62;236;117;334;179;570
352965;201707;369;1050;226;725;57;200;31;80;88;280
352970;201707;3244;8007;2589;7009;263;738;1746;4736;2009;5474
352980;201707;1187;3619;993;3294;198;695;502;1678;700;2373
352990;201707;4122;12599;3596;11672;877;3217;1599;4875;2476;8092
353000;201707;438;1210;215;703;38;135;52;154;90;289
353010;201707;2990;8135;2152;6481;505;1694;602;1643;1107;3337
353020;201707;4057;10930;2326;7163;340;1142;743;2075;1083;3217
353030;201707;3642;10528;2828;8936;780;2622;544;1679;1324;4301
353040;201707;493;1378;405;1209;78;249;131;361;209;610
353050;201707;4876;15817;3937;13826;1029;3824;1369;4564;2398;8388
353060;201707;43679;124004;37636;114002;3916;14203;25957;75377;29873;89580
353070;201707;10219;31038;7446;25107;1697;6133;2073;6887;3770;13020
353080;201707;4889;15047;3475;12020;840;3190;879;2775;1719;5965
353090;201707;547;1826;493;1704;45;184;300;971;345;1155
353100;201707;297;834;131;449;18;64;22;63;40;127
353110;201707;7458;22569;6498;21001;1119;3980;3983;12869;5102;16849
353120;201707;649;1909;427;1398;76;279;119;341;195;620
353130;201707;2492;6983;1848;5938;554;1909;570;1784;1124;3693
353140;201707;2243;6122;1777;5204;283;929;905;2492;1188;3421
353150;201707;1614;4732;1269;4112;335;1100;364;1163;699;2263
353160;201707;690;1894;452;1429;81;274;146;407;227;681
353170;201707;458;1401;401;1329;87;382;200;601;287;983
353180;201707;9093;24926;7346;22006;1100;3604;4382;12954;5482;16558
353190;201707;3650;10781;2953;9252;454;1582;1512;4387;1966;5969
353200;201707;1141;3753;829;2873;199;747;200;667;399;1414
353205;201707;355;1183;319;1092;78;297;150;501;228;798
353210;201707;1052;2575;674;1885;40;144;406;1079;446;1223
353215;201707;455;1374;366;1173;67;248;121;322;188;570
353220;201707;592;1804;469;1556;117;404;101;316;218;720
353230;201707;744;2329;667;2205;162;576;230;697;392;1273
353240;201707;2147;6644;1846;6057;282;1087;1056;3311;1338;4398
353250;201707;1093;2903;811;2370;121;374;354;999;475;1373
353260;201707;914;2521;617;1947;135;467;168;496;303;963
353270;201707;634;1853;543;1671;88;266;242;719;330;985
353280;201707;658;2050;498;1661;115;415;129;399;244;814
353282;201707;1798;5556;1634;5226;231;796;910;2813;1141;3609
353284;201707;375;980;218;657;40;132;56;144;96;276
353286;201707;130;390;95;319;26;88;17;50;43;138
353290;201707;1005;2954;770;2501;95;379;421;1242;516;1621
353300;201707;1569;4716;1255;4032;239;895;456;1297;695;2192
353310;201707;253;716;204;639;43;151;83;241;126;392
353320;201707;606;1714;500;1508;59;192;290;847;349;1039
353325;201707;668;2121;503;1749;89;314;133;474;222;788
353330;201707;613;1711;431;1298;49;171;214;597;263;768
353340;201707;2959;8379;1974;6521;565;1969;526;1781;1091;3750
353350;201707;3368;9968;2459;7971;662;2302;529;1575;1191;3877
353360;201707;451;1465;407;1372;53;198;253;838;306;1036
353370;201707;606;1965;525;1789;57;214;290;943;347;1157
353380;201707;320;1039;260;906;48;176;79;269;127;445
353390;201707;5971;16153;4323;13109;875;2773;1523;4421;2398;7194
353400;201707;486;1472;399;1292;72;258;75;179;147;437
353410;201707;608;1773;508;1578;98;353;247;725;345;1078
353420;201707;591;1650;373;1145;90;271;61;174;151;445
353430;201707;2224;7269;1676;5948;431;1652;325;1072;756;2724
353440;201707;58463;179774;45091;150581;11518;39968;16348;52874;27866;92842
353450;201707;418;1203;308;957;56;204;111;320;167;524
353460;201707;3348;9522;2523;7859;305;1120;1058;3269;1363;4389
353470;201707;7491;22132;5574;18291;1241;4484;1442;4394;2683;8878
353475;201707;1470;4162;1097;3332;169;561;377;1038;546;1599
353480;201707;1382;4176;1225;3852;131;440;856;2636;987;3076
353490;201707;932;2702;691;2168;154;471;254;758;408;1229
353500;201707;1024;2674;837;2367;218;619;433;1214;651;1833
353510;201707;935;2965;696;2346;190;657;103;304;293;961
353520;201707;1144;3166;813;2574;118;421;354;1054;472;1475
353530;201707;2470;7037;2092;6322;269;910;1103;3177;1372;4087
353540;201707;2023;6072;1706;5498;398;1331;757;2386;1155;3717
353550;201707;6165;17182;4975;15086;781;2686;2642;7554;3423;10240
353560;201707;2116;6799;1734;6107;556;2099;398;1322;954;3421
353570;201707;527;1546;382;1246;91;288;162;522;253;810
353580;201707;2383;6812;2035;6197;389;1294;1145;3394;1534;4688
353590;201707;693;2037;473;1528;102;362;163;520;265;882
353600;201707;1801;4912;1555;4437;198;624;801;2173;999;2797
353610;201707;623;2095;471;1748;98;383;83;285;181;668
353620;201707;2319;7132;1877;6253;484;1687;464;1419;948;3106
353625;201707;481;1310;285;900;36;131;136;410;172;541
353630;201707;1414;4867;1108;4088;211;829;162;534;373;1363
353640;201707;1427;4033;1084;3338;138;492;565;1690;703;2182
353650;201707;8829;25517;6664;20979;1140;3793;2767;8306;3907;12099
353657;201707;304;925;255;830;35;117;92;265;127;382
353660;201707;1072;2745;790;2223;206;649;232;534;438;1183
353670;201707;3550;11151;2987;9998;828;3068;1131;3506;1959;6574
353680;201707;699;2150;559;1907;152;564;202;655;354;1219
353690;201707;525;1387;255;845;29;92;39;112;68;204
353700;201707;2036;6062;1740;5474;254;870;936;2791;1190;3661
353710;201707;3489;8287;1709;5304;351;1047;515;1539;866;2586
353715;201707;542;1528;380;1200;28;105;103;293;131;398
353720;201707;1950;5874;1632;5384;313;1156;830;2625;1143;3781
353730;201707;4293;12740;3339;10651;609;2109;1291;3769;1900;5878
353740;201707;1777;5114;1298;4170;330;1147;327;975;657;2122
353750;201707;905;3028;672;2480;150;600;140;503;290;1103
353760;201707;10722;28310;8729;25534;1320;4295;5383;15474;6703;19769
353770;201707;665;2059;347;1231;64;255;35;83;99;338
353780;201707;4166;14022;3603;12811;1086;4151;839;2880;1925;7031
353790;201707;2242;7493;1815;6576;485;2025;440;1448;925;3473
353800;201707;16473;49396;13131;43276;3006;10720;5179;16700;8185;27420
353810;201707;1022;3229;781;2685;143;568;239;782;382;1350
353820;201707;1470;4782;1262;4276;240;947;562;1791;802;2738
353830;201707;636;1709;500;1480;67;211;257;721;324;932
353850;201707;1655;5076;1399;4525;375;1244;476;1520;851;2764
353860;201707;2611;8279;2133;7204;600;2120;588;1944;1188;4064
353870;201707;28233;80888;19945;64026;3482;12410;7401;21579;10883;33989
353880;201707;2784;8638;2340;7787;319;1221;1253;4059;1572;5280
353890;201707;2347;5793;1648;4638;237;739;881;2370;1118;3109
353900;201707;822;2524;613;2109;133;485;172;566;305;1051
353910;201707;1896;6560;1754;6315;247;866;1226;4555;1473;5421
353920;201707;2276;6655;1589;5227;346;1250;285;815;631;2065
353930;201707;4554;13534;3242;11049;855;3174;504;1631;1359;4805
353940;201707;1117;3629;844;2970;165;620;229;758;394;1378
353950;201707;3155;9721;2661;8709;529;1891;1259;3812;1788;5703
353960;201707;587;1817;409;1410;84;283;106;355;190;638
353970;201707;599;1659;479;1454;53;176;289;853;342;1029
353980;201707;13770;39937;11488;35655;2189;7158;5865;17736;8054;24894
353990;201707;509;1447;413;1279;49;176;229;678;278;854
354000;201707;2418;6458;1450;4543;273;916;201;613;474;1529
354010;201707;370;1097;307;975;53;177;167;519;220;696
354020;201707;4100;12665;3479;11293;892;3130;1029;3023;1921;6153
354025;201707;877;2435;607;1907;123;402;175;559;298;961
354030;201707;488;1274;304;910;43;138;122;340;165;478
354040;201707;777;2054;509;1522;46;163;293;800;339;963
354050;201707;970;3005;738;2527;206;770;140;450;346;1220
354060;201707;4814;14687;3302;11270;867;3067;805;2566;1672;5633
354070;201707;2852;9285;2351;8142;599;2233;464;1451;1063;3684
354075;201707;1984;7061;1765;6550;361;1506;853;3042;1214;4548
354080;201707;1448;4303;1010;3331;179;632;306;893;485;1525
354085;201707;381;894;342;844;8;33;258;612;266;645
354090;201707;1347;3955;1275;3815;139;481;862;2544;1001;3025
354100;201707;14444;47424;11911;42473;2990;11434;4769;16573;7759;28007
354105;201707;959;2713;832;2522;137;427;528;1605;665;2032
354110;201707;707;1897;542;1657;166;564;128;338;294;902
354120;201707;1922;5286;1331;4057;221;733;494;1359;715;2092
354130;201707;6237;17631;4480;14198;1558;5260;267;662;1825;5922
354140;201707;26233;65750;16659;48576;3434;10730;4746;12784;8180;23514
354150;201707;3864;10184;2900;8446;579;1819;1157;3236;1736;5055
354160;201707;3417;10854;2648;9087;738;2649;774;2618;1512;5267
354165;201707;535;1716;451;1546;99;395;206;686;305;1081
354170;201707;1391;4342;1107;3655;157;574;504;1574;661;2148
354180;201707;478;1465;396;1278;67;247;154;419;221;666
354190;201707;1513;4698;1219;4060;234;860;377;1227;611;2087
354200;201707;964;2657;751;2275;90;293;360;1008;450;1301
354210;201707;659;2055;543;1838;72;294;287;896;359;1190
354220;201707;3053;8705;2510;7662;472;1555;1217;3578;1689;5133
354230;201707;662;2007;559;1833;87;348;269;807;356;1155
354240;201707;1260;4050;932;3282;174;655;204;667;378;1322
354250;201707;675;1845;436;1442;126;434;108;375;234;809
354260;201707;7526;22010;6076;19439;1587;5341;1867;6099;3454;11440
354270;201707;1173;3839;959;3373;186;706;318;1102;504;1808
354280;201707;706;2007;623;1861;111;405;349;956;460;1361
354290;201707;926;3215;828;2971;162;610;342;1220;504;1830
354300;201707;3800;12002;3470;11377;1081;3706;1283;4020;2364;7726
354310;201707;820;2483;663;2173;137;469;330;1062;467;1531
354320;201707;813;2324;594;1887;124;457;210;602;334;1059
354323;201707;497;1318;358;1049;54;149;134;363;188;512
354325;201707;1220;3937;908;3208;164;611;320;1062;484;1673
354330;201707;6617;19147;5207;16382;992;3598;2484;7140;3476;10738
354340;201707;23996;71753;19322;63444;5371;19059;6742;21392;12113;40451
354350;201707;1089;3151;948;2866;185;641;527;1486;712;2127
354360;201707;471;1462;291;1053;51;166;25;95;76;261
354370;201707;1108;3653;944;3308;125;526;501;1698;626;2224
354380;201707;800;2382;601;1980;162;617;88;242;250;859
354390;201707;13607;38181;9207;29767;1796;6231;1992;6222;3788;12453
354400;201707;1622;5571;1307;4781;262;1034;391;1403;653;2437
354410;201707;5387;16256;4415;14345;1083;3800;1726;5398;2809;9198
354420;201707;1295;3800;920;2945;172;588;406;1252;578;1840
354425;201707;2207;6267;1838;5529;541;1695;501;1529;1042;3224
354430;201707;1367;4349;1218;4056;224;851;544;1728;768;2579
354440;201707;575;1670;392;1276;49;166;153;458;202;624
354450;201707;406;1173;245;810;34;126;42;125;76;251
354460;201707;1014;2775;694;2138;127;419;288;887;415;1306
354470;201707;604;1577;465;1310;36;134;230;575;266;709
354480;201707;748;2024;605;1784;69;216;360;1006;429;1222
354490;201707;745;2432;608;2099;87;334;262;854;349;1188
354500;201707;2147;6734;1879;6300;659;2470;412;1346;1071;3816
354510;201707;824;2283;748;2132;102;270;433;1208;535;1478
354515;201707;254;828;200;705;40;162;73;250;113;412
354520;201707;8136;25893;4687;15937;827;3199;2009;6272;2836;9471
354530;201707;3392;11133;2918;10118;730;2745;1125;3798;1855;6543
354540;201707;1202;3554;953;3081;281;959;237;771;518;1730
354550;201707;487;1402;385;1211;78;264;195;589;273;853
354560;201707;1809;4929;1052;3235;154;509;468;1353;622;1862
354570;201707;1120;3086;505;1589;95;323;74;200;169;523
354580;201707;10795;29910;7383;23459;1282;4419;2846;8482;4128;12901
354600;201707;1660;5210;1391;4694;259;989;709;2317;968;3306
354610;201707;366;1054;209;681;35;122;52;151;87;273
354620;201707;426;1329;333;1154;60;261;139;429;199;690
354625;201707;310;947;193;665;26;99;44;117;70;216
354630;201707;2177;7082;1871;6438;743;2705;219;710;962;3415
354640;201707;3186;10393;2449;8639;505;1990;456;1458;961;3448
354650;201707;883;2585;751;2311;93;312;488;1509;581;1821
354660;201707;2454;6676;1765;5489;140;524;1147;3508;1287;4032
354670;201707;1099;3367;830;2724;204;732;207;612;411;1344
354680;201707;4517;14240;4081;13368;1074;3688;1892;6134;2966;9822
354690;201707;761;2430;520;1855;107;402;114;383;221;785
354700;201707;1060;2963;737;2260;145;508;294;782;439;1290
354710;201707;520;1522;382;1226;36;137;183;530;219;667
354720;201707;268;724;144;454;43;139;21;63;64;202
354730;201707;9360;28468;7018;23941;1293;4899;3332;10833;4625;15732
354740;201707;322;923;132;476;15;70;18;59;33;129
354750;201707;2474;7296;1777;5950;384;1459;633;1971;1017;3430
354760;201707;1868;5804;1480;4982;465;1673;226;756;691;2429
354765;201707;311;869;148;501;15;52;29;95;44;147
354770;201707;2368;6394;1726;5261;510;1657;543;1588;1053;3245
354780;201707;56509;153880;46660;133617;7196;23094;24634;65920;31830;89014
354790;201707;830;2669;721;2448;114;405;353;1163;467;1568
354800;201707;2439;6924;2036;6314;433;1476;961;2870;1394;4346
354805;201707;1046;3076;769;2470;91;332;245;689;336;1021
354810;201707;558;1779;350;1293;54;227;72;253;126;480
354820;201707;930;3109;773;2763;148;593;176;565;324;1158
354830;201707;464;1214;333;977;111;327;105;291;216;618
354840;201707;718;2031;520;1613;91;289;251;752;342;1041
354850;201707;17718;52529;13046;43277;2434;9128;6105;18783;8539;27911
354860;201707;1344;4118;1111;3731;257;980;373;1123;630;2103
354870;201707;46985;133233;40664;120750;7948;25735;19467;55703;27415;81438
354880;201707;4501;12273;2396;7543;352;1279;760;1999;1112;3278
354890;201707;15787;44769;13191;40080;2644;8748;6011;17497;8655;26245
354900;201707;475;1394;319;1056;52;185;71;219;123;404
354910;201707;6271;18402;3723;13022;673;2625;215;674;888;3299
354920;201707;389;1134;233;793;40;165;44;125;84;290
354925;201707;248;758;133;478;34;125;21;65;55;190
354930;201707;324;836;185;591;25;76;80;256;105;332
354940;201707;1702;6012;1401;5217;486;1918;135;461;621;2379
354950;201707;1468;4505;1222;4079;151;638;693;2202;844;2840
354960;201707;799;2323;656;2098;124;448;304;926;428;1374
354970;201707;3935;12586;3393;11471;576;2208;1802;5844;2378;8052
354980;201707;28205;73082;19025;56909;2952;10188;8324;22905;11276;33093
354990;201707;57008;161433;44168;136545;6723;22695;22158;65775;28881;88470
354995;201707;1949;5665;1592;5082;370;1271;792;2444;1162;3715
355000;201707;1361;4287;1203;3991;294;1101;226;624;520;1725
355010;201707;3425;10520;2525;8336;820;2902;407;1334;1227;4236
355020;201707;3051;9712;2321;8219;802;3112;614;2071;1416;5183
355030;201707;1245685;3277560;1001789;2804642;205070;625482;440028;1156798;645098;1782280
355040;201707;2650;7967;2347;7437;397;1336;1456;4564;1853;5900
355050;201707;1082;3171;831;2676;239;779;144;452;383;1231
355060;201707;4599;14570;3709;12723;751;2923;1346;4159;2097;7082
355070;201707;7197;21391;6152;19594;1082;3941;3220;9556;4302;13497
355080;201707;874;2909;607;2285;104;447;36;122;140;569
355090;201707;1099;3615;911;3215;175;642;305;1083;480;1725
355100;201707;16907;50600;13941;45576;3135;11210;7361;23360;10496;34570
355110;201707;1160;3687;967;3322;341;1255;181;597;522;1852
355120;201707;639;1898;486;1607;84;319;188;598;272;917
355130;201707;651;1639;295;869;43;135;86;229;129;364
355140;201707;1207;3802;1110;3639;212;781;648;2143;860;2924
355150;201707;3675;10560;2976;9322;585;1960;1393;4320;1978;6280
355160;201707;1787;5488;1463;4911;406;1489;348;1102;754;2591
355170;201707;8375;23637;6640;20736;2132;6976;2104;6700;4236;13676
355180;201707;2743;8395;2167;7299;509;2025;674;2054;1183;4079
355190;201707;1496;4515;1253;4065;382;1348;445;1513;827;2861
355200;201707;787;2701;704;2530;313;1215;149;484;462;1699
355210;201707;2847;8615;2512;7897;300;1130;1565;4674;1865;5804
355220;201707;38555;113846;31480;99594;9649;32309;8643;25148;18292;57457
355230;201707;1458;3864;850;2596;161;479;195;548;356;1027
355240;201707;24320;68757;16976;53676;3628;12138;5896;18252;9524;30390
355250;201707;30685;92126;25002;81328;6828;23791;8439;26708;15267;50499
355255;201707;882;2390;531;1673;104;342;147;452;251;794
355260;201707;1240;3589;1024;3207;185;668;504;1457;689;2125
355270;201707;1608;4978;1312;4296;266;936;557;1708;823;2644
355280;201707;28101;79067;22139;67334;4141;13797;9158;26434;13299;40231
355290;201707;889;2778;694;2300;164;544;189;582;353;1126
355300;201707;1339;4219;1106;3712;247;893;312;1017;559;1910
355310;201707;1040;3052;807;2636;118;421;416;1375;534;1796
355320;201707;600;1788;509;1608;103;388;191;509;294;897
355330;201707;1947;5804;1435;4792;254;924;700;2239;954;3163
355340;201707;2893;7142;2561;6650;383;999;1625;4181;2008;5180
355350;201707;1341;4346;1031;3655;232;910;294;1012;526;1922
355360;201707;1207;3624;1071;3316;134;426;723;2287;857;2713
355365;201707;343;985;192;674;43;133;34;117;77;250
355370;201707;6912;17636;5376;15592;1246;3827;2321;7118;3567;10945
355380;201707;3150;9191;2466;7742;499;1671;640;1751;1139;3422
355385;201707;1062;3347;949;3112;248;876;352;1073;600;1949
355390;201707;781;2272;596;1883;113;385;217;605;330;990
355395;201707;1890;5677;1389;4494;224;737;570;1754;794;2491
355400;201707;9387;30264;7992;27356;2428;8984;2087;6725;4515;15709
355410;201707;19422;60019;14971;51064;4162;15475;2876;9860;7038;25335
355420;201707;724;2541;639;2352;169;735;157;570;326;1305
355430;201707;3826;10218;3031;8836;575;1791;1451;4139;2026;5930
355440;201707;889;2678;637;2100;121;405;179;543;300;948
355450;201707;3890;10971;2322;7546;468;1586;644;1941;1112;3527
355460;201707;573;1523;373;1154;65;237;139;361;204;598
355465;201707;354;1116;266;906;55;199;61;190;116;389
355470;201707;993;2845;623;2039;177;595;189;600;366;1195
355475;201707;196;569;186;545;27;100;135;374;162;474
355480;201707;3104;10328;2789;9704;559;2164;1446;4881;2005;7045
355490;201707;1025;2929;633;2053;89;305;196;595;285;900
355495;201707;800;2597;672;2324;143;548;180;599;323;1147
355500;201707;7083;20563;4677;15135;805;2821;956;2886;1761;5707
355510;201707;1875;4950;1017;3222;140;490;272;766;412;1256
355520;201707;425;995;212;585;23;70;103;263;126;333
355530;201707;464;1064;180;534;20;72;42;102;62;174
355535;201707;629;1856;497;1619;140;519;142;396;282;915
355540;201707;8410;25511;7727;24391;1720;5806;4205;12908;5925;18714
355550;201707;755;2307;615;2018;102;369;234;757;336;1126
355560;201707;1189;3561;712;2443;147;543;46;137;193;680
355570;201707;238;733;128;462;22;97;22;70;44;167
355580;201707;1242;3399;839;2634;145;529;331;990;476;1519
355590;201707;216;578;168;491;23;77;91;254;114;331
355600;201707;1483;4135;1072;3301;291;997;335;950;626;1947
355610;201707;1688;4622;1240;3768;204;661;544;1582;748;2243
355620;201707;4518;13773;3599;11659;554;2111;1653;4837;2207;6948
355630;201707;2758;7982;1873;6234;409;1423;552;1858;961;3281
355635;201707;977;3028;828;2788;110;404;531;1843;641;2247
355640;201707;2855;9002;2078;7413;470;1783;353;1238;823;3021
355645;201707;4005;12676;3413;11713;468;1927;2032;6806;2500;8733
355650;201707;7240;21312;6256;19455;1278;4506;3531;10177;4809;14683
355660;201707;1317;4002;1044;3397;152;606;503;1451;655;2057
355670;201707;3030;9268;2167;7164;382;1444;906;2618;1288;4062
355680;201707;1765;5707;1180;4200;312;1182;119;386;431;1568
355690;201707;542;1718;379;1369;115;438;18;41;133;479
355695;201707;247;808;146;523;13;53;17;53;30;106
355700;201707;5748;18237;4881;16289;1256;4249;1893;6169;3149;10418
355710;201707;9656;23774;5773;16649;1148;3506;1599;4293;2747;7799
355715;201707;369;1083;233;763;63;226;49;145;112;371
355720;201707;1497;4832;1238;4274;268;970;438;1369;706;2339
355730;201707;879;2831;740;2495;218;738;211;667;429;1405
410010;201707;1352;4111;1115;3568;258;906;180;571;438;1477
410020;201707;1184;3760;992;3339;304;1014;305;1034;609;2048
410030;201707;1175;3843;975;3381;257;927;227;801;484;1728
410040;201707;9972;31819;8543;29107;1984;7445;2682;8995;4666;16440
410045;201707;1052;2882;726;2259;126;444;207;584;333;1028
410050;201707;2755;7377;1750;5457;434;1436;221;614;655;2050
410060;201707;2256;6758;1889;6001;422;1383;723;2306;1145;3689
410070;201707;1743;4827;1316;3975;325;1081;407;1172;732;2253
410080;201707;1442;4036;1119;3435;201;695;448;1309;649;2004
410090;201707;1014;3036;941;2892;164;545;443;1405;607;1950
410100;201707;2655;8070;1967;6393;336;1269;270;819;606;2088
410105;201707;366;1117;234;793;36;152;40;112;76;264
410110;201707;3139;8825;2369;7266;360;1213;770;2268;1130;3481
410115;201707;545;1456;411;1209;76;239;142;386;218;625
410120;201707;2514;8519;2310;8094;897;3325;545;1894;1442;5219
410130;201707;1053;3218;984;3074;354;1228;268;710;622;1938
410140;201707;17784;45554;11471;34165;2343;7645;2396;6622;4739;14267
410150;201707;16261;41215;8512;25209;1640;5191;1339;3751;2979;8942
410160;201707;2973;8961;2636;8321;586;2051;952;3038;1538;5089
410165;201707;717;2090;575;1754;89;286;278;796;367;1082
410170;201707;2316;6564;1717;5205;454;1509;234;666;688;2175
410180;201707;11912;36924;10118;32850;1979;6929;4539;13776;6518;20705
410185;201707;537;1485;395;1210;81;258;97;271;178;529
410190;201707;2078;5969;1652;5070;357;1188;305;868;662;2056
410200;201707;4109;10970;2801;8489;583;2027;455;1306;1038;3333
410210;201707;2708;7886;1919;6137;310;1126;426;1120;736;2246
410220;201707;670;1794;490;1463;67;236;133;402;200;638
410230;201707;1524;4669;1294;4189;268;977;516;1593;784;2570
410240;201707;4404;13091;3904;12030;1182;4112;536;1592;1718;5704
410250;201707;2765;7422;1920;5760;448;1432;394;1183;842;2615
410260;201707;1676;4628;1287;3973;269;933;544;1634;813;2567
410270;201707;573;1564;441;1302;48;160;199;569;247;729
410275;201707;766;2324;514;1713;81;292;208;690;289;982
410280;201707;2121;6116;1505;4805;325;1143;407;1173;732;2316
410290;201707;3438;10192;2751;8825;611;1992;994;3215;1605;5207
410300;201707;735;2013;581;1691;106;343;250;646;356;989
410302;201707;460;1239;258;832;26;88;136;440;162;528
410304;201707;1264;3916;1137;3636;277;939;473;1524;750;2463
410305;201707;1923;5026;1468;4261;359;1104;657;1867;1016;2971
410310;201707;2333;7252;2031;6713;434;1594;651;2126;1085;3720
410315;201707;725;2004;445;1472;85;312;126;388;211;700
410320;201707;1185;3572;776;2615;104;409;97;292;201;701
410322;201707;587;1698;333;1106;55;183;77;252;132;435
410330;201707;1418;3838;1090;3189;259;800;260;754;519;1554
410335;201707;933;2704;787;2410;128;449;330;918;458;1367
410337;201707;821;2144;582;1691;89;281;205;548;294;829
410340;201707;553;1559;373;1105;55;190;149;369;204;559
410345;201707;2079;5811;1303;4136;292;951;301;913;593;1864
410347;201707;735;1944;534;1571;56;196;161;441;217;637
410350;201707;1193;3502;888;2878;144;500;239;718;383;1218
410360;201707;4096;10681;3192;9083;338;1136;1770;4878;2108;6014
410370;201707;12131;35116;8645;26801;1441;4923;2662;7302;4103;12225
410380;201707;1389;3971;1201;3560;160;588;460;1291;620;1879
410390;201707;2591;7436;1878;5964;575;1948;360;1030;935;2978
410395;201707;951;2976;797;2652;191;711;338;1126;529;1837
410400;201707;4502;13692;3656;11871;714;2491;1330;4143;2044;6634
410405;201707;853;2345;688;2043;166;524;267;768;433;1292
410410;201707;1235;3766;1197;3714;271;1033;647;1925;918;2958
410420;201707;7005;22335;5679;19342;1360;5070;946;2864;2306;7934
410425;201707;2669;8341;2001;6902;374;1381;401;1283;775;2664
410430;201707;14113;37582;10246;30400;1836;5970;2913;8138;4749;14108
410440;201707;3031;10304;2718;9678;518;1906;1376;5163;1894;7069
410442;201707;2647;8636;2307;7871;705;2549;624;2076;1329;4625
410445;201707;2370;7451;1992;6709;478;1754;603;2092;1081;3846
410450;201707;1957;5514;1495;4580;348;1171;226;529;574;1700
410460;201707;1692;4893;1323;4205;346;1178;333;1002;679;2180
410465;201707;2380;7562;1956;6647;445;1551;649;2117;1094;3668
410470;201707;1846;5751;1436;4817;319;1190;270;892;589;2082
410480;201707;32266;88568;19381;62001;3153;10972;1711;4763;4864;15735
410490;201707;11726;34934;8609;28232;1834;6549;2359;7152;4193;13701
410500;201707;1611;4924;1237;4070;390;1437;173;472;563;1909
410510;201707;2461;6452;1641;4801;303;890;515;1419;818;2309
410520;201707;3078;10401;2869;9975;802;2857;1271;4494;2073;7351
410530;201707;1599;4389;950;2873;179;575;126;307;305;882
410540;201707;2957;8610;2098;6781;384;1309;757;2432;1141;3741
410550;201707;6511;18632;4566;14382;914;3150;676;1886;1590;5036
410560;201707;1328;3846;1037;3276;251;861;349;1009;600;1870
410570;201707;2646;8183;2282;7538;630;2300;512;1829;1142;4129
410580;201707;23098;67340;18645;58512;4168;14571;6190;18012;10358;32583
410590;201707;1385;4253;907;2979;149;515;194;571;343;1086
410600;201707;1863;5324;1468;4548;348;1072;472;1507;820;2579
410610;201707;781;2185;598;1828;64;220;215;625;279;845
410620;201707;1877;6119;1298;4681;312;1212;127;398;439;1610
410630;201707;2481;7321;1675;5464;347;1244;157;402;504;1646
410640;201707;3867;10476;2901;8690;782;2646;431;1184;1213;3830
410645;201707;1143;3820;1058;3673;456;1646;242;899;698;2545
410650;201707;2143;6535;1709;5585;516;1785;324;970;840;2755
410655;201707;1373;4869;1131;4389;62;231;733;3129;795;3360
410657;201707;799;2193;535;1629;114;376;176;466;290;842
410660;201707;3106;8619;1719;5497;336;1088;209;662;545;1750
410670;201707;938;2539;632;1882;121;368;241;695;362;1063
410680;201707;2903;9179;2172;7351;618;2079;490;1760;1108;3839
410685;201707;643;1804;543;1624;91;311;290;825;381;1136
410690;201707;120445;338665;84378;263457;15978;55181;21719;59357;37697;114538
410700;201707;2182;6328;1969;5912;460;1459;850;2407;1310;3866
410710;201707;936;2671;627;2013;129;421;192;561;321;982
410712;201707;807;2368;693;2156;221;747;246;754;467;1501
410715;201707;911;2890;636;2204;132;476;159;546;291;1022
410720;201707;3023;8901;2348;7456;416;1461;400;1134;816;2595
410725;201707;1126;3124;764;2408;126;416;119;346;245;762
410730;201707;529;1503;408;1272;107;364;72;224;179;588
410740;201707;892;2625;630;2091;113;415;246;812;359;1227
410750;201707;1877;5382;1532;4667;311;1029;489;1393;800;2422
410752;201707;324;857;149;464;26;85;46;122;72;207
410753;201707;359;1062;219;734;26;92;35;105;61;197
410754;201707;1215;3358;1044;3085;66;187;642;2099;708;2286
410755;201707;818;2029;582;1632;66;217;308;800;374;1017
410760;201707;2666;7762;2247;7030;618;2070;627;1963;1245;4033
410765;201707;14894;44387;11541;37816;1943;7173;1101;3398;3044;10571
410770;201707;932;2508;651;1968;137;421;171;514;308;935
410773;201707;1356;3783;1203;3554;188;645;836;2403;1024;3048
410775;201707;1457;4093;1315;3877;274;883;456;1300;730;2183
410780;201707;579;1562;375;1126;89;269;95;315;184;584
410785;201707;794;2411;666;2138;177;629;178;529;355;1158
410790;201707;463;1494;393;1318;116;410;41;106;157;516
410800;201707;2988;7280;2364;6269;274;812;947;2431;1221;3243
410810;201707;340;1012;271;875;43;159;111;353;154;512
410820;201707;800;2359;571;1819;130;437;78;238;208;675
410830;201707;30450;84387;23921;72861;6490;21872;7368;21358;13858;43230
410832;201707;1049;2966;898;2663;113;415;497;1383;610;1798
410840;201707;6898;19423;4445;14350;1057;3774;434;1101;1491;4875
410845;201707;1232;3601;1009;3151;203;707;348;1028;551;1735
410850;201707;2655;7869;2320;7279;514;1805;840;2639;1354;4444
410855;201707;592;1620;434;1299;59;198;180;505;239;703
410860;201707;3992;11103;3168;9466;573;1848;999;2843;1572;4691
410865;201707;1487;4792;1403;4641;342;1175;755;2596;1097;3771
410870;201707;1255;3686;1140;3509;110;375;763;2375;873;2750
410880;201707;3763;11706;3106;10345;600;2186;436;1492;1036;3678
410890;201707;934;2987;722;2524;164;631;127;435;291;1066
410895;201707;1077;3637;949;3339;366;1389;167;549;533;1938
410900;201707;939;2557;624;1930;92;309;167;457;259;766
410910;201707;391;990;266;753;25;85;137;352;162;437
410920;201707;851;2337;682;2051;165;563;220;652;385;1215
410930;201707;1586;4676;1299;4078;357;1297;303;899;660;2196
410940;201707;21592;67183;17840;59872;5385;19549;3292;11248;8677;30797
410950;201707;1847;5802;1700;5559;113;420;1330;4309;1443;4729
410960;201707;7811;21189;4878;15637;1354;4749;1142;3539;2496;8288
410965;201707;1085;3130;838;2620;189;613;318;934;507;1547
410970;201707;4240;12341;3249;10379;824;3053;491;1413;1315;4466
410975;201707;1596;4422;1216;3678;227;796;410;1212;637;2008
410980;201707;6406;17740;4268;13532;670;2341;1412;4284;2082;6625
410990;201707;1039;2982;677;2198;196;716;113;300;309;1016
411000;201707;465;1398;337;1117;53;197;71;193;124;390
411005;201707;486;1409;310;996;56;198;49;136;105;334
411007;201707;2370;7303;2068;6692;527;1817;599;1908;1126;3725
411010;201707;4115;13571;3663;12552;1031;3750;376;1188;1407;4938
411020;201707;2480;7437;2139;6834;640;2200;617;1901;1257;4101
411030;201707;690;1817;475;1348;88;263;134;342;222;605
411040;201707;773;2165;340;1077;62;210;51;148;113;358
411050;201707;1955;6647;1721;6126;521;1995;236;728;757;2723
411060;201707;1640;4785;1198;3844;243;928;186;526;429;1454
411065;201707;332;960;260;820;55;179;99;319;154;498
411070;201707;6411;18487;5114;15912;1123;3817;1499;4382;2622;8199
411080;201707;2216;6402;1907;5842;536;1752;427;1314;963;3066
411090;201707;845;2183;581;1710;62;211;95;250;157;461
411095;201707;1517;4072;1122;3304;184;591;337;922;521;1513
411100;201707;1181;3424;854;2707;116;435;208;653;324;1088
411110;201707;583;1685;287;984;29;101;18;48;47;149
411120;201707;1610;4807;1214;3909;359;1330;244;665;603;1995
411125;201707;4359;13857;4082;13320;1033;3519;1620;5361;2653;8880
411130;201707;707;2022;511;1600;117;368;153;523;270;891
411140;201707;2271;7435;1902;6581;461;1685;749;2636;1210;4321
411150;201707;4012;11186;2974;9095;648;2180;270;685;918;2865
411155;201707;1006;2746;698;2160;86;284;283;824;369;1108
411160;201707;288;805;218;663;44;129;48;156;92;285
411170;201707;756;2322;601;1962;141;482;190;617;331;1099
411180;201707;5671;16454;4582;14359;913;3125;1563;4851;2476;7976
411190;201707;1432;4054;1155;3470;273;888;245;641;518;1529
411200;201707;4543;13115;3546;11317;940;3239;990;3057;1930;6296
411210;201707;2049;5655;1628;4910;451;1519;187;503;638;2022
411220;201707;952;2670;777;2331;170;573;280;768;450;1341
411230;201707;1249;3425;804;2553;177;589;191;591;368;1180
411240;201707;1603;3816;904;2609;132;397;373;1018;505;1415
411250;201707;2049;5952;1660;5238;431;1502;468;1468;899;2970
411260;201707;353;926;223;683;31;98;87;246;118;344
411270;201707;1794;5472;1550;4960;252;930;686;2079;938;3009
411275;201707;1376;3900;1055;3222;227;735;272;770;499;1505
411280;201707;1563;4444;1007;3211;180;645;168;481;348;1126
411290;201707;734;2087;537;1707;112;359;183;576;295;935
411295;201707;1009;2763;875;2499;158;502;320;894;478;1396
411300;201707;1205;3058;798;2272;72;227;284;727;356;954
411310;201707;859;2284;677;1976;48;146;223;648;271;794
411320;201707;5150;14731;3721;12003;934;3123;741;2267;1675;5390
411325;201707;1534;4754;1362;4391;259;874;670;2194;929;3068
411330;201707;3128;9508;2531;8290;734;2646;590;1957;1324;4603
411340;201707;813;2402;525;1700;47;186;209;644;256;830
411342;201707;701;1940;568;1673;145;456;174;467;319;923
411345;201707;1012;2978;865;2691;177;617;425;1317;602;1934
411350;201707;2842;8311;2077;6714;561;2012;201;635;762;2647
411360;201707;583;1468;404;1175;61;217;137;343;198;560
411370;201707;46905;129318;36942;110851;4863;16820;17347;48337;22210;65157
411373;201707;1452;4289;1242;3921;215;758;417;1336;632;2094
411375;201707;1145;3094;837;2514;154;499;247;687;401;1186
411380;201707;1096;2965;701;2050;113;346;224;585;337;931
411390;201707;1792;5217;1394;4291;260;876;410;1148;670;2024
411400;201707;2209;6050;1751;5139;336;1080;567;1579;903;2659
411410;201707;2161;6425;1628;5216;374;1334;335;934;709;2268
411420;201707;4122;11345;2719;8469;425;1474;418;1039;843;2513
411430;201707;3364;9802;2775;8811;629;2147;1223;3812;1852;5959
411435;201707;505;1538;381;1266;90;303;125;384;215;687
411440;201707;2852;8839;2453;7993;663;2281;553;1890;1216;4171
411450;201707;2686;7588;2155;6685;425;1345;1050;3357;1475;4702
411460;201707;3699;10558;2016;6771;341;1317;180;545;521;1862
411470;201707;805;2371;552;1788;96;335;102;304;198;639
411480;201707;4573;13575;3383;11190;734;2663;595;1827;1329;4490
411490;201707;1483;4310;1204;3788;225;807;329;920;554;1727
411500;201707;1850;4852;1294;3857;230;778;346;986;576;1764
411510;201707;2046;5972;1684;5234;420;1433;312;971;732;2404
411520;201707;24466;66397;14996;46351;2472;8242;3547;9855;6019;18097
411530;201707;976;2698;679;2143;119;434;225;674;344;1108
411535;201707;484;1459;224;795;23;103;16;43;39;146
411540;201707;3067;8189;2214;6426;456;1433;577;1512;1033;2945
411545;201707;1020;3214;893;2955;105;380;554;1875;659;2255
411550;201707;766;2060;621;1819;141;457;96;261;237;718
411560;201707;2278;6621;1530;4947;238;854;104;257;342;1111
411570;201707;7350;18971;5280;15616;1161;3898;1171;3502;2332;7400
411573;201707;839;2388;766;2268;74;240;483;1420;557;1660
411575;201707;1646;4960;1387;4439;312;1073;398;1247;710;2320
411580;201707;4203;11480;2628;8481;320;1262;326;883;646;2145
411585;201707;828;2592;407;1431;70;252;54;161;124;413
411590;201707;363;1077;300;957;40;135;122;353;162;488
411600;201707;326;896;221;721;46;178;80;253;126;431
411605;201707;1679;4590;1108;3382;178;625;398;1136;576;1761
411610;201707;2255;6279;1701;5137;376;1207;574;1672;950;2879
411620;201707;2922;8756;2608;8249;524;1815;1367;4275;1891;6090
411630;201707;590;1570;379;1207;82;303;49;123;131;426
411640;201707;472;1427;347;1118;46;142;108;337;154;479
411650;201707;220;678;161;555;29;102;23;80;52;182
411660;201707;950;2507;675;2002;68;216;331;951;399;1167
411670;201707;1121;3102;876;2576;156;481;284;793;440;1274
411680;201707;1564;4516;1297;4005;245;854;603;1843;848;2697
411690;201707;3445;9928;2695;8502;582;1903;683;2241;1265;4144
411695;201707;722;2295;550;1888;91;340;173;617;264;957
411700;201707;1655;4701;1129;3635;228;805;152;446;380;1251
411705;201707;1837;6282;1620;5848;392;1401;798;3051;1190;4452
411710;201707;1733;4954;1377;4248;357;1189;215;666;572;1855
411720;201707;943;2585;738;2170;115;359;220;605;335;964
411721;201707;801;2320;628;1943;150;471;101;307;251;778
411722;201707;687;2068;446;1502;91;362;107;284;198;646
411725;201707;1388;4336;860;3016;189;701;147;515;336;1216
411727;201707;1730;5013;1215;3880;332;1100;189;543;521;1643
411729;201707;645;1657;438;1271;103;307;98;240;201;547
411730;201707;5156;14896;4304;13178;1361;4331;1127;3421;2488;7752
411740;201707;647;1820;369;1185;67;240;66;185;133;425
411745;201707;908;2644;697;2182;119;403;163;468;282;871
411750;201707;5150;15114;3948;12428;635;2177;1507;4511;2142;6688
411760;201707;7881;22471;6548;20160;2144;7025;1334;4251;3478;11276
411770;201707;3465;11015;2773;9409;772;2775;399;1301;1171;4076
411780;201707;2957;8822;2667;8284;654;2201;1197;3789;1851;5990
411790;201707;3425;9507;2196;6907;529;1833;372;1091;901;2924
411800;201707;1148;3303;775;2446;108;362;114;324;222;686
411810;201707;1755;4852;1406;4182;247;824;642;1787;889;2611
411820;201707;13175;42111;11071;37597;3764;13259;2714;9374;6478;22633
411830;201707;550;1382;380;1088;101;323;33;108;134;431
411840;201707;10648;29779;7724;23931;1620;5434;1647;5048;3267;10482
411845;201707;509;1539;304;1003;56;205;23;63;79;268
411850;201707;7719;22401;6247;19459;1743;5911;1257;3749;3000;9660
411860;201707;897;2688;693;2240;137;475;182;544;319;1019
411870;201707;860;2756;572;1966;107;403;100;309;207;712
411880;201707;2240;6385;1718;5416;452;1582;284;834;736;2416
411885;201707;1029;2798;817;2432;149;541;249;672;398;1213
411890;201707;1177;3522;790;2612;123;475;59;152;182;627
411900;201707;933;2886;595;2031;142;485;58;209;200;694
411910;201707;1165;3704;882;3051;244;891;220;713;464;1604
411915;201707;17994;47664;11199;34446;2081;6944;2491;6906;4572;13850
411920;201707;925;3045;799;2740;233;914;113;319;346;1233
411925;201707;616;1707;408;1316;101;342;93;284;194;626
411930;201707;5781;18959;5082;17553;2364;8869;374;1307;2738;10176
411940;201707;3231;10557;2758;9518;727;2633;569;1816;1296;4449
411950;201707;12880;39423;10947;35688;2362;8234;4763;15200;7125;23434
411960;201707;5584;16055;5005;14948;1030;3365;1899;5422;2929;8787
411965;201707;547;1513;385;1230;73;274;96;309;169;583
411970;201707;826;2215;697;2029;141;394;363;1162;504;1556
411980;201707;1646;4769;1398;4285;337;1100;422;1263;759;2363
411990;201707;34636;104432;25763;85759;5985;21910;7062;22381;13047;44291
411995;201707;2647;7736;2189;6927;629;2272;567;1662;1196;3934
412000;201707;2345;5720;1762;4727;195;634;939;2269;1134;2903
412010;201707;704;2328;538;1922;81;330;121;375;202;705
412015;201707;640;1879;527;1656;82;256;245;781;327;1037
412020;201707;417;1251;257;863;50;178;68;203;118;381
412030;201707;792;2379;558;1885;84;327;174;543;258;870
412033;201707;934;2765;667;2164;88;298;215;750;303;1048
412035;201707;976;2639;610;1963;114;385;218;676;332;1061
412040;201707;610;1818;439;1455;69;242;79;252;148;494
412050;201707;1768;4974;1317;4088;227;813;301;920;528;1733
412060;201707;7189;23673;6384;22016;1924;7156;1536;5179;3460;12335
412065;201707;799;2359;608;1955;116;401;177;540;293;941
412070;201707;1345;3560;994;2835;146;444;406;1139;552;1583
412080;201707;1584;4800;980;3418;125;503;33;97;158;600
412085;201707;444;1275;153;526;17;62;12;31;29;93
412090;201707;4953;14333;4518;13545;1019;3079;2314;7126;3333;10205
412100;201707;1865;5599;1493;4876;440;1552;297;973;737;2525
412110;201707;963;2703;676;2084;139;467;142;455;281;922
412120;201707;1713;5700;1446;5082;350;1363;395;1177;745;2540
412125;201707;684;2181;585;1952;141;503;178;577;319;1080
412130;201707;615;1813;452;1436;80;280;97;320;177;600
412135;201707;553;1555;298;923;47;147;94;264;141;411
412140;201707;1666;4720;1245;3878;270;929;220;621;490;1550
412150;201707;3084;8600;2614;7653;307;1019;1584;4486;1891;5505
412160;201707;1236;3900;761;2638;194;750;75;238;269;988
412170;201707;4659;13881;3827;12302;923;3212;1441;4343;2364;7555
412175;201707;1488;4722;1276;4281;269;952;540;1833;809;2785
412180;201707;1761;5194;1323;4349;261;1015;492;1440;753;2455
412190;201707;3424;9311;2558;7698;411;1327;898;2826;1309;4153
412200;201707;2111;6579;1527;5112;317;1118;343;1143;660;2261
412210;201707;660;1778;384;1200;81;303;57;145;138;448
412215;201707;3655;10794;3216;9955;792;2453;1595;5202;2387;7655
412217;201707;1103;3058;966;2799;87;303;657;1807;744;2110
412220;201707;5941;18297;5405;17343;1413;4546;2269;7607;3682;12153
412230;201707;2925;9417;2469;8430;482;1829;634;1978;1116;3807
412240;201707;9123;23316;5446;16453;991;3371;1143;3180;2134;6551
412250;201707;1956;5565;1570;4768;365;1185;227;598;592;1783
412260;201707;1351;3718;907;2744;129;439;304;813;433;1252
412265;201707;966;2899;841;2676;225;772;306;975;531;1747
412270;201707;909;2796;611;2057;100;381;203;632;303;1013
412280;201707;628;1919;475;1599;148;518;56;178;204;696
412290;201707;1067;2926;767;2377;134;467;230;665;364;1132
412300;201707;1653;4981;1418;4506;376;1306;280;822;656;2128
412310;201707;972;2831;812;2548;114;468;377;1175;491;1643
412320;201707;843;2246;598;1770;86;333;183;525;269;858
412330;201707;1503;4246;1080;3357;172;570;416;1282;588;1852
412340;201707;998;3068;670;2226;106;383;132;388;238;771
412350;201707;2626;7633;1749;5750;323;1174;62;123;385;1297
412360;201707;296;864;182;588;24;87;52;148;76;235
412370;201707;891;2637;652;2197;135;504;82;273;217;777
412380;201707;1635;4951;1246;4049;305;1023;250;841;555;1864
412382;201707;674;1860;472;1438;71;231;119;333;190;564
412385;201707;2355;7033;2041;6333;724;2298;489;1613;1213;3911
412390;201707;2250;6204;1988;5778;430;1357;874;2581;1304;3938
412395;201707;779;2224;590;1851;68;236;287;868;355;1104
412400;201707;917;2773;729;2343;172;587;159;540;331;1127
412402;201707;1954;5576;1523;4729;302;1046;248;703;550;1749
412405;201707;3494;10049;2172;7043;347;1264;90;240;437;1504
412410;201707;5184;15155;4125;13155;1005;3676;884;2689;1889;6365
412420;201707;426;1219;260;821;38;125;95;251;133;376
412430;201707;564;1557;395;1232;51;179;122;362;173;541
412440;201707;3113;9260;2321;7710;595;2182;450;1456;1045;3638
412450;201707;272;901;203;711;27;87;15;44;42;131
412460;201707;785;2395;663;2130;155;519;172;542;327;1061
412470;201707;1864;6201;1524;5343;449;1652;299;1102;748;2754
412480;201707;1138;3401;768;2472;122;432;97;243;219;675
412490;201707;936;2699;780;2377;156;476;277;807;433;1283
412500;201707;1936;5424;1587;4718;286;944;397;1046;683;1990
412510;201707;2226;7150;1716;5861;466;1697;286;896;752;2593
412520;201707;1485;4231;1069;3320;271;874;135;393;406;1267
412530;201707;571;1666;444;1369;83;278;74;213;157;491
412535;201707;1043;3285;784;2703;100;335;339;1282;439;1617
412540;201707;1254;3476;906;2755;127;458;244;747;371;1205
412545;201707;776;2144;534;1602;87;264;117;309;204;573
412550;201707;32275;95412;22423;73405;4770;16633;5124;15652;9894;32285
412555;201707;254;746;179;579;26;88;43;116;69;204
412560;201707;5442;16507;4123;13464;819;3007;918;2865;1737;5872
412570;201707;4325;12305;2817;9082;574;2062;355;1157;929;3219
412575;201707;909;2715;718;2246;132;443;242;698;374;1141
412580;201707;1352;3645;956;2860;165;553;364;1009;529;1562
412590;201707;447;1296;268;909;54;177;33;109;87;286
412600;201707;1448;4319;1081;3482;205;741;319;974;524;1715
412610;201707;793;2346;500;1609;105;348;154;460;259;808
412620;201707;1282;3877;1002;3327;259;1006;218;616;477;1622
412625;201707;8928;25736;6499;20792;1199;4216;721;2131;1920;6347
412627;201707;1041;3147;712;2382;206;736;153;501;359;1237
412630;201707;3202;9975;2443;8238;479;1610;687;2224;1166;3834
412635;201707;467;1346;323;1020;59;193;41;104;100;297
412640;201707;974;2834;599;1943;94;340;107;313;201;653
412650;201707;1647;4871;1379;4344;268;980;418;1174;686;2154
412660;201707;2763;7679;2058;6297;383;1304;503;1391;886;2695
412665;201707;646;1662;366;1122;82;263;87;249;169;512
412667;201707;1699;4756;1324;4001;234;795;458;1329;692;2124
412670;201707;554;1684;439;1459;111;402;96;305;207;707
412680;201707;1455;4304;913;3107;153;570;231;711;384;1281
412690;201707;796;2353;621;1985;128;413;138;459;266;872
412700;201707;1927;5568;1575;5018;413;1517;497;1529;910;3046
412710;201707;6481;20358;5470;18229;1173;4275;1395;4265;2568;8540
412720;201707;1441;4426;1037;3436;164;579;187;533;351;1112
412730;201707;2186;6504;1271;4323;265;952;157;504;422;1456
412740;201707;1614;4979;1151;3929;235;876;135;504;370;1380
412750;201707;4222;12362;3715;11493;537;1936;2176;6489;2713;8425
412760;201707;2576;7870;2385;7517;338;1203;1421;4316;1759;5519
412770;201707;11033;30067;6177;19705;843;2880;1034;2940;1877;5820
412780;201707;1318;3935;1105;3514;221;790;441;1329;662;2119
412785;201707;2249;6131;1663;4979;414;1250;671;2035;1085;3285
412788;201707;1452;4468;1233;4018;327;1160;384;1148;711;2308
412790;201707;1104;3281;743;2471;154;570;159;438;313;1008
412795;201707;1054;2895;693;2100;123;393;205;595;328;988
412796;201707;2625;7912;2340;7328;497;1692;930;2735;1427;4427
412800;201707;3278;9110;2442;7318;375;1268;854;2338;1229;3606
412810;201707;11771;31926;6947;21539;920;3247;1734;4576;2654;7823
412820;201707;7475;21515;5486;17509;1191;4059;1418;4544;2609;8603
412830;201707;374;1122;275;909;41;147;62;191;103;338
412840;201707;1877;5242;1476;4410;247;789;374;1096;621;1885
412850;201707;2967;8504;2326;7327;464;1587;708;2134;1172;3721
412853;201707;1866;5264;1594;4656;152;490;811;2162;963;2652
412855;201707;1425;4131;1054;3260;202;698;213;526;415;1224
412860;201707;1168;3341;908;2812;213;720;297;866;510;1586
412862;201707;761;1920;500;1451;78;254;146;421;224;675
412863;201707;1173;3865;1140;3808;116;426;845;2779;961;3205
412865;201707;742;2160;546;1769;111;388;154;514;265;902
412870;201707;943;2672;746;2334;268;934;127;395;395;1329
412880;201707;874;2576;651;2070;139;494;80;219;219;713
420005;201707;538;1591;314;1069;49;182;104;338;153;520
420010;201707;3285;8861;2561;7828;317;1023;1708;5250;2025;6273
420020;201707;624;2014;378;1381;52;238;46;128;98;366
420030;201707;442;1144;224;752;52;211;21;74;73;285
420040;201707;687;2190;406;1546;70;307;26;81;96;388
420050;201707;745;2072;493;1551;99;325;215;663;314;988
420055;201707;197;612;114;407;22;94;23;76;45;170
420060;201707;221;707;151;536;21;94;25;68;46;162
420070;201707;1279;4073;953;3277;185;700;333;1148;518;1848
420075;201707;162;434;84;260;16;52;11;20;27;72
420080;201707;602;1844;479;1594;140;478;117;387;257;865
420090;201707;422;1426;293;1090;77;297;50;199;127;496
420100;201707;1200;3685;1096;3535;181;621;699;2252;880;2873
420110;201707;299;1002;279;957;81;292;79;258;160;550
420120;201707;279;941;223;813;63;263;58;178;121;441
420125;201707;320;1130;288;1065;73;303;131;469;204;772
420127;201707;457;1294;167;596;35;148;17;43;52;191
420130;201707;1965;6527;1573;5710;413;1676;371;1217;784;2893
420140;201707;4261;12590;3137;10389;730;2722;469;1388;1199;4110
420150;201707;545;1521;382;1240;49;188;180;536;229;724
420160;201707;263;691;147;473;26;88;41;123;67;211
420165;201707;226;700;136;469;26;100;33;102;59;202
420170;201707;221;677;138;507;40;175;13;41;53;216
420180;201707;363;1084;199;697;26;88;44;149;70;237
420190;201707;270;905;167;630;34;130;19;62;53;192
420195;201707;1370;3992;1109;3510;286;997;213;633;499;1630
420200;201707;2770;8397;1696;5994;346;1404;307;978;653;2382
420205;201707;1191;3683;941;3196;174;628;508;1727;682;2355
420207;201707;1573;4553;1079;3564;271;1008;250;790;521;1798
420208;201707;589;1562;323;1101;72;278;112;395;184;673
420209;201707;276;854;171;600;38;150;61;207;99;357
420210;201707;2062;5893;1325;4668;310;1270;490;1618;800;2888
420213;201707;819;2814;754;2669;202;776;360;1278;562;2054
420215;201707;324;1019;205;742;55;196;16;67;71;263
420220;201707;179;633;145;561;42;184;41;149;83;333
420230;201707;4327;12684;3281;10788;632;2435;1262;3940;1894;6375
420240;201707;11793;32658;7688;24808;1138;4349;3505;10243;4643;14592
420243;201707;606;1794;474;1534;96;329;158;497;254;826
420245;201707;1341;3859;909;2994;133;513;363;1083;496;1596
420250;201707;519;1643;460;1531;98;372;209;671;307;1043
420253;201707;550;1390;404;1183;40;111;213;631;253;742
420257;201707;296;808;186;606;39;133;81;261;120;394
420260;201707;1174;3723;939;3290;180;705;408;1421;588;2126
420270;201707;691;2015;267;891;32;119;69;199;101;318
420280;201707;2084;5680;1276;4223;268;941;365;1150;633;2091
420285;201707;125;365;61;230;9;36;5;11;14;47
420287;201707;489;1356;373;1172;119;407;101;310;220;717
420290;201707;5935;17672;4072;13385;805;2833;1190;3548;1995;6381
420300;201707;6776;19833;4256;14391;888;3370;835;2539;1723;5909
420310;201707;886;2308;635;1778;79;258;450;1202;529;1460
420315;201707;962;3011;737;2552;206;768;239;815;445;1583
420320;201707;4568;14048;3758;12536;1181;4381;981;3113;2162;7494
420325;201707;220;733;189;663;39;140;63;216;102;356
420330;201707;980;3281;707;2595;140;559;197;675;337;1234
420340;201707;1428;4304;1032;3417;194;687;77;235;271;922
420350;201707;1487;4290;1064;3413;204;713;485;1523;689;2236
420360;201707;3007;9032;1811;6373;368;1440;169;569;537;2009
420370;201707;1783;4968;1421;4343;158;552;1009;3009;1167;3561
420380;201707;5286;15373;3467;11461;804;2857;893;2863;1697;5720
420390;201707;1355;3676;826;2579;147;537;218;487;365;1024
420395;201707;1302;3961;876;3012;134;515;91;268;225;783
420400;201707;1196;3537;831;2787;176;678;177;544;353;1222
420410;201707;717;1891;500;1518;78;272;310;923;388;1195
420415;201707;470;1429;343;1141;96;339;84;275;180;614
420417;201707;735;2309;589;1952;124;440;224;726;348;1166
420419;201707;307;993;215;784;73;293;11;41;84;334
420420;201707;10921;32360;8571;27822;3003;10497;1683;5066;4686;15563
420425;201707;1186;3118;782;2371;84;326;309;862;393;1188
420430;201707;3487;10427;2254;7513;491;1757;644;2005;1135;3762
420435;201707;271;802;170;582;39;164;73;225;112;389
420440;201707;842;2525;470;1566;150;552;108;308;258;860
420445;201707;374;1070;245;775;51;164;68;205;119;369
420450;201707;802;2438;559;1895;113;419;131;395;244;814
420455;201707;1994;5698;1631;5051;252;923;748;2198;1000;3121
420460;201707;9033;26072;6951;22373;1492;5506;2650;8050;4142;13556
420470;201707;1064;2760;586;1843;115;396;151;416;266;812
420475;201707;101;296;53;189;20;69;6;21;26;90
420480;201707;5095;14350;3626;11585;845;2934;828;2558;1673;5492
420490;201707;636;1650;344;1146;82;303;71;244;153;547
420500;201707;1493;4608;1098;3808;318;1205;326;1110;644;2315
420510;201707;129;457;100;379;22;99;50;178;72;277
420515;201707;79;242;64;219;14;55;18;63;32;118
420517;201707;885;2583;782;2407;80;265;536;1635;616;1900
420519;201707;471;1217;305;925;56;194;78;217;134;411
420520;201707;635;1656;324;1063;47;152;57;152;104;304
420530;201707;1232;3816;886;3060;189;728;210;614;399;1342
420535;201707;268;764;121;412;29;99;13;50;42;149
420540;201707;23291;64622;16253;50109;3500;11817;4463;11931;7963;23748
420543;201707;350;899;277;783;45;101;179;528;224;629
420545;201707;1633;5032;1306;4322;305;1087;390;1240;695;2327
420550;201707;4088;12560;2965;10356;766;3096;595;2041;1361;5137
420555;201707;356;1066;265;882;46;166;94;294;140;460
420560;201707;469;1324;348;1106;61;195;183;569;244;764
420570;201707;2263;7001;1740;5857;385;1461;606;1873;991;3334
420580;201707;1674;4819;1320;4238;299;1128;595;1812;894;2940
420590;201707;3380;9928;2138;7090;432;1566;337;930;769;2496
420600;201707;967;3083;858;2864;158;550;470;1588;628;2138
420610;201707;519;1570;295;1053;68;263;59;202;127;465
420620;201707;564;1717;495;1582;141;486;142;455;283;941
420630;201707;1010;3076;739;2421;169;610;273;823;442;1433
420640;201707;786;2304;381;1365;95;384;27;82;122;466
420650;201707;2546;7364;1661;5561;293;1033;421;1258;714;2291
420660;201707;464;1356;327;1071;59;217;82;250;141;467
420665;201707;707;1970;476;1545;74;281;163;479;237;760
420670;201707;1717;4981;1207;3927;235;919;306;877;541;1796
420675;201707;189;615;144;501;29;125;30;90;59;215
420680;201707;353;892;221;700;39;123;91;280;130;403
420690;201707;883;3034;632;2321;113;445;92;283;205;728
420700;201707;3129;9123;2416;7691;452;1614;852;2552;1304;4166
420710;201707;649;2104;490;1753;125;516;160;528;285;1044
420720;201707;1699;4791;1299;4220;384;1317;543;1736;927;3053
420730;201707;3245;9510;2627;8458;562;1984;1125;3514;1687;5498
420740;201707;845;2547;623;2094;166;602;167;517;333;1119
420750;201707;2131;6766;1569;5481;254;983;491;1510;745;2493
420757;201707;91;205;32;112;7;30;10;30;17;60
420760;201707;395;1217;193;646;39;133;20;59;59;192
420765;201707;545;1725;282;1044;53;215;56;204;109;419
420768;201707;1227;4047;992;3574;326;1161;441;1666;767;2827
420770;201707;570;1579;282;1023;56;230;57;206;113;436
420775;201707;644;1922;369;1252;77;285;51;152;128;437
420780;201707;1420;4268;845;2904;160;578;142;465;302;1043
420785;201707;257;758;193;607;37;113;45;128;82;241
420790;201707;1234;4142;948;3518;244;978;336;1183;580;2161
420800;201707;916;2561;456;1497;96;350;128;398;224;748
420810;201707;2000;6677;1591;5787;504;2066;328;1079;832;3145
420820;201707;9095;26482;6361;21816;1528;5868;1792;5917;3320;11785
420830;201707;2962;8966;2391;7907;644;2339;785;2548;1429;4887
420840;201707;1008;2928;473;1679;92;358;73;243;165;601
420845;201707;1567;4526;1033;3541;261;1034;229;731;490;1765
420850;201707;1487;4665;898;3319;197;798;71;243;268;1041
420860;201707;398;1116;236;803;62;241;44;144;106;385
420870;201707;1088;3022;846;2632;311;1094;215;597;526;1691
420880;201707;996;3317;778;2750;177;700;141;427;318;1127
420890;201707;8968;24154;4718;15486;810;2932;1053;3026;1863;5958
420895;201707;215;624;111;369;29;107;27;73;56;180
420900;201707;1818;5034;1171;3822;229;867;312;908;541;1775
420910;201707;23897;69348;16462;54909;2930;11000;5223;16032;8153;27032
420915;201707;574;2211;395;1666;80;349;168;664;248;1013
420917;201707;505;1522;234;761;36;126;92;273;128;399
420920;201707;169;488;76;262;10;41;11;28;21;69
420930;201707;18571;51952;14033;44084;2875;9945;5441;16340;8316;26285
420940;201707;2890;8394;2125;6914;563;2011;163;465;726;2476
420945;201707;212;633;137;455;33;119;37;114;70;233
420950;201707;588;1618;298;1024;36;163;70;230;106;393
420960;201707;973;2722;759;2351;152;538;283;799;435;1337
420970;201707;2655;8045;2021;6837;619;2257;354;1222;973;3479
420980;201707;447;1321;348;1172;127;462;120;445;247;907
420985;201707;499;1397;229;807;49;205;64;207;113;412
420990;201707;771;2169;424;1470;79;293;62;186;141;479
421000;201707;565;1890;367;1390;69;279;61;181;130;460
421003;201707;720;1906;257;857;31;106;22;60;53;166
421005;201707;145;453;111;394;31;120;50;191;81;311
421010;201707;5089;14305;3540;11535;812;2931;708;2094;1520;5025
421020;201707;456;1374;334;1162;33;130;202;699;235;829
421030;201707;770;2674;659;2394;220;883;113;380;333;1263
421040;201707;966;2348;591;1766;83;288;300;863;383;1151
421050;201707;1570;4444;909;3008;180;642;221;662;401;1304
421055;201707;220;611;112;364;22;67;25;72;47;139
421060;201707;578;1851;387;1369;85;329;131;447;216;776
421070;201707;675;2114;431;1507;96;370;52;162;148;532
421080;201707;776;3132;697;3013;92;299;529;2469;621;2768
421085;201707;526;1468;246;862;50;196;58;179;108;375
421090;201707;402;1105;191;621;25;88;42;126;67;214
421100;201707;975;2564;497;1552;117;383;50;139;167;522
421105;201707;1541;4543;1230;4032;222;776;492;1690;714;2466
421110;201707;987;3395;896;3190;289;1078;300;1006;589;2084
421120;201707;1326;4243;887;3180;121;502;212;655;333;1157
421125;201707;411;1125;304;948;85;289;88;245;173;534
421130;201707;3481;11281;2999;10320;895;3322;1138;3955;2033;7277
421140;201707;343;980;246;775;44;137;92;263;136;400
421145;201707;549;1644;346;1125;56;186;120;382;176;568
421150;201707;621;1767;442;1481;89;350;170;538;259;888
421160;201707;1165;3206;593;1919;108;406;214;645;322;1051
421165;201707;232;781;195;696;28;89;94;357;122;446
421170;201707;1308;3701;1044;3290;185;629;589;1847;774;2476
421175;201707;1224;3422;846;2736;161;619;300;857;461;1476
421180;201707;515;1387;245;821;60;229;41;132;101;361
421185;201707;406;1091;287;871;63;186;116;365;179;551
421187;201707;362;1067;247;801;40;126;88;268;128;394
421189;201707;408;1272;322;1083;67;239;87;271;154;510
421190;201707;11718;32852;7171;24000;1411;5262;1070;3283;2481;8545
421200;201707;907;2916;752;2594;169;624;253;831;422;1455
421205;201707;222;646;160;521;39;157;49;136;88;293
421210;201707;1383;4151;1017;3323;253;847;281;928;534;1775
421220;201707;1734;5825;1512;5303;443;1724;237;721;680;2445
421223;201707;523;1625;375;1327;69;263;136;489;205;752
421225;201707;1149;3643;980;3286;214;797;413;1403;627;2200
421227;201707;983;2825;727;2360;157;586;374;1154;531;1740
421230;201707;484;1531;401;1378;103;372;149;503;252;875
421240;201707;393;1236;195;722;19;93;20;64;39;157
421250;201707;1666;4697;1060;3627;286;1055;216;734;502;1789
421260;201707;358;1012;86;308;14;44;14;48;28;92
421265;201707;780;2317;686;2171;106;388;424;1309;530;1697
421270;201707;761;2089;401;1328;76;254;90;309;166;563
421280;201707;1644;5132;1312;4530;338;1326;535;1798;873;3124
421290;201707;972;2764;574;1852;97;335;95;265;192;600
421300;201707;296;878;218;715;57;227;83;246;140;473
421310;201707;218;671;170;554;35;132;57;178;92;310
421315;201707;325;957;189;656;30;104;22;82;52;186
421320;201707;681;2084;418;1433;76;261;71;180;147;441
421330;201707;622;1986;464;1672;116;441;102;373;218;814
421335;201707;474;1575;398;1419;83;342;79;283;162;625
421340;201707;1749;4875;1367;4251;193;726;718;2183;911;2909
421350;201707;1134;3591;921;3162;164;679;459;1482;623;2161
421360;201707;2846;8035;1781;5949;380;1520;500;1476;880;2996
421370;201707;559;1891;418;1556;119;474;110;403;229;877
421380;201707;941;2701;797;2429;131;426;392;1133;523;1559
421390;201707;185;518;80;268;16;58;27;84;43;142
421400;201707;304;1004;218;840;62;268;75;271;137;539
421410;201707;312;885;188;636;22;83;74;255;96;338
421415;201707;372;1186;160;579;36;139;24;80;60;219
421420;201707;783;2338;599;1947;97;352;244;730;341;1082
421430;201707;200;642;151;539;29;113;34;116;63;229
421440;201707;864;2436;569;1924;108;418;236;788;344;1206
421450;201707;438;1341;267;955;41;170;22;85;63;255
421460;201707;596;1651;319;1125;64;237;70;255;134;492
421470;201707;389;1263;302;1081;72;295;83;278;155;573
421480;201707;3154;8759;2068;6871;693;2666;291;768;984;3434
421490;201707;275;803;130;470;23;90;21;64;44;154
421500;201707;2091;7014;1678;6121;518;2083;200;673;718;2756
421505;201707;364;1166;317;1066;73;254;146;489;219;743
421507;201707;534;1589;352;1209;79;295;84;283;163;578
421510;201707;206;651;162;554;31;124;77;219;108;343
421520;201707;713;1968;457;1390;68;242;183;494;251;736
421530;201707;337;1041;199;711;42;185;37;106;79;291
421535;201707;674;1930;375;1310;42;168;164;519;206;687
421540;201707;338;902;251;760;55;181;89;248;144;429
421545;201707;853;2607;616;2152;143;555;185;621;328;1176
421550;201707;2155;6578;1825;6014;468;1756;688;2134;1156;3890
421555;201707;278;809;86;308;15;66;11;28;26;94
421560;201707;141;435;76;275;14;52;11;43;25;95
421565;201707;834;2436;696;2221;206;719;302;983;508;1702
421567;201707;612;2201;511;1951;260;1031;111;421;371;1452
421568;201707;523;1580;342;1163;70;261;98;330;168;591
421569;201707;240;720;113;405;21;73;18;68;39;141
421570;201707;1390;4153;816;2799;186;672;120;393;306;1065
421575;201707;360;1209;317;1085;62;224;152;507;214;731
421580;201707;3084;9682;2307;7973;539;2126;635;1945;1174;4071
421590;201707;215;652;169;562;23;80;84;270;107;350
421600;201707;471;1425;350;1147;84;287;75;231;159;518
421605;201707;642;1958;469;1632;89;346;133;454;222;800
421610;201707;1402;3767;966;2949;166;564;337;982;503;1546
421620;201707;4532;13446;2941;10154;815;3022;691;2359;1506;5381
421625;201707;375;1033;149;514;26;90;20;68;46;158
421630;201707;3172;9261;1769;5963;333;1258;284;852;617;2110
421635;201707;229;675;122;400;16;64;38;97;54;161
421640;201707;1104;3159;781;2547;164;564;273;873;437;1437
421650;201707;2253;6993;1625;5609;392;1554;208;560;600;2114
421660;201707;7921;25365;6580;22636;1398;5345;2135;6798;3533;12143
421670;201707;1101;3221;744;2422;170;636;216;659;386;1295
421680;201707;1146;3628;934;3179;308;1109;224;736;532;1845
421690;201707;1482;4713;1098;3835;231;906;175;554;406;1460
421700;201707;479;1560;265;998;50;209;62;215;112;424
421710;201707;209;685;85;306;14;57;28;89;42;146
421715;201707;227;607;122;397;28;94;47;145;75;239
421720;201707;1981;5783;1197;4171;304;1174;217;694;521;1868
421725;201707;154;446;109;354;29;105;35;95;64;200
421730;201707;591;1672;287;942;41;138;73;211;114;349
421740;201707;742;2334;513;1774;118;455;105;332;223;787
421750;201707;1032;2676;621;1894;99;323;212;581;311;904
421755;201707;319;915;184;587;33;122;62;178;95;300
421760;201707;992;2989;511;1791;79;287;86;281;165;568
421770;201707;2999;8767;2252;7332;546;1856;719;2445;1265;4301
421775;201707;467;1337;317;1056;61;223;101;322;162;545
421780;201707;1052;3541;789;2910;180;768;204;662;384;1430
421790;201707;820;2143;474;1615;200;732;119;361;319;1093
421795;201707;371;1081;222;699;37;127;65;191;102;318
421800;201707;2766;8212;2067;6888;447;1619;780;2483;1227;4102
421810;201707;697;2033;491;1616;110;415;143;429;253;844
421820;201707;991;2866;581;1956;96;352;73;200;169;552
421825;201707;1477;4538;1373;4344;180;663;922;2806;1102;3469
421830;201707;2535;8446;2221;7805;553;2143;716;2357;1269;4500
421835;201707;167;498;119;414;20;83;69;230;89;313
421840;201707;287;877;202;699;42;160;64;207;106;367
421850;201707;445;1375;254;886;43;169;59;183;102;352
421860;201707;303;924;195;695;37;148;52;160;89;308
421870;201707;3819;10722;2672;8395;717;2468;660;1974;1377;4442
421875;201707;401;1162;180;633;30;106;20;56;50;162
421880;201707;818;2459;606;2010;142;513;115;361;257;874
421885;201707;302;901;237;803;75;267;53;160;128;427
421890;201707;839;2806;704;2537;222;908;219;714;441;1622
421895;201707;397;1220;353;1147;67;236;212;689;279;925
421900;201707;1009;2780;640;2020;147;497;200;590;347;1087
421910;201707;434;1371;309;1084;63;270;59;167;122;437
421915;201707;482;1430;294;980;59;188;40;124;99;312
421917;201707;625;1738;425;1444;132;500;103;340;235;840
421920;201707;688;1936;437;1576;208;768;120;460;328;1228
421930;201707;3072;7955;1621;5363;415;1498;231;675;646;2173
421935;201707;654;2088;490;1726;100;407;180;589;280;996
421940;201707;239;803;146;535;28;129;34;108;62;237
421950;201707;3595;9706;1715;5721;365;1344;216;698;581;2042
421960;201707;182;532;131;440;27;106;25;84;52;190
421970;201707;2367;6403;1364;4321;352;1173;309;873;661;2046
421985;201707;434;1119;234;729;38;148;63;207;101;355
422000;201707;1473;4345;1235;3895;246;887;602;1867;848;2754
430003;201707;600;1898;505;1723;136;521;154;502;290;1023
430005;201707;345;999;238;789;61;212;92;287;153;499
430010;201707;2112;5641;1614;4792;337;1098;756;2218;1093;3316
430020;201707;688;1680;570;1520;85;269;351;890;436;1159
430030;201707;1132;2881;755;2174;210;623;183;525;393;1148
430040;201707;10904;28820;7597;22571;1927;6410;719;1949;2646;8359
430045;201707;702;1864;512;1476;69;206;216;604;285;810
430047;201707;302;702;136;402;19;63;42;119;61;182
430050;201707;949;2595;545;1716;121;381;127;385;248;766
430055;201707;306;781;140;422;12;38;66;191;78;229
430057;201707;71;178;39;114;9;28;6;9;15;37
430060;201707;17317;53665;14777;49344;4068;14614;5581;18752;9649;33366
430063;201707;1012;2893;780;2388;184;561;373;1154;557;1715
430064;201707;1249;3676;952;3077;260;895;265;839;525;1734
430066;201707;169;391;114;304;10;31;62;159;72;190
430070;201707;674;1811;165;557;20;75;16;40;36;115
430080;201707;737;2027;439;1429;96;350;141;404;237;754
430085;201707;968;2440;589;1761;106;343;170;525;276;868
430087;201707;810;2520;710;2331;129;483;355;1094;484;1577
430090;201707;709;1849;257;833;29;109;59;195;88;304
430100;201707;871;2297;455;1444;104;347;125;352;229;699
430105;201707;1053;2998;698;2339;162;614;255;839;417;1453
430107;201707;214;687;157;540;24;88;36;112;60;200
430110;201707;1974;5504;1594;4916;329;1066;752;2220;1081;3286
430120;201707;1673;4992;1144;3817;251;877;456;1549;707;2426
430130;201707;4157;11727;3522;10729;992;2814;1370;4845;2362;7659
430140;201707;1210;3641;795;2679;204;709;248;828;452;1537
430150;201707;745;1967;469;1430;102;350;118;356;220;706
430155;201707;320;885;184;595;28;103;44;128;72;231
430160;201707;17358;48770;14903;44668;3658;11709;5449;16801;9107;28510
430163;201707;2046;5779;1626;5067;235;813;927;2870;1162;3683
430165;201707;477;1175;128;428;17;57;15;38;32;95
430170;201707;970;2754;370;1325;64;247;53;159;117;406
430175;201707;903;2811;755;2459;184;589;321;1076;505;1665
430180;201707;821;2228;680;1981;120;411;378;1041;498;1452
430185;201707;513;1343;305;940;52;178;116;309;168;487
430187;201707;682;1972;538;1675;102;352;209;635;311;987
430190;201707;1601;4788;1382;4347;297;1000;655;2010;952;3010
430192;201707;181;550;78;248;9;28;9;24;18;52
430195;201707;389;1182;95;311;9;32;4;11;13;43
430200;201707;1348;4252;1153;3847;340;1166;315;1048;655;2214
430205;201707;552;1537;411;1254;31;115;287;854;318;969
430210;201707;6212;16268;3966;11581;582;1925;1338;3172;1920;5097
430215;201707;354;957;243;730;51;171;89;244;140;415
430220;201707;658;1686;222;737;36;142;44;127;80;269
430222;201707;266;825;215;711;40;145;87;268;127;413
430223;201707;363;994;296;876;60;180;139;420;199;600
430225;201707;35;92;15;47;4;11;5;12;9;23
430230;201707;1552;4541;1478;4449;306;838;1056;3322;1362;4160
430235;201707;274;871;219;739;43;171;71;227;114;398
430237;201707;566;1417;403;1139;38;124;237;628;275;752
430240;201707;1048;2618;725;2103;92;314;376;1041;468;1355
430245;201707;873;2662;677;2253;215;707;260;915;475;1622
430250;201707;1096;3129;967;2926;281;919;78;207;359;1126
430258;201707;145;404;110;348;11;39;46;145;57;184
430260;201707;696;1964;510;1590;91;296;236;771;327;1067
430265;201707;274;836;212;719;48;158;35;125;83;283
430270;201707;2865;7890;2467;7237;330;1100;1506;4302;1836;5402
430280;201707;4889;12841;3852;11033;867;2574;1597;4565;2464;7139
430290;201707;2452;6318;2247;6013;116;365;1915;5071;2031;5436
430300;201707;9307;26651;7677;23565;1683;5566;3360;10337;5043;15903
430310;201707;7036;20497;5404;17370;1111;3988;2197;6624;3308;10612
430320;201707;870;2495;521;1726;114;329;223;797;337;1126
430330;201707;699;1803;515;1460;131;386;209;531;340;917
430340;201707;728;1749;380;1158;75;244;178;522;253;766
430350;201707;6210;18443;5219;16354;1694;5530;1712;5161;3406;10691
430355;201707;413;1034;154;486;29;103;15;43;44;146
430360;201707;1002;2651;779;2226;172;535;269;709;441;1244
430367;201707;244;670;156;491;38;145;54;154;92;299
430370;201707;542;1497;326;1048;70;237;70;200;140;437
430380;201707;752;1942;419;1322;128;433;97;304;225;737
430390;201707;3906;10725;2395;7633;398;1417;248;722;646;2139
430400;201707;1371;3242;1002;2639;221;582;480;1216;701;1798
430410;201707;608;1572;428;1259;58;197;237;676;295;873
430420;201707;3540;10144;2766;8387;765;2411;877;2564;1642;4975
430430;201707;671;1812;413;1305;103;352;72;210;175;562
430435;201707;2053;5443;1472;4389;380;1164;396;1177;776;2341
430440;201707;4137;12805;3213;10697;712;2504;1333;4545;2045;7049
430450;201707;7030;19425;5775;17033;1613;5013;1803;5396;3416;10409
430460;201707;28674;83931;22109;72279;5712;20655;6744;21472;12456;42127
430461;201707;514;1347;162;512;21;70;34;99;55;169
430462;201707;296;829;194;652;32;116;37;140;69;256
430463;201707;4416;13645;3726;12373;808;2929;1743;5785;2551;8714
430465;201707;608;1647;509;1469;114;356;270;755;384;1111
430466;201707;3796;10002;3238;9118;722;2198;1654;4428;2376;6626
430467;201707;480;1386;402;1231;76;254;165;467;241;721
430468;201707;1406;3899;1190;3549;245;768;569;1687;814;2455
430469;201707;546;1536;59;205;6;15;11;27;17;42
430470;201707;7771;20600;5468;16759;1658;5388;981;3065;2639;8453
430471;201707;542;1786;486;1662;121;430;161;550;282;980
430480;201707;1030;2754;534;1721;89;311;89;253;178;564
430485;201707;166;475;77;248;14;53;15;38;29;91
430490;201707;335;972;210;699;43;157;83;293;126;450
430495;201707;396;1162;256;874;41;162;84;265;125;427
430500;201707;1157;3144;941;2799;220;735;406;1150;626;1885
430510;201707;23191;65660;17931;55385;4963;16695;5385;15498;10348;32193
430511;201707;384;1184;164;581;31;104;13;34;44;138
430512;201707;1065;2716;909;2453;246;702;263;737;509;1439
430513;201707;822;2120;449;1297;111;358;162;420;273;778
430515;201707;472;1319;337;1047;61;175;151;491;212;666
430517;201707;1167;3627;955;3192;173;607;460;1549;633;2156
430520;201707;1522;4146;913;2852;173;605;197;548;370;1153
430530;201707;1136;2977;466;1445;93;282;103;302;196;584
430535;201707;2649;7721;1997;6446;384;1338;777;2452;1161;3790
430537;201707;455;1498;380;1317;41;151;257;886;298;1037
430540;201707;729;1601;477;1259;84;231;276;724;360;955
430543;201707;509;1225;438;1150;87;209;290;799;377;1008
430544;201707;659;2093;537;1805;123;452;247;787;370;1239
430545;201707;1461;4573;1267;4289;375;1368;551;1869;926;3237
430550;201707;616;1725;353;1148;71;242;68;203;139;445
430558;201707;81;240;50;160;12;42;13;33;25;75
430560;201707;413;981;183;555;16;60;53;150;69;210
430570;201707;1124;2836;735;2100;127;415;332;838;459;1253
430580;201707;1260;3116;793;2350;125;408;343;1012;468;1420
430583;201707;173;454;41;129;5;14;7;25;12;39
430585;201707;303;763;176;504;34;113;72;177;106;290
430587;201707;173;537;135;439;30;105;54;184;84;289
430590;201707;1294;3448;1177;3250;96;307;936;2533;1032;2840
430593;201707;25;95;23;88;5;22;10;36;15;58
430595;201707;318;911;89;313;11;49;11;32;22;81
430597;201707;360;1042;241;745;26;86;70;182;96;268
430600;201707;1945;5259;993;3057;172;543;258;730;430;1273
430605;201707;1293;3789;987;3165;159;607;395;1250;554;1857
430607;201707;779;1818;564;1494;55;161;347;935;402;1096
430610;201707;7563;20056;5754;17204;1659;5413;1130;3375;2789;8788
430613;201707;293;719;112;349;9;30;29;74;38;104
430620;201707;711;1967;583;1715;149;476;243;688;392;1164
430630;201707;480;1433;169;555;25;85;30;87;55;172
430632;201707;657;1820;313;978;41;138;113;317;154;455
430635;201707;615;1722;463;1407;82;280;253;734;335;1014
430637;201707;490;1371;432;1260;71;234;237;646;308;880
430640;201707;1627;4302;805;2550;99;317;134;378;233;695
430642;201707;481;1247;308;920;56;166;125;381;181;547
430645;201707;279;640;109;309;19;56;27;79;46;135
430650;201707;1791;5685;1520;5122;366;1277;763;2608;1129;3885
430655;201707;163;415;141;372;33;108;68;149;101;257
430660;201707;5496;15221;4398;13258;1003;3254;1821;5443;2824;8697
430670;201707;503;1414;449;1314;40;127;314;940;354;1067
430673;201707;739;1720;311;923;69;207;84;243;153;450
430675;201707;244;725;72;249;13;56;16;44;29;100
430676;201707;3858;11198;3125;9844;683;2282;1162;3657;1845;5939
430680;201707;1102;3102;670;2189;137;445;126;391;263;836
430690;201707;4036;11409;3261;9899;990;3162;763;2316;1753;5478
430692;201707;248;791;186;674;16;69;125;454;141;523
430693;201707;1237;3308;718;2235;156;528;123;353;279;881
430695;201707;569;1521;369;1096;56;189;163;459;219;648
430697;201707;453;1264;325;1031;71;229;128;426;199;655
430700;201707;9712;24593;5000;15867;897;3193;448;1390;1345;4583
430705;201707;277;818;199;629;43;136;54;162;97;298
430710;201707;1729;4314;1302;3580;254;773;545;1472;799;2245
430720;201707;778;1940;509;1518;120;361;158;494;278;855
430730;201707;1628;4192;1042;3205;193;618;434;1379;627;1997
430740;201707;642;1792;363;1195;71;252;77;267;148;519
430745;201707;500;1424;246;795;39;124;41;138;80;262
430750;201707;1568;4229;1171;3545;232;766;575;1704;807;2470
430755;201707;509;1334;333;975;31;102;155;409;186;511
430760;201707;2880;7052;1948;5711;448;1458;760;2301;1208;3759
430770;201707;6446;18339;5117;15909;928;3154;2631;7939;3559;11093
430780;201707;2497;6576;1574;4902;298;996;492;1528;790;2524
430781;201707;450;1324;303;997;72;244;66;217;138;461
430783;201707;547;1324;327;944;43;141;147;394;190;535
430786;201707;78;264;54;210;8;30;11;41;19;71
430790;201707;4658;12738;3180;9712;659;2229;1262;3612;1921;5841
430800;201707;918;2529;627;1894;102;346;276;793;378;1139
430805;201707;566;1560;339;1056;37;111;157;473;194;584
430807;201707;495;1354;329;1017;48;175;106;300;154;475
430810;201707;737;2019;261;920;48;175;56;193;104;368
430820;201707;1444;4070;808;2714;169;589;148;481;317;1070
430825;201707;325;880;131;397;29;81;24;55;53;136
430830;201707;1829;5481;1635;5184;207;719;1109;3513;1316;4232
430840;201707;999;2955;869;2718;207;639;405;1289;612;1928
430843;201707;104;266;34;106;6;16;9;27;15;43
430845;201707;276;785;216;666;93;310;24;59;117;369
430850;201707;2470;7167;2073;6407;503;1672;876;2692;1379;4364
430860;201707;1055;2679;506;1558;93;333;181;519;274;852
430865;201707;597;1568;532;1466;160;470;243;651;403;1121
430870;201707;766;2108;370;1240;71;250;78;233;149;483
430880;201707;1201;3259;838;2548;227;718;246;759;473;1477
430885;201707;250;566;138;400;12;41;99;291;111;332
430890;201707;1636;4372;1100;3327;78;314;164;410;242;724
430900;201707;2779;7157;2113;6027;409;1296;926;2511;1335;3807
430905;201707;1115;3137;720;2309;152;514;156;481;308;995
430910;201707;1669;4863;1120;3639;242;904;389;1114;631;2018
430912;201707;501;1430;366;1187;48;166;222;725;270;891
430915;201707;588;1798;417;1486;110;403;139;531;249;934
430920;201707;18855;54821;16287;50182;2982;10096;8911;26662;11893;36758
430925;201707;140;311;61;169;10;28;20;58;30;86
430930;201707;9926;27037;6673;21161;1786;6037;1436;4808;3222;10845
430940;201707;1273;3862;716;2447;187;675;92;270;279;945
430950;201707;909;2432;604;1814;128;413;240;651;368;1064
430955;201707;185;521;73;233;14;46;13;39;27;85
430957;201707;235;769;197;694;35;113;92;337;127;450
430960;201707;1488;3811;1104;3141;236;761;513;1446;749;2207
430965;201707;1612;4290;1312;3767;90;330;995;2743;1085;3073
430970;201707;402;1104;230;736;33;108;89;275;122;383
430975;201707;565;1849;438;1540;104;389;155;548;259;937
430980;201707;393;1000;242;745;51;168;85;257;136;425
430990;201707;590;1808;384;1274;65;234;117;374;182;608
430995;201707;661;1840;478;1487;113;356;201;596;314;952
431000;201707;1610;4011;745;2251;119;388;45;118;164;506
431010;201707;2646;7270;1555;5179;270;1012;147;416;417;1428
431020;201707;10527;25276;6863;19108;1638;4816;1785;4723;3423;9539
431030;201707;338;944;153;531;35;121;17;62;52;183
431033;201707;2643;7903;2290;7345;590;1985;954;3207;1544;5192
431036;201707;218;576;79;249;8;21;16;42;24;63
431040;201707;1040;2817;746;2305;143;524;342;984;485;1508
431041;201707;514;1296;446;1202;102;279;208;577;310;856
431043;201707;478;1294;260;876;93;337;60;183;153;520
431046;201707;126;345;70;209;7;21;17;49;24;70
431050;201707;1668;4167;1193;3384;264;776;545;1545;809;2321
431053;201707;588;1825;457;1541;136;490;109;362;245;852
431055;201707;684;1775;616;1670;59;176;450;1201;509;1377
431057;201707;369;1068;227;751;45;163;55;160;100;323
431060;201707;5573;16372;4741;14866;1549;5207;1148;3707;2697;8914
431065;201707;556;1553;390;1228;68;224;110;328;178;552
431070;201707;632;1815;358;1163;86;289;57;145;143;434
431075;201707;252;776;184;631;32;129;58;199;90;328
431080;201707;687;2053;483;1583;93;323;130;411;223;734
431085;201707;769;2096;606;1742;103;294;348;987;451;1281
431087;201707;531;1513;459;1363;40;117;303;906;343;1023
431090;201707;515;1254;199;618;42;150;37;105;79;255
431100;201707;3408;9151;2731;8042;695;2240;938;2696;1633;4936
431110;201707;1495;3878;1126;3148;279;817;396;1033;675;1850
431112;201707;568;1816;510;1700;119;392;249;812;368;1204
431113;201707;472;1369;375;1178;114;377;110;359;224;736
431115;201707;1360;3865;1140;3476;198;662;606;1812;804;2474
431120;201707;2714;8107;2011;6623;621;2338;545;1615;1166;3953
431123;201707;435;1238;282;917;77;242;117;398;194;640
431125;201707;1339;3948;946;3098;284;960;219;795;503;1755
431127;201707;268;731;61;204;8;22;10;25;18;47
431130;201707;3438;9782;2373;7650;521;1783;694;2242;1215;4025
431140;201707;5269;12824;2907;8655;388;1282;876;2354;1264;3636
431142;201707;495;1411;409;1252;62;202;246;762;308;964
431150;201707;1036;3046;784;2505;175;591;276;891;451;1482
431160;201707;832;2350;664;2029;152;451;245;823;397;1274
431162;201707;563;1394;252;793;29;102;49;136;78;238
431164;201707;165;447;51;175;9;38;5;15;14;53
431170;201707;689;1857;470;1443;134;434;134;394;268;828
431171;201707;765;2191;664;1992;146;470;303;872;449;1342
431173;201707;472;1338;359;1138;135;458;83;261;218;719
431175;201707;1008;2746;798;2366;228;707;202;574;430;1281
431177;201707;773;2450;579;2067;179;703;192;672;371;1375
431179;201707;392;849;95;273;13;41;18;38;31;79
431180;201707;2268;6261;1520;4814;367;1253;288;884;655;2137
431190;201707;574;1569;318;1014;43;145;53;138;96;283
431198;201707;354;1154;314;1074;112;402;87;316;199;718
431200;201707;408;1133;110;375;12;34;0;0;12;34
431205;201707;265;766;114;398;26;85;43;153;69;238
431210;201707;725;1916;614;1756;163;457;296;879;459;1336
431213;201707;253;760;191;645;23;83;101;337;124;420
431215;201707;275;860;179;620;34;124;47;153;81;277
431217;201707;164;489;110;372;24;78;43;147;67;225
431220;201707;828;2253;461;1473;41;150;187;540;228;690
431225;201707;1352;3693;1033;3107;220;676;395;1228;615;1904
431230;201707;800;2318;595;1858;104;361;249;749;353;1110
431235;201707;137;384;37;116;7;22;4;9;11;31
431237;201707;476;1400;381;1244;66;252;188;587;254;839
431238;201707;29;101;23;84;8;35;6;20;14;55
431240;201707;3656;10573;3098;9598;794;2678;1188;3615;1982;6293
431242;201707;384;1130;324;1014;82;252;119;390;201;642
431244;201707;370;879;193;548;29;99;69;160;98;259
431245;201707;1241;3203;821;2391;160;501;320;907;480;1408
431247;201707;217;607;136;429;27;86;31;88;58;174
431250;201707;1442;4585;1255;4300;307;1098;506;1795;813;2893
431260;201707;353;981;177;594;22;96;53;156;75;252
431261;201707;266;873;222;771;44;158;88;302;132;460
431262;201707;427;1184;189;622;15;50;94;315;109;365
431265;201707;1440;3595;677;2072;101;328;188;477;289;805
431267;201707;302;849;173;529;10;40;106;300;116;340
431270;201707;2855;6927;1649;4879;419;1344;450;1350;869;2694
431275;201707;227;678;123;446;30;112;15;49;45;161
431280;201707;331;910;118;394;10;34;16;33;26;67
431290;201707;333;1009;242;808;39;151;54;153;93;304
431295;201707;78;222;32;108;2;12;7;16;9;28
431300;201707;390;973;62;234;1;4;5;17;6;21
431301;201707;277;855;87;300;8;25;10;24;18;49
431303;201707;773;2043;453;1374;52;176;146;422;198;598
431306;201707;2278;5831;1388;4221;177;614;423;1156;600;1770
431308;201707;36;121;33;109;16;57;11;34;27;91
431310;201707;726;2127;428;1426;78;269;125;423;203;692
431320;201707;766;2152;390;1318;73;275;61;184;134;459
431330;201707;2569;6350;1288;3998;296;1027;146;394;442;1421
431333;201707;417;1106;152;446;19;47;35;92;54;139
431335;201707;41;123;28;97;8;27;4;8;12;35
431337;201707;2581;7656;1857;6241;472;1730;275;931;747;2661
431339;201707;557;1511;385;1161;73;239;198;582;271;821
431340;201707;23450;61580;16992;50256;3875;12553;4188;11915;8063;24468
431342;201707;551;1333;412;1110;92;282;253;644;345;926
431344;201707;373;1009;253;781;8;29;177;541;185;570
431346;201707;285;719;106;324;15;46;21;64;36;110
431349;201707;755;2078;441;1338;66;210;153;423;219;633
431350;201707;4140;11894;3273;10256;798;2780;1073;3147;1871;5927
431360;201707;668;1662;410;1221;93;285;139;401;232;686
431365;201707;1567;4504;1335;4112;205;684;804;2508;1009;3192
431370;201707;4909;13528;3804;11620;939;3035;1446;4590;2385;7625
431380;201707;838;2567;753;2410;106;376;428;1360;534;1736
431390;201707;2781;7288;1628;5091;301;1059;430;1214;731;2273
431395;201707;1263;3688;998;3195;252;839;388;1262;640;2101
431400;201707;422;1287;205;676;31;95;40;130;71;225
431402;201707;1111;2687;709;1966;126;374;373;974;499;1348
431403;201707;195;582;164;528;45;171;67;189;112;360
431405;201707;4287;11827;3486;10630;594;2035;1861;5600;2455;7635
431406;201707;621;1893;484;1626;101;349;261;877;362;1226
431407;201707;552;1546;369;1182;86;285;123;368;209;653
431410;201707;14807;41812;9949;32207;2538;9201;2021;6231;4559;15432
431413;201707;207;507;76;247;8;32;13;35;21;67
431415;201707;708;2002;497;1613;112;412;148;436;260;848
431417;201707;535;1352;440;1211;70;215;261;695;331;910
431420;201707;1366;3618;1181;3329;230;667;528;1569;758;2236
431430;201707;586;1516;342;1034;63;210;89;238;152;448
431440;201707;22846;61748;17948;53864;5068;16088;5092;16326;10160;32414
431442;201707;123;375;74;254;14;47;3;9;17;56
431445;201707;492;1394;183;602;22;70;40;126;62;196
431446;201707;399;1176;290;918;77;257;65;200;142;457
431447;201707;595;1660;428;1331;74;231;205;624;279;855
431449;201707;795;2147;566;1685;51;156;279;825;330;981
431450;201707;2158;5095;1863;4676;199;586;1363;3276;1562;3862
431454;201707;62;208;54;187;12;45;20;72;32;117
431455;201707;708;1789;369;1044;65;186;125;315;190;501
431460;201707;3127;8459;2533;7316;663;1957;811;2401;1474;4358
431470;201707;1759;5022;1270;3968;265;850;433;1361;698;2211
431475;201707;203;600;36;144;4;19;1;1;5;20
431477;201707;710;1831;450;1298;58;171;202;534;260;705
431478;201707;267;689;82;241;14;44;11;25;25;69
431480;201707;3239;8714;2507;7483;439;1449;1201;3516;1640;4965
431490;201707;110696;294689;94509;270068;11300;37693;64113;178491;75413;216184
431500;201707;576;1561;445;1297;90;247;231;669;321;916
431505;201707;504;1221;327;943;34;98;189;549;223;647
431507;201707;377;907;187;529;39;120;79;200;118;320
431510;201707;1849;5159;1429;4311;287;944;527;1531;814;2475
431513;201707;337;871;163;499;21;61;85;258;106;319
431514;201707;108;293;50;159;6;22;13;33;19;55
431515;201707;593;1626;396;1218;89;303;163;468;252;771
431517;201707;77;265;59;214;11;42;13;41;24;83
431520;201707;528;1318;230;732;47;179;39;107;86;286
431530;201707;4206;9758;2902;7994;799;2310;584;1643;1383;3953
431531;201707;239;674;174;550;23;85;54;151;77;236
431532;201707;508;1389;396;1144;89;262;137;396;226;658
431535;201707;314;807;139;426;29;103;48;129;77;232
431540;201707;2094;6750;1888;6430;133;539;1296;4492;1429;5031
431545;201707;368;1016;62;211;3;11;16;58;19;69
431550;201707;2184;6319;1874;5734;430;1428;742;2154;1172;3582
431555;201707;689;1673;478;1320;54;152;279;780;333;932
431560;201707;21202;60461;14797;48569;3135;11469;3478;12049;6613;23518
431570;201707;6007;14898;4737;13197;1057;3132;2358;6502;3415;9634
431575;201707;252;723;202;634;37;131;30;71;67;202
431580;201707;614;1723;344;1147;73;274;92;296;165;570
431590;201707;952;2489;592;1789;117;375;183;553;300;928
431595;201707;414;1164;294;896;44;134;140;406;184;540
431600;201707;1966;5330;1449;4440;353;1220;303;905;656;2125
431610;201707;1430;3957;1038;3213;131;403;468;1469;599;1872
431620;201707;493;1402;221;696;46;138;101;296;147;434
431630;201707;1377;3701;770;2388;204;665;189;541;393;1206
431640;201707;6395;17260;5732;16326;948;2780;3599;10421;4547;13201
431642;201707;534;1400;372;1087;45;130;150;427;195;557
431643;201707;353;900;154;446;21;57;43;109;64;166
431645;201707;1696;4687;1418;4194;224;720;865;2552;1089;3272
431647;201707;138;404;93;303;15;50;15;39;30;89
431650;201707;315;943;220;726;37;135;57;170;94;305
431660;201707;1022;2871;611;2017;108;396;120;336;228;732
431670;201707;1255;3248;930;2682;178;585;390;1045;568;1630
431673;201707;252;681;96;336;24;85;8;19;32;104
431675;201707;733;1882;149;513;17;64;38;116;55;180
431680;201707;9155;25004;7005;20881;1880;5917;1981;5941;3861;11858
431690;201707;22709;62452;17740;53997;4752;15350;5527;17190;10279;32540
431695;201707;152;444;108;356;20;72;33;84;53;156
431697;201707;484;1305;411;1186;94;288;189;559;283;847
431700;201707;1510;4225;1307;3850;200;598;712;2069;912;2667
431710;201707;12198;34732;10219;31613;3137;10280;2940;9973;6077;20253
431720;201707;6973;19089;5082;15252;1147;3666;1106;3099;2253;6765
431725;201707;30;84;18;59;2;7;5;15;7;22
431730;201707;3783;10725;2983;9340;791;2701;809;2707;1600;5408
431740;201707;5159;13843;3948;11708;1261;4143;637;1646;1898;5789
431750;201707;8498;23783;7296;21818;1700;5486;3125;9431;4825;14917
431755;201707;334;910;70;244;9;29;10;35;19;64
431760;201707;4308;11651;3402;10058;502;1684;1794;5017;2296;6701
431770;201707;1952;5161;1644;4715;260;786;995;2799;1255;3585
431775;201707;198;536;101;318;24;81;10;25;34;106
431780;201707;2185;5900;1582;4717;364;1123;425;1221;789;2344
431790;201707;1173;3410;906;2832;179;596;321;983;500;1579
431795;201707;378;1008;228;689;40;123;60;178;100;301
431800;201707;8437;24188;6646;20867;2170;7386;809;2531;2979;9917
431805;201707;340;827;104;342;9;33;25;86;34;119
431810;201707;3241;8513;2353;6768;469;1493;947;2564;1416;4057
431820;201707;2495;7565;2149;6904;473;1658;917;2887;1390;4545
431830;201707;11092;26350;8543;22638;2055;5937;3386;8981;5441;14918
431840;201707;2542;7540;2195;6908;475;1591;1091;3478;1566;5069
431842;201707;746;1881;261;808;36;120;68;191;104;311
431843;201707;353;1009;283;881;39;141;127;370;166;511
431844;201707;287;780;80;260;22;82;13;28;35;110
431845;201707;502;1420;361;1107;21;63;218;666;239;729
431846;201707;318;939;270;865;27;106;199;630;226;736
431848;201707;235;620;126;396;8;26;17;41;25;67
431849;201707;474;1144;90;254;14;40;14;29;28;69
431850;201707;4612;13409;3870;11839;852;2788;1263;3795;2115;6583
431860;201707;802;2098;550;1619;93;298;253;701;346;999
431861;201707;111;315;56;195;8;27;16;45;24;72
431862;201707;499;1603;404;1430;74;282;182;652;256;934
431870;201707;18534;53186;15070;46795;3273;11127;5737;17464;9010;28591
431880;201707;4156;11986;3316;10319;746;2585;1219;3621;1965;6206
431890;201707;4954;13356;3418;10449;1006;3315;598;1915;1604;5230
431900;201707;1157;3134;733;2265;169;588;288;822;457;1410
431910;201707;964;2330;438;1255;51;139;118;317;169;456
431912;201707;468;1378;389;1223;86;272;194;618;280;890
431915;201707;1228;3322;930;2801;223;722;360;1067;583;1789
431920;201707;1308;3492;1123;3195;124;377;810;2289;934;2666
431930;201707;1103;3066;793;2526;182;564;389;1268;571;1832
431935;201707;66;217;54;191;14;52;11;36;25;88
431936;201707;338;996;227;732;61;212;62;196;123;408
431937;201707;282;755;163;501;40;133;18;47;58;180
431940;201707;2501;6698;1578;4824;344;1107;434;1254;778;2361
431950;201707;1651;4897;1458;4559;280;957;727;2215;1007;3172
431960;201707;2777;7755;2360;6936;644;1976;684;1960;1328;3936
431970;201707;427;1178;200;667;47;158;48;145;95;303
431971;201707;106;298;67;227;8;27;11;34;19;61
431973;201707;468;1564;398;1427;40;138;272;997;312;1135
431975;201707;114;270;27;95;4;15;2;5;6;20
431980;201707;1361;3905;1075;3344;256;835;366;1091;622;1926
431990;201707;7009;18828;4881;15402;916;3237;1447;4483;2363;7720
432000;201707;10411;28620;8372;25107;2514;7702;2934;8930;5448;16632
432010;201707;2182;5984;1743;5196;260;859;842;2435;1102;3294
432020;201707;2296;5408;1662;4512;372;1109;863;2256;1235;3365
432023;201707;520;1383;307;930;51;180;135;345;186;525
432026;201707;1145;3451;866;2850;150;483;438;1438;588;1921
432030;201707;378;1059;266;806;57;181;113;320;170;501
432032;201707;541;1425;359;1058;42;142;155;423;197;565
432035;201707;830;2448;734;2282;243;833;209;641;452;1474
432040;201707;1033;2459;493;1520;72;250;160;474;232;724
432045;201707;263;720;139;465;31;112;37;127;68;239
432050;201707;606;1658;504;1473;122;369;213;636;335;1005
432055;201707;934;2559;632;1981;156;536;238;717;394;1253
432057;201707;394;964;276;754;45;111;136;352;181;463
432060;201707;501;1282;184;599;29;119;51;139;80;258
432065;201707;240;679;184;573;48;150;59;179;107;329
432067;201707;905;2713;694;2261;126;396;324;1052;450;1448
432070;201707;2395;6472;1513;4711;277;930;311;922;588;1852
432080;201707;3889;10636;3228;9488;888;2889;1160;3337;2048;6226
432085;201707;327;911;219;737;60;204;90;299;150;503
432090;201707;1515;4217;1174;3569;331;1065;424;1240;755;2305
432100;201707;1374;3899;610;2076;92;341;40;106;132;447
432110;201707;2536;7507;1833;6046;427;1640;153;444;580;2084
432120;201707;4198;12287;3463;10974;1210;4089;789;2480;1999;6569
432130;201707;2783;7539;2258;6868;747;2455;828;2535;1575;4990
432132;201707;311;871;155;522;26;91;41;124;67;215
432135;201707;765;2180;605;1846;99;326;366;1095;465;1421
432140;201707;1863;5827;1449;5033;303;1087;604;2181;907;3268
432143;201707;1396;4005;1141;3576;202;680;561;1787;763;2467
432145;201707;1416;4244;891;3020;144;538;129;406;273;944
432146;201707;178;552;122;421;37;138;25;78;62;216
432147;201707;599;1929;468;1637;141;522;89;316;230;838
432149;201707;386;1049;237;706;29;87;103;298;132;385
432150;201707;3690;10230;2768;8525;627;2155;745;2208;1372;4363
432160;201707;4460;13832;3833;12725;1188;4158;1171;3948;2359;8106
432162;201707;379;919;59;189;12;43;7;21;19;64
432163;201707;295;814;65;211;5;15;2;8;7;23
432166;201707;636;1871;503;1590;88;330;181;489;269;819
432170;201707;1243;3749;857;2934;194;704;172;567;366;1271
432180;201707;2576;6903;1491;4612;351;1150;277;752;628;1902
432183;201707;405;1278;308;1047;101;374;56;185;157;559
432185;201707;899;2397;606;1838;63;191;329;970;392;1161
432190;201707;2988;7997;1900;5699;412;1294;553;1571;965;2865
432195;201707;1071;2826;738;2254;191;548;244;763;435;1311
432200;201707;2999;8908;2409;7864;579;2045;1035;3363;1614;5408
432210;201707;407;1111;288;904;57;206;109;317;166;523
432215;201707;813;2465;702;2284;119;381;402;1355;521;1736
432218;201707;275;696;161;451;25;63;54;131;79;194
432220;201707;4287;10929;3327;9379;487;1590;1832;4915;2319;6505
432225;201707;111;325;85;272;23;71;29;94;52;165
432230;201707;1005;2654;582;1741;103;332;151;393;254;725
432232;201707;536;1454;411;1226;71;249;179;510;250;759
432234;201707;373;994;221;665;40;119;37;95;77;214
432235;201707;121;356;41;141;7;25;3;7;10;32
432237;201707;446;1177;389;1079;18;64;262;689;280;753
432240;201707;14160;42638;11895;39491;1411;5663;7179;24612;8590;30275
432250;201707;4728;15831;4261;14881;1292;4796;1373;4934;2665;9730
432252;201707;477;1202;311;919;51;161;143;418;194;579
432253;201707;1272;3979;730;2557;166;645;38;114;204;759
432254;201707;932;2506;257;837;51;189;20;50;71;239
432255;201707;206;523;111;356;17;63;37;103;54;166
432260;201707;7560;18609;5301;14913;1199;3497;1983;5811;3182;9308
432270;201707;2546;7533;2148;6784;640;2124;455;1444;1095;3568
432280;201707;1455;3862;767;2405;117;372;203;598;320;970
432285;201707;198;614;25;83;2;5;3;6;5;11
432290;201707;501;1461;306;1014;78;250;72;227;150;477
432300;201707;24337;70657;21052;64958;3523;11900;11903;36042;15426;47942
432310;201707;787;2284;617;1991;138;453;294;958;432;1411
432320;201707;229;567;89;277;17;51;13;36;30;87
432330;201707;302;791;104;350;13;42;17;64;30;106
432335;201707;172;492;74;261;14;54;14;41;28;95
432340;201707;367;893;189;574;38;135;53;145;91;280
432345;201707;649;1736;599;1660;69;257;394;1014;463;1271
432350;201707;376;1018;198;641;33;96;52;165;85;261
432360;201707;196;600;38;136;4;16;9;29;13;45
432370;201707;427;1147;299;892;29;95;175;523;204;618
432375;201707;721;1807;530;1479;80;221;287;793;367;1014
432377;201707;243;810;38;143;7;31;9;19;16;50
432380;201707;1143;3520;801;2775;199;767;319;1034;518;1801
500020;201707;2405;6707;1814;5723;399;1443;717;2184;1116;3627
500025;201707;1454;3359;860;2344;83;243;478;1280;561;1523
500060;201707;7052;20689;5504;17958;782;2612;3267;11091;4049;13703
500070;201707;4406;12400;3444;10702;767;2653;1269;4020;2036;6673
500080;201707;1482;4204;1066;3435;253;915;390;1212;643;2127
500085;201707;2177;5396;1488;4400;139;442;911;2649;1050;3091
500090;201707;2328;6534;1616;5218;324;1090;597;2058;921;3148
500100;201707;3201;8787;2569;7699;464;1556;1047;2974;1511;4530
500110;201707;8082;23566;6296;20743;1213;4277;2566;9163;3779;13440
500124;201707;2150;6778;1849;6264;464;1517;869;3310;1333;4827
500150;201707;1424;3531;926;2698;172;583;310;771;482;1354
500190;201707;5200;13038;3967;11397;823;2517;2030;5984;2853;8501
500200;201707;2559;6311;1878;5116;378;1103;794;1981;1172;3084
500210;201707;4795;13866;3891;12436;897;3045;1695;5469;2592;8514
500215;201707;1338;4061;1004;3396;160;597;402;1328;562;1925
500220;201707;3160;9376;2492;8207;448;1552;1043;3488;1491;5040
500230;201707;3002;7522;2109;6108;362;1101;999;2917;1361;4018
500240;201707;4531;13888;3188;11122;565;2248;836;3071;1401;5319
500260;201707;3066;7181;1930;5477;253;747;950;2598;1203;3345
500270;201707;125122;320436;78554;236902;17392;56505;17914;52911;35306;109416
500280;201707;1385;3524;1073;3091;101;321;734;2107;835;2428
500290;201707;4426;9833;2484;7068;426;1342;835;2352;1261;3694
500295;201707;2656;7453;1554;5019;223;796;401;1068;624;1864
500310;201707;863;2227;694;1991;131;413;368;1031;499;1444
500315;201707;3295;10087;2693;9090;373;1280;1615;5704;1988;6984
500320;201707;18554;57181;13911;48505;3849;14571;3585;13340;7434;27911
500325;201707;4569;11138;3152;9009;500;1558;1716;4936;2216;6494
500330;201707;7057;17925;4794;13883;555;1761;2276;6634;2831;8395
500345;201707;2167;5461;1611;4674;414;1261;655;1882;1069;3143
500348;201707;2263;6474;1944;5978;198;739;1258;3785;1456;4524
500350;201707;1321;3822;717;2418;73;252;229;794;302;1046
500370;201707;22928;67424;17044;56839;3580;13417;5358;18024;8938;31441
500375;201707;2930;7972;2093;6326;401;1340;567;1676;968;3016
500380;201707;3583;9489;2679;7959;659;2080;973;2910;1632;4990
500390;201707;569;1272;332;902;49;152;161;421;210;573
500400;201707;1350;4018;985;3161;231;779;244;735;475;1514
500410;201707;2271;6328;1845;5708;306;979;1082;3443;1388;4422
500430;201707;2798;7532;2022;6391;374;1340;751;2512;1125;3852
500440;201707;1507;3837;944;2861;165;513;351;1103;516;1616
500450;201707;1369;3931;886;2965;190;695;125;349;315;1044
500460;201707;4099;11646;2782;9075;655;2383;523;1692;1178;4075
500470;201707;3008;8575;2057;6577;567;1977;328;929;895;2906
500480;201707;2327;6886;2134;6634;176;536;1618;5354;1794;5890
500490;201707;1000;2653;732;2215;190;659;171;532;361;1191
500500;201707;3966;11574;3024;10133;1031;3918;707;2433;1738;6351
500510;201707;863;2210;533;1602;51;180;257;720;308;900
500515;201707;2150;5403;1709;4785;187;520;1067;3153;1254;3673
500520;201707;3351;11262;2845;10243;471;1979;1541;5467;2012;7446
500525;201707;1195;3652;961;3236;176;670;420;1458;596;2128
500540;201707;6473;17183;3704;12040;860;3305;365;1020;1225;4325
500560;201707;5161;15980;4521;14978;409;1450;3289;11126;3698;12576
500568;201707;4251;10228;2799;8054;663;2326;751;1921;1414;4247
500570;201707;7737;19741;4684;14148;1181;3799;777;2264;1958;6063
500580;201707;3712;10269;2950;9024;376;1170;1817;5615;2193;6785
500600;201707;4096;10583;2636;7963;574;1916;725;2140;1299;4056
500620;201707;8087;22577;5836;18214;922;3096;2523;8003;3445;11099
500625;201707;717;2019;393;1281;69;253;135;415;204;668
500627;201707;741;1956;480;1479;92;285;115;355;207;640
500630;201707;5996;15696;3966;12189;963;3150;1108;3376;2071;6526
500635;201707;2718;9831;2226;9086;254;1054;1553;6854;1807;7908
500640;201707;1704;4026;1259;3383;71;233;876;2281;947;2514
500660;201707;19739;55843;15053;48280;4600;16294;3878;12580;8478;28874
500690;201707;2482;7245;1937;6378;908;3250;269;897;1177;4147
500710;201707;3478;9998;2786;8769;667;2325;895;2747;1562;5072
500720;201707;6280;16311;3897;12258;1011;3572;646;1942;1657;5514
500730;201707;1008;2718;664;2061;142;492;188;541;330;1033
500740;201707;4633;12037;3460;9920;344;1172;1743;5031;2087;6203
500750;201707;1018;2721;814;2365;140;458;371;1002;511;1460
500755;201707;1172;3327;775;2534;146;497;132;342;278;839
500769;201707;5670;14735;3076;9463;523;1807;552;1367;1075;3174
500770;201707;1757;4935;1157;3775;216;769;343;1118;559;1887
500780;201707;1344;3683;954;2926;237;730;223;694;460;1424
500790;201707;9923;26262;8117;23388;1546;4931;4145;11780;5691;16711
500793;201707;2201;6124;1600;5062;482;1579;247;682;729;2261
500795;201707;2405;6865;2038;6349;215;565;1485;4965;1700;5530
500797;201707;832;2205;556;1697;105;354;183;539;288;893
500800;201707;3073;7893;2226;6654;767;2626;424;1314;1191;3940
500830;201707;20781;53848;14226;41798;2523;8092;5311;14922;7834;23014
500840;201707;1379;3743;883;2751;106;358;302;878;408;1236
510010;201707;1329;3775;1049;3300;268;847;487;1581;755;2428
510020;201707;3632;9930;2128;6880;430;1437;416;1251;846;2688
510025;201707;7438;20949;5149;16472;1051;3675;1448;4347;2499;8022
510030;201707;1750;4479;1388;3968;270;840;659;1849;929;2689
510035;201707;1038;2882;704;2359;127;414;387;1395;514;1809
510040;201707;1938;4969;1486;4308;181;556;869;2511;1050;3067
510050;201707;1928;5411;1400;4422;340;1201;486;1449;826;2650
510060;201707;1620;4431;1211;3679;190;625;539;1576;729;2201
510080;201707;1020;3234;827;2837;235;922;137;372;372;1294
510100;201707;711;1833;481;1378;45;143;219;580;264;723
510120;201707;313;647;202;505;11;28;133;336;144;364
510125;201707;3038;7753;2272;6439;377;1289;860;2231;1237;3520
510130;201707;1705;4667;1377;4092;340;1080;399;1165;739;2245
510140;201707;3005;9130;2294;8139;926;3757;554;1749;1480;5506
510160;201707;1310;4287;1163;4050;221;819;696;2437;917;3256
510170;201707;5185;15328;4141;13510;820;2912;1764;5703;2584;8615
510180;201707;12922;32909;8649;25971;2419;7839;2099;7196;4518;15035
510185;201707;1630;4428;1192;3810;292;888;573;2158;865;3046
510190;201707;2541;6850;1735;5635;394;1380;695;2320;1089;3700
510250;201707;14512;41927;12475;38986;3048;10181;5884;19075;8932;29256
510260;201707;2204;9001;1792;8171;298;1306;960;5076;1258;6382
510263;201707;4064;11049;2836;8920;650;2201;506;1523;1156;3724
510267;201707;5869;17017;3916;12755;892;3071;804;2615;1696;5686
510268;201707;1363;3592;993;2945;147;480;546;1570;693;2050
510269;201707;1037;3090;705;2397;246;926;139;419;385;1345
510270;201707;2912;9210;2337;8060;525;1823;826;2791;1351;4614
510279;201707;1805;5421;1432;4654;344;1221;518;1557;862;2778
510285;201707;1190;3383;883;2859;251;861;242;767;493;1628
510300;201707;3628;9992;2901;8975;253;814;2037;6447;2290;7261
510305;201707;1511;4650;1131;3910;243;872;354;1308;597;2180
510310;201707;792;2278;626;1998;205;679;191;617;396;1296
510320;201707;3955;10984;2983;9241;494;1744;1023;3084;1517;4828
510325;201707;5169;15840;4316;14681;1098;3886;2340;8355;3438;12241
510330;201707;2848;9035;2172;7822;540;2013;765;3030;1305;5043
510335;201707;5208;15342;4085;13829;474;1645;2650;9563;3124;11208
510336;201707;594;1786;445;1502;75;259;211;728;286;987
510337;201707;1921;6084;1468;5247;566;2133;281;1061;847;3194
510340;201707;79517;206424;54270;166399;17262;59591;9626;29996;26888;89587
510343;201707;1107;3178;803;2565;145;489;323;995;468;1484
510345;201707;1600;4699;1220;3989;257;867;422;1354;679;2221
510350;201707;3220;8620;2372;7391;601;1978;908;2916;1509;4894
510360;201707;1873;4329;1181;3496;93;366;829;2441;922;2807
510370;201707;1547;4875;1206;4285;214;795;665;2478;879;3273
510380;201707;536;1510;297;1014;82;302;32;113;114;415
510385;201707;994;3737;708;3087;85;418;334;1613;419;2031
510390;201707;1090;3440;944;3171;270;863;431;1565;701;2428
510395;201707;817;1935;574;1562;65;193;268;785;333;978
510410;201707;4081;12759;3394;11458;866;2987;1605;5701;2471;8688
510420;201707;2495;6071;1800;4983;193;643;932;2520;1125;3163
510450;201707;719;1857;465;1415;107;361;81;240;188;601
510452;201707;717;2217;506;1756;100;341;236;818;336;1159
510454;201707;892;2724;719;2394;122;448;395;1343;517;1791
510455;201707;975;2961;722;2394;134;512;241;738;375;1250
510460;201707;2375;6066;1725;5137;184;657;936;2685;1120;3342
510480;201707;4466;11331;3197;9098;504;1535;1328;3555;1832;5090
510490;201707;1579;4859;1315;4453;321;1167;613;2054;934;3221
510500;201707;1522;4419;1025;3441;192;766;438;1424;630;2190
510510;201707;2994;9950;2478;8947;744;2961;609;2290;1353;5251
510515;201707;6448;18201;4293;13871;925;3246;998;2923;1923;6169
510517;201707;1551;4544;1236;3971;374;1254;225;703;599;1957
510520;201707;2246;4884;1485;3916;37;93;927;2665;964;2758
510523;201707;991;2784;861;2569;100;288;586;1792;686;2080
510525;201707;5617;16770;4397;14299;924;3249;1387;4095;2311;7344
510530;201707;535;1427;411;1248;28;137;286;808;314;945
510550;201707;2889;9129;2214;7824;563;2078;696;2526;1259;4604
510558;201707;1930;5501;1664;5131;130;442;1028;3356;1158;3798
510560;201707;1714;5072;1079;3938;273;1098;230;893;503;1991
510562;201707;5472;15408;3990;12504;1079;3665;1002;3269;2081;6934
510590;201707;3312;8379;2546;7409;490;1349;1477;4585;1967;5934
510600;201707;1657;4125;1101;3213;249;737;359;1049;608;1786
510610;201707;2949;8150;2319;7200;259;908;1394;4260;1653;5168
510615;201707;2050;6054;1720;5524;507;1684;710;2394;1217;4078
510617;201707;721;2139;585;1908;33;98;462;1573;495;1671
510618;201707;1477;4178;1063;3377;202;739;485;1463;687;2202
510619;201707;779;2110;449;1492;83;311;67;196;150;507
510620;201707;1412;3473;749;2371;185;658;112;325;297;983
510621;201707;956;3060;820;2799;204;775;222;712;426;1487
510622;201707;4305;12659;3063;10011;886;3148;554;1702;1440;4850
510623;201707;3538;9465;2652;7993;589;2044;846;2395;1435;4439
510624;201707;1770;4797;852;2874;148;561;120;318;268;879
510625;201707;2029;5583;1506;4709;423;1501;238;744;661;2245
510626;201707;1646;4174;1017;3255;295;1064;192;619;487;1683
510627;201707;703;1978;478;1508;126;422;117;382;243;804
510628;201707;1576;3815;1058;3093;191;569;595;1776;786;2345
510629;201707;1765;5610;1407;4815;392;1445;412;1442;804;2887
510630;201707;2695;8652;1798;6759;392;1595;307;1222;699;2817
510631;201707;417;1140;334;996;9;23;265;802;274;825
510637;201707;3094;8517;2485;7505;763;2537;797;2380;1560;4917
510642;201707;5025;16028;4212;14795;1227;4699;1664;6095;2891;10794
510645;201707;987;2156;598;1641;167;458;166;485;333;943
510650;201707;6557;20317;5836;19472;1177;4128;3814;13241;4991;17369
510665;201707;1828;4690;1138;3429;215;718;386;1169;601;1887
510670;201707;385;839;209;580;20;63;111;314;131;377
510675;201707;6500;19746;5098;17011;1433;5234;1106;3642;2539;8876
510677;201707;2046;5404;1553;4734;207;663;960;3032;1167;3695
510680;201707;723;2148;521;1731;121;415;82;253;203;668
510682;201707;2082;6505;1569;5548;442;1713;322;1126;764;2839
510685;201707;934;2482;714;2121;95;322;356;984;451;1306
510700;201707;4276;10961;2892;9011;710;2234;1260;4121;1970;6355
510704;201707;10423;26900;7453;21745;1431;4637;2834;7860;4265;12497
510706;201707;2022;5914;1361;4923;283;1092;649;2498;932;3590
510710;201707;3224;8755;2250;6793;466;1450;702;1967;1168;3417
510715;201707;707;1687;486;1329;73;199;182;510;255;709
510718;201707;2630;6100;1570;4835;666;2151;290;1100;956;3251
510719;201707;408;927;254;723;33;111;122;336;155;447
510720;201707;1116;2731;777;2258;184;605;260;687;444;1292
510724;201707;766;2190;547;1783;113;402;214;659;327;1061
510726;201707;769;1750;511;1374;74;216;320;826;394;1042
510729;201707;730;1797;387;1153;74;242;106;293;180;535
510730;201707;3055;8270;2172;6697;592;1934;564;1747;1156;3681
510735;201707;1018;3179;786;2836;119;483;440;1608;559;2091
510740;201707;1444;3958;1058;3374;128;368;652;2289;780;2657
510757;201707;732;2373;602;2128;252;933;191;651;443;1584
510760;201707;34221;84104;22286;64951;6427;20777;4520;12170;10947;32947
510770;201707;4657;10974;3683;9839;369;914;2354;6963;2723;7877
510774;201707;371;1023;288;844;61;164;127;403;188;567
510775;201707;679;2012;537;1745;144;541;110;322;254;863
510776;201707;559;1551;434;1294;98;289;164;499;262;788
510777;201707;1648;4661;1214;4079;84;295;995;3400;1079;3695
510779;201707;643;1876;509;1636;62;191;284;938;346;1129
510780;201707;3810;10926;3044;9759;727;2432;1188;4188;1915;6620
510785;201707;1921;5323;1258;4140;333;1203;181;614;514;1817
510787;201707;2494;7298;1925;6283;830;2861;244;757;1074;3618
510788;201707;626;1569;428;1267;95;270;157;562;252;832
510790;201707;16029;45571;10746;35446;2345;8967;1150;3555;3495;12522
510792;201707;9064;25432;6030;19783;1233;4462;1058;3356;2291;7818
510794;201707;1245;3768;954;3221;274;1023;231;725;505;1748
510795;201707;8451;24694;6134;20377;1669;6085;1133;3983;2802;10068
510800;201707;1640;4459;1247;3862;276;934;533;1560;809;2494
510805;201707;2046;5623;1469;4617;300;1014;571;1680;871;2694
510810;201707;689;1618;514;1377;136;365;249;644;385;1009
510820;201707;752;1701;481;1315;72;238;203;510;275;748
510830;201707;726;2020;559;1776;109;339;285;974;394;1313
510835;201707;649;1810;475;1515;77;271;213;638;290;909
510840;201707;46240;114699;36705;102208;8341;24011;17138;49847;25479;73858
510850;201707;1643;4403;1052;3349;325;1181;210;608;535;1789
510860;201707;2837;8456;1979;6860;671;2617;182;603;853;3220
510880;201707;598;1945;509;1783;137;515;214;765;351;1280
510885;201707;645;1738;498;1521;97;341;197;570;294;911
510890;201707;799;2391;651;2180;122;439;357;1216;479;1655
510895;201707;1266;3633;976;3118;229;824;336;995;565;1819
520005;201707;1843;5454;1577;5098;463;1458;699;2468;1162;3926
520010;201707;2053;6521;1516;5365;541;2164;247;748;788;2912
520013;201707;3259;9006;2362;7262;530;1672;683;2206;1213;3878
520015;201707;508;1429;413;1299;107;356;130;430;237;786
520017;201707;1137;3241;908;2870;215;733;392;1211;607;1944
520020;201707;426;1082;335;954;83;250;152;418;235;668
520025;201707;32020;92827;28817;88964;3428;11397;21168;65414;24596;76811
520030;201707;5052;14880;4137;13371;645;2262;2135;6954;2780;9216
520050;201707;449;1117;277;796;21;54;157;467;178;521
520055;201707;879;2615;733;2333;124;378;383;1238;507;1616
520060;201707;1447;4386;1196;3919;291;1082;339;1049;630;2131
520080;201707;1941;5357;1574;4877;294;863;802;2686;1096;3549
520082;201707;1069;2789;932;2560;115;257;594;1691;709;1948
520085;201707;765;2273;654;2086;158;496;222;695;380;1191
520090;201707;962;2169;682;1818;123;284;381;1100;504;1384
520110;201707;43276;121611;32722;105406;11652;42908;2798;8299;14450;51207
520120;201707;196;500;118;365;13;41;39;124;52;165
520130;201707;3651;9859;3241;9243;714;2219;1659;4821;2373;7040
520140;201707;36943;115110;30755;103711;11002;40449;3773;12721;14775;53170
520145;201707;403;1118;294;921;62;212;92;273;154;485
520150;201707;515;1344;417;1233;64;209;247;715;311;924
520160;201707;953;2455;761;2172;166;487;285;818;451;1305
520170;201707;4936;10712;3732;9355;283;790;3029;7639;3312;8429
520180;201707;2277;6454;1904;5905;407;1409;834;2533;1241;3942
520215;201707;1997;5065;1599;4418;290;869;779;2111;1069;2980
520235;201707;696;1735;493;1430;79;260;185;508;264;768
520250;201707;1613;4393;1142;3645;310;1063;205;671;515;1734
520260;201707;824;2061;522;1506;80;239;200;568;280;807
520280;201707;590;1680;495;1500;152;456;196;650;348;1106
520310;201707;1271;2976;890;2373;231;644;295;880;526;1524
520320;201707;2028;6063;1643;5356;191;669;885;2925;1076;3594
520330;201707;3033;9169;2282;7848;612;2350;576;1971;1188;4321
520340;201707;2023;4941;1481;4165;205;511;933;2783;1138;3294
520350;201707;3388;8932;2537;7411;701;2202;817;2289;1518;4491
520355;201707;1530;4427;1258;3997;315;1111;569;1785;884;2896
520357;201707;832;2170;670;1921;62;189;457;1320;519;1509
520360;201707;771;2151;628;1910;195;615;202;632;397;1247
520380;201707;1356;3574;861;2601;123;413;358;1000;481;1413
520390;201707;1031;2474;610;1886;205;743;152;411;357;1154
520393;201707;568;1357;435;1166;50;138;225;574;275;712
520396;201707;740;2237;623;2019;129;406;347;1133;476;1539
520400;201707;1637;4618;1381;4251;281;930;795;2420;1076;3350
520410;201707;1605;3749;1130;3078;169;512;670;1794;839;2306
520420;201707;356;967;263;773;34;108;140;372;174;480
520425;201707;1327;3528;1002;2931;263;778;418;1258;681;2036
520430;201707;1903;4945;1132;3514;213;699;96;296;309;995
520440;201707;3778;9584;2493;7291;693;2182;515;1501;1208;3683
520450;201707;11441;30388;7819;24085;2192;7403;444;1398;2636;8801
520455;201707;741;2148;578;1879;207;731;156;515;363;1246
520460;201707;942;2568;778;2319;119;382;471;1400;590;1782
520465;201707;848;2287;736;2120;98;344;468;1264;566;1608
520470;201707;1820;5741;1624;5442;337;1168;1002;3522;1339;4690
520480;201707;897;2604;609;2068;121;440;118;351;239;791
520485;201707;1468;4388;1270;4101;204;708;825;2684;1029;3392
520490;201707;4005;12069;3138;10704;656;2297;1648;5771;2304;8068
520495;201707;1480;3681;1221;3344;95;287;882;2506;977;2793
520500;201707;1406;3884;1145;3501;293;981;434;1294;727;2275
520505;201707;779;2080;616;1841;147;424;284;861;431;1285
520510;201707;8814;23728;6214;19680;1404;5014;1766;5613;3170;10627
520520;201707;1147;3078;905;2718;269;835;296;952;565;1787
520530;201707;2054;6544;1645;5834;580;2083;393;1571;973;3654
520540;201707;2999;8191;2080;6460;520;1684;379;1228;899;2912
520545;201707;1063;3079;854;2718;171;580;264;815;435;1395
520547;201707;711;2186;606;2000;188;634;200;642;388;1276
520549;201707;10533;30652;8715;27951;2074;6962;4246;13874;6320;20836
520551;201707;3970;11769;3550;11127;667;2345;2241;6904;2908;9249
520552;201707;801;2338;721;2237;100;310;517;1646;617;1956
520570;201707;611;1634;445;1372;123;398;151;464;274;862
520580;201707;3149;7385;2215;6126;323;960;1263;3525;1586;4485
520590;201707;1464;4138;1111;3509;246;820;222;720;468;1540
520620;201707;8325;23604;6994;21855;1880;6128;3202;10146;5082;16274
520630;201707;1019;2565;705;2057;114;357;283;787;397;1144
520640;201707;2849;7609;2325;6724;546;1617;911;2679;1457;4296
520650;201707;932;2394;658;1893;106;321;325;929;431;1250
520660;201707;429;1059;254;782;72;250;58;188;130;438
520670;201707;1013;2907;876;2704;65;205;674;2064;739;2269
520680;201707;800;2059;603;1749;143;415;251;743;394;1158
520690;201707;339;833;227;659;57;167;85;250;142;417
520710;201707;577;1477;362;1065;12;33;215;623;227;656
520725;201707;1734;4305;1267;3527;175;546;789;2162;964;2708
520735;201707;857;2257;594;1760;99;299;210;631;309;930
520740;201707;1845;4732;1488;4269;235;682;882;2566;1117;3248
520750;201707;683;1757;538;1544;104;272;244;755;348;1027
520753;201707;1564;4025;1398;3803;154;385;941;2740;1095;3125
520760;201707;889;2250;776;2102;133;291;514;1540;647;1831
520780;201707;1873;4535;1402;3856;155;447;794;2132;949;2579
520790;201707;3131;7695;2305;6454;179;475;1594;4655;1773;5130
520800;201707;16766;45422;14136;42278;2721;7822;8713;27842;11434;35664
520810;201707;1220;2842;932;2516;128;377;572;1645;700;2022
520815;201707;632;1957;466;1607;167;660;41;133;208;793
520830;201707;1722;4191;1327;3731;62;141;1051;2959;1113;3100
520840;201707;1795;5601;1547;5204;590;2112;394;1412;984;3524
520850;201707;654;1898;464;1588;120;474;120;403;240;877
520860;201707;6716;19564;5182;17060;1237;4356;1800;6123;3037;10479
520870;201707;97274;256377;71546;215834;21386;70864;15325;44954;36711;115818
520880;201707;6966;19763;5424;17517;1949;6964;927;2966;2876;9930
520890;201707;3921;10641;3062;9217;628;2158;1381;4078;2009;6236
520910;201707;3774;10530;2629;8380;869;2990;460;1391;1329;4381
520915;201707;665;1918;505;1586;102;356;205;627;307;983
520920;201707;3775;9655;2582;7889;413;1398;1115;3490;1528;4888
520929;201707;645;1675;496;1424;95;240;251;799;346;1039
520940;201707;1165;3197;921;2844;79;264;676;2098;755;2362
520945;201707;653;1520;511;1291;79;187;287;694;366;881
520960;201707;1041;2934;820;2530;169;545;338;1043;507;1588
520970;201707;2754;8296;2377;7613;649;2257;588;1898;1237;4155
520980;201707;799;2197;672;2005;173;561;300;888;473;1449
520990;201707;3048;9506;2840;9220;294;1004;1946;6619;2240;7623
520993;201707;1019;2566;777;2171;48;138;548;1556;596;1694
520995;201707;2322;6221;1985;5771;412;1198;1103;3274;1515;4472
521000;201707;7611;22379;6055;19407;1923;6628;1369;4313;3292;10941
521010;201707;4200;11776;3253;10058;621;1903;1475;4577;2096;6480
521015;201707;725;1913;611;1730;102;288;395;1119;497;1407
521020;201707;2906;8198;1985;6292;561;1919;218;655;779;2574
521030;201707;668;1647;497;1365;78;200;210;604;288;804
521040;201707;6709;17546;5452;15582;1777;5393;1692;5025;3469;10418
521056;201707;886;2553;700;2242;216;749;185;634;401;1383
521060;201707;1060;2719;833;2371;89;262;469;1374;558;1636
521080;201707;1144;2744;636;1915;66;224;239;640;305;864
521090;201707;3089;8046;2336;6965;722;2296;533;1628;1255;3924
521100;201707;1934;4523;1411;3802;222;584;848;2347;1070;2931
521120;201707;4963;12399;3772;10834;710;2105;1596;4971;2306;7076
521130;201707;1066;2749;742;2130;59;211;414;1182;473;1393
521140;201707;1046;3027;838;2641;167;550;283;907;450;1457
521150;201707;12299;30478;8015;23216;2484;7734;2230;6647;4714;14381
521160;201707;903;2065;568;1530;92;277;261;672;353;949
521170;201707;1168;2842;852;2353;108;320;514;1374;622;1694
521180;201707;6498;20256;5721;18875;1470;5189;1883;6344;3353;11533
521190;201707;8944;25165;5858;19396;1464;5275;1112;3732;2576;9007
521200;201707;773;2059;599;1767;67;222;331;963;398;1185
521205;201707;643;1745;501;1502;47;156;317;935;364;1091
521210;201707;899;2468;539;1702;117;423;81;208;198;631
521220;201707;4450;10939;3171;9150;687;2136;1244;3569;1931;5705
521225;201707;390;948;321;872;32;77;236;675;268;752
521230;201707;1380;4048;1254;3826;431;1312;585;1813;1016;3125
521250;201707;31395;93199;26237;85565;10920;37009;6824;23976;17744;60985
521260;201707;726;1723;569;1496;94;277;326;851;420;1128
521270;201707;1818;5088;1648;4857;163;385;1251;3863;1414;4248
521280;201707;1974;5815;1573;5042;487;1698;458;1453;945;3151
521290;201707;469;1245;350;1079;79;280;173;515;252;795
521295;201707;1227;2820;998;2520;118;284;721;1901;839;2185
521300;201707;1939;5236;1640;4789;218;653;1065;3163;1283;3816
521305;201707;750;2059;599;1819;105;313;317;987;422;1300
521308;201707;4546;13264;3580;11401;736;2400;1620;5205;2356;7605
521310;201707;8746;24719;6081;19619;1526;5352;1413;4361;2939;9713
521340;201707;353;873;325;839;22;47;273;706;295;753
521350;201707;2050;5404;1618;4733;276;778;982;2928;1258;3706
521370;201707;1038;2869;698;2257;214;744;87;290;301;1034
521375;201707;1444;4018;1123;3547;255;870;444;1407;699;2277
521377;201707;1241;2925;1064;2724;58;131;917;2372;975;2503
521380;201707;6069;16628;4159;13090;547;1802;1040;3369;1587;5171
521385;201707;592;1503;487;1380;128;372;205;627;333;999
521390;201707;759;2060;605;1848;190;640;177;537;367;1177
521400;201707;2113;5733;1861;5431;285;930;1293;3788;1578;4718
521405;201707;1444;3947;1131;3405;285;907;476;1456;761;2363
521410;201707;730;2151;676;2074;176;503;329;1087;505;1590
521440;201707;1484;4132;1158;3487;281;910;326;874;607;1784
521450;201707;4023;12706;3233;11132;914;3308;718;2531;1632;5839
521460;201707;7094;19710;5608;17069;1611;5294;1929;5717;3540;11011
521470;201707;689;1948;470;1473;90;276;90;280;180;556
521480;201707;389;1115;234;787;44;158;70;225;114;383
521483;201707;2838;7231;2072;5893;525;1521;541;1516;1066;3037
521486;201707;1745;4287;1388;3801;95;256;1047;2852;1142;3108
521487;201707;514;1343;372;1127;84;265;125;384;209;649
521490;201707;837;2328;637;1979;37;148;425;1283;462;1431
521500;201707;1488;4376;1135;3697;176;660;434;1325;610;1985
521520;201707;885;2022;637;1682;132;360;284;783;416;1143
521523;201707;13639;47122;12141;43942;3929;15071;2206;8780;6135;23851
521525;201707;1086;2721;879;2419;107;340;529;1398;636;1738
521530;201707;2033;5516;1290;4047;279;943;242;770;521;1713
521540;201707;905;2390;589;1845;96;363;242;738;338;1101
521550;201707;1624;4100;1045;2941;194;598;445;1222;639;1820
521560;201707;3786;11905;3018;10820;850;3353;1374;5114;2224;8467
521565;201707;608;1549;510;1425;79;217;325;899;404;1116
521570;201707;4859;13193;3121;9778;670;2258;393;1254;1063;3512
521580;201707;559;1315;324;956;58;168;62;186;120;354
521590;201707;642;1701;499;1472;131;441;198;549;329;990
521600;201707;436;1251;294;948;69;225;61;186;130;411
521630;201707;1423;3468;972;2816;231;767;254;657;485;1424
521640;201707;2256;5579;1714;4815;409;1133;745;2163;1154;3296
521645;201707;559;1634;398;1303;101;342;115;344;216;686
521680;201707;1294;4112;1053;3615;350;1269;107;363;457;1632
521690;201707;564;1603;494;1486;114;377;228;661;342;1038
521710;201707;2904;8303;2263;7138;492;1622;517;1615;1009;3237
521720;201707;1998;5487;1522;4611;259;798;767;2273;1026;3071
521730;201707;3900;12237;3252;10974;1159;4304;534;1573;1693;5877
521740;201707;3829;10474;3024;9296;710;2407;1192;3828;1902;6235
521760;201707;14889;45596;12545;41775;3511;12826;4371;14919;7882;27745
521770;201707;2736;7657;2089;6399;681;2232;484;1400;1165;3632
521800;201707;6820;20205;5752;18381;1727;5811;1946;6594;3673;12405
521805;201707;940;2088;665;1703;191;454;282;790;473;1244
521810;201707;808;2022;586;1695;109;340;241;727;350;1067
521830;201707;5305;16100;4602;15059;630;2258;2931;9541;3561;11799
521839;201707;704;1905;513;1546;114;391;192;533;306;924
521850;201707;6629;17465;4818;14414;1258;4072;909;2560;2167;6632
521860;201707;1992;5227;1483;4424;294;1008;460;1335;754;2343
521870;201707;496;1605;410;1426;105;394;126;405;231;799
521878;201707;811;2290;570;1796;98;346;177;504;275;850
521880;201707;22308;56889;15419;45967;3940;12456;4525;14071;8465;26527
521890;201707;3420;9827;2446;7847;616;2122;352;1080;968;3202
521900;201707;1509;3834;1009;3078;235;765;338;982;573;1747
521910;201707;1209;2771;847;2353;117;354;482;1406;599;1760
521920;201707;330;1003;256;852;60;229;72;244;132;473
521925;201707;710;2105;565;1834;112;366;153;481;265;847
521930;201707;3684;11374;3177;10462;1050;3514;781;2691;1831;6205
521935;201707;648;1781;544;1593;130;371;234;673;364;1044
521940;201707;1066;2807;852;2506;208;695;404;1145;612;1840
521945;201707;658;1988;551;1799;97;328;253;882;350;1210
521950;201707;686;1705;546;1511;51;153;398;1110;449;1263
521960;201707;691;2016;530;1691;85;297;232;713;317;1010
521970;201707;2788;7116;2292;6525;200;510;1780;5291;1980;5801
521971;201707;998;2651;694;2113;136;433;165;487;301;920
521973;201707;1039;3083;868;2790;155;541;426;1365;581;1906
521975;201707;13041;35310;11573;33472;1989;6096;7466;21476;9455;27572
521980;201707;2318;6053;1916;5525;229;591;1426;4216;1655;4807
521990;201707;1192;3364;960;2988;141;464;568;1827;709;2291
522000;201707;2382;6363;1725;5511;228;762;857;2919;1085;3681
522005;201707;384;919;272;757;84;221;91;265;175;486
522010;201707;3621;9860;2863;8637;973;3032;630;1916;1603;4948
522015;201707;951;2737;765;2428;177;580;299;934;476;1514
522020;201707;5307;13419;3899;11204;904;2709;1716;4942;2620;7651
522026;201707;740;2015;545;1767;97;340;283;962;380;1302
522028;201707;579;1596;420;1239;65;208;194;533;259;741
522040;201707;2515;5936;1937;5224;367;1006;1267;3479;1634;4485
522045;201707;16085;50927;13020;44756;3464;12971;2229;7559;5693;20530
522050;201707;1171;3314;833;2648;178;598;242;701;420;1299
522060;201707;2463;7224;2041;6575;388;1322;1060;3454;1448;4776
522068;201707;1726;5141;1526;4898;193;568;1092;3690;1285;4258
522070;201707;676;1958;593;1813;82;321;378;1098;460;1419
522100;201707;532;1547;437;1405;113;392;188;599;301;991
522108;201707;857;2602;710;2358;66;293;516;1649;582;1942
522119;201707;1537;4345;1258;3935;241;777;624;2008;865;2785
522130;201707;368;1020;294;921;80;266;143;459;223;725
522140;201707;17039;48471;13595;42178;4144;13780;2379;7085;6523;20865
522145;201707;842;2170;656;1896;157;419;339;1070;496;1489
522150;201707;986;2519;784;2212;206;571;297;863;503;1434
522155;201707;913;2582;779;2368;179;502;394;1270;573;1772
522157;201707;664;1789;556;1631;36;135;403;1162;439;1297
522160;201707;6421;17657;4515;14212;1290;4434;439;1471;1729;5905
522170;201707;2391;6817;1791;5678;580;1968;335;1056;915;3024
522180;201707;413;1126;268;860;68;217;50;177;118;394
522185;201707;16681;45317;13183;40811;4178;13748;5178;16864;9356;30612
522190;201707;902;2192;692;1899;129;344;319;923;448;1267
522200;201707;1749;5545;1319;4558;296;1072;235;796;531;1868
522205;201707;1421;3773;1118;3306;137;446;695;2046;832;2492
522220;201707;1472;3680;1118;3205;148;419;651;1972;799;2391
522230;201707;1322;3527;1105;3192;174;565;611;1755;785;2320
530010;201707;194025;590625;170062;550156;42379;152735;71637;224701;114016;377436
110001;201706;3302;10714;2904;10064;689;2486;1395;4901;2084;7387
110002;201706;12873;36515;9848;31293;3060;10528;2971;9238;6031;19766
110003;201706;740;2279;599;2006;184;652;112;353;296;1005
110004;201706;9193;28451;7469;25044;2354;8436;1333;4807;3687;13243
110005;201706;1897;5695;1535;5046;432;1495;582;1929;1014;3424
110006;201706;1673;5051;1136;3916;349;1265;111;371;460;1636
110007;201706;1360;3987;1132;3567;330;1098;431;1558;761;2656
110008;201706;2463;8112;2261;7839;313;1014;1717;6209;2030;7223
110009;201706;4560;13698;3450;11877;1027;3737;979;3506;2006;7243
110010;201706;6957;22183;6062;20804;1778;6190;2617;9938;4395;16128
110011;201706;6878;20988;5808;18897;2016;6891;1639;5351;3655;12242
110012;201706;15125;42515;11601;36459;3130;10449;2639;8441;5769;18890
110013;201706;5473;17069;4588;15389;1811;6234;1030;3775;2841;10009
110014;201706;4070;11472;3328;10254;997;3215;1436;4351;2433;7566
110015;201706;4920;14438;3315;11235;859;3131;477;1619;1336;4750
110018;201706;3960;10818;2805;8976;702;2533;888;2723;1590;5256
110020;201706;69344;183189;50357;157432;11417;37981;20518;67588;31935;105569
110025;201706;4286;11965;3387;10385;503;1665;2061;6179;2564;7844
110026;201706;629;1903;559;1791;165;552;254;833;419;1385
110028;201706;6296;18901;4894;16089;1465;5228;579;1889;2044;7117
110029;201706;1321;3659;992;3157;264;863;418;1350;682;2213
110030;201706;10263;27863;7817;24371;1921;6661;2901;9033;4822;15694
110032;201706;3661;11305;2956;9852;981;3350;746;2490;1727;5840
110033;201706;4918;15703;4224;14434;1466;5079;1307;4826;2773;9905
110034;201706;3431;9091;2682;8043;828;2631;1285;3844;2113;6475
110037;201706;1849;6264;1606;5738;435;1641;687;2440;1122;4081
110040;201706;3263;9988;2648;8839;843;2997;786;2548;1629;5545
110045;201706;4922;15705;4275;14831;1363;5097;1800;6291;3163;11388
110050;201706;1648;5192;1370;4667;535;1875;395;1368;930;3243
110060;201706;811;2645;639;2271;229;864;92;344;321;1208
110070;201706;1957;6444;1668;5774;560;2047;547;1838;1107;3885
110080;201706;4850;12929;3954;11859;972;3041;2083;6445;3055;9486
110090;201706;690;1968;498;1618;123;443;226;705;349;1148
110092;201706;1313;4226;1156;3989;205;766;663;2367;868;3133
110094;201706;3440;10121;2840;9199;951;3243;1013;3338;1964;6581
110100;201706;2099;6513;1857;6086;415;1455;986;3227;1401;4682
110110;201706;1625;5010;1345;4584;502;1786;317;1158;819;2944
110120;201706;1703;5292;1311;4455;388;1389;255;859;643;2248
110130;201706;2488;6853;1755;5619;514;1802;461;1482;975;3284
110140;201706;2376;7588;1859;6548;512;1915;458;1518;970;3433
110143;201706;1420;4090;1057;3435;377;1263;323;1043;700;2306
110145;201706;1097;3065;757;2414;187;655;278;867;465;1522
110146;201706;409;1226;338;1116;70;226;163;549;233;775
110147;201706;704;2040;518;1687;140;478;176;534;316;1012
110148;201706;1123;3419;725;2479;133;490;87;297;220;787
110149;201706;3244;9501;2499;8323;899;2998;886;3153;1785;6151
110150;201706;2404;6782;1933;6095;761;2688;459;1365;1220;4053
110155;201706;823;2546;707;2293;170;585;284;887;454;1472
110160;201706;1788;5721;1475;5103;537;1887;408;1475;945;3362
110170;201706;2744;7613;1960;6187;431;1440;904;2832;1335;4272
110175;201706;1633;4909;1300;4429;207;760;693;2473;900;3233
110180;201706;1216;3545;995;3197;286;905;489;1609;775;2514
120001;201706;2820;9319;2520;8862;521;1867;1477;5440;1998;7307
120005;201706;1626;6605;1512;6397;176;796;1094;4828;1270;5624
120010;201706;4980;16505;4718;16102;647;2147;3438;12078;4085;14225
120013;201706;2116;8307;2009;8155;483;1893;1188;5188;1671;7081
120017;201706;2039;7239;1888;6968;457;1721;923;3741;1380;5462
120020;201706;14354;62674;13866;61737;1808;8555;9981;45703;11789;54258
120025;201706;2365;8122;2268;7979;423;1525;1393;5018;1816;6543
120030;201706;6609;25394;6414;25165;302;1481;5665;22259;5967;23740
120032;201706;1560;7434;1491;7264;140;819;1138;5541;1278;6360
120033;201706;3619;14334;3513;14144;219;1015;3066;12356;3285;13371
120034;201706;2043;8529;1927;8304;138;841;1527;6496;1665;7337
120035;201706;3199;14105;3095;13916;215;1165;2612;11810;2827;12975
120038;201706;2630;9200;2464;8896;573;2098;1334;4996;1907;7094
120039;201706;1819;8548;1763;8438;195;1178;1277;6099;1472;7277
120040;201706;43943;154818;40361;148460;8978;35822;21137;79142;30115;114964
120042;201706;3078;12461;2908;12087;198;1011;2238;9345;2436;10356
120043;201706;1106;4976;1065;4899;72;362;906;4257;978;4619
120045;201706;4704;15413;4510;15196;309;1196;4004;13461;4313;14657
120050;201706;8171;32837;7771;31992;970;4335;5519;23349;6489;27684
120060;201706;8021;34816;7806;34431;719;3743;6238;27771;6957;31514
120070;201706;2743;9952;2640;9745;408;1522;1754;6689;2162;8211
120080;201706;3686;13700;3519;13421;628;2550;2420;9402;3048;11952
130002;201706;3237;13062;3010;12731;149;766;2642;11259;2791;12025
130006;201706;2219;9005;1929;8494;167;885;1457;6442;1624;7327
130008;201706;2323;8845;2131;8481;299;1367;1524;6023;1823;7390
130010;201706;3330;10536;3073;10237;141;494;2757;9246;2898;9740
130014;201706;3247;10362;2778;9590;476;1773;1759;6158;2235;7931
130020;201706;2836;10597;2687;10343;121;687;2275;8647;2396;9334
130030;201706;8273;30255;7887;29813;257;788;7316;28236;7573;29024
130040;201706;3803;11514;3314;10894;273;982;2674;8913;2947;9895
130050;201706;6413;25699;6044;25217;294;1173;5268;22640;5562;23813
130060;201706;6250;28033;5942;27552;532;2972;4757;22135;5289;25107
130063;201706;4349;18084;4079;17754;222;1144;3631;15889;3853;17033
130068;201706;3263;13362;2940;12692;246;1224;2160;9412;2406;10636
130070;201706;8114;26738;7258;25751;463;1539;6172;22556;6635;24095
130080;201706;5775;24552;5364;23979;596;3175;4027;18142;4623;21317
130083;201706;2356;8976;2202;8741;239;1128;1668;6598;1907;7726
130090;201706;2949;10015;2777;9762;84;357;2441;8703;2525;9060
130100;201706;6003;21574;5824;21368;149;562;5518;20398;5667;20960
130110;201706;6896;21826;6468;21336;604;1798;5344;18191;5948;19989
130115;201706;4862;16601;4604;16215;180;651;3981;14159;4161;14810
130120;201706;15255;56469;14219;55129;1463;5903;11348;45058;12811;50961
130130;201706;4132;16328;4050;16188;384;1815;3251;12933;3635;14748
130140;201706;6280;24556;6166;24432;279;1192;5693;22615;5972;23807
130150;201706;3479;13794;3409;13708;143;778;3077;12342;3220;13120
130160;201706;4483;18069;4239;17755;418;2106;3433;14437;3851;16543
130165;201706;3007;12118;2862;11870;155;834;2422;10078;2577;10912
130170;201706;10226;34198;8709;32411;857;3474;6895;26274;7752;29748
130180;201706;3625;11859;3558;11773;68;223;3389;11286;3457;11509
130185;201706;12862;38825;11346;37159;652;1656;9701;33436;10353;35092
130190;201706;17287;59024;15098;56099;2222;8299;10428;40328;12650;48627
130195;201706;2017;8485;1956;8407;108;435;1731;7626;1839;8061
130200;201706;2102;7012;1904;6715;274;975;1346;4915;1620;5890
130210;201706;1413;5383;1282;5226;121;669;1013;4061;1134;4730
130220;201706;1999;8126;1846;7839;197;991;1297;5534;1494;6525
130230;201706;3812;17366;3555;16957;395;2123;2761;13444;3156;15567
130240;201706;9542;33585;8429;31986;316;1707;7293;27767;7609;29474
130250;201706;21071;71438;19751;69835;2184;7488;15466;56833;17650;64321
130255;201706;4323;15084;4016;14600;289;1203;3288;12015;3577;13218
130260;201706;255846;820409;228150;774262;66788;243248;94879;324047;161667;567295
130270;201706;7626;30989;7030;30068;823;3743;5230;23056;6053;26799
130280;201706;3373;13998;3245;13848;111;497;3003;13002;3114;13499
130290;201706;11510;40428;10877;39709;197;484;10346;38576;10543;39060
130300;201706;4671;17429;4418;17051;278;1315;3748;14542;4026;15857
130310;201706;5295;19809;4882;19268;404;1660;3965;15995;4369;17655
130320;201706;3180;11274;2911;10903;384;1464;2021;7845;2405;9309
130330;201706;3970;13918;3539;13386;159;818;3061;11540;3220;12358
130340;201706;19072;70676;17452;68715;1865;7312;14115;57391;15980;64703
130350;201706;3555;14113;3419;13920;236;1337;2884;11592;3120;12929
130353;201706;6412;19364;5611;18355;969;3069;3743;13146;4712;16215
130356;201706;4856;17238;4491;16650;525;2026;3225;12277;3750;14303
130360;201706;3457;9862;3030;9417;93;239;2822;8920;2915;9159
130370;201706;5546;21686;5038;21028;191;1074;4331;18201;4522;19275
130380;201706;8196;33642;7875;33185;528;2696;6689;28206;7217;30902
130390;201706;5360;23491;5042;22897;542;2869;3745;17018;4287;19887
130395;201706;2306;7878;2057;7424;245;923;1434;5219;1679;6142
130400;201706;2188;8033;2046;7828;128;584;1772;6808;1900;7392
130406;201706;10975;41149;9957;39763;1851;7748;6685;27211;8536;34959
130410;201706;3938;14639;3487;13848;1057;4450;1635;6692;2692;11142
130420;201706;11134;45562;10604;44804;1451;6434;8048;34821;9499;41255
130423;201706;3695;13364;3413;12980;227;1134;2911;10949;3138;12083
130426;201706;2476;10293;2398;10171;107;514;2139;9203;2246;9717
130430;201706;3641;12428;3480;12199;249;886;2931;10453;3180;11339
130440;201706;3877;13490;3580;13146;158;629;3220;11931;3378;12560
140002;201706;1768;5729;1609;5517;118;487;1263;4320;1381;4807
140005;201706;3621;9786;3477;9631;62;160;3353;9327;3415;9487
140010;201706;55188;156579;44811;141474;10856;36328;18163;60880;29019;97208
140015;201706;3120;9879;2872;9591;143;453;2554;8676;2697;9129
140017;201706;3438;10866;3085;10406;309;1060;2288;8048;2597;9108
140020;201706;4726;15368;4177;14613;496;1976;2994;10516;3490;12492
140023;201706;2265;7376;1953;6903;237;912;1340;4820;1577;5732
140028;201706;2155;5878;1943;5597;191;662;1479;4120;1670;4782
140030;201706;3739;11551;3453;11179;513;1468;2486;8417;2999;9885
140040;201706;1855;8366;1794;8284;93;569;1618;7423;1711;7992
140045;201706;2628;9707;2358;9336;438;1725;1536;6471;1974;8196
140047;201706;5796;17491;5044;16299;1231;4033;2417;8430;3648;12463
140050;201706;1455;4486;1281;4237;203;683;818;2772;1021;3455
140060;201706;1475;4374;1308;4115;177;583;945;3005;1122;3588
140070;201706;1661;9038;1607;8886;154;1043;1243;6885;1397;7928
150010;201706;38598;109043;35987;105525;2076;6861;29803;87265;31879;94126
150013;201706;1758;5028;1562;4807;176;513;1140;3608;1316;4121
150020;201706;12798;42192;12345;41572;1285;3811;10115;35187;11400;38998
150030;201706;7870;32308;7604;31929;513;2163;6523;27917;7036;30080
150034;201706;4285;11683;3848;11060;280;865;3147;9032;3427;9897
150040;201706;13002;40132;11518;38407;1216;3293;9186;32584;10402;35877
150050;201706;5898;22796;5604;22308;220;1119;4919;19620;5139;20739
150060;201706;18909;57641;16937;54517;3982;12795;9338;31380;13320;44175
150070;201706;6256;24861;5616;24171;186;994;5170;22443;5356;23437
150080;201706;83368;208488;71375;192803;15400;43037;31343;92594;46743;135631
150085;201706;5953;19515;5684;19182;289;781;5072;17597;5361;18378
150090;201706;10467;39508;9877;38644;825;3481;7812;31019;8637;34500
150095;201706;5517;17544;4998;16829;323;1040;4026;13964;4349;15004
150100;201706;3262;11837;3000;11369;228;981;2311;8683;2539;9664
150110;201706;3717;17364;3689;17320;197;978;3308;15704;3505;16682
150120;201706;6909;24339;6724;24073;453;1415;5705;21172;6158;22587
150125;201706;778;2163;666;2030;99;342;441;1338;540;1680
150130;201706;22956;68753;20999;65969;2449;7348;15281;49467;17730;56815
150140;201706;175164;473378;160914;454722;22589;63058;113730;328010;136319;391068
150145;201706;4659;14325;4221;13752;501;1605;3308;10999;3809;12604
150150;201706;12884;37665;11837;36171;1475;4789;8470;26162;9945;30951
150157;201706;3161;9329;2723;8740;325;1146;1858;6097;2183;7243
150160;201706;3115;9714;2923;9435;764;2498;1577;5250;2341;7748
150170;201706;23590;82013;21512;78870;3200;11743;14493;55416;17693;67159
150172;201706;3242;10637;2836;9989;301;1070;2112;7633;2413;8703
150175;201706;1870;5608;1734;5445;145;506;1383;4446;1528;4952
150178;201706;10129;30209;8651;28462;907;3072;6490;22086;7397;25158
150180;201706;19196;75411;18425;74400;1125;5086;15903;64816;17028;69902
150190;201706;7164;24151;6889;23792;201;904;6267;21695;6468;22599
150195;201706;5553;17627;5238;17142;130;430;4800;15846;4930;16276
150200;201706;5435;16887;5138;16543;74;235;4867;15793;4941;16028
150210;201706;25103;93023;24308;91940;1661;6454;20478;79530;22139;85984
150215;201706;7732;24085;6809;22646;2214;7566;2637;9169;4851;16735
150220;201706;11636;35531;10474;33778;2196;7154;5643;18922;7839;26076
150230;201706;12335;37301;10725;35109;1719;5500;6904;23769;8623;29269
150240;201706;35126;103337;30136;94468;10059;32500;8023;26299;18082;58799
150250;201706;4080;16963;3936;16757;725;3098;2713;12035;3438;15133
150260;201706;2098;8079;1996;7909;318;1289;1300;5276;1618;6565
150270;201706;8337;25010;6449;22567;1718;6170;3111;11398;4829;17568
150275;201706;6088;21529;5730;20985;593;2079;4352;16355;4945;18434
150276;201706;2209;6519;1970;6218;275;892;1480;4775;1755;5667
150277;201706;4823;14437;4120;13579;525;1868;3021;10203;3546;12071
150280;201706;6044;26542;5871;26172;666;2993;4546;20650;5212;23643
150285;201706;3132;11742;2883;11345;312;1322;2018;8114;2330;9436
150290;201706;10382;29026;9843;28431;602;1438;8599;25652;9201;27090
150293;201706;9340;24743;6954;21484;2062;6557;2556;8742;4618;15299
150295;201706;7673;21854;6291;20238;1547;4959;3385;12195;4932;17154
150300;201706;2057;6678;1907;6471;90;419;1583;5342;1673;5761
150304;201706;4203;13331;3669;12471;642;2155;2327;8234;2969;10389
150307;201706;6568;21480;6176;20936;348;1208;5281;18014;5629;19222
150309;201706;6234;20769;5507;19683;1309;4620;2894;11060;4203;15680
150310;201706;6569;27513;6255;27079;449;2262;5218;22706;5667;24968
150320;201706;9605;24877;8783;23933;539;1414;7261;20037;7800;21451
150330;201706;14280;47513;13363;46192;1829;6418;9760;34686;11589;41104
150340;201706;2598;8012;2398;7708;207;672;1841;5958;2048;6630
150345;201706;7091;22716;6620;22070;536;1890;5349;18112;5885;20002
150350;201706;8384;24593;7799;23882;1135;2890;5901;18954;7036;21844
150360;201706;21809;66306;18917;62655;2942;9521;12614;43689;15556;53210
150370;201706;10074;35320;9103;33994;948;3555;6804;26414;7752;29969
150375;201706;3056;13129;2805;12752;245;1146;2342;10804;2587;11950
150380;201706;9766;27834;8538;26120;475;1487;7138;22175;7613;23662
150390;201706;7899;33850;7376;32924;1210;5160;4888;22890;6098;28050
150400;201706;6055;23089;5811;22625;438;1695;4656;18428;5094;20123
150405;201706;8379;24682;7467;23564;663;1633;5733;19250;6396;20883
150410;201706;1649;6032;1512;5762;241;969;947;3664;1188;4633
150420;201706;36218;118224;29981;108245;9962;38439;8452;33812;18414;72251
150430;201706;7736;25057;7317;24443;850;2747;5518;18922;6368;21669
150440;201706;5532;18632;5307;18327;417;1397;4365;15364;4782;16761
150442;201706;22220;62376;19469;58262;3144;9378;11811;36783;14955;46161
150445;201706;5655;18870;5184;18128;428;1505;4060;14475;4488;15980
150450;201706;4439;20900;4270;20623;424;2147;3449;16938;3873;19085
150460;201706;7447;26495;6868;25762;371;1654;5720;22246;6091;23900
150470;201706;18055;54393;17233;53405;1304;3434;14837;46994;16141;50428
150475;201706;3895;13310;3569;12857;269;1019;2884;10576;3153;11595
150480;201706;14326;48359;13062;46378;1597;5811;9620;35090;11217;40901
150490;201706;7322;27606;7107;27283;264;1248;6283;24252;6547;25500
150495;201706;5086;18437;4926;18229;171;692;4522;16862;4693;17554
150497;201706;2615;9391;2329;8848;692;2721;1070;4230;1762;6951
150500;201706;3212;8714;2954;8339;317;864;2302;6520;2619;7384
150503;201706;3765;11450;3098;10506;965;3349;1518;5401;2483;8750
150506;201706;10852;37030;9885;35667;2122;7144;6260;24309;8382;31453
150510;201706;10039;38289;9049;36245;1480;5756;5791;24458;7271;30214
150520;201706;6876;26850;6763;26707;229;942;6312;25140;6541;26082
150530;201706;12465;42832;11230;40879;1243;4099;8443;31734;9686;35833
150540;201706;4726;13995;4154;13191;229;774;3457;10994;3686;11768
150543;201706;6018;18093;5274;17064;995;3282;3350;11264;4345;14546
150548;201706;9789;30846;9085;29964;355;1056;8266;27584;8621;28640
150549;201706;2081;6566;1889;6350;57;222;1720;5810;1777;6032
150550;201706;20377;63994;17733;59490;5265;17948;6510;23245;11775;41193
150553;201706;23550;78889;19399;70772;6872;26495;5073;19784;11945;46279
150555;201706;1784;5186;1473;4683;89;315;1058;3374;1147;3689
150560;201706;1864;6036;1713;5733;281;927;999;3414;1280;4341
150563;201706;2600;8531;2374;8127;534;1938;1260;4326;1794;6264
150565;201706;4026;13670;3666;13089;134;645;3052;10968;3186;11613
150570;201706;5911;21175;5727;20868;420;1704;4572;16715;4992;18419
150580;201706;9980;41443;9664;41053;657;2908;8283;35901;8940;38809
150590;201706;6186;23966;5946;23656;179;839;5517;21989;5696;22828
150600;201706;8306;31207;7907;30640;279;1287;7070;27616;7349;28903
150610;201706;2434;8061;2244;7677;184;700;1711;5791;1895;6491
150611;201706;2815;9280;2640;8984;150;562;2185;7448;2335;8010
150613;201706;12582;36853;10050;32890;2581;8775;4322;14745;6903;23520
150616;201706;3226;9575;2427;8216;564;2117;733;2359;1297;4476
150618;201706;6622;21786;5867;20461;1300;4588;3195;11592;4495;16180
150619;201706;5240;17394;4777;16665;513;1946;3518;12266;4031;14212
150620;201706;6433;22677;5776;21837;674;2642;4380;16773;5054;19415
150630;201706;6107;17516;5767;17122;421;1325;4893;14694;5314;16019
150635;201706;3989;12689;3574;11902;913;3095;1564;5427;2477;8522
150640;201706;2087;6004;1942;5845;71;213;1783;5487;1854;5700
150650;201706;11778;35394;10624;33354;3038;9500;4512;14997;7550;24497
150655;201706;5170;16503;4841;15928;482;1649;3771;12487;4253;14136
150658;201706;4516;13264;3869;12399;746;2609;2346;7798;3092;10407
150660;201706;5704;17509;5197;16777;986;3155;3077;10200;4063;13355
150670;201706;7866;20106;6357;18288;678;1914;4896;14500;5574;16414
150680;201706;62779;206481;52488;189855;14583;53566;22154;88888;36737;142454
150690;201706;2081;6201;1870;5885;155;496;1448;4605;1603;5101
150700;201706;6183;19279;5677;18612;732;2367;4019;13632;4751;15999
150710;201706;4325;14360;3875;13659;362;1409;2784;9921;3146;11330
150715;201706;4978;15265;4330;14268;411;1518;3218;10649;3629;12167
150720;201706;6470;25495;6117;24871;605;2714;4674;19340;5279;22054
150730;201706;10500;34974;9633;33524;1207;4386;7118;25331;8325;29717
150740;201706;3671;11440;3275;10744;547;1822;1980;6572;2527;8394
150745;201706;4909;15486;4394;14765;1004;3544;2699;9161;3703;12705
150746;201706;1359;4427;1288;4295;97;311;1022;3482;1119;3793
150747;201706;5387;16608;4758;15803;674;2000;3199;11455;3873;13455
150750;201706;3516;11269;3179;10802;203;819;2523;8658;2726;9477
150760;201706;11580;36060;10745;34990;1222;4056;7993;26492;9215;30548
150770;201706;5982;22455;5764;22123;202;648;5163;20735;5365;21383
150775;201706;1058;3176;899;2913;167;664;507;1591;674;2255
150780;201706;3689;11760;3554;11607;132;515;3231;10573;3363;11088
150790;201706;5128;16343;4673;15825;281;916;3825;13872;4106;14788
150795;201706;14723;47430;13316;45202;3018;9981;7626;27314;10644;37295
150796;201706;3289;9248;2941;8837;258;800;2309;7110;2567;7910
150797;201706;3813;12895;3493;12326;134;514;2894;10263;3028;10777
150800;201706;14013;45068;12865;43665;2367;7348;8842;32008;11209;39356
150803;201706;6851;24092;6409;23394;671;2568;4882;18008;5553;20576
150805;201706;2804;9846;2572;9459;334;1216;1841;6912;2175;8128
150808;201706;5726;18548;4600;16392;1737;6757;534;2012;2271;8769
150810;201706;19921;58531;16046;53803;2669;8692;9932;35669;12601;44361
150812;201706;5375;16519;4911;15728;577;2043;3484;10921;4061;12964
150815;201706;8640;28063;7726;26918;788;2713;5986;21468;6774;24181
150820;201706;11559;33056;10366;31723;804;2214;8307;26288;9111;28502
150830;201706;12665;47612;11999;46787;586;2947;10035;40155;10621;43102
150835;201706;2165;7544;2012;7252;455;1663;1053;3944;1508;5607
150840;201706;7412;22359;6079;20076;1347;4788;2722;9090;4069;13878
160005;201706;867;2847;829;2781;49;196;707;2356;756;2552
160010;201706;1434;4751;1431;4748;18;30;1400;4686;1418;4716
160015;201706;1839;6722;1788;6646;93;344;1610;6068;1703;6412
160020;201706;1883;6927;1751;6717;237;1009;1279;4931;1516;5940
160021;201706;1076;4550;1038;4484;114;631;783;3365;897;3996
160023;201706;1005;4164;993;4140;81;321;836;3560;917;3881
160025;201706;1497;4538;1477;4516;36;100;1420;4361;1456;4461
160027;201706;8332;24565;7754;23920;989;2825;6021;19350;7010;22175
160030;201706;51599;172650;45425;162996;10839;38541;23290;90508;34129;129049
160040;201706;4378;16908;4271;16761;220;1169;3810;14741;4030;15910
160050;201706;3383;12327;2993;11777;1483;5561;934;4322;2417;9883
160053;201706;3003;11045;2919;10924;714;2593;1865;7267;2579;9860
160055;201706;562;2253;557;2246;26;140;506;2021;532;2161
160060;201706;16012;54351;15217;53430;1686;5600;11985;43302;13671;48902
160070;201706;2836;10952;2652;10651;205;952;2164;8762;2369;9714
160080;201706;2593;9611;2529;9532;74;367;2346;8817;2420;9184
170025;201706;552;1734;474;1627;141;477;216;770;357;1247
170030;201706;1193;3842;1015;3522;202;725;477;1717;679;2442
170035;201706;1438;3911;1144;3422;142;469;631;1900;773;2369
170040;201706;1912;5755;1644;5413;159;579;854;3069;1013;3648
170070;201706;1632;4277;1232;3752;195;638;704;2173;899;2811
170100;201706;2331;6838;2021;6376;201;616;1467;4686;1668;5302
170105;201706;754;2356;569;1951;144;504;226;763;370;1267
170110;201706;915;3000;791;2759;176;669;339;1202;515;1871
170130;201706;1376;4327;1073;3727;241;865;478;1750;719;2615
170190;201706;1584;4616;1164;3923;376;1214;258;1078;634;2292
170200;201706;1633;4418;1034;3282;294;1012;199;578;493;1590
170210;201706;31067;86959;24663;76790;8158;27581;4420;14799;12578;42380
170215;201706;1270;3831;1079;3547;99;405;774;2509;873;2914
170220;201706;5650;18816;5159;17842;1220;4254;2637;9462;3857;13716
170230;201706;1341;4220;1074;3693;228;843;430;1475;658;2318
170240;201706;2779;8153;2232;7275;217;864;1479;4753;1696;5617
170255;201706;3492;10937;2812;9689;803;2829;1116;3966;1919;6795
170270;201706;1017;2485;673;2011;35;113;461;1354;496;1467
170290;201706;2882;8183;2501;7754;253;545;1984;6686;2237;7231
170300;201706;1887;5637;1543;5077;188;613;970;3299;1158;3912
170305;201706;738;2164;596;1894;88;311;287;897;375;1208
170307;201706;996;3530;846;3232;191;765;399;1568;590;2333
170310;201706;1537;4269;1164;3613;255;862;557;1711;812;2573
170320;201706;1133;3197;825;2684;149;515;415;1379;564;1894
170330;201706;817;2651;740;2525;42;181;559;1879;601;2060
170360;201706;466;1428;374;1268;62;241;208;673;270;914
170370;201706;1327;3686;1014;3182;159;518;491;1554;650;2072
170380;201706;1821;5810;1450;5181;198;799;790;2891;988;3690
170382;201706;589;1802;473;1609;60;241;296;995;356;1236
170384;201706;1599;6270;1435;5955;405;1785;642;2686;1047;4471
170386;201706;861;2458;639;2028;132;486;166;456;298;942
170388;201706;600;1780;454;1524;85;303;192;626;277;929
170389;201706;902;3001;800;2832;63;260;592;2068;655;2328
170390;201706;1356;3688;1083;3356;90;296;821;2595;911;2891
170410;201706;536;1692;430;1499;24;100;273;951;297;1051
170460;201706;483;1300;341;1062;45;163;170;533;215;696
170510;201706;806;2611;626;2263;98;409;307;1085;405;1494
170550;201706;6604;18536;4849;15501;1512;5399;721;2345;2233;7744
170555;201706;1352;3812;1071;3377;154;517;542;1750;696;2267
170560;201706;1164;3453;887;3074;145;564;465;1770;610;2334
170600;201706;1315;3809;1130;3543;314;900;601;2005;915;2905
170610;201706;1643;4870;1304;4264;132;503;848;2722;980;3225
170625;201706;402;1186;297;961;39;133;102;306;141;439
170650;201706;1247;3906;990;3427;249;890;351;1323;600;2213
170700;201706;3948;12143;3181;10826;626;2305;1416;5006;2042;7311
170710;201706;1776;5137;1395;4431;304;1057;609;1837;913;2894
170720;201706;1858;4885;1592;4493;146;327;1259;3738;1405;4065
170730;201706;952;2840;762;2516;209;732;322;1091;531;1823
170740;201706;2119;7498;1836;6973;272;1054;1164;4513;1436;5567
170755;201706;819;2489;613;2069;82;315;279;936;361;1251
170765;201706;1259;3423;916;2876;243;787;346;1167;589;1954
170770;201706;1736;5680;1542;5361;281;949;915;3282;1196;4231
170820;201706;4065;14273;3692;13644;610;2180;2160;8590;2770;10770
170825;201706;977;2487;805;2232;92;228;497;1421;589;1649
170830;201706;1450;4075;1188;3666;60;147;951;2983;1011;3130
170900;201706;2563;8955;2392;8691;204;818;1919;7042;2123;7860
170930;201706;3698;10763;3163;9936;692;2378;1557;5040;2249;7418
170950;201706;13854;39851;10278;33670;3035;11235;1458;4870;4493;16105
170980;201706;504;1407;379;1202;52;181;194;582;246;763
171050;201706;1552;5081;1392;4786;94;430;1060;3585;1154;4015
171070;201706;1395;4258;1261;4062;270;806;788;2720;1058;3526
171090;201706;1122;2890;918;2616;59;168;680;1932;739;2100
171110;201706;585;1705;427;1422;117;443;169;491;286;934
171150;201706;1014;2730;659;2101;78;271;388;1239;466;1510
171180;201706;697;2077;469;1609;93;331;192;701;285;1032
171190;201706;1550;5748;1374;5398;261;1066;701;2881;962;3947
171195;201706;839;2884;723;2681;95;445;458;1679;553;2124
171200;201706;635;1944;496;1687;139;503;167;559;306;1062
171215;201706;447;1319;341;1111;76;286;146;462;222;748
171240;201706;701;2548;648;2451;68;323;395;1538;463;1861
171245;201706;599;1993;489;1734;105;407;199;687;304;1094
171250;201706;1068;3009;839;2635;181;605;411;1282;592;1887
171270;201706;399;1591;368;1515;115;439;154;712;269;1151
171280;201706;882;2725;723;2436;165;572;322;1163;487;1735
171320;201706;3897;11469;3212;10293;870;2790;1314;4473;2184;7263
171330;201706;2752;7925;2210;7033;548;1876;1041;3356;1589;5232
171360;201706;1416;4436;1256;4209;103;375;989;3335;1092;3710
171370;201706;676;1871;563;1718;75;258;363;1106;438;1364
171380;201706;1293;4099;1065;3693;361;1250;313;1218;674;2468
171395;201706;913;2674;678;2218;109;426;326;1020;435;1446
171420;201706;1876;5835;1432;4941;304;1149;585;2030;889;3179
171430;201706;1053;3177;872;2867;126;424;541;1763;667;2187
171488;201706;2521;7662;2093;7005;427;1430;1090;3824;1517;5254
171500;201706;888;2508;703;2211;71;243;478;1498;549;1741
171510;201706;831;2879;743;2721;64;274;511;1884;575;2158
171515;201706;497;1384;378;1179;37;119;220;674;257;793
171525;201706;615;1944;525;1787;45;189;339;1105;384;1294
171550;201706;363;1130;272;977;61;238;107;390;168;628
171570;201706;1274;3904;1099;3575;202;620;694;2357;896;2977
171575;201706;1921;5243;1347;4243;226;759;601;1876;827;2635
171610;201706;5258;16310;4323;14679;1109;4133;1244;4350;2353;8483
171620;201706;2784;7864;2361;7307;119;436;1934;6040;2053;6476
171630;201706;905;2737;764;2527;201;708;406;1334;607;2042
171650;201706;2206;6716;1650;5564;394;1383;546;1872;940;3255
171660;201706;2396;6558;1773;5441;296;930;901;2744;1197;3674
171665;201706;1481;4234;1149;3731;227;793;523;1763;750;2556
171670;201706;1870;5153;1513;4584;339;1165;706;2078;1045;3243
171700;201706;1100;3436;894;3049;149;499;465;1624;614;2123
171720;201706;773;2236;655;2034;114;356;382;1209;496;1565
171750;201706;1181;3584;883;3003;246;845;230;839;476;1684
171780;201706;1221;3254;892;2784;80;273;550;1718;630;1991
171790;201706;1462;5132;1212;4543;280;1071;562;2236;842;3307
171800;201706;731;2184;592;1976;64;222;373;1285;437;1507
171820;201706;10344;30550;8394;27348;1837;6407;3445;11559;5282;17966
171830;201706;1367;4984;1223;4676;315;1189;548;2227;863;3416
171840;201706;714;1997;606;1841;41;144;444;1318;485;1462
171845;201706;675;1846;533;1612;82;286;278;848;360;1134
171850;201706;887;3163;785;2948;81;354;524;1961;605;2315
171855;201706;1147;3594;1039;3405;74;254;745;2440;819;2694
171865;201706;426;1438;370;1346;70;262;174;636;244;898
171870;201706;718;2111;559;1819;117;378;240;873;357;1251
171875;201706;1243;3882;1031;3537;83;350;738;2481;821;2831
171880;201706;904;3186;867;3135;82;270;710;2652;792;2922
171884;201706;919;2505;674;2138;139;503;197;707;336;1210
171886;201706;1372;4281;1052;3641;313;1174;201;717;514;1891
171888;201706;743;2189;550;1811;55;201;329;1064;384;1265
171889;201706;517;1572;453;1462;78;261;216;738;294;999
171890;201706;1197;3502;975;3178;170;560;552;1820;722;2380
171900;201706;487;1748;387;1492;91;361;152;597;243;958
172000;201706;590;1872;500;1695;71;275;263;868;334;1143
172010;201706;1177;4061;1068;3855;117;524;716;2514;833;3038
172015;201706;335;1296;275;1176;50;199;138;613;188;812
172020;201706;2371;7724;2201;7467;259;955;1545;5283;1804;6238
172025;201706;719;2074;526;1751;70;261;290;991;360;1252
172030;201706;1197;3743;1057;3514;49;209;832;2748;881;2957
172049;201706;1352;3418;946;2744;372;1174;399;1117;771;2291
172065;201706;1390;3592;1129;3296;69;199;1002;2964;1071;3163
172080;201706;2469;7551;2043;6788;171;661;1372;4539;1543;5200
172085;201706;481;1354;340;1061;59;164;107;329;166;493
172090;201706;3971;10628;3207;9542;123;390;2692;8082;2815;8472
172093;201706;549;1653;422;1428;85;320;202;669;287;989
172097;201706;673;1924;514;1662;101;339;202;679;303;1018
172100;201706;38629;107362;28395;90182;7422;26203;7522;24733;14944;50936
172110;201706;1673;6223;1466;5879;167;726;1053;4362;1220;5088
172120;201706;5106;15812;4140;14351;823;2899;2195;7914;3018;10813
172125;201706;270;836;218;739;40;157;103;348;143;505
172130;201706;548;1512;419;1293;38;140;254;766;292;906
172208;201706;2200;6235;1897;5792;255;808;1141;3513;1396;4321
172210;201706;2563;7516;2190;6988;424;1419;1224;3919;1648;5338
210005;201706;21482;65475;18020;60135;5537;19545;6797;23491;12334;43036
210010;201706;1711;5884;1556;5620;64;262;1308;4767;1372;5029
210015;201706;3476;10719;3078;10109;185;492;2565;8690;2750;9182
210020;201706;7236;17064;6765;16523;155;413;6276;15274;6431;15687
210030;201706;5274;17511;4961;17095;322;1519;4130;14078;4452;15597
210040;201706;2198;6507;2034;6324;51;133;1881;5953;1932;6086
210043;201706;6893;18772;5857;17524;742;2100;4128;13150;4870;15250
210047;201706;6629;23340;6036;22490;419;1902;4899;18245;5318;20147
210050;201706;2269;8288;1882;7528;433;1766;906;3881;1339;5647
210055;201706;1735;5976;1584;5735;101;420;1234;4472;1335;4892
210060;201706;7027;27357;6501;26368;946;3972;4365;18249;5311;22221
210070;201706;7370;21210;6853;20593;89;303;6357;19292;6446;19595
210080;201706;3755;12915;3666;12813;28;116;3535;12426;3563;12542
210083;201706;4717;15897;4211;15345;106;490;3931;14401;4037;14891
210087;201706;3021;8766;2743;8400;255;777;2181;6808;2436;7585
210090;201706;10424;32701;9873;31854;360;1324;8813;28444;9173;29768
210095;201706;5865;20735;5590;20373;330;1328;4785;17627;5115;18955
210100;201706;7255;21564;6646;20772;297;1165;5578;17322;5875;18487
210110;201706;2774;9504;2662;9356;84;360;2418;8518;2502;8878
210120;201706;26416;72416;22984;68352;2905;7285;15952;50719;18857;58004
210125;201706;3724;11368;3561;11196;373;889;2972;9762;3345;10651
210130;201706;4205;12262;3851;11772;233;743;3172;9682;3405;10425
210135;201706;1613;4792;1404;4488;77;238;1136;3678;1213;3916
210140;201706;17092;53316;14481;49765;2936;10777;8139;28679;11075;39456
210150;201706;4631;11367;4108;10720;63;239;3722;9595;3785;9834
210160;201706;17491;54220;16342;52504;1349;4058;12853;42586;14202;46644
210170;201706;14218;48592;13746;47998;703;2552;12227;43070;12930;45622
210173;201706;2455;9416;2326;9223;50;266;2155;8628;2205;8894
210177;201706;3143;9423;2961;9205;86;240;2745;8658;2831;8898
210180;201706;1510;4460;1427;4342;38;148;1237;3742;1275;3890
210190;201706;4855;15113;4458;14395;161;784;3549;11197;3710;11981
210193;201706;1319;4112;1192;3912;66;232;967;3189;1033;3421
210197;201706;2062;6843;1889;6636;222;743;1420;5196;1642;5939
210200;201706;8209;27059;7581;26180;835;2785;5893;20963;6728;23748
210203;201706;6820;21121;6407;20587;305;881;5685;18637;5990;19518
210207;201706;3322;10832;3139;10516;236;723;2503;8640;2739;9363
210210;201706;8455;28201;8046;27658;113;461;7396;25823;7509;26284
210215;201706;1219;4919;1153;4819;88;442;930;3927;1018;4369
210220;201706;5969;22178;5680;21704;321;1500;4781;18264;5102;19764
210230;201706;5245;16639;4884;16106;239;795;4290;14242;4529;15037
210232;201706;12906;40766;10783;38056;1661;5975;6856;26255;8517;32230
210235;201706;3809;11525;3355;10961;163;660;2865;9408;3028;10068
210237;201706;2302;8723;2236;8634;28;129;2131;8295;2159;8424
210240;201706;2961;9198;2741;8869;133;484;2313;7471;2446;7955
210250;201706;5347;17017;5014;16593;141;716;4546;14903;4687;15619
210255;201706;2649;8370;2394;7915;323;1129;1681;5576;2004;6705
210260;201706;5189;16655;4789;16046;379;1292;3796;12903;4175;14195
210270;201706;5244;14840;4641;14007;130;610;4008;11951;4138;12561
210275;201706;3563;8729;3361;8508;89;153;3176;8166;3265;8319
210280;201706;5698;16977;4846;15770;269;1275;3578;11367;3847;12642
210290;201706;5845;18821;5390;18283;203;764;4703;16106;4906;16870
210300;201706;37629;102610;31066;94556;2280;7289;23091;73294;25371;80583
210310;201706;2933;8079;2672;7735;85;197;2328;6833;2413;7030
210312;201706;2357;7117;2208;6925;72;328;1960;6130;2032;6458
210315;201706;2842;8665;2482;8222;104;366;2140;7232;2244;7598
210317;201706;4039;12739;3860;12529;150;576;3513;11429;3663;12005
210320;201706;19742;62918;18222;61072;815;3193;15871;53915;16686;57108
210325;201706;3808;11399;3386;10775;165;590;2785;8977;2950;9567
210330;201706;32984;85228;26979;78467;5271;14186;15785;52299;21056;66485
210340;201706;11537;34278;10451;32843;1120;3117;7634;25560;8754;28677
210350;201706;9864;29592;8819;28162;425;1489;7274;23439;7699;24928
210355;201706;3986;14289;3593;13673;164;791;2990;11538;3154;12329
210360;201706;15281;45762;13848;43809;879;3295;11198;35361;12077;38656
210370;201706;9690;22944;8045;21189;332;661;7058;19313;7390;19974
210375;201706;3198;9469;2624;8721;744;2560;1227;4266;1971;6826
210380;201706;5894;16109;5306;15355;375;998;4417;13063;4792;14061
210390;201706;2998;10556;2735;10142;158;769;2242;8320;2400;9089
210400;201706;4924;15231;4600;14834;122;308;4278;13980;4400;14288
210405;201706;7795;21545;6274;19372;1551;4785;2962;9815;4513;14600
210407;201706;1971;6987;1680;6448;180;728;1215;4676;1395;5404
210408;201706;2436;9393;2281;9196;168;838;1821;7519;1989;8357
210409;201706;3777;13528;3565;13217;191;880;2998;11153;3189;12033
210410;201706;3771;11947;3548;11602;311;868;2788;9517;3099;10385
210420;201706;4146;13521;3772;12881;219;799;3092;10653;3311;11452
210430;201706;2181;6625;2099;6534;102;317;1833;5736;1935;6053
210440;201706;4133;12242;3961;12032;103;312;3685;11260;3788;11572
210450;201706;2727;8493;2406;8019;134;472;1908;6357;2042;6829
210455;201706;3847;10951;3437;10462;642;1892;2331;7457;2973;9349
210460;201706;3541;11356;3250;10932;156;659;2677;8976;2833;9635
210462;201706;1362;4868;1251;4669;76;361;1001;3723;1077;4084
210465;201706;2612;8397;2405;8108;124;363;2088;7212;2212;7575
210467;201706;6191;20484;5817;20063;344;1224;5066;17729;5410;18953
210470;201706;2110;5618;1520;4759;92;277;1139;3634;1231;3911
210480;201706;14844;46802;12991;44496;1846;6038;9092;33451;10938;39489
210490;201706;3791;10138;3215;9345;81;298;2770;8024;2851;8322
210500;201706;6146;25468;5921;25045;536;2532;4662;19828;5198;22360
210510;201706;6521;21864;6116;21382;328;1017;5260;18930;5588;19947
210515;201706;3675;11435;3499;11239;153;393;3190;10499;3343;10892
210520;201706;2669;7968;2404;7611;143;490;2042;6514;2185;7004
210530;201706;50534;136322;42874;124966;6893;25955;12994;45435;19887;71390
210535;201706;3287;11085;3103;10836;121;458;2733;9665;2854;10123
210540;201706;13187;43237;11779;41279;1800;6217;7834;29000;9634;35217
210542;201706;5882;16277;5300;15645;341;779;4594;14021;4935;14800
210545;201706;2335;7373;2219;7202;40;225;1974;6327;2014;6552
210547;201706;3798;13369;3495;12839;384;1386;2530;9581;2914;10967
210550;201706;6229;17957;5526;17209;311;958;4868;15465;5179;16423
210560;201706;3959;12246;3548;11566;141;562;3013;9760;3154;10322
210565;201706;1460;5213;1253;4885;60;295;994;3962;1054;4257
210570;201706;12128;33907;11148;32808;585;1417;9871;29702;10456;31119
210580;201706;3181;9095;2868;8713;299;614;2281;7347;2580;7961
210590;201706;4009;12716;3698;12307;212;892;3202;10559;3414;11451
210592;201706;2546;7896;2430;7711;51;257;2114;6657;2165;6914
210594;201706;2760;7692;2203;6839;114;328;1617;5184;1731;5512
210596;201706;2601;9586;2469;9329;241;1012;1841;7046;2082;8058
210598;201706;1757;5482;1639;5338;92;387;1449;4681;1541;5068
210600;201706;3218;9037;2723;8378;127;436;2161;6640;2288;7076
210610;201706;2531;8110;2330;7852;135;617;2001;6609;2136;7226
210620;201706;2089;6644;1903;6417;49;112;1731;5995;1780;6107
210630;201706;3318;11712;3047;11278;245;1149;2305;8390;2550;9539
210632;201706;4559;15552;4186;15000;441;1753;3204;11516;3645;13269
210635;201706;1894;6613;1783;6430;80;282;1552;5694;1632;5976
210637;201706;2681;9141;2438;8791;145;602;1927;7042;2072;7644
210640;201706;4732;18871;4655;18790;32;141;4532;18418;4564;18559
210650;201706;7124;21052;6880;20740;123;380;6575;19885;6698;20265
210660;201706;8446;24543;7625;23357;262;998;6681;20260;6943;21258
210663;201706;2753;8384;2623;8227;123;387;2268;7250;2391;7637
210667;201706;1917;6412;1800;6229;75;326;1555;5410;1630;5736
210670;201706;4582;16472;4341;16085;228;1039;3645;13560;3873;14599
210675;201706;5119;14098;4647;13511;430;1092;3729;11233;4159;12325
210680;201706;4020;10737;3500;10111;145;377;3059;8951;3204;9328
210690;201706;7561;25248;7232;24899;322;1108;6307;22495;6629;23603
210700;201706;2669;7674;2416;7388;281;664;1800;6127;2081;6791
210710;201706;4919;15985;4624;15550;198;876;3934;13186;4132;14062
210720;201706;2669;9371;2507;9149;96;475;2258;8187;2354;8662
210725;201706;1103;4174;1005;3971;35;131;773;3202;808;3333
210730;201706;1214;3501;1044;3266;79;243;817;2578;896;2821
210735;201706;4296;14036;3873;13352;424;1537;2950;10365;3374;11902
210740;201706;5156;14950;4814;14599;192;885;4263;12641;4455;13526
210745;201706;4281;12051;4025;11747;221;593;3457;10162;3678;10755
210750;201706;19738;53377;17338;50615;2136;6223;12516;37670;14652;43893
210760;201706;5895;16803;5397;16280;32;88;5230;15875;5262;15963
210770;201706;5939;16135;5108;15177;94;378;4603;13704;4697;14082
210780;201706;7776;25889;7134;24801;796;2734;5111;18306;5907;21040
210790;201706;4855;15038;4455;14558;204;541;3588;12374;3792;12915
210800;201706;4910;13522;4377;12885;104;373;3931;11578;4035;11951
210805;201706;3843;15251;3710;15046;185;944;3179;12937;3364;13881
210810;201706;5364;16043;4971;15548;288;591;4336;14137;4624;14728
210820;201706;7719;22196;6869;20883;808;2345;4718;14761;5526;17106
210825;201706;5939;20009;5667;19648;549;1800;4584;16406;5133;18206
210830;201706;8457;24182;7970;23595;664;1634;6638;20352;7302;21986
210840;201706;3603;9744;3231;9232;93;326;2759;7822;2852;8148
210845;201706;6118;17716;5911;17494;63;136;5750;17169;5813;17305
210850;201706;6239;21475;5572;20424;519;2252;4092;14967;4611;17219
210860;201706;17905;52158;15890;49322;1040;3335;12655;39867;13695;43202
210870;201706;5891;19257;5353;18572;487;1690;4309;15256;4796;16946
210880;201706;4361;14019;4124;13724;277;1062;3400;11315;3677;12377
210890;201706;4848;14477;4455;14027;320;822;3732;12348;4052;13170
210900;201706;4864;14437;3959;12948;1546;5332;954;3430;2500;8762
210905;201706;1878;5732;1641;5397;92;261;1330;4501;1422;4762
210910;201706;8238;26053;7263;24410;909;3269;4912;16580;5821;19849
210920;201706;2865;10427;2720;10181;132;673;2282;8527;2414;9200
210923;201706;1492;4959;1379;4788;132;523;947;3369;1079;3892
210927;201706;4816;15492;4539;15196;108;357;4243;14363;4351;14720
210930;201706;2492;8900;2327;8673;116;630;1931;7069;2047;7699
210940;201706;3197;11202;3071;10999;157;740;2648;9359;2805;10099
210945;201706;5805;17666;5575;17409;283;695;5008;15849;5291;16544
210950;201706;5327;16095;4436;14723;507;1630;3092;10602;3599;12232
210955;201706;1851;5854;1638;5534;154;538;1142;3962;1296;4500
210960;201706;9130;28728;8363;27694;1704;5348;5078;18052;6782;23400
210970;201706;1360;4640;1189;4349;134;578;843;3014;977;3592
210975;201706;1765;5863;1664;5677;150;536;1231;4203;1381;4739
210980;201706;10343;23641;9897;23188;387;724;9103;21721;9490;22445
210990;201706;16423;50152;13535;46022;2831;9948;7081;25274;9912;35222
211000;201706;15574;48329;13776;46291;778;3232;11434;39036;12212;42268
211003;201706;4730;16778;4267;16184;267;1228;3328;12937;3595;14165
211010;201706;6606;23941;6214;23462;80;403;5802;22112;5882;22515
211020;201706;7625;24368;7313;23910;490;1824;6101;19933;6591;21757
211023;201706;2202;7419;2115;7282;156;637;1713;5857;1869;6494
211027;201706;2929;10604;2866;10499;294;1170;2321;8501;2615;9671
211030;201706;3902;11657;3632;11371;420;907;2930;9831;3350;10738
211040;201706;4579;16770;4367;16462;165;948;3779;14218;3944;15166
211050;201706;10094;25693;9558;25115;206;546;9027;23730;9233;24276
211060;201706;6162;21338;5942;21034;420;1600;5060;18058;5480;19658
211065;201706;2060;6333;1834;6021;51;159;1632;5413;1683;5572
211070;201706;7994;27013;7277;25849;386;1483;5960;21419;6346;22902
211080;201706;1339;3951;1160;3678;74;360;882;2641;956;3001
211085;201706;2027;6585;1848;6291;192;661;1395;4834;1587;5495
211090;201706;3455;9795;3202;9454;95;432;2782;8066;2877;8498
211100;201706;6462;17131;6297;16941;35;142;6092;16345;6127;16487
211102;201706;2866;10855;2707;10634;203;846;2278;9105;2481;9951
211105;201706;2505;8211;2150;7635;235;899;1499;5294;1734;6193
211107;201706;4622;14565;4079;13815;246;842;3248;11366;3494;12208
211110;201706;6343;18368;5057;16458;763;2357;3319;11285;4082;13642
211120;201706;36767;104353;33752;100863;4687;13247;24779;76914;29466;90161
211125;201706;2094;6506;1834;6092;114;408;1506;5047;1620;5455
211130;201706;171919;452348;160415;438115;23771;68046;78643;235068;102414;303114
211140;201706;5191;16655;4811;16079;221;868;4066;13582;4287;14450
211150;201706;9728;27662;8654;26359;365;1365;7328;22338;7693;23703
211153;201706;2720;8419;2463;8087;499;1677;1602;5491;2101;7168
211157;201706;1156;3687;991;3423;72;350;674;2350;746;2700
211160;201706;4210;13400;3533;12274;260;1244;2409;8104;2669;9348
211163;201706;1775;6040;1671;5897;42;119;1523;5509;1565;5628
211167;201706;1540;5007;1465;4896;35;145;1373;4587;1408;4732
211170;201706;6203;16171;5945;15859;90;307;5571;14763;5661;15070
211172;201706;2484;7144;2224;6769;96;402;1883;5624;1979;6026
211174;201706;2747;8091;2525;7810;64;338;2305;7037;2369;7375
211176;201706;4269;13145;3623;12287;300;1208;2742;9343;3042;10551
211178;201706;4406;10658;4005;10208;40;128;3787;9566;3827;9694
211180;201706;4240;14502;3990;14140;283;1099;3360;11986;3643;13085
211190;201706;2937;9389;2679;9001;77;375;2269;7549;2346;7924
211195;201706;1482;4361;1251;4064;73;220;1022;3425;1095;3645
211200;201706;2185;7029;1907;6647;305;1058;1185;4354;1490;5412
211210;201706;6828;20683;6442;20178;372;1225;5537;17457;5909;18682
211220;201706;34262;96495;30016;91113;4474;13910;20103;62965;24577;76875
211223;201706;5126;15506;4652;14788;445;1371;3502;11333;3947;12704
211227;201706;1715;6017;1561;5791;68;299;1332;5006;1400;5305
211230;201706;7981;25438;7214;24192;708;2530;5425;18343;6133;20873
211240;201706;8116;27549;7699;27011;247;1248;6936;24043;7183;25291
211245;201706;5749;16748;5710;16709;60;108;5620;16543;5680;16651
211250;201706;13748;42342;12867;41310;893;2683;10843;35628;11736;38311
211260;201706;8474;26045;7973;25389;328;1236;7174;22868;7502;24104
211270;201706;10399;34871;9307;33491;537;2461;7400;27060;7937;29521
211280;201706;13393;39151;12193;37634;917;2302;9895;31765;10812;34067
211285;201706;1774;6435;1558;5995;254;1078;763;3004;1017;4082
211290;201706;7155;23100;6823;22657;364;1229;5873;19714;6237;20943
211300;201706;8284;24457;7714;23691;120;355;7217;22303;7337;22658
211400;201706;11850;36417;10110;33869;2301;7841;5337;19487;7638;27328
220005;201706;1869;5265;1689;5000;64;258;1335;3832;1399;4090
220010;201706;1433;4154;1258;3880;30;130;993;3006;1023;3136
220020;201706;3332;10380;3105;10000;544;1788;1961;6346;2505;8134
220025;201706;2298;5527;2043;5173;38;117;1680;4156;1718;4273
220027;201706;1367;3602;1210;3398;57;171;959;2680;1016;2851
220030;201706;3294;8707;3175;8518;137;446;2715;7125;2852;7571
220040;201706;7657;23459;7007;22300;1254;4035;4475;14308;5729;18343
220045;201706;1413;4602;1272;4324;55;266;970;3211;1025;3477
220050;201706;4523;13454;3892;12427;183;754;3128;9913;3311;10667
220060;201706;2169;5183;1915;4891;33;78;1735;4428;1768;4506
220070;201706;2429;6905;2181;6515;110;308;1737;5197;1847;5505
220080;201706;691;2080;638;2000;37;147;532;1601;569;1748
220090;201706;1842;4556;1509;4105;44;154;1303;3494;1347;3648
220095;201706;732;1930;686;1867;12;44;634;1707;646;1751
220100;201706;1327;3924;1084;3478;58;242;863;2718;921;2960
220105;201706;2226;6975;1969;6480;139;472;1437;4779;1576;5251
220110;201706;3418;9768;3279;9550;78;304;2869;8244;2947;8548
220115;201706;2631;8599;2512;8398;129;535;2176;7185;2305;7720
220117;201706;1282;3364;1041;2996;37;107;872;2496;909;2603
220120;201706;11926;34706;11086;33685;136;613;10368;31405;10504;32018
220130;201706;910;2939;804;2782;29;177;693;2349;722;2526
220140;201706;1716;4477;1489;4205;147;298;1204;3528;1351;3826
220150;201706;7055;21025;6658;20477;192;843;5759;17490;5951;18333
220155;201706;1100;3318;874;2889;39;157;594;1932;633;2089
220157;201706;1090;2735;930;2477;21;78;750;1937;771;2015
220160;201706;2625;7842;2325;7283;80;380;1859;5687;1939;6067
220170;201706;1392;4065;1185;3731;37;180;980;3032;1017;3212
220173;201706;2012;6029;1694;5429;53;279;1319;4115;1372;4394
220177;201706;1835;5423;1796;5373;32;126;1717;5119;1749;5245
220180;201706;1185;3109;926;2632;17;67;663;1780;680;1847
220190;201706;4911;15132;4485;14574;491;1673;3395;11065;3886;12738
220191;201706;1410;4614;1319;4451;113;456;986;3252;1099;3708
220192;201706;1821;5124;1460;4486;57;201;1106;3369;1163;3570
220194;201706;1805;5319;1597;5004;93;358;1245;3809;1338;4167
220196;201706;2058;5833;1886;5537;97;367;1536;4423;1633;4790
220198;201706;1367;3826;1038;3390;12;41;960;3183;972;3224
220200;201706;4549;14675;4203;14228;308;1132;3421;11603;3729;12735
220202;201706;2180;6332;1886;5818;27;150;1618;4901;1645;5051
220205;201706;2760;7252;2460;6849;50;192;2147;5886;2197;6078
220207;201706;858;2626;736;2411;63;254;497;1598;560;1852
220208;201706;1797;5676;1534;5222;259;990;845;2846;1104;3836
220209;201706;1595;4710;1376;4330;34;146;1104;3460;1138;3606
220210;201706;1646;4379;1433;4034;42;179;1143;3102;1185;3281
220211;201706;1572;4358;1495;4255;37;151;1300;3661;1337;3812
220213;201706;1712;4795;1561;4496;33;128;1260;3540;1293;3668
220217;201706;2026;6315;1939;6212;39;156;1790;5785;1829;5941
220220;201706;10552;28752;9368;26973;666;1796;6878;20240;7544;22036
220225;201706;1119;3149;917;2873;25;101;756;2345;781;2446
220230;201706;5569;14575;5032;13840;226;605;4328;11963;4554;12568
220240;201706;2887;8781;2657;8345;102;400;2168;6748;2270;7148
220245;201706;1531;4019;1277;3677;22;76;1115;3272;1137;3348
220250;201706;3038;8869;2738;8422;68;288;2363;7266;2431;7554
220253;201706;1618;4669;1363;4216;148;466;1009;3095;1157;3561
220255;201706;1781;4812;1520;4375;40;192;1211;3314;1251;3506
220260;201706;4553;14503;4037;13563;287;1014;3014;10223;3301;11237
220265;201706;1331;4519;1215;4328;108;440;824;2936;932;3376
220270;201706;6838;21842;6510;21249;438;1786;5211;16565;5649;18351
220271;201706;1495;4091;1317;3811;53;153;1083;3175;1136;3328
220272;201706;1797;5338;1621;5036;52;215;1235;3764;1287;3979
220273;201706;1221;3506;1052;3196;63;222;783;2361;846;2583
220275;201706;2180;5409;1739;4884;44;173;1482;4122;1526;4295
220277;201706;2240;6048;1952;5600;59;210;1562;4378;1621;4588
220280;201706;1519;4114;1324;3770;76;277;1038;2852;1114;3129
220285;201706;1667;4327;1365;3927;26;109;1235;3553;1261;3662
220290;201706;6146;19933;5217;18584;568;2231;3560;12712;4128;14943
220300;201706;1805;5990;1607;5683;78;433;1265;4339;1343;4772
220310;201706;2515;8101;2237;7779;79;388;1872;6508;1951;6896
220320;201706;3002;9112;2538;8275;249;944;1814;5852;2063;6796
220323;201706;1507;5189;1309;4888;128;521;1021;3817;1149;4338
220325;201706;1209;3756;1026;3395;54;223;778;2557;832;2780
220327;201706;1344;4247;1218;4019;59;280;979;3147;1038;3427
220330;201706;3727;10040;3292;9452;149;458;2784;7990;2933;8448
220335;201706;1794;5447;1614;5239;33;116;1503;4905;1536;5021
220340;201706;1891;5123;1554;4584;78;282;1116;3178;1194;3460
220342;201706;1160;3661;1085;3543;64;250;863;2827;927;3077
220345;201706;2911;7166;2563;6688;33;64;2366;6191;2399;6255
220350;201706;3776;9980;3147;8975;174;605;2356;6595;2530;7200
220360;201706;1276;3396;1086;3115;62;195;847;2368;909;2563
220370;201706;9426;26508;8541;25376;265;1055;7554;22283;7819;23338
220375;201706;1507;4597;1397;4458;13;36;1344;4323;1357;4359
220380;201706;1393;3672;1178;3366;32;116;992;2774;1024;2890
220385;201706;865;2179;690;1891;12;51;559;1490;571;1541
220390;201706;8932;27039;7890;25239;1989;6554;3256;10763;5245;17317
220400;201706;1512;3784;1174;3240;29;113;920;2437;949;2550
220410;201706;1201;3431;1017;3140;71;231;782;2376;853;2607
220415;201706;839;2285;729;2117;30;105;525;1486;555;1591
220420;201706;2170;6203;1799;5487;96;299;1314;3967;1410;4266
220430;201706;2506;6891;2442;6813;106;339;2178;6024;2284;6363
220435;201706;1725;4923;1566;4667;56;194;1207;3558;1263;3752
220440;201706;2421;7894;2266;7669;155;565;1805;6021;1960;6586
220450;201706;2006;6095;1696;5653;323;1212;1077;3562;1400;4774
220455;201706;1318;4100;1246;3997;40;149;1111;3558;1151;3707
220460;201706;906;2471;823;2369;49;154;693;1953;742;2107
220465;201706;2384;7742;2173;7416;213;764;1624;5585;1837;6349
220470;201706;3634;10674;3315;10166;139;464;2634;7963;2773;8427
220480;201706;2456;6881;2124;6346;143;365;1531;4548;1674;4913
220490;201706;2318;6378;2111;6121;49;167;1853;5346;1902;5513
220500;201706;3140;8398;2709;7690;88;368;2080;5700;2168;6068
220510;201706;2866;8320;2309;7341;106;367;1709;5462;1815;5829
220515;201706;1840;4438;1629;4161;94;239;1389;3531;1483;3770
220520;201706;5140;13786;4714;13225;105;308;4224;11876;4329;12184
220525;201706;1272;3515;1194;3406;40;147;1007;2836;1047;2983
220527;201706;1395;4138;1232;3836;83;264;911;2890;994;3154
220530;201706;1276;3566;1119;3341;53;215;970;2824;1023;3039
220535;201706;855;2541;811;2480;66;225;620;1872;686;2097
220540;201706;3538;11167;3374;10919;118;521;2920;9382;3038;9903
220545;201706;1412;4599;1335;4458;103;406;1048;3454;1151;3860
220550;201706;9353;29252;8565;27932;666;2446;6382;20572;7048;23018
220551;201706;1489;4557;1313;4268;74;320;1021;3213;1095;3533
220552;201706;1597;4882;1382;4482;75;381;1064;3293;1139;3674
220553;201706;1642;4626;1372;4216;62;226;1036;3249;1098;3475
220554;201706;799;2300;703;2157;46;121;541;1661;587;1782
220555;201706;2120;6771;1968;6549;53;286;1664;5435;1717;5721
220556;201706;1383;4208;1232;3910;51;232;914;2769;965;3001
220557;201706;1581;4949;1407;4610;109;401;1016;3301;1125;3702
220558;201706;1130;3372;985;3148;42;191;786;2448;828;2639
220559;201706;1592;4344;1404;4032;21;70;1169;3347;1190;3417
220560;201706;1632;4007;1322;3587;40;121;1129;3008;1169;3129
220570;201706;7246;23141;6824;22401;756;2619;4959;16468;5715;19087
220580;201706;6734;20126;6524;19797;231;766;5856;17635;6087;18401
220585;201706;2065;6834;1880;6497;108;465;1483;5040;1591;5505
220590;201706;1304;3815;1138;3561;115;383;777;2450;892;2833
220595;201706;2452;6973;2289;6758;33;162;2108;6140;2141;6302
220600;201706;1329;3175;1081;2848;77;115;875;2391;952;2506
220605;201706;1850;5438;1591;4995;49;197;1227;3757;1276;3954
220610;201706;2830;8295;2674;8076;50;221;2417;7243;2467;7464
220620;201706;7583;24864;7276;24442;247;1164;6464;21484;6711;22648
220630;201706;394;1202;323;1070;49;182;172;581;221;763
220635;201706;1686;5580;1496;5174;76;325;1127;3833;1203;4158
220640;201706;2762;7760;2429;7287;96;336;2006;5974;2102;6310
220650;201706;2152;6257;1905;5819;95;331;1403;4254;1498;4585
220660;201706;2868;8443;2578;8089;114;542;2236;6827;2350;7369
220665;201706;1234;3999;1122;3811;30;154;943;3166;973;3320
220667;201706;1675;5468;1516;5184;80;300;1228;4194;1308;4494
220669;201706;1808;5773;1723;5623;141;596;1319;4224;1460;4820
220670;201706;2002;5797;1745;5475;90;268;1497;4744;1587;5012
220672;201706;2489;7134;2284;6878;139;450;1971;5972;2110;6422
220675;201706;1288;3608;1188;3434;68;178;919;2659;987;2837
220680;201706;2466;7445;2344;7292;117;381;2036;6336;2153;6717
220690;201706;1717;4681;1483;4303;124;320;1095;3260;1219;3580
220695;201706;973;2750;878;2569;28;91;706;2050;734;2141
220700;201706;8372;23431;7222;21671;468;1609;5456;16160;5924;17769
220710;201706;840;2442;665;2097;50;143;466;1458;516;1601
220720;201706;2086;5247;1931;5019;58;181;1652;4247;1710;4428
220730;201706;1394;3959;1177;3622;30;131;966;2911;996;3042
220735;201706;1046;2574;816;2193;28;76;658;1738;686;1814
220740;201706;1425;4278;1207;3989;52;188;1004;3364;1056;3552
220750;201706;3994;11043;3628;10494;227;660;2996;8679;3223;9339
220755;201706;1203;3312;1072;3101;47;169;832;2351;879;2520
220760;201706;2943;9267;2644;8863;121;529;2247;7461;2368;7990
220770;201706;21575;70928;19373;66732;6579;23722;6177;22353;12756;46075
220775;201706;1229;3224;1176;3167;14;57;1145;3074;1159;3131
220777;201706;1574;4219;1306;3806;59;161;985;2867;1044;3028
220779;201706;1388;3496;1288;3363;39;144;1133;2908;1172;3052
220780;201706;5701;15366;5056;14352;351;1134;3986;11161;4337;12295
220785;201706;1441;3410;1337;3256;35;59;1243;3025;1278;3084
220790;201706;10415;30607;9506;29252;474;1832;7762;23585;8236;25417
220793;201706;823;2301;738;2173;37;124;597;1757;634;1881
220795;201706;1497;4063;1383;3911;58;200;1210;3414;1268;3614
220800;201706;16336;43405;14361;40384;1044;3297;10122;27647;11166;30944
220810;201706;3213;9169;2786;8441;87;337;2231;6627;2318;6964
220820;201706;5472;14598;4859;13728;366;1000;3881;10925;4247;11925
220830;201706;7383;20640;6829;19775;458;1398;5467;15798;5925;17196
220840;201706;13630;42387;12036;39229;2309;7610;6430;21290;8739;28900
220850;201706;2997;9720;2809;9493;96;461;2532;8508;2628;8969
220855;201706;603;1813;522;1673;27;122;405;1266;432;1388
220860;201706;977;2570;862;2396;30;99;728;1989;758;2088
220865;201706;2641;7106;2087;6169;50;237;1661;4746;1711;4983
220870;201706;2223;7325;1977;6998;51;252;1762;6209;1813;6461
220880;201706;4796;12606;4439;12191;53;178;4171;11454;4224;11632
220885;201706;1283;4504;1123;4209;74;360;850;3168;924;3528
220887;201706;1411;3387;1233;3141;15;61;1135;2858;1150;2919
220890;201706;1643;5523;1415;5069;115;427;1013;3694;1128;4121
220900;201706;1938;5129;1695;4782;40;123;1461;4074;1501;4197
220910;201706;1516;4496;1321;4197;43;134;1148;3685;1191;3819
220915;201706;990;2785;850;2515;32;142;653;1865;685;2007
220920;201706;1341;4782;1199;4571;97;480;888;3311;985;3791
220930;201706;1497;4643;1363;4443;42;205;1165;3749;1207;3954
220935;201706;1052;3100;868;2704;36;136;597;1760;633;1896
220937;201706;1502;4033;1266;3659;40;151;992;2807;1032;2958
220940;201706;1333;4118;1202;3864;58;249;866;2702;924;2951
220945;201706;418;1526;372;1430;30;148;262;985;292;1133
220950;201706;1324;3205;916;2531;19;80;705;1882;724;1962
220955;201706;1489;4178;1306;3860;62;172;1031;3051;1093;3223
220960;201706;917;2324;727;2012;20;72;568;1550;588;1622
220965;201706;1678;4851;1551;4661;35;206;1343;3901;1378;4107
220970;201706;1919;5113;1507;4443;71;226;1151;3386;1222;3612
220975;201706;735;2307;663;2216;31;184;578;1845;609;2029
220980;201706;1258;3668;1115;3434;44;157;878;2680;922;2837
220985;201706;1222;3524;1128;3379;65;250;849;2432;914;2682
220987;201706;1476;4630;1323;4377;79;337;1046;3402;1125;3739
220990;201706;1811;5183;1545;4743;44;211;1182;3526;1226;3737
220995;201706;1253;3669;963;3206;77;276;665;2267;742;2543
220997;201706;2416;7124;2296;6958;51;216;2113;6345;2164;6561
221000;201706;4199;12453;3927;12005;255;993;3114;9357;3369;10350
221005;201706;1447;4333;1321;4102;170;486;897;2779;1067;3265
221010;201706;1236;3083;1052;2859;25;87;919;2452;944;2539
221020;201706;1686;5242;1561;5006;51;233;1130;3553;1181;3786
221030;201706;1480;4308;1312;4034;59;247;1045;3133;1104;3380
221035;201706;1528;4109;1417;3964;53;121;1286;3683;1339;3804
221037;201706;600;1769;528;1644;12;57;356;1056;368;1113
221038;201706;595;1665;466;1448;30;104;291;906;321;1010
221039;201706;965;2614;848;2439;23;80;695;1947;718;2027
221040;201706;4540;13877;4186;13290;202;675;3277;10466;3479;11141
221050;201706;3638;10439;3348;10069;86;313;2984;8925;3070;9238
221060;201706;8179;23749;7028;21847;410;1473;5374;16614;5784;18087
221062;201706;1302;4456;1163;4172;61;310;891;3141;952;3451
221063;201706;1108;3441;981;3230;95;328;680;2243;775;2571
221065;201706;2816;7404;2475;6863;79;236;2079;5680;2158;5916
221070;201706;3684;11657;3173;10685;181;718;2337;7799;2518;8517
221080;201706;3563;8833;2888;7880;88;328;2326;6279;2414;6607
221090;201706;1396;3818;1204;3494;36;142;999;2836;1035;2978
221093;201706;1573;4623;1477;4435;186;601;918;2649;1104;3250
221095;201706;975;2589;844;2381;11;33;698;1935;709;1968
221097;201706;821;2241;655;1938;25;90;475;1359;500;1449
221100;201706;101528;296164;92485;280715;17650;56064;53048;158985;70698;215049
221110;201706;10533;32332;9748;31373;390;1782;8288;26296;8678;28078
221120;201706;4171;13034;3983;12719;498;1713;2936;9345;3434;11058
221130;201706;4578;12877;3737;11174;1026;2968;1591;4866;2617;7834
221135;201706;1567;4573;1443;4399;66;241;1237;3736;1303;3977
221140;201706;1346;3275;1204;3074;23;58;1059;2670;1082;2728
221150;201706;1206;3022;957;2597;27;106;711;1852;738;1958
221160;201706;783;2026;723;1946;30;82;583;1560;613;1642
221170;201706;1160;3417;1055;3247;35;127;832;2527;867;2654
230010;201706;3392;9050;2736;7926;210;699;2054;5822;2264;6521
230015;201706;2923;9934;2738;9549;291;1163;1796;6174;2087;7337
230020;201706;13851;44391;13426;43709;601;2470;11407;36745;12008;39215
230030;201706;12191;33764;10801;31695;436;1621;9037;26265;9473;27886
230040;201706;4351;11913;3729;10840;221;786;2823;8069;3044;8855
230050;201706;2684;8868;1996;7053;478;1631;581;2113;1059;3744
230060;201706;2355;6559;1983;5911;83;318;1552;4526;1635;4844
230070;201706;4186;11981;3628;10931;241;862;2489;7559;2730;8421
230075;201706;9146;31116;8513;29941;559;2799;6596;22580;7155;25379
230080;201706;2433;6101;1974;5414;64;258;1621;4354;1685;4612
230090;201706;4076;11172;3598;10393;282;938;2575;7307;2857;8245
230100;201706;16801;49164;15658;47175;2470;7913;9208;27873;11678;35786
230110;201706;12374;38986;11301;36742;2111;7236;6036;19456;8147;26692
230120;201706;7937;21824;6896;20237;727;2074;4808;14612;5535;16686
230125;201706;3059;8649;2558;7762;132;479;1885;5670;2017;6149
230130;201706;5742;18501;4866;16626;560;2057;3098;10403;3658;12460
230140;201706;3587;11143;3047;10170;196;790;2116;7014;2312;7804
230150;201706;1666;5104;1449;4642;300;982;748;2417;1048;3399
230160;201706;6435;18091;5704;17035;289;1120;4568;13460;4857;14580
230170;201706;6202;19072;5415;17578;310;1229;3855;12302;4165;13531
230180;201706;1712;4928;1487;4481;60;260;1089;3123;1149;3383
230185;201706;3865;12392;3445;11614;481;1668;2254;7725;2735;9393
230190;201706;12540;39301;11044;36269;1776;6170;5640;18463;7416;24633
230195;201706;5293;15984;4680;14917;267;1043;3631;11341;3898;12384
230200;201706;5093;14418;4589;13472;283;946;3479;9981;3762;10927
230205;201706;4121;13221;3758;12558;266;1138;2629;8653;2895;9791
230210;201706;8971;25051;7873;23289;883;2809;5305;15771;6188;18580
230220;201706;13239;36812;11960;34673;791;2683;9040;25805;9831;28488
230230;201706;7316;22927;6706;21767;598;2058;4729;15327;5327;17385
230240;201706;13588;36917;11879;34144;583;1760;9170;26171;9753;27931
230250;201706;9760;29487;9705;29384;577;2126;7414;21890;7991;24016
230260;201706;14516;47006;13269;44460;1831;6533;7675;26006;9506;32539
230270;201706;7607;21734;6312;19360;776;2526;3910;12063;4686;14589
230280;201706;20210;58120;17644;53652;1097;4088;13255;39363;14352;43451
230290;201706;4841;14348;4159;12950;488;1434;2818;8873;3306;10307
230300;201706;4447;12880;4231;12583;222;866;3502;10220;3724;11086
230310;201706;4937;14407;4269;13246;165;681;3014;9165;3179;9846
230320;201706;7436;22190;6681;20858;438;1725;4989;15290;5427;17015
230330;201706;4973;14088;4161;12528;296;983;2931;8693;3227;9676
230340;201706;3518;11479;3162;10727;290;1093;2145;7177;2435;8270
230350;201706;18439;54464;16786;51577;1437;5294;10342;32048;11779;37342
230360;201706;3256;9063;2514;7704;179;640;1655;5012;1834;5652
230365;201706;3123;8030;2691;7320;84;328;2239;5988;2323;6316
230370;201706;54787;170556;49268;161200;12444;42653;21734;74132;34178;116785
230380;201706;6665;19022;5466;16762;238;881;3837;11571;4075;12452
230390;201706;3374;10532;3037;9948;191;818;2226;7133;2417;7951
230393;201706;3123;9986;2674;9111;161;798;1918;6264;2079;7062
230395;201706;5742;16306;5140;15286;671;2046;3187;9645;3858;11691
230400;201706;5593;16451;5017;15497;243;1019;3897;11744;4140;12763
230410;201706;14692;45729;12457;41087;1658;5699;7301;24158;8959;29857
230420;201706;24320;75619;21875;70810;3908;13475;10772;34660;14680;48135
230423;201706;4345;13694;3955;12897;198;799;3084;9937;3282;10736
230425;201706;5579;18125;5101;17115;638;2167;3308;11164;3946;13331
230426;201706;2577;7142;2047;6119;64;282;1500;4373;1564;4655
230427;201706;1906;5536;1411;4450;101;305;878;2687;979;2992
230428;201706;8953;27021;8412;25999;1459;4904;4424;13388;5883;18292
230430;201706;4509;13901;4031;12998;287;1104;2917;9147;3204;10251
230435;201706;5318;16005;4703;14878;618;2162;2757;8691;3375;10853
230440;201706;373194;1055554;334335;990221;67698;211005;163873;487644;231571;698649
230445;201706;4517;12236;3862;11139;223;657;2729;7817;2952;8474
230450;201706;3726;11297;3257;10475;277;1152;2269;7139;2546;8291
230460;201706;1950;6164;1692;5687;144;545;1218;4079;1362;4624
230465;201706;4057;11810;3394;10591;162;652;2373;7174;2535;7826
230470;201706;11027;39051;10169;37333;1122;4864;7042;25530;8164;30394
230480;201706;1482;4511;1256;4068;130;508;862;2722;992;3230
230490;201706;2362;7018;2061;6453;267;870;1095;3326;1362;4196
230495;201706;5678;18242;5156;17204;558;2294;3140;10314;3698;12608
230500;201706;8795;30730;8362;29850;535;2412;6285;22280;6820;24692
230510;201706;1555;5318;1178;4355;259;1031;407;1511;666;2542
230520;201706;4382;13278;4047;12641;384;1341;2749;8440;3133;9781
230523;201706;15137;47649;13086;43024;3075;10625;3226;11014;6301;21639
230526;201706;4096;11971;3516;10947;189;796;2722;8302;2911;9098
230530;201706;5517;17329;4942;16508;677;2391;3303;11304;3980;13695
230533;201706;4138;11187;3591;10192;319;852;2598;7466;2917;8318
230535;201706;5577;16086;4814;14699;417;1308;3167;9879;3584;11187
230540;201706;17344;49896;15613;47187;523;2214;12998;38694;13521;40908
230550;201706;19638;56781;17149;52117;2676;8937;9271;27702;11947;36639
230560;201706;6978;19512;5994;17736;185;766;4611;13426;4796;14192
230565;201706;3514;9507;2848;8312;110;415;2077;5979;2187;6394
230570;201706;3645;9691;3188;9089;108;367;2588;7309;2696;7676
230580;201706;10218;29607;9310;28292;511;1921;7735;23227;8246;25148
230590;201706;9217;27537;7803;24854;545;2044;5391;16703;5936;18747
230600;201706;3761;10233;2886;8495;100;317;1874;5587;1974;5904
230610;201706;6357;19283;5782;18346;543;1771;4215;13408;4758;15179
230620;201706;2200;6169;1724;5159;197;623;947;2735;1144;3358
230625;201706;7892;24965;7084;23188;2108;7369;1967;6517;4075;13886
230630;201706;10716;33286;9759;31490;2590;7903;4336;15090;6926;22993
230640;201706;27252;84969;24760;81223;2291;8513;18696;60987;20987;69500
230650;201706;4831;14489;4356;13563;278;1035;3238;9860;3516;10895
230655;201706;9549;34428;9177;33724;708;3063;7110;26187;7818;29250
230660;201706;6283;19144;5329;17274;266;1312;4150;13070;4416;14382
230670;201706;6059;15733;4817;13571;178;602;3681;10074;3859;10676
230680;201706;2631;7660;2284;6975;282;884;1410;4311;1692;5195
230690;201706;6496;20476;6129;19662;648;2310;3715;11686;4363;13996
230700;201706;9727;26557;8561;24443;512;1818;6124;16814;6636;18632
230710;201706;7487;23741;6460;21830;723;2544;4446;15064;5169;17608
230720;201706;1870;5825;1597;5219;205;714;962;3123;1167;3837
230725;201706;3752;12409;3209;11064;775;2745;975;3398;1750;6143
230730;201706;55086;164852;47275;151549;13156;46523;11815;40101;24971;86624
230740;201706;6323;18311;5648;17184;236;894;4364;13125;4600;14019
230750;201706;8308;23576;7210;21744;345;1285;5422;15977;5767;17262
230760;201706;11316;32680;10356;30859;913;3229;7228;20797;8141;24026
230763;201706;4335;12884;3795;11842;232;976;2816;8423;3048;9399
230765;201706;40080;122282;35522;113613;8941;30287;11197;36856;20138;67143
230770;201706;25372;68833;22604;64784;2939;8877;14203;40740;17142;49617
230780;201706;5926;21973;5669;21398;1139;4294;3073;12079;4212;16373
230790;201706;2933;8954;2734;8627;207;731;2098;6619;2305;7350
230800;201706;7560;25950;6933;24589;1154;4530;3642;12681;4796;17211
230810;201706;12068;38152;11287;36807;730;2889;8549;27392;9279;30281
230820;201706;3310;11164;2898;10262;341;1397;1665;5741;2006;7138
230830;201706;7516;22320;6629;20684;334;1304;5035;15420;5369;16724
230835;201706;3956;10220;3227;9055;145;507;2512;6923;2657;7430
230837;201706;3170;10494;2760;9659;190;849;1990;6766;2180;7615
230840;201706;9033;28785;8329;27604;685;2594;6338;21024;7023;23618
230850;201706;9516;29035;8734;27645;809;2770;6026;19052;6835;21822
230860;201706;5200;14292;4554;13325;234;797;3662;10595;3896;11392
230870;201706;18184;46952;15844;43429;652;2065;12201;33155;12853;35220
230880;201706;1998;6576;1856;6303;115;556;1343;4422;1458;4978
230890;201706;4244;14707;3931;14060;416;1648;2642;9352;3058;11000
230900;201706;2858;9256;2426;8307;434;1410;1252;4371;1686;5781
230910;201706;3140;9000;2568;7993;149;654;1897;5746;2046;6400
230920;201706;4777;13419;4420;12961;188;722;3748;10976;3936;11698
230930;201706;6893;20469;6072;18886;529;1752;3972;12282;4501;14034
230940;201706;7618;21578;6856;20295;242;894;5541;16288;5783;17182
230945;201706;6314;18634;5516;17271;444;1504;3747;11891;4191;13395
230950;201706;6562;17128;5991;16414;181;461;5215;14600;5396;15061
230960;201706;14033;43051;12841;40725;2100;7044;6263;20077;8363;27121
230970;201706;13620;40204;11901;37166;2263;7685;5536;17251;7799;24936
230980;201706;2943;8923;2550;8226;567;1811;1351;4541;1918;6352
230990;201706;1818;5203;1495;4599;106;431;974;2866;1080;3297
231000;201706;2599;7075;2159;6200;106;337;1468;4132;1574;4469
231010;201706;3091;8361;2536;7423;235;750;1732;4993;1967;5743
231020;201706;8054;26501;7525;25312;1260;4188;4495;15517;5755;19705
231025;201706;7683;23274;7047;22119;1025;3379;4468;14198;5493;17577
231030;201706;7356;23340;6148;20823;1137;3997;3190;10874;4327;14871
231040;201706;3189;9724;2823;9009;130;561;2094;6508;2224;7069
231050;201706;11992;33072;10097;29714;660;2085;7418;21694;8078;23779
231060;201706;2515;7909;2297;7546;115;569;1723;5541;1838;6110
231070;201706;8487;26252;7582;24462;1312;4361;4078;13374;5390;17735
231080;201706;4078;12307;3682;11618;152;777;2784;8418;2936;9195
231085;201706;5055;15121;4817;14772;498;1491;3483;11048;3981;12539
231090;201706;4186;11498;3336;9825;140;481;2315;6672;2455;7153
231095;201706;2108;6664;1829;6062;172;648;1239;4063;1411;4711
231100;201706;3203;9695;2683;8730;247;820;1803;5864;2050;6684
231110;201706;3507;11284;3461;11204;312;1199;2407;7607;2719;8806
231120;201706;1981;6512;1846;6238;241;847;1165;3933;1406;4780
231123;201706;2032;5484;1777;5038;122;374;1278;3553;1400;3927
231126;201706;6197;17508;5079;15389;228;829;3544;10506;3772;11335
231130;201706;19192;56962;17267;53882;2400;8111;10779;34382;13179;42493
231135;201706;4128;12036;3514;10901;203;724;2492;7648;2695;8372
231140;201706;17585;52912;15003;48076;1100;4581;9950;30909;11050;35490
231150;201706;5649;16149;4901;14736;739;2297;2431;7453;3170;9750
231160;201706;5833;19005;5424;18199;864;2977;3136;10624;4000;13601
231170;201706;4256;13319;3726;12230;250;998;2596;8269;2846;9267
231180;201706;14512;42417;12630;38527;2449;7653;6128;18535;8577;26188
231190;201706;4632;12880;3851;11675;221;902;2827;8265;3048;9167
231195;201706;4599;15162;4015;13937;329;1432;2746;9301;3075;10733
231200;201706;7895;26071;6917;24045;349;1800;4972;16723;5321;18523
231210;201706;4950;15374;4362;14422;245;1107;3226;10409;3471;11516
231220;201706;11817;32968;10272;30118;553;2012;7478;21306;8031;23318
231230;201706;8728;28583;7951;27408;649;2672;6009;20724;6658;23396
231240;201706;11802;36482;10771;34366;1990;6607;5859;18832;7849;25439
231250;201706;1933;5358;1348;3978;141;415;671;1941;812;2356
231260;201706;3360;9981;3026;9412;419;1277;1909;6085;2328;7362
231270;201706;7149;19176;6279;17826;259;1064;4771;13242;5030;14306
231280;201706;1767;5652;1649;5432;164;548;1105;3659;1269;4207
231290;201706;35081;113670;31592;106005;5847;21115;13837;45617;19684;66732
231300;201706;4312;12391;3544;10839;257;897;2344;7018;2601;7915
231310;201706;7481;20869;6151;18123;790;2349;3602;10460;4392;12809
231320;201706;7104;21049;5833;18503;214;894;4311;13500;4525;14394
231325;201706;2746;7805;2315;7108;471;1435;1177;3709;1648;5144
231330;201706;11109;34964;9590;31862;1765;5898;5065;17063;6830;22961
231335;201706;5627;15489;4813;14068;154;650;3928;11217;4082;11867
231340;201706;18117;58081;16601;55632;1257;4475;12615;42829;13872;47304
231350;201706;14917;42458;13949;41152;496;1451;12358;36807;12854;38258
231355;201706;4636;14388;4168;13572;275;1051;3044;9835;3319;10886
231360;201706;7759;24228;6854;22645;940;3223;4481;15029;5421;18252
231370;201706;2444;6700;1926;5830;57;196;1445;4337;1502;4533
231375;201706;4217;13959;3895;13348;197;930;3060;10314;3257;11244
231380;201706;5552;16232;5262;15871;241;686;4395;13602;4636;14288
231390;201706;3469;10593;3167;10040;280;1050;2210;6871;2490;7921
231395;201706;3912;12546;3511;11788;632;2158;1932;6556;2564;8714
231400;201706;9152;27611;8360;26047;479;1843;6232;19064;6711;20907
231410;201706;14931;48488;13624;46505;1287;4528;9982;34314;11269;38842
240010;201706;2449;7113;1993;6194;245;870;1148;3470;1393;4340
240020;201706;10417;31938;9341;29922;1460;4986;5193;16659;6653;21645
240030;201706;2591;7119;2491;6968;137;451;2158;5968;2295;6419
240040;201706;874;2512;728;2221;27;128;518;1511;545;1639
240050;201706;3461;9226;2887;8218;88;291;2253;6287;2341;6578
240060;201706;1432;3998;1243;3650;58;211;958;2715;1016;2926
240070;201706;2453;7342;2276;6981;278;905;1566;4720;1844;5625
240080;201706;3056;8069;2609;7420;130;434;1944;5474;2074;5908
240090;201706;2294;6014;1891;5306;40;150;1494;4102;1534;4252
240100;201706;8107;22633;7169;20744;594;1848;5092;14355;5686;16203
240110;201706;4736;14555;4159;13392;507;1848;2385;7563;2892;9411
240120;201706;2683;9223;2546;8928;318;1272;1604;5551;1922;6823
240130;201706;2832;7250;2469;6694;91;308;2081;5551;2172;5859
240140;201706;2264;6673;1902;5988;217;752;1170;3650;1387;4402
240145;201706;5901;18030;5210;16829;1001;3390;2923;9622;3924;13012
240150;201706;972;2942;823;2632;60;252;589;1817;649;2069
240160;201706;1472;4494;1249;4107;115;450;816;2696;931;3146
240165;201706;888;2715;761;2434;143;443;432;1409;575;1852
240170;201706;2333;6896;2009;6296;321;1083;1129;3464;1450;4547
240180;201706;2758;8511;2413;7801;405;1352;1416;4647;1821;5999
240185;201706;1380;4556;1270;4368;86;365;1008;3438;1094;3803
240190;201706;1008;3130;892;2930;40;180;684;2236;724;2416
240200;201706;12340;32966;10493;30062;2034;6009;4493;13216;6527;19225
240210;201706;2859;7857;2577;7402;96;373;2091;5829;2187;6202
240220;201706;7465;24472;6859;23597;698;2945;4782;16391;5480;19336
240230;201706;5824;15187;4938;13785;256;740;3935;10970;4191;11710
240240;201706;1774;5403;1108;3727;186;643;208;646;394;1289
240250;201706;2691;7748;2506;7503;165;486;2042;6147;2207;6633
240260;201706;12223;40162;11569;39096;1582;5840;7633;25917;9215;31757
240270;201706;2323;7187;2130;6865;129;445;1723;5600;1852;6045
240280;201706;1601;4366;1413;4109;62;200;1130;3252;1192;3452
240290;201706;1191;3698;1034;3377;48;238;692;2106;740;2344
240300;201706;2315;6211;1724;5022;138;435;913;2607;1051;3042
240310;201706;9423;26348;8385;24631;1130;3628;4524;13297;5654;16925
240320;201706;2007;5767;1558;4835;44;192;1145;3382;1189;3574
240325;201706;32415;90441;26190;80089;7458;24263;6587;21309;14045;45572
240330;201706;1499;4477;1259;3970;76;313;805;2432;881;2745
240340;201706;2087;5249;1706;4651;121;328;1261;3387;1382;3715
240350;201706;2079;5619;1916;5424;66;230;1697;4772;1763;5002
240360;201706;6814;20809;6148;19786;1592;5086;2958;10087;4550;15173
240370;201706;2063;5643;1636;4817;163;473;1022;2995;1185;3468
240375;201706;851;2255;755;2082;43;164;549;1433;592;1597
240380;201706;2426;7135;1821;5771;206;664;955;3007;1161;3671
240390;201706;922;2514;742;2155;21;62;493;1359;514;1421
240400;201706;1365;3595;1052;3004;56;179;720;1982;776;2161
240410;201706;449;1473;405;1384;62;264;235;779;297;1043
240420;201706;4717;17767;4366;16949;741;3371;2316;8836;3057;12207
240430;201706;3434;9449;3083;8813;160;622;2352;6431;2512;7053
240440;201706;2541;6385;2252;5970;323;911;1413;3690;1736;4601
240450;201706;4067;11872;3405;10608;384;1319;1922;5851;2306;7170
240460;201706;2951;8824;2773;8594;220;862;2203;6680;2423;7542
240470;201706;3559;11097;2778;9412;450;1528;1493;5093;1943;6621
240480;201706;539;1460;407;1206;38;120;195;578;233;698
240485;201706;2036;6232;1756;5674;177;587;1188;3883;1365;4470
240490;201706;1777;4376;1439;3844;26;77;1227;3254;1253;3331
240500;201706;2236;6195;1996;5854;95;332;1625;4732;1720;5064
240510;201706;1680;4865;1604;4746;136;410;1286;3776;1422;4186
240520;201706;1273;3496;1093;3226;60;234;870;2480;930;2714
240530;201706;1962;6292;1824;6076;226;803;1312;4360;1538;5163
240540;201706;1883;5377;1753;5180;98;344;1470;4265;1568;4609
240550;201706;782;2190;666;1989;40;120;482;1430;522;1550
240560;201706;3320;9235;3003;8792;299;779;2322;6944;2621;7723
240570;201706;3055;8339;2214;6433;301;930;982;2584;1283;3514
240580;201706;7920;23800;7315;22790;556;2003;5811;17886;6367;19889
240590;201706;743;2071;650;1903;21;81;497;1426;518;1507
240600;201706;1666;4764;1276;3934;119;435;749;2212;868;2647
240610;201706;4654;13236;4031;12054;332;1094;2683;7871;3015;8965
240615;201706;991;2893;815;2544;112;382;505;1526;617;1908
240620;201706;1861;5494;1639;5123;128;414;1259;3899;1387;4313
240630;201706;2060;6183;1874;5872;164;463;1273;4079;1437;4542
240640;201706;965;2642;795;2369;50;197;556;1590;606;1787
240650;201706;4015;11598;3593;10939;179;628;2832;8557;3011;9185
240660;201706;2453;7510;2302;7289;144;527;1852;5799;1996;6326
240670;201706;2603;7650;2163;6727;207;723;1280;3842;1487;4565
240680;201706;1539;4406;1242;3881;82;274;829;2552;911;2826
240690;201706;929;2501;789;2263;34;127;631;1740;665;1867
240700;201706;2546;7415;2116;6637;85;367;1624;4950;1709;5317
240710;201706;17722;47196;15353;43274;3025;8422;8105;23421;11130;31843
240720;201706;5224;14649;4709;13737;1098;3294;2334;6685;3432;9979
240725;201706;1037;3100;831;2625;58;197;506;1557;564;1754
240730;201706;2083;6156;1811;5646;123;386;1330;4125;1453;4511
240740;201706;1952;5553;1716;5109;106;405;1208;3443;1314;3848
240750;201706;2152;7918;1976;7568;393;1663;1012;3895;1405;5558
240760;201706;1364;3633;1043;3142;66;188;767;2362;833;2550
240770;201706;3132;8829;2800;8368;161;613;2296;6725;2457;7338
240780;201706;5958;16253;4802;14405;589;1801;2882;8808;3471;10609
240790;201706;904;2661;738;2348;33;127;529;1691;562;1818
240800;201706;35003;98800;30747;91570;6298;19610;13286;39877;19584;59487
240810;201706;84551;240461;77418;228078;19627;58480;35536;106876;55163;165356
240820;201706;5644;17764;5057;16831;1137;3934;2380;8325;3517;12259
240830;201706;8924;26777;8289;25855;421;1726;6763;20751;7184;22477
240840;201706;1121;3046;941;2733;79;252;631;1760;710;2012
240850;201706;1306;3772;969;3017;97;325;510;1576;607;1901
240860;201706;1271;3600;1026;3144;42;179;760;2224;802;2403
240870;201706;1165;3101;927;2686;66;204;616;1711;682;1915
240880;201706;1256;4093;1187;3980;97;388;945;3100;1042;3488
240890;201706;4994;13945;4094;12205;783;2434;1765;5222;2548;7656
240895;201706;2633;9041;2431;8704;245;943;1778;6437;2023;7380
240910;201706;3031;8831;2666;8133;99;375;2136;6444;2235;6819
240920;201706;791;2501;689;2275;104;364;338;1098;442;1462
240930;201706;3523;8839;3069;8284;92;251;2473;6775;2565;7026
240933;201706;1616;4205;1392;3846;56;202;1132;3037;1188;3239
240940;201706;6511;16934;5247;14833;629;1761;3332;9301;3961;11062
240950;201706;951;3048;872;2892;56;244;637;2045;693;2289
240960;201706;804;2466;703;2257;53;183;502;1595;555;1778
240970;201706;1883;5123;1586;4615;79;284;1243;3491;1322;3775
240980;201706;2875;9422;2674;9049;370;1365;1775;5944;2145;7309
240990;201706;2650;7826;2510;7555;385;1229;1639;4875;2024;6104
241000;201706;1036;2832;872;2537;47;157;596;1708;643;1865
241010;201706;2790;9311;2620;8989;309;1269;1826;6023;2135;7292
241020;201706;2028;5573;1592;4687;201;558;905;2647;1106;3205
241025;201706;1701;5044;1478;4641;79;304;959;2991;1038;3295
241030;201706;2407;7803;2099;7167;208;818;1398;4715;1606;5533
241040;201706;2252;7503;2045;7124;140;600;1524;5307;1664;5907
241050;201706;1279;3702;1076;3334;67;238;772;2338;839;2576
241060;201706;844;2408;749;2238;57;178;510;1493;567;1671
241070;201706;698;1996;626;1867;51;191;466;1307;517;1498
241080;201706;1150;3356;936;2936;30;138;686;2108;716;2246
241090;201706;2152;6320;1788;5696;91;391;1328;4169;1419;4560
241100;201706;1168;3404;997;3026;57;202;682;2023;739;2225
241105;201706;1198;3591;1034;3302;266;853;419;1379;685;2232
241110;201706;837;2541;686;2203;39;138;439;1348;478;1486
241120;201706;7389;22173;6654;20860;1580;4760;3336;11130;4916;15890
241140;201706;3407;9116;2915;8162;209;585;2079;5669;2288;6254
241142;201706;757;2181;584;1830;65;223;310;938;375;1161
241150;201706;5590;15941;4989;14934;345;1203;3633;10732;3978;11935
241160;201706;978;2803;875;2625;154;478;487;1425;641;1903
241170;201706;1179;3308;1093;3163;100;290;856;2447;956;2737
241180;201706;977;2696;764;2282;73;221;416;1227;489;1448
241190;201706;1187;3242;945;2733;51;187;629;1745;680;1932
241200;201706;19277;54231;16956;50715;4004;12542;7541;23247;11545;35789
241210;201706;1477;4080;1159;3439;119;384;695;2001;814;2385
241220;201706;8076;25926;7411;24703;2164;7316;3193;11080;5357;18396
241230;201706;3078;8661;2832;8272;136;480;2322;6632;2458;7112
241240;201706;1287;3726;841;2707;74;269;372;1204;446;1473
241250;201706;6141;18416;5097;16422;233;1143;3729;11552;3962;12695
241255;201706;1796;6541;1612;6128;260;1130;891;3369;1151;4499
241260;201706;5162;13773;4086;12065;161;685;2946;8492;3107;9177
241270;201706;1890;5667;1640;5170;114;448;1156;3568;1270;4016
241280;201706;1846;5245;1687;4952;151;466;1255;3647;1406;4113
241290;201706;2980;8095;2469;7212;144;524;1830;5217;1974;5741
241300;201706;1491;4179;1269;3777;46;159;854;2504;900;2663
241310;201706;1774;4991;1597;4706;72;269;1298;3772;1370;4041
241320;201706;945;3226;853;3015;116;461;525;1844;641;2305
241330;201706;1477;4386;1379;4259;79;329;1162;3527;1241;3856
241335;201706;2925;8584;2654;8099;133;479;2162;6480;2295;6959
241340;201706;1836;5555;1535;4872;333;1111;630;1937;963;3048
241350;201706;1938;5967;1747;5608;116;460;1311;4097;1427;4557
241355;201706;1435;3913;1147;3402;57;213;872;2541;929;2754
241360;201706;2121;5628;1724;4860;77;242;1254;3448;1331;3690
241370;201706;1391;4058;1138;3562;93;347;715;2143;808;2490
241380;201706;644;1802;538;1600;60;201;330;942;390;1143
241390;201706;2776;8818;2575;8505;240;900;1918;6306;2158;7206
241400;201706;3719;10499;3357;9974;308;990;2540;7597;2848;8587
241410;201706;2465;7422;2182;6997;371;1263;1341;4307;1712;5570
241415;201706;1700;5019;1495;4676;137;459;1095;3345;1232;3804
241420;201706;2269;7728;2020;7301;633;2430;546;2022;1179;4452
241430;201706;569;1665;437;1376;41;150;249;741;290;891
241440;201706;6289;22203;5914;21567;632;2675;4320;15697;4952;18372
241445;201706;1012;2837;959;2774;52;122;815;2471;867;2593
241450;201706;3014;7900;2627;7349;299;847;1851;5167;2150;6014
241460;201706;3458;9877;3039;9024;236;826;2124;6116;2360;6942
241470;201706;1438;3891;1171;3528;80;290;902;2708;982;2998
241475;201706;1268;3730;1041;3281;49;257;741;2205;790;2462
241480;201706;2700;8861;2451;8406;939;3264;640;2502;1579;5766
241490;201706;703;1826;579;1637;29;85;378;1030;407;1115
241500;201706;740;2312;630;2169;18;66;528;1819;546;1885
250010;201706;2804;8604;2340;7582;94;410;1719;5428;1813;5838
250020;201706;1584;4465;1194;3710;52;173;844;2564;896;2737
250030;201706;6996;19878;6437;19089;388;1300;5191;15134;5579;16434
250040;201706;4010;13326;3703;12659;416;1521;2482;8453;2898;9974
250050;201706;3312;10202;3069;9822;456;1500;1927;6083;2383;7583
250053;201706;1241;3691;1127;3519;128;419;776;2441;904;2860
250057;201706;636;2606;618;2587;2;2;590;2524;592;2526
250060;201706;5214;15108;4838;14572;424;1406;3753;11239;4177;12645
250070;201706;3887;11850;3601;11309;106;529;2729;8213;2835;8742
250073;201706;797;2296;694;2121;23;85;526;1552;549;1637
250077;201706;2172;6201;1731;5437;113;373;1200;3744;1313;4117
250080;201706;4258;11992;4030;11597;199;694;3294;9271;3493;9965
250090;201706;2640;7350;2443;7032;136;375;1989;5677;2125;6052
250100;201706;3892;12361;3643;11908;210;887;2920;9292;3130;10179
250110;201706;4809;14217;4521;13801;451;1622;3509;10497;3960;12119
250115;201706;506;1569;463;1494;22;115;345;1069;367;1184
250120;201706;1846;5671;1615;5218;84;337;1244;4005;1328;4342
250130;201706;5317;16257;4785;15274;166;812;3766;11745;3932;12557
250135;201706;1057;3183;988;3066;36;142;787;2414;823;2556
250140;201706;2115;6774;2040;6655;139;584;1625;5247;1764;5831
250150;201706;5044;16619;4610;15797;250;1142;3445;11550;3695;12692
250153;201706;1474;3922;1249;3585;36;157;1037;2910;1073;3067
250157;201706;1781;5657;1628;5349;241;747;1055;3529;1296;4276
250160;201706;3344;9530;3133;9214;99;344;2815;8260;2914;8604
250170;201706;1609;4648;1468;4433;82;300;1161;3467;1243;3767
250180;201706;15895;45238;14733;43523;1278;4484;10757;30944;12035;35428
250190;201706;4147;11836;3778;11246;521;1563;2424;7188;2945;8751
250200;201706;1958;5688;1633;5195;74;299;1298;4094;1372;4393
250205;201706;835;2853;784;2740;33;170;589;2036;622;2206
250210;201706;1502;4832;1398;4661;78;368;1063;3473;1141;3841
250215;201706;1434;4424;1304;4236;98;402;825;2617;923;3019
250220;201706;741;2165;613;1965;39;144;444;1406;483;1550
250230;201706;1594;3933;1265;3394;43;146;992;2553;1035;2699
250240;201706;2331;7484;2188;7223;101;384;1756;5756;1857;6140
250250;201706;4521;13423;4109;12861;170;603;3378;10567;3548;11170
250260;201706;1704;5040;1473;4658;51;196;1154;3637;1205;3833
250270;201706;1297;3956;1169;3794;99;330;853;2893;952;3223
250280;201706;3576;10399;3122;9673;222;723;2348;7242;2570;7965
250290;201706;1791;4795;1495;4393;16;55;1255;3674;1271;3729
250300;201706;5291;15522;5055;15227;379;1499;4267;12508;4646;14007
250310;201706;1119;3367;997;3156;54;215;755;2318;809;2533
250320;201706;8298;23663;7775;22905;845;2758;5791;16762;6636;19520
250330;201706;2437;7405;2077;6869;141;524;1566;5126;1707;5650
250340;201706;1095;3162;981;2968;27;96;797;2358;824;2454
250350;201706;4172;11473;3751;10954;146;476;3250;9483;3396;9959
250355;201706;1990;6135;1814;5904;40;217;1613;5194;1653;5411
250360;201706;1813;5270;1694;5070;45;156;1394;4145;1439;4301
250370;201706;11684;33004;10381;31470;705;2336;8633;26079;9338;28415
250375;201706;1087;3186;981;3031;31;105;848;2646;879;2751
250380;201706;1686;4686;1597;4569;73;280;1311;3611;1384;3891
250390;201706;1823;4944;1498;4394;214;594;948;2821;1162;3415
250400;201706;73873;194225;57919;168553;14646;44941;20843;61948;35489;106889
250403;201706;1589;5086;1467;4910;211;828;930;3029;1141;3857
250407;201706;1203;3310;1039;3065;83;222;753;2204;836;2426
250410;201706;545;1700;502;1619;20;105;401;1240;421;1345
250415;201706;1936;5668;1725;5299;84;272;1320;4042;1404;4314
250420;201706;1246;3589;1123;3409;21;70;1012;3070;1033;3140
250430;201706;6240;16518;5620;15578;233;772;4565;12374;4798;13146
250435;201706;1337;4078;1198;3831;68;267;879;2767;947;3034
250440;201706;4477;12585;4041;11979;102;385;3426;10050;3528;10435
250450;201706;1899;5303;1645;4953;48;183;1362;4037;1410;4220
250460;201706;6670;19343;6261;18825;380;1198;5295;16111;5675;17309
250470;201706;1567;4152;1312;3790;93;323;945;2630;1038;2953
250480;201706;3767;11120;3474;10717;70;307;3043;9390;3113;9697
250485;201706;648;1570;498;1350;18;64;411;1073;429;1137
250490;201706;4015;11805;3825;11554;439;1390;2924;8837;3363;10227
250500;201706;1802;5321;1625;5026;98;312;1270;3940;1368;4252
250510;201706;5008;13672;4447;12898;109;341;3918;11378;4027;11719
250520;201706;1793;5331;1665;5159;235;840;1045;3147;1280;3987
250523;201706;1807;5205;1738;5116;103;427;1455;4145;1558;4572
250527;201706;1488;4268;1416;4179;36;129;1304;3813;1340;3942
250530;201706;594;1809;526;1722;25;102;460;1495;485;1597
250535;201706;1350;4126;1252;3934;53;244;967;2951;1020;3195
250540;201706;2504;6779;2313;6561;87;275;2021;5682;2108;5957
250550;201706;877;2925;806;2810;39;198;646;2189;685;2387
250560;201706;1644;5046;1549;4892;76;297;1268;3918;1344;4215
250570;201706;2668;8188;2338;7564;116;501;1812;5689;1928;6190
250580;201706;1114;2910;978;2706;51;197;810;2164;861;2361
250590;201706;827;2531;750;2408;32;148;606;1878;638;2026
250600;201706;7028;20479;6572;19774;629;1835;5073;15362;5702;17197
250610;201706;3044;8794;2817;8462;231;750;2185;6507;2416;7257
250620;201706;688;1990;621;1853;67;226;418;1200;485;1426
250625;201706;2456;7539;2328;7328;54;201;2060;6398;2114;6599
250630;201706;9694;29485;8758;27562;1695;5564;4861;15117;6556;20681
250640;201706;3430;10340;3242;10086;154;685;2698;8173;2852;8858
250650;201706;880;2351;768;2202;43;171;591;1603;634;1774
250660;201706;1789;4647;1651;4455;30;65;1527;4139;1557;4204
250670;201706;2332;7731;2217;7532;101;491;1863;6191;1964;6682
250680;201706;4939;13281;4647;12948;168;617;4160;11480;4328;12097
250690;201706;6066;15175;5781;14851;253;682;5272;13481;5525;14163
250700;201706;4533;13295;4136;12695;556;1824;2823;8539;3379;10363
250710;201706;4457;13549;3997;12923;401;1393;2754;9010;3155;10403
250720;201706;2772;7644;2558;7306;55;237;2271;6423;2326;6660
250730;201706;3568;10459;3273;10044;231;799;2594;7791;2825;8590
250740;201706;1938;5401;1663;4992;145;504;1253;3655;1398;4159
250750;201706;97526;269571;88868;256901;10621;33715;58906;167219;69527;200934
250760;201706;2292;6303;2019;5904;122;431;1573;4496;1695;4927
250770;201706;3903;12684;3654;12361;375;1465;2622;8842;2997;10307
250780;201706;1744;5044;1497;4563;164;569;976;2906;1140;3475
250790;201706;2325;7450;2203;7230;405;1332;1313;4419;1718;5751
250800;201706;2642;7235;2323;6716;95;275;1890;5405;1985;5680
250810;201706;1269;3647;1095;3379;56;225;853;2591;909;2816
250820;201706;1898;5858;1823;5768;97;414;1604;5005;1701;5419
250830;201706;5607;17778;5160;16850;463;1799;3562;11369;4025;13168
250840;201706;914;2908;789;2650;40;161;516;1740;556;1901
250850;201706;1988;5957;1775;5608;68;329;1396;4284;1464;4613
250855;201706;1089;3154;957;2943;39;173;702;2099;741;2272
250860;201706;3263;10366;2786;9493;547;1964;1243;4352;1790;6316
250870;201706;1086;3082;944;2811;33;118;741;2181;774;2299
250880;201706;1531;4116;1265;3725;199;602;789;2354;988;2956
250890;201706;9326;27433;8872;26813;941;3431;6636;19527;7577;22958
250900;201706;2744;8671;2418;8049;136;490;1865;6111;2001;6601
250905;201706;2053;6383;1976;6292;148;576;1620;5081;1768;5657
250910;201706;5051;14145;4736;13704;232;816;3981;11428;4213;12244
250915;201706;1473;4326;1421;4266;56;128;1295;3973;1351;4101
250920;201706;3240;9032;3049;8746;297;838;2253;6401;2550;7239
250930;201706;1996;5916;1892;5741;144;558;1476;4350;1620;4908
250933;201706;1127;3658;1019;3435;73;320;676;2203;749;2523
250937;201706;684;2046;593;1879;40;147;443;1378;483;1525
250939;201706;1638;4718;1459;4442;68;265;1124;3313;1192;3578
250940;201706;3789;10910;3541;10509;82;322;3089;9167;3171;9489
250950;201706;1377;4032;1195;3791;40;163;984;3126;1024;3289
250960;201706;1030;3288;974;3188;37;160;783;2521;820;2681
250970;201706;8491;23200;7404;21470;527;1714;5399;15390;5926;17104
250980;201706;2559;7357;2311;6899;84;353;1778;5114;1862;5467
250990;201706;1958;6497;1736;6005;151;649;1196;4019;1347;4668
251000;201706;2089;6034;1818;5603;54;259;1517;4596;1571;4855
251010;201706;2727;7925;2454;7480;78;296;2132;6477;2210;6773
251020;201706;1682;4637;1533;4451;66;214;1382;3998;1448;4212
251030;201706;1021;2877;925;2682;52;182;645;1807;697;1989
251040;201706;1782;5455;1578;5115;74;351;1231;3860;1305;4211
251050;201706;1054;3041;877;2702;121;385;566;1704;687;2089
251060;201706;1050;2359;779;2011;24;98;609;1529;633;1627
251065;201706;480;1365;399;1249;24;95;262;757;286;852
251070;201706;645;1740;571;1634;26;106;455;1248;481;1354
251080;201706;18706;51611;16719;48520;3601;10845;8722;25835;12323;36680
251090;201706;2920;8812;2551;8090;121;475;1937;6007;2058;6482
251100;201706;948;2950;856;2790;41;194;606;1883;647;2077
251110;201706;1831;5290;1614;4858;97;304;1161;3455;1258;3759
251120;201706;6304;20657;5966;20057;492;1988;4474;14804;4966;16792
251130;201706;3826;9560;3532;9241;175;463;3267;8568;3442;9031
251140;201706;4248;12695;3970;12248;139;591;3243;9920;3382;10511
251150;201706;2664;8201;2466;7906;168;737;1892;5889;2060;6626
251160;201706;1865;6035;1792;5924;66;247;1613;5344;1679;5591
251170;201706;1483;4326;1407;4237;40;165;1268;3803;1308;3968
251180;201706;2548;7549;2281;7139;288;965;1450;4493;1738;5458
251190;201706;4471;12108;4262;11855;110;359;3856;10584;3966;10943
251200;201706;3939;12606;3724;12337;97;428;3343;11089;3440;11517
251203;201706;1000;3292;958;3203;53;232;698;2270;751;2502
251207;201706;1030;3165;881;2882;28;142;605;1913;633;2055
251210;201706;7917;21809;6743;20275;514;1593;5166;15702;5680;17295
251220;201706;1192;3110;981;2824;58;165;755;2186;813;2351
251230;201706;4703;13428;4260;12877;231;865;3633;10765;3864;11630
251240;201706;3317;9795;3005;9367;328;1076;2227;6883;2555;7959
251250;201706;10362;29743;9604;28645;949;3192;6945;20158;7894;23350
251260;201706;465;1444;427;1379;18;76;319;1009;337;1085
251270;201706;4305;13705;3927;13228;144;645;3332;11204;3476;11849
251272;201706;1343;3790;1267;3681;51;174;1134;3266;1185;3440
251274;201706;936;2811;809;2581;73;309;531;1602;604;1911
251275;201706;1232;3533;1147;3401;52;214;861;2422;913;2636
251276;201706;1210;3650;1151;3554;107;412;850;2577;957;2989
251278;201706;597;1808;524;1669;50;191;343;1092;393;1283
251280;201706;2339;6813;2151;6497;79;338;1693;4938;1772;5276
251290;201706;5667;15213;5325;14787;449;1595;4239;11373;4688;12968
251300;201706;756;2459;709;2383;18;70;578;1928;596;1998
251310;201706;2925;8629;2712;8332;133;592;2144;6363;2277;6955
251315;201706;1662;5523;1574;5368;118;449;1182;3991;1300;4440
251320;201706;1868;5042;1370;4231;67;247;934;2875;1001;3122
251330;201706;1791;4665;1506;4293;59;236;1330;3728;1389;3964
251335;201706;1051;3375;955;3218;70;305;692;2253;762;2558
251340;201706;3428;9630;3004;9045;158;576;2255;6644;2413;7220
251350;201706;1192;3758;1114;3617;48;216;880;2753;928;2969
251360;201706;1807;5542;1536;5163;45;188;1302;4422;1347;4610
251365;201706;720;2139;599;1867;17;72;448;1375;465;1447
251370;201706;23278;70001;22321;68706;1845;6769;17404;52588;19249;59357
251380;201706;1325;4028;1142;3718;39;188;947;2963;986;3151
251385;201706;738;1944;600;1725;34;110;411;1113;445;1223
251390;201706;5775;19145;5121;17858;1288;4659;2452;8573;3740;13232
251392;201706;1052;3046;916;2816;58;220;662;1985;720;2205
251394;201706;640;2194;553;2045;30;134;398;1494;428;1628
251396;201706;814;2280;694;2083;55;154;448;1337;503;1491
251398;201706;948;2658;771;2348;35;142;541;1578;576;1720
251400;201706;1152;3204;978;2952;65;229;698;2020;763;2249
251410;201706;1557;3944;1312;3559;30;121;1093;2852;1123;2973
251420;201706;1978;5568;1701;5239;128;462;1257;3805;1385;4267
251430;201706;1627;5350;1496;5143;60;297;1262;4261;1322;4558
251440;201706;1186;3519;973;3103;38;145;744;2361;782;2506
251445;201706;1526;4590;1445;4484;101;399;1123;3394;1224;3793
251450;201706;4649;14408;4264;13874;129;594;3491;11262;3620;11856
251455;201706;1064;3326;948;3102;78;323;665;2126;743;2449
251460;201706;829;2541;761;2431;43;162;621;1989;664;2151
251465;201706;444;1400;384;1266;18;91;286;912;304;1003
251470;201706;1150;3304;934;2854;86;293;562;1682;648;1975
251480;201706;926;2594;813;2409;33;144;593;1683;626;1827
251490;201706;1805;5235;1598;4913;160;527;1034;3140;1194;3667
251500;201706;1754;5502;1679;5366;103;424;1370;4287;1473;4711
251510;201706;2544;8203;2287;7696;295;1091;1382;4614;1677;5705
251520;201706;951;2625;807;2329;82;229;521;1464;603;1693
251530;201706;12328;33396;11473;32229;276;1214;9889;27102;10165;28316
251540;201706;2864;8910;2631;8470;165;642;1986;6271;2151;6913
251550;201706;3410;8907;2862;8168;87;321;2357;6658;2444;6979
251560;201706;662;2037;595;1922;105;375;332;1023;437;1398
251570;201706;966;2827;791;2489;32;129;551;1676;583;1805
251580;201706;1888;5123;1715;4885;239;617;1236;3594;1475;4211
251590;201706;1504;4398;1421;4281;73;237;1118;3364;1191;3601
251593;201706;1001;3019;919;2902;123;407;557;1738;680;2145
251597;201706;1948;5840;1882;5754;38;143;1704;5172;1742;5315
251600;201706;6544;18748;6043;17966;289;971;4916;14464;5205;15435
251610;201706;3326;9718;2952;9024;390;1147;1966;6113;2356;7260
251615;201706;1151;3187;937;2817;35;145;659;1924;694;2069
251620;201706;15969;41003;14166;38904;509;1364;11543;33412;12052;34776
251630;201706;4688;11867;3966;10831;254;746;2944;7895;3198;8641
251640;201706;2215;6583;2001;6176;83;354;1631;4922;1714;5276
251650;201706;4040;11301;3692;10840;191;678;3074;8941;3265;9619
251660;201706;3526;11033;3186;10414;132;631;2573;8177;2705;8808
251670;201706;4466;12874;3945;12217;37;168;3633;11318;3670;11486
251675;201706;700;2144;647;2070;96;339;424;1333;520;1672
251680;201706;2781;7814;2251;7008;87;339;1759;5426;1846;5765
251690;201706;3288;9694;2971;9095;120;428;2145;6397;2265;6825
251700;201706;1915;6105;1787;5936;93;443;1474;4771;1567;5214
251710;201706;875;2299;587;1722;69;245;277;782;346;1027
251720;201706;1426;4259;1214;3858;48;223;907;2785;955;3008
251740;201706;762;2114;605;1852;47;153;381;1144;428;1297
260005;201706;25503;61138;21939;56078;3738;9361;13070;33504;16808;42865
260010;201706;9876;26570;8305;24386;800;2407;5085;15346;5885;17753
260020;201706;6359;16850;5366;15431;194;724;4290;12272;4484;12996
260030;201706;6159;17322;5464;16216;336;1177;4195;12371;4531;13548
260040;201706;9387;23895;7770;21937;848;2398;5504;16106;6352;18504
260050;201706;11311;34287;10586;33416;455;1743;9125;29011;9580;30754
260060;201706;3876;10733;3422;9922;310;862;2481;7309;2791;8171
260070;201706;9910;27841;9013;26407;857;2852;6362;18290;7219;21142
260080;201706;6270;15712;5591;14773;402;1096;4329;11277;4731;12373
260090;201706;5269;13982;4870;13432;537;1419;3680;10296;4217;11715
260100;201706;3309;9007;2845;8368;155;548;2298;6739;2453;7287
260105;201706;5009;13790;4741;13366;154;644;4029;11086;4183;11730
260110;201706;21726;59113;19895;56943;938;2916;17344;49681;18282;52597
260120;201706;13318;38520;11790;35995;2118;6604;6612;20730;8730;27334
260130;201706;3145;8686;2944;8364;302;919;2186;6115;2488;7034
260140;201706;12699;31171;11017;29162;695;2132;8899;23592;9594;25724
260150;201706;3164;8581;2854;8171;204;692;2251;6378;2455;7070
260160;201706;5582;17079;4813;16057;201;912;3936;13175;4137;14087
260170;201706;16588;45104;15686;43859;756;2315;13362;37112;14118;39427
260180;201706;3288;9697;2993;9267;184;643;2494;7669;2678;8312
260190;201706;16554;37381;14898;35367;330;990;12934;30153;13264;31143
260200;201706;11130;27744;10223;26607;392;1172;8974;23292;9366;24464
260210;201706;11963;35088;10589;32905;465;1766;8591;26603;9056;28369
260220;201706;9550;26221;9141;25708;336;1220;8125;22530;8461;23750
260230;201706;9894;27217;9028;26028;434;1520;7220;20681;7654;22201
260240;201706;2962;8660;2577;8100;229;788;1955;6171;2184;6959
260250;201706;2278;6242;1999;5842;106;360;1584;4539;1690;4899
260260;201706;12300;34303;11063;32488;741;2516;8591;25124;9332;27640
260270;201706;3647;10391;3343;9934;229;972;2503;7150;2732;8122
260280;201706;13035;41155;11982;39610;599;2271;10102;33522;10701;35793
260290;201706;33064;96595;30980;92988;4871;15563;19130;56627;24001;72190
260300;201706;9124;26771;8019;25137;377;1574;6204;19386;6581;20960
260310;201706;4513;13025;4090;12409;723;2039;2637;8331;3360;10370
260320;201706;7510;23109;6851;21982;367;1359;5464;17439;5831;18798
260330;201706;2577;8110;2383;7741;136;534;1850;5898;1986;6432
260340;201706;1908;5421;1744;5178;46;172;1522;4474;1568;4646
260345;201706;22477;67813;20897;64884;5058;17191;8520;25265;13578;42456
260350;201706;4957;13006;4560;12448;153;532;3948;10659;4101;11191
260360;201706;2468;6859;2243;6471;97;427;1541;4355;1638;4782
260370;201706;5616;17103;4951;15903;322;1334;3652;11553;3974;12887
260380;201706;4879;15602;4385;14809;259;1098;3231;10814;3490;11912
260390;201706;4273;13357;3680;12173;285;1012;2495;8158;2780;9170
260392;201706;3508;11151;3175;10722;194;938;2592;8538;2786;9476
260400;201706;13858;38011;13044;36723;1359;4230;9469;26206;10828;30436
260410;201706;61020;170520;52642;157324;13334;42393;20698;63433;34032;105826
260415;201706;3717;11409;3252;10480;187;857;2204;6778;2391;7635
260420;201706;12385;27765;10955;26213;181;615;10049;23836;10230;24451
260430;201706;2928;9279;2558;8572;200;733;1714;5730;1914;6463
260440;201706;3348;9764;2963;9027;272;979;2102;6220;2374;7199
260450;201706;5081;14325;4868;14032;171;588;4343;12490;4514;13078
260460;201706;5548;17359;5054;16413;755;2791;2937;9292;3692;12083
260470;201706;4650;13296;4210;12773;137;385;3692;11542;3829;11927
260480;201706;4159;11589;3638;10842;415;1341;2344;7128;2759;8469
260490;201706;5060;12920;4397;11796;173;581;3651;9505;3824;10086
260500;201706;5893;16510;5194;15417;658;1970;3424;10271;4082;12241
260510;201706;8955;23242;8228;22249;332;1035;7171;19201;7503;20236
260515;201706;4772;13956;3623;11696;208;761;2272;7264;2480;8025
260520;201706;16751;42086;15836;40847;1416;3779;12425;31768;13841;35547
260530;201706;9548;28952;8399;27170;332;1389;6976;22450;7308;23839
260540;201706;6026;14822;5462;14208;732;1439;4230;11628;4962;13067
260545;201706;67;239;44;176;12;45;6;25;18;70
260550;201706;2777;8732;2340;7768;291;1115;1258;4112;1549;5227
260560;201706;6347;16402;5594;15375;177;718;4785;12932;4962;13650
260570;201706;6827;21597;6262;20695;644;2337;4623;15287;5267;17624
260580;201706;3823;10298;3480;9754;73;269;3033;8366;3106;8635
260590;201706;6323;15731;5881;15227;267;740;5095;13157;5362;13897
260600;201706;29313;82741;25769;76917;1687;6073;18846;55524;20533;61597
260610;201706;6437;18737;6125;18229;635;2014;4534;13324;5169;15338
260620;201706;15162;45216;14470;44001;2165;7491;9201;27116;11366;34607
260630;201706;2335;6509;2014;6039;72;289;1644;4854;1716;5143
260640;201706;17488;46653;16295;45059;1759;5309;11590;31815;13349;37124
260650;201706;5485;16540;4802;15372;247;987;3841;12277;4088;13264
260660;201706;7680;20911;6874;19881;233;900;5777;16478;6010;17378
260670;201706;2338;6136;1926;5541;114;348;1364;3886;1478;4234
260680;201706;22320;61587;20151;57826;3288;9631;10707;30649;13995;40280
260690;201706;3753;9900;3111;8862;164;494;2424;6894;2588;7388
260700;201706;5805;17278;5647;17107;25;43;5534;16938;5559;16981
260710;201706;1383;3895;1311;3798;90;317;976;2889;1066;3206
260720;201706;18213;55861;17005;53592;3016;9958;9829;30824;12845;40782
260730;201706;6819;22011;6368;21282;569;2199;4915;16166;5484;18365
260740;201706;1256;3728;1120;3492;44;146;922;2874;966;3020
260750;201706;7013;20338;6148;19236;211;632;5433;17330;5644;17962
260760;201706;4904;12895;4577;12491;219;709;3812;10383;4031;11092
260765;201706;7562;25377;7154;24696;875;3899;4793;15895;5668;19794
260770;201706;3813;10123;3405;9472;130;426;2672;7363;2802;7789
260775;201706;4964;14466;4689;14045;365;1420;3397;9849;3762;11269
260780;201706;3707;11536;3455;11058;627;2145;2008;6272;2635;8417
260790;201706;110799;275837;101863;262463;18953;49748;59086;150911;78039;200659
260795;201706;3119;8884;2749;8321;207;721;1952;5934;2159;6655
260800;201706;5196;13080;4807;12542;123;450;4249;10732;4372;11182
260805;201706;3748;11120;3219;10251;296;1097;2184;6853;2480;7950
260810;201706;6600;18281;6295;17781;442;1327;5076;14250;5518;15577
260820;201706;4098;11216;3638;10500;487;1604;2273;6414;2760;8018
260825;201706;2902;9097;2584;8566;134;571;1938;6368;2072;6939
260830;201706;3840;12007;3409;11195;443;1451;2279;7560;2722;9011
260840;201706;4189;11895;3721;11214;231;742;2969;8896;3200;9638
260845;201706;4109;11732;3897;11349;388;1159;2880;8372;3268;9531
260850;201706;4956;15518;4386;14254;682;2381;2316;7420;2998;9801
260860;201706;3651;10837;3147;9824;164;606;2395;7386;2559;7992
260870;201706;4310;11283;3806;10644;188;626;3156;8725;3344;9351
260875;201706;6654;18120;5785;16726;784;2290;3725;10826;4509;13116
260880;201706;9945;28942;8955;27351;462;1569;7168;21958;7630;23527
260890;201706;12977;36661;12074;35270;888;3006;8802;25297;9690;28303
260900;201706;5692;17236;4898;15733;351;1392;3222;10157;3573;11549
260910;201706;3096;9085;2766;8550;134;481;2070;6387;2204;6868
260915;201706;4696;15131;4386;14699;87;432;3971;13270;4058;13702
260920;201706;3305;9787;3064;9458;183;590;2463;7779;2646;8369
260930;201706;3844;12400;3417;11673;296;1091;2461;8432;2757;9523
260940;201706;14133;36593;12931;34640;1348;4081;8912;23303;10260;27384
260950;201706;6337;19146;5567;17583;840;2989;2807;8427;3647;11416
260960;201706;56794;152498;51242;143586;9082;27295;27715;76471;36797;103766
260970;201706;4964;14580;4540;14021;214;789;3540;10959;3754;11748
260980;201706;4141;12950;3804;12529;102;443;3361;11048;3463;11491
260990;201706;17212;51735;15435;49251;935;3644;11695;37069;12630;40713
261000;201706;15805;41773;13076;37666;1568;4832;7782;22881;9350;27713
261010;201706;2565;6924;2318;6620;94;213;2047;5942;2141;6155
261020;201706;6524;18484;5709;17030;482;1572;4184;12150;4666;13722
261030;201706;3850;11558;3384;10786;169;631;2662;8361;2831;8992
261040;201706;5146;16220;4342;14523;312;1220;3079;10099;3391;11319
261050;201706;7850;22432;7296;21473;900;2694;4739;13988;5639;16682
261060;201706;12652;35740;11652;34015;1024;3483;8678;24760;9702;28243
261070;201706;54636;130685;48097;121325;4796;12655;33654;83954;38450;96609
261080;201706;5781;16069;5478;15632;284;780;4769;13756;5053;14536
261090;201706;16809;44641;15386;42684;872;2627;12633;34964;13505;37591
261100;201706;8301;25446;7360;23839;1043;3575;4590;15092;5633;18667
261110;201706;61044;179438;54104;168808;13524;44736;23549;75159;37073;119895
261120;201706;3903;9994;3394;9388;76;263;3009;8328;3085;8591
261130;201706;7275;18193;6699;17547;185;568;5921;15438;6106;16006
261140;201706;3203;8627;2900;8166;356;1112;1911;5313;2267;6425
261150;201706;5392;14880;4903;14135;200;709;4173;11919;4373;12628
261153;201706;2068;6098;1761;5607;94;379;1235;3901;1329;4280
261160;201706;196707;509521;180567;485364;44988;126674;78713;213623;123701;340297
261170;201706;5686;15089;5191;14378;278;790;4164;11536;4442;12326
261180;201706;9767;26504;9067;25540;883;2769;6259;17431;7142;20200
261190;201706;5002;15243;4647;14801;476;1914;3258;10117;3734;12031
261200;201706;3617;8726;3221;8248;295;776;2496;6368;2791;7144
261210;201706;1893;4933;1740;4734;98;279;1506;4098;1604;4377
261220;201706;13586;41006;11525;36835;1569;5492;6409;20312;7978;25804
261230;201706;4637;14023;4167;13427;118;476;3499;11399;3617;11875
261240;201706;4932;13869;4515;13164;467;1300;3353;9858;3820;11158
261245;201706;3499;10597;3022;9744;143;667;2335;7288;2478;7955
261247;201706;3144;9549;2682;8698;172;666;1877;6071;2049;6737
261250;201706;19174;50008;17708;48032;3280;8556;11155;31461;14435;40017
261255;201706;4087;12414;3622;11592;207;919;2846;8851;3053;9770
261260;201706;12673;34930;11217;33175;495;1747;9318;27729;9813;29476
261270;201706;3796;11037;3418;10419;292;1018;2477;7345;2769;8363
261280;201706;2578;7630;2357;7275;99;396;1883;5693;1982;6089
261290;201706;2980;8315;2666;7903;156;561;2055;6106;2211;6667
261300;201706;10989;33989;9553;31366;943;3698;6289;20169;7232;23867
261310;201706;7185;21554;6702;20718;1560;4916;3704;11431;5264;16347
261320;201706;5912;17663;5376;16733;195;785;4332;13252;4527;14037
261330;201706;5778;15614;5406;15133;274;1004;4591;12587;4865;13591
261340;201706;3953;12865;3686;12426;322;1336;2580;8603;2902;9939
261350;201706;8193;25922;7694;25075;234;1225;6252;19849;6486;21074
261360;201706;8291;21293;7292;19930;484;1396;5746;15443;6230;16839
261370;201706;19257;56015;18011;54010;3522;11112;10159;30433;13681;41545
261380;201706;4118;13660;3804;12998;547;2118;2354;7902;2901;10020
261390;201706;16314;48774;14594;45851;1867;6355;8745;27486;10612;33841
261400;201706;4707;15862;4177;14725;242;1074;2970;10280;3212;11354
261410;201706;9128;24543;8056;22878;580;1824;6360;17935;6940;19759
261420;201706;7319;24257;6979;23803;1358;5213;4294;14461;5652;19674
261430;201706;3495;10434;2979;9657;174;605;2344;7633;2518;8238
261440;201706;1567;4855;1393;4551;54;284;1018;3213;1072;3497
261450;201706;14076;39566;13483;38833;340;1350;11785;33597;12125;34947
261460;201706;7095;20574;6611;19888;354;1188;5652;16945;6006;18133
261470;201706;4101;10940;3759;10480;72;289;3128;8742;3200;9031
261480;201706;3979;13578;3617;12941;244;1039;2734;9575;2978;10614
261485;201706;4967;14961;4394;13986;543;1992;2750;8598;3293;10590
261500;201706;5542;15361;4948;14556;474;1371;3564;10750;4038;12121
261510;201706;1889;5908;1676;5542;123;470;1226;4072;1349;4542
261520;201706;2716;8474;2559;8196;121;445;1634;5478;1755;5923
261530;201706;10897;34860;9835;32704;1721;6468;4587;15137;6308;21605
261540;201706;7171;22603;6665;21741;1366;4510;3802;12714;5168;17224
261550;201706;3507;9641;3261;9291;237;850;2466;6831;2703;7681
261560;201706;7422;23519;6677;22503;665;2708;4923;16524;5588;19232
261570;201706;3449;10041;2956;9225;301;1057;1882;5787;2183;6844
261580;201706;6177;18136;5595;17225;231;1014;4744;14370;4975;15384
261590;201706;2546;6977;2159;6380;134;409;1625;4824;1759;5233
261600;201706;5291;14059;4519;12947;300;939;3324;9504;3624;10443
261610;201706;2472;6808;2121;6292;74;285;1699;5031;1773;5316
261618;201706;2494;6772;2260;6465;126;407;1807;5075;1933;5482
261620;201706;3975;12218;3729;11809;852;2590;2204;7263;3056;9853
261630;201706;7482;21473;6296;19255;656;2403;3668;10814;4324;13217
261640;201706;35429;85683;33079;82892;2047;4684;26750;69730;28797;74414
261650;201706;3856;10993;3564;10609;210;787;2656;7965;2866;8752
270010;201706;4331;15733;3968;15034;250;1276;3017;11271;3267;12547
270020;201706;3940;10755;3635;10322;284;963;2908;8021;3192;8984
270030;201706;37110;108575;34190;103755;6419;19924;20092;61454;26511;81378
270040;201706;10765;31707;9873;30540;1105;3725;7202;22385;8307;26110
270050;201706;4590;12106;4150;11586;307;874;3475;9811;3782;10685
270060;201706;1927;5463;1773;5261;237;723;1231;3722;1468;4445
270070;201706;4435;13309;4036;12753;181;847;3360;10340;3541;11187
270080;201706;1289;3975;1110;3631;118;410;749;2399;867;2809
270090;201706;2139;6555;1927;6149;97;446;1501;4590;1598;5036
270100;201706;5646;16691;5280;16110;476;1716;3991;11953;4467;13669
270110;201706;2986;8267;2665;7904;292;911;1959;6014;2251;6925
270120;201706;3123;8503;2744;8025;87;328;2414;7031;2501;7359
270130;201706;5244;15332;4826;14870;498;1630;3778;11806;4276;13436
270135;201706;1846;4855;1643;4608;145;293;1387;4042;1532;4335
270140;201706;10679;24478;8965;22286;525;1991;7305;17177;7830;19168
270150;201706;2685;8459;2609;8371;37;120;2533;8146;2570;8266
270160;201706;4955;16142;4553;15644;157;781;3891;13206;4048;13987
270170;201706;3708;11640;3390;11199;424;1704;2260;7275;2684;8979
270180;201706;2304;7333;2118;7071;106;492;1757;5746;1863;6238
270190;201706;1766;5602;1671;5478;86;298;1410;4685;1496;4983
270200;201706;2528;8266;2351;8007;198;850;1722;5671;1920;6521
270210;201706;4964;13881;4598;13398;297;929;3912;11384;4209;12313
270220;201706;1290;4105;1189;3928;258;933;640;2072;898;3005
270230;201706;10726;32813;9320;30587;1085;4312;5613;17811;6698;22123
270235;201706;6159;19637;5757;19004;318;1340;4687;15314;5005;16654
270240;201706;10143;29440;8621;27473;1816;6114;4865;15772;6681;21886
270250;201706;3137;8172;2834;7790;389;1037;2106;5851;2495;6888
270255;201706;4803;14386;3883;12689;261;1080;2721;8670;2982;9750
270260;201706;5944;18402;5697;18050;309;1355;4810;14783;5119;16138
270270;201706;1154;3192;1062;3068;189;574;637;1796;826;2370
270280;201706;3523;9664;3042;8992;381;920;2106;6422;2487;7342
270290;201706;8072;27034;7523;26102;491;2270;5996;20402;6487;22672
270300;201706;3762;11522;3363;11051;330;1211;2446;8011;2776;9222
270310;201706;7559;22226;6636;20868;250;1246;5419;16529;5669;17775
270320;201706;5844;17740;5423;17038;773;2627;3620;11190;4393;13817
270330;201706;4139;13946;3848;13557;358;1367;2958;10534;3316;11901
270340;201706;1654;4924;1457;4656;108;430;1156;3598;1264;4028
270350;201706;1924;5000;1707;4717;172;537;1206;3326;1378;3863
270360;201706;2120;6291;2008;6160;139;398;1720;5386;1859;5784
270370;201706;1462;4747;1328;4517;93;387;981;3319;1074;3706
270375;201706;2978;7807;2616;7341;71;223;2310;6465;2381;6688
270380;201706;5772;17398;5333;16798;445;1457;4065;13024;4510;14481
270390;201706;1268;3415;1092;3152;54;188;836;2353;890;2541
270400;201706;6418;18680;5706;17644;307;1228;4197;12587;4504;13815
270410;201706;4746;14721;4326;13967;348;1301;3125;9948;3473;11249
270420;201706;5944;18444;5659;18071;280;1263;4583;14278;4863;15541
270430;201706;138587;386296;120434;359933;33992;107518;42953;133100;76945;240618
270440;201706;4658;13672;4261;13143;156;659;3478;10660;3634;11319
270450;201706;6407;19152;6052;18680;393;1518;4888;14897;5281;16415
270460;201706;3493;8850;3147;8441;101;357;2774;7299;2875;7656
270470;201706;10362;32337;9505;30987;1078;3972;6434;21110;7512;25082
270480;201706;2879;8543;2509;7920;293;1086;1731;5262;2024;6348
270490;201706;1006;3062;909;2932;58;234;700;2222;758;2456
270500;201706;4856;15870;4498;15428;217;1054;3742;12643;3959;13697
270510;201706;6060;17275;5415;16374;577;2237;4023;11675;4600;13912
270520;201706;3513;10929;3157;10302;1035;3615;1016;3509;2051;7124
270530;201706;1299;3968;1207;3831;99;322;863;2783;962;3105
270540;201706;2060;6583;1901;6359;95;478;1567;5074;1662;5552
270550;201706;6789;19711;6118;18882;713;2303;4441;13986;5154;16289
270560;201706;3145;9147;2888;8754;200;720;2175;6480;2375;7200
270570;201706;3757;11940;3399;11329;220;937;2673;8737;2893;9674
270580;201706;2125;6280;2004;6118;100;306;1724;5333;1824;5639
270590;201706;1405;4475;1359;4416;6;26;1334;4341;1340;4367
270600;201706;2886;9293;2609;8830;157;757;2120;6992;2277;7749
270610;201706;3365;9948;3089;9556;143;558;2628;8015;2771;8573
270620;201706;1391;4489;1292;4320;75;331;1044;3374;1119;3705
270630;201706;16016;46073;14557;43749;1698;5325;10225;31065;11923;36390
270640;201706;5782;17420;5178;16475;302;1261;4115;12800;4417;14061
270642;201706;2379;8146;2208;7905;194;960;1693;5864;1887;6824
270644;201706;2856;8103;2474;7577;266;834;1781;5571;2047;6405
270650;201706;3667;11221;3462;10942;425;1878;2467;7354;2892;9232
270660;201706;2101;5388;1660;4770;77;324;1212;3435;1289;3759
270670;201706;16868;42114;14610;39566;1531;4139;10956;30315;12487;34454
270680;201706;4446;12410;4215;12153;90;233;3976;11546;4066;11779
270690;201706;9398;24633;8347;23466;1984;5139;5235;15645;7219;20784
270700;201706;577;1816;509;1700;68;290;336;1073;404;1363
270710;201706;6029;18591;5682;18149;345;1466;4730;14802;5075;16268
270720;201706;3480;11254;3118;10622;125;720;2556;8479;2681;9199
270730;201706;6544;18060;6120;17592;393;1186;5273;15312;5666;16498
270740;201706;2354;6537;2196;6301;157;548;1797;5093;1954;5641
270750;201706;5271;15559;4823;14870;523;1846;3531;10790;4054;12636
270760;201706;3556;10311;3177;9712;123;484;2594;7835;2717;8319
270770;201706;19617;50832;16343;46886;3215;8961;9483;28890;12698;37851
270780;201706;1816;5621;1728;5488;161;567;1320;4193;1481;4760
270790;201706;1593;4941;1465;4751;258;873;882;2873;1140;3746
270800;201706;11179;32340;10368;31253;551;2298;8754;25764;9305;28062
270810;201706;3253;9759;2611;8586;237;918;1736;5664;1973;6582
270820;201706;1776;5592;1559;5229;228;872;1004;3316;1232;4188
270830;201706;5595;14214;4954;13461;386;1071;3932;11020;4318;12091
270840;201706;7977;24777;7308;23885;285;1511;6276;19953;6561;21464
270850;201706;7745;22617;7317;22062;673;2685;5581;16034;6254;18719
270860;201706;11480;30989;9660;28721;970;3352;6782;19794;7752;23146
270870;201706;2232;6592;1882;5892;209;696;1230;3806;1439;4502
270880;201706;8291;25775;7668;24861;435;1804;6142;19574;6577;21378
270890;201706;2471;7384;2288;7068;224;814;1644;4926;1868;5740
270895;201706;2967;10283;2854;10119;124;635;2474;8612;2598;9247
270900;201706;1830;4908;1488;4384;66;213;1161;3327;1227;3540
270910;201706;3610;11425;3287;10861;185;848;2490;8025;2675;8873
270915;201706;9431;30460;8383;28601;1131;4516;5105;16969;6236;21485
270920;201706;6252;19176;5928;18727;291;1395;5093;15603;5384;16998
270930;201706;16711;44014;14187;40981;2642;7380;8812;26514;11454;33894
270940;201706;5536;17786;5208;17433;450;2016;3846;12582;4296;14598
280010;201706;687;1934;590;1764;35;167;418;1134;453;1301
280020;201706;4874;13593;4249;12580;547;1687;2766;8158;3313;9845
280030;201706;74208;190388;62850;173652;17422;49871;23144;66818;40566;116689
280040;201706;3186;9303;2846;8792;291;980;2023;6164;2314;7144
280050;201706;3724;11613;3427;11099;795;2740;1785;5785;2580;8525
280060;201706;5063;15283;4328;14031;800;2782;2150;7115;2950;9897
280067;201706;7132;19591;6147;17992;819;2433;3827;11208;4646;13641
280070;201706;1955;6202;1878;6080;160;511;1518;4934;1678;5445
280100;201706;3805;11477;3422;10820;448;1554;2260;7148;2708;8702
280110;201706;1369;4050;1253;3870;57;230;1041;3145;1098;3375
280120;201706;7923;24137;7180;22901;1047;3152;5010;16500;6057;19652
280130;201706;8010;21000;7425;20160;797;2359;5437;14767;6234;17126
280140;201706;5859;15081;5353;14377;415;1126;4267;11485;4682;12611
280150;201706;3600;10284;3370;9928;209;750;2674;7762;2883;8512
280160;201706;1320;3837;1111;3475;165;557;675;2064;840;2621
280170;201706;4889;14102;4454;13457;343;1041;3481;10656;3824;11697
280190;201706;1227;3051;1045;2777;74;239;819;2102;893;2341
280200;201706;1221;3535;1100;3348;104;376;789;2333;893;2709
280210;201706;14648;40792;13001;38535;2300;7183;7328;22087;9628;29270
280220;201706;1738;4908;1578;4670;82;304;1297;3792;1379;4096
280230;201706;3330;9644;3002;9137;300;1012;2107;6401;2407;7413
280240;201706;3524;9731;3177;9190;128;492;2612;7396;2740;7888
280250;201706;853;2234;677;1944;111;337;321;913;432;1250
280260;201706;2140;5482;1993;5309;63;195;1833;4880;1896;5075
280270;201706;2215;6686;2028;6399;114;414;1665;5179;1779;5593
280280;201706;4182;13460;3784;12805;679;1955;2308;8418;2987;10373
280290;201706;17663;51861;15904;49154;1888;6662;10039;31028;11927;37690
280300;201706;9828;28623;9117;27764;625;2167;6914;21868;7539;24035
280310;201706;1398;3822;1190;3465;42;169;869;2454;911;2623
280320;201706;8714;26600;7974;25414;1264;4398;4594;14500;5858;18898
280330;201706;4710;12654;4246;11926;353;1145;3263;8890;3616;10035
280340;201706;4207;10772;3921;10399;322;823;3159;8673;3481;9496
280350;201706;22544;61168;19829;57190;2679;8162;12900;37386;15579;45548
280360;201706;5769;17532;5305;16735;889;3054;3012;9391;3901;12445
280370;201706;1959;5182;1660;4696;157;402;1194;3392;1351;3794
280380;201706;1069;3163;960;2983;110;417;657;1976;767;2393
280390;201706;3140;8987;2685;8133;209;708;1863;5609;2072;6317
280400;201706;4127;11382;3748;10827;895;2532;1929;5816;2824;8348
280410;201706;2152;6706;1846;6099;204;734;1091;3508;1295;4242
280420;201706;4289;12005;3915;11439;193;574;3333;9797;3526;10371
280430;201706;2250;5686;2008;5341;96;353;1542;4001;1638;4354
280440;201706;4711;13240;4274;12678;336;1081;3347;9826;3683;10907
280445;201706;2477;6596;2233;6158;62;210;1726;4623;1788;4833
280450;201706;9531;23953;8756;22957;563;1236;7380;19874;7943;21110
280460;201706;6944;17485;6329;16615;750;1956;4723;12539;5473;14495
280470;201706;1860;5412;1644;5037;92;289;1220;3742;1312;4031
280480;201706;33478;92300;31101;88853;4014;12957;21060;58948;25074;71905
280490;201706;3893;11494;3424;10729;209;833;2546;7817;2755;8650
280500;201706;955;2470;839;2315;47;148;676;1852;723;2000
280510;201706;2552;7404;2277;7015;148;573;1650;5036;1798;5609
280520;201706;1768;4672;1600;4459;105;294;1337;3743;1442;4037
280530;201706;2522;6568;2305;6292;140;426;1875;5119;2015;5545
280540;201706;9384;25388;8612;24274;248;1068;7476;20502;7724;21570
280550;201706;7017;17561;5781;15702;427;1151;4175;11260;4602;12411
280560;201706;7518;21730;7091;21122;292;1138;6033;17650;6325;18788
280570;201706;6381;16939;5451;15689;427;1409;3783;10759;4210;12168
280580;201706;5443;16474;4702;15139;698;2212;2897;9574;3595;11786
280590;201706;2703;7287;2374;6876;208;812;1586;4452;1794;5264
280600;201706;3546;10475;3244;10037;269;970;2413;7377;2682;8347
280610;201706;2514;6742;2279;6411;165;544;1729;4761;1894;5305
280620;201706;5439;15151;4759;14059;503;1362;3257;10005;3760;11367
280630;201706;3682;11684;3433;11317;291;988;2672;8993;2963;9981
280640;201706;2242;6670;2114;6530;69;210;1954;6078;2023;6288
280650;201706;1119;3308;991;3114;114;384;677;2091;791;2475
280660;201706;2755;7442;2604;7268;224;617;2173;6110;2397;6727
280670;201706;17340;43519;15780;41451;1604;4526;11447;29858;13051;34384
280680;201706;2922;7599;2499;6926;180;507;1860;5070;2040;5577
280690;201706;999;2688;890;2542;87;278;643;1802;730;2080
280700;201706;1084;3084;983;2904;46;159;724;2105;770;2264
280710;201706;13202;32182;11721;30464;666;1283;10082;27015;10748;28298
280720;201706;2470;6183;2226;5902;194;542;1521;4290;1715;4832
280730;201706;1050;2830;967;2705;56;199;799;2182;855;2381
280740;201706;13355;34908;11468;31972;1292;3596;7439;20903;8731;24499
280750;201706;3506;10319;3206;9825;234;812;2287;6971;2521;7783
280760;201706;5824;17145;5322;16379;777;2511;3272;10349;4049;12860
290010;201706;2867;6405;2099;5213;45;196;1656;3877;1701;4073
290020;201706;4528;14280;4372;14080;301;920;3721;12072;4022;12992
290030;201706;3332;9655;3118;9372;301;903;2471;7461;2772;8364
290035;201706;4669;11461;4052;10633;198;584;3228;8608;3426;9192
290040;201706;4285;11013;3608;10250;195;749;2771;7901;2966;8650
290050;201706;2383;7686;2093;7174;146;610;1463;4952;1609;5562
290060;201706;1300;3239;1077;2957;128;429;750;1973;878;2402
290070;201706;33843;82414;29217;76486;4441;11929;16698;45138;21139;57067
290080;201706;5948;17412;5047;16159;718;2396;3269;10708;3987;13104
290090;201706;2126;4331;1741;3914;64;121;1565;3547;1629;3668
290100;201706;9260;26142;8208;24485;1134;3333;5119;15706;6253;19039
290110;201706;5039;14365;4750;13857;638;1993;3083;8895;3721;10888
290115;201706;4660;13691;4139;12989;189;575;3469;11104;3658;11679
290120;201706;6949;17585;5747;16163;243;859;4706;13031;4949;13890
290130;201706;4720;12071;3829;10963;158;632;3028;8424;3186;9056
290135;201706;4711;11359;3896;10093;282;832;2834;7093;3116;7925
290140;201706;4579;13113;3833;12149;194;725;3199;10168;3393;10893
290150;201706;2248;6527;2130;6358;216;659;1604;4701;1820;5360
290160;201706;3355;8275;3158;8030;235;557;2605;6597;2840;7154
290170;201706;2679;8427;2506;8198;139;587;2147;6914;2286;7501
290180;201706;2967;8370;2522;7677;140;510;1935;5832;2075;6342
290190;201706;3832;12360;3650;12090;216;940;2839;9291;3055;10231
290195;201706;2235;5939;1865;5353;70;299;1485;4179;1555;4478
290200;201706;3981;11896;3471;11128;222;792;2715;8623;2937;9415
290205;201706;3391;9312;3036;8749;162;632;2304;6425;2466;7057
290210;201706;14671;41079;13137;39061;1468;3831;9613;29964;11081;33795
290220;201706;2486;6973;2353;6784;209;645;1837;5257;2046;5902
290225;201706;3135;7268;2768;6857;69;161;2572;6404;2641;6565
290230;201706;2267;7070;2120;6897;111;447;1756;5717;1867;6164
290240;201706;3572;9705;3218;9191;206;668;2515;7041;2721;7709
290250;201706;3924;11929;3631;11539;139;376;3064;10209;3203;10585
290260;201706;5224;14355;4298;12964;313;1093;3238;9725;3551;10818
290265;201706;3629;10836;3092;9870;156;657;2347;7374;2503;8031
290270;201706;12147;42889;11601;42021;1013;4296;8781;31564;9794;35860
290280;201706;5725;17742;5241;16963;364;1285;3884;12549;4248;13834
290290;201706;10172;30639;8876;28477;947;3117;6160;19913;7107;23030
290300;201706;4640;12866;3353;10462;206;695;2294;7256;2500;7951
290310;201706;1498;4278;1293;3954;163;551;825;2500;988;3051
290320;201706;28209;78059;23857;72576;4933;15978;12562;39323;17495;55301
290323;201706;3821;10358;3417;9857;117;409;2870;8148;2987;8557
290327;201706;4595;13397;3931;12212;397;1237;2663;8272;3060;9509
290330;201706;1947;4542;1756;4342;86;200;1558;3921;1644;4121
290340;201706;5247;15474;4774;14896;1000;3249;2979;9410;3979;12659
290350;201706;4635;14190;4096;13305;386;1315;2884;9531;3270;10846
290360;201706;4859;13915;4182;13000;135;521;3491;10915;3626;11436
290370;201706;4768;12742;3984;11644;247;701;3125;9233;3372;9934
290380;201706;5618;15921;4905;14859;250;831;3930;12033;4180;12864
290390;201706;15277;45014;13562;42475;1679;5460;8827;28368;10506;33828
290395;201706;2701;8572;2387;7976;98;443;1808;6029;1906;6472
290400;201706;3770;10634;3110;9617;209;706;2237;6813;2446;7519
290405;201706;4836;14668;4071;13277;345;1216;2647;8708;2992;9924
290410;201706;5906;16989;4802;15185;280;1136;3467;10565;3747;11701
290420;201706;3258;9171;2691;8328;214;694;2027;6293;2241;6987
290430;201706;3202;9626;2785;8874;431;1392;1695;5495;2126;6887
290440;201706;3029;7732;2366;6784;119;397;1737;5006;1856;5403
290450;201706;3272;9274;2770;8530;151;590;2076;6239;2227;6829
290460;201706;12595;35907;11272;33612;3211;9914;4119;12226;7330;22140
290470;201706;4183;11656;3236;10166;622;2150;1485;4801;2107;6951
290475;201706;5912;18223;5189;16908;163;809;4039;12865;4202;13674
290480;201706;2343;6263;2172;6016;216;640;1408;4007;1624;4647
290485;201706;4857;14887;4199;13896;222;1099;3408;11036;3630;12135
290490;201706;8633;21780;8105;21106;596;1762;6568;16921;7164;18683
290500;201706;4067;12584;3307;11036;425;1535;1743;5768;2168;7303
290510;201706;3227;8989;2858;8484;113;448;2406;7072;2519;7520
290515;201706;3694;10011;3079;9222;121;321;2623;8036;2744;8357
290520;201706;11481;34699;9219;30226;531;2182;5809;18728;6340;20910
290530;201706;5197;15080;4561;14064;286;928;3645;11225;3931;12153
290540;201706;3730;10667;3493;10299;191;605;2918;8593;3109;9198
290550;201706;4581;11739;4081;11173;78;245;3757;10347;3835;10592
290560;201706;6520;18101;5651;16847;792;2471;3832;11373;4624;13844
290570;201706;43208;114868;39823;110381;3378;9767;29600;81794;32978;91561
290580;201706;7133;23332;6650;22570;657;2306;4976;17209;5633;19515
290590;201706;7182;22637;6226;20965;232;987;5058;17027;5290;18014
290600;201706;18049;52651;16686;50714;1275;4028;13089;40537;14364;44565
290610;201706;2475;8170;2032;7308;114;545;1407;4949;1521;5494
290620;201706;6339;18690;5776;17780;320;1087;4764;14538;5084;15625
290630;201706;8443;21344;7307;20043;507;1399;6042;16711;6549;18110
290640;201706;2681;7540;2170;6744;118;448;1647;5032;1765;5480
290650;201706;10934;31252;10360;30460;2399;6964;6030;18369;8429;25333
290660;201706;3715;9956;3171;9164;129;381;2327;7026;2456;7407
290670;201706;7092;20949;6280;19612;593;1907;4475;14147;5068;16054
290680;201706;10288;30190;9124;28607;345;1594;7312;22471;7657;24065
290682;201706;4703;13000;4101;12138;170;619;3376;9862;3546;10481
290685;201706;3688;8615;2447;6879;248;691;1540;4437;1788;5128
290687;201706;7164;20449;5724;18052;1105;3524;2926;9591;4031;13115
290689;201706;3078;8751;2709;8197;216;742;1923;5934;2139;6676
290690;201706;5538;15322;4811;14344;719;2098;3089;9313;3808;11411
290700;201706;2503;7283;2336;7043;104;362;1954;5912;2058;6274
290710;201706;7821;23990;7218;23116;404;1393;6009;19292;6413;20685
290720;201706;18971;53609;17535;51823;1125;3301;14402;43205;15527;46506
290730;201706;7248;19171;6457;18130;413;1147;4858;13634;5271;14781
290740;201706;933;2699;736;2348;50;169;535;1712;585;1881
290750;201706;10774;29124;9266;26422;1268;3931;5576;15469;6844;19400
290755;201706;2315;6496;1825;5606;107;388;1260;3802;1367;4190
290760;201706;4114;12274;3308;10729;436;1295;1894;6432;2330;7727
290770;201706;2571;8757;2395;8524;104;489;1915;6847;2019;7336
290780;201706;9114;22604;7842;20790;655;1372;5912;16164;6567;17536
290790;201706;4540;13022;4148;12501;229;635;3515;10682;3744;11317
290800;201706;7210;15052;5641;13349;396;795;4376;10748;4772;11543
290810;201706;5587;16174;4587;14560;204;752;3406;10845;3610;11597
290820;201706;5412;14949;4873;14206;335;1129;3608;10533;3943;11662
290830;201706;4587;11420;4182;10880;176;579;3267;8338;3443;8917
290840;201706;17501;49088;15374;45831;1879;5315;10003;31125;11882;36440
290850;201706;6236;17199;5940;16838;666;1678;4503;13263;5169;14941
290860;201706;5369;17328;4973;16857;344;1274;4006;13887;4350;15161
290870;201706;4825;13731;3860;12118;196;782;2729;8519;2925;9301
290880;201706;1451;3785;1157;3335;88;220;787;2317;875;2537
290890;201706;7421;18030;6363;16847;304;781;5623;15004;5927;15785
290900;201706;2368;6627;1827;5671;143;488;1124;3452;1267;3940
290910;201706;5047;13280;4142;11943;80;348;3465;9873;3545;10221
290920;201706;5110;13234;4719;12736;167;460;4152;11178;4319;11638
290930;201706;8370;24105;7135;22163;263;1166;5604;16981;5867;18147
290940;201706;3654;11021;3205;10368;173;587;2401;7888;2574;8475
290950;201706;1590;4267;1383;3947;113;349;962;2747;1075;3096
290960;201706;5681;15749;5122;15051;183;609;4279;12592;4462;13201
290970;201706;3790;11288;3245;10392;242;757;2269;7342;2511;8099
290980;201706;10687;29548;9116;26642;2149;6500;3317;9769;5466;16269
290990;201706;9092;26322;7832;24214;587;2058;5869;17812;6456;19870
291000;201706;3117;8965;2795;8573;272;796;2218;6887;2490;7683
291005;201706;14928;37403;13200;35240;1018;2778;10141;27357;11159;30135
291010;201706;3300;10003;2591;8537;208;693;1654;5461;1862;6154
291020;201706;1291;3383;1049;2952;65;199;649;1728;714;1927
291030;201706;2354;6224;1695;4930;111;353;1042;2925;1153;3278
291040;201706;5603;16283;4910;15253;293;1159;3816;11796;4109;12955
291050;201706;7864;24601;7167;23363;1363;4964;4165;13243;5528;18207
291060;201706;6005;21446;5620;20811;745;3219;3657;13283;4402;16502
291070;201706;16195;45418;14093;42271;671;2463;11045;32833;11716;35296
291072;201706;23872;68507;19112;59004;4367;14398;6609;20620;10976;35018
291075;201706;5093;14094;4505;13159;291;755;3402;9980;3693;10735
291077;201706;1525;4249;1258;3792;58;193;904;2718;962;2911
291080;201706;79106;240469;69820;223769;24507;79963;11776;39110;36283;119073
291085;201706;5744;14890;4906;13752;276;858;4026;11264;4302;12122
291090;201706;1754;3817;1526;3559;133;194;1252;3021;1385;3215
291100;201706;2759;6724;2106;5947;120;445;1608;4438;1728;4883
291110;201706;5390;17974;4786;17018;523;2067;3427;11925;3950;13992
291120;201706;7529;19705;6885;18747;605;1725;5124;13934;5729;15659
291125;201706;1967;3807;1530;3338;52;133;1266;2760;1318;2893
291130;201706;2888;8802;2402;7907;87;401;1789;5723;1876;6124
291140;201706;4268;12409;3595;11127;505;1448;2216;6978;2721;8426
291150;201706;2114;5127;1929;4914;56;176;1636;4097;1692;4273
291160;201706;5062;15737;4488;14732;566;2076;2728;8788;3294;10864
291165;201706;2498;6875;1938;5845;42;174;1357;3971;1399;4145
291170;201706;21297;55372;18264;50756;1340;4084;11467;31811;12807;35895
291180;201706;6118;15794;5022;14074;364;1104;3634;10170;3998;11274
291185;201706;3529;9652;3109;8949;133;413;2516;7146;2649;7559
291190;201706;7488;19553;6501;18158;550;1633;5016;13986;5566;15619
291200;201706;2987;8678;2319;7421;106;353;1491;4777;1597;5130
291210;201706;6702;16102;5716;14915;265;921;4310;11066;4575;11987
291220;201706;4301;12847;3905;12211;444;1596;2612;8018;3056;9614
291230;201706;4033;9864;3612;9398;88;163;3381;8906;3469;9069
291240;201706;4546;12043;3959;11022;124;407;3284;8986;3408;9393
291250;201706;3450;10464;2773;9189;213;695;1845;6218;2058;6913
291260;201706;1126;3079;993;2908;54;242;835;2346;889;2588
291270;201706;4744;14442;4159;13376;899;3002;2299;7508;3198;10510
291280;201706;2246;6323;1788;5524;272;916;983;2993;1255;3909
291290;201706;5709;15675;4881;14548;702;2129;3052;9290;3754;11419
291300;201706;4119;11651;3158;9989;153;547;2245;7023;2398;7570
291310;201706;5415;15072;4671;13730;240;807;3601;10472;3841;11279
291320;201706;6183;18632;4921;16135;1200;3868;2199;7466;3399;11334
291330;201706;1635;4701;1424;4333;95;309;1002;3011;1097;3320
291340;201706;3979;10771;3336;9830;106;399;2694;7843;2800;8242
291345;201706;3279;10231;3051;9938;183;644;2465;8139;2648;8783
291350;201706;5823;16691;5080;15449;275;831;3981;12327;4256;13158
291360;201706;33833;88929;28754;82024;5827;16945;15053;44372;20880;61317
291370;201706;8203;23095;7712;22460;552;1816;5844;16923;6396;18739
291380;201706;3649;10732;3168;9975;137;534;2411;7563;2548;8097
291390;201706;10780;27787;9987;26830;722;2102;8001;21471;8723;23573
291400;201706;14479;38775;12509;35838;2009;5324;7845;23653;9854;28977
291410;201706;3083;8195;2395;7046;104;463;1755;4950;1859;5413
291420;201706;2016;5276;1708;4892;63;230;1437;4084;1500;4314
291430;201706;3267;9152;2856;8557;129;615;2291;6611;2420;7226
291440;201706;6482;19239;5660;17822;483;1571;4301;13662;4784;15233
291450;201706;8530;23671;7338;22106;261;697;5947;18649;6208;19346
291460;201706;13318;39363;11964;37317;1289;4395;8014;25205;9303;29600
291465;201706;8023;22299;6966;21043;371;1561;5642;16711;6013;18272
291470;201706;15731;40860;13849;38649;804;2260;10444;30000;11248;32260
291480;201706;36548;88078;29670;78943;3851;11168;16575;44460;20426;55628
291490;201706;4322;13354;4037;12959;479;1587;2952;9599;3431;11186
291500;201706;4377;12035;3688;11018;148;582;3047;9046;3195;9628
291510;201706;3789;10891;3384;10305;90;394;2816;8594;2906;8988
291520;201706;3972;10383;3408;9617;274;830;2390;6773;2664;7603
291530;201706;2173;5699;1719;5030;360;985;914;2963;1274;3948
291535;201706;3540;10721;3251;10249;229;756;2427;7736;2656;8492
291540;201706;2103;5072;1742;4664;118;316;1473;3896;1591;4212
291550;201706;5214;13364;4512;12387;669;1716;2772;7817;3441;9533
291560;201706;18979;43989;13416;37416;925;2532;9126;26894;10051;29426
291570;201706;2195;5564;1960;5283;142;281;1613;4520;1755;4801
291580;201706;5510;16148;4837;15181;496;1864;3346;10387;3842;12251
291590;201706;1781;5437;1616;5173;145;508;1229;3965;1374;4473
291600;201706;5281;14089;4037;12093;812;2540;1982;5849;2794;8389
291610;201706;4853;14879;4691;14691;131;492;4289;13438;4420;13930
291620;201706;3099;7143;2279;6249;153;472;1718;4795;1871;5267
291630;201706;3215;7597;2575;6803;160;436;2029;5371;2189;5807
291640;201706;16482;44152;13023;38832;3125;9742;3852;12280;6977;22022
291650;201706;8521;23991;7770;23068;533;1362;6479;19582;7012;20944
291660;201706;2286;5713;1711;4821;151;532;1068;2819;1219;3351
291670;201706;1895;5178;1711;4922;114;315;1336;3904;1450;4219
291680;201706;3939;11062;3426;10188;482;1555;2235;6619;2717;8174
291685;201706;4943;12150;4055;10981;494;1198;2729;7725;3223;8923
291690;201706;3793;9863;3029;8613;166;456;2242;6329;2408;6785
291700;201706;9109;27491;8090;25681;764;2414;5998;19204;6762;21618
291710;201706;5230;13374;4182;11959;441;1322;2775;7824;3216;9146
291720;201706;4698;14711;3911;13080;280;1085;2722;8877;3002;9962
291730;201706;6331;17978;5698;17123;385;1335;4508;13622;4893;14957
291733;201706;2841;7755;2351;7069;146;472;1623;5039;1769;5511
291735;201706;3002;8058;2530;7375;112;380;2056;5935;2168;6315
291740;201706;3872;10538;3227;9643;165;549;2568;7651;2733;8200
291750;201706;21419;54384;17075;47732;2861;8285;9264;26462;12125;34747
291760;201706;10588;33224;9222;30820;3404;12573;2200;7485;5604;20058
291770;201706;7557;21449;6326;19233;726;2429;4136;12278;4862;14707
291780;201706;4535;13278;4172;12669;211;702;3438;10406;3649;11108
291790;201706;2677;7924;2532;7714;128;454;2059;6190;2187;6644
291800;201706;30169;80446;26187;74964;3417;9946;16697;48926;20114;58872
291810;201706;10869;28085;9170;26000;338;1160;7542;21230;7880;22390
291820;201706;3785;10800;3377;10184;180;618;2569;7767;2749;8385
291830;201706;4160;10760;3829;10275;334;893;2970;8063;3304;8956
291835;201706;6271;19410;5140;17297;1019;3481;2766;9632;3785;13113
291840;201706;48418;134013;42259;126699;5616;16922;28735;88994;34351;105916
291845;201706;2553;7394;2356;7122;128;360;1991;6107;2119;6467
291850;201706;4432;12651;3657;11388;339;961;2602;8393;2941;9354
291855;201706;1927;4414;1649;4070;112;337;1302;3151;1414;3488
291860;201706;2257;6137;1701;5059;55;198;1131;3215;1186;3413
291870;201706;1390;3674;980;2916;72;264;604;1705;676;1969
291875;201706;2871;8729;2539;8194;135;527;1808;5712;1943;6239
291880;201706;5046;15780;4617;14935;478;1553;3258;10581;3736;12134
291890;201706;1329;3242;1049;2887;228;517;652;1896;880;2413
291900;201706;1278;3328;980;2830;40;164;744;2096;784;2260
291905;201706;2800;7313;2127;6113;78;259;1556;4358;1634;4617
291910;201706;2845;7421;2414;6912;115;393;2018;5792;2133;6185
291915;201706;7042;21266;5912;19259;333;1251;4466;14623;4799;15874
291920;201706;24898;72945;22952;70217;2901;10016;15027;45356;17928;55372
291930;201706;2557;7471;2254;6964;195;742;1594;4762;1789;5504
291940;201706;3362;9320;2472;7773;265;871;1471;4503;1736;5374
291950;201706;8787;28301;7803;26410;1161;3985;4461;15543;5622;19528
291955;201706;11674;32547;10816;31489;2180;6128;6599;20271;8779;26399
291960;201706;3128;8813;2536;7911;187;606;1847;5925;2034;6531
291970;201706;4002;11851;3674;11300;326;1210;2526;7694;2852;8904
291980;201706;11633;32589;9071;28913;703;2321;6223;20136;6926;22457
291990;201706;2130;6266;1973;6072;78;295;1740;5383;1818;5678
291992;201706;2897;8562;2820;8436;371;1069;2151;6478;2522;7547
291995;201706;2152;5979;1785;5452;74;296;1422;4253;1496;4549
292000;201706;2407;6558;2142;6176;194;620;1441;4179;1635;4799
292010;201706;6204;15155;5109;13629;361;954;3951;10604;4312;11558
292020;201706;4178;13426;3874;12910;399;1450;2898;9574;3297;11024
292030;201706;1809;5795;1691;5608;161;601;978;3146;1139;3747
292040;201706;4374;11541;3735;10829;269;669;3011;9140;3280;9809
292045;201706;3541;10420;3104;9805;102;261;2786;8908;2888;9169
292050;201706;6448;19171;5414;17131;462;1607;3358;10555;3820;12162
292060;201706;12905;31099;11873;29826;708;1833;9943;24622;10651;26455
292070;201706;5184;14898;4748;14393;349;1069;3973;12119;4322;13188
292080;201706;3452;8834;2816;8025;158;535;2380;6766;2538;7301
292090;201706;4074;10001;3397;9206;227;725;2735;7467;2962;8192
292100;201706;10613;28383;9251;26451;1915;5694;4603;13576;6518;19270
292105;201706;3051;9086;2741;8571;115;474;2208;6876;2323;7350
292110;201706;6435;16922;4947;14524;1287;3802;2181;6560;3468;10362
292120;201706;7125;19689;5888;17435;873;2555;3526;10599;4399;13154
292130;201706;2943;8000;2541;7437;318;894;1714;5163;2032;6057
292140;201706;4880;12677;4060;11467;391;1043;2994;8569;3385;9612
292145;201706;2253;6880;1969;6387;219;669;1293;4328;1512;4997
292150;201706;13226;38457;12090;36763;442;1679;9972;30238;10414;31917
292160;201706;2379;6833;2159;6544;82;327;1913;5752;1995;6079
292170;201706;8707;24415;7271;21957;737;2341;4767;14431;5504;16772
292180;201706;3080;8615;2363;7395;470;1413;1168;3746;1638;5159
292190;201706;3187;8882;2702;8109;452;1452;1452;4407;1904;5859
292200;201706;6977;20489;5909;18687;1401;4575;2592;8406;3993;12981
292205;201706;3862;11295;3455;10695;134;630;2877;8679;3011;9309
292210;201706;6429;16300;5376;14892;184;644;4585;12521;4769;13165
292220;201706;1825;4948;1631;4652;238;648;1027;2949;1265;3597
292225;201706;3243;9874;2933;9396;122;543;2406;7592;2528;8135
292230;201706;7087;19118;6642;18446;237;986;5427;14606;5664;15592
292240;201706;4881;14613;4292;13404;362;1140;2867;8951;3229;10091
292250;201706;5253;15370;4900;14789;774;2359;2943;9006;3717;11365
292260;201706;3254;9195;2986;8836;190;548;2482;7447;2672;7995
292265;201706;3238;9538;2772;8749;101;466;2138;6562;2239;7028
292270;201706;4041;10126;3371;9323;238;738;2730;7566;2968;8304
292273;201706;2538;5924;2146;5432;131;243;1675;4408;1806;4651
292275;201706;1714;4993;1521;4704;95;230;1215;3935;1310;4165
292280;201706;2405;6270;2024;5824;103;272;1613;4843;1716;5115
292285;201706;2466;6535;2049;5937;123;392;1587;4594;1710;4986
292290;201706;6364;19410;5605;18251;311;1262;4362;14145;4673;15407
292300;201706;8753;25137;7530;23555;1611;5199;4243;13635;5854;18834
292303;201706;2896;8577;2598;8145;87;320;2208;6870;2295;7190
292305;201706;2829;7574;2657;7323;54;225;2389;6504;2443;6729
292310;201706;6240;17678;5712;16936;268;822;4665;13832;4933;14654
292320;201706;6873;18487;5722;16510;370;1171;4329;12301;4699;13472
292330;201706;2325;5850;2125;5588;113;340;1759;4556;1872;4896
292335;201706;5188;13333;4641;12595;331;828;3766;10387;4097;11215
292340;201706;6685;17871;5671;16251;313;908;4242;12097;4555;13005
292350;201706;2300;6620;1969;6155;88;334;1618;5066;1706;5400
292360;201706;5300;13671;4818;12886;377;1133;3559;9548;3936;10681
292370;201706;8988;23727;7848;22240;384;1040;6620;18790;7004;19830
292380;201706;7297;21002;6634;19919;576;1683;4964;14993;5540;16676
292390;201706;3943;8266;3048;7304;135;244;2680;6535;2815;6779
292400;201706;20947;63615;19146;60590;2688;8786;12432;39543;15120;48329
292405;201706;4552;11173;3727;10083;210;519;2991;8145;3201;8664
292410;201706;2073;5359;1858;5105;100;269;1558;4294;1658;4563
292420;201706;3779;11836;3549;11481;212;929;2903;9280;3115;10209
292430;201706;5476;15879;4115;13933;358;1354;2662;9087;3020;10441
292440;201706;8560;27682;7946;26801;169;756;7225;24507;7394;25263
292450;201706;4030;11878;3262;10524;223;790;2384;7748;2607;8538
292460;201706;4609;13678;3999;12586;378;1256;2822;8898;3200;10154
292465;201706;2426;6946;2027;6318;142;466;1377;4377;1519;4843
292467;201706;1773;5557;1700;5444;240;780;1180;3869;1420;4649
292470;201706;2975;7668;2430;6793;96;272;1897;5294;1993;5566
292480;201706;6447;16165;5354;14768;124;433;4722;12873;4846;13306
292490;201706;2406;6377;1969;5749;135;415;1464;4287;1599;4702
292500;201706;6492;18766;5571;17121;672;2069;3637;11329;4309;13398
292510;201706;12722;35980;10791;33028;754;2860;7821;23883;8575;26743
292520;201706;6411;17061;5569;15787;1020;2902;3330;9659;4350;12561
292525;201706;5425;13889;4619;12956;208;567;3931;11146;4139;11713
292530;201706;27604;77619;24235;72733;5722;17495;11266;35049;16988;52544
292540;201706;3180;7964;2795;7507;283;728;2216;6051;2499;6779
292550;201706;6860;20382;5801;19012;490;1824;4430;14789;4920;16613
292560;201706;4120;11273;3627;10517;170;695;2851;8126;3021;8821
292570;201706;4285;11623;3826;11075;79;236;3534;10347;3613;10583
292575;201706;6495;20620;6244;20268;316;1081;5258;17136;5574;18217
292580;201706;6967;19697;6360;18828;311;977;5362;15902;5673;16879
292590;201706;7681;21162;7055;20269;321;1096;5979;16819;6300;17915
292593;201706;2971;7545;2528;6835;225;586;1892;5068;2117;5654
292595;201706;5804;15662;5116;14769;275;938;4101;11733;4376;12671
292600;201706;10991;30611;9754;28943;715;1862;7449;22551;8164;24413
292610;201706;4804;12781;3932;11351;224;611;2589;7720;2813;8331
292620;201706;6349;18388;5569;17506;119;358;5161;16448;5280;16806
292630;201706;9057;22906;7502;20438;527;1496;5222;14295;5749;15791
292640;201706;7846;24667;7234;23659;325;1295;5396;17671;5721;18966
292650;201706;4517;12034;4185;11596;264;756;3576;9861;3840;10617
292660;201706;11084;32191;10007;30598;779;2568;7638;23455;8417;26023
292665;201706;2269;7066;2112;6867;30;126;1890;6198;1920;6324
292670;201706;3650;10139;2858;8696;188;678;1844;5534;2032;6212
292680;201706;3813;10778;3316;9886;258;777;2406;7065;2664;7842
292690;201706;2753;7447;1986;6192;155;469;1301;4188;1456;4657
292700;201706;9733;27606;8450;25786;1021;2938;5508;17583;6529;20521
292710;201706;2245;7262;2092;7058;70;266;1861;6309;1931;6575
292720;201706;9507;23404;8207;21967;303;963;6928;18736;7231;19699
292730;201706;3753;10692;3597;10469;163;493;3016;8774;3179;9267
292740;201706;337486;885835;314766;850911;55873;159593;184926;493481;240799;653074
292750;201706;6563;17588;5611;16193;274;883;4301;12448;4575;13331
292760;201706;3939;11885;3562;11212;319;1092;2531;7903;2850;8995
292770;201706;6081;17320;5262;16100;905;2911;3092;9774;3997;12685
292780;201706;1854;4155;1440;3636;81;237;1083;2666;1164;2903
292790;201706;3629;8253;3333;7928;46;102;3211;7672;3257;7774
292800;201706;9623;27013;8793;25661;503;1558;6973;20252;7476;21810
292805;201706;3059;8307;2659;7737;240;683;1965;5784;2205;6467
292810;201706;9718;27691;7855;24964;615;2114;5565;17867;6180;19981
292820;201706;7678;21104;5668;18172;390;1559;4214;13324;4604;14883
292830;201706;2238;5784;2009;5488;64;289;1817;4848;1881;5137
292840;201706;8216;23945;7710;23253;246;1071;6739;19828;6985;20899
292850;201706;3078;8087;2463;7145;203;698;1591;4474;1794;5172
292860;201706;15592;38757;14255;37039;978;2496;11243;29299;12221;31795
292870;201706;18806;50500;16463;46845;1481;4872;10196;28475;11677;33347
292880;201706;12187;34345;10926;32584;631;2497;8017;23069;8648;25566
292890;201706;5539;17788;4969;16806;532;1953;3483;11779;4015;13732
292895;201706;2938;6826;2177;5680;152;392;1556;4071;1708;4463
292900;201706;2769;8237;2621;7996;133;610;2026;5906;2159;6516
292905;201706;4235;12027;3373;10665;286;876;2269;7311;2555;8187
292910;201706;5004;14494;4532;13652;472;1520;2899;8706;3371;10226
292920;201706;9852;27858;9395;27246;417;1573;8052;22876;8469;24449
292925;201706;5140;15179;4678;14477;276;886;3634;11221;3910;12107
292930;201706;6566;20499;6070;19554;434;1897;4111;12847;4545;14744
292935;201706;2014;5807;1671;5422;68;284;1418;4702;1486;4986
292937;201706;3110;7890;2701;7389;103;309;2275;6230;2378;6539
292940;201706;3126;8478;2582;7695;183;578;1884;5718;2067;6296
292950;201706;8660;24387;7968;23249;421;1539;5985;17090;6406;18629
292960;201706;5474;13419;4673;12368;209;663;3610;9404;3819;10067
292970;201706;4272;12362;3741;11649;150;639;3042;9454;3192;10093
292975;201706;3805;9424;3521;9082;239;538;3052;7936;3291;8474
292980;201706;3220;8363;2568;7364;157;504;1923;5419;2080;5923
292990;201706;11864;32934;10191;30388;451;1555;8088;24110;8539;25665
293000;201706;2860;7100;2592;6773;34;115;1962;5444;1996;5559
293010;201706;17791;48398;15060;43975;2034;6237;9090;26475;11124;32712
293015;201706;7478;24871;6357;22667;690;2858;4153;14679;4843;17537
293020;201706;8971;29109;8534;28490;259;1182;7502;24860;7761;26042
293030;201706;5610;15711;4438;13844;204;680;2995;9677;3199;10357
293040;201706;3736;11759;3538;11445;162;601;3045;9797;3207;10398
293050;201706;21194;55995;18722;52757;2634;7628;11058;32279;13692;39907
293060;201706;3603;9549;2974;8508;228;734;2132;5995;2360;6729
293070;201706;24633;64646;20247;58540;4356;12546;9625;29543;13981;42089
293075;201706;3251;10938;3011;10543;185;852;2356;8262;2541;9114
293076;201706;3699;9856;3271;9289;145;390;2610;7565;2755;7955
293077;201706;5243;15484;4512;14474;663;2158;2832;9374;3495;11532
293080;201706;4722;14401;4241;13642;175;767;3453;10902;3628;11669
293090;201706;3160;9890;2612;9007;226;840;1784;6255;2010;7095
293100;201706;5942;16842;4905;14992;414;1279;3586;11040;4000;12319
293105;201706;3926;12677;3429;11721;364;1303;2277;7807;2641;9110
293110;201706;2105;5679;1824;5289;81;248;1462;4240;1543;4488
293120;201706;3884;12004;3687;11697;197;619;3072;9802;3269;10421
293130;201706;3777;10941;3423;10510;119;474;2968;9094;3087;9568
293135;201706;31652;78640;24018;67723;4975;15813;9257;26439;14232;42252
293140;201706;2033;5379;1911;5213;94;307;1571;4163;1665;4470
293150;201706;5516;17552;4660;15893;581;2041;2975;10272;3556;12313
293160;201706;3838;9645;3428;9153;393;734;2665;7611;3058;8345
293170;201706;3487;9715;3180;9267;195;665;2352;6870;2547;7535
293180;201706;5094;14040;4155;12474;164;691;3242;9439;3406;10130
293190;201706;14067;40750;12636;38607;485;2202;10533;31629;11018;33831
293200;201706;7656;20089;6628;18755;240;883;5029;14275;5269;15158
293210;201706;5234;14499;4555;13385;269;864;3429;10025;3698;10889
293220;201706;5018;14475;4167;12909;1046;3230;1538;5000;2584;8230
293230;201706;3653;10839;3223;10141;446;1531;2111;6645;2557;8176
293240;201706;4332;11886;3503;10474;126;400;2620;7893;2746;8293
293245;201706;4310;11766;3832;11109;202;652;3124;9007;3326;9659
293250;201706;5663;14894;5054;13964;441;1259;3705;10166;4146;11425
293260;201706;4555;13123;3780;11938;216;746;2643;8251;2859;8997
293270;201706;5927;15140;5232;14368;401;993;4349;12235;4750;13228
293280;201706;5236;14209;4416;13097;218;654;3373;10073;3591;10727
293290;201706;14119;45869;13056;43903;3283;11238;5700;20118;8983;31356
293300;201706;6713;15801;5682;14542;382;908;4196;10941;4578;11849
293305;201706;4786;11798;4031;10802;124;412;3353;8947;3477;9359
293310;201706;2371;6157;1898;5339;164;473;1284;3572;1448;4045
293315;201706;4302;10634;3595;9575;222;538;2829;7542;3051;8080
293317;201706;2443;6727;2196;6289;172;481;1559;4491;1731;4972
293320;201706;7759;24434;7474;24081;1104;3495;5502;18117;6606;21612
293325;201706;1741;4867;1450;4394;228;738;900;2701;1128;3439
293330;201706;48615;156704;43997;148225;9924;35128;19901;68091;29825;103219
293340;201706;2558;7279;2054;6393;235;772;1224;3810;1459;4582
293345;201706;3260;9486;2872;8985;262;606;2124;7090;2386;7696
293350;201706;6516;18989;6148;18556;140;327;5649;17483;5789;17810
293360;201706;13752;39364;12397;37696;669;2233;10779;32814;11448;35047
310010;201706;788;2156;656;1958;79;300;304;849;383;1149
310020;201706;2557;7943;2148;7183;549;2036;274;867;823;2903
310030;201706;2165;6610;1808;6005;331;1271;1024;3299;1355;4570
310040;201706;993;2607;809;2343;71;266;604;1676;675;1942
310050;201706;1797;6019;1671;5757;323;1273;751;2460;1074;3733
310060;201706;3369;9904;2924;9323;204;825;2321;7342;2525;8167
310070;201706;362;968;271;799;10;40;176;484;186;524
310080;201706;749;2161;588;1879;90;354;234;711;324;1065
310090;201706;4768;13633;4065;12441;499;1658;2698;8240;3197;9898
310100;201706;3558;10399;2979;9474;160;617;2254;7110;2414;7727
310110;201706;4948;13673;4162;12305;678;2277;2150;6103;2828;8380
310120;201706;658;1909;490;1597;108;428;190;500;298;928
310130;201706;377;1122;331;1037;68;264;174;476;242;740
310140;201706;176;590;149;547;47;203;46;141;93;344
310150;201706;4656;13942;3932;12525;925;3180;1256;3894;2181;7074
310160;201706;6737;21044;5616;18883;1766;6357;886;3000;2652;9357
310163;201706;1089;3439;921;3104;306;1113;244;784;550;1897
310170;201706;9082;24766;8007;23232;889;2754;5596;16312;6485;19066
310180;201706;1755;4844;1471;4418;183;649;900;2610;1083;3259
310190;201706;2946;9463;2608;8875;705;2663;496;1686;1201;4349
310200;201706;1720;5549;1436;4922;272;1027;525;1746;797;2773
310205;201706;1138;3206;864;2790;126;387;472;1582;598;1969
310210;201706;2808;7691;2392;7089;156;531;1720;5008;1876;5539
310220;201706;1042;3041;896;2798;128;464;566;1692;694;2156
310230;201706;2486;7432;2084;6540;272;1041;1190;3502;1462;4543
310240;201706;896;3206;821;3057;99;455;503;1826;602;2281
310250;201706;883;2778;811;2644;144;571;462;1394;606;1965
310260;201706;3029;9441;2237;7842;519;2074;342;983;861;3057
310270;201706;2654;7136;2130;6401;149;565;1647;4856;1796;5421
310280;201706;2323;5878;1842;5156;150;583;1171;3129;1321;3712
310285;201706;1975;6871;1826;6624;185;766;1226;4562;1411;5328
310290;201706;1130;3323;1044;3176;240;864;555;1525;795;2389
310300;201706;1650;5436;1562;5275;354;1402;766;2428;1120;3830
310310;201706;330;878;231;699;37;105;120;367;157;472
310320;201706;401;1192;312;1031;34;145;158;475;192;620
310330;201706;528;1294;340;937;44;132;125;299;169;431
310340;201706;8189;23746;6697;21154;1387;4360;3033;10022;4420;14382
310350;201706;13839;35775;9690;28934;2509;8225;2269;6626;4778;14851
310360;201706;453;1232;407;1168;20;71;319;896;339;967
310370;201706;1378;4548;1206;4215;261;954;515;1809;776;2763
310375;201706;1236;3329;823;2606;126;434;277;871;403;1305
310380;201706;374;951;214;651;56;175;64;174;120;349
310390;201706;456;1534;392;1404;99;369;86;258;185;627
310400;201706;9797;26709;7449;22759;1681;5647;2441;7296;4122;12943
310410;201706;685;2221;492;1892;118;499;91;340;209;839
310420;201706;4479;12455;3068;9578;617;2152;500;1334;1117;3486
310430;201706;1272;4016;918;3278;232;880;129;431;361;1311
310440;201706;540;1549;403;1274;65;244;184;570;249;814
310445;201706;1320;4071;1037;3545;71;276;710;2409;781;2685
310450;201706;4525;12259;3581;10850;303;968;2574;7882;2877;8850
310460;201706;1720;4912;1312;4195;319;1133;346;1127;665;2260
310470;201706;4149;9166;3488;8363;276;788;2899;6849;3175;7637
310480;201706;1273;3595;937;2944;190;628;419;1254;609;1882
310490;201706;3002;9369;2539;8471;509;1971;1038;3319;1547;5290
310500;201706;1313;4287;1124;3901;263;990;443;1496;706;2486
310510;201706;1925;6025;1518;5136;393;1446;283;954;676;2400
310520;201706;1417;3578;1057;3022;71;199;715;2025;786;2224
310530;201706;936;2735;497;1657;80;293;52;139;132;432
310540;201706;3086;9544;2656;8771;699;2454;1004;3182;1703;5636
310550;201706;1157;3177;929;2812;140;532;555;1577;695;2109
310560;201706;14524;43148;12165;38801;3087;10942;3781;11258;6868;22200
310570;201706;1189;3452;1002;3132;131;525;672;2005;803;2530
310590;201706;4339;12408;3631;11144;514;1722;1908;5751;2422;7473
310600;201706;1472;4666;1239;4150;219;807;531;1667;750;2474
310610;201706;464;1436;385;1293;86;366;153;452;239;818
310620;201706;146796;435935;124537;393219;29770;105348;41750;118485;71520;223833
310630;201706;4431;12946;3928;12063;346;1199;2844;8613;3190;9812
310640;201706;1250;3818;1022;3421;280;1049;285;915;565;1964
310650;201706;2695;8146;2066;7030;268;981;1109;3732;1377;4713
310660;201706;1356;3941;1185;3722;97;324;892;2786;989;3110
310665;201706;1323;3798;1158;3562;68;238;913;2850;981;3088
310670;201706;41127;123075;36467;113586;8157;27085;15284;46115;23441;73200
310680;201706;677;1837;597;1722;63;206;427;1201;490;1407
310690;201706;1353;4241;1112;3822;178;735;528;1728;706;2463
310700;201706;551;1328;429;1174;63;203;259;679;322;882
310710;201706;6215;19628;4704;17263;1054;4522;511;1735;1565;6257
310720;201706;825;2375;746;2261;65;234;532;1591;597;1825
310730;201706;9272;27822;8229;26076;1133;4031;4850;15129;5983;19160
310740;201706;5162;15939;3927;13369;840;3030;860;2828;1700;5858
310750;201706;1489;3676;1093;3136;214;657;416;1097;630;1754
310760;201706;576;1702;469;1519;67;236;203;683;270;919
310770;201706;991;2987;725;2556;103;413;356;1198;459;1611
310780;201706;3915;10399;3215;9228;313;927;2139;6082;2452;7009
310790;201706;1946;6196;1779;5896;386;1293;810;2814;1196;4107
310800;201706;2621;8255;2008;7033;557;2272;136;444;693;2716
310810;201706;1138;3141;994;2877;131;428;572;1572;703;2000
310820;201706;1257;3542;875;2799;198;692;225;699;423;1391
310825;201706;2933;9987;2382;9046;117;668;1801;6752;1918;7420
310830;201706;1382;4391;1130;3920;286;1063;381;1303;667;2366
310840;201706;2185;6351;1580;5241;317;1112;385;1196;702;2308
310850;201706;1557;4458;1347;4195;111;439;997;3041;1108;3480
310855;201706;3059;9058;2601;8397;337;1222;1760;5647;2097;6869
310860;201706;7240;21784;6024;19486;613;2158;3633;11831;4246;13989
310870;201706;1095;2834;835;2414;189;575;444;1283;633;1858
310880;201706;1010;3102;824;2738;108;411;464;1516;572;1927
310890;201706;2551;7464;1943;6449;493;1860;364;1062;857;2922
310900;201706;4263;13060;3351;11224;669;2527;1308;4073;1977;6600
310910;201706;1910;5342;1221;4009;174;635;124;327;298;962
310920;201706;1885;5361;1483;4708;277;979;724;2261;1001;3240
310925;201706;975;3045;861;2846;203;747;461;1464;664;2211
310930;201706;6061;16710;4788;14775;716;2340;2679;8494;3395;10834
310940;201706;6209;16815;5131;15184;601;1941;3208;9376;3809;11317
310945;201706;1235;3681;1123;3506;93;343;763;2322;856;2665
310950;201706;2121;6462;1534;5216;328;1293;511;1613;839;2906
310960;201706;471;1358;386;1194;75;273;164;480;239;753
310970;201706;1233;3955;927;3303;227;871;200;647;427;1518
310980;201706;398;955;250;699;33;106;140;373;173;479
310990;201706;1180;3697;953;3197;206;740;322;1035;528;1775
311000;201706;3550;11643;3230;11038;965;3607;1127;3659;2092;7266
311010;201706;750;2443;671;2245;235;851;234;762;469;1613
311020;201706;962;2747;744;2357;109;415;360;1070;469;1485
311030;201706;1717;4635;1194;3699;317;1133;352;982;669;2115
311040;201706;437;1436;361;1253;85;299;76;241;161;540
311050;201706;2378;7026;2022;6451;484;1714;756;2371;1240;4085
311060;201706;2636;7584;1929;6070;310;1125;651;1856;961;2981
311070;201706;1460;4690;1242;4293;241;969;542;1781;783;2750
311080;201706;824;2438;693;2193;139;493;285;833;424;1326
311090;201706;1898;6541;1573;5962;427;1849;521;1907;948;3756
311100;201706;1972;6519;1543;5582;474;1897;197;666;671;2563
311110;201706;3506;8220;2477;6742;496;1424;1096;3018;1592;4442
311115;201706;1240;3544;1046;3249;92;357;744;2271;836;2628
311120;201706;7463;20705;5706;17556;1116;3811;1677;4688;2793;8499
311130;201706;2057;6159;1700;5597;264;1074;736;2285;1000;3359
311140;201706;1353;3473;1022;3014;79;261;649;1934;728;2195
311150;201706;1647;5679;1500;5401;247;969;883;3158;1130;4127
311160;201706;3903;12677;3100;11198;1041;4095;680;2443;1721;6538
311170;201706;798;2351;631;2047;56;214;336;1104;392;1318
311180;201706;1130;3223;877;2757;268;906;237;733;505;1639
311190;201706;1109;3131;854;2663;160;574;256;755;416;1329
311200;201706;1826;5439;1416;4592;400;1405;245;730;645;2135
311205;201706;978;3180;837;2903;94;419;422;1446;516;1865
311210;201706;1013;3123;915;2995;129;394;652;2210;781;2604
311220;201706;824;2558;682;2254;156;574;241;744;397;1318
311230;201706;8376;26235;6490;22271;1333;4844;1990;7082;3323;11926
311240;201706;992;2937;782;2611;178;646;328;1064;506;1710
311250;201706;790;2506;695;2342;191;706;257;803;448;1509
311260;201706;2170;5800;1691;5008;389;1268;580;1645;969;2913
311265;201706;1237;3409;972;2969;108;368;597;1800;705;2168
311270;201706;3365;10435;2967;9879;269;1228;2040;6494;2309;7722
311280;201706;1174;3300;711;2274;142;528;167;514;309;1042
311290;201706;2012;6503;1883;6203;259;829;1203;4018;1462;4847
311300;201706;4471;14090;3980;13218;310;1416;2968;9615;3278;11031
311310;201706;625;1979;539;1814;119;407;154;480;273;887
311320;201706;3474;11378;3150;10666;546;2145;1223;3828;1769;5973
311330;201706;4475;13089;3895;12082;740;2525;1920;5937;2660;8462
311340;201706;11654;36077;9973;32875;2983;10463;2513;8387;5496;18850
311350;201706;2309;6279;1767;5261;237;825;843;2290;1080;3115
311360;201706;910;2684;788;2518;393;1302;112;385;505;1687
311370;201706;3949;11336;3249;10104;449;1707;1584;4544;2033;6251
311380;201706;451;1451;368;1282;107;387;110;395;217;782
311390;201706;1798;6270;1600;5982;687;2927;428;1430;1115;4357
311400;201706;1476;4513;1159;3876;211;828;447;1326;658;2154
311410;201706;1709;5787;1563;5598;375;1538;758;2693;1133;4231
311420;201706;1887;6046;1295;4641;226;883;133;368;359;1251
311430;201706;3584;10513;2493;8183;469;1675;419;1334;888;3009
311440;201706;2433;7677;1813;6512;553;2244;338;1233;891;3477
311450;201706;1980;6598;1575;5786;407;1642;281;923;688;2565
311455;201706;1030;2737;797;2344;219;672;279;792;498;1464
311460;201706;602;1905;442;1601;91;405;106;349;197;754
311470;201706;466;1548;374;1349;98;402;59;192;157;594
311480;201706;820;2121;742;2002;129;356;453;1192;582;1548
311490;201706;209;754;187;691;54;219;64;211;118;430
311500;201706;441;1263;353;1109;57;208;177;556;234;764
311510;201706;2809;8370;2127;7126;573;2223;462;1513;1035;3736
311520;201706;600;1895;560;1813;164;581;241;739;405;1320
311530;201706;10590;26911;7666;22246;1887;6393;1898;5223;3785;11616
311535;201706;770;2208;509;1710;117;477;97;297;214;774
311540;201706;597;2016;555;1946;133;474;280;974;413;1448
311545;201706;2184;6357;1934;6057;152;599;1436;4395;1588;4994
311547;201706;1507;4117;1280;3767;67;232;943;2749;1010;2981
311550;201706;2945;8927;2391;7839;382;1478;885;2793;1267;4271
311560;201706;260;670;219;616;31;95;126;327;157;422
311570;201706;1990;5023;1527;4387;59;169;1212;3610;1271;3779
311580;201706;2473;4811;1779;4011;285;571;1093;2645;1378;3216
311590;201706;498;1472;418;1350;100;382;185;575;285;957
311600;201706;1277;3725;1065;3443;160;519;707;2335;867;2854
311610;201706;2724;9364;2426;8794;687;2412;947;3599;1634;6011
311615;201706;3193;9683;2640;8801;239;958;1872;6163;2111;7121
311620;201706;422;1247;370;1163;45;161;251;781;296;942
311630;201706;1363;3926;1124;3494;100;348;782;2371;882;2719
311640;201706;792;2486;642;2232;122;465;294;1021;416;1486
311650;201706;2231;6160;1901;5653;196;690;1175;3423;1371;4113
311660;201706;2796;8715;2167;7430;435;1571;352;1067;787;2638
311670;201706;1627;4532;1328;4071;305;1043;504;1539;809;2582
311680;201706;2113;6527;1751;5842;317;1126;1006;3337;1323;4463
311690;201706;545;1325;459;1214;31;86;361;963;392;1049
311700;201706;2313;5870;1796;5195;84;281;1385;3928;1469;4209
311710;201706;1633;4970;1192;4090;370;1388;322;1129;692;2517
311720;201706;396;1308;356;1238;55;217;169;566;224;783
311730;201706;6013;14689;3453;10338;1054;3590;528;1292;1582;4882
311740;201706;797;2428;763;2381;93;264;615;1966;708;2230
311750;201706;4115;12907;3493;11877;522;2062;1935;6340;2457;8402
311760;201706;682;2221;597;2023;131;509;154;420;285;929
311770;201706;2166;6751;1762;5971;403;1495;547;1781;950;3276
311780;201706;1276;4254;1022;3692;248;1031;226;707;474;1738
311783;201706;2067;6446;1729;5798;62;291;1330;4402;1392;4693
311787;201706;625;2079;471;1653;80;322;139;400;219;722
311790;201706;1564;4525;1191;3840;258;945;396;1232;654;2177
311800;201706;5023;16559;4383;15015;804;3049;514;1629;1318;4678
311810;201706;1035;3354;883;3045;71;285;515;1757;586;2042
311820;201706;631;1896;531;1665;106;400;300;849;406;1249
311830;201706;8108;26008;6320;21830;1781;6709;612;2034;2393;8743
311840;201706;2847;8444;2587;8041;485;1716;1567;4791;2052;6507
311850;201706;306;914;265;839;43;140;152;481;195;621
311860;201706;50918;145669;43358;132687;7380;24523;23217;69496;30597;94019
311870;201706;2131;6157;1546;5000;286;1058;497;1451;783;2509
311880;201706;6715;18659;5897;17575;616;1778;4247;12982;4863;14760
311890;201706;1423;4120;1173;3659;232;779;561;1715;793;2494
311900;201706;710;2080;601;1899;76;278;370;1155;446;1433
311910;201706;4119;11822;3434;10828;729;2444;1599;5066;2328;7510
311920;201706;1952;6127;1662;5620;193;750;980;3273;1173;4023
311930;201706;3455;9499;2861;8551;1133;3614;764;2154;1897;5768
311940;201706;12974;37990;10441;32931;1998;6937;3593;10742;5591;17679
311950;201706;2226;6436;1765;5672;136;553;1238;3918;1374;4471
311960;201706;392;1188;352;1107;58;235;170;453;228;688
311970;201706;408;1349;287;1056;53;228;58;195;111;423
311980;201706;550;1551;358;1183;63;229;112;371;175;600
311990;201706;482;1293;364;1122;114;392;142;426;256;818
311995;201706;1164;3519;690;2372;40;155;52;122;92;277
312000;201706;608;1772;542;1670;46;146;370;1163;416;1309
312010;201706;891;2868;734;2496;95;351;334;1093;429;1444
312015;201706;1340;4226;1215;4000;128;508;801;2559;929;3067
312020;201706;1109;3539;979;3312;190;705;438;1440;628;2145
312030;201706;1896;5167;1691;4920;53;234;1513;4346;1566;4580
312040;201706;769;2671;626;2323;124;528;176;619;300;1147
312050;201706;1177;4114;1015;3728;279;1145;196;644;475;1789
312060;201706;743;2266;665;2130;135;472;354;1103;489;1575
312070;201706;1010;3042;676;2319;118;460;282;942;400;1402
312080;201706;2731;7243;2149;6366;244;892;1246;3421;1490;4313
312083;201706;957;2619;800;2383;100;322;574;1688;674;2010
312087;201706;2162;6279;1943;5965;147;477;1494;4670;1641;5147
312090;201706;9015;26737;7403;23993;1889;6489;2843;9105;4732;15594
312100;201706;1484;4668;1150;4110;169;723;523;1795;692;2518
312110;201706;998;3441;860;3143;262;1070;176;570;438;1640
312120;201706;690;2156;565;1921;124;486;197;587;321;1073
312125;201706;1230;3796;1097;3567;236;721;661;2267;897;2988
312130;201706;880;2434;692;2070;88;292;264;738;352;1030
312140;201706;790;2507;675;2238;178;630;203;615;381;1245
312150;201706;462;1357;393;1198;20;81;251;714;271;795
312160;201706;7533;24367;6494;22176;1353;5120;2576;8377;3929;13497
312170;201706;881;2512;729;2259;56;207;476;1430;532;1637
312180;201706;1382;4147;1188;3756;183;663;544;1624;727;2287
312190;201706;599;1894;453;1591;136;523;68;238;204;761
312200;201706;4883;13684;4078;12401;713;2231;2409;7368;3122;9599
312210;201706;1142;2945;862;2542;136;465;524;1461;660;1926
312220;201706;2003;6553;1851;6376;113;283;1585;5699;1698;5982
312230;201706;11562;34799;8813;29457;2825;10356;1099;3493;3924;13849
312235;201706;1599;4638;1406;4369;147;539;1005;3063;1152;3602
312240;201706;888;2962;707;2571;171;688;174;614;345;1302
312245;201706;2349;6578;2082;6228;103;376;1692;5027;1795;5403
312247;201706;815;2329;623;2008;151;504;264;890;415;1394
312250;201706;1147;3103;833;2557;163;575;309;890;472;1465
312260;201706;960;2891;782;2586;98;373;496;1572;594;1945
312270;201706;654;1935;538;1696;40;171;279;806;319;977
312280;201706;421;1377;369;1261;126;451;40;129;166;580
312290;201706;779;2532;707;2412;151;574;234;788;385;1362
312300;201706;897;2886;706;2427;182;683;68;159;250;842
312310;201706;802;2901;748;2778;173;703;334;1222;507;1925
312320;201706;1967;5497;1534;4707;429;1414;324;922;753;2336
312330;201706;1026;2942;837;2672;124;460;578;1800;702;2260
312340;201706;304;816;238;712;41;140;117;328;158;468
312350;201706;284;698;249;660;25;92;200;500;225;592
312352;201706;1594;4903;1426;4660;209;717;963;3265;1172;3982
312360;201706;2974;9363;2438;8222;543;1972;660;2193;1203;4165
312370;201706;1770;5327;1548;4938;382;1360;653;1982;1035;3342
312380;201706;2092;5284;1862;4984;61;167;1592;4350;1653;4517
312385;201706;1322;3757;1125;3442;88;315;793;2362;881;2677
312390;201706;2104;6553;1657;5687;398;1452;381;1229;779;2681
312400;201706;2918;9264;2425;8273;915;3215;563;1978;1478;5193
312410;201706;10309;32615;9156;30464;1862;6691;4164;13604;6026;20295
312420;201706;3885;11691;3629;11285;584;1924;2230;6974;2814;8898
312430;201706;8173;23176;6918;20971;920;2992;4238;12793;5158;15785
312440;201706;836;2613;695;2360;267;999;199;681;466;1680
312450;201706;1217;3924;948;3380;280;1058;321;1189;601;2247
312460;201706;349;1023;300;959;56;199;170;545;226;744
312470;201706;608;1642;399;1255;76;294;115;318;191;612
312480;201706;1182;2992;870;2636;149;529;494;1416;643;1945
312490;201706;1960;5049;1514;4345;255;790;805;2223;1060;3013
312500;201706;736;2067;627;1902;90;321;317;933;407;1254
312510;201706;3805;10918;3070;9414;398;1392;1581;4594;1979;5986
312520;201706;236;728;190;654;65;238;71;244;136;482
312530;201706;591;1698;521;1602;42;162;389;1195;431;1357
312540;201706;1388;4302;1046;3593;217;808;437;1467;654;2275
312550;201706;745;2176;617;1890;93;308;316;905;409;1213
312560;201706;2119;5422;1746;4944;93;344;1412;3954;1505;4298
312570;201706;2289;6567;1899;5940;532;1762;698;2196;1230;3958
312580;201706;537;1708;444;1496;62;237;166;554;228;791
312590;201706;1664;5282;1408;4758;198;839;674;2119;872;2958
312595;201706;1847;6094;1704;5773;315;1092;949;3263;1264;4355
312600;201706;833;2532;610;2140;112;489;281;934;393;1423
312610;201706;6609;18173;4795;14873;1103;3733;976;2830;2079;6563
312620;201706;2241;6311;1730;5584;94;353;1298;4286;1392;4639
312630;201706;314;1005;268;918;65;262;96;320;161;582
312640;201706;531;1654;430;1442;75;253;132;415;207;668
312650;201706;2153;5997;1554;4814;152;546;916;2713;1068;3259
312660;201706;1428;3643;1120;3194;121;395;731;2048;852;2443
312670;201706;5446;15588;4604;14429;829;3047;2359;7140;3188;10187
312675;201706;1295;3940;1090;3521;103;407;781;2483;884;2890
312680;201706;1439;4221;1241;3944;142;564;825;2556;967;3120
312690;201706;2208;5712;1786;5128;218;677;1197;3357;1415;4034
312695;201706;863;2854;807;2766;136;453;534;1883;670;2336
312700;201706;1863;5520;1459;4711;183;628;792;2519;975;3147
312705;201706;1287;3573;1058;3170;56;199;759;2216;815;2415
312707;201706;1482;4670;1168;4047;126;555;638;2088;764;2643
312710;201706;6598;16237;4278;12619;1306;4319;801;2358;2107;6677
312720;201706;780;2566;672;2335;98;400;320;1046;418;1446
312730;201706;1887;4523;1345;3855;115;387;860;2442;975;2829
312733;201706;1566;4192;1195;3514;52;149;744;2156;796;2305
312735;201706;803;2172;699;2012;122;448;433;1129;555;1577
312737;201706;820;2040;594;1707;145;430;249;704;394;1134
312738;201706;513;1555;366;1261;91;363;126;396;217;759
312740;201706;324;802;199;654;66;225;43;126;109;351
312750;201706;1235;4230;1138;4078;192;811;570;1955;762;2766
312760;201706;1944;6073;1483;5136;325;1190;410;1401;735;2591
312770;201706;41904;111635;30637;92455;7556;24521;8512;24956;16068;49477
312780;201706;2712;8983;2404;8456;361;1417;1361;4800;1722;6217
312790;201706;336;854;210;654;27;98;85;239;112;337
312800;201706;5007;15876;3998;13762;1187;4406;891;3084;2078;7490
312810;201706;2030;6105;1415;4862;359;1350;290;905;649;2255
312820;201706;1932;5395;1627;4868;84;306;1103;3196;1187;3502
312825;201706;1324;3452;1164;3244;67;205;927;2587;994;2792
312830;201706;2577;7771;1785;6207;464;1761;304;1022;768;2783
312840;201706;1219;3802;969;3312;154;611;315;956;469;1567
312850;201706;752;2211;592;1913;110;400;220;697;330;1097
312860;201706;1416;3772;946;2975;221;762;275;813;496;1575
312870;201706;5716;17202;3932;13363;651;2393;935;3013;1586;5406
312880;201706;1352;3843;1201;3620;86;283;763;2373;849;2656
312890;201706;1889;5530;1209;4044;218;767;437;1478;655;2245
312900;201706;1210;3473;1036;3223;103;333;686;2186;789;2519
312910;201706;1678;3264;986;2370;151;412;485;1095;636;1507
312920;201706;905;2767;723;2438;155;621;321;1018;476;1639
312930;201706;2136;5954;1800;5437;412;1292;803;2404;1215;3696
312940;201706;888;2798;771;2585;174;620;296;1001;470;1621
312950;201706;2971;8184;2249;7087;790;2694;506;1622;1296;4316
312960;201706;1930;5376;1677;5025;114;326;1301;3973;1415;4299
312965;201706;1801;5562;1532;5050;131;465;957;3134;1088;3599
312970;201706;991;3186;787;2835;193;791;231;796;424;1587
312980;201706;18570;59570;17057;56540;4045;14642;7210;22792;11255;37434
312990;201706;479;1390;330;1126;92;369;109;363;201;732
313000;201706;480;1553;395;1387;84;397;145;439;229;836
313005;201706;2623;8046;2327;7517;295;997;1537;4946;1832;5943
313010;201706;3877;12062;3310;11064;786;2873;1609;5195;2395;8068
313020;201706;948;3127;691;2496;132;535;85;255;217;790
313030;201706;1460;3791;1066;3207;168;588;515;1503;683;2091
313040;201706;791;2573;684;2322;76;305;340;1087;416;1392
313050;201706;1817;5535;1335;4770;320;1301;329;1061;649;2362
313055;201706;1628;4960;1496;4768;58;211;1264;4026;1322;4237
313060;201706;836;2556;647;2144;189;652;99;322;288;974
313065;201706;1914;6073;1640;5637;189;768;1156;3972;1345;4740
313070;201706;991;2847;812;2538;148;516;355;1080;503;1596
313080;201706;439;1302;329;1073;82;321;92;239;174;560
313090;201706;5233;14807;4499;13616;1205;3956;2057;6189;3262;10145
313100;201706;1161;3425;1054;3261;88;297;822;2536;910;2833
313110;201706;1671;4695;1228;3815;174;600;516;1495;690;2095
313115;201706;2386;7757;2221;7410;437;1584;1034;3232;1471;4816
313120;201706;3537;9088;3023;8436;448;1379;1955;5512;2403;6891
313130;201706;25931;76283;22068;68652;4074;14104;9587;28159;13661;42263
313140;201706;515;1316;391;1121;24;88;274;756;298;844
313150;201706;1321;4108;1090;3676;397;1428;257;866;654;2294
313160;201706;968;2842;824;2569;143;520;452;1340;595;1860
313170;201706;10372;34283;7893;28402;1664;6296;2305;8175;3969;14471
313180;201706;2314;6201;1795;5437;339;1129;801;2336;1140;3465
313190;201706;3996;12967;3143;10967;650;2469;846;2762;1496;5231
313200;201706;1151;3583;1008;3313;80;321;741;2362;821;2683
313210;201706;3999;12124;3370;11135;606;2225;1752;5560;2358;7785
313220;201706;1668;4797;1183;3833;244;888;316;890;560;1778
313230;201706;2333;7851;2184;7646;162;634;1742;6064;1904;6698
313240;201706;8577;25216;6537;21428;1262;4630;2511;7780;3773;12410
313250;201706;6392;19934;5436;18213;555;2106;2977;9845;3532;11951
313260;201706;666;1896;454;1443;77;289;149;462;226;751
313270;201706;5378;15749;4477;14163;827;2802;2453;7753;3280;10555
313280;201706;369;1198;270;988;56;219;64;228;120;447
313290;201706;776;2747;647;2521;239;1041;84;293;323;1334
313300;201706;1788;5721;1468;5001;409;1521;202;595;611;2116
313310;201706;977;3268;868;3052;172;689;169;494;341;1183
313320;201706;2335;6513;1684;5481;342;1232;693;2239;1035;3471
313330;201706;4054;11984;3386;10844;286;1225;2128;6537;2414;7762
313340;201706;1671;4091;1299;3540;220;615;743;2040;963;2655
313350;201706;2515;7757;1995;6598;392;1406;522;1607;914;3013
313360;201706;1336;3694;985;3101;201;777;512;1499;713;2276
313370;201706;1193;3975;1113;3773;169;648;577;1872;746;2520
313375;201706;2134;5666;1515;4735;281;1063;467;1375;748;2438
313380;201706;4826;14492;4080;12998;1034;3607;1395;4099;2429;7706
313390;201706;896;3024;834;2917;76;336;550;1879;626;2215
313400;201706;3641;9751;3147;9165;290;822;2550;7535;2840;8357
313410;201706;1213;3368;1011;3052;158;537;669;1973;827;2510
313420;201706;17064;40760;10475;29731;2153;6855;1592;4507;3745;11362
313430;201706;981;3062;736;2553;138;570;257;793;395;1363
313440;201706;6434;14428;4428;12007;321;902;2766;7581;3087;8483
313450;201706;592;1756;467;1497;96;318;147;444;243;762
313460;201706;2096;6933;1818;6451;479;1959;713;2310;1192;4269
313470;201706;3084;8264;2713;7722;347;995;1858;5283;2205;6278
313480;201706;822;2389;631;2041;94;351;212;626;306;977
313490;201706;1594;4366;893;3263;288;1195;74;265;362;1460
313500;201706;422;1387;338;1168;56;216;114;373;170;589
313505;201706;9115;25962;8405;25146;342;1009;7554;22751;7896;23760
313507;201706;1387;3721;1192;3442;103;344;816;2355;919;2699
313510;201706;14545;41898;12738;38827;1659;5551;6795;20298;8454;25849
313520;201706;14200;42861;11813;38641;1202;4543;7581;24491;8783;29034
313530;201706;566;1699;471;1531;47;192;170;507;217;699
313535;201706;2536;7266;2266;6789;184;569;1561;4636;1745;5205
313540;201706;962;2991;712;2337;182;638;198;621;380;1259
313545;201706;1257;4449;1115;4177;180;754;619;2198;799;2952
313550;201706;1847;5779;1618;5335;375;1307;790;2538;1165;3845
313560;201706;2244;5020;1819;4544;143;337;1426;3604;1569;3941
313570;201706;871;2956;752;2725;201;807;298;1046;499;1853
313580;201706;5661;15928;4440;14102;751;2573;2307;7504;3058;10077
313590;201706;945;2752;746;2462;319;1148;164;529;483;1677
313600;201706;3740;10984;3275;10231;286;1018;2425;7564;2711;8582
313610;201706;966;2745;819;2473;158;485;492;1489;650;1974
313620;201706;5351;16022;4637;14734;1131;3822;1844;5828;2975;9650
313630;201706;8197;22019;6095;19038;927;3184;2945;9617;3872;12801
313640;201706;930;2435;652;2022;185;638;216;623;401;1261
313650;201706;1814;5896;1617;5554;184;757;1042;3536;1226;4293
313652;201706;908;3080;833;2946;123;521;493;1644;616;2165
313655;201706;944;2929;791;2690;96;374;467;1582;563;1956
313657;201706;1347;3851;1076;3433;85;360;766;2286;851;2646
313660;201706;819;2599;701;2363;135;549;339;1063;474;1612
313665;201706;3907;12236;3333;11042;576;2095;1721;5551;2297;7646
313670;201706;45284;128864;33001;105216;7227;25263;10492;32158;17719;57421
313680;201706;1050;3036;928;2836;108;397;573;1712;681;2109
313690;201706;901;3129;756;2816;162;614;237;900;399;1514
313695;201706;1435;4472;1216;4066;111;441;828;2769;939;3210
313700;201706;3510;11704;3038;11114;378;1432;2268;8450;2646;9882
313710;201706;1337;3535;1010;3014;144;476;554;1639;698;2115
313720;201706;5589;17056;4340;14460;813;3019;1485;4553;2298;7572
313730;201706;1301;3313;979;2888;87;281;580;1698;667;1979
313740;201706;1839;6650;1555;5923;430;1756;107;397;537;2153
313750;201706;2120;6234;1686;5378;435;1525;492;1420;927;2945
313753;201706;2010;5334;1527;4511;224;746;771;2231;995;2977
313760;201706;4327;13522;3541;11943;945;3462;1104;3516;2049;6978
313770;201706;3435;10549;2929;9837;429;1533;1784;6019;2213;7552
313780;201706;4093;11184;3124;9635;484;1696;961;2963;1445;4659
313790;201706;459;1531;432;1482;69;244;253;857;322;1101
313800;201706;1224;3175;1058;2922;84;274;776;2175;860;2449
313810;201706;1585;4383;1363;4071;136;442;964;2895;1100;3337
313820;201706;13003;33823;10220;29241;1685;5675;4198;11196;5883;16871
313830;201706;374;1197;331;1121;76;285;147;495;223;780
313835;201706;877;2837;783;2670;88;363;438;1426;526;1789
313840;201706;7303;20621;5716;17940;1411;4840;1232;3837;2643;8677
313850;201706;1089;2920;950;2674;155;540;504;1282;659;1822
313860;201706;2807;8264;2111;6759;428;1459;616;1847;1044;3306
313862;201706;1263;3199;876;2555;109;318;453;1351;562;1669
313865;201706;2302;6819;2058;6452;145;535;1553;4812;1698;5347
313867;201706;1122;3786;980;3490;319;1157;333;1211;652;2368
313868;201706;1729;5734;1478;5231;111;480;1064;3712;1175;4192
313870;201706;812;2455;687;2228;164;592;210;601;374;1193
313880;201706;1311;3993;1102;3622;260;949;388;1118;648;2067
313890;201706;1990;5009;1523;4396;216;658;870;2633;1086;3291
313900;201706;3859;13480;3427;12530;1054;4230;849;3093;1903;7323
313910;201706;698;2291;575;2050;175;665;83;305;258;970
313920;201706;3260;10623;2792;9760;550;1954;1459;5294;2009;7248
313925;201706;1805;4848;1397;4073;221;611;802;2370;1023;2981
313930;201706;6340;22249;5338;20500;625;2278;3392;13910;4017;16188
313940;201706;8774;27870;6881;24711;1759;7059;1844;7137;3603;14196
313950;201706;4117;11132;3118;9548;875;3129;1225;3501;2100;6630
313960;201706;5564;14174;3931;11696;959;3174;1141;3251;2100;6425
313970;201706;1430;4176;1267;3941;124;449;727;2333;851;2782
313980;201706;1258;3854;950;3296;194;766;343;1142;537;1908
313990;201706;1640;6066;1434;5534;479;1983;341;1227;820;3210
314000;201706;8596;25990;7652;24117;938;3602;4652;14157;5590;17759
314010;201706;1212;3226;997;2934;73;271;720;2072;793;2343
314015;201706;1670;5203;1379;4698;239;946;709;2344;948;3290
314020;201706;512;1506;330;1099;58;233;70;224;128;457
314030;201706;818;2609;643;2193;98;360;264;889;362;1249
314040;201706;744;2114;621;1880;136;440;251;740;387;1180
314050;201706;1645;4950;1292;4243;242;926;536;1601;778;2527
314053;201706;1621;5037;1427;4770;174;580;993;3517;1167;4097
314055;201706;2225;6427;1944;6013;77;317;1583;4891;1660;5208
314060;201706;1177;3541;937;3125;77;308;594;1942;671;2250
314070;201706;4237;12925;3419;11350;869;3062;1019;3226;1888;6288
314080;201706;1775;5466;1287;4361;214;813;317;931;531;1744
314085;201706;2011;6517;1739;6120;449;1728;680;2390;1129;4118
314090;201706;3377;11090;2949;10287;413;1687;1579;5595;1992;7282
314100;201706;3346;8173;2933;7616;142;295;2469;6672;2611;6967
314110;201706;3978;12425;3482;11402;653;2372;1536;4673;2189;7045
314120;201706;1025;2423;485;1536;95;336;111;351;206;687
314130;201706;707;2029;368;1268;61;239;71;235;132;474
314140;201706;4866;14772;3926;12863;708;2490;1735;5612;2443;8102
314150;201706;1507;4135;1200;3610;150;497;675;1993;825;2490
314160;201706;2545;6636;1934;5672;284;908;942;2831;1226;3739
314170;201706;1074;3126;887;2748;120;403;486;1429;606;1832
314180;201706;5135;15708;4509;14727;1099;3780;2062;6796;3161;10576
314190;201706;691;1887;507;1585;115;437;184;503;299;940
314200;201706;2923;8802;2573;8180;233;936;1795;5495;2028;6431
314210;201706;2037;5723;1794;5323;160;562;1102;3182;1262;3744
314220;201706;1467;4469;1090;3733;348;1309;225;680;573;1989
314225;201706;1322;3756;1185;3575;75;263;874;2654;949;2917
314230;201706;685;2140;631;2048;93;366;352;1116;445;1482
314240;201706;1125;3348;925;3028;208;734;416;1408;624;2142
314250;201706;537;1592;392;1267;84;291;115;328;199;619
314260;201706;1037;3594;881;3234;182;786;277;923;459;1709
314270;201706;2956;9115;2441;8198;197;774;1708;5657;1905;6431
314280;201706;3109;8262;2112;6406;432;1513;792;2215;1224;3728
314290;201706;4728;12830;4050;11731;659;1962;2381;6847;3040;8809
314300;201706;1506;4888;1253;4297;348;1258;339;1122;687;2380
314310;201706;5640;15894;4557;14034;1297;4301;1355;3932;2652;8233
314315;201706;810;3114;737;2968;77;367;525;2096;602;2463
314320;201706;3041;8524;2158;7159;544;1922;861;2930;1405;4852
314330;201706;53912;159052;44876;144009;13265;45536;11649;36973;24914;82509
314340;201706;2840;7599;1612;5248;310;1146;146;355;456;1501
314345;201706;1247;4103;1122;3879;176;643;716;2437;892;3080
314350;201706;1174;3351;875;2829;233;809;184;567;417;1376
314360;201706;685;2151;437;1564;86;353;93;326;179;679
314370;201706;581;1781;525;1702;84;322;371;1159;455;1481
314380;201706;1287;3834;903;3038;251;919;127;431;378;1350
314390;201706;12865;36056;9265;29483;2199;7545;2134;6273;4333;13818
314400;201706;4438;12954;3696;11859;1122;3779;1291;4303;2413;8082
314410;201706;2752;8159;2075;6866;438;1615;647;2267;1085;3882
314420;201706;760;2045;584;1783;26;140;432;1267;458;1407
314430;201706;6223;18056;5255;16281;1266;4197;1778;5519;3044;9716
314435;201706;1432;4333;1267;4074;82;377;892;2797;974;3174
314437;201706;1014;2682;829;2398;26;87;605;1771;631;1858
314440;201706;552;1667;458;1521;143;533;136;399;279;932
314450;201706;1525;4417;1290;4037;204;796;671;1916;875;2712
314460;201706;3827;12558;2995;10727;691;2703;508;1735;1199;4438
314465;201706;2278;6935;2088;6596;87;420;1646;5053;1733;5473
314467;201706;974;2731;831;2495;46;134;609;1860;655;1994
314470;201706;2134;6610;1842;6016;415;1514;686;2074;1101;3588
314480;201706;5793;18901;4214;14908;746;2871;630;2012;1376;4883
314490;201706;838;2476;648;2085;98;358;350;1055;448;1413
314500;201706;1837;5144;1354;4271;261;895;427;1311;688;2206
314505;201706;1906;5207;1705;4950;169;542;1184;3474;1353;4016
314510;201706;1950;5169;1309;4284;314;1113;407;1362;721;2475
314520;201706;2968;10261;2162;8325;430;1908;212;730;642;2638
314530;201706;5783;19783;5416;19105;825;2930;3417;12307;4242;15237
314535;201706;2754;7450;2291;6795;194;644;1652;4887;1846;5531
314537;201706;1134;3435;924;3061;114;450;576;1851;690;2301
314540;201706;358;1059;285;911;55;195;104;309;159;504
314545;201706;1557;4410;1383;4173;87;271;1075;3413;1162;3684
314550;201706;649;1688;468;1427;61;235;205;562;266;797
314560;201706;4288;14339;3565;12672;640;2576;1129;3704;1769;6280
314570;201706;311;916;242;780;35;132;123;381;158;513
314580;201706;505;1660;392;1409;90;356;47;171;137;527
314585;201706;864;2740;629;2223;136;567;200;667;336;1234
314587;201706;1990;5915;1654;5337;309;970;848;2782;1157;3752
314590;201706;2975;9909;2266;8131;455;1805;542;1879;997;3684
314600;201706;1639;5171;1122;4075;252;1023;135;411;387;1434
314610;201706;7051;23172;6206;21276;1326;5167;2566;8239;3892;13406
314620;201706;1636;4692;1453;4433;94;314;1144;3446;1238;3760
314625;201706;1581;4988;1426;4743;160;755;1014;3169;1174;3924
314630;201706;4821;13967;4196;12971;250;1032;3171;9693;3421;10725
314640;201706;604;1617;456;1356;111;362;149;390;260;752
314650;201706;1054;2877;762;2404;100;384;296;819;396;1203
314655;201706;1543;4509;1139;3717;231;735;461;1530;692;2265
314660;201706;305;800;209;613;16;44;103;292;119;336
314670;201706;1650;4315;1166;3470;133;443;688;1978;821;2421
314675;201706;1856;5341;1609;4911;138;504;1168;3502;1306;4006
314690;201706;2106;6722;1727;5998;515;1952;299;1006;814;2958
314700;201706;9358;30250;6581;24091;1735;6987;1002;3620;2737;10607
314710;201706;8470;25082;6018;19867;1133;4189;929;2766;2062;6955
314720;201706;2346;7617;1864;6547;427;1651;466;1629;893;3280
314730;201706;2149;6347;1715;5610;449;1597;541;1627;990;3224
314740;201706;2799;8662;2371;7824;322;1287;1213;3788;1535;5075
314750;201706;335;1017;268;874;30;115;143;440;173;555
314760;201706;1743;5623;1291;4547;188;754;283;820;471;1574
314770;201706;1036;3187;616;2085;51;193;131;372;182;565
314780;201706;320;829;234;704;49;181;111;312;160;493
314790;201706;9712;29257;7560;25223;2926;10826;617;1750;3543;12576
314795;201706;1594;4536;1386;4201;89;367;1024;2965;1113;3332
314800;201706;11518;32256;7587;24354;1865;6478;857;2554;2722;9032
314810;201706;10556;30126;8049;25760;2385;8156;1703;5511;4088;13667
314820;201706;912;2509;675;2099;144;505;289;863;433;1368
314830;201706;1564;5087;1383;4768;317;1229;674;2318;991;3547
314840;201706;913;3157;749;2913;125;617;451;1663;576;2280
314850;201706;1957;5428;1549;4713;161;615;1098;3233;1259;3848
314860;201706;3294;10627;2872;9827;431;1713;1695;5677;2126;7390
314870;201706;5590;16644;4796;15552;434;1711;3531;11376;3965;13087
314875;201706;1758;5585;1657;5450;134;416;1383;4614;1517;5030
314880;201706;906;2325;736;2107;56;135;506;1532;562;1667
314890;201706;550;1683;409;1350;77;292;149;439;226;731
314900;201706;636;1733;513;1552;98;323;213;658;311;981
314910;201706;1674;5299;1350;4771;354;1428;537;1834;891;3262
314915;201706;2464;7632;2124;7027;165;695;1438;4577;1603;5272
314920;201706;532;1450;384;1233;31;110;203;622;234;732
314930;201706;4751;15671;4108;14284;1021;3807;1212;3985;2233;7792
314940;201706;404;1157;364;1089;48;147;220;628;268;775
314950;201706;363;1044;257;878;48;181;82;277;130;458
314960;201706;762;2260;596;1918;110;402;247;728;357;1130
314970;201706;620;2077;534;1910;118;477;174;605;292;1082
314980;201706;1412;4249;1157;3831;338;1241;78;238;416;1479
314990;201706;2524;7805;1901;6427;486;1874;383;1122;869;2996
314995;201706;1621;4897;1401;4546;143;583;870;2736;1013;3319
315000;201706;1087;3025;869;2670;87;317;545;1638;632;1955
315010;201706;425;1295;333;1106;64;270;119;344;183;614
315015;201706;2157;6453;1956;6208;244;807;1331;4426;1575;5233
315020;201706;846;2559;626;2102;87;324;272;872;359;1196
315030;201706;611;1830;469;1558;129;467;100;299;229;766
315040;201706;907;2700;838;2569;153;500;497;1503;650;2003
315050;201706;1289;3645;1014;3223;148;547;498;1554;646;2101
315053;201706;1113;3238;948;2911;137;535;481;1455;618;1990
315057;201706;1649;5520;1479;5191;260;926;791;2788;1051;3714
315060;201706;706;2249;489;1778;109;427;69;248;178;675
315070;201706;734;2146;580;1866;169;576;210;621;379;1197
315080;201706;2886;9224;2419;8216;562;2031;1051;3518;1613;5549
315090;201706;779;2650;629;2309;138;550;157;540;295;1090
315100;201706;1194;3932;844;3083;187;774;227;763;414;1537
315110;201706;1340;3870;1089;3438;209;732;445;1393;654;2125
315120;201706;13845;32178;9598;26638;1304;3746;4561;13469;5865;17215
315130;201706;1305;4194;1173;3933;274;1077;397;1229;671;2306
315140;201706;2857;8735;2327;7670;478;1791;938;2827;1416;4618
315150;201706;4520;11951;3314;9964;522;1730;1336;3981;1858;5711
315160;201706;1373;3917;1052;3349;231;777;422;1308;653;2085
315170;201706;1513;4698;1172;3975;255;930;236;767;491;1697
315180;201706;17381;47837;9835;32004;1685;6171;1703;5018;3388;11189
315190;201706;2000;5089;1664;4577;369;1031;1028;2808;1397;3839
315200;201706;3702;12183;3066;10837;955;3691;590;2042;1545;5733
315210;201706;7996;22914;6313;19397;1017;3466;2383;6819;3400;10285
315213;201706;1136;3360;1026;3192;48;162;824;2544;872;2706
315217;201706;2458;8188;1996;7329;182;851;1246;4469;1428;5320
315220;201706;9526;27088;7960;24381;2458;7798;2400;7537;4858;15335
315230;201706;2976;7666;2644;7281;117;178;2344;6806;2461;6984
315240;201706;3015;9073;2551;8352;653;2290;1213;3898;1866;6188
315250;201706;10547;31311;8258;26984;1789;6432;2798;9017;4587;15449
315260;201706;956;2952;626;2198;139;520;77;235;216;755
315270;201706;674;2154;513;1835;99;420;128;422;227;842
315280;201706;2957;8255;1831;5849;398;1347;279;843;677;2190
315290;201706;1247;3401;843;2733;266;938;194;652;460;1590
315300;201706;552;1464;388;1258;159;536;148;490;307;1026
315310;201706;1266;3907;1008;3410;114;430;589;1917;703;2347
315320;201706;753;2214;592;1974;90;394;268;847;358;1241
315330;201706;736;2634;456;1868;103;455;88;341;191;796
315340;201706;3521;9725;2770;8581;462;1554;1252;3809;1714;5363
315350;201706;1855;5016;1415;4373;111;379;932;2954;1043;3333
315360;201706;1643;5385;1309;4635;259;997;422;1398;681;2395
315370;201706;473;1451;409;1322;81;268;177;566;258;834
315380;201706;194;634;149;524;32;136;34;99;66;235
315390;201706;1229;3970;938;3321;214;839;211;698;425;1537
315400;201706;4322;12713;3485;11124;550;1887;1714;5366;2264;7253
315410;201706;2197;5454;1799;4930;374;1109;919;2491;1293;3600
315415;201706;1070;3338;913;3104;347;1270;270;947;617;2217
315420;201706;1180;3736;894;3144;208;761;128;412;336;1173
315430;201706;3623;9649;2725;8186;773;2598;702;1997;1475;4595
315440;201706;988;2906;854;2679;151;580;398;1116;549;1696
315445;201706;2053;5522;1586;4795;220;721;994;3000;1214;3721
315450;201706;2421;7339;2138;6890;314;1001;1317;4345;1631;5346
315460;201706;31472;101065;28218;94479;9944;35306;5883;19098;15827;54404
315470;201706;482;1431;400;1279;31;120;210;652;241;772
315480;201706;1667;5027;1153;3876;263;953;219;746;482;1699
315490;201706;3136;8149;2295;6989;405;1395;729;2068;1134;3463
315500;201706;483;1393;309;997;34;131;129;352;163;483
315510;201706;1383;3886;1185;3566;77;277;930;2761;1007;3038
315520;201706;1075;3117;862;2781;74;283;555;1729;629;2012
315530;201706;646;2112;507;1756;170;655;157;483;327;1138
315540;201706;1069;3277;877;2918;153;601;297;968;450;1569
315550;201706;1859;5178;1421;4502;305;1103;474;1464;779;2567
315560;201706;6460;21029;5810;20091;590;2336;3823;13235;4413;15571
315570;201706;1862;5894;1702;5569;216;822;879;2774;1095;3596
315580;201706;2306;6430;1841;5651;460;1593;546;1610;1006;3203
315590;201706;855;2458;741;2277;104;352;378;1143;482;1495
315600;201706;2409;8396;1922;7393;285;1147;1049;4169;1334;5316
315610;201706;974;2690;782;2316;132;508;330;830;462;1338
315620;201706;312;1092;295;1058;69;239;166;638;235;877
315630;201706;860;2652;689;2305;171;574;146;475;317;1049
315640;201706;446;1296;378;1182;60;240;165;474;225;714
315645;201706;815;2380;652;2062;218;730;185;557;403;1287
315650;201706;1850;4955;1455;4381;92;350;1049;3105;1141;3455
315660;201706;2561;6489;2047;5659;159;408;1389;3810;1548;4218
315670;201706;11054;35119;9774;32601;2384;8635;3953;12770;6337;21405
315680;201706;2991;9710;2314;8357;644;2476;707;2544;1351;5020
315690;201706;3283;9088;2237;7217;545;1919;449;1548;994;3467
315700;201706;7383;22267;6142;19794;1062;3702;2828;8809;3890;12511
315710;201706;1858;5065;1408;4363;104;436;844;2475;948;2911
315720;201706;3861;11974;3440;11200;254;1122;2188;6843;2442;7965
315725;201706;1560;4760;1389;4512;205;686;1020;3374;1225;4060
315727;201706;617;1804;477;1535;96;355;189;553;285;908
315730;201706;737;2293;681;2165;95;357;346;1038;441;1395
315733;201706;1069;3097;939;2866;244;837;350;1019;594;1856
315737;201706;1219;3625;962;3158;61;256;627;2037;688;2293
315740;201706;998;2998;828;2654;138;540;400;1155;538;1695
315750;201706;1192;3489;1054;3249;63;235;783;2410;846;2645
315760;201706;1107;2831;1057;2766;26;66;975;2547;1001;2613
315765;201706;1684;4871;1467;4595;63;212;1256;3993;1319;4205
315770;201706;1426;4507;1232;4181;352;1298;341;1164;693;2462
315780;201706;22621;71762;20348;66956;3884;14072;8679;27484;12563;41556
315790;201706;3697;11982;3208;11032;294;1021;2111;7459;2405;8480
315800;201706;1270;4900;983;4048;211;950;179;690;390;1640
315810;201706;1345;3510;1158;3228;126;396;825;2217;951;2613
315820;201706;2412;7868;2096;7310;457;1661;1118;3920;1575;5581
315830;201706;1173;3736;956;3311;96;408;376;1212;472;1620
315840;201706;771;2014;496;1486;79;239;148;433;227;672
315850;201706;978;3328;920;3236;219;864;523;1733;742;2597
315860;201706;530;1717;378;1411;86;372;96;320;182;692
315870;201706;453;1309;376;1185;36;124;231;696;267;820
315880;201706;1198;3065;942;2723;149;516;396;1122;545;1638
315890;201706;1524;5074;1350;4741;471;1767;510;1744;981;3511
315895;201706;5655;17118;4727;15144;809;2849;1873;5643;2682;8492
315900;201706;791;2223;750;2155;58;229;607;1652;665;1881
315910;201706;485;1608;451;1553;92;339;293;989;385;1328
315920;201706;1642;4448;915;2932;204;708;166;457;370;1165
315930;201706;1066;2771;780;2282;191;571;242;707;433;1278
315935;201706;891;2908;791;2710;192;744;216;725;408;1469
315940;201706;611;1930;528;1769;96;358;248;823;344;1181
315950;201706;1207;3563;1055;3290;207;630;662;2105;869;2735
315960;201706;3780;11634;2518;9143;827;3499;105;232;932;3731
315970;201706;696;1984;546;1775;56;166;377;1270;433;1436
315980;201706;3867;9436;2478;7141;605;1927;657;1675;1262;3602
315990;201706;4000;11003;3206;9650;469;1608;1622;4786;2091;6394
316000;201706;586;1690;482;1543;119;458;176;543;295;1001
316010;201706;655;2065;525;1816;54;234;263;834;317;1068
316020;201706;987;3122;871;2915;90;400;582;1840;672;2240
316030;201706;3159;9085;2321;7564;187;706;1404;4648;1591;5354
316040;201706;3092;9668;2339;8120;407;1595;433;1284;840;2879
316045;201706;2029;6130;1881;5886;200;616;1371;4365;1571;4981
316050;201706;360;1123;284;989;45;189;148;493;193;682
316060;201706;719;2069;570;1833;73;326;331;983;404;1309
316070;201706;6244;18909;5322;16933;1075;3822;2191;6628;3266;10450
316080;201706;744;2610;647;2375;166;663;68;244;234;907
316090;201706;526;1614;384;1316;64;261;122;386;186;647
316095;201706;1454;4521;1238;4140;173;608;714;2378;887;2986
316100;201706;2654;8509;1989;6967;447;1744;496;1587;943;3331
316105;201706;938;2625;708;2237;153;507;306;978;459;1485
316110;201706;12128;39531;10821;37323;1516;5478;6874;24226;8390;29704
316120;201706;1122;3538;867;2936;201;726;216;637;417;1363
316130;201706;1525;3486;908;2567;136;450;359;955;495;1405
316140;201706;989;2735;747;2390;95;312;452;1478;547;1790
316150;201706;1558;4102;1340;3737;203;628;709;1896;912;2524
316160;201706;1179;3398;926;2933;132;458;482;1449;614;1907
316165;201706;952;2434;778;2195;141;460;429;1206;570;1666
316170;201706;1282;3581;940;3007;144;503;413;1253;557;1756
316180;201706;1474;4511;1022;3539;233;897;160;469;393;1366
316190;201706;2873;8669;1575;5399;293;979;353;1084;646;2063
316200;201706;3748;11760;2873;10028;622;2556;718;2378;1340;4934
316210;201706;4779;14873;3825;12938;1296;4685;463;1519;1759;6204
316220;201706;787;2421;556;1942;114;452;53;194;167;646
316225;201706;1260;3313;1028;2933;123;409;655;1787;778;2196
316230;201706;440;1240;359;1106;49;161;159;527;208;688
316240;201706;6549;19543;5761;18468;678;2229;4143;13366;4821;15595
316245;201706;3258;11102;2976;10660;253;1279;2236;7787;2489;9066
316250;201706;10464;29561;8031;24870;2175;7392;1706;4977;3881;12369
316255;201706;2610;7649;2283;7224;292;1036;1564;5002;1856;6038
316257;201706;1306;3477;977;2897;147;485;392;1115;539;1600
316260;201706;1891;5120;1464;4489;86;321;783;2512;869;2833
316265;201706;1351;3732;991;3043;77;265;619;1877;696;2142
316270;201706;3593;11947;3298;11284;792;2928;1288;4215;2080;7143
316280;201706;3160;10016;2878;9451;454;1686;1509;4764;1963;6450
316290;201706;3381;10257;2803;9135;528;1952;995;3221;1523;5173
316292;201706;3764;11328;3280;10536;424;1583;2180;6774;2604;8357
316294;201706;822;2572;615;2166;126;504;74;272;200;776
316295;201706;1906;6075;1776;5831;162;678;1283;4094;1445;4772
316300;201706;1011;3176;853;2881;66;244;515;1780;581;2024
316310;201706;711;2025;488;1626;92;345;161;521;253;866
316320;201706;615;1903;503;1691;91;360;141;442;232;802
316330;201706;1020;3029;789;2517;79;281;510;1578;589;1859
316340;201706;994;3045;777;2609;123;511;385;1212;508;1723
316350;201706;1277;4004;1149;3785;153;545;703;2302;856;2847
316360;201706;732;1925;582;1699;58;181;399;1152;457;1333
316370;201706;4628;14308;3864;12809;1098;4099;712;2139;1810;6238
316380;201706;1635;4201;1290;3735;64;216;942;2731;1006;2947
316390;201706;873;2439;722;2202;148;492;324;999;472;1491
316400;201706;1314;3979;985;3371;175;637;376;1249;551;1886
316410;201706;1020;3293;932;3163;112;392;692;2339;804;2731
316420;201706;1937;5977;1703;5666;149;600;1230;4004;1379;4604
316430;201706;949;2868;662;2251;157;588;153;485;310;1073
316440;201706;685;2189;561;2002;184;759;101;372;285;1131
316443;201706;642;1880;507;1627;122;440;160;484;282;924
316447;201706;1684;4841;1506;4596;93;332;1233;3758;1326;4090
316450;201706;2168;7075;1814;6368;197;769;1206;4170;1403;4939
316460;201706;839;2510;763;2371;252;806;329;991;581;1797
316470;201706;7408;22944;5889;19888;1387;5345;1563;4954;2950;10299
316480;201706;183;604;156;542;42;155;44;143;86;298
316490;201706;343;1001;262;833;48;149;96;281;144;430
316500;201706;1211;4141;811;3010;152;623;65;215;217;838
316510;201706;744;2701;665;2553;207;866;191;715;398;1581
316520;201706;1046;3058;862;2746;152;559;348;1002;500;1561
316530;201706;844;2680;702;2417;136;586;288;874;424;1460
316540;201706;749;2369;664;2212;101;407;207;634;308;1041
316550;201706;1216;3964;1139;3826;181;653;706;2385;887;3038
316553;201706;2386;7962;1781;6427;527;2048;302;1031;829;3079
316555;201706;2841;9405;2504;8965;180;729;1856;6757;2036;7486
316556;201706;646;1604;483;1338;50;156;274;686;324;842
316557;201706;806;2856;745;2750;337;1306;209;728;546;2034
316560;201706;286;1027;245;942;71;324;56;194;127;518
316570;201706;1209;3857;1067;3567;284;987;346;1181;630;2168
316580;201706;339;887;221;661;57;183;64;186;121;369
316590;201706;1464;3931;1042;3204;184;648;546;1546;730;2194
316600;201706;1048;3370;938;3160;194;713;429;1435;623;2148
316610;201706;591;2072;509;1907;77;391;307;1077;384;1468
316620;201706;2245;6566;1909;6026;161;617;1291;4035;1452;4652
316630;201706;1529;4817;1232;4217;407;1385;407;1545;814;2930
316640;201706;168;519;145;475;33;137;62;166;95;303
316650;201706;956;3270;800;3038;80;325;536;2089;616;2414
316660;201706;192;493;93;287;7;30;16;39;23;69
316670;201706;1961;5310;1560;4624;503;1598;489;1409;992;3007
316680;201706;2074;5433;1634;4800;165;547;1152;3304;1317;3851
316690;201706;1181;3916;1041;3621;274;1095;314;1056;588;2151
316695;201706;1072;3285;937;3031;85;333;609;1933;694;2266
316700;201706;391;1100;339;1024;27;119;219;606;246;725
316710;201706;2739;10000;2329;9090;799;3243;655;2767;1454;6010
316720;201706;16755;52948;13848;46669;3293;11835;4261;13982;7554;25817
316730;201706;352;1079;310;984;87;304;109;321;196;625
316740;201706;704;2242;642;2137;78;340;425;1401;503;1741
316750;201706;413;1367;339;1211;59;244;116;393;175;637
316760;201706;3609;11644;3052;10839;1385;5192;989;3571;2374;8763
316770;201706;1418;3793;1228;3527;53;197;1030;2963;1083;3160
316780;201706;596;1947;505;1756;158;602;50;137;208;739
316790;201706;763;2186;605;1915;165;568;174;543;339;1111
316800;201706;5258;16674;4510;15193;792;2936;2345;7497;3137;10433
316805;201706;824;2024;795;1984;31;54;694;1828;725;1882
316810;201706;661;1958;513;1650;138;509;195;558;333;1067
316820;201706;398;1013;217;688;36;130;29;99;65;229
316830;201706;577;1921;537;1838;120;474;280;920;400;1394
316840;201706;2766;8289;2437;7694;497;1727;1108;3374;1605;5101
316850;201706;2123;5931;1715;5266;234;833;973;2910;1207;3743
316860;201706;17945;55219;15291;50379;3301;12353;5975;18982;9276;31335
316870;201706;6408;20119;5163;17363;1396;5040;1143;3702;2539;8742
316880;201706;884;2596;762;2386;192;689;265;800;457;1489
316890;201706;1306;2996;907;2465;196;650;512;1264;708;1914
316900;201706;2565;7394;2011;6266;474;1666;584;1583;1058;3249
316905;201706;464;1491;395;1339;116;415;148;499;264;914
316910;201706;959;2837;657;2250;153;602;87;273;240;875
316920;201706;1624;4300;1146;3611;243;856;444;1386;687;2242
316930;201706;7878;26127;6214;22617;1433;5667;1072;3749;2505;9416
316935;201706;4471;13391;3260;10826;804;2853;738;2425;1542;5278
316940;201706;6786;21489;5378;18446;1177;4368;1326;4271;2503;8639
316950;201706;1659;4318;1360;3910;108;356;987;2793;1095;3149
316960;201706;4975;12333;3838;10723;643;1947;2172;5997;2815;7944
316970;201706;3236;10093;3030;9711;635;2314;1272;3783;1907;6097
316980;201706;921;2741;648;2221;197;737;89;310;286;1047
316990;201706;9976;30620;8034;26352;2333;8224;730;2272;3063;10496
317000;201706;2806;9257;2699;9134;220;686;2107;7843;2327;8529
317005;201706;2673;8070;2312;7458;489;1646;1143;3701;1632;5347
317010;201706;27352;67283;16733;50915;4147;14187;3167;10325;7314;24512
317020;201706;66264;176254;39526;123308;7778;26547;7441;21278;15219;47825
317030;201706;712;2060;604;1892;45;183;395;1213;440;1396
317040;201706;10373;29217;8102;25218;2024;6709;2964;9281;4988;15990
317043;201706;765;1987;630;1797;124;364;340;959;464;1323
317047;201706;1156;2999;872;2540;67;220;552;1594;619;1814
317050;201706;1470;4868;1117;4024;207;805;347;1133;554;1938
317052;201706;2272;7253;2104;6972;185;737;1518;4899;1703;5636
317057;201706;1626;4412;1235;3727;92;352;801;2311;893;2663
317060;201706;428;1186;258;819;52;192;66;183;118;375
317065;201706;1300;3793;1134;3519;61;275;863;2579;924;2854
317070;201706;9119;27909;6331;21737;1418;5473;808;2660;2226;8133
317075;201706;1087;3248;847;2741;185;620;180;545;365;1165
317080;201706;6269;16410;5143;14528;1642;4841;1402;3759;3044;8600
317090;201706;4784;15275;4417;14718;443;1553;3151;10585;3594;12138
317100;201706;3005;7948;2171;6553;705;2254;625;1855;1330;4109
317103;201706;1836;6242;1622;5833;205;956;919;3130;1124;4086
317107;201706;1397;4124;1191;3726;105;415;755;2175;860;2590
317110;201706;747;1802;417;1258;73;274;140;430;213;704
317115;201706;1166;3516;985;3134;86;279;673;2146;759;2425
317120;201706;11021;35502;8976;30960;1846;7028;3810;12684;5656;19712
317130;201706;7535;21471;6005;18714;1341;4605;2100;6438;3441;11043
317140;201706;576;1797;519;1700;75;262;311;1005;386;1267
317150;201706;1016;2681;862;2494;59;184;675;1940;734;2124
317160;201706;3557;9103;2615;7806;248;793;1725;5140;1973;5933
317170;201706;1985;5253;1480;4398;219;739;517;1347;736;2086
317180;201706;1785;5910;1446;5182;361;1356;321;1106;682;2462
317190;201706;1377;3825;1061;3351;66;230;689;2154;755;2384
317200;201706;4620;13896;3799;12277;944;3355;978;2970;1922;6325
317210;201706;953;2764;821;2584;104;419;543;1676;647;2095
317220;201706;287;981;266;935;72;286;123;416;195;702
320010;201706;4905;15118;4163;13667;651;2279;2280;7341;2931;9620
320013;201706;1914;5745;1327;4452;233;802;527;1813;760;2615
320016;201706;3040;8338;2579;7679;215;604;1941;5812;2156;6416
320020;201706;3794;11582;3105;10237;857;2987;935;3143;1792;6130
320030;201706;1731;5379;1281;4417;369;1346;374;1236;743;2582
320035;201706;1793;5232;1537;4817;509;1764;595;1755;1104;3519
320040;201706;3222;10186;2705;9186;562;2048;1059;3548;1621;5596
320050;201706;1699;4475;1477;4089;371;1041;680;1865;1051;2906
320060;201706;11352;35292;8558;29082;2110;7785;1757;5698;3867;13483
320070;201706;1484;4583;1175;3925;256;938;325;1044;581;1982
320080;201706;5637;15905;4287;13224;920;2930;1411;4433;2331;7363
320090;201706;7829;22404;6204;19139;1586;5147;2269;6814;3855;11961
320100;201706;2581;8009;2094;7016;624;2137;629;2122;1253;4259
320110;201706;1242;3624;1055;3274;269;850;262;834;531;1684
320115;201706;1862;6444;1662;6073;813;3054;439;1680;1252;4734
320120;201706;15702;46268;12097;39401;2979;10698;3250;10456;6229;21154
320130;201706;36299;114117;32598;106972;6317;23286;15701;49976;22018;73262
320140;201706;3380;10491;2442;8425;633;2425;472;1610;1105;4035
320150;201706;14330;40296;10875;33478;3223;10644;1222;3444;4445;14088
320160;201706;5043;15463;4227;13840;1002;3594;1636;5191;2638;8785
320170;201706;1628;5150;1348;4526;305;1082;565;1864;870;2946
320180;201706;743;2514;635;2309;224;840;153;584;377;1424
320190;201706;3464;11779;2727;9973;706;2697;445;1580;1151;4277
320200;201706;995;2996;794;2642;250;915;200;689;450;1604
320210;201706;4600;12778;3834;11303;734;2406;1833;5098;2567;7504
320220;201706;2296;6978;1922;6314;437;1579;888;2908;1325;4487
320225;201706;1292;4283;980;3514;325;1228;147;527;472;1755
320230;201706;4260;13360;3545;12086;1003;3676;1300;4485;2303;8161
320240;201706;13357;38255;10703;33682;2607;8850;3556;11281;6163;20131
320245;201706;3139;10497;2873;9874;997;3614;717;2410;1714;6024
320250;201706;1926;5799;1372;4506;364;1340;220;657;584;1997
320255;201706;1690;5688;1481;5320;560;2102;571;2143;1131;4245
320260;201706;1024;3075;774;2517;230;827;196;529;426;1356
320265;201706;2468;7810;2085;7119;810;2887;690;2353;1500;5240
320270;201706;2711;7796;1990;6437;392;1356;885;2937;1277;4293
320280;201706;6364;19442;5486;17702;1422;4990;1440;4382;2862;9372
320290;201706;1436;4564;1019;3545;305;1151;158;520;463;1671
320300;201706;4174;13749;3612;12470;1192;4384;713;2435;1905;6819
320305;201706;4522;14184;3823;12634;949;3336;1408;4591;2357;7927
320310;201706;1885;5617;1559;4933;367;1201;595;1865;962;3066
320313;201706;2143;6035;1462;4557;330;1164;279;815;609;1979
320316;201706;1673;4986;1333;4284;405;1357;411;1309;816;2666
320320;201706;19876;58648;15437;50503;4218;14948;4807;15469;9025;30417
320330;201706;2958;8636;2396;7641;658;2095;953;3234;1611;5329
320332;201706;5452;17089;4698;15684;1338;4734;1882;6218;3220;10952
320334;201706;2069;6425;1431;5041;344;1361;316;1065;660;2426
320335;201706;2248;6578;1417;4639;384;1377;198;588;582;1965
320340;201706;5551;14869;4759;13564;1014;3113;2195;6399;3209;9512
320350;201706;5134;13427;3805;10992;693;2069;1626;4669;2319;6738
320360;201706;1632;4332;1208;3508;199;566;481;1379;680;1945
320370;201706;2809;9206;2258;7920;642;2326;671;2321;1313;4647
320380;201706;2198;6466;1941;6016;395;1349;997;3005;1392;4354
320390;201706;7167;21123;5767;18148;1553;5241;1787;5380;3340;10621
320400;201706;3512;10607;3048;9753;642;2192;1372;4364;2014;6556
320405;201706;4325;12355;3725;11289;692;2222;2056;6111;2748;8333
320410;201706;5324;14432;3996;12471;850;2855;1771;5670;2621;8525
320420;201706;2526;7460;2020;6558;600;2156;463;1479;1063;3635
320425;201706;2043;5201;1591;4455;160;483;973;2660;1133;3143
320430;201706;2600;7132;2198;6313;415;1262;1185;3256;1600;4518
320435;201706;2688;8548;2172;7530;892;3218;542;1973;1434;5191
320440;201706;1034;3331;902;2998;196;724;320;1018;516;1742
320450;201706;1948;5959;1579;5237;407;1493;655;2092;1062;3585
320455;201706;4141;13361;3070;10832;817;3044;695;2378;1512;5422
320460;201706;2630;8253;1917;6625;480;1778;355;1122;835;2900
320465;201706;1540;4658;1173;3860;169;613;541;1781;710;2394
320470;201706;4218;12349;2989;9710;825;2908;601;1864;1426;4772
320480;201706;1693;5235;1464;4764;320;1153;615;1952;935;3105
320490;201706;15654;46871;13189;42520;3479;12289;4264;13717;7743;26006
320495;201706;1340;3861;886;2932;263;906;137;484;400;1390
320500;201706;48468;142798;42030;131349;8924;30135;20280;62001;29204;92136
320501;201706;4596;13912;3569;12166;1088;4150;904;3003;1992;7153
320503;201706;1913;6339;1532;5521;548;2187;420;1369;968;3556
320506;201706;4097;12478;2896;9691;779;2774;106;279;885;3053
320510;201706;8509;25934;7392;23858;1493;5290;3608;11441;5101;16731
320515;201706;1883;5405;1523;4623;455;1435;345;1038;800;2473
320517;201706;2061;6556;1646;5734;545;2066;344;1160;889;3226
320520;201706;36688;108654;30143;96946;7162;25512;10698;33837;17860;59349
320530;201706;28031;83005;23316;74193;4121;15350;11681;34939;15802;50289
330010;201706;20486;62160;18315;58181;3910;13147;9705;30944;13615;44091
330015;201706;1509;4150;1298;3765;203;688;607;1702;810;2390
330020;201706;18274;51931;16588;49165;2876;9462;10229;29531;13105;38993
330022;201706;1922;5583;1601;5045;310;1082;886;2738;1196;3820
330023;201706;3194;9655;2763;8961;768;2701;834;2608;1602;5309
330025;201706;4751;12766;3599;10681;994;3149;1392;4129;2386;7278
330030;201706;8284;26829;7262;24851;1379;5242;3533;11543;4912;16785
330040;201706;11762;34959;10671;32846;2047;6865;5983;17853;8030;24718
330045;201706;75633;203151;65531;188933;8185;25236;44299;126124;52484;151360
330050;201706;2432;7284;2029;6544;542;1880;747;2275;1289;4155
330060;201706;5659;15965;4799;14629;1093;3713;2156;6345;3249;10058
330070;201706;20277;60474;18163;56931;3855;13063;8886;27860;12741;40923
330080;201706;8184;22711;7517;21665;689;2052;5317;15242;6006;17294
330090;201706;2633;6902;2333;6444;354;1096;1292;3445;1646;4541
330093;201706;1991;5869;1654;5277;293;965;818;2735;1111;3700
330095;201706;1026;3417;877;3081;161;627;338;1149;499;1776
330100;201706;61644;185576;55065;175255;7410;27023;33337;104720;40747;131743
330110;201706;2261;7000;1991;6534;465;1658;703;2241;1168;3899
330115;201706;1785;5118;1549;4751;286;998;847;2503;1133;3501
330120;201706;2755;7309;2391;6777;330;1078;1553;4317;1883;5395
330130;201706;3318;10549;2954;9918;685;2522;1426;4702;2111;7224
330140;201706;3114;9415;2835;8991;549;2019;1569;4853;2118;6872
330150;201706;2075;6104;1675;5320;440;1464;436;1388;876;2852
330160;201706;1165;3588;1017;3338;263;991;479;1479;742;2470
330170;201706;99636;294813;90521;280131;17399;57348;49933;152846;67332;210194
330180;201706;2112;6034;1764;5407;109;451;1186;3489;1295;3940
330185;201706;8460;25462;7323;23304;1309;4568;4128;12785;5437;17353
330187;201706;3840;10835;3278;9916;524;1764;1992;5916;2516;7680
330190;201706;25770;71715;24021;69072;3651;10996;16997;48713;20648;59709
330200;201706;13997;42957;12478;40425;3036;10039;6226;20541;9262;30580
330205;201706;2065;5640;1796;5180;197;651;1162;3262;1359;3913
330210;201706;3052;8419;2473;7313;569;1719;841;2440;1410;4159
330220;201706;10241;30558;8698;27350;2185;7422;2185;6354;4370;13776
330225;201706;3719;11421;3202;10461;392;1626;1861;5801;2253;7427
330227;201706;16771;47590;15071;45122;2798;8628;9303;28263;12101;36891
330230;201706;1257;3672;1129;3479;159;583;680;2017;839;2600
330240;201706;18017;53904;15352;49029;4573;15725;5099;15756;9672;31481
330245;201706;1245;3681;941;3136;240;852;190;599;430;1451
330250;201706;35156;102183;31870;96774;8946;27470;12911;40648;21857;68118
330260;201706;4199;12788;3576;11567;658;2315;1542;4783;2200;7098
330270;201706;19850;44653;13350;35931;3039;9173;4929;13298;7968;22471
330280;201706;2276;6639;1890;5893;308;1086;907;2661;1215;3747
330285;201706;18127;51172;16209;48214;2732;8883;9793;28573;12525;37456
330290;201706;3271;9363;2880;8735;480;1612;1573;4588;2053;6200
330300;201706;3222;10331;2893;9685;518;1973;1609;5154;2127;7127
330310;201706;2211;6183;1859;5565;215;666;1148;3415;1363;4081
330320;201706;13018;38730;12146;37354;1552;5300;8857;26889;10409;32189
330330;201706;28460;76746;24749;70976;4247;13620;14803;41013;19050;54633
330340;201706;14370;40998;11314;35496;2730;9245;3753;11436;6483;20681
330350;201706;87879;251128;78576;237828;10758;34972;52946;159609;63704;194581
330360;201706;6110;17560;5776;17069;637;2006;4352;12768;4989;14774
330370;201706;3581;12466;3209;11692;1061;3989;1003;3666;2064;7655
330380;201706;5109;16187;4281;14509;1043;3923;1432;4643;2475;8566
330385;201706;3879;13185;3533;12498;1025;3847;1366;4875;2391;8722
330390;201706;22375;71915;19469;66009;4800;17575;7858;26033;12658;43608
330395;201706;3061;8810;2787;8364;229;822;1852;5462;2081;6284
330400;201706;2709;8279;2454;7810;280;1097;1583;4667;1863;5764
330410;201706;2857;8522;2242;7374;431;1567;1013;3150;1444;4717
330411;201706;2377;7263;2069;6621;239;903;1285;3903;1524;4806
330412;201706;1399;4632;1175;4158;214;841;542;1780;756;2621
330414;201706;23910;66349;20753;61893;3842;11360;12168;36629;16010;47989
330415;201706;3318;10126;2803;9219;645;2140;1127;3771;1772;5911
330420;201706;9961;27799;6820;22158;1415;5015;1589;4935;3004;9950
330430;201706;7338;21329;6491;19757;1338;4443;3051;8959;4389;13402
330440;201706;1548;5090;1386;4773;425;1647;406;1251;831;2898
330450;201706;1365;4391;1209;4125;241;964;611;2020;852;2984
330452;201706;14028;40690;11306;35536;2636;9003;4781;14592;7417;23595
330455;201706;507993;1368132;412694;1213575;82478;259565;211919;612935;294397;872500
330460;201706;1165;3714;1016;3442;214;799;432;1413;646;2212
330470;201706;4303;12705;3814;11847;894;3020;1726;5213;2620;8233
330475;201706;7778;23614;6858;22091;2000;6986;2632;8266;4632;15252
330480;201706;5743;16460;5130;15548;825;2689;3061;9061;3886;11750
330490;201706;110971;286963;98329;268216;11058;32309;67201;180866;78259;213175
330500;201706;5402;16163;5149;15728;662;2236;3673;11083;4335;13319
330510;201706;37394;112310;33067;105384;10292;33091;13653;44550;23945;77641
330513;201706;1326;3952;1222;3771;388;1244;496;1531;884;2775
330515;201706;3006;9142;2605;8354;854;2827;698;2228;1552;5055
330520;201706;11041;33166;9837;30975;1993;6765;4521;13892;6514;20657
330530;201706;1463;4176;1240;3763;300;1015;537;1527;837;2542
330540;201706;2936;8488;2407;7516;634;2098;848;2534;1482;4632
330550;201706;7759;25673;6853;23923;2839;10298;1199;4342;4038;14640
330555;201706;9637;28282;8606;26750;1584;5140;5183;16347;6767;21487
330560;201706;4303;12761;3814;11848;593;2001;2062;6194;2655;8195
330570;201706;3128;9148;2646;8323;626;2063;1262;3943;1888;6006
330575;201706;5305;14859;4727;13801;618;2058;3172;8878;3790;10936
330580;201706;13313;41230;11104;36766;3042;10649;4168;13692;7210;24341
330590;201706;1551;4665;1449;4511;202;667;1000;3135;1202;3802
330600;201706;11352;32831;9067;28740;1517;5284;4219;13210;5736;18494
330610;201706;8742;26847;7839;25247;1283;4671;4371;13715;5654;18386
330615;201706;1616;5605;1492;5401;566;2144;545;2028;1111;4172
330620;201706;3502;11960;3105;11125;1127;4333;619;2162;1746;6495
330630;201706;23596;66962;19149;59105;2721;9797;10970;32419;13691;42216
350010;201706;1808;5209;1182;3983;301;1049;123;369;424;1418
350020;201706;485;1328;332;1022;44;152;158;442;202;594
350030;201706;4512;13784;3456;11656;960;3512;847;2770;1807;6282
350040;201706;475;1560;343;1251;68;275;109;368;177;643
350050;201706;871;2628;702;2299;165;626;213;584;378;1210
350055;201706;677;1935;576;1767;82;275;374;1137;456;1412
350060;201706;115;351;95;322;24;92;44;149;68;241
350070;201706;3909;11315;2500;8407;490;1719;602;1853;1092;3572
350075;201706;565;1848;434;1572;178;653;67;229;245;882
350080;201706;674;1927;424;1365;63;232;165;505;228;737
350090;201706;612;1604;391;1155;91;250;127;375;218;625
350100;201706;2004;6073;1425;4910;261;1044;497;1588;758;2632
350110;201706;461;1401;343;1142;33;130;183;587;216;717
350115;201706;1256;3731;1095;3407;219;736;527;1508;746;2244
350120;201706;843;2435;523;1756;67;217;260;950;327;1167
350130;201706;3395;9858;2927;8938;378;1293;1634;4726;2012;6019
350140;201706;586;1916;485;1713;52;227;272;935;324;1162
350150;201706;468;1501;402;1365;138;498;96;328;234;826
350160;201706;9265;25710;6140;19750;1133;4108;2685;7985;3818;12093
350170;201706;1527;5079;1271;4454;313;1164;303;1019;616;2183
350180;201706;1136;3081;691;2123;110;376;311;919;421;1295
350190;201706;3254;9845;2528;8340;535;2032;987;2761;1522;4793
350200;201706;384;1163;344;1086;25;83;229;711;254;794
350210;201706;5151;13489;3649;10916;882;2753;1554;4595;2436;7348
350220;201706;2440;7656;2095;6856;444;1696;899;2718;1343;4414
350230;201706;778;2397;692;2230;162;552;299;947;461;1499
350240;201706;552;1636;420;1340;50;176;217;658;267;834
350250;201706;2098;7337;1882;6927;676;2671;548;2010;1224;4681
350260;201706;983;2564;650;1941;120;372;275;794;395;1166
350270;201706;4857;14493;4031;12731;764;2673;1712;5013;2476;7686
350275;201706;1954;6241;1754;5898;464;1666;660;2174;1124;3840
350280;201706;21999;52746;13778;38982;2769;8380;3677;10139;6446;18519
350290;201706;2341;7283;1831;6204;368;1393;601;1937;969;3330
350300;201706;572;1649;423;1325;90;266;155;461;245;727
350310;201706;901;2946;767;2624;103;400;296;954;399;1354
350315;201706;521;1598;386;1298;65;245;108;332;173;577
350320;201706;10780;33251;9580;30991;2746;9391;1676;5674;4422;15065
350330;201706;14810;40211;10216;30056;1820;5265;4120;11460;5940;16725
350335;201706;390;1195;345;1106;21;63;250;811;271;874
350340;201706;1097;3174;752;2479;150;555;237;777;387;1332
350350;201706;719;2191;611;2037;127;456;205;671;332;1127
350360;201706;888;2934;754;2636;199;688;285;1006;484;1694
350370;201706;585;1711;417;1320;107;339;72;215;179;554
350380;201706;4480;12972;3184;10521;749;2719;930;2862;1679;5581
350390;201706;9488;28498;8147;25938;2347;7655;2888;9019;5235;16674
350395;201706;371;1020;186;633;27;97;55;166;82;263
350400;201706;8095;22753;6292;19463;1585;5377;2042;5982;3627;11359
350410;201706;8449;27349;6681;23694;1800;6963;1374;4557;3174;11520
350420;201706;562;1750;427;1507;87;363;54;184;141;547
350430;201706;688;2112;582;1918;99;383;316;994;415;1377
350440;201706;1320;4068;1096;3539;251;789;452;1431;703;2220
350450;201706;7522;23077;6109;20194;1419;5006;1615;5105;3034;10111
350460;201706;1439;3876;875;2749;174;617;285;830;459;1447
350470;201706;245;635;204;565;21;75;132;337;153;412
350480;201706;757;2208;538;1772;90;339;90;266;180;605
350490;201706;1860;5495;1544;4954;356;1221;495;1473;851;2694
350500;201706;568;1689;489;1537;80;295;262;787;342;1082
350510;201706;1109;3287;834;2702;125;469;362;1111;487;1580
350520;201706;1635;5801;1283;4970;271;1118;373;1412;644;2530
350530;201706;2304;6695;1855;5784;544;1778;444;1310;988;3088
350535;201706;1273;4032;1185;3882;155;631;800;2506;955;3137
350540;201706;1794;4936;1345;4150;324;1080;492;1524;816;2604
350550;201706;10506;27489;7302;22209;1195;4141;2862;8169;4057;12310
350560;201706;3417;11004;2975;9942;381;1361;1639;5387;2020;6748
350570;201706;18783;59589;16526;55105;4592;16639;6335;20063;10927;36702
350580;201706;1791;5614;1152;3985;227;834;118;328;345;1162
350590;201706;3968;12058;3084;10240;796;2989;1174;3526;1970;6515
350600;201706;43402;106060;28508;79768;4532;13921;12180;31500;16712;45421
350610;201706;6896;20233;5463;17553;1121;3961;2274;7077;3395;11038
350620;201706;420;1179;313;1014;46;188;142;423;188;611
350630;201706;1623;4570;1200;3755;174;649;524;1495;698;2144
350635;201706;6978;19874;5446;17230;1192;4139;2305;7064;3497;11203
350640;201706;825;2519;563;1872;98;343;141;429;239;772
350650;201706;7757;22909;4971;16353;1055;3813;1160;3576;2215;7389
350660;201706;4881;13961;3936;12270;754;2511;1844;5699;2598;8210
350670;201706;1541;4785;1411;4526;325;1090;688;2157;1013;3247
350680;201706;1088;3216;795;2631;183;682;318;1035;501;1717
350690;201706;885;2836;687;2407;147;556;243;800;390;1356
350700;201706;4305;12434;3052;10273;673;2524;1106;3420;1779;5944
350710;201706;2728;8318;2363;7605;369;1339;1312;4088;1681;5427
350715;201706;741;2229;662;2054;89;316;366;1052;455;1368
350720;201706;130;365;117;344;25;83;42;118;67;201
350730;201706;421;1494;390;1418;82;332;174;617;256;949
350740;201706;1776;5311;1251;4136;225;798;326;973;551;1771
350745;201706;528;1609;316;1078;54;199;129;396;183;595
350750;201706;9321;28005;7676;24773;1749;6291;2134;6292;3883;12583
350760;201706;13299;38144;10586;33332;2833;9710;2605;7351;5438;17061
350770;201706;686;1940;469;1498;63;206;226;719;289;925
350775;201706;616;1619;495;1416;55;194;232;632;287;826
350780;201706;1887;5649;1466;4838;386;1413;306;1046;692;2459
350790;201706;1891;5709;1369;4661;318;1161;242;700;560;1861
350800;201706;3018;9873;2817;9485;506;1919;1457;4738;1963;6657
350810;201706;2020;5596;1734;5188;409;1304;838;2613;1247;3917
350820;201706;630;1706;420;1287;66;207;146;415;212;622
350830;201706;858;2640;547;1914;73;268;138;439;211;707
350840;201706;2626;8854;2110;7756;666;2618;494;1727;1160;4345
350850;201706;6011;19614;5003;17441;1498;5479;1217;4223;2715;9702
350860;201706;3230;9680;3024;9354;151;636;2301;6998;2452;7634
350870;201706;2726;8440;2200;7539;468;1769;1192;4107;1660;5876
350880;201706;1315;4277;1054;3653;242;875;262;885;504;1760
350890;201706;662;1843;414;1302;50;165;118;312;168;477
350900;201706;5390;16374;3857;13039;1206;4476;428;1348;1634;5824
350910;201706;888;2535;761;2279;176;595;389;1114;565;1709
350920;201706;11571;31673;10176;29350;825;2750;7506;20787;8331;23537
350925;201706;4451;13654;3513;11788;814;2912;1148;3360;1962;6272
350930;201706;1528;4221;1098;3339;138;445;586;1697;724;2142
350940;201706;1826;5902;1665;5576;288;1115;938;3026;1226;4141
350945;201706;921;2830;763;2537;129;501;358;1106;487;1607
350950;201706;77808;228484;63135;196673;12080;41291;29877;87733;41957;129024
350960;201706;4835;15669;4117;14168;819;3199;2079;6816;2898;10015
350970;201706;4121;13934;3444;12276;1120;4333;541;1713;1661;6046
350980;201706;629;2024;543;1832;216;771;164;539;380;1310
350990;201706;1768;5724;1427;5086;374;1474;414;1382;788;2856
350995;201706;794;2638;748;2542;91;396;461;1475;552;1871
351000;201706;2824;8252;2273;7205;417;1463;873;2592;1290;4055
351010;201706;334;961;198;652;40;138;69;225;109;363
351015;201706;749;2516;633;2297;152;596;244;861;396;1457
351020;201706;8076;24635;6935;22771;1674;5742;3431;11267;5105;17009
351030;201706;2177;7242;1852;6443;393;1533;750;2424;1143;3957
351040;201706;3726;10872;3375;10276;382;1328;2372;6967;2754;8295
351050;201706;15942;43334;11203;35274;2612;8982;3499;10918;6111;19900
351060;201706;40851;114001;33013;100292;5719;19114;17201;50644;22920;69758
351070;201706;1405;3854;896;2914;240;861;90;249;330;1110
351080;201706;2755;7816;2086;6975;498;1829;914;2850;1412;4679
351090;201706;352;1194;276;1038;53;220;45;168;98;388
351100;201706;2449;7292;1675;5390;445;1501;455;1475;900;2976
351110;201706;6495;16539;3834;12175;816;2898;1004;2997;1820;5895
351120;201706;680;1990;514;1649;82;281;205;569;287;850
351130;201706;1033;2894;515;1779;87;302;99;332;186;634
351140;201706;1689;5600;1387;4950;421;1631;297;965;718;2596
351150;201706;1424;4898;1003;3804;218;870;82;253;300;1123
351160;201706;1211;4101;1059;3748;267;1003;347;1057;614;2060
351170;201706;1381;4285;1178;3836;156;571;611;1864;767;2435
351190;201706;832;2606;648;2149;102;336;196;626;298;962
351200;201706;1873;5449;1577;4905;176;615;728;2120;904;2735
351210;201706;1309;3569;901;2745;127;448;364;996;491;1444
351220;201706;2981;9783;2726;9241;395;1507;1524;4976;1919;6483
351230;201706;1816;5455;1452;4789;294;1093;677;2109;971;3202
351240;201706;1182;3482;879;2850;215;724;334;1014;549;1738
351250;201706;1021;2957;618;2000;100;340;210;650;310;990
351260;201706;905;2627;762;2335;254;788;178;515;432;1303
351270;201706;327;1058;286;969;70;272;121;349;191;621
351280;201706;5200;14660;3861;11997;709;2453;1441;4243;2150;6696
351290;201706;965;2715;673;2130;147;479;271;817;418;1296
351300;201706;13336;41641;10028;34757;2387;8997;3142;10870;5529;19867
351310;201706;3026;9064;2434;7956;440;1636;1162;3518;1602;5154
351320;201706;886;2874;715;2449;126;477;246;778;372;1255
351330;201706;610;2180;551;2085;71;215;376;1540;447;1755
351340;201706;5683;18591;4806;16858;1283;4691;1789;6239;3072;10930
351350;201706;7504;23579;6518;21588;1568;5456;2711;8559;4279;14015
351360;201706;3931;11981;3585;11321;916;3162;1087;3141;2003;6303
351370;201706;2287;7014;1767;5856;368;1358;665;1991;1033;3349
351380;201706;40554;113931;35328;104369;6805;21390;16226;46590;23031;67980
351385;201706;263;772;187;605;25;90;64;183;89;273
351390;201706;1216;3767;999;3312;256;1023;426;1238;682;2261
351400;201706;938;3022;880;2889;239;849;410;1322;649;2171
351410;201706;2390;7181;2040;6499;299;969;1152;3603;1451;4572
351420;201706;306;842;201;641;46;148;53;165;99;313
351430;201706;785;2432;733;2341;87;314;559;1753;646;2067
351440;201706;3236;9550;2376;7655;467;1592;348;999;815;2591
351450;201706;1546;4302;1207;3711;285;932;379;1209;664;2141
351460;201706;653;1940;567;1777;265;829;165;525;430;1354
351470;201706;1038;2984;895;2704;130;457;469;1320;599;1777
351480;201706;2737;8644;2457;8170;374;1580;1344;4255;1718;5835
351490;201706;1815;5876;1615;5444;165;707;977;3100;1142;3807
351492;201706;302;941;253;814;17;66;136;409;153;475
351495;201706;208;669;159;540;28;109;67;215;95;324
351500;201706;31820;86396;23867;72111;5599;18034;9622;27890;15221;45924
351510;201706;9934;29012;7940;25035;1686;5728;3902;11947;5588;17675
351512;201706;498;1407;361;1103;53;155;160;472;213;627
351515;201706;2476;7166;1708;5559;382;1422;415;1238;797;2660
351518;201706;2211;6581;1529;5291;325;1256;596;1874;921;3130
351519;201706;767;2249;547;1757;92;331;129;305;221;636
351520;201706;798;2158;378;1294;64;239;110;339;174;578
351530;201706;372;1126;242;785;32;95;62;163;94;258
351535;201706;2336;5924;1769;5023;159;570;1115;2973;1274;3543
351540;201706;1820;5239;1375;4359;478;1640;186;514;664;2154
351550;201706;5198;15217;3677;11752;651;2300;1519;4529;2170;6829
351560;201706;445;1418;383;1274;85;316;77;249;162;565
351565;201706;168;565;149;517;31;107;59;192;90;299
351570;201706;14394;41728;11813;36600;2072;7031;6780;20132;8852;27163
351580;201706;303;829;187;590;33;94;54;179;87;273
351590;201706;476;1199;287;820;28;96;148;388;176;484
351600;201706;1759;4815;1414;4178;181;608;804;2234;985;2842
351610;201706;688;1828;496;1487;49;176;242;629;291;805
351620;201706;18883;58590;14929;50647;2985;11455;4538;13836;7523;25291
351630;201706;23041;68414;20224;63688;3935;13166;11680;36019;15615;49185
351640;201706;14369;41710;11854;37288;1871;6526;7016;21429;8887;27955
351650;201706;439;1307;209;710;30;109;38;114;68;223
351660;201706;797;2469;569;1891;118;422;114;337;232;759
351670;201706;4034;12606;3236;10692;569;2091;1450;4462;2019;6553
351680;201706;552;1693;329;1118;68;227;69;235;137;462
351685;201706;433;1381;374;1256;91;283;158;535;249;818
351690;201706;1056;3076;756;2429;135;474;280;803;415;1277
351700;201706;1069;3121;919;2822;209;614;346;1066;555;1680
351710;201706;565;1828;462;1581;64;251;191;600;255;851
351720;201706;1582;4660;1102;3583;205;724;352;1091;557;1815
351730;201706;1087;2998;853;2637;159;593;364;1067;523;1660
351740;201706;4046;10896;3175;9166;589;1821;1245;3354;1834;5175
351750;201706;1212;3813;775;2795;144;564;232;833;376;1397
351760;201706;3276;10067;2544;8446;642;2333;682;2042;1324;4375
351770;201706;2151;6715;1794;6001;544;1876;631;2037;1175;3913
351780;201706;1424;3951;787;2501;129;461;161;471;290;932
351790;201706;1148;3177;966;2878;184;505;546;1661;730;2166
351800;201706;532;1164;287;739;38;106;103;253;141;359
351810;201706;1038;2939;863;2620;91;264;576;1707;667;1971
351820;201706;2574;8047;1867;6521;374;1421;196;682;570;2103
351830;201706;4416;13186;3399;11081;522;1973;1688;5251;2210;7224
351840;201706;6739;22379;5858;20571;1400;5342;2154;7234;3554;12576
351850;201706;2092;5577;1458;4469;225;860;614;1688;839;2548
351860;201706;3091;9788;2657;8878;595;2099;1200;3950;1795;6049
351870;201706;27028;78717;22204;70000;6907;22904;8181;25553;15088;48457
351880;201706;119382;360315;98947;320273;28676;99565;26442;81397;55118;180962
351885;201706;654;2185;593;2058;163;584;243;802;406;1386
351890;201706;626;1921;511;1697;120;418;74;210;194;628
351900;201706;1187;3580;969;3204;258;895;294;970;552;1865
351905;201706;451;1386;350;1182;48;179;163;501;211;680
351907;201706;19491;55904;16225;49790;1171;4412;11210;33324;12381;37736
351910;201706;1067;3208;853;2719;184;644;338;1001;522;1645
351920;201706;972;2594;782;2296;105;362;398;1123;503;1485
351925;201706;1009;2967;822;2595;143;474;364;1054;507;1528
351930;201706;2789;8670;2670;8447;370;1533;2028;6091;2398;7624
351940;201706;1008;2944;813;2587;100;350;431;1365;531;1715
351950;201706;1571;4153;1115;3311;110;377;588;1692;698;2069
351960;201706;4656;13202;3470;10943;746;2578;1422;4386;2168;6964
351970;201706;5624;19602;4999;18367;1262;5056;2031;7122;3293;12178
351980;201706;919;2662;681;2143;126;438;287;824;413;1262
351990;201706;1492;4083;1148;3449;205;729;294;785;499;1514
352000;201706;2258;7280;2045;6821;326;1232;1067;3354;1393;4586
352010;201706;1640;5348;1411;4871;347;1283;232;811;579;2094
352020;201706;1460;4435;1239;4011;286;1017;495;1499;781;2516
352030;201706;4936;14246;4077;12969;831;2913;2105;6638;2936;9551
352040;201706;2033;6371;1522;5264;302;1132;238;759;540;1891
352042;201706;3595;9662;2180;6721;419;1377;928;2800;1347;4177
352044;201706;1816;5472;1150;4081;184;706;246;827;430;1533
352050;201706;11594;34842;7914;26561;1831;6920;1353;4020;3184;10940
352060;201706;718;2133;567;1817;100;362;229;673;329;1035
352070;201706;822;2016;649;1740;129;382;239;635;368;1017
352080;201706;457;1305;289;920;51;178;79;223;130;401
352090;201706;1336;4493;1076;3848;177;695;295;971;472;1666
352100;201706;3035;9048;2423;7899;560;1967;1017;3159;1577;5126
352110;201706;561;1923;471;1723;123;464;164;564;287;1028
352115;201706;494;1522;422;1382;57;185;252;833;309;1018
352120;201706;861;2677;704;2367;109;453;355;1087;464;1540
352130;201706;1873;5590;1223;4012;278;959;301;950;579;1909
352140;201706;1743;4901;1064;3460;158;556;373;1137;531;1693
352150;201706;782;2286;622;1973;155;516;298;926;453;1442
352160;201706;973;2663;738;2250;172;572;240;668;412;1240
352170;201706;2751;8185;2395;7383;512;1701;1105;3167;1617;4868
352180;201706;3046;8628;2564;7684;664;2110;880;2500;1544;4610
352190;201706;1180;3491;959;3057;145;554;320;862;465;1416
352200;201706;386;1304;295;1103;36;146;100;354;136;500
352210;201706;16167;43372;13369;39176;2083;6534;8369;24653;10452;31187
352215;201706;512;1537;469;1479;54;205;287;870;341;1075
352220;201706;12890;39240;10202;33932;3252;11574;2379;7855;5631;19429
352230;201706;12446;41247;10547;37449;2956;11488;3269;10936;6225;22424
352240;201706;11848;33669;9123;28788;2350;8359;2910;8321;5260;16680
352250;201706;21228;66582;18143;60552;5400;18917;6693;22001;12093;40918
352260;201706;5898;17636;4131;13871;690;2469;1894;6409;2584;8878
352265;201706;882;2698;757;2488;69;300;496;1560;565;1860
352270;201706;1606;5435;1321;4800;332;1272;356;1247;688;2519
352280;201706;2263;6580;1841;5847;279;1067;867;2591;1146;3658
352290;201706;1131;3559;955;3132;169;664;405;1198;574;1862
352300;201706;991;2809;732;2289;138;505;324;898;462;1403
352310;201706;46018;131886;36129;114622;9456;31098;15537;49407;24993;80505
352320;201706;5595;16840;4707;14966;1053;3589;1705;4864;2758;8453
352330;201706;2020;6314;1699;5845;504;1880;551;1823;1055;3703
352340;201706;5086;15754;3888;13489;1071;3974;884;2914;1955;6888
352350;201706;1691;5542;1497;5100;265;1042;550;1713;815;2755
352360;201706;1081;3190;956;2968;170;607;632;1874;802;2481
352370;201706;867;2869;775;2645;82;338;463;1519;545;1857
352380;201706;915;2845;769;2572;222;818;185;585;407;1403
352390;201706;19504;50757;12892;38622;2135;7211;5995;16845;8130;24056
352400;201706;3688;10494;2643;8492;756;2599;842;2494;1598;5093
352410;201706;2893;8529;2428;7757;475;1659;1088;3340;1563;4999
352420;201706;894;2407;711;2060;132;416;279;787;411;1203
352430;201706;6345;18660;5356;17028;1681;5694;1773;5618;3454;11312
352440;201706;16718;50420;13638;44306;2983;10392;5466;17295;8449;27687
352450;201706;634;1908;408;1392;84;324;115;381;199;705
352460;201706;2471;7703;2019;6819;505;1858;602;1902;1107;3760
352470;201706;3891;10726;2870;8856;357;1238;1323;3775;1680;5013
352480;201706;4059;10724;2990;8792;574;1904;1189;3138;1763;5042
352490;201706;674;2285;518;1900;95;369;152;561;247;930
352500;201706;8854;24448;7136;21548;3584;11576;1276;3083;4860;14659
352510;201706;3022;9202;2368;7982;667;2422;658;2189;1325;4611
352520;201706;2039;6943;1791;6349;463;1730;700;2423;1163;4153
352530;201706;8666;26982;6371;21611;1502;5459;868;2406;2370;7865
352540;201706;513;1603;368;1273;62;224;102;345;164;569
352550;201706;840;2701;611;2183;137;548;130;432;267;980
352560;201706;623;1842;431;1394;75;243;96;273;171;516
352570;201706;1828;5809;1309;4669;340;1362;205;604;545;1966
352580;201706;843;2511;658;2132;100;358;222;648;322;1006
352585;201706;270;849;220;737;38;145;82;266;120;411
352590;201706;11904;35712;9472;30915;3177;11026;3277;9845;6454;20871
352600;201706;1824;5506;1466;4697;297;1011;608;1860;905;2871
352610;201706;3291;9941;2609;8706;639;2359;791;2455;1430;4814
352620;201706;5294;15672;4686;14672;1180;3791;2114;6585;3294;10376
352630;201706;619;1884;567;1762;125;468;244;681;369;1149
352640;201706;2626;7645;2189;6887;200;699;1450;4510;1650;5209
352650;201706;757;2266;563;1800;100;349;145;422;245;771
352660;201706;958;3367;813;3040;175;710;256;945;431;1655
352670;201706;10863;32083;6632;22690;1552;5870;479;1575;2031;7445
352680;201706;3026;9782;2294;8170;446;1772;844;2786;1290;4558
352690;201706;31505;85383;22820;68194;2810;9395;12083;34279;14893;43674
352700;201706;589;1741;502;1604;154;543;192;571;346;1114
352710;201706;5541;15779;4104;12912;1016;3548;1395;4152;2411;7700
352720;201706;7945;24813;6891;22528;2513;8399;1662;5204;4175;13603
352725;201706;431;1180;221;717;23;90;93;271;116;361
352730;201706;2267;7263;2041;6651;434;1563;903;2615;1337;4178
352740;201706;2192;5713;1694;4929;213;726;956;2665;1169;3391
352750;201706;469;1318;249;833;39;149;54;156;93;305
352760;201706;1293;4254;1057;3655;253;948;358;1151;611;2099
352770;201706;784;2406;638;2092;145;519;234;725;379;1244
352780;201706;654;2154;515;1808;106;414;160;542;266;956
352790;201706;645;1816;448;1441;66;223;137;416;203;639
352800;201706;1126;3927;838;3141;181;735;216;730;397;1465
352810;201706;1056;2726;659;1944;130;391;230;649;360;1040
352820;201706;623;1651;436;1358;96;312;98;310;194;622
352830;201706;542;1535;300;946;43;141;41;106;84;247
352840;201706;3942;12951;3513;12062;1008;3658;1375;4546;2383;8204
352850;201706;10336;28654;7558;24194;1978;6806;2509;7852;4487;14658
352860;201706;840;2815;763;2633;157;597;300;983;457;1580
352870;201706;903;2271;590;1600;64;213;305;736;369;949
352880;201706;2278;6044;1604;4749;249;782;677;1809;926;2591
352885;201706;261;817;219;732;25;80;142;466;167;546
352890;201706;677;1725;466;1290;63;214;207;486;270;700
352900;201706;19486;55846;14162;45065;2804;9851;5145;15338;7949;25189
352910;201706;396;1117;219;724;22;83;42;112;64;195
352920;201706;2431;7069;1842;5843;309;1087;851;2506;1160;3593
352930;201706;5754;17572;4605;15097;904;3169;1608;5020;2512;8189
352940;201706;21419;67197;17748;59033;5881;21464;1911;5641;7792;27105
352950;201706;368;1043;226;763;48;169;27;86;75;255
352960;201706;622;1822;367;1210;58;221;117;334;175;555
352965;201706;369;1053;229;735;58;198;33;93;91;291
352970;201706;3239;8004;2591;7017;255;722;1774;4805;2029;5527
352980;201706;1160;3586;978;3282;197;688;492;1688;689;2376
352990;201706;4093;12557;3591;11679;884;3245;1588;4861;2472;8106
353000;201706;450;1252;227;746;39;139;47;145;86;284
353010;201706;2958;8046;2140;6450;501;1676;595;1624;1096;3300
353020;201706;4045;10899;2323;7161;340;1132;754;2123;1094;3255
353030;201706;3603;10466;2816;8934;777;2625;542;1678;1319;4303
353040;201706;483;1356;397;1190;79;256;124;341;203;597
353050;201706;4838;15733;3912;13781;1018;3801;1371;4582;2389;8383
353060;201706;43217;123053;37295;113229;3902;14209;25764;74997;29666;89206
353070;201706;10105;30760;7362;24909;1675;6096;2047;6873;3722;12969
353080;201706;4836;14934;3435;11934;832;3176;864;2744;1696;5920
353090;201706;543;1808;490;1686;46;185;299;965;345;1150
353100;201706;297;835;132;452;19;68;21;60;40;128
353110;201706;7389;22389;6449;20864;1119;4006;3972;12841;5091;16847
353120;201706;651;1923;428;1410;79;296;115;332;194;628
353130;201706;2467;6915;1837;5905;557;1926;562;1774;1119;3700
353140;201706;2196;6004;1750;5125;301;974;878;2427;1179;3401
353150;201706;1599;4713;1263;4105;333;1095;361;1161;694;2256
353160;201706;686;1875;448;1409;81;267;145;407;226;674
353170;201706;452;1385;394;1309;85;374;198;596;283;970
353180;201706;9015;24778;7292;21892;1088;3591;4360;12907;5448;16498
353190;201706;3629;10750;2939;9244;457;1609;1505;4385;1962;5994
353200;201706;1130;3722;828;2869;201;757;197;655;398;1412
353205;201706;353;1183;318;1097;78;298;147;496;225;794
353210;201706;1042;2568;670;1883;42;151;409;1095;451;1246
353215;201706;446;1355;364;1164;64;238;123;332;187;570
353220;201706;587;1801;469;1563;115;398;100;318;215;716
353230;201706;717;2278;649;2163;160;579;216;659;376;1238
353240;201706;2116;6591;1821;6018;283;1096;1030;3264;1313;4360
353250;201706;1087;2894;810;2370;118;358;353;998;471;1356
353260;201706;895;2464;611;1920;132;453;175;513;307;966
353270;201706;631;1850;545;1678;90;270;245;736;335;1006
353280;201706;644;2023;491;1649;116;419;125;393;241;812
353282;201706;1780;5516;1620;5193;225;775;915;2839;1140;3614
353284;201706;376;986;219;663;41;138;57;149;98;287
353286;201706;128;383;92;309;25;84;15;44;40;128
353290;201706;952;2819;738;2404;94;377;405;1199;499;1576
353300;201706;1521;4613;1230;3975;246;927;440;1260;686;2187
353310;201706;248;710;203;643;42;144;86;259;128;403
353320;201706;607;1716;501;1510;59;192;292;854;351;1046
353325;201706;659;2091;501;1741;81;286;144;513;225;799
353330;201706;612;1707;430;1294;49;172;215;597;264;769
353340;201706;2855;8166;1942;6440;564;1979;512;1729;1076;3708
353350;201706;3292;9773;2422;7864;647;2248;530;1579;1177;3827
353360;201706;451;1465;407;1372;53;198;253;838;306;1036
353370;201706;603;1960;523;1785;57;225;290;936;347;1161
353380;201706;321;1046;261;913;48;179;79;268;127;447
353390;201706;5909;16023;4275;13007;874;2775;1497;4396;2371;7171
353400;201706;477;1438;395;1274;73;263;83;205;156;468
353410;201706;603;1757;504;1566;97;348;245;717;342;1065
353420;201706;587;1651;369;1144;87;265;63;181;150;446
353430;201706;2179;7150;1641;5856;427;1653;307;1021;734;2674
353440;201706;57230;176599;44347;148549;11502;40160;15935;51776;27437;91936
353450;201706;412;1192;306;952;57;205;109;311;166;516
353460;201706;3272;9283;2499;7767;293;1068;1055;3283;1348;4351
353470;201706;7383;21857;5512;18146;1245;4533;1412;4345;2657;8878
353475;201706;1456;4128;1085;3301;170;561;372;1036;542;1597
353480;201706;1370;4140;1218;3831;131;437;858;2642;989;3079
353490;201706;928;2692;691;2167;150;458;252;749;402;1207
353500;201706;1008;2642;828;2348;218;621;422;1185;640;1806
353510;201706;911;2899;682;2313;182;629;106;320;288;949
353520;201706;1128;3133;808;2568;115;407;363;1099;478;1506
353530;201706;2478;7079;2112;6394;283;980;1117;3228;1400;4208
353540;201706;2009;6044;1694;5472;392;1318;750;2367;1142;3685
353550;201706;6137;17112;4965;15054;742;2562;2704;7735;3446;10297
353560;201706;2088;6751;1713;6067;544;2074;400;1330;944;3404
353570;201706;522;1522;385;1251;90;287;174;559;264;846
353580;201706;2369;6792;2032;6193;372;1248;1169;3465;1541;4713
353590;201706;683;2008;471;1516;98;341;169;535;267;876
353600;201706;1788;4908;1552;4452;202;648;801;2186;1003;2834
353610;201706;621;2090;470;1746;94;374;91;314;185;688
353620;201706;2286;7069;1864;6219;469;1640;469;1431;938;3071
353625;201706;476;1296;286;899;36;129;136;409;172;538
353630;201706;1402;4842;1092;4050;214;850;160;525;374;1375
353640;201706;1418;4032;1082;3343;140;501;562;1681;702;2182
353650;201706;8763;25352;6614;20854;1137;3797;2741;8243;3878;12040
353657;201706;301;919;251;823;36;120;88;259;124;379
353660;201706;1052;2731;775;2208;224;706;188;420;412;1126
353670;201706;3507;11065;2956;9929;831;3075;1112;3466;1943;6541
353680;201706;686;2124;552;1886;153;569;199;647;352;1216
353690;201706;522;1379;257;846;32;102;42;117;74;219
353700;201706;2014;6020;1731;5458;250;856;941;2820;1191;3676
353710;201706;3414;8107;1663;5208;345;1042;450;1367;795;2409
353715;201706;535;1507;377;1185;29;109;100;282;129;391
353720;201706;1941;5857;1628;5374;315;1166;829;2625;1144;3791
353730;201706;4294;12799;3362;10774;605;2124;1271;3724;1876;5848
353740;201706;1757;5065;1288;4151;330;1165;332;1000;662;2165
353750;201706;876;2947;656;2428;146;590;139;495;285;1085
353760;201706;10582;28031;8620;25314;1296;4257;5333;15395;6629;19652
353770;201706;659;2041;344;1224;63;256;31;73;94;329
353780;201706;4096;13870;3552;12700;1074;4106;832;2892;1906;6998
353790;201706;2221;7437;1809;6550;490;2052;452;1482;942;3534
353800;201706;16333;49025;13059;43071;3021;10767;5161;16670;8182;27437
353810;201706;999;3185;782;2697;142;569;239;785;381;1354
353820;201706;1447;4729;1247;4242;242;949;566;1815;808;2764
353830;201706;634;1703;499;1477;68;212;258;729;326;941
353850;201706;1653;5079;1405;4545;378;1266;491;1566;869;2832
353860;201706;2558;8155;2093;7121;580;2072;570;1916;1150;3988
353870;201706;28066;80546;19862;63876;3496;12498;7363;21528;10859;34026
353880;201706;2765;8597;2337;7798;325;1252;1248;4059;1573;5311
353890;201706;2334;5766;1642;4621;241;754;866;2327;1107;3081
353900;201706;811;2499;605;2086;133;491;164;547;297;1038
353910;201706;1885;6554;1744;6310;244;871;1219;4542;1463;5413
353920;201706;2301;6702;1594;5243;339;1221;286;822;625;2043
353930;201706;4500;13375;3204;10932;840;3122;490;1601;1330;4723
353940;201706;1105;3584;837;2934;163;614;234;771;397;1385
353950;201706;3137;9708;2646;8698;528;1880;1239;3791;1767;5671
353960;201706;579;1794;409;1406;85;283;106;355;191;638
353970;201706;598;1663;482;1465;54;180;292;862;346;1042
353980;201706;13668;39774;11438;35584;2201;7235;5811;17603;8012;24838
353990;201706;497;1411;402;1245;47;169;223;665;270;834
354000;201706;2383;6405;1444;4550;268;907;190;585;458;1492
354010;201706;367;1085;305;971;55;186;168;525;223;711
354020;201706;4079;12629;3473;11304;889;3131;1034;3056;1923;6187
354025;201706;854;2380;596;1885;128;421;177;565;305;986
354030;201706;485;1271;303;911;44;141;123;346;167;487
354040;201706;776;2060;510;1530;47;167;295;811;342;978
354050;201706;955;2968;730;2504;195;730;142;458;337;1188
354060;201706;4804;14675;3306;11293;861;3044;808;2578;1669;5622
354070;201706;2795;9148;2314;8043;594;2216;457;1457;1051;3673
354075;201706;1948;6980;1746;6503;362;1519;848;3031;1210;4550
354080;201706;1406;4242;981;3299;170;610;293;905;463;1515
354085;201706;369;869;333;822;6;27;267;638;273;665
354090;201706;1350;3969;1278;3829;134;460;868;2568;1002;3028
354100;201706;14299;47125;11820;42292;2980;11428;4800;16752;7780;28180
354105;201706;948;2693;824;2508;128;407;530;1610;658;2017
354110;201706;709;1902;543;1660;167;567;128;340;295;907
354120;201706;1914;5259;1338;4071;221;737;511;1410;732;2147
354130;201706;6228;17624;4480;14208;1558;5250;270;683;1828;5933
354140;201706;26087;65428;16560;48346;3405;10636;4769;12982;8174;23618
354150;201706;3838;10124;2879;8398;576;1803;1141;3202;1717;5005
354160;201706;3373;10724;2622;9009;707;2546;797;2696;1504;5242
354165;201706;533;1707;449;1537;100;385;204;686;304;1071
354170;201706;1377;4310;1096;3632;160;584;489;1539;649;2123
354180;201706;478;1458;398;1276;63;234;158;426;221;660
354190;201706;1491;4648;1206;4030;234;858;378;1235;612;2093
354200;201706;955;2631;741;2244;84;276;357;1000;441;1276
354210;201706;644;2015;528;1795;72;297;280;876;352;1173
354220;201706;3017;8598;2482;7575;461;1523;1211;3562;1672;5085
354230;201706;611;1946;549;1818;91;368;261;778;352;1146
354240;201706;1246;4012;927;3272;173;659;198;652;371;1311
354250;201706;670;1847;436;1450;127;444;107;373;234;817
354260;201706;7458;21848;6037;19331;1587;5347;1861;6120;3448;11467
354270;201706;1146;3740;934;3277;179;687;310;1065;489;1752
354280;201706;698;1996;619;1857;115;419;352;963;467;1382
354290;201706;916;3186;819;2945;164;615;337;1203;501;1818
354300;201706;3794;12022;3470;11407;1066;3650;1320;4178;2386;7828
354310;201706;802;2423;650;2119;135;455;324;1042;459;1497
354320;201706;739;2184;582;1868;124;464;210;599;334;1063
354323;201706;490;1303;357;1049;54;160;140;378;194;538
354325;201706;1219;3934;910;3213;161;598;318;1051;479;1649
354330;201706;6489;18862;5107;16154;983;3578;2408;6977;3391;10555
354340;201706;23668;70989;19102;62883;5299;18864;6827;21787;12126;40651
354350;201706;1076;3127;944;2855;190;652;527;1486;717;2138
354360;201706;461;1439;289;1041;46;151;24;88;70;239
354370;201706;1105;3656;943;3315;122;520;503;1711;625;2231
354380;201706;795;2369;598;1968;164;624;98;272;262;896
354390;201706;13416;37817;9115;29594;1796;6257;1904;5995;3700;12252
354400;201706;1596;5492;1289;4722;265;1046;379;1375;644;2421
354410;201706;5336;16133;4376;14248;1079;3811;1711;5351;2790;9162
354420;201706;1261;3739;904;2912;174;598;393;1228;567;1826
354425;201706;2183;6210;1826;5499;532;1658;498;1529;1030;3187
354430;201706;1358;4317;1211;4030;231;880;540;1714;771;2594
354440;201706;568;1653;389;1269;47;165;156;462;203;627
354450;201706;407;1176;243;806;31;114;44;134;75;248
354460;201706;1002;2749;687;2118;123;415;292;899;415;1314
354470;201706;598;1571;466;1314;39;141;227;571;266;712
354480;201706;741;2012;597;1771;69;215;358;1015;427;1230
354490;201706;739;2422;606;2099;84;326;264;871;348;1197
354500;201706;2123;6689;1868;6277;663;2490;412;1347;1075;3837
354510;201706;824;2264;750;2123;98;252;445;1240;543;1492
354515;201706;253;825;199;702;40;156;70;242;110;398
354520;201706;8045;25685;4644;15817;828;3214;1977;6189;2805;9403
354530;201706;3302;10940;2890;10049;711;2685;1133;3829;1844;6514
354540;201706;1181;3517;936;3050;291;999;221;729;512;1728
354550;201706;482;1393;384;1216;80;274;191;583;271;857
354560;201706;1786;4898;1048;3243;151;495;458;1332;609;1827
354570;201706;1110;3064;507;1603;89;303;77;214;166;517
354580;201706;10678;29625;7342;23386;1279;4438;2808;8394;4087;12832
354600;201706;1631;5152;1380;4667;253;968;704;2308;957;3276
354610;201706;364;1051;207;679;30;107;56;166;86;273
354620;201706;412;1290;324;1125;57;248;144;451;201;699
354625;201706;308;942;194;668;26;99;43;111;69;210
354630;201706;2166;7058;1870;6434;741;2690;234;774;975;3464
354640;201706;3161;10327;2432;8584;501;1999;461;1466;962;3465
354650;201706;875;2559;748;2296;90;299;487;1502;577;1801
354660;201706;2430;6628;1756;5469;141;528;1132;3465;1273;3993
354670;201706;1098;3363;835;2732;201;716;207;611;408;1327
354680;201706;4452;14096;4029;13248;1055;3638;1875;6101;2930;9739
354690;201706;754;2404;515;1829;104;393;110;363;214;756
354700;201706;1064;2970;740;2266;147;518;297;789;444;1307
354710;201706;519;1514;382;1219;32;123;183;527;215;650
354720;201706;263;708;143;452;45;142;19;57;64;199
354730;201706;9109;27906;6858;23536;1281;4861;3214;10590;4495;15451
354740;201706;315;910;137;495;15;70;21;73;36;143
354750;201706;2449;7262;1778;5962;383;1457;638;1981;1021;3438
354760;201706;1851;5767;1471;4967;469;1688;220;743;689;2431
354765;201706;307;857;145;492;15;53;24;77;39;130
354770;201706;2340;6349;1718;5255;507;1658;543;1596;1050;3254
354780;201706;56164;153129;46494;133237;7137;22929;24679;66213;31816;89142
354790;201706;829;2671;721;2452;114;403;355;1172;469;1575
354800;201706;2392;6831;2008;6254;432;1489;962;2885;1394;4374
354805;201706;1023;3009;748;2410;91;337;240;675;331;1012
354810;201706;558;1782;349;1293;61;255;67;234;128;489
354820;201706;924;3116;773;2783;153;623;174;564;327;1187
354830;201706;463;1208;331;970;108;322;108;297;216;619
354840;201706;717;2034;520;1617;92;292;250;753;342;1045
354850;201706;17307;51559;12743;42540;2407;9095;5925;18409;8332;27504
354860;201706;1342;4109;1109;3723;256;974;385;1166;641;2140
354870;201706;46433;132014;40235;119795;7948;25791;19123;54955;27071;80746
354880;201706;4443;12138;2387;7536;339;1223;770;2065;1109;3288
354890;201706;15608;44459;13087;39901;2640;8786;5956;17426;8596;26212
354900;201706;476;1398;319;1055;52;186;76;234;128;420
354910;201706;6186;18233;3701;12970;671;2625;201;635;872;3260
354920;201706;380;1105;229;777;41;166;45;133;86;299
354925;201706;234;732;127;464;31;118;19;58;50;176
354930;201706;323;834;184;589;24;74;80;256;104;330
354940;201706;1661;5909;1372;5145;473;1902;130;447;603;2349
354950;201706;1464;4512;1221;4089;154;652;694;2207;848;2859
354960;201706;793;2306;655;2093;120;432;304;930;424;1362
354970;201706;3907;12521;3379;11427;557;2151;1807;5860;2364;8011
354980;201706;27640;71789;18650;56003;2951;10250;8086;22325;11037;32575
354990;201706;56518;160349;43903;135894;6755;22799;21987;65441;28742;88240
354995;201706;1925;5639;1575;5063;360;1237;799;2492;1159;3729
355000;201706;1347;4264;1195;3981;297;1119;219;603;516;1722
355010;201706;3376;10377;2516;8297;805;2851;434;1428;1239;4279
355020;201706;3016;9676;2322;8257;777;3027;605;2060;1382;5087
355030;201706;1225793;3232872;990296;2777714;203289;621725;437479;1155171;640768;1776896
355040;201706;2645;7957;2344;7430;392;1319;1459;4570;1851;5889
355050;201706;1070;3145;823;2659;245;789;134;425;379;1214
355060;201706;4520;14370;3643;12544;747;2925;1299;4031;2046;6956
355070;201706;7061;21065;6063;19365;1088;3976;3163;9434;4251;13410
355080;201706;870;2904;605;2284;102;439;35;119;137;558
355090;201706;1094;3624;908;3227;174;645;300;1060;474;1705
355100;201706;16622;50303;13823;45497;3198;11567;7178;22935;10376;34502
355110;201706;1142;3661;962;3327;333;1237;177;581;510;1818
355120;201706;627;1884;482;1599;84;319;190;606;274;925
355130;201706;650;1635;293;864;43;137;86;227;129;364
355140;201706;1186;3778;1092;3618;204;759;643;2159;847;2918
355150;201706;3583;10311;2912;9137;578;1943;1372;4267;1950;6210
355160;201706;1763;5444;1446;4877;407;1502;345;1099;752;2601
355170;201706;8250;23324;6533;20467;2115;6949;2038;6515;4153;13464
355180;201706;2718;8345;2167;7306;506;2035;676;2055;1182;4090
355190;201706;1464;4434;1228;3998;382;1350;417;1442;799;2792
355200;201706;772;2690;700;2530;313;1208;148;490;461;1698
355210;201706;2830;8579;2494;7858;300;1135;1556;4656;1856;5791
355220;201706;37955;112283;31001;98307;9544;32062;8438;24634;17982;56696
355230;201706;1458;3872;852;2605;162;484;193;541;355;1025
355240;201706;24135;68350;16867;53434;3608;12138;5811;18046;9419;30184
355250;201706;30375;91327;24790;80721;6756;23661;8465;26798;15221;50459
355255;201706;877;2382;531;1673;102;339;147;459;249;798
355260;201706;1229;3580;1017;3208;194;704;490;1420;684;2124
355270;201706;1576;4892;1325;4311;272;956;578;1747;850;2703
355280;201706;27764;78383;21980;67007;4099;13689;9173;26657;13272;40346
355290;201706;884;2768;693;2297;160;529;193;596;353;1125
355300;201706;1335;4221;1106;3725;244;883;313;1027;557;1910
355310;201706;1016;2985;802;2606;120;437;416;1360;536;1797
355320;201706;592;1777;509;1611;100;372;198;542;298;914
355330;201706;1926;5757;1426;4768;251;907;687;2208;938;3115
355340;201706;2867;7118;2549;6642;379;979;1620;4195;1999;5174
355350;201706;1327;4323;1023;3648;232;905;295;1033;527;1938
355360;201706;1220;3684;1087;3382;160;514;708;2250;868;2764
355365;201706;337;977;195;684;46;149;33;110;79;259
355370;201706;6898;17609;5383;15611;1241;3813;2342;7183;3583;10996
355380;201706;3137;9188;2463;7761;506;1694;634;1763;1140;3457
355385;201706;1033;3265;927;3052;242;863;339;1043;581;1906
355390;201706;790;2301;603;1910;116;396;221;615;337;1011
355395;201706;1882;5654;1391;4500;216;708;577;1779;793;2487
355400;201706;9297;30042;7941;27219;2423;8960;2075;6725;4498;15685
355410;201706;19132;59267;14793;50566;4118;15383;2878;9895;6996;25278
355420;201706;712;2498;632;2325;171;739;166;599;337;1338
355430;201706;3787;10129;3013;8792;552;1737;1460;4149;2012;5886
355440;201706;882;2664;631;2093;125;422;174;532;299;954
355450;201706;3854;10890;2300;7492;457;1566;649;1948;1106;3514
355460;201706;569;1523;369;1153;63;230;137;367;200;597
355465;201706;347;1102;262;898;54;198;64;201;118;399
355470;201706;942;2721;606;1997;173;578;186;596;359;1174
355475;201706;191;558;182;537;28;106;131;363;159;469
355480;201706;3062;10247;2763;9647;570;2194;1411;4794;1981;6988
355490;201706;1028;2930;636;2058;88;298;207;635;295;933
355495;201706;787;2559;666;2302;144;548;179;596;323;1144
355500;201706;7033;20491;4658;15127;819;2866;936;2846;1755;5712
355510;201706;1876;4959;1022;3238;142;502;277;780;419;1282
355520;201706;424;991;211;583;23;70;102;261;125;331
355530;201706;451;1040;175;525;21;78;41;101;62;179
355535;201706;624;1852;495;1619;144;532;134;373;278;905
355540;201706;8282;25257;7642;24204;1731;5850;4154;12822;5885;18672
355550;201706;751;2296;616;2021;102;369;236;760;338;1129
355560;201706;1174;3519;706;2431;146;546;46;137;192;683
355570;201706;217;689;125;455;23;96;20;67;43;163
355580;201706;1229;3379;834;2627;142;513;324;982;466;1495
355590;201706;217;580;169;494;22;76;93;259;115;335
355600;201706;1374;3898;1016;3154;285;975;319;937;604;1912
355610;201706;1674;4592;1233;3755;208;673;539;1583;747;2256
355620;201706;4491;13688;3586;11609;559;2121;1641;4805;2200;6926
355630;201706;2743;7958;1866;6222;400;1379;548;1866;948;3245
355635;201706;956;2991;816;2761;107;389;532;1846;639;2235
355640;201706;2846;8980;2073;7403;468;1781;351;1233;819;3014
355645;201706;3954;12539;3380;11610;473;1925;2015;6777;2488;8702
355650;201706;7225;21275;6247;19426;1276;4512;3529;10153;4805;14665
355660;201706;1309;3981;1037;3381;155;622;497;1441;652;2063
355670;201706;2973;9138;2149;7123;379;1441;900;2618;1279;4059
355680;201706;1666;5406;1140;4088;286;1096;138;458;424;1554
355690;201706;517;1633;367;1323;113;422;19;44;132;466
355695;201706;248;803;149;526;12;43;17;48;29;91
355700;201706;5709;18159;4852;16230;1248;4236;1887;6166;3135;10402
355710;201706;9600;23647;5749;16603;1148;3533;1574;4237;2722;7770
355715;201706;354;1037;226;740;61;218;45;138;106;356
355720;201706;1478;4793;1225;4241;267;974;430;1341;697;2315
355730;201706;870;2805;732;2476;222;756;205;650;427;1406
410010;201706;1341;4109;1112;3573;258;907;181;574;439;1481
410020;201706;1176;3737;986;3316;289;965;317;1077;606;2042
410030;201706;1147;3770;946;3306;250;906;199;713;449;1619
410040;201706;9853;31494;8444;28821;1947;7334;2662;8946;4609;16280
410045;201706;1063;2931;736;2306;138;487;199;564;337;1051
410050;201706;2718;7287;1731;5420;428;1427;219;611;647;2038
410060;201706;2249;6760;1891;6027;422;1385;731;2330;1153;3715
410070;201706;1729;4798;1307;3957;328;1080;394;1158;722;2238
410080;201706;1423;3993;1105;3404;195;681;443;1293;638;1974
410090;201706;1017;3049;946;2908;168;557;438;1395;606;1952
410100;201706;2648;8049;1972;6412;341;1288;270;820;611;2108
410105;201706;360;1098;227;771;34;143;37;106;71;249
410110;201706;3069;8690;2351;7226;358;1217;756;2238;1114;3455
410115;201706;544;1458;411;1212;77;246;141;380;218;626
410120;201706;2491;8473;2290;8056;872;3251;541;1896;1413;5147
410130;201706;1047;3222;986;3089;363;1251;260;691;623;1942
410140;201706;17654;45245;11399;33996;2314;7558;2424;6721;4738;14279
410150;201706;15851;40345;8421;24998;1622;5156;1337;3757;2959;8913
410160;201706;2937;8889;2613;8275;588;2077;947;3027;1535;5104
410165;201706;713;2079;572;1748;88;282;277;792;365;1074
410170;201706;2290;6484;1699;5149;446;1480;237;685;683;2165
410180;201706;11763;36485;10015;32521;1979;6932;4510;13700;6489;20632
410185;201706;537;1476;398;1204;81;252;96;263;177;515
410190;201706;2072;5980;1654;5090;349;1176;298;847;647;2023
410200;201706;3986;10759;2755;8403;577;2015;437;1276;1014;3291
410210;201706;2662;7766;1888;6043;308;1122;408;1063;716;2185
410220;201706;667;1789;489;1463;73;259;133;401;206;660
410230;201706;1510;4632;1285;4163;264;967;518;1600;782;2567
410240;201706;4348;12955;3870;11949;1193;4171;534;1590;1727;5761
410250;201706;2752;7410;1921;5774;445;1426;391;1169;836;2595
410260;201706;1646;4575;1272;3951;264;918;532;1620;796;2538
410270;201706;573;1576;444;1315;50;166;202;579;252;745
410275;201706;767;2331;514;1717;80;289;212;706;292;995
410280;201706;2147;6190;1537;4891;324;1139;414;1199;738;2338
410290;201706;3398;10089;2763;8847;611;1999;1031;3321;1642;5320
410300;201706;735;2016;582;1699;107;344;247;640;354;984
410302;201706;449;1229;258;836;26;88;135;441;161;529
410304;201706;1250;3891;1127;3622;278;947;458;1492;736;2439
410305;201706;1910;5030;1474;4293;356;1105;668;1906;1024;3011
410310;201706;2308;7206;2015;6683;440;1626;664;2178;1104;3804
410315;201706;706;1951;438;1442;80;284;127;394;207;678
410320;201706;1186;3589;781;2637;111;432;93;287;204;719
410322;201706;579;1683;328;1095;51;171;76;250;127;421
410330;201706;1407;3822;1086;3190;255;793;257;744;512;1537
410335;201706;928;2689;785;2402;127;444;332;920;459;1364
410337;201706;806;2119;575;1680;91;291;199;542;290;833
410340;201706;553;1561;374;1112;56;196;149;370;205;566
410345;201706;2051;5742;1298;4122;300;973;301;914;601;1887
410347;201706;730;1932;529;1554;57;199;156;426;213;625
410350;201706;1171;3451;871;2836;146;516;230;690;376;1206
410360;201706;4047;10600;3154;9018;338;1139;1744;4850;2082;5989
410370;201706;11969;34606;8545;26419;1459;4998;2568;6931;4027;11929
410380;201706;1377;3942;1206;3568;160;594;477;1325;637;1919
410390;201706;2521;7307;1864;5933;571;1926;362;1043;933;2969
410395;201706;949;2989;797;2673;195;734;339;1136;534;1870
410400;201706;4441;13549;3604;11740;706;2479;1309;4085;2015;6564
410405;201706;839;2314;682;2029;165;532;257;734;422;1266
410410;201706;1218;3721;1180;3669;276;1054;627;1871;903;2925
410420;201706;6876;21991;5587;19083;1361;5121;890;2684;2251;7805
410425;201706;2734;8563;2068;7111;388;1435;388;1230;776;2665
410430;201706;14009;37367;10189;30298;1848;6038;2897;8157;4745;14195
410440;201706;3022;10321;2716;9709;523;1927;1369;5155;1892;7082
410442;201706;2630;8595;2296;7852;683;2489;638;2120;1321;4609
410445;201706;2350;7424;1983;6714;481;1774;610;2136;1091;3910
410450;201706;1939;5475;1481;4548;347;1176;212;490;559;1666
410460;201706;1685;4875;1326;4207;354;1190;318;949;672;2139
410465;201706;2333;7459;1937;6596;430;1489;656;2147;1086;3636
410470;201706;1828;5711;1424;4790;314;1171;269;891;583;2062
410480;201706;31752;87717;19160;61583;3116;10883;1657;4717;4773;15600
410490;201706;11603;34614;8550;28090;1845;6659;2306;6995;4151;13654
410500;201706;1588;4885;1227;4054;390;1435;164;463;554;1898
410510;201706;2458;6447;1645;4806;304;894;519;1433;823;2327
410520;201706;3072;10396;2864;9972;801;2868;1274;4502;2075;7370
410530;201706;1556;4277;951;2876;177;564;138;341;315;905
410540;201706;2921;8654;2068;6833;381;1311;726;2467;1107;3778
410550;201706;6407;18326;4505;14187;903;3113;653;1833;1556;4946
410560;201706;1311;3813;1024;3249;256;878;330;957;586;1835
410570;201706;2622;8133;2287;7554;632;2306;563;2019;1195;4325
410580;201706;22768;66525;18445;57972;4156;14533;6065;17702;10221;32235
410590;201706;1375;4212;904;2958;159;557;198;571;357;1128
410600;201706;1850;5310;1463;4549;356;1102;470;1509;826;2611
410610;201706;777;2170;597;1823;72;244;211;610;283;854
410620;201706;1809;5966;1290;4671;324;1268;129;406;453;1674
410630;201706;2455;7270;1676;5482;349;1262;160;425;509;1687
410640;201706;3823;10377;2866;8606;764;2590;436;1211;1200;3801
410645;201706;1134;3798;1051;3656;450;1626;244;907;694;2533
410650;201706;2129;6533;1704;5596;516;1783;315;961;831;2744
410655;201706;1366;4851;1128;4382;62;235;731;3123;793;3358
410657;201706;791;2165;541;1639;117;392;179;471;296;863
410660;201706;3060;8491;1694;5429;330;1086;203;651;533;1737
410670;201706;922;2505;627;1875;117;359;238;684;355;1043
410680;201706;2886;9129;2171;7347;633;2132;483;1739;1116;3871
410685;201706;643;1798;542;1616;93;318;289;819;382;1137
410690;201706;118682;334637;83299;260915;15898;55046;21221;58349;37119;113395
410700;201706;2133;6237;1936;5840;458;1445;837;2397;1295;3842
410710;201706;928;2654;616;1984;133;433;180;524;313;957
410712;201706;809;2381;696;2169;225;767;256;789;481;1556
410715;201706;896;2855;630;2193;133;480;155;533;288;1013
410720;201706;3024;8947;2340;7540;420;1476;402;1145;822;2621
410725;201706;1107;3071;756;2382;129;424;118;333;247;757
410730;201706;518;1475;402;1258;106;358;73;228;179;586
410740;201706;900;2642;640;2113;117;428;251;823;368;1251
410750;201706;1849;5321;1512;4624;306;1015;478;1368;784;2383
410752;201706;319;840;149;461;28;84;38;105;66;189
410753;201706;360;1062;218;730;29;102;36;110;65;212
410754;201706;1211;3368;1041;3097;67;194;639;2099;706;2293
410755;201706;806;1998;587;1636;68;227;314;810;382;1037
410760;201706;2640;7715;2226;6987;584;1990;636;1983;1220;3973
410765;201706;14796;44183;11486;37716;1975;7277;1072;3350;3047;10627
410770;201706;919;2478;645;1949;138;437;155;457;293;894
410773;201706;1351;3780;1201;3559;191;664;837;2408;1028;3072
410775;201706;1446;4072;1305;3859;286;924;443;1279;729;2203
410780;201706;570;1555;374;1131;87;267;100;331;187;598
410785;201706;788;2397;663;2132;175;625;176;525;351;1150
410790;201706;454;1476;386;1299;119;420;36;96;155;516
410800;201706;2941;7198;2329;6186;277;833;925;2362;1202;3195
410810;201706;341;1017;272;881;43;161;112;357;155;518
410820;201706;794;2351;570;1829;129;439;78;244;207;683
410830;201706;30103;83761;23736;72508;6456;21799;7362;21405;13818;43204
410832;201706;1044;2968;895;2667;111;409;504;1409;615;1818
410840;201706;6875;19427;4449;14406;1041;3719;426;1085;1467;4804
410845;201706;1221;3583;1003;3140;202;692;353;1058;555;1750
410850;201706;2653;7844;2321;7261;505;1770;848;2667;1353;4437
410855;201706;582;1602;427;1287;68;224;170;479;238;703
410860;201706;3938;10975;3139;9385;569;1843;976;2779;1545;4622
410865;201706;1481;4790;1401;4646;348;1203;748;2580;1096;3783
410870;201706;1257;3697;1143;3522;113;387;771;2400;884;2787
410880;201706;3719;11613;3078;10281;602;2187;446;1548;1048;3735
410890;201706;932;2975;720;2511;167;639;119;405;286;1044
410895;201706;1073;3631;946;3337;365;1389;173;573;538;1962
410900;201706;935;2549;625;1929;92;299;170;468;262;767
410910;201706;386;993;266;768;25;88;136;360;161;448
410920;201706;841;2326;675;2043;164;563;219;660;383;1223
410930;201706;1579;4682;1298;4097;363;1333;303;896;666;2229
410940;201706;21395;66704;17742;59620;5416;19707;3243;11096;8659;30803
410950;201706;1823;5757;1684;5527;121;454;1304;4239;1425;4693
410960;201706;7756;21088;4848;15578;1350;4745;1112;3467;2462;8212
410965;201706;1075;3119;834;2614;201;654;297;870;498;1524
410970;201706;4209;12286;3243;10375;824;3047;497;1452;1321;4499
410975;201706;1587;4401;1221;3686;229;792;410;1209;639;2001
410980;201706;6323;17562;4206;13407;666;2345;1376;4197;2042;6542
410990;201706;1018;2922;657;2135;193;707;105;267;298;974
411000;201706;477;1436;346;1144;54;200;68;188;122;388
411005;201706;480;1405;306;995;49;179;50;148;99;327
411007;201706;2348;7268;2055;6673;525;1811;593;1900;1118;3711
411010;201706;4072;13473;3639;12498;1028;3753;369;1166;1397;4919
411020;201706;2474;7408;2136;6812;633;2164;626;1929;1259;4093
411030;201706;688;1819;470;1340;85;263;129;324;214;587
411040;201706;774;2186;344;1103;63;211;56;174;119;385
411050;201706;1942;6618;1713;6116;519;1998;231;712;750;2710
411060;201706;1596;4718;1188;3836;246;944;172;500;418;1444
411065;201706;331;965;263;834;57;190;99;319;156;509
411070;201706;6343;18337;5060;15784;1116;3811;1463;4288;2579;8099
411080;201706;2190;6358;1897;5831;470;1591;510;1561;980;3152
411090;201706;834;2156;576;1698;68;235;92;240;160;475
411095;201706;1472;4001;1089;3237;176;574;316;868;492;1442
411100;201706;1174;3415;850;2701;117;442;208;653;325;1095
411110;201706;577;1664;290;987;28;100;19;50;47;150
411120;201706;1602;4784;1209;3894;354;1309;247;676;601;1985
411125;201706;4280;13645;4007;13110;1012;3457;1575;5227;2587;8684
411130;201706;701;2012;512;1612;122;389;144;486;266;875
411140;201706;2246;7391;1893;6566;459;1665;758;2679;1217;4344
411150;201706;3981;11073;2963;9034;651;2187;278;695;929;2882
411155;201706;989;2698;691;2131;85;282;281;809;366;1091
411160;201706;286;804;222;672;46;135;47;152;93;287
411170;201706;754;2318;599;1961;134;458;199;655;333;1113
411180;201706;5620;16352;4559;14323;912;3111;1549;4841;2461;7952
411190;201706;1428;4042;1153;3462;275;889;245;640;520;1529
411200;201706;4507;13050;3521;11275;931;3236;981;3026;1912;6262
411210;201706;2019;5598;1608;4864;428;1453;189;517;617;1970
411220;201706;956;2683;781;2344;172;582;281;770;453;1352
411230;201706;1251;3435;809;2570;179;600;194;598;373;1198
411240;201706;1596;3789;894;2580;129;387;373;1020;502;1407
411250;201706;2021;5875;1645;5185;437;1531;459;1422;896;2953
411260;201706;353;925;223;685;31;98;88;250;119;348
411270;201706;1783;5459;1544;4965;255;952;687;2101;942;3053
411275;201706;1363;3868;1043;3190;225;727;261;735;486;1462
411280;201706;1558;4423;1007;3203;182;650;171;487;353;1137
411290;201706;725;2085;536;1716;113;364;182;577;295;941
411295;201706;994;2725;875;2494;154;488;323;910;477;1398
411300;201706;1197;3043;791;2262;72;229;279;717;351;946
411310;201706;838;2248;661;1944;48;156;217;628;265;784
411320;201706;5130;14716;3712;12024;945;3174;714;2167;1659;5341
411325;201706;1530;4747;1357;4384;258;877;668;2184;926;3061
411330;201706;3062;9343;2495;8190;723;2615;583;1934;1306;4549
411340;201706;801;2386;520;1698;46;180;205;640;251;820
411342;201706;700;1943;569;1680;153;477;171;464;324;941
411345;201706;978;2906;848;2650;184;637;406;1266;590;1903
411350;201706;2814;8254;2060;6684;557;2002;196;622;753;2624
411360;201706;579;1463;401;1171;57;202;138;354;195;556
411370;201706;46478;128494;36678;110345;4864;16851;17236;48252;22100;65103
411373;201706;1426;4253;1222;3893;225;824;387;1246;612;2070
411375;201706;1138;3077;835;2506;158;521;242;664;400;1185
411380;201706;1084;2952;690;2039;114;349;215;580;329;929
411390;201706;1775;5181;1384;4271;268;892;399;1122;667;2014
411400;201706;2188;6016;1739;5116;343;1106;551;1546;894;2652
411410;201706;2112;6302;1594;5131;370;1318;327;928;697;2246
411420;201706;4042;11165;2702;8426;417;1455;414;1032;831;2487
411430;201706;3348;9778;2769;8803;620;2125;1244;3889;1864;6014
411435;201706;494;1504;373;1239;82;283;131;398;213;681
411440;201706;2832;8804;2444;7988;672;2313;549;1888;1221;4201
411450;201706;2513;7321;2148;6690;446;1401;1033;3337;1479;4738
411460;201706;3653;10461;1986;6709;333;1296;153;484;486;1780
411470;201706;789;2328;541;1756;87;307;104;308;191;615
411480;201706;4536;13513;3363;11163;751;2733;575;1772;1326;4505
411490;201706;1459;4259;1184;3745;223;809;319;899;542;1708
411500;201706;1848;4846;1296;3860;235;798;353;1008;588;1806
411510;201706;2034;5963;1680;5238;411;1414;309;963;720;2377
411520;201706;26172;70649;16039;49458;2679;8924;3623;10082;6302;19006
411530;201706;970;2686;685;2157;117;419;225;677;342;1096
411535;201706;476;1433;219;782;22;102;15;35;37;137
411540;201706;3054;8161;2203;6405;460;1456;585;1540;1045;2996
411545;201706;1015;3202;888;2946;111;400;549;1870;660;2270
411550;201706;761;2046;620;1813;150;480;95;264;245;744
411560;201706;2247;6548;1511;4897;228;817;104;264;332;1081
411570;201706;7245;18784;5208;15489;1164;3926;1144;3472;2308;7398
411573;201706;834;2379;764;2264;76;246;484;1432;560;1678
411575;201706;1628;4951;1372;4434;317;1090;397;1259;714;2349
411580;201706;4098;11319;2627;8482;319;1248;334;918;653;2166
411585;201706;818;2568;405;1421;69;251;54;159;123;410
411590;201706;364;1080;301;960;41;137;122;354;163;491
411600;201706;323;889;222;725;48;185;82;259;130;444
411605;201706;1679;4591;1109;3387;179;627;402;1150;581;1777
411610;201706;2236;6238;1696;5131;372;1197;587;1715;959;2912
411620;201706;2876;8679;2584;8205;534;1864;1350;4235;1884;6099
411630;201706;581;1548;376;1200;81;297;48;122;129;419
411640;201706;470;1425;346;1117;47;147;107;335;154;482
411650;201706;220;676;160;552;30;106;24;81;54;187
411660;201706;932;2462;666;1978;72;229;323;929;395;1158
411670;201706;1099;3066;864;2549;156;490;281;780;437;1270
411680;201706;1547;4490;1296;4006;249;861;595;1824;844;2685
411690;201706;3407;9844;2666;8429;580;1897;666;2193;1246;4090
411695;201706;715;2276;547;1873;91;336;178;634;269;970
411700;201706;1644;4676;1133;3648;228;803;154;452;382;1255
411705;201706;1826;6265;1610;5832;391;1396;790;3042;1181;4438
411710;201706;1708;4909;1363;4220;358;1197;214;674;572;1871
411720;201706;933;2565;731;2151;115;363;214;583;329;946
411721;201706;794;2304;626;1940;152;481;95;289;247;770
411722;201706;686;2065;444;1500;90;360;106;282;196;642
411725;201706;1378;4341;862;3050;181;682;149;529;330;1211
411727;201706;1719;5004;1216;3894;331;1092;198;574;529;1666
411729;201706;635;1627;434;1252;100;300;100;240;200;540
411730;201706;5222;14993;4351;13257;1389;4391;1117;3392;2506;7783
411740;201706;644;1816;373;1203;67;245;67;188;134;433
411745;201706;903;2618;697;2167;115;387;171;489;286;876
411750;201706;5096;15000;3935;12404;645;2202;1495;4490;2140;6692
411760;201706;7861;22467;6551;20209;2147;7046;1342;4288;3489;11334
411770;201706;3445;10980;2763;9398;768;2774;409;1345;1177;4119
411780;201706;2945;8796;2663;8280;636;2130;1237;3942;1873;6072
411790;201706;3400;9463;2193;6909;538;1869;381;1128;919;2997
411800;201706;1140;3283;770;2435;103;354;112;322;215;676
411810;201706;1757;4871;1411;4204;246;834;645;1790;891;2624
411820;201706;13080;41909;11001;37445;3763;13300;2672;9265;6435;22565
411830;201706;548;1383;394;1113;104;336;31;97;135;433
411840;201706;10578;29638;7694;23911;1643;5539;1609;4968;3252;10507
411845;201706;497;1501;294;966;50;180;25;68;75;248
411850;201706;7634;22221;6212;19381;1737;5904;1278;3817;3015;9721
411860;201706;890;2685;694;2249;134;459;187;557;321;1016
411870;201706;849;2720;571;1956;106;397;101;316;207;713
411880;201706;2224;6356;1712;5409;449;1583;296;877;745;2460
411885;201706;1009;2778;816;2435;149;542;249;678;398;1220
411890;201706;1169;3516;784;2613;123;475;53;141;176;616
411900;201706;930;2890;603;2072;146;498;62;223;208;721
411910;201706;1158;3697;877;3033;238;872;220;707;458;1579
411915;201706;17900;47521;11172;34429;2079;6940;2441;6779;4520;13719
411920;201706;913;3010;784;2696;226;890;104;291;330;1181
411925;201706;611;1697;408;1321;97;327;95;290;192;617
411930;201706;5751;18889;5057;17474;2329;8715;414;1467;2743;10182
411940;201706;3204;10474;2739;9463;734;2663;553;1766;1287;4429
411950;201706;12688;38993;10809;35367;2297;8071;4755;15255;7052;23326
411960;201706;5526;15935;4977;14894;1022;3358;1916;5483;2938;8841
411965;201706;545;1510;383;1226;75;281;93;301;168;582
411970;201706;823;2197;697;2015;139;378;364;1162;503;1540
411980;201706;1633;4742;1395;4274;336;1093;420;1258;756;2351
411990;201706;34099;103157;25563;85225;6012;22101;6982;22188;12994;44289
411995;201706;2596;7631;2161;6869;622;2246;550;1625;1172;3871
412000;201706;2332;5674;1749;4684;203;668;934;2237;1137;2905
412010;201706;702;2328;537;1924;80;328;126;396;206;724
412015;201706;641;1880;526;1653;85;270;247;783;332;1053
412020;201706;407;1224;254;850;50;175;65;193;115;368
412030;201706;789;2375;558;1884;83;326;172;539;255;865
412033;201706;930;2752;662;2148;91;304;214;749;305;1053
412035;201706;969;2640;605;1966;120;409;204;644;324;1053
412040;201706;615;1829;446;1470;69;240;81;256;150;496
412050;201706;1762;4966;1315;4093;227;810;304;941;531;1751
412060;201706;7125;23575;6364;22046;1879;7032;1643;5621;3522;12653
412065;201706;801;2368;608;1960;122;421;175;537;297;958
412070;201706;1333;3536;985;2816;143;443;400;1118;543;1561
412080;201706;1544;4680;962;3369;120;473;31;89;151;562
412085;201706;445;1283;153;527;17;62;14;36;31;98
412090;201706;4837;14140;4438;13417;958;2928;2322;7223;3280;10151
412100;201706;1857;5592;1487;4874;433;1536;302;989;735;2525
412110;201706;979;2741;689;2120;139;464;144;460;283;924
412120;201706;1697;5655;1436;5051;342;1321;403;1224;745;2545
412125;201706;675;2160;581;1942;134;474;181;592;315;1066
412130;201706;580;1733;448;1425;89;305;89;292;178;597
412135;201706;548;1539;300;929;50;156;94;264;144;420
412140;201706;1629;4648;1226;3831;267;922;218;621;485;1543
412150;201706;3074;8582;2607;7641;303;1007;1580;4484;1883;5491
412160;201706;1236;3909;761;2645;187;725;76;246;263;971
412170;201706;4619;13809;3807;12253;927;3253;1436;4330;2363;7583
412175;201706;1479;4703;1272;4270;261;931;558;1898;819;2829
412180;201706;1739;5149;1308;4316;256;991;492;1459;748;2450
412190;201706;3407;9306;2553;7717;409;1352;891;2809;1300;4161
412200;201706;2109;6582;1533;5138;317;1120;353;1179;670;2299
412210;201706;657;1771;382;1197;80;298;53;133;133;431
412215;201706;3544;10636;3131;9841;774;2430;1574;5166;2348;7596
412217;201706;1104;3062;973;2817;85;301;670;1839;755;2140
412220;201706;5882;18202;5386;17339;1425;4592;2291;7714;3716;12306
412230;201706;2895;9355;2457;8424;492;1885;627;1985;1119;3870
412240;201706;9012;22999;5373;16233;978;3344;1123;3152;2101;6496
412250;201706;1933;5511;1551;4717;361;1176;212;562;573;1738
412260;201706;1335;3686;893;2712;128;433;298;814;426;1247
412265;201706;969;2914;844;2690;225;773;310;991;535;1764
412270;201706;886;2737;597;2020;99;379;202;634;301;1013
412280;201706;628;1921;475;1600;147;513;55;175;202;688
412290;201706;1053;2903;763;2372;131;463;233;675;364;1138
412300;201706;1646;4966;1417;4508;374;1307;287;840;661;2147
412310;201706;968;2815;812;2542;112;461;374;1164;486;1625
412320;201706;833;2226;598;1769;89;341;187;534;276;875
412330;201706;1495;4236;1079;3364;166;553;416;1287;582;1840
412340;201706;976;3001;661;2194;102;370;128;376;230;746
412350;201706;2595;7582;1736;5734;318;1150;58;120;376;1270
412360;201706;298;866;183;588;22;78;56;163;78;241
412370;201706;888;2630;651;2196;136;513;86;292;222;805
412380;201706;1636;4976;1253;4088;310;1044;250;842;560;1886
412382;201706;672;1856;468;1432;70;229;118;330;188;559
412385;201706;2336;6987;2035;6308;722;2285;487;1607;1209;3892
412390;201706;2212;6141;1967;5735;435;1382;860;2537;1295;3919
412395;201706;778;2225;593;1866;63;229;294;888;357;1117
412400;201706;911;2761;724;2333;172;592;157;532;329;1124
412402;201706;1875;5403;1479;4609;290;1016;255;721;545;1737
412405;201706;3475;10027;2158;7023;333;1231;91;241;424;1472
412410;201706;5148;15065;4095;13074;1009;3705;880;2674;1889;6379
412420;201706;422;1221;262;829;42;138;91;242;133;380
412430;201706;556;1542;389;1220;54;192;116;347;170;539
412440;201706;3110;9287;2329;7767;590;2142;472;1573;1062;3715
412450;201706;277;920;210;739;28;90;12;33;40;123
412460;201706;770;2375;651;2110;160;540;161;515;321;1055
412470;201706;1855;6173;1524;5335;461;1703;296;1094;757;2797
412480;201706;1135;3391;771;2474;123;437;97;241;220;678
412490;201706;922;2665;770;2353;148;459;281;821;429;1280
412500;201706;1928;5407;1579;4702;278;918;395;1046;673;1964
412510;201706;2212;7121;1720;5881;475;1741;291;908;766;2649
412520;201706;1474;4202;1068;3318;278;895;129;374;407;1269
412530;201706;574;1668;446;1369;85;283;75;213;160;496
412535;201706;1038;3272;778;2688;100;341;342;1292;442;1633
412540;201706;1250;3476;909;2764;126;455;248;755;374;1210
412545;201706;768;2129;531;1596;87;264;115;306;202;570
412550;201706;31790;94287;22178;72732;4761;16645;5038;15470;9799;32115
412555;201706;251;736;177;572;25;83;42;113;67;196
412560;201706;5418;16437;4109;13440;811;2995;931;2909;1742;5904
412570;201706;4268;12190;2799;9064;580;2084;359;1170;939;3254
412575;201706;869;2631;679;2163;131;446;207;617;338;1063
412580;201706;1335;3610;947;2846;168;568;359;996;527;1564
412590;201706;447;1296;268;909;53;173;32;106;85;279
412600;201706;1439;4310;1077;3487;210;767;309;940;519;1707
412610;201706;776;2308;489;1587;100;333;147;451;247;784
412620;201706;1262;3853;988;3313;258;1012;205;585;463;1597
412625;201706;8817;25385;6445;20585;1211;4260;728;2118;1939;6378
412627;201706;1018;3114;714;2392;205;739;156;516;361;1255
412630;201706;3185;9927;2430;8208;479;1611;686;2220;1165;3831
412635;201706;463;1336;319;1011;60;196;38;95;98;291
412640;201706;969;2831;607;1976;95;346;101;295;196;641
412650;201706;1622;4854;1361;4339;269;983;409;1196;678;2179
412660;201706;2722;7570;2041;6244;376;1281;499;1386;875;2667
412665;201706;641;1649;363;1110;81;261;87;248;168;509
412667;201706;1698;4772;1322;4011;239;815;451;1314;690;2129
412670;201706;547;1667;435;1446;111;403;95;299;206;702
412680;201706;1426;4249;890;3069;147;536;210;689;357;1225
412690;201706;785;2339;615;1983;123;404;142;479;265;883
412700;201706;1922;5566;1574;5024;419;1537;486;1504;905;3041
412710;201706;6432;20236;5437;18139;1183;4324;1378;4224;2561;8548
412720;201706;1426;4391;1029;3414;162;575;183;517;345;1092
412730;201706;2161;6438;1268;4316;266;966;153;492;419;1458
412740;201706;1590;4909;1132;3862;236;886;134;491;370;1377
412750;201706;4207;12343;3700;11476;532;1924;2163;6478;2695;8402
412760;201706;2498;7705;2322;7382;318;1145;1413;4345;1731;5490
412770;201706;10884;29752;6136;19629;845;2916;1027;2907;1872;5823
412780;201706;1314;3927;1104;3513;222;792;441;1328;663;2120
412785;201706;2223;6079;1653;4964;404;1231;678;2078;1082;3309
412788;201706;1455;4493;1236;4042;336;1198;372;1110;708;2308
412790;201706;1088;3226;741;2453;159;581;156;428;315;1009
412795;201706;1043;2860;692;2094;123;391;211;619;334;1010
412796;201706;2647;7983;2369;7427;505;1724;948;2789;1453;4513
412800;201706;3256;9072;2431;7302;376;1276;842;2326;1218;3602
412810;201706;11653;31882;6889;21635;919;3274;1698;4686;2617;7960
412820;201706;7425;21429;5447;17442;1186;4043;1400;4514;2586;8557
412830;201706;369;1111;272;906;42;154;60;195;102;349
412840;201706;1847;5178;1461;4377;242;773;362;1071;604;1844
412850;201706;2916;8363;2297;7219;458;1555;679;2035;1137;3590
412853;201706;1823;5134;1589;4664;155;507;820;2215;975;2722
412855;201706;1408;4092;1047;3249;216;751;207;504;423;1255
412860;201706;1169;3354;911;2832;221;747;305;892;526;1639
412862;201706;756;1916;498;1449;74;239;146;421;220;660
412863;201706;1165;3840;1132;3783;116;423;839;2765;955;3188
412865;201706;741;2156;547;1772;110;377;152;509;262;886
412870;201706;932;2639;736;2301;272;943;118;370;390;1313
412880;201706;831;2449;634;2008;141;503;72;197;213;700
420005;201706;538;1588;316;1073;50;184;106;346;156;530
420010;201706;3250;8825;2547;7818;306;995;1707;5274;2013;6269
420020;201706;633;2029;375;1371;50;231;43;129;93;360
420030;201706;442;1145;224;753;52;211;21;74;73;285
420040;201706;682;2179;405;1541;73;322;28;81;101;403
420050;201706;739;2076;495;1567;105;351;207;637;312;988
420055;201706;196;606;113;401;22;90;22;69;44;159
420060;201706;224;718;153;545;21;94;27;77;48;171
420070;201706;1274;4058;951;3267;178;677;339;1170;517;1847
420075;201706;163;436;86;265;17;57;11;21;28;78
420080;201706;599;1835;478;1590;141;489;116;381;257;870
420090;201706;413;1399;288;1076;74;288;51;204;125;492
420100;201706;1191;3669;1087;3519;194;663;680;2200;874;2863
420110;201706;298;1007;279;963;84;309;83;273;167;582
420120;201706;271;913;217;790;61;257;56;173;117;430
420125;201706;319;1139;290;1079;75;312;130;467;205;779
420127;201706;456;1294;166;596;37;157;15;38;52;195
420130;201706;1917;6371;1540;5583;413;1681;352;1141;765;2822
420140;201706;4208;12464;3099;10292;714;2673;471;1395;1185;4068
420150;201706;540;1514;384;1249;50;193;179;533;229;726
420160;201706;263;692;147;474;26;89;42;127;68;216
420165;201706;225;700;135;469;27;107;32;99;59;206
420170;201706;214;654;132;486;39;172;12;37;51;209
420180;201706;361;1079;198;697;22;79;45;150;67;229
420190;201706;303;998;177;665;35;133;20;66;55;199
420195;201706;1364;4001;1108;3529;290;1014;214;640;504;1654
420200;201706;2669;8111;1635;5792;338;1382;285;919;623;2301
420205;201706;1179;3653;934;3177;175;631;506;1725;681;2356
420207;201706;1542;4478;1062;3505;273;1028;239;739;512;1767
420208;201706;587;1555;322;1097;71;274;112;399;183;673
420209;201706;273;840;171;592;33;128;68;227;101;355
420210;201706;2027;5848;1303;4650;310;1294;467;1554;777;2848
420213;201706;807;2794;744;2654;199;768;354;1277;553;2045
420215;201706;314;988;204;731;54;195;17;68;71;263
420220;201706;175;619;143;552;41;178;40;146;81;324
420230;201706;4252;12509;3221;10634;628;2434;1207;3793;1835;6227
420240;201706;11495;31890;7503;24284;1121;4295;3412;10043;4533;14338
420243;201706;602;1782;473;1530;97;334;154;483;251;817
420245;201706;1316;3794;891;2938;122;471;357;1069;479;1540
420250;201706;509;1617;453;1509;97;377;206;655;303;1032
420253;201706;540;1369;394;1160;39;109;213;647;252;756
420257;201706;294;803;185;604;39;133;79;256;118;389
420260;201706;1168;3707;938;3283;184;715;402;1407;586;2122
420270;201706;683;2003;258;874;33;122;65;193;98;315
420280;201706;2088;5676;1282;4233;275;988;373;1165;648;2153
420285;201706;134;394;66;247;10;42;5;11;15;53
420287;201706;508;1431;406;1275;130;441;122;385;252;826
420290;201706;5863;17535;4025;13309;793;2799;1186;3605;1979;6404
420300;201706;6742;19746;4239;14328;895;3419;808;2442;1703;5861
420310;201706;837;2161;640;1793;81;270;454;1210;535;1480
420315;201706;952;2976;726;2515;206;769;233;797;439;1566
420320;201706;4502;13862;3710;12400;1174;4379;1018;3251;2192;7630
420325;201706;212;714;182;646;35;131;62;214;97;345
420330;201706;970;3254;701;2578;142;570;196;677;338;1247
420340;201706;1417;4282;1031;3414;195;693;76;229;271;922
420350;201706;1479;4287;1062;3433;219;782;457;1429;676;2211
420360;201706;2961;8909;1787;6297;365;1437;162;552;527;1989
420370;201706;1763;4936;1404;4314;158;553;973;2914;1131;3467
420380;201706;5252;15327;3459;11470;793;2840;884;2842;1677;5682
420390;201706;1324;3588;802;2497;141;525;205;433;346;958
420395;201706;1271;3880;862;2957;132;511;93;270;225;781
420400;201706;1194;3531;833;2795;173;665;173;526;346;1191
420410;201706;709;1886;496;1518;81;292;305;909;386;1201
420415;201706;472;1430;344;1141;93;328;89;291;182;619
420417;201706;727;2289;583;1937;117;418;232;763;349;1181
420419;201706;305;988;213;779;71;286;12;45;83;331
420420;201706;10662;31833;8468;27585;2968;10433;1688;5123;4656;15556
420425;201706;1182;3117;782;2370;85;330;314;879;399;1209
420430;201706;3443;10353;2240;7506;487;1766;643;2010;1130;3776
420435;201706;267;786;166;566;35;144;76;242;111;386
420440;201706;827;2499;464;1551;152;558;104;296;256;854
420445;201706;379;1081;246;780;49;159;69;212;118;371
420450;201706;791;2400;551;1866;109;396;132;406;241;802
420455;201706;1977;5680;1625;5052;249;929;744;2179;993;3108
420460;201706;8880;25667;6835;22042;1480;5470;2600;7945;4080;13415
420470;201706;1076;2799;600;1891;114;400;165;460;279;860
420475;201706;101;296;53;189;20;69;6;21;26;90
420480;201706;5001;14202;3580;11511;830;2889;795;2487;1625;5376
420490;201706;651;1694;362;1210;85;309;75;266;160;575
420500;201706;1456;4540;1087;3801;321;1248;324;1113;645;2361
420510;201706;128;455;99;377;22;99;50;182;72;281
420515;201706;79;245;65;223;15;59;18;63;33;122
420517;201706;880;2601;777;2425;82;276;530;1642;612;1918
420519;201706;466;1201;302;911;53;178;77;210;130;388
420520;201706;637;1644;321;1048;47;154;57;148;104;302
420530;201706;1221;3792;879;3045;185;716;211;625;396;1341
420535;201706;268;763;123;418;31;108;12;48;43;156
420540;201706;22853;63746;16000;49570;3470;11801;4387;11853;7857;23654
420543;201706;353;913;280;797;46;105;181;538;227;643
420545;201706;1631;5036;1304;4320;310;1109;386;1223;696;2332
420550;201706;4048;12478;2949;10310;771;3128;585;2004;1356;5132
420555;201706;359;1076;269;896;45;161;96;302;141;463
420560;201706;468;1330;349;1115;61;200;184;573;245;773
420570;201706;2230;6923;1713;5784;399;1512;581;1807;980;3319
420580;201706;1596;4681;1253;4112;298;1124;525;1687;823;2811
420590;201706;3351;9859;2131;7066;434;1583;339;939;773;2522
420600;201706;951;3025;849;2821;156;542;473;1591;629;2133
420610;201706;517;1558;294;1045;70;268;58;199;128;467
420620;201706;561;1710;494;1579;141;479;140;451;281;930
420630;201706;1005;3066;734;2413;171;625;272;819;443;1444
420640;201706;773;2277;378;1361;92;371;26;78;118;449
420650;201706;2545;7356;1644;5534;291;1037;404;1224;695;2261
420660;201706;464;1358;327;1073;62;230;85;263;147;493
420665;201706;698;1957;470;1535;74;285;160;473;234;758
420670;201706;1701;4939;1196;3894;232;913;296;845;528;1758
420675;201706;180;590;136;478;27;117;28;86;55;203
420680;201706;349;881;219;692;38;125;89;270;127;395
420690;201706;870;3016;628;2319;111;449;96;295;207;744
420700;201706;3093;9041;2395;7642;452;1607;828;2496;1280;4103
420710;201706;645;2097;488;1750;124;516;160;525;284;1041
420720;201706;1684;4758;1291;4199;388;1327;537;1725;925;3052
420730;201706;3166;9358;2580;8346;555;1976;1107;3477;1662;5453
420740;201706;828;2510;625;2097;174;632;174;547;348;1179
420750;201706;2097;6688;1555;5447;258;1003;488;1511;746;2514
420757;201706;91;204;32;111;7;30;10;29;17;59
420760;201706;383;1184;190;638;40;136;23;69;63;205
420765;201706;540;1712;278;1032;52;209;54;201;106;410
420768;201706;1218;4038;983;3563;326;1166;425;1623;751;2789
420770;201706;526;1490;279;1007;58;233;56;210;114;443
420775;201706;641;1920;367;1246;76;283;46;136;122;419
420780;201706;1415;4258;848;2913;162;580;135;437;297;1017
420785;201706;260;768;193;611;34;103;47;136;81;239
420790;201706;1233;4139;947;3511;243;972;343;1209;586;2181
420800;201706;905;2522;449;1467;94;337;130;404;224;741
420810;201706;1992;6650;1588;5776;507;2088;331;1096;838;3184
420820;201706;8877;26015;6226;21487;1498;5790;1740;5816;3238;11606
420830;201706;2906;8845;2352;7809;651;2360;757;2495;1408;4855
420840;201706;1005;2921;473;1678;92;360;76;247;168;607
420845;201706;1525;4407;1013;3472;257;1026;226;721;483;1747
420850;201706;1474;4631;890;3304;195;797;70;243;265;1040
420860;201706;400;1124;237;810;62;242;43;142;105;384
420870;201706;1081;3020;846;2643;309;1087;213;598;522;1685
420880;201706;988;3306;772;2742;175;692;136;423;311;1115
420890;201706;9013;24326;4744;15625;798;2897;1061;3075;1859;5972
420895;201706;216;623;114;374;32;112;26;72;58;184
420900;201706;1807;5016;1168;3824;234;885;306;903;540;1788
420910;201706;23591;68558;16274;54377;2915;10981;5188;16025;8103;27006
420915;201706;570;2197;394;1661;79;347;169;664;248;1011
420917;201706;495;1496;225;736;33;117;89;270;122;387
420920;201706;169;487;75;260;10;41;10;26;20;67
420930;201706;18485;51849;14002;44081;2897;10079;5452;16403;8349;26482
420940;201706;2873;8384;2124;6932;552;1988;165;474;717;2462
420945;201706;210;626;135;449;29;108;38;116;67;224
420950;201706;583;1608;295;1019;36;165;64;213;100;378
420960;201706;963;2702;756;2342;146;517;287;822;433;1339
420970;201706;2632;8012;2023;6859;632;2319;364;1244;996;3563
420980;201706;447;1316;348;1167;126;457;122;449;248;906
420985;201706;487;1369;225;792;47;198;59;185;106;383
420990;201706;771;2167;426;1474;81;299;60;177;141;476
421000;201706;558;1877;361;1378;69;280;60;185;129;465
421003;201706;717;1893;256;853;31;106;22;60;53;166
421005;201706;140;429;106;370;28;102;49;186;77;288
421010;201706;5049;14217;3524;11505;808;2947;711;2116;1519;5063
421020;201706;446;1353;325;1140;33;132;193;675;226;807
421030;201706;763;2669;655;2393;213;866;112;380;325;1246
421040;201706;961;2345;588;1767;83;288;295;852;378;1140
421050;201706;1593;4510;935;3085;183;647;223;657;406;1304
421055;201706;214;597;112;365;21;63;25;68;46;131
421060;201706;560;1810;376;1344;85;335;123;423;208;758
421070;201706;674;2116;431;1512;97;376;51;160;148;536
421080;201706;768;3113;689;2994;90;293;525;2463;615;2756
421085;201706;511;1422;250;877;49;188;63;196;112;384
421090;201706;403;1110;192;622;28;99;42;126;70;225
421100;201706;974;2571;505;1584;121;403;55;156;176;559
421105;201706;1521;4503;1217;4004;221;777;472;1638;693;2415
421110;201706;972;3372;883;3169;303;1122;259;878;562;2000
421120;201706;1307;4187;877;3146;120;499;213;665;333;1164
421125;201706;406;1114;301;941;83;284;89;247;172;531
421130;201706;3390;11017;2919;10074;898;3340;1060;3702;1958;7042
421140;201706;336;972;246;785;43;138;94;275;137;413
421145;201706;549;1665;345;1131;54;175;117;373;171;548
421150;201706;618;1755;442;1477;91;360;171;538;262;898
421160;201706;1155;3172;583;1883;110;411;201;600;311;1011
421165;201706;228;763;193;683;28;97;92;339;120;436
421170;201706;1302;3680;1041;3275;176;598;600;1881;776;2479
421175;201706;1216;3398;843;2718;160;613;300;853;460;1466
421180;201706;552;1509;275;924;67;257;48;155;115;412
421185;201706;410;1104;290;883;62;184;121;386;183;570
421187;201706;360;1062;246;798;39;124;91;277;130;401
421189;201706;407;1265;323;1086;67;234;86;273;153;507
421190;201706;11569;32433;7085;23724;1422;5315;1085;3340;2507;8655
421200;201706;908;2928;753;2605;168;624;257;851;425;1475
421205;201706;220;647;159;524;39;157;49;139;88;296
421210;201706;1382;4153;1014;3322;254;851;278;922;532;1773
421220;201706;1726;5815;1512;5312;446;1740;234;715;680;2455
421223;201706;521;1621;374;1326;68;260;138;504;206;764
421225;201706;1135;3597;971;3254;213;784;406;1386;619;2170
421227;201706;955;2756;717;2326;155;574;373;1164;528;1738
421230;201706;478;1513;397;1367;102;373;154;518;256;891
421240;201706;400;1263;208;765;18;88;20;64;38;152
421250;201706;1644;4651;1049;3602;289;1077;209;713;498;1790
421260;201706;356;1003;83;297;14;44;12;42;26;86
421265;201706;781;2322;688;2177;108;394;423;1306;531;1700
421270;201706;754;2066;396;1311;74;248;89;309;163;557
421280;201706;1613;5049;1289;4464;335;1327;522;1748;857;3075
421290;201706;968;2763;570;1849;95;333;100;285;195;618
421300;201706;291;869;216;714;59;241;79;229;138;470
421310;201706;211;646;165;532;31;107;56;176;87;283
421315;201706;326;958;191;660;31;108;23;83;54;191
421320;201706;657;2005;406;1398;73;252;66;172;139;424
421330;201706;608;1942;457;1644;119;454;103;382;222;836
421335;201706;475;1595;399;1439;84;347;82;304;166;651
421340;201706;1755;4904;1376;4287;195;736;733;2237;928;2973
421350;201706;1117;3554;915;3139;158;661;470;1531;628;2192
421360;201706;2829;8007;1779;5948;379;1504;503;1503;882;3007
421370;201706;555;1867;415;1534;120;479;111;398;231;877
421380;201706;925;2652;782;2383;128;419;381;1098;509;1517
421390;201706;184;517;80;268;16;58;27;84;43;142
421400;201706;302;1001;218;844;60;261;73;266;133;527
421410;201706;310;881;186;629;22;83;73;251;95;334
421415;201706;369;1177;159;573;36;142;26;87;62;229
421420;201706;773;2305;590;1916;93;336;245;735;338;1071
421430;201706;197;628;151;537;28;105;37;132;65;237
421440;201706;862;2446;580;1965;113;433;242;813;355;1246
421450;201706;429;1310;262;938;39;163;24;95;63;258
421460;201706;592;1639;315;1113;59;218;71;258;130;476
421470;201706;380;1234;296;1058;68;278;84;282;152;560
421480;201706;3106;8630;2037;6770;688;2664;275;711;963;3375
421490;201706;269;788;125;456;20;79;21;66;41;145
421500;201706;2094;7048;1683;6161;522;2115;201;680;723;2795
421505;201706;360;1158;314;1059;69;242;149;500;218;742
421507;201706;532;1589;353;1217;83;308;82;281;165;589
421510;201706;202;640;158;544;30;121;77;218;107;339
421520;201706;713;1968;457;1390;68;242;183;494;251;736
421530;201706;333;1031;196;706;41;183;37;114;78;297
421535;201706;669;1922;372;1304;42;167;164;525;206;692
421540;201706;337;901;251;760;55;183;90;248;145;431
421545;201706;834;2570;603;2132;142;554;180;622;322;1176
421550;201706;2127;6535;1800;5980;479;1814;654;2047;1133;3861
421555;201706;287;841;95;342;15;64;11;29;26;93
421560;201706;140;433;76;275;14;52;12;47;26;99
421565;201706;805;2352;697;2197;210;736;303;978;513;1714
421567;201706;603;2167;509;1935;256;1014;114;434;370;1448
421568;201706;515;1558;342;1165;71;267;100;335;171;602
421569;201706;235;708;109;394;20;71;17;64;37;135
421570;201706;1374;4104;807;2769;186;668;121;395;307;1063
421575;201706;355;1201;313;1078;60;226;152;506;212;732
421580;201706;3031;9548;2290;7924;532;2113;627;1927;1159;4040
421590;201706;216;654;170;564;24;84;84;270;108;354
421600;201706;465;1413;346;1139;83;286;73;227;156;513
421605;201706;629;1914;461;1597;88;337;130;443;218;780
421610;201706;1389;3739;970;2956;166;566;345;997;511;1563
421620;201706;4506;13411;2941;10184;821;3026;714;2485;1535;5511
421625;201706;375;1032;152;520;27;94;22;73;49;167
421630;201706;3108;9119;1741;5887;325;1224;273;830;598;2054
421635;201706;225;657;118;382;17;67;34;80;51;147
421640;201706;1103;3174;784;2571;165;570;273;883;438;1453
421650;201706;2227;6936;1609;5565;393;1546;200;555;593;2101
421660;201706;7848;25169;6537;22516;1384;5320;2142;6820;3526;12140
421670;201706;1095;3209;740;2416;172;646;213;644;385;1290
421680;201706;1138;3608;927;3160;308;1112;219;725;527;1837
421690;201706;1473;4713;1096;3851;230;911;172;548;402;1459
421700;201706;478;1553;264;997;51;203;64;228;115;431
421710;201706;208;683;92;330;13;52;26;80;39;132
421715;201706;226;600;121;390;28;93;46;139;74;232
421720;201706;1980;5769;1203;4194;315;1214;187;594;502;1808
421725;201706;154;449;110;358;32;117;34;91;66;208
421730;201706;591;1672;288;944;40;134;71;207;111;341
421740;201706;710;2261;486;1706;114;452;92;294;206;746
421750;201706;1014;2644;615;1881;105;344;215;592;320;936
421755;201706;308;883;177;567;36;135;57;165;93;300
421760;201706;974;2938;500;1761;71;259;92;308;163;567
421770;201706;2966;8688;2222;7250;533;1818;711;2434;1244;4252
421775;201706;458;1327;315;1057;59;219;103;331;162;550
421780;201706;1042;3503;783;2885;182;776;203;660;385;1436
421790;201706;818;2140;475;1617;196;716;121;369;317;1085
421795;201706;369;1079;223;705;39;134;64;190;103;324
421800;201706;2727;8090;2039;6785;441;1602;785;2503;1226;4105
421810;201706;682;1981;479;1572;108;403;133;396;241;799
421820;201706;997;2884;590;1990;96;354;73;200;169;554
421825;201706;1469;4511;1368;4324;171;631;939;2855;1110;3486
421830;201706;2527;8436;2220;7815;530;2061;775;2591;1305;4652
421835;201706;163;486;121;424;18;79;77;262;95;341
421840;201706;291;905;204;717;44;176;67;216;111;392
421850;201706;446;1379;257;898;41;163;59;185;100;348
421860;201706;302;919;193;689;35;140;49;149;84;289
421870;201706;3774;10629;2641;8347;725;2507;632;1920;1357;4427
421875;201706;403;1173;184;650;33;124;21;58;54;182
421880;201706;815;2462;606;2017;140;505;118;371;258;876
421885;201706;302;904;237;806;68;240;59;188;127;428
421890;201706;832;2791;701;2528;228;933;218;708;446;1641
421895;201706;394;1209;349;1135;67;239;208;672;275;911
421900;201706;993;2743;633;2004;152;515;193;567;345;1082
421910;201706;474;1460;327;1130;68;286;65;176;133;462
421915;201706;484;1445;299;1003;58;192;47;154;105;346
421917;201706;614;1710;420;1423;124;473;109;354;233;827
421920;201706;684;1931;435;1574;210;778;118;455;328;1233
421930;201706;3069;7940;1621;5375;409;1485;225;661;634;2146
421935;201706;642;2061;482;1705;99;403;174;572;273;975
421940;201706;239;796;145;525;27;125;33;99;60;224
421950;201706;3557;9566;1694;5641;368;1343;217;710;585;2053
421960;201706;183;539;136;458;27;106;26;87;53;193
421970;201706;2355;6366;1360;4306;349;1142;324;943;673;2085
421985;201706;440;1133;238;740;39;149;63;208;102;357
422000;201706;1442;4255;1208;3804;266;949;543;1683;809;2632
430003;201706;599;1896;504;1721;136;521;154;504;290;1025
430005;201706;342;990;236;781;59;206;92;285;151;491
430010;201706;2083;5601;1601;4777;340;1116;744;2202;1084;3318
430020;201706;684;1679;572;1525;85;268;361;921;446;1189
430030;201706;1127;2863;753;2162;211;629;182;522;393;1151
430040;201706;10800;28591;7600;22537;1940;6430;731;1991;2671;8421
430045;201706;705;1880;523;1512;78;231;212;604;290;835
430047;201706;297;695;137;405;18;59;43;125;61;184
430050;201706;1023;2786;581;1833;115;361;135;415;250;776
430055;201706;305;780;147;447;12;38;65;190;77;228
430057;201706;69;171;37;107;7;21;6;9;13;30
430060;201706;17195;53473;14691;49218;4053;14580;5568;18831;9621;33411
430063;201706;997;2853;771;2366;178;547;374;1154;552;1701
430064;201706;1252;3690;962;3109;258;878;286;920;544;1798
430066;201706;169;392;114;305;9;28;62;159;71;187
430070;201706;669;1791;169;567;21;79;16;40;37;119
430080;201706;735;2036;438;1440;99;361;141;414;240;775
430085;201706;961;2432;586;1752;109;353;162;504;271;857
430087;201706;808;2514;711;2327;134;499;353;1081;487;1580
430090;201706;698;1825;255;830;31;119;60;195;91;314
430100;201706;864;2277;447;1419;103;345;121;340;224;685
430105;201706;1054;2997;698;2337;163;619;256;840;419;1459
430107;201706;213;691;157;544;24;88;37;117;61;205
430110;201706;1959;5494;1588;4915;334;1088;743;2200;1077;3288
430120;201706;1667;4989;1158;3869;257;900;454;1550;711;2450
430130;201706;4140;11861;3518;10887;955;2695;1413;5152;2368;7847
430140;201706;1171;3559;780;2657;206;720;243;826;449;1546
430150;201706;742;1959;468;1427;100;338;122;372;222;710
430155;201706;319;880;186;599;25;93;47;138;72;231
430160;201706;17104;48268;14682;44231;3588;11610;5512;16968;9100;28578
430163;201706;2033;5775;1615;5065;239;835;911;2829;1150;3664
430165;201706;474;1165;126;422;16;54;14;35;30;89
430170;201706;963;2742;369;1326;64;246;48;143;112;389
430175;201706;900;2798;750;2441;181;576;320;1085;501;1661
430180;201706;809;2203;674;1970;123;424;372;1024;495;1448
430185;201706;510;1344;305;948;54;186;110;297;164;483
430187;201706;678;1973;539;1682;107;375;204;619;311;994
430190;201706;1594;4767;1378;4333;291;981;667;2049;958;3030
430192;201706;181;550;78;248;8;26;10;26;18;52
430195;201706;391;1189;96;316;9;32;4;11;13;43
430200;201706;1343;4248;1156;3857;342;1174;317;1055;659;2229
430205;201706;545;1516;411;1252;33;121;283;843;316;964
430210;201706;6149;16121;3933;11511;567;1875;1302;3088;1869;4963
430215;201706;348;948;241;731;51;172;90;251;141;423
430220;201706;657;1681;230;766;38;143;44;129;82;272
430222;201706;264;823;214;711;42;154;89;279;131;433
430223;201706;364;998;296;878;57;172;141;424;198;596
430225;201706;35;92;15;47;4;11;5;12;9;23
430230;201706;1512;4424;1444;4341;272;734;1067;3349;1339;4083
430235;201706;268;858;217;740;45;179;69;221;114;400
430237;201706;560;1411;402;1144;41;135;235;627;276;762
430240;201706;1045;2617;721;2103;91;312;372;1040;463;1352
430245;201706;851;2622;666;2236;210;695;254;907;464;1602
430250;201706;1079;3104;967;2928;284;922;82;223;366;1145
430258;201706;160;447;119;376;10;35;50;163;60;198
430260;201706;692;1951;511;1591;89;287;235;763;324;1050
430265;201706;273;839;213;727;50;167;33;117;83;284
430270;201706;2855;7867;2465;7226;332;1110;1497;4261;1829;5371
430280;201706;4856;12778;3851;11037;857;2551;1626;4664;2483;7215
430290;201706;2446;6330;2243;6028;117;364;1914;5098;2031;5462
430300;201706;9208;26488;7624;23476;1681;5584;3342;10334;5023;15918
430310;201706;6952;20335;5357;17291;1111;4006;2175;6604;3286;10610
430320;201706;860;2483;519;1730;107;319;233;819;340;1138
430330;201706;683;1783;517;1465;129;379;214;549;343;928
430340;201706;722;1743;375;1152;74;241;171;508;245;749
430350;201706;6114;18241;5173;16254;1752;5740;1628;4922;3380;10662
430355;201706;410;1025;152;479;28;100;15;42;43;142
430360;201706;996;2645;779;2230;176;543;263;702;439;1245
430367;201706;246;678;158;499;38;145;55;158;93;303
430370;201706;535;1476;330;1063;69;234;68;198;137;432
430380;201706;742;1909;418;1319;121;416;101;319;222;735
430390;201706;3876;10644;2387;7605;399;1428;252;736;651;2164
430400;201706;1362;3229;1003;2646;237;615;459;1171;696;1786
430410;201706;603;1558;422;1243;57;193;231;657;288;850
430420;201706;3530;10127;2770;8404;742;2330;903;2663;1645;4993
430430;201706;671;1816;422;1337;105;363;74;225;179;588
430435;201706;2047;5444;1476;4408;378;1158;405;1214;783;2372
430440;201706;4122;12782;3203;10684;691;2437;1334;4554;2025;6991
430450;201706;6989;19348;5749;16978;1596;4990;1801;5390;3397;10380
430460;201706;28500;83654;22007;72142;5718;20711;6687;21410;12405;42121
430461;201706;514;1346;163;513;21;70;34;97;55;167
430462;201706;295;828;194;654;32;116;37;143;69;259
430463;201706;4242;13277;3603;12075;797;2894;1697;5697;2494;8591
430465;201706;602;1637;506;1465;117;365;264;739;381;1104
430466;201706;3749;9891;3205;9043;703;2143;1644;4421;2347;6564
430467;201706;478;1388;400;1232;75;253;165;470;240;723
430468;201706;1404;3890;1186;3536;250;782;556;1645;806;2427
430469;201706;539;1498;61;205;6;14;13;28;19;42
430470;201706;7746;20566;5465;16764;1649;5378;983;3077;2632;8455
430471;201706;526;1730;475;1617;119;418;155;530;274;948
430480;201706;1025;2733;529;1701;87;298;90;260;177;558
430485;201706;166;476;77;249;14;53;15;38;29;91
430490;201706;322;939;210;701;41;149;84;298;125;447
430495;201706;393;1153;253;861;41;155;85;270;126;425
430500;201706;1151;3138;939;2799;218;725;413;1177;631;1902
430510;201706;22881;64926;17769;54980;4942;16687;5330;15383;10272;32070
430511;201706;380;1176;165;587;31;107;12;31;43;138
430512;201706;1059;2711;907;2452;238;685;268;761;506;1446
430513;201706;809;2081;454;1310;108;343;163;433;271;776
430515;201706;471;1320;337;1051;58;165;149;488;207;653
430517;201706;1172;3652;961;3218;174;609;464;1568;638;2177
430520;201706;1517;4136;915;2856;168;591;201;564;369;1155
430530;201706;1128;2952;470;1454;89;280;110;316;199;596
430535;201706;2584;7580;1953;6343;388;1367;746;2371;1134;3738
430537;201706;457;1505;383;1326;40;156;257;881;297;1037
430540;201706;731;1602;481;1263;81;215;289;758;370;973
430543;201706;507;1225;438;1152;83;203;294;807;377;1010
430544;201706;652;2081;537;1808;119;443;249;792;368;1235
430545;201706;1405;4449;1230;4210;378;1408;526;1803;904;3211
430550;201706;612;1709;351;1136;73;241;65;193;138;434
430558;201706;81;241;51;162;12;42;13;33;25;75
430560;201706;402;958;185;558;14;53;57;162;71;215
430570;201706;1099;2799;719;2076;127;424;313;793;440;1217
430580;201706;1233;3069;787;2337;123;411;352;1039;475;1450
430583;201706;174;457;41;129;5;14;7;25;12;39
430585;201706;302;766;177;514;29;97;74;187;103;284
430587;201706;170;532;132;434;30;105;53;182;83;287
430590;201706;1263;3403;1153;3212;97;313;905;2468;1002;2781
430593;201706;25;95;23;88;5;22;10;36;15;58
430595;201706;310;897;89;311;11;50;13;37;24;87
430597;201706;358;1041;238;741;27;91;67;174;94;265
430600;201706;1939;5228;1007;3092;176;561;270;758;446;1319
430605;201706;1285;3779;986;3169;158;605;402;1269;560;1874
430607;201706;771;1811;565;1506;50;147;357;976;407;1123
430610;201706;7529;19989;5735;17170;1663;5429;1137;3405;2800;8834
430613;201706;276;677;112;348;8;28;30;76;38;104
430620;201706;706;1958;584;1718;153;488;241;677;394;1165
430630;201706;484;1450;173;574;25;89;28;81;53;170
430632;201706;660;1827;317;990;43;144;113;314;156;458
430635;201706;600;1681;455;1384;83;283;247;722;330;1005
430637;201706;486;1364;432;1259;72;238;238;646;310;884
430640;201706;1615;4284;794;2530;104;333;115;331;219;664
430642;201706;477;1233;306;912;55;163;125;379;180;542
430645;201706;281;638;110;305;20;55;29;80;49;135
430650;201706;1783;5683;1519;5135;345;1203;778;2670;1123;3873
430655;201706;163;415;141;372;33;108;68;149;101;257
430660;201706;5480;15185;4388;13239;996;3233;1833;5494;2829;8727
430670;201706;500;1398;446;1302;42;135;311;927;353;1062
430673;201706;736;1721;313;934;70;212;79;235;149;447
430675;201706;237;697;76;263;11;48;18;52;29;100
430676;201706;3774;11010;3065;9697;702;2380;1077;3406;1779;5786
430680;201706;1097;3081;662;2161;133;431;130;404;263;835
430690;201706;4014;11373;3246;9877;1005;3222;733;2225;1738;5447
430692;201706;251;810;190;696;17;76;127;462;144;538
430693;201706;1230;3308;715;2242;155;525;123;353;278;878
430695;201706;571;1528;372;1106;57;194;165;466;222;660
430697;201706;453;1263;324;1028;75;251;126;412;201;663
430700;201706;9605;24386;4952;15766;889;3205;410;1267;1299;4472
430705;201706;277;821;206;651;47;150;57;168;104;318
430710;201706;1716;4302;1292;3570;255;775;537;1477;792;2252
430720;201706;777;1935;512;1521;116;352;166;517;282;869
430730;201706;1621;4188;1039;3207;194;626;431;1374;625;2000
430740;201706;638;1781;359;1184;72;252;73;257;145;509
430745;201706;493;1413;244;798;39;124;40;136;79;260
430750;201706;1541;4158;1153;3487;221;729;585;1735;806;2464
430755;201706;499;1313;327;958;31;102;150;397;181;499
430760;201706;2831;6930;1906;5601;443;1444;733;2231;1176;3675
430770;201706;6395;18254;5092;15861;890;3030;2673;8114;3563;11144
430780;201706;2490;6578;1568;4902;297;995;491;1532;788;2527
430781;201706;434;1280;300;990;69;235;67;220;136;455
430783;201706;545;1318;327;941;46;149;147;389;193;538
430786;201706;78;266;54;212;8;30;11;42;19;72
430790;201706;4594;12571;3150;9636;660;2224;1223;3515;1883;5739
430800;201706;914;2530;623;1896;108;371;263;759;371;1130
430805;201706;562;1548;335;1045;38;115;152;458;190;573
430807;201706;496;1354;331;1021;49;179;106;300;155;479
430810;201706;729;1991;257;894;46;170;50;170;96;340
430820;201706;1422;4026;796;2684;167;581;154;500;321;1081
430825;201706;318;864;131;400;28;79;25;58;53;137
430830;201706;1796;5403;1625;5154;212;743;1107;3509;1319;4252
430840;201706;995;2950;866;2716;214;670;397;1260;611;1930
430843;201706;103;263;35;108;6;16;10;29;16;45
430845;201706;273;785;215;669;91;308;23;58;114;366
430850;201706;2447;7123;2054;6370;523;1757;839;2578;1362;4335
430860;201706;1043;2644;497;1532;93;335;176;499;269;834
430865;201706;596;1568;531;1466;161;473;242;651;403;1124
430870;201706;764;2108;373;1248;74;256;74;227;148;483
430880;201706;1193;3257;834;2551;230;734;242;753;472;1487
430885;201706;249;568;138;403;12;41;99;294;111;335
430890;201706;1646;4380;1101;3306;75;297;180;428;255;725
430900;201706;2752;7120;2114;6029;409;1310;924;2499;1333;3809
430905;201706;1099;3108;712;2292;152;510;153;476;305;986
430910;201706;1654;4811;1105;3587;236;872;389;1113;625;1985
430912;201706;487;1382;358;1150;49;167;215;695;264;862
430915;201706;591;1809;417;1487;114;421;134;517;248;938
430920;201706;18448;54043;15994;49581;2919;9983;8815;26550;11734;36533
430925;201706;140;311;61;169;10;28;20;58;30;86
430930;201706;9802;26820;6593;21013;1780;6061;1403;4740;3183;10801
430940;201706;1257;3816;711;2431;186;676;87;251;273;927
430950;201706;907;2434;606;1826;132;422;235;640;367;1062
430955;201706;187;530;75;242;14;46;14;42;28;88
430957;201706;231;750;193;675;34;108;89;323;123;431
430960;201706;1467;3769;1098;3122;234;749;511;1445;745;2194
430965;201706;1602;4282;1323;3809;89;328;999;2775;1088;3103
430970;201706;392;1080;228;731;34;112;91;280;125;392
430975;201706;559;1832;438;1539;101;375;152;549;253;924
430980;201706;391;997;243;748;50;165;86;260;136;425
430990;201706;586;1818;386;1297;67;246;118;380;185;626
430995;201706;652;1823;475;1476;111;351;204;604;315;955
431000;201706;1592;3969;742;2245;119;388;46;122;165;510
431010;201706;2641;7262;1556;5186;268;1018;154;427;422;1445
431020;201706;10464;25177;6853;19110;1646;4839;1799;4779;3445;9618
431030;201706;335;937;153;528;34;117;17;62;51;179
431033;201706;2611;7836;2272;7302;585;1944;967;3283;1552;5227
431036;201706;217;568;79;249;12;38;14;32;26;70
431040;201706;1039;2810;747;2300;139;511;343;983;482;1494
431041;201706;506;1288;439;1196;108;301;198;556;306;857
431043;201706;477;1299;260;882;98;355;57;175;155;530
431046;201706;127;347;73;217;7;21;19;55;26;76
431050;201706;1657;4159;1192;3397;270;794;528;1506;798;2300
431053;201706;589;1828;458;1544;137;498;110;364;247;862
431055;201706;678;1765;612;1664;56;171;452;1205;508;1376
431057;201706;365;1054;226;746;45;164;54;157;99;321
431060;201706;5444;16129;4708;14816;1544;5198;1179;3824;2723;9022
431065;201706;555;1553;388;1223;67;224;114;340;181;564
431070;201706;629;1813;356;1160;86;289;56;141;142;430
431075;201706;246;764;182;625;34;135;55;189;89;324
431080;201706;683;2043;481;1580;92;314;130;412;222;726
431085;201706;763;2092;606;1752;105;299;340;976;445;1275
431087;201706;531;1516;465;1381;43;127;308;920;351;1047
431090;201706;510;1242;201;618;46;160;39;107;85;267
431100;201706;3350;9056;2694;7982;697;2258;906;2620;1603;4878
431110;201706;1483;3859;1116;3132;272;800;391;1029;663;1829
431112;201706;562;1807;506;1693;116;386;249;817;365;1203
431113;201706;469;1362;372;1169;115;380;107;351;222;731
431115;201706;1352;3849;1144;3483;201;666;619;1853;820;2519
431120;201706;2700;8087;2011;6635;618;2332;567;1691;1185;4023
431123;201706;437;1241;283;921;72;230;127;424;199;654
431125;201706;1333;3947;944;3101;287;973;215;783;502;1756
431127;201706;264;720;61;204;9;25;9;22;18;47
431130;201706;3416;9755;2365;7661;520;1788;695;2265;1215;4053
431140;201706;5180;12594;2866;8543;386;1272;861;2332;1247;3604
431142;201706;492;1404;408;1248;64;210;245;758;309;968
431150;201706;1032;3046;786;2515;172;590;276;892;448;1482
431160;201706;833;2361;672;2061;152;444;252;852;404;1296
431162;201706;559;1385;248;783;28;101;46;122;74;223
431164;201706;167;450;52;177;10;40;5;15;15;55
431170;201706;680;1840;472;1452;136;447;134;395;270;842
431171;201706;758;2188;658;1991;148;479;298;873;446;1352
431173;201706;470;1330;358;1133;138;470;77;241;215;711
431175;201706;1008;2754;798;2374;228;709;205;584;433;1293
431177;201706;768;2433;574;2047;168;658;193;676;361;1334
431179;201706;389;839;95;274;13;41;17;35;30;76
431180;201706;2222;6151;1488;4746;355;1230;274;833;629;2063
431190;201706;575;1573;319;1018;43;145;53;138;96;283
431198;201706;352;1148;312;1068;113;407;85;314;198;721
431200;201706;407;1131;112;387;14;42;0;0;14;42
431205;201706;257;742;111;392;27;90;35;130;62;220
431210;201706;714;1881;602;1720;162;455;290;863;452;1318
431213;201706;252;757;194;650;22;80;103;344;125;424
431215;201706;275;850;175;601;34;126;47;149;81;275
431217;201706;164;489;110;372;24;78;42;144;66;222
431220;201706;824;2246;457;1460;38;140;182;533;220;673
431225;201706;1337;3651;1024;3082;231;704;376;1171;607;1875
431230;201706;788;2298;589;1855;111;389;240;732;351;1121
431235;201706;136;381;37;116;7;22;4;9;11;31
431237;201706;476;1397;381;1241;65;250;188;583;253;833
431238;201706;29;101;23;84;8;35;6;20;14;55
431240;201706;3592;10451;3050;9503;784;2651;1182;3611;1966;6262
431242;201706;378;1110;317;996;82;252;113;374;195;626
431244;201706;367;874;192;547;27;92;70;165;97;257
431245;201706;1233;3189;817;2382;151;472;329;936;480;1408
431247;201706;216;606;136;429;28;89;31;90;59;179
431250;201706;1432;4577;1252;4304;315;1126;497;1764;812;2890
431260;201706;344;959;171;578;21;91;47;140;68;231
431261;201706;259;843;216;742;47;185;84;275;131;460
431262;201706;426;1189;186;621;16;57;94;314;110;371
431265;201706;1427;3573;677;2077;100;328;187;474;287;802
431267;201706;298;841;172;526;10;40;106;299;116;339
431270;201706;2843;6918;1653;4905;410;1322;457;1370;867;2692
431275;201706;226;678;124;451;31;117;14;46;45;163
431280;201706;330;906;116;388;10;34;15;29;25;63
431290;201706;330;1005;243;809;38;142;48;135;86;277
431295;201706;78;222;32;108;2;12;6;13;8;25
431300;201706;388;966;61;230;2;7;3;10;5;17
431301;201706;278;856;90;311;8;25;10;24;18;49
431303;201706;757;1998;446;1352;50;164;145;419;195;583
431306;201706;2245;5761;1358;4138;161;562;398;1073;559;1635
431308;201706;36;123;33;111;17;61;10;32;27;93
431310;201706;723;2121;424;1418;82;284;122;419;204;703
431320;201706;758;2121;380;1279;71;269;56;168;127;437
431330;201706;2529;6277;1281;3990;308;1065;132;354;440;1419
431333;201706;415;1111;154;458;20;51;35;97;55;148
431335;201706;42;125;29;99;8;27;4;8;12;35
431337;201706;2539;7554;1826;6157;448;1636;267;920;715;2556
431339;201706;549;1489;381;1150;73;239;199;584;272;823
431340;201706;23315;61392;16932;50225;3869;12543;4052;11615;7921;24158
431342;201706;548;1327;409;1104;92;285;252;642;344;927
431344;201706;370;998;251;772;7;24;176;537;183;561
431346;201706;297;753;115;353;18;54;20;59;38;113
431349;201706;749;2052;434;1309;65;206;154;422;219;628
431350;201706;4106;11828;3257;10232;797;2781;1057;3112;1854;5893
431360;201706;660;1654;406;1219;95;288;130;387;225;675
431365;201706;1528;4408;1300;4028;204;678;761;2393;965;3071
431370;201706;4896;13520;3793;11610;927;2998;1459;4638;2386;7636
431380;201706;829;2564;761;2434;109;388;432;1369;541;1757
431390;201706;2776;7302;1635;5126;304;1073;421;1185;725;2258
431395;201706;1229;3607;990;3180;251;838;389;1264;640;2102
431400;201706;412;1266;198;659;31;98;41;135;72;233
431402;201706;1101;2662;701;1947;125;370;367;960;492;1330
431403;201706;193;575;163;523;46;172;64;181;110;353
431405;201706;4228;11663;3443;10493;582;1999;1852;5561;2434;7560
431406;201706;623;1906;486;1639;103;358;262;883;365;1241
431407;201706;544;1524;365;1170;81;272;122;361;203;633
431410;201706;14590;41295;9833;31905;2568;9325;1889;5863;4457;15188
431413;201706;206;505;76;247;8;32;13;35;21;67
431415;201706;705;1996;498;1612;114;418;147;428;261;846
431417;201706;535;1351;444;1216;65;197;268;709;333;906
431420;201706;1347;3577;1168;3295;230;675;519;1542;749;2217
431430;201706;585;1513;345;1046;62;208;97;262;159;470
431440;201706;22610;61284;17800;53557;5081;16200;5033;16227;10114;32427
431442;201706;124;377;75;256;14;47;4;12;18;59
431445;201706;497;1405;186;618;23;75;42;136;65;211
431446;201706;393;1165;288;913;77;260;71;217;148;477
431447;201706;583;1629;432;1342;75;229;201;613;276;842
431449;201706;785;2125;569;1694;50;155;279;823;329;978
431450;201706;2144;5081;1858;4673;200;596;1364;3284;1564;3880
431454;201706;61;206;53;185;11;41;21;77;32;118
431455;201706;704;1781;366;1038;65;189;118;302;183;491
431460;201706;3112;8447;2557;7389;662;1945;813;2427;1475;4372
431470;201706;1755;5019;1273;3984;267;847;432;1373;699;2220
431475;201706;202;598;36;144;4;19;1;1;5;20
431477;201706;708;1835;453;1311;56;165;201;532;257;697
431478;201706;257;656;83;244;12;37;9;19;21;56
431480;201706;3204;8624;2485;7414;449;1481;1178;3440;1627;4921
431490;201706;109481;292421;93615;268380;11176;37463;63769;178184;74945;215647
431500;201706;571;1561;443;1298;90;248;231;673;321;921
431505;201706;500;1214;329;946;34;98;192;557;226;655
431507;201706;374;900;192;539;39;116;87;225;126;341
431510;201706;1833;5124;1414;4280;296;977;513;1485;809;2462
431513;201706;327;858;163;496;21;61;86;258;107;319
431514;201706;98;267;46;149;6;22;10;23;16;45
431515;201706;585;1598;389;1194;86;292;156;443;242;735
431517;201706;75;259;57;208;11;42;13;41;24;83
431520;201706;524;1305;232;740;44;169;37;104;81;273
431530;201706;4175;9709;2901;7998;817;2363;590;1662;1407;4025
431531;201706;235;675;176;558;24;85;54;151;78;236
431532;201706;508;1389;401;1157;90;264;138;403;228;667
431535;201706;314;810;142;435;30;105;48;128;78;233
431540;201706;2078;6738;1873;6417;137;560;1281;4475;1418;5035
431545;201706;362;1004;61;208;3;11;17;61;20;72
431550;201706;2175;6306;1869;5729;408;1357;764;2223;1172;3580
431555;201706;683;1664;476;1319;57;159;277;779;334;938
431560;201706;20910;59908;14667;48298;3130;11552;3419;11880;6549;23432
431570;201706;5955;14819;4686;13118;1077;3208;2287;6363;3364;9571
431575;201706;357;983;275;839;46;162;39;91;85;253
431580;201706;604;1713;340;1140;74;275;91;292;165;567
431590;201706;946;2482;584;1775;122;388;175;535;297;923
431595;201706;411;1157;292;892;44;139;140;404;184;543
431600;201706;1956;5319;1445;4441;326;1145;312;940;638;2085
431610;201706;1421;3934;1035;3201;130;401;458;1441;588;1842
431620;201706;477;1363;228;714;45;132;98;281;143;413
431630;201706;1366;3681;767;2382;204;669;189;536;393;1205
431640;201706;6366;17253;5713;16339;948;2813;3586;10402;4534;13215
431642;201706;531;1389;369;1083;46;140;154;436;200;576
431643;201706;353;901;155;447;23;63;44;111;67;174
431645;201706;1669;4649;1399;4173;215;722;845;2506;1060;3228
431647;201706;137;406;91;300;10;35;18;50;28;85
431650;201706;314;948;221;735;41;155;59;180;100;335
431660;201706;1007;2846;617;2034;108;397;123;346;231;743
431670;201706;1247;3242;931;2696;177;593;404;1086;581;1679
431673;201706;250;675;97;337;24;84;9;23;33;107
431675;201706;733;1878;151;520;17;65;41;129;58;194
431680;201706;9099;24899;6977;20834;1892;5945;1935;5830;3827;11775
431690;201706;22558;62189;17663;53887;4742;15365;5554;17328;10296;32693
431695;201706;151;437;107;345;21;74;32;76;53;150
431697;201706;478;1296;411;1185;99;299;184;544;283;843
431700;201706;1509;4227;1307;3854;200;605;713;2074;913;2679
431710;201706;12089;34558;10133;31476;3145;10386;2860;9740;6005;20126
431720;201706;6908;18980;5061;15238;1130;3606;1125;3180;2255;6786
431725;201706;30;84;18;59;2;7;5;15;7;22
431730;201706;3696;10592;2957;9306;789;2693;796;2693;1585;5386
431740;201706;5096;13738;3930;11688;1259;4160;641;1678;1900;5838
431750;201706;8447;23711;7259;21771;1709;5521;3079;9308;4788;14829
431755;201706;330;905;69;238;11;34;9;30;20;64
431760;201706;4268;11575;3372;10000;508;1702;1769;4983;2277;6685
431770;201706;1941;5147;1635;4703;263;796;987;2791;1250;3587
431775;201706;193;526;109;347;24;82;10;25;34;107
431780;201706;2162;5846;1572;4688;369;1144;410;1171;779;2315
431790;201706;1164;3388;899;2822;176;587;318;976;494;1563
431795;201706;378;1009;229;691;40;123;61;180;101;303
431800;201706;8364;24066;6624;20847;2164;7379;829;2591;2993;9970
431805;201706;336;819;101;335;9;33;24;84;33;117
431810;201706;3159;8390;2355;6802;463;1475;956;2605;1419;4080
431820;201706;2497;7582;2151;6921;468;1642;925;2926;1393;4568
431830;201706;11011;26215;8522;22599;2033;5886;3430;9082;5463;14968
431840;201706;2517;7509;2175;6892;465;1586;1084;3474;1549;5060
431842;201706;770;1949;267;832;38;128;64;174;102;302
431843;201706;353;1009;283;879;39;144;126;365;165;509
431844;201706;285;774;79;257;22;81;12;26;34;107
431845;201706;497;1409;359;1106;22;69;215;661;237;730
431846;201706;318;942;270;868;28;109;199;631;227;740
431848;201706;234;620;126;399;7;25;17;41;24;66
431849;201706;474;1142;91;255;13;33;15;31;28;64
431850;201706;4602;13383;3879;11871;855;2791;1272;3822;2127;6613
431860;201706;798;2095;551;1626;89;294;258;711;347;1005
431861;201706;106;304;55;191;7;24;16;45;23;69
431862;201706;489;1577;397;1411;74;287;179;636;253;923
431870;201706;18269;52669;14879;46407;3269;11133;5608;17263;8877;28396
431880;201706;4114;11920;3294;10290;743;2586;1212;3614;1955;6200
431890;201706;4900;13227;3411;10451;1009;3329;613;1969;1622;5298
431900;201706;1141;3097;723;2240;161;564;290;836;451;1400
431910;201706;959;2316;448;1273;54;147;120;321;174;468
431912;201706;469;1379;390;1224;84;266;194;617;278;883
431915;201706;1222;3297;930;2790;230;739;345;1011;575;1750
431920;201706;1307;3498;1127;3209;119;368;810;2282;929;2650
431930;201706;1099;3061;791;2525;180;557;388;1271;568;1828
431935;201706;65;215;54;192;14;52;12;39;26;91
431936;201706;331;987;223;727;57;202;67;215;124;417
431937;201706;282;759;164;507;40;133;18;47;58;180
431940;201706;2479;6655;1572;4804;342;1113;425;1232;767;2345
431950;201706;1620;4812;1437;4492;271;927;724;2211;995;3138
431960;201706;2758;7712;2345;6898;638;1968;694;1986;1332;3954
431970;201706;421;1166;199;666;48;161;46;137;94;298
431971;201706;103;289;63;214;9;33;11;32;20;65
431973;201706;464;1558;398;1428;40;137;272;997;312;1134
431975;201706;114;270;27;95;4;15;2;5;6;20
431980;201706;1354;3898;1073;3346;256;838;366;1097;622;1935
431990;201706;6936;18694;4851;15344;901;3200;1425;4444;2326;7644
432000;201706;10251;28264;8253;24810;2460;7573;2898;8855;5358;16428
432010;201706;2150;5919;1724;5154;251;833;840;2440;1091;3273
432020;201706;2273;5347;1649;4471;362;1091;895;2330;1257;3421
432023;201706;520;1380;308;931;50;178;136;348;186;526
432026;201706;1133;3427;856;2831;127;417;444;1458;571;1875
432030;201706;372;1049;266;814;54;172;112;323;166;495
432032;201706;520;1378;360;1064;43;149;159;436;202;585
432035;201706;821;2429;724;2257;243;836;202;620;445;1456
432040;201706;1029;2454;490;1517;67;236;166;500;233;736
432045;201706;263;719;139;464;31;112;38;130;69;242
432050;201706;591;1630;504;1478;114;354;221;663;335;1017
432055;201706;925;2528;629;1964;156;540;240;712;396;1252
432057;201706;394;964;277;756;44;106;139;362;183;468
432060;201706;483;1256;184;599;30;123;49;132;79;255
432065;201706;236;668;180;566;44;137;59;184;103;321
432067;201706;896;2706;688;2258;125;395;315;1026;440;1421
432070;201706;2379;6457;1505;4704;272;926;306;914;578;1840
432080;201706;3859;10591;3220;9483;890;2918;1153;3318;2043;6236
432085;201706;324;899;216;725;58;196;90;300;148;496
432090;201706;1497;4180;1168;3560;338;1094;423;1238;761;2332
432100;201706;1369;3905;614;2100;96;357;38;104;134;461
432110;201706;2503;7431;1821;6017;433;1666;155;459;588;2125
432120;201706;4194;12289;3462;10979;1209;4082;814;2563;2023;6645
432130;201706;2774;7521;2253;6856;727;2388;846;2602;1573;4990
432132;201706;308;868;153;520;27;98;38;117;65;215
432135;201706;760;2179;601;1848;96;319;368;1110;464;1429
432140;201706;1843;5794;1436;5012;300;1080;599;2174;899;3254
432143;201706;1353;3916;1122;3528;200;681;545;1748;745;2429
432145;201706;1384;4154;871;2956;144;542;133;422;277;964
432146;201706;177;551;121;420;37;138;25;78;62;216
432147;201706;598;1931;467;1639;142;535;90;321;232;856
432149;201706;381;1038;238;712;29;84;102;299;131;383
432150;201706;3642;10156;2737;8483;619;2151;757;2273;1376;4424
432160;201706;4391;13656;3795;12602;1171;4099;1174;3962;2345;8061
432162;201706;379;918;59;188;12;43;8;26;20;69
432163;201706;294;814;67;216;6;20;2;8;8;28
432166;201706;626;1839;498;1569;90;340;187;509;277;849
432170;201706;1230;3711;850;2909;197;712;171;566;368;1278
432180;201706;2547;6838;1494;4619;355;1160;264;709;619;1869
432183;201706;401;1267;305;1039;103;379;53;177;156;556
432185;201706;894;2369;606;1822;67;200;328;963;395;1163
432190;201706;2971;7975;1888;5690;412;1289;548;1569;960;2858
432195;201706;1063;2810;731;2243;182;532;252;785;434;1317
432200;201706;2959;8813;2388;7813;575;2061;1029;3337;1604;5398
432210;201706;398;1100;286;903;57;206;107;315;164;521
432215;201706;813;2463;702;2282;121;386;398;1340;519;1726
432218;201706;275;696;161;451;26;67;55;133;81;200
432220;201706;4244;10857;3306;9346;480;1552;1824;4920;2304;6472
432225;201706;108;318;85;272;23;71;29;98;52;169
432230;201706;1012;2678;592;1778;106;337;154;403;260;740
432232;201706;532;1448;409;1223;70;246;178;510;248;756
432234;201706;368;981;224;675;40;119;39;103;79;222
432235;201706;112;322;40;138;6;22;3;7;9;29
432237;201706;445;1178;389;1081;15;58;266;701;281;759
432240;201706;13946;42277;11749;39230;1404;5705;7125;24506;8529;30211
432250;201706;4684;15756;4223;14819;1262;4706;1394;5040;2656;9746
432252;201706;466;1184;308;920;53;170;143;423;196;593
432253;201706;1269;3969;728;2548;165;642;39;121;204;763
432254;201706;929;2498;257;834;51;189;21;53;72;242
432255;201706;206;522;111;355;17;63;36;100;53;163
432260;201706;7488;18448;5280;14851;1168;3369;2039;6021;3207;9390
432270;201706;2533;7502;2141;6767;626;2086;471;1505;1097;3591
432280;201706;1436;3837;764;2411;111;351;200;594;311;945
432285;201706;198;614;25;83;2;5;3;6;5;11
432290;201706;494;1442;302;1000;78;249;70;218;148;467
432300;201706;24037;69929;20829;64391;3555;12051;11764;35735;15319;47786
432310;201706;789;2296;619;2003;139;457;294;962;433;1419
432320;201706;209;524;86;272;16;48;12;35;28;83
432330;201706;315;830;117;392;13;40;18;64;31;104
432335;201706;167;477;71;250;12;47;13;36;25;83
432340;201706;366;889;188;570;37;132;53;144;90;276
432345;201706;646;1733;596;1657;73;272;389;1003;462;1275
432350;201706;377;1009;196;631;34;99;53;169;87;268
432360;201706;196;602;38;138;4;16;8;24;12;40
432370;201706;412;1121;300;896;30;99;173;517;203;616
432375;201706;717;1798;532;1486;77;215;291;803;368;1018
432377;201706;238;799;38;143;7;31;9;19;16;50
432380;201706;1118;3458;790;2746;199;768;317;1042;516;1810
500020;201706;2370;6638;1797;5689;393;1450;710;2153;1103;3603
500025;201706;1447;3350;856;2343;87;255;472;1274;559;1529
500060;201706;7002;20589;5472;17895;771;2579;3283;11160;4054;13739
500070;201706;4360;12289;3405;10601;757;2634;1271;4030;2028;6664
500080;201706;1452;4144;1059;3422;249;897;387;1217;636;2114
500085;201706;2184;5422;1494;4424;136;434;918;2675;1054;3109
500090;201706;2320;6548;1615;5244;321;1092;614;2115;935;3207
500100;201706;3157;8696;2543;7639;463;1555;1033;2948;1496;4503
500110;201706;8049;23529;6290;20756;1207;4269;2620;9341;3827;13610
500124;201706;2122;6693;1832;6198;452;1454;892;3381;1344;4835
500150;201706;1396;3487;907;2662;159;544;314;780;473;1324
500190;201706;5162;12966;3942;11339;837;2569;2009;5924;2846;8493
500200;201706;2544;6270;1865;5081;384;1116;765;1906;1149;3022
500210;201706;4786;13873;3888;12457;891;3023;1696;5497;2587;8520
500215;201706;1396;4230;1055;3558;169;626;407;1356;576;1982
500220;201706;3143;9351;2486;8213;448;1558;1053;3536;1501;5094
500230;201706;3002;7540;2112;6136;348;1080;1023;2995;1371;4075
500240;201706;4460;13746;3176;11094;562;2214;855;3174;1417;5388
500260;201706;3064;7206;1956;5553;263;785;962;2637;1225;3422
500270;201706;123732;317598;77911;235461;17290;56423;17758;52704;35048;109127
500280;201706;1377;3496;1069;3071;92;285;748;2165;840;2450
500290;201706;4421;9826;2484;7069;432;1360;832;2357;1264;3717
500295;201706;2628;7413;1530;4972;226;811;392;1068;618;1879
500310;201706;845;2201;683;1975;130;417;355;997;485;1414
500315;201706;3269;10027;2676;9044;382;1316;1600;5663;1982;6979
500320;201706;18272;56591;13834;48337;3845;14587;3577;13333;7422;27920
500325;201706;4545;11128;3138;9013;488;1522;1729;5019;2217;6541
500330;201706;6997;17797;4750;13789;556;1783;2266;6609;2822;8392
500345;201706;2165;5465;1612;4682;412;1259;657;1888;1069;3147
500348;201706;2250;6456;1939;5975;182;697;1270;3825;1452;4522
500350;201706;1317;3822;718;2429;74;254;229;807;303;1061
500370;201706;22655;66877;16896;56509;3572;13389;5270;17866;8842;31255
500375;201706;2914;7943;2091;6326;402;1338;559;1654;961;2992
500380;201706;3551;9418;2661;7908;636;2013;994;2971;1630;4984
500390;201706;553;1241;319;877;48;149;153;408;201;557
500400;201706;1343;4004;985;3163;230;777;242;726;472;1503
500410;201706;2234;6265;1818;5658;297;957;1058;3405;1355;4362
500430;201706;2792;7513;2017;6376;370;1333;754;2510;1124;3843
500440;201706;1466;3770;940;2855;164;508;362;1137;526;1645
500450;201706;1355;3908;883;2964;190;699;126;357;316;1056
500460;201706;4094;11662;2787;9111;661;2401;523;1703;1184;4104
500470;201706;2992;8529;2054;6570;562;1952;325;936;887;2888
500480;201706;2326;6877;2133;6626;178;535;1626;5381;1804;5916
500490;201706;973;2588;714;2163;185;643;157;494;342;1137
500500;201706;3933;11541;3019;10152;1050;4027;708;2434;1758;6461
500510;201706;865;2215;535;1607;52;183;258;722;310;905
500515;201706;2118;5344;1685;4730;195;539;1041;3091;1236;3630
500520;201706;3331;11234;2846;10257;469;1989;1560;5516;2029;7505
500525;201706;1195;3659;965;3249;178;672;425;1480;603;2152
500540;201706;6448;17142;3694;12020;858;3299;378;1071;1236;4370
500560;201706;5080;15836;4492;14935;414;1468;3274;11094;3688;12562
500568;201706;4225;10176;2781;8017;651;2297;739;1896;1390;4193
500570;201706;7647;19588;4647;14093;1182;3852;749;2211;1931;6063
500580;201706;3712;10262;2958;9043;360;1129;1866;5775;2226;6904
500600;201706;4064;10525;2616;7922;589;1958;699;2078;1288;4036
500620;201706;8015;22432;5798;18128;915;3061;2504;7979;3419;11040
500625;201706;713;2009;392;1275;73;271;130;399;203;670
500627;201706;733;1934;481;1479;92;283;110;339;202;622
500630;201706;5926;15588;3934;12139;963;3162;1108;3401;2071;6563
500635;201706;2714;9836;2224;9092;255;1058;1559;6879;1814;7937
500640;201706;1698;4016;1262;3386;72;236;884;2299;956;2535
500660;201706;19607;55634;14995;48215;4536;16075;3989;13060;8525;29135
500690;201706;2458;7209;1929;6365;917;3260;281;951;1198;4211
500710;201706;3443;9930;2770;8748;665;2338;927;2885;1592;5223
500720;201706;6239;16220;3873;12201;981;3468;656;1981;1637;5449
500730;201706;1002;2715;668;2077;141;481;192;557;333;1038
500740;201706;4618;12078;3448;9963;340;1174;1753;5110;2093;6284
500750;201706;1012;2706;808;2350;138;444;368;1010;506;1454
500755;201706;1171;3320;779;2540;152;517;134;343;286;860
500769;201706;5616;14644;3060;9433;507;1761;565;1416;1072;3177
500770;201706;1749;4925;1154;3773;215;766;343;1118;558;1884
500780;201706;1326;3654;943;2906;236;743;215;670;451;1413
500790;201706;9763;25976;8038;23203;1533;4902;4144;11804;5677;16706
500793;201706;2188;6128;1601;5089;470;1542;246;691;716;2233
500795;201706;2405;6886;2040;6371;218;574;1481;4967;1699;5541
500797;201706;828;2201;556;1703;106;354;179;535;285;889
500800;201706;3081;7915;2233;6675;770;2633;424;1321;1194;3954
500830;201706;20475;53207;14109;41551;2540;8202;5232;14763;7772;22965
500840;201706;1374;3727;882;2747;107;363;300;872;407;1235
510010;201706;1313;3727;1037;3269;265;846;488;1583;753;2429
510020;201706;3589;9822;2118;6856;431;1466;420;1249;851;2715
510025;201706;7362;20821;5123;16452;1070;3727;1386;4208;2456;7935
510030;201706;1740;4476;1386;3979;267;830;672;1892;939;2722
510035;201706;1020;2845;695;2341;127;417;385;1386;512;1803
510040;201706;1890;4871;1454;4236;177;547;835;2429;1012;2976
510050;201706;1896;5360;1390;4411;345;1224;462;1375;807;2599
510060;201706;1600;4396;1198;3650;195;649;516;1506;711;2155
510080;201706;1015;3235;823;2840;235;924;133;371;368;1295
510100;201706;710;1818;483;1376;45;148;223;582;268;730
510120;201706;312;645;201;503;11;28;131;332;142;360
510125;201706;3015;7716;2256;6407;373;1261;857;2243;1230;3504
510130;201706;1699;4684;1378;4127;350;1119;397;1184;747;2303
510140;201706;2932;8959;2240;7986;921;3738;511;1622;1432;5360
510160;201706;1283;4239;1148;4015;228;855;686;2400;914;3255
510170;201706;5147;15261;4134;13515;807;2871;1797;5801;2604;8672
510180;201706;12765;32596;8583;25829;2416;7833;2106;7265;4522;15098
510185;201706;1600;4335;1170;3733;269;811;585;2192;854;3003
510190;201706;2531;6822;1737;5630;378;1331;717;2392;1095;3723
510250;201706;14413;41811;12391;38890;3095;10400;5810;18876;8905;29276
510260;201706;2195;8972;1781;8136;299;1328;953;5040;1252;6368
510263;201706;4021;10952;2818;8878;646;2202;508;1546;1154;3748
510267;201706;5777;16760;3890;12666;897;3087;797;2579;1694;5666
510268;201706;1306;3457;978;2894;139;443;554;1612;693;2055
510269;201706;1042;3116;711;2424;251;945;140;424;391;1369
510270;201706;2886;9139;2320;8005;529;1834;815;2753;1344;4587
510279;201706;1764;5326;1406;4581;339;1190;476;1431;815;2621
510285;201706;1169;3336;868;2826;247;855;237;760;484;1615
510300;201706;3611;9963;2900;8973;247;797;2048;6485;2295;7282
510305;201706;1482;4549;1119;3854;241;849;355;1305;596;2154
510310;201706;779;2246;623;1987;203;679;194;625;397;1304
510320;201706;3919;10920;2958;9194;506;1802;1000;3008;1506;4810
510325;201706;5147;15796;4298;14648;1084;3821;2372;8495;3456;12316
510330;201706;2819;8970;2171;7814;546;2050;783;3079;1329;5129
510335;201706;5115;15129;4044;13698;489;1682;2640;9522;3129;11204
510336;201706;587;1773;438;1489;72;252;210;731;282;983
510337;201706;1909;6084;1473;5273;569;2158;279;1053;848;3211
510340;201706;78664;204878;53775;165453;17058;59052;9637;30342;26695;89394
510343;201706;1109;3166;806;2560;143;477;325;1001;468;1478
510345;201706;1593;4687;1222;4000;267;912;421;1346;688;2258
510350;201706;3191;8545;2363;7355;586;1913;912;2939;1498;4852
510360;201706;1842;4308;1166;3494;92;370;818;2436;910;2806
510370;201706;1524;4840;1196;4275;213;801;666;2499;879;3300
510380;201706;536;1514;299;1023;83;306;31;110;114;416
510385;201706;986;3700;704;3060;85;414;335;1597;420;2011
510390;201706;1073;3383;933;3126;261;818;436;1587;697;2405
510395;201706;807;1911;569;1544;66;198;262;765;328;963
510410;201706;4031;12651;3370;11391;843;2909;1598;5687;2441;8596
510420;201706;2487;6064;1798;4986;193;640;941;2556;1134;3196
510450;201706;719;1853;472;1435;110;371;77;225;187;596
510452;201706;707;2196;498;1745;93;332;232;806;325;1138
510454;201706;882;2716;720;2402;123;451;405;1375;528;1826
510455;201706;974;2963;720;2396;135;514;242;739;377;1253
510460;201706;2361;6043;1724;5136;182;648;949;2735;1131;3383
510480;201706;4413;11215;3170;9037;501;1538;1313;3534;1814;5072
510490;201706;1570;4856;1312;4458;315;1161;615;2059;930;3220
510500;201706;1513;4415;1020;3442;194;782;438;1431;632;2213
510510;201706;2877;9602;2392;8685;711;2826;580;2220;1291;5046
510515;201706;6436;18237;4302;13940;922;3252;998;2934;1920;6186
510517;201706;1542;4525;1236;3967;367;1234;228;712;595;1946
510520;201706;2223;4849;1477;3908;32;82;937;2705;969;2787
510523;201706;980;2763;856;2558;94;266;600;1842;694;2108
510525;201706;5569;16624;4378;14218;922;3230;1431;4252;2353;7482
510530;201706;529;1428;415;1261;29;139;289;817;318;956
510550;201706;2868;9097;2205;7821;558;2087;702;2559;1260;4646
510558;201706;1905;5433;1638;5063;125;428;1015;3325;1140;3753
510560;201706;1671;4970;1062;3914;275;1110;231;909;506;2019
510562;201706;5439;15350;3969;12474;1080;3683;998;3263;2078;6946
510590;201706;3302;8340;2545;7387;483;1327;1508;4668;1991;5995
510600;201706;1643;4099;1096;3193;248;733;351;1028;599;1761
510610;201706;2956;8177;2326;7228;257;900;1407;4313;1664;5213
510615;201706;2045;6044;1715;5514;503;1682;713;2393;1216;4075
510617;201706;698;2044;572;1828;30;91;449;1498;479;1589
510618;201706;1465;4155;1058;3364;200;745;496;1493;696;2238
510619;201706;774;2100;451;1494;86;322;62;182;148;504
510620;201706;1400;3464;752;2399;178;637;111;329;289;966
510621;201706;931;3018;804;2770;195;750;217;707;412;1457
510622;201706;4253;12563;3036;9964;861;3078;549;1698;1410;4776
510623;201706;3505;9396;2642;7983;590;2043;864;2466;1454;4509
510624;201706;1757;4775;850;2882;146;550;120;330;266;880
510625;201706;1999;5536;1500;4706;426;1509;237;749;663;2258
510626;201706;1618;4138;1014;3262;292;1060;194;629;486;1689
510627;201706;703;1982;478;1510;131;440;115;377;246;817
510628;201706;1571;3817;1060;3103;192;574;598;1784;790;2358
510629;201706;1741;5563;1393;4790;382;1410;413;1455;795;2865
510630;201706;2641;8507;1762;6661;388;1591;295;1180;683;2771
510631;201706;411;1125;332;986;10;24;265;798;275;822
510637;201706;3045;8420;2459;7450;797;2652;744;2215;1541;4867
510642;201706;4962;15897;4176;14706;1210;4616;1660;6128;2870;10744
510645;201706;977;2155;591;1643;164;458;167;492;331;950
510650;201706;6489;20257;5785;19434;1193;4221;3752;13114;4945;17335
510665;201706;1806;4659;1130;3413;210;689;395;1209;605;1898
510670;201706;384;832;208;574;19;60;105;298;124;358
510675;201706;6423;19553;5050;16888;1430;5242;1101;3660;2531;8902
510677;201706;2015;5340;1540;4708;201;651;967;3060;1168;3711
510680;201706;715;2141;514;1727;119;418;80;250;199;668
510682;201706;2060;6443;1550;5490;445;1735;314;1090;759;2825
510685;201706;930;2468;712;2112;93;314;359;995;452;1309
510700;201706;4243;10893;2866;8959;701;2209;1253;4134;1954;6343
510704;201706;10346;26723;7413;21628;1433;4665;2824;7807;4257;12472
510706;201706;1964;5788;1335;4875;279;1081;654;2536;933;3617
510710;201706;3201;8720;2236;6773;470;1467;692;1956;1162;3423
510715;201706;708;1685;488;1331;71;191;185;517;256;708
510718;201706;2560;6004;1550;4808;665;2166;290;1117;955;3283
510719;201706;408;927;254;722;33;111;123;336;156;447
510720;201706;1111;2711;775;2247;182;606;262;688;444;1294
510724;201706;765;2197;550;1800;115;410;217;677;332;1087
510726;201706;762;1740;503;1358;74;214;308;797;382;1011
510729;201706;727;1797;385;1153;73;239;110;308;183;547
510730;201706;3011;8203;2148;6670;590;1962;550;1707;1140;3669
510735;201706;1017;3193;791;2863;118;489;442;1614;560;2103
510740;201706;1362;3653;979;3072;126;359;577;2003;703;2362
510757;201706;734;2383;605;2140;251;933;195;666;446;1599
510760;201706;33824;83342;22048;64484;6233;20244;4524;12275;10757;32519
510770;201706;4567;10847;3640;9764;352;872;2352;7007;2704;7879
510774;201706;362;1000;290;841;55;146;133;421;188;567
510775;201706;665;1990;539;1755;148;560;113;329;261;889
510776;201706;554;1541;432;1290;94;276;168;521;262;797
510777;201706;1629;4628;1205;4060;84;293;985;3373;1069;3666
510779;201706;635;1860;507;1634;64;197;277;924;341;1121
510780;201706;3784;10854;3037;9728;716;2389;1202;4235;1918;6624
510785;201706;1833;5121;1225;4038;329;1193;188;640;517;1833
510787;201706;2473;7260;1911;6264;833;2884;248;771;1081;3655
510788;201706;615;1537;418;1238;100;285;154;549;254;834
510790;201706;15769;44994;10606;35135;2297;8835;1148;3635;3445;12470
510792;201706;8985;25293;5989;19712;1223;4430;1044;3337;2267;7767
510794;201706;1232;3764;957;3250;270;1006;252;814;522;1820
510795;201706;8276;24201;6031;20027;1641;6009;1129;4005;2770;10014
510800;201706;1610;4390;1225;3806;276;933;513;1493;789;2426
510805;201706;2039;5594;1469;4609;296;1005;569;1666;865;2671
510810;201706;691;1625;520;1392;136;358;250;648;386;1006
510820;201706;742;1676;472;1295;73;243;196;493;269;736
510830;201706;723;2028;567;1806;113;359;286;982;399;1341
510835;201706;645;1808;475;1519;80;286;213;638;293;924
510840;201706;45675;113754;36369;101548;8263;23937;16953;49381;25216;73318
510850;201706;1632;4373;1044;3328;312;1134;212;630;524;1764
510860;201706;2813;8385;1968;6814;664;2581;179;600;843;3181
510880;201706;594;1943;505;1781;136;516;214;772;350;1288
510885;201706;643;1746;501;1535;100;349;197;578;297;927
510890;201706;800;2402;654;2193;124;448;366;1247;490;1695
510895;201706;1243;3585;966;3091;221;799;334;992;555;1791
520005;201706;1834;5438;1569;5082;462;1456;695;2466;1157;3922
520010;201706;2041;6501;1509;5352;536;2150;247;748;783;2898
520013;201706;3229;8959;2345;7242;532;1684;691;2241;1223;3925
520015;201706;506;1433;412;1304;102;346;134;444;236;790
520017;201706;1125;3215;901;2851;209;721;390;1201;599;1922
520020;201706;422;1077;332;947;79;241;152;418;231;659
520025;201706;31685;92007;28578;88288;3385;11279;21148;65427;24533;76706
520030;201706;5011;14825;4099;13316;632;2254;2131;6961;2763;9215
520050;201706;446;1112;274;785;21;54;155;463;176;517
520055;201706;867;2583;727;2309;124;381;384;1240;508;1621
520060;201706;1435;4351;1187;3896;288;1081;338;1046;626;2127
520080;201706;1932;5350;1570;4878;293;860;812;2720;1105;3580
520082;201706;1075;2813;938;2590;113;253;600;1716;713;1969
520085;201706;756;2247;646;2062;163;509;211;665;374;1174
520090;201706;962;2173;685;1827;122;284;382;1107;504;1391
520110;201706;42585;119976;32379;104386;11745;43336;2874;8585;14619;51921
520120;201706;193;498;117;366;14;48;38;121;52;169
520130;201706;3625;9821;3232;9241;703;2200;1667;4860;2370;7060
520140;201706;36114;113448;30293;102669;10921;40313;3779;12823;14700;53136
520145;201706;402;1116;295;922;62;214;92;273;154;487
520150;201706;494;1298;400;1195;62;204;239;693;301;897
520160;201706;942;2431;750;2148;166;490;279;803;445;1293
520170;201706;4875;10634;3689;9294;277;766;2990;7586;3267;8352
520180;201706;2266;6438;1897;5894;395;1374;831;2529;1226;3903
520215;201706;1993;5057;1610;4445;279;827;803;2184;1082;3011
520235;201706;691;1724;490;1423;81;267;184;504;265;771
520250;201706;1597;4370;1129;3623;307;1064;198;653;505;1717
520260;201706;815;2041;521;1501;77;230;197;559;274;789
520280;201706;585;1672;493;1500;155;468;192;645;347;1113
520310;201706;1265;2967;886;2372;234;672;286;854;520;1526
520320;201706;2023;6053;1641;5348;190;660;895;2963;1085;3623
520330;201706;2907;8804;2192;7567;586;2245;515;1783;1101;4028
520340;201706;1996;4898;1475;4152;206;511;932;2785;1138;3296
520350;201706;3364;8901;2536;7422;692;2183;817;2299;1509;4482
520355;201706;1484;4331;1228;3929;309;1095;571;1813;880;2908
520357;201706;828;2161;669;1916;62;189;455;1314;517;1503
520360;201706;772;2160;631;1922;196;618;203;639;399;1257
520380;201706;1345;3549;859;2594;127;421;352;982;479;1403
520390;201706;1021;2462;605;1881;204;742;148;404;352;1146
520393;201706;567;1352;435;1163;51;140;224;572;275;712
520396;201706;741;2242;624;2024;134;422;343;1124;477;1546
520400;201706;1630;4616;1381;4257;275;915;804;2454;1079;3369
520410;201706;1585;3713;1129;3075;169;515;677;1819;846;2334
520420;201706;347;948;253;752;35;109;130;356;165;465
520425;201706;1314;3513;996;2926;263;777;418;1277;681;2054
520430;201706;1882;4919;1121;3503;217;709;106;324;323;1033
520440;201706;3741;9504;2471;7236;692;2192;484;1407;1176;3599
520450;201706;11321;30145;7735;23892;2132;7231;421;1326;2553;8557
520455;201706;732;2130;578;1877;201;707;166;554;367;1261
520460;201706;943;2576;780;2328;120;387;470;1398;590;1785
520465;201706;843;2269;736;2112;92;331;485;1308;577;1639
520470;201706;1816;5737;1621;5440;338;1175;998;3511;1336;4686
520480;201706;884;2554;597;2018;113;409;114;331;227;740
520485;201706;1456;4343;1259;4054;203;696;827;2690;1030;3386
520490;201706;4006;12099;3137;10730;644;2257;1662;5847;2306;8104
520495;201706;1469;3656;1210;3321;92;277;874;2494;966;2771
520500;201706;1387;3857;1134;3481;292;986;428;1274;720;2260
520505;201706;761;2078;619;1858;142;410;289;876;431;1286
520510;201706;8692;23491;6130;19506;1391;4990;1719;5494;3110;10484
520520;201706;1118;3016;892;2683;265;831;293;938;558;1769
520530;201706;2049;6542;1641;5834;580;2094;391;1561;971;3655
520540;201706;2930;8062;2067;6416;520;1687;371;1207;891;2894
520545;201706;1047;3049;844;2698;163;576;267;816;430;1392
520547;201706;693;2141;590;1961;179;606;193;626;372;1232
520549;201706;10340;30154;8573;27553;2037;6858;4198;13795;6235;20653
520551;201706;3930;11710;3526;11093;660;2334;2225;6884;2885;9218
520552;201706;797;2333;717;2232;103;327;513;1629;616;1956
520570;201706;606;1622;438;1355;120;390;153;468;273;858
520580;201706;3142;7379;2214;6127;338;1014;1253;3494;1591;4508
520590;201706;1453;4124;1108;3512;246;817;225;739;471;1556
520620;201706;8272;23485;6954;21771;1834;5970;3261;10374;5095;16344
520630;201706;1020;2575;715;2085;115;354;289;811;404;1165
520640;201706;2843;7598;2322;6719;548;1614;907;2681;1455;4295
520650;201706;918;2373;649;1880;105;326;317;906;422;1232
520660;201706;430;1068;259;798;81;276;63;207;144;483
520670;201706;1006;2886;871;2687;63;203;673;2051;736;2254
520680;201706;802;2065;605;1755;141;411;249;736;390;1147
520690;201706;335;830;225;658;51;146;93;279;144;425
520710;201706;572;1467;361;1061;13;36;215;622;228;658
520725;201706;1725;4292;1261;3516;174;538;792;2183;966;2721
520735;201706;857;2260;595;1766;101;311;210;629;311;940
520740;201706;1823;4683;1470;4230;230;701;880;2538;1110;3239
520750;201706;679;1749;536;1538;101;263;246;758;347;1021
520753;201706;1571;4051;1404;3828;154;385;947;2765;1101;3150
520760;201706;823;2138;705;1983;99;243;486;1476;585;1719
520780;201706;1865;4521;1394;3841;149;427;797;2150;946;2577
520790;201706;3120;7683;2305;6459;180;483;1597;4666;1777;5149
520800;201706;16718;45367;14113;42269;2698;7736;8724;27952;11422;35688
520810;201706;1147;2732;884;2434;101;296;603;1744;704;2040
520815;201706;623;1928;459;1586;171;685;34;102;205;787
520830;201706;1706;4173;1322;3730;58;134;1069;3019;1127;3153
520840;201706;1775;5558;1531;5165;580;2083;387;1396;967;3479
520850;201706;646;1891;461;1586;116;462;120;406;236;868
520860;201706;6670;19480;5145;16980;1230;4334;1797;6141;3027;10475
520870;201706;96358;254767;70947;214697;21350;70917;15130;44615;36480;115532
520880;201706;6858;19503;5336;17297;1957;7028;869;2790;2826;9818
520890;201706;3903;10617;3056;9215;630;2167;1383;4090;2013;6257
520910;201706;3750;10482;2626;8377;878;3025;469;1410;1347;4435
520915;201706;658;1905;500;1579;103;362;203;627;306;989
520920;201706;3663;9500;2544;7824;404;1370;1093;3463;1497;4833
520929;201706;645;1682;497;1433;93;231;252;808;345;1039
520940;201706;1163;3203;920;2851;79;268;676;2106;755;2374
520945;201706;652;1518;513;1295;82;193;285;687;367;880
520960;201706;1025;2916;809;2522;143;460;338;1069;481;1529
520970;201706;2736;8264;2361;7581;635;2221;585;1888;1220;4109
520980;201706;789;2185;663;1994;166;542;306;916;472;1458
520990;201706;3030;9462;2833;9196;299;1030;1950;6622;2249;7652
520993;201706;1001;2520;770;2152;45;132;545;1541;590;1673
520995;201706;2311;6190;1983;5754;400;1170;1119;3303;1519;4473
521000;201706;7549;22228;6016;19297;1949;6713;1316;4161;3265;10874
521010;201706;4170;11713;3239;10032;629;1929;1451;4518;2080;6447
521015;201706;724;1912;611;1731;103;290;394;1118;497;1408
521020;201706;2892;8194;1984;6314;564;1925;210;648;774;2573
521030;201706;663;1641;493;1360;76;197;212;614;288;811
521040;201706;6581;17298;5363;15395;1739;5277;1665;4953;3404;10230
521056;201706;870;2538;694;2238;212;739;191;657;403;1396
521060;201706;1059;2720;832;2372;93;275;469;1378;562;1653
521080;201706;1141;2739;641;1932;63;218;250;673;313;891
521090;201706;3060;7981;2327;6942;721;2292;547;1659;1268;3951
521100;201706;1931;4511;1410;3792;219;573;849;2344;1068;2917
521120;201706;4929;12336;3764;10832;715;2128;1594;4982;2309;7110
521130;201706;1045;2710;737;2127;61;218;409;1176;470;1394
521140;201706;1028;3002;821;2611;166;559;267;865;433;1424
521150;201706;12181;30237;7952;23065;2485;7725;2189;6551;4674;14276
521160;201706;898;2063;569;1539;91;276;258;667;349;943
521170;201706;1161;2829;847;2341;110;328;511;1369;621;1697
521180;201706;6375;19986;5651;18703;1452;5155;1895;6421;3347;11576
521190;201706;8810;24891;5815;19279;1446;5217;1124;3785;2570;9002
521200;201706;765;2044;598;1762;70;234;328;951;398;1185
521205;201706;641;1741;501;1500;48;157;318;939;366;1096
521210;201706;899;2464;541;1705;118;423;86;221;204;644
521220;201706;4432;10844;3193;9159;667;2056;1347;3904;2014;5960
521225;201706;388;947;320;872;32;77;235;675;267;752
521230;201706;1366;4020;1236;3785;420;1290;577;1795;997;3085
521250;201706;31259;93132;26153;85571;10911;37171;6789;23883;17700;61054
521260;201706;728;1724;570;1496;95;283;324;838;419;1121
521270;201706;1801;5066;1635;4840;156;384;1243;3844;1399;4228
521280;201706;1921;5758;1553;5032;485;1680;456;1466;941;3146
521290;201706;463;1241;347;1078;80;286;173;521;253;807
521295;201706;1220;2822;996;2527;120;291;719;1905;839;2196
521300;201706;1919;5236;1634;4805;217;650;1063;3170;1280;3820
521305;201706;743;2042;600;1819;107;320;317;993;424;1313
521308;201706;4519;13214;3573;11385;735;2395;1626;5248;2361;7643
521310;201706;8612;24424;6028;19487;1524;5337;1399;4326;2923;9663
521340;201706;354;873;326;840;23;51;276;711;299;762
521350;201706;2038;5372;1607;4706;277;784;970;2901;1247;3685
521370;201706;1021;2831;687;2232;213;748;90;303;303;1051
521375;201706;1413;3951;1107;3496;247;845;448;1406;695;2251
521377;201706;1230;2920;1061;2728;61;137;913;2364;974;2501
521380;201706;6037;16602;4141;13081;530;1749;1061;3461;1591;5210
521385;201706;581;1476;483;1359;136;396;206;624;342;1020
521390;201706;756;2061;603;1852;186;633;179;546;365;1179
521400;201706;2062;5618;1822;5328;280;914;1270;3730;1550;4644
521405;201706;1422;3906;1115;3373;281;900;475;1461;756;2361
521410;201706;719;2139;669;2067;184;532;317;1060;501;1592
521440;201706;1449;4072;1143;3455;269;870;323;866;592;1736
521450;201706;3986;12634;3210;11074;919;3356;705;2473;1624;5829
521460;201706;7063;19679;5601;17077;1594;5246;2010;5969;3604;11215
521470;201706;685;1945;473;1489;102;319;90;277;192;596
521480;201706;384;1106;234;788;47;164;67;217;114;381
521483;201706;2814;7210;2059;5890;522;1521;550;1551;1072;3072
521486;201706;1721;4252;1379;3785;93;251;1045;2857;1138;3108
521487;201706;509;1332;368;1117;83;257;117;366;200;623
521490;201706;836;2323;635;1970;35;144;430;1290;465;1434
521500;201706;1462;4331;1112;3652;182;686;389;1187;571;1873
521520;201706;878;2007;636;1677;132;360;285;788;417;1148
521523;201706;13423;46593;11951;43471;3863;14876;2151;8649;6014;23525
521525;201706;1089;2737;886;2444;104;330;540;1434;644;1764
521530;201706;1922;5266;1227;3883;259;885;216;683;475;1568
521540;201706;899;2390;590;1853;94;354;246;755;340;1109
521550;201706;1618;4082;1041;2931;192;585;454;1256;646;1841
521560;201706;3727;11817;2993;10798;849;3356;1360;5096;2209;8452
521565;201706;608;1553;511;1430;80;220;326;904;406;1124
521570;201706;4828;13133;3096;9729;666;2266;392;1250;1058;3516
521580;201706;560;1310;328;961;60;172;63;189;123;361
521590;201706;636;1698;496;1473;134;455;191;533;325;988
521600;201706;434;1235;294;937;72;236;62;187;134;423
521630;201706;1404;3419;962;2778;227;753;248;641;475;1394
521640;201706;2235;5524;1703;4780;408;1117;741;2164;1149;3281
521645;201706;561;1650;404;1328;106;364;108;324;214;688
521680;201706;1290;4107;1058;3629;367;1335;103;351;470;1686
521690;201706;561;1594;491;1477;118;399;227;657;345;1056
521710;201706;2850;8176;2240;7083;491;1619;513;1621;1004;3240
521720;201706;1987;5467;1514;4599;262;817;754;2239;1016;3056
521730;201706;3874;12183;3237;10930;1147;4274;538;1591;1685;5865
521740;201706;3792;10368;2991;9196;659;2240;1243;3998;1902;6238
521760;201706;14781;45365;12469;41593;3437;12563;4398;15040;7835;27603
521770;201706;2718;7616;2091;6408;697;2283;494;1431;1191;3714
521800;201706;6804;20198;5761;18413;1721;5779;1973;6695;3694;12474
521805;201706;937;2091;669;1717;179;426;296;826;475;1252
521810;201706;794;1979;581;1666;106;327;240;715;346;1042
521830;201706;5275;16087;4595;15074;648;2309;2900;9489;3548;11798
521839;201706;705;1912;515;1554;111;374;199;562;310;936
521850;201706;6596;17416;4807;14404;1256;4069;925;2632;2181;6701
521860;201706;1969;5165;1470;4392;298;1020;464;1361;762;2381
521870;201706;489;1588;405;1413;102;375;126;406;228;781
521878;201706;802;2270;567;1796;101;356;177;508;278;864
521880;201706;22167;56609;15317;45761;3906;12407;4518;14066;8424;26473
521890;201706;3386;9785;2456;7920;615;2142;363;1125;978;3267
521900;201706;1496;3821;999;3056;231;756;336;980;567;1736
521910;201706;1203;2783;848;2373;115;346;488;1440;603;1786
521920;201706;310;957;245;823;64;244;66;225;130;469
521925;201706;705;2088;561;1820;113;377;150;466;263;843
521930;201706;3660;11351;3158;10447;1051;3531;762;2646;1813;6177
521935;201706;642;1778;541;1593;131;376;231;663;362;1039
521940;201706;1022;2717;835;2453;193;642;413;1175;606;1817
521945;201706;652;1973;546;1786;96;323;251;879;347;1202
521950;201706;682;1704;543;1510;52;160;392;1099;444;1259
521960;201706;673;1973;518;1664;88;313;233;722;321;1035
521970;201706;2784;7114;2287;6521;189;484;1789;5321;1978;5805
521971;201706;996;2644;693;2106;133;422;169;496;302;918
521973;201706;1028;3058;858;2766;153;534;415;1334;568;1868
521975;201706;12941;35102;11510;33309;1951;6019;7502;21561;9453;27580
521980;201706;2271;5991;1892;5500;227;592;1412;4215;1639;4807
521990;201706;1176;3304;951;2958;129;425;575;1851;704;2276
522000;201706;2364;6328;1716;5499;228;771;861;2942;1089;3713
522005;201706;381;917;269;755;80;213;96;281;176;494
522010;201706;3535;9685;2821;8530;961;3004;638;1936;1599;4940
522015;201706;952;2727;770;2426;171;545;333;1053;504;1598
522020;201706;5298;13408;3896;11201;908;2708;1727;4996;2635;7704
522026;201706;731;1985;541;1747;86;301;291;989;377;1290
522028;201706;578;1593;421;1240;69;217;189;522;258;739
522040;201706;2471;5852;1912;5165;359;985;1250;3440;1609;4425
522045;201706;15920;50515;12923;44496;3442;12944;2213;7504;5655;20448
522050;201706;1159;3280;826;2623;177;598;232;663;409;1261
522060;201706;2440;7188;2025;6555;385;1315;1054;3465;1439;4780
522068;201706;1723;5149;1526;4909;196;573;1088;3694;1284;4267
522070;201706;677;1971;594;1826;81;318;382;1115;463;1433
522100;201706;529;1545;439;1408;121;421;185;586;306;1007
522108;201706;847;2586;702;2345;68;298;509;1644;577;1942
522119;201706;1529;4346;1254;3944;240;778;620;2011;860;2789
522130;201706;362;1004;289;907;80;263;142;454;222;717
522140;201706;16877;48176;13533;42018;4079;13600;2422;7231;6501;20831
522145;201706;832;2165;656;1905;159;426;338;1074;497;1500
522150;201706;984;2514;783;2211;198;550;305;882;503;1432
522155;201706;911;2571;778;2359;183;512;395;1273;578;1785
522157;201706;663;1787;555;1629;36;135;403;1163;439;1298
522160;201706;6359;17524;4488;14155;1288;4448;441;1482;1729;5930
522170;201706;2363;6768;1773;5642;577;1946;329;1049;906;2995
522180;201706;391;1078;262;857;67;224;56;201;123;425
522185;201706;16603;45190;13135;40737;4112;13560;5274;17160;9386;30720
522190;201706;895;2177;687;1886;128;348;325;934;453;1282
522200;201706;1744;5543;1323;4580;299;1091;240;814;539;1905
522205;201706;1394;3708;1107;3269;146;486;673;1967;819;2453
522220;201706;1462;3664;1119;3208;147;429;663;2011;810;2440
522230;201706;1320;3529;1106;3208;168;548;623;1801;791;2349
530010;201706;192276;586982;168681;547224;42506;153757;70857;223137;113363;376894
110001;201705;3286;10713;2890;10062;676;2440;1416;5018;2092;7458
110002;201705;12796;36377;9794;31188;3040;10440;2947;9229;5987;19669
110003;201705;720;2226;596;1999;188;670;117;371;305;1041
110004;201705;9128;28331;7430;24983;2337;8420;1323;4786;3660;13206
110005;201705;1817;5540;1502;4978;438;1527;576;1927;1014;3454
110006;201705;1652;4996;1121;3883;343;1247;111;375;454;1622
110007;201705;1369;4016;1139;3594;332;1105;436;1583;768;2688
110008;201705;2426;8068;2236;7807;310;1010;1698;6191;2008;7201
110009;201705;4539;13689;3445;11890;1025;3762;990;3552;2015;7314
110010;201705;6953;22161;6061;20788;1765;6144;2641;10020;4406;16164
110011;201705;6849;20986;5797;18939;2029;6996;1686;5533;3715;12529
110012;201705;14955;42210;11527;36321;3119;10429;2669;8619;5788;19048
110013;201705;5431;16940;4549;15264;1809;6224;1043;3831;2852;10055
110014;201705;4047;11461;3319;10276;987;3194;1462;4465;2449;7659
110015;201705;4860;14300;3283;11132;857;3131;473;1607;1330;4738
110018;201705;3940;10785;2799;8969;711;2574;905;2787;1616;5361
110020;201705;68518;181584;49834;156310;11246;37622;20453;67625;31699;105247
110025;201705;4264;11926;3375;10361;482;1608;2091;6301;2573;7909
110026;201705;629;1898;559;1787;164;547;256;837;420;1384
110028;201705;6229;18769;4855;16007;1477;5286;576;1903;2053;7189
110029;201705;1323;3663;996;3165;269;884;421;1360;690;2244
110030;201705;10193;27706;7768;24265;1958;6793;2834;8867;4792;15660
110032;201705;3637;11224;2961;9843;978;3323;775;2589;1753;5912
110033;201705;4910;15693;4224;14446;1473;5134;1320;4845;2793;9979
110034;201705;3404;9055;2669;8022;811;2577;1317;3963;2128;6540
110037;201705;1842;6259;1601;5739;422;1592;704;2520;1126;4112
110040;201705;3245;9976;2644;8855;843;2997;798;2612;1641;5609
110045;201705;4884;15615;4244;14756;1367;5122;1800;6307;3167;11429
110050;201705;1637;5167;1364;4650;526;1846;414;1439;940;3285
110060;201705;807;2632;635;2257;226;857;97;356;323;1213
110070;201705;1947;6442;1668;5798;564;2075;561;1903;1125;3978
110080;201705;4791;12770;3926;11757;908;2798;2177;6753;3085;9551
110090;201705;689;1972;498;1625;124;448;225;707;349;1155
110092;201705;1309;4217;1156;3993;202;763;671;2395;873;3158
110094;201705;3435;10105;2848;9221;953;3259;1020;3355;1973;6614
110100;201705;2093;6511;1855;6089;418;1471;1004;3307;1422;4778
110110;201705;1615;5007;1342;4588;504;1802;320;1167;824;2969
110120;201705;1701;5283;1311;4450;381;1361;270;916;651;2277
110130;201705;2479;6849;1754;5630;516;1811;464;1509;980;3320
110140;201705;2363;7567;1861;6565;519;1944;457;1515;976;3459
110143;201705;1399;4036;1044;3405;376;1265;326;1059;702;2324
110145;201705;1092;3062;758;2420;188;659;279;875;467;1534
110146;201705;393;1221;333;1125;71;233;163;567;234;800
110147;201705;699;2035;518;1695;142;487;175;541;317;1028
110148;201705;1122;3426;730;2502;137;511;84;282;221;793
110149;201705;3224;9465;2493;8310;880;2922;913;3264;1793;6186
110150;201705;2377;6724;1913;6046;697;2442;512;1591;1209;4033
110155;201705;816;2529;705;2285;164;563;295;926;459;1489
110160;201705;1787;5748;1481;5144;550;1945;424;1546;974;3491
110170;201705;2729;7599;1954;6194;428;1446;900;2828;1328;4274
110175;201705;1633;4934;1304;4463;204;754;706;2532;910;3286
110180;201705;1216;3561;995;3208;282;898;499;1650;781;2548
120001;201705;2802;9322;2517;8889;515;1856;1491;5515;2006;7371
120005;201705;1600;6549;1489;6345;183;821;1070;4763;1253;5584
120010;201705;4924;16378;4691;16026;588;1950;3543;12444;4131;14394
120013;201705;2082;8207;1980;8062;461;1820;1203;5267;1664;7087
120017;201705;2003;7157;1857;6892;472;1787;895;3666;1367;5453
120020;201705;14271;62619;13788;61693;1793;8525;9968;45905;11761;54430
120025;201705;2349;8108;2252;7969;414;1494;1423;5158;1837;6652
120030;201705;6592;25295;6395;25064;283;1381;5686;22347;5969;23728
120032;201705;1548;7402;1488;7255;152;879;1131;5528;1283;6407
120033;201705;3610;14337;3508;14158;222;1001;3078;12463;3300;13464
120034;201705;2023;8543;1934;8354;139;835;1544;6598;1683;7433
120035;201705;3196;14129;3098;13950;202;1093;2643;11977;2845;13070
120038;201705;2615;9193;2454;8897;563;2071;1354;5094;1917;7165
120039;201705;1804;8506;1755;8412;186;1091;1312;6314;1498;7405
120040;201705;43833;155138;40279;148847;9015;36080;21225;79975;30240;116055
120042;201705;3064;12465;2896;12097;203;1060;2220;9313;2423;10373
120043;201705;1052;4754;1013;4684;66;323;861;4083;927;4406
120045;201705;4623;15210;4444;15012;325;1247;3927;13252;4252;14499
120050;201705;8122;32724;7732;31896;970;4348;5492;23300;6462;27648
120060;201705;7964;34727;7754;34355;733;3809;6196;27731;6929;31540
120070;201705;2730;9943;2631;9744;408;1530;1752;6707;2160;8237
120080;201705;3638;13581;3478;13314;626;2533;2402;9375;3028;11908
130002;201705;3229;13020;3006;12693;153;777;2639;11239;2792;12016
130006;201705;2209;8951;1920;8444;176;929;1452;6403;1628;7332
130008;201705;2318;8839;2127;8475;276;1265;1546;6141;1822;7406
130010;201705;3300;10507;3055;10229;140;483;2756;9304;2896;9787
130014;201705;3241;10365;2775;9597;481;1794;1750;6141;2231;7935
130020;201705;2831;10578;2684;10327;119;664;2290;8699;2409;9363
130030;201705;8215;30148;7833;29712;241;729;7293;28235;7534;28964
130040;201705;3779;11507;3303;10902;282;1026;2656;8879;2938;9905
130050;201705;6351;25492;5992;25022;298;1197;5218;22448;5516;23645
130060;201705;6087;27636;5788;27167;512;2872;4642;21890;5154;24762
130063;201705;4301;17937;4044;17625;222;1101;3607;15840;3829;16941
130068;201705;3242;13336;2920;12667;254;1270;2132;9333;2386;10603
130070;201705;7815;25416;6966;24434;459;1535;5897;21282;6356;22817
130080;201705;5754;24514;5344;23940;604;3229;3999;18053;4603;21282
130083;201705;2320;8880;2174;8651;248;1167;1637;6496;1885;7663
130090;201705;2904;9952;2752;9724;84;359;2426;8691;2510;9050
130100;201705;5984;21481;5807;21276;145;549;5512;20340;5657;20889
130110;201705;6842;21764;6438;21298;602;1819;5332;18199;5934;20018
130115;201705;4794;16471;4544;16094;190;704;3917;13990;4107;14694
130120;201705;15189;56389;14159;55057;1457;5876;11334;45166;12791;51042
130130;201705;4107;16314;4031;16188;314;1515;3366;13491;3680;15006
130140;201705;6271;24524;6160;24404;264;1109;5729;22780;5993;23889
130150;201705;3469;13769;3401;13685;136;726;3081;12384;3217;13110
130160;201705;4432;18008;4211;17726;423;2154;3432;14473;3855;16627
130165;201705;3002;12109;2857;11859;154;818;2423;10106;2577;10924
130170;201705;10086;34038;8650;32341;862;3467;6853;26266;7715;29733
130180;201705;3624;11851;3557;11765;70;237;3390;11284;3460;11521
130185;201705;12684;38564;11205;36942;658;1696;9560;33195;10218;34891
130190;201705;17195;58790;15043;55929;2231;8370;10416;40286;12647;48656
130195;201705;1996;8449;1937;8375;109;443;1715;7599;1824;8042
130200;201705;2060;6917;1873;6638;287;1018;1302;4787;1589;5805
130210;201705;1383;5327;1255;5174;123;683;987;4005;1110;4688
130220;201705;1998;8143;1845;7856;198;1001;1296;5550;1494;6551
130230;201705;3787;17244;3542;16856;399;2103;2749;13379;3148;15482
130240;201705;9402;33419;8378;31938;322;1720;7256;27761;7578;29481
130250;201705;20795;70891;19526;69342;2257;7766;15157;56048;17414;63814
130255;201705;4301;15005;4010;14547;271;1115;3332;12158;3603;13273
130260;201705;253893;816813;226749;771685;66116;241651;95958;329058;162074;570709
130270;201705;7565;30869;6989;29983;827;3769;5244;23200;6071;26969
130280;201705;3363;13959;3236;13810;109;486;2997;12971;3106;13457
130290;201705;11296;39827;10667;39111;178;447;10162;38021;10340;38468
130300;201705;4655;17446;4402;17068;272;1292;3748;14618;4020;15910
130310;201705;5207;19626;4798;19091;383;1634;3940;15992;4323;17626
130320;201705;3169;11229;2903;10864;390;1492;2018;7820;2408;9312
130330;201705;3913;13796;3497;13287;160;819;3019;11445;3179;12264
130340;201705;18987;70652;17395;68727;1861;7324;14098;57510;15959;64834
130350;201705;3531;14092;3405;13913;242;1348;2875;11616;3117;12964
130353;201705;6342;19226;5554;18232;972;3102;3706;13047;4678;16149
130356;201705;4861;17273;4499;16695;518;2009;3251;12380;3769;14389
130360;201705;3409;9732;2993;9298;88;228;2795;8826;2883;9054
130370;201705;5538;21630;5030;20972;190;1046;4350;18287;4540;19333
130380;201705;8176;33578;7858;33123;513;2619;6708;28308;7221;30927
130390;201705;5328;23367;5012;22777;541;2885;3733;16950;4274;19835
130395;201705;2296;7856;2050;7404;234;883;1451;5282;1685;6165
130400;201705;2142;8008;2004;7807;121;564;1738;6798;1859;7362
130406;201705;10907;41004;9926;39671;1822;7623;6699;27308;8521;34931
130410;201705;3917;14615;3475;13837;1063;4483;1621;6651;2684;11134
130420;201705;11076;45512;10547;44758;1464;6516;8023;34877;9487;41393
130423;201705;3688;13351;3407;12970;231;1150;2907;10951;3138;12101
130426;201705;2462;10249;2384;10127;109;519;2124;9153;2233;9672
130430;201705;3630;12436;3473;12213;243;872;2940;10525;3183;11397
130440;201705;3840;13416;3557;13089;164;668;3182;11803;3346;12471
140002;201705;1754;5708;1598;5501;119;485;1250;4305;1369;4790
140005;201705;3627;9812;3486;9660;64;171;3363;9354;3427;9525
140010;201705;54942;156117;44684;141226;10812;36197;18289;61355;29101;97552
140015;201705;3087;9782;2847;9501;136;423;2540;8631;2676;9054
140017;201705;3369;10621;3024;10177;297;1039;2264;7931;2561;8970
140020;201705;4674;15295;4141;14562;518;2094;2959;10433;3477;12527
140023;201705;2255;7380;1948;6919;224;861;1358;4928;1582;5789
140028;201705;2131;5855;1930;5586;195;675;1462;4103;1657;4778
140030;201705;3686;11457;3412;11099;515;1473;2451;8354;2966;9827
140040;201705;1842;8333;1788;8261;97;596;1610;7381;1707;7977
140045;201705;2610;9612;2347;9248;431;1691;1537;6431;1968;8122
140047;201705;5762;17438;5029;16280;1218;3987;2436;8507;3654;12494
140050;201705;1450;4480;1279;4239;202;693;824;2796;1026;3489
140060;201705;1462;4364;1301;4113;190;639;922;2935;1112;3574
140070;201705;1656;9018;1602;8866;154;1044;1237;6860;1391;7904
150010;201705;37880;108149;35518;104980;2106;7023;29434;86858;31540;93881
150013;201705;1746;5003;1554;4786;163;468;1165;3688;1328;4156
150020;201705;12765;42112;12319;41502;1369;4089;10017;34880;11386;38969
150030;201705;7824;32220;7567;31854;519;2173;6499;27903;7018;30076
150034;201705;4262;11647;3845;11056;284;868;3142;9032;3426;9900
150040;201705;12924;40142;11460;38439;1222;3326;9137;32615;10359;35941
150050;201705;5826;22677;5543;22199;231;1200;4851;19435;5082;20635
150060;201705;18702;57185;16784;54159;3871;12419;9449;31845;13320;44264
150070;201705;6235;24832;5596;24143;186;994;5160;22455;5346;23449
150080;201705;82596;206987;70691;191431;15148;42423;31654;93566;46802;135989
150085;201705;5894;19363;5631;19040;297;829;5034;17477;5331;18306
150090;201705;10469;39572;9882;38714;828;3487;7829;31140;8657;34627
150095;201705;5477;17468;4969;16770;322;1052;4012;13947;4334;14999
150100;201705;3268;11899;3009;11435;222;960;2343;8838;2565;9798
150110;201705;3699;17286;3675;17246;194;980;3303;15652;3497;16632
150120;201705;6897;24354;6714;24090;450;1394;5700;21222;6150;22616
150125;201705;773;2167;666;2039;101;354;447;1364;548;1718
150130;201705;22846;68539;20907;65794;2394;7238;15360;49795;17754;57033
150140;201705;173081;469774;159320;451779;21843;61270;113860;329442;135703;390712
150145;201705;4654;14347;4222;13783;478;1527;3359;11201;3837;12728
150150;201705;12805;37594;11776;36131;1474;4829;8419;26114;9893;30943
150157;201705;3140;9293;2711;8714;329;1165;1856;6112;2185;7277
150160;201705;3115;9742;2928;9470;760;2503;1626;5449;2386;7952
150170;201705;22264;80318;20955;78213;2975;11289;14803;56683;17778;67972
150172;201705;3200;10585;2808;9956;286;1035;2122;7712;2408;8747
150175;201705;1870;5640;1736;5479;133;444;1407;4576;1540;5020
150178;201705;10005;30134;8565;28434;963;3305;6337;21796;7300;25101
150180;201705;19076;75121;18319;74127;1127;5130;15795;64504;16922;69634
150190;201705;7153;24163;6883;23815;194;851;6293;21855;6487;22706
150195;201705;5520;17618;5207;17135;133;441;4770;15844;4903;16285
150200;201705;5397;16907;5114;16578;80;282;4852;15834;4932;16116
150210;201705;25048;92880;24261;91817;1678;6525;20453;79502;22131;86027
150215;201705;7662;23891;6753;22478;2191;7511;2639;9202;4830;16713
150220;201705;11549;35395;10409;33673;2186;7178;5627;18871;7813;26049
150230;201705;12199;37059;10616;34897;1677;5494;6819;23464;8496;28958
150240;201705;35001;103112;30064;94352;10045;32558;8051;26463;18096;59021
150250;201705;4075;16958;3932;16754;736;3134;2708;12029;3444;15163
150260;201705;2076;8004;1974;7834;317;1285;1282;5214;1599;6499
150270;201705;8299;25012;6437;22614;1689;6092;3196;11768;4885;17860
150275;201705;6025;21437;5673;20904;617;2207;4294;16246;4911;18453
150276;201705;2182;6480;1946;6184;271;882;1465;4754;1736;5636
150277;201705;4796;14417;4100;13566;559;2008;2968;10059;3527;12067
150280;201705;5914;26278;5745;25923;668;3075;4435;20397;5103;23472
150285;201705;3108;11684;2865;11295;298;1271;2038;8212;2336;9483
150290;201705;10280;28828;9769;28263;517;1274;8644;25720;9161;26994
150293;201705;9246;24556;6879;21325;2039;6556;2508;8595;4547;15151
150295;201705;7615;21822;6262;20243;1407;4518;3543;12789;4950;17307
150300;201705;2051;6662;1912;6471;87;408;1598;5379;1685;5787
150304;201705;4192;13314;3664;12466;639;2155;2343;8307;2982;10462
150307;201705;6560;21576;6177;21044;348;1218;5288;18142;5636;19360
150309;201705;6213;20800;5501;19743;1300;4603;2925;11216;4225;15819
150310;201705;6575;27581;6264;27150;440;2186;5247;22905;5687;25091
150320;201705;9572;24773;8759;23846;536;1433;7277;20043;7813;21476
150330;201705;14200;47369;13292;46064;1793;6308;9755;34774;11548;41082
150340;201705;2575;7958;2377;7654;212;717;1821;5893;2033;6610
150345;201705;7019;22576;6555;21941;517;1788;5355;18252;5872;20040
150350;201705;8364;24611;7781;23903;1139;2915;5888;18982;7027;21897
150360;201705;21607;65835;18765;62257;2920;9476;12616;43802;15536;53278
150370;201705;9971;35206;9059;33956;934;3538;6847;26620;7781;30158
150375;201705;3043;13099;2801;12740;214;1012;2383;10976;2597;11988
150380;201705;9742;27848;8533;26161;480;1512;7154;22268;7634;23780
150390;201705;7841;33722;7331;32829;1184;5110;4898;22976;6082;28086
150400;201705;6020;23037;5784;22587;438;1716;4658;18493;5096;20209
150405;201705;8330;24664;7418;23545;675;1703;5696;19242;6371;20945
150410;201705;1624;5994;1492;5735;237;995;952;3708;1189;4703
150420;201705;35897;117523;29748;107680;9886;38362;8499;34003;18385;72365
150430;201705;7715;25051;7303;24443;839;2729;5537;19029;6376;21758
150440;201705;5493;18550;5271;18254;423;1441;4361;15398;4784;16839
150442;201705;22059;62229;19339;58159;3161;9524;11789;36920;14950;46444
150445;201705;5602;18807;5147;18084;437;1546;4026;14437;4463;15983
150450;201705;4401;20796;4241;20532;431;2168;3430;16897;3861;19065
150460;201705;7376;26397;6801;25670;368;1604;5676;22276;6044;23880
150470;201705;17975;54364;17170;53398;1204;3204;14964;47500;16168;50704
150475;201705;3854;13218;3536;12775;270;1031;2866;10537;3136;11568
150480;201705;14231;48129;12990;46197;1509;5548;9713;35423;11222;40971
150490;201705;7266;27507;7062;27201;260;1204;6257;24270;6517;25474
150495;201705;5088;18483;4928;18275;166;665;4539;16976;4705;17641
150497;201705;2605;9399;2326;8871;695;2762;1073;4239;1768;7001
150500;201705;3200;8708;2947;8344;312;871;2309;6543;2621;7414
150503;201705;3668;11234;3023;10327;937;3258;1519;5458;2456;8716
150506;201705;10768;36893;9809;35538;2111;7137;6210;24224;8321;31361
150510;201705;9985;38185;9013;36174;1454;5672;5821;24620;7275;30292
150520;201705;6838;26801;6727;26662;228;928;6295;25179;6523;26107
150530;201705;12413;42629;11202;40728;1178;3946;8498;31816;9676;35762
150540;201705;4723;14026;4159;13236;242;814;3453;11021;3695;11835
150543;201705;5912;17856;5184;16848;988;3275;3276;11057;4264;14332
150548;201705;9536;30300;8851;29452;337;1005;8111;27337;8448;28342
150549;201705;2086;6641;1901;6439;57;228;1743;5936;1800;6164
150550;201705;20270;63864;17675;59459;5198;17777;6633;23794;11831;41571
150553;201705;23342;78437;19252;70423;6797;26259;5066;19803;11863;46062
150555;201705;1785;5195;1477;4703;86;306;1072;3433;1158;3739
150560;201705;1861;6052;1713;5755;280;946;1003;3435;1283;4381
150563;201705;2585;8522;2368;8136;535;1963;1284;4418;1819;6381
150565;201705;3994;13601;3643;13039;136;654;3059;11016;3195;11670
150570;201705;5901;21141;5721;20840;438;1779;4556;16662;4994;18441
150580;201705;9951;41285;9647;40916;635;2810;8342;36074;8977;38884
150590;201705;6104;23760;5878;23474;160;745;5519;22084;5679;22829
150600;201705;8284;31232;7895;30682;279;1305;7086;27745;7365;29050
150610;201705;2414;8029;2228;7654;188;737;1699;5766;1887;6503
150611;201705;2786;9247;2616;8959;149;553;2174;7477;2323;8030
150613;201705;12352;36121;9874;32263;2583;8817;4261;14428;6844;23245
150616;201705;3205;9534;2412;8200;578;2188;740;2404;1318;4592
150618;201705;6571;21732;5835;20446;1310;4636;3207;11695;4517;16331
150619;201705;5199;17376;4755;16681;531;2009;3490;12266;4021;14275
150620;201705;6385;22573;5740;21751;636;2514;4423;16985;5059;19499
150630;201705;5993;17408;5658;17019;431;1346;4791;14639;5222;15985
150635;201705;3953;12612;3547;11841;913;3118;1536;5326;2449;8444
150640;201705;2087;5984;1945;5828;73;208;1784;5482;1857;5690
150650;201705;11685;35270;10543;33256;2979;9378;4512;15052;7491;24430
150655;201705;5135;16481;4811;15914;511;1800;3716;12352;4227;14152
150658;201705;4489;13192;3849;12339;706;2488;2404;8010;3110;10498
150660;201705;5672;17479;5169;16754;985;3189;3063;10195;4048;13384
150670;201705;7749;19950;6326;18226;663;1929;4904;14515;5567;16444
150680;201705;61883;204782;51987;188805;14552;53729;21945;88394;36497;142123
150690;201705;2053;6167;1850;5863;163;515;1416;4542;1579;5057
150700;201705;6166;19221;5667;18564;745;2407;4006;13584;4751;15991
150710;201705;4327;14377;3882;13685;372;1444;2797;9983;3169;11427
150715;201705;4916;15159;4294;14210;406;1501;3198;10650;3604;12151
150720;201705;6468;25583;6120;24966;618;2808;4698;19481;5316;22289
150730;201705;10433;34889;9581;33467;1195;4346;7127;25495;8322;29841
150740;201705;3658;11428;3265;10739;550;1844;1963;6528;2513;8372
150745;201705;4879;15491;4375;14784;1033;3677;2659;9058;3692;12735
150746;201705;1346;4410;1279;4286;98;321;1017;3481;1115;3802
150747;201705;5382;16581;4757;15780;620;1825;3281;11731;3901;13556
150750;201705;3517;11274;3182;10810;195;788;2548;8753;2743;9541
150760;201705;11507;36000;10687;34956;1240;4140;7954;26533;9194;30673
150770;201705;5947;22433;5733;22104;202;667;5140;20714;5342;21381
150775;201705;1060;3204;904;2944;169;675;514;1625;683;2300
150780;201705;3636;11609;3505;11461;128;512;3192;10450;3320;10962
150790;201705;5116;16321;4665;15807;277;919;3820;13854;4097;14773
150795;201705;14668;47375;13274;45168;2978;9888;7665;27529;10643;37417
150796;201705;3255;9212;2913;8808;262;821;2285;7097;2547;7918
150797;201705;3790;12847;3472;12284;129;501;2881;10231;3010;10732
150800;201705;13938;44978;12801;43586;2359;7329;8811;32033;11170;39362
150803;201705;6808;24036;6379;23352;678;2629;4848;17925;5526;20554
150805;201705;2791;9824;2560;9439;321;1177;1856;6983;2177;8160
150808;201705;5677;18489;4567;16355;1734;6780;547;2069;2281;8849
150810;201705;19764;58297;15970;53683;2611;8552;9997;35977;12608;44529
150812;201705;5367;16543;4904;15754;583;2087;3469;10898;4052;12985
150815;201705;8512;27882;7619;26767;759;2643;5947;21528;6706;24171
150820;201705;11485;32955;10301;31636;766;2086;8317;26431;9083;28517
150830;201705;12650;47605;11968;46771;580;2885;10076;40480;10656;43365
150835;201705;2178;7579;2027;7288;452;1643;1091;4082;1543;5725
150840;201705;7349;22228;6042;20000;1299;4630;2811;9406;4110;14036
160005;201705;853;2816;816;2752;54;223;688;2296;742;2519
160010;201705;1409;4707;1406;4704;18;30;1375;4642;1393;4672
160015;201705;1808;6659;1759;6586;85;278;1596;6103;1681;6381
160020;201705;1877;6906;1751;6708;219;924;1299;5018;1518;5942
160021;201705;1057;4484;1019;4418;115;637;767;3317;882;3954
160023;201705;965;4057;954;4035;77;312;808;3481;885;3793
160025;201705;1492;4529;1472;4507;38;101;1413;4351;1451;4452
160027;201705;8276;24474;7706;23839;1030;3002;5950;19169;6980;22171
160030;201705;51319;172453;45222;162927;10781;38582;23445;91381;34226;129963
160040;201705;4318;16747;4218;16612;188;1058;3812;14818;4000;15876
160050;201705;3339;12242;2954;11692;1466;5524;929;4311;2395;9835
160053;201705;2993;11037;2914;10924;731;2670;1853;7228;2584;9898
160055;201705;562;2237;557;2230;31;160;500;1980;531;2140
160060;201705;15834;53810;15045;52898;1637;5585;11881;42835;13518;48420
160070;201705;2825;10931;2647;10640;205;942;2174;8813;2379;9755
160080;201705;2585;9626;2523;9548;64;316;2356;8905;2420;9221
170025;201705;546;1719;470;1614;138;473;222;792;360;1265
170030;201705;1186;3842;1014;3532;200;714;477;1714;677;2428
170035;201705;1421;3879;1139;3408;136;445;635;1907;771;2352
170040;201705;1895;5748;1635;5414;157;567;856;3100;1013;3667
170070;201705;1606;4245;1205;3716;199;664;688;2142;887;2806
170100;201705;2319;6845;2027;6417;191;585;1510;4845;1701;5430
170105;201705;745;2319;566;1932;141;499;226;749;367;1248
170110;201705;910;3000;784;2752;173;663;341;1208;514;1871
170130;201705;1367;4301;1066;3704;244;883;472;1725;716;2608
170190;201705;1575;4611;1164;3933;377;1205;265;1114;642;2319
170200;201705;1611;4375;1021;3256;287;988;204;610;491;1598
170210;201705;30985;86909;24647;76865;8159;27625;4653;15628;12812;43253
170215;201705;1270;3836;1083;3562;100;397;779;2532;879;2929
170220;201705;5559;18668;5084;17718;1164;4137;2657;9542;3821;13679
170230;201705;1344;4231;1080;3709;230;838;437;1508;667;2346
170240;201705;2775;8146;2238;7289;226;889;1499;4828;1725;5717
170255;201705;3457;10819;2788;9608;790;2773;1124;4006;1914;6779
170270;201705;1010;2471;673;2010;35;113;463;1357;498;1470
170290;201705;2835;8106;2476;7699;244;508;1966;6648;2210;7156
170300;201705;1886;5651;1542;5090;176;581;993;3371;1169;3952
170305;201705;736;2160;597;1899;95;337;284;897;379;1234
170307;201705;984;3478;839;3197;182;724;408;1600;590;2324
170310;201705;1533;4264;1160;3613;254;859;564;1754;818;2613
170320;201705;1133;3206;827;2699;148;521;423;1412;571;1933
170330;201705;809;2624;736;2502;43;182;558;1871;601;2053
170360;201705;463;1434;372;1275;61;243;208;683;269;926
170370;201705;1320;3684;1009;3179;155;508;490;1555;645;2063
170380;201705;1779;5714;1429;5120;192;772;787;2897;979;3669
170382;201705;581;1793;472;1611;52;220;307;1035;359;1255
170384;201705;1596;6280;1436;5974;406;1795;660;2781;1066;4576
170386;201705;854;2452;645;2058;140;512;181;513;321;1025
170388;201705;601;1784;458;1536;86;307;190;623;276;930
170389;201705;901;3011;804;2852;61;251;598;2099;659;2350
170390;201705;1347;3688;1081;3366;88;289;817;2601;905;2890
170410;201705;537;1687;432;1496;26;112;276;949;302;1061
170460;201705;477;1290;333;1046;47;177;156;487;203;664
170510;201705;799;2587;618;2236;97;405;303;1077;400;1482
170550;201705;6563;18441;4823;15438;1525;5439;709;2327;2234;7766
170555;201705;1339;3784;1063;3358;151;515;548;1771;699;2286
170560;201705;1169;3499;898;3130;151;581;469;1797;620;2378
170600;201705;1290;3770;1121;3529;311;910;605;2022;916;2932
170610;201705;1633;4883;1301;4297;133;508;848;2766;981;3274
170625;201705;397;1176;297;965;34;116;108;327;142;443
170650;201705;1249;3920;997;3451;252;918;358;1338;610;2256
170700;201705;3938;12165;3183;10886;618;2295;1457;5202;2075;7497
170710;201705;1772;5136;1394;4435;294;1027;623;1907;917;2934
170720;201705;1834;4817;1576;4434;133;303;1254;3696;1387;3999
170730;201705;948;2825;758;2502;203;712;321;1088;524;1800
170740;201705;2124;7534;1842;7009;272;1059;1169;4540;1441;5599
170755;201705;816;2481;611;2059;83;309;283;951;366;1260
170765;201705;1247;3401;915;2876;238;765;351;1189;589;1954
170770;201705;1718;5662;1528;5349;287;992;907;3270;1194;4262
170820;201705;3970;13907;3605;13293;621;2230;2090;8277;2711;10507
170825;201705;971;2484;799;2229;100;261;483;1381;583;1642
170830;201705;1449;4104;1193;3708;65;170;954;3020;1019;3190
170900;201705;2560;8979;2392;8719;211;856;1917;7056;2128;7912
170930;201705;3706;10814;3181;10015;693;2382;1592;5176;2285;7558
170950;201705;13738;39622;10205;33511;3020;11235;1488;4986;4508;16221
170980;201705;499;1400;376;1199;57;201;185;555;242;756
171050;201705;1540;5059;1382;4764;91;408;1056;3599;1147;4007
171070;201705;1394;4270;1266;4090;247;731;815;2808;1062;3539
171090;201705;1113;2887;911;2615;61;177;672;1921;733;2098
171110;201705;580;1692;425;1414;116;436;174;513;290;949
171150;201705;1023;2750;668;2117;73;253;403;1290;476;1543
171180;201705;693;2069;465;1605;91;323;190;701;281;1024
171190;201705;1532;5701;1361;5358;266;1084;695;2881;961;3965
171195;201705;843;2897;727;2694;96;451;465;1702;561;2153
171200;201705;625;1933;491;1682;151;547;157;530;308;1077
171215;201705;445;1305;339;1094;71;265;152;481;223;746
171240;201705;686;2497;635;2402;60;296;398;1544;458;1840
171245;201705;595;1993;487;1736;108;425;190;658;298;1083
171250;201705;1055;2993;827;2619;170;570;411;1303;581;1873
171270;201705;398;1591;368;1519;115;444;154;712;269;1156
171280;201705;881;2719;730;2454;169;581;324;1173;493;1754
171320;201705;3796;11282;3162;10184;868;2793;1318;4501;2186;7294
171330;201705;2740;7916;2206;7039;535;1832;1071;3463;1606;5295
171360;201705;1418;4453;1261;4230;102;378;997;3369;1099;3747
171370;201705;669;1868;560;1719;79;274;365;1127;444;1401
171380;201705;1283;4074;1059;3677;368;1281;313;1222;681;2503
171395;201705;912;2675;682;2228;110;431;330;1040;440;1471
171420;201705;1879;5854;1440;4970;311;1174;585;2041;896;3215
171430;201705;1041;3162;863;2854;124;416;533;1750;657;2166
171488;201705;2517;7655;2099;7021;427;1419;1106;3891;1533;5310
171500;201705;877;2486;693;2187;65;219;475;1505;540;1724
171510;201705;829;2892;741;2734;61;253;523;1956;584;2209
171515;201705;489;1372;372;1173;35;112;217;677;252;789
171525;201705;614;1946;525;1790;46;185;343;1127;389;1312
171550;201705;364;1132;274;979;64;256;107;379;171;635
171570;201705;1273;3906;1096;3570;198;605;696;2368;894;2973
171575;201705;1915;5235;1355;4269;232;775;611;1910;843;2685
171610;201705;5200;16200;4292;14622;1108;4162;1268;4445;2376;8607
171620;201705;2752;7804;2340;7261;117;434;1920;6011;2037;6445
171630;201705;889;2707;752;2503;192;670;405;1350;597;2020
171650;201705;2200;6726;1647;5582;380;1323;560;1938;940;3261
171660;201705;2383;6547;1771;5452;282;904;919;2802;1201;3706
171665;201705;1479;4233;1149;3732;224;785;527;1783;751;2568
171670;201705;1849;5130;1506;4583;352;1208;686;2034;1038;3242
171700;201705;1097;3437;894;3054;145;492;469;1643;614;2135
171720;201705;777;2250;659;2048;121;383;384;1215;505;1598
171750;201705;1161;3544;873;2981;251;870;230;836;481;1706
171780;201705;1209;3229;882;2762;78;273;543;1703;621;1976
171790;201705;1461;5141;1220;4577;273;1032;593;2376;866;3408
171800;201705;728;2186;591;1980;64;217;377;1307;441;1524
171820;201705;10224;30256;8316;27130;1753;6078;3595;12132;5348;18210
171830;201705;1345;4928;1207;4628;318;1196;526;2151;844;3347
171840;201705;712;1992;607;1842;39;140;458;1366;497;1506
171845;201705;673;1841;531;1607;80;275;279;854;359;1129
171850;201705;880;3141;780;2932;81;342;517;1952;598;2294
171855;201705;1141;3574;1036;3390;72;248;754;2464;826;2712
171865;201705;427;1445;371;1353;68;256;177;649;245;905
171870;201705;713;2113;561;1837;122;397;233;857;355;1254
171875;201705;1232;3861;1029;3532;77;324;732;2488;809;2812
171880;201705;892;3162;855;3111;87;282;694;2620;781;2902
171884;201705;912;2485;667;2120;144;523;195;707;339;1230
171886;201705;1362;4278;1044;3645;317;1206;209;751;526;1957
171888;201705;737;2186;550;1818;58;210;317;1031;375;1241
171889;201705;508;1550;445;1441;75;248;223;774;298;1022
171890;201705;1200;3521;978;3197;170;560;555;1839;725;2399
171900;201705;489;1754;391;1503;91;361;153;601;244;962
172000;201705;587;1870;499;1694;71;275;265;874;336;1149
172010;201705;1170;4053;1065;3856;117;519;726;2574;843;3093
172015;201705;335;1305;275;1184;50;204;137;613;187;817
172020;201705;2358;7707;2191;7455;260;942;1537;5286;1797;6228
172025;201705;718;2067;528;1751;71;269;286;966;357;1235
172030;201705;1189;3739;1054;3520;54;227;828;2756;882;2983
172049;201705;1342;3397;944;2735;384;1217;381;1054;765;2271
172065;201705;1356;3513;1101;3223;64;183;983;2913;1047;3096
172080;201705;2450;7525;2033;6779;172;664;1365;4532;1537;5196
172085;201705;481;1351;344;1068;60;168;111;344;171;512
172090;201705;3929;10562;3203;9533;111;343;2707;8153;2818;8496
172093;201705;546;1648;418;1421;85;326;201;672;286;998
172097;201705;670;1928;512;1666;106;356;195;660;301;1016
172100;201705;37898;105836;27987;89228;7326;26007;7529;24888;14855;50895
172110;201705;1660;6190;1459;5864;171;751;1050;4345;1221;5096
172120;201705;5044;15680;4099;14256;801;2798;2229;8110;3030;10908
172125;201705;264;815;216;727;37;140;105;354;142;494
172130;201705;541;1510;414;1294;40;150;256;784;296;934
172208;201705;2167;6174;1880;5752;251;805;1145;3543;1396;4348
172210;201705;2555;7499;2195;6998;403;1374;1289;4123;1692;5497
210005;201705;21391;65373;17971;60108;5645;20019;6703;23214;12348;43233
210010;201705;1702;5901;1549;5639;74;315;1293;4743;1367;5058
210015;201705;3463;10734;3070;10130;188;484;2584;8833;2772;9317
210020;201705;7194;17045;6740;16521;164;434;6249;15260;6413;15694
210030;201705;5264;17524;4954;17112;327;1551;4130;14102;4457;15653
210040;201705;2157;6535;2037;6398;52;139;1884;6021;1936;6160
210043;201705;6878;18763;5849;17527;739;2081;4139;13240;4878;15321
210047;201705;6576;23409;6005;22599;407;1849;4901;18474;5308;20323
210050;201705;2262;8265;1881;7516;477;1954;876;3753;1353;5707
210055;201705;1726;5982;1582;5758;98;421;1238;4518;1336;4939
210060;201705;7015;27353;6503;26396;958;4020;4390;18372;5348;22392
210070;201705;7324;21109;6810;20495;95;327;6312;19183;6407;19510
210080;201705;3737;12873;3648;12771;28;117;3518;12387;3546;12504
210083;201705;4679;15856;4180;15310;107;486;3901;14372;4008;14858
210087;201705;3023;8798;2745;8435;258;787;2177;6812;2435;7599
210090;201705;10382;32669;9840;31836;359;1325;8793;28475;9152;29800
210095;201705;5826;20621;5557;20266;330;1324;4764;17565;5094;18889
210100;201705;7224;21545;6625;20774;289;1167;5586;17389;5875;18556
210110;201705;2765;9505;2653;9357;92;420;2397;8441;2489;8861
210120;201705;26359;72449;22995;68504;2909;7346;16116;51299;19025;58645
210125;201705;3688;11348;3537;11188;278;641;3065;10070;3343;10711
210130;201705;4182;12242;3840;11770;245;812;3169;9700;3414;10512
210135;201705;1613;4788;1405;4485;75;224;1143;3706;1218;3930
210140;201705;16984;53139;14419;49648;2897;10683;8161;28828;11058;39511
210150;201705;4625;11347;4107;10710;59;211;3751;9704;3810;9915
210160;201705;17392;54167;16301;52534;1331;3999;12982;43122;14313;47121
210170;201705;14142;48712;13680;48132;704;2560;12198;43340;12902;45900
210173;201705;2450;9465;2325;9280;52;279;2151;8667;2203;8946
210177;201705;3116;9386;2938;9173;86;245;2729;8636;2815;8881
210180;201705;1507;4487;1425;4370;41;157;1229;3751;1270;3908
210190;201705;4812;15063;4432;14376;168;810;3537;11226;3705;12036
210193;201705;1322;4137;1195;3937;66;237;975;3228;1041;3465
210197;201705;2048;6833;1879;6630;230;789;1420;5216;1650;6005
210200;201705;8200;27116;7584;26259;821;2726;5954;21274;6775;24000
210203;201705;6796;21063;6384;20530;309;880;5677;18634;5986;19514
210207;201705;3316;10852;3135;10539;248;766;2495;8643;2743;9409
210210;201705;8424;28287;8020;27757;110;444;7400;26032;7510;26476
210215;201705;1166;4803;1119;4728;84;425;900;3844;984;4269
210220;201705;5889;22121;5611;21675;298;1456;4763;18380;5061;19836
210230;201705;5221;16609;4864;16083;223;757;4294;14285;4517;15042
210232;201705;12795;40558;10719;37923;1642;5920;6871;26396;8513;32316
210235;201705;3797;11549;3352;10996;163;655;2869;9466;3032;10121
210237;201705;2275;8677;2209;8588;27;127;2106;8251;2133;8378
210240;201705;2965;9227;2750;8904;135;489;2331;7551;2466;8040
210250;201705;5316;16968;4988;16548;134;671;4538;14938;4672;15609
210255;201705;2629;8334;2384;7897;297;1038;1717;5712;2014;6750
210260;201705;5183;16715;4817;16164;399;1353;3821;13048;4220;14401
210270;201705;5226;14857;4627;14028;126;603;4029;12081;4155;12684
210275;201705;3534;8707;3339;8495;96;172;3152;8147;3248;8319
210280;201705;5674;16937;4833;15752;272;1305;3595;11429;3867;12734
210290;201705;5804;18811;5360;18288;208;782;4692;16172;4900;16954
210300;201705;37457;102590;30952;94604;2242;7190;23163;73896;25405;81086
210310;201705;2882;8016;2635;7695;82;195;2302;6810;2384;7005
210312;201705;2356;7146;2211;6958;74;342;1963;6155;2037;6497
210315;201705;2817;8656;2470;8228;106;383;2131;7239;2237;7622
210317;201705;4035;12726;3865;12528;149;540;3541;11523;3690;12063
210320;201705;19680;62990;18179;61171;808;3133;15858;54167;16666;57300
210325;201705;3794;11381;3379;10766;173;625;2773;8940;2946;9565
210330;201705;32984;85190;26996;78476;5195;13950;15942;52768;21137;66718
210340;201705;11521;34288;10444;32869;1112;3063;7679;25821;8791;28884
210350;201705;9831;29608;8799;28194;430;1505;7260;23487;7690;24992
210355;201705;3971;14304;3587;13710;162;782;3006;11656;3168;12438
210360;201705;15144;45729;13754;43823;896;3384;11098;35302;11994;38686
210370;201705;9626;22864;8027;21158;329;636;7064;19379;7393;20015
210375;201705;3182;9455;2620;8726;743;2564;1253;4364;1996;6928
210380;201705;5852;16045;5278;15310;375;1014;4400;13026;4775;14040
210390;201705;3000;10558;2736;10142;152;746;2256;8367;2408;9113
210400;201705;4912;15251;4610;14882;117;299;4306;14073;4423;14372
210405;201705;7736;21459;6227;19297;1611;5022;2885;9585;4496;14607
210407;201705;1963;6991;1678;6469;186;743;1213;4711;1399;5454
210408;201705;2435;9394;2280;9197;162;799;1843;7625;2005;8424
210409;201705;3745;13454;3545;13158;200;928;2975;11065;3175;11993
210410;201705;3759;11961;3553;11646;308;830;2822;9696;3130;10526
210420;201705;4132;13514;3761;12878;222;801;3084;10672;3306;11473
210430;201705;2145;6553;2063;6462;94;293;1814;5716;1908;6009
210440;201705;4072;12181;3908;11979;111;332;3624;11185;3735;11517
210450;201705;2716;8492;2399;8025;127;466;1923;6421;2050;6887
210455;201705;3802;10867;3413;10402;620;1834;2353;7541;2973;9375
210460;201705;3530;11365;3243;10945;158;667;2676;9008;2834;9675
210462;201705;1350;4869;1245;4680;78;376;999;3740;1077;4116
210465;201705;2592;8378;2390;8096;123;358;2085;7238;2208;7596
210467;201705;6141;20435;5776;20026;343;1232;5050;17767;5393;18999
210470;201705;2099;5605;1519;4758;95;287;1140;3642;1235;3929
210480;201705;14701;46545;12902;44315;1824;6046;9160;33771;10984;39817
210490;201705;3780;10118;3212;9333;78;275;2770;8033;2848;8308
210500;201705;6126;25444;5910;25040;525;2452;4694;20038;5219;22490
210510;201705;6482;21864;6087;21395;329;1036;5232;18924;5561;19960
210515;201705;3673;11506;3498;11311;153;383;3195;10599;3348;10982
210520;201705;2654;7962;2401;7621;144;496;2035;6509;2179;7005
210530;201705;50462;136423;42879;125215;6880;26010;13110;45988;19990;71998
210535;201705;3229;10987;3051;10747;121;449;2685;9597;2806;10046
210540;201705;13057;43012;11662;41073;1794;6263;7748;28856;9542;35119
210542;201705;5816;16218;5268;15622;327;767;4584;14025;4911;14792
210545;201705;2335;7401;2223;7236;45;242;1983;6376;2028;6618
210547;201705;3738;13243;3468;12781;373;1339;2540;9655;2913;10994
210550;201705;6177;17886;5500;17165;290;865;4887;15578;5177;16443
210560;201705;3928;12193;3521;11523;143;569;2988;9720;3131;10289
210565;201705;1462;5225;1255;4897;62;300;994;3968;1056;4268
210570;201705;12051;33867;11076;32775;582;1434;9802;29653;10384;31087
210580;201705;3165;9142;2860;8769;296;611;2286;7438;2582;8049
210590;201705;3964;12657;3669;12275;209;855;3196;10638;3405;11493
210592;201705;2545;7909;2431;7726;49;245;2139;6758;2188;7003
210594;201705;2749;7682;2197;6839;109;310;1625;5233;1734;5543
210596;201705;2591;9583;2462;9333;238;997;1846;7091;2084;8088
210598;201705;1759;5495;1641;5351;92;394;1448;4680;1540;5074
210600;201705;3207;9083;2723;8439;130;454;2172;6733;2302;7187
210610;201705;2526;8125;2335;7880;129;585;2019;6699;2148;7284
210620;201705;2067;6601;1887;6382;45;104;1723;5980;1768;6084
210630;201705;3320;11744;3050;11315;255;1193;2326;8510;2581;9703
210632;201705;4528;15495;4163;14958;447;1784;3185;11478;3632;13262
210635;201705;1884;6575;1777;6406;76;269;1554;5689;1630;5958
210637;201705;2674;9144;2436;8801;137;555;1952;7162;2089;7717
210640;201705;4695;18800;4618;18719;16;62;4509;18419;4525;18481
210650;201705;7076;20983;6836;20677;133;402;6526;19816;6659;20218
210660;201705;8422;24508;7617;23348;243;908;6756;20552;6999;21460
210663;201705;2734;8361;2606;8206;122;385;2261;7254;2383;7639
210667;201705;1918;6420;1804;6241;74;319;1562;5436;1636;5755
210670;201705;4578;16492;4341;16113;215;1013;3672;13664;3887;14677
210675;201705;5079;14051;4620;13485;425;1090;3728;11251;4153;12341
210680;201705;3991;10703;3480;10090;142;367;3054;8977;3196;9344
210690;201705;7531;25213;7207;24869;311;1058;6300;22537;6611;23595
210700;201705;2657;7709;2427;7453;305;725;1787;6133;2092;6858
210710;201705;4909;16000;4619;15575;205;921;3930;13202;4135;14123
210720;201705;2655;9356;2494;9137;100;494;2243;8166;2343;8660
210725;201705;1098;4162;1004;3972;37;134;768;3190;805;3324
210730;201705;1208;3503;1040;3269;79;242;815;2588;894;2830
210735;201705;4245;14056;3843;13403;431;1583;2912;10354;3343;11937
210740;201705;5114;14958;4780;14615;191;892;4263;12758;4454;13650
210745;201705;4249;12032;3998;11734;223;577;3434;10182;3657;10759
210750;201705;19554;52947;17186;50229;2055;6025;12522;37695;14577;43720
210760;201705;5893;16913;5395;16390;32;88;5231;16001;5263;16089
210770;201705;5897;16084;5081;15142;96;392;4583;13682;4679;14074
210780;201705;7756;25906;7132;24845;806;2779;5113;18373;5919;21152
210790;201705;4825;15024;4435;14558;206;540;3587;12442;3793;12982
210800;201705;4896;13512;4370;12886;107;386;3935;11621;4042;12007
210805;201705;3826;15278;3696;15079;184;927;3180;13034;3364;13961
210810;201705;5343;16032;4954;15541;289;599;4333;14163;4622;14762
210820;201705;7699;22152;6865;20875;807;2368;4778;14944;5585;17312
210825;201705;5903;19961;5640;19611;553;1801;4578;16453;5131;18254
210830;201705;8416;24115;7935;23534;692;1717;6571;20209;7263;21926
210840;201705;3582;9742;3215;9238;92;330;2747;7835;2839;8165
210845;201705;6079;17721;5873;17500;62;139;5713;17172;5775;17311
210850;201705;6241;21534;5576;20486;522;2272;4113;15085;4635;17357
210860;201705;17895;52207;15900;49409;1043;3314;12720;40188;13763;43502
210870;201705;5844;19191;5328;18530;493;1719;4281;15191;4774;16910
210880;201705;4353;14013;4123;13729;277;1081;3430;11413;3707;12494
210890;201705;4850;14500;4459;14052;324;828;3740;12389;4064;13217
210900;201705;4831;14391;3940;12923;1558;5394;972;3514;2530;8908
210905;201705;1856;5705;1625;5376;90;261;1310;4460;1400;4721
210910;201705;8232;26081;7263;24446;873;3181;4992;16872;5865;20053
210920;201705;2844;10405;2705;10172;132;692;2272;8521;2404;9213
210923;201705;1490;4981;1378;4811;136;534;952;3421;1088;3955
210927;201705;4798;15460;4527;15170;100;324;4251;14416;4351;14740
210930;201705;2495;8940;2335;8719;118;641;1945;7138;2063;7779
210940;201705;3167;11182;3048;10987;159;750;2628;9346;2787;10096
210945;201705;5767;17641;5546;17394;272;638;4995;15900;5267;16538
210950;201705;5303;16058;4437;14732;474;1554;3164;10840;3638;12394
210955;201705;1836;5848;1630;5542;139;491;1160;4039;1299;4530
210960;201705;9105;28688;8338;27655;1720;5453;5066;18027;6786;23480
210970;201705;1350;4628;1182;4344;127;547;854;3083;981;3630
210975;201705;1762;5848;1664;5669;124;455;1275;4346;1399;4801
210980;201705;10174;23513;9739;23071;400;757;8924;21555;9324;22312
210990;201705;16322;50117;13464;46027;2950;10484;6923;24875;9873;35359
211000;201705;15564;48448;13778;46421;776;3236;11479;39318;12255;42554
211003;201705;4644;16676;4213;16120;263;1225;3287;12869;3550;14094
211010;201705;6558;23954;6185;23499;64;325;5835;22388;5899;22713
211020;201705;7579;24356;7273;23910;460;1754;6107;20030;6567;21784
211023;201705;2183;7385;2099;7252;161;684;1722;5896;1883;6580
211027;201705;2929;10638;2866;10533;291;1123;2333;8620;2624;9743
211030;201705;3878;11648;3613;11370;420;915;2931;9882;3351;10797
211040;201705;4543;16721;4341;16426;168;969;3766;14225;3934;15194
211050;201705;10085;25671;9557;25100;196;526;9049;23783;9245;24309
211060;201705;6082;21195;5883;20927;396;1552;5065;18121;5461;19673
211065;201705;2046;6304;1828;6003;51;166;1641;5447;1692;5613
211070;201705;7926;26902;7271;25841;373;1434;6030;21697;6403;23131
211080;201705;1326;3944;1155;3684;76;370;879;2648;955;3018
211085;201705;2023;6591;1846;6299;203;703;1380;4793;1583;5496
211090;201705;3457;9809;3206;9474;94;423;2804;8175;2898;8598
211100;201705;6444;17130;6287;16951;34;135;6109;16453;6143;16588
211102;201705;2866;10912;2710;10694;213;902;2284;9166;2497;10068
211105;201705;2503;8216;2163;7674;217;844;1552;5471;1769;6315
211107;201705;4598;14538;4065;13798;237;810;3263;11438;3500;12248
211110;201705;6336;18418;5063;16525;759;2379;3349;11416;4108;13795
211120;201705;36375;102547;33404;99122;4629;13126;24677;75874;29306;89000
211125;201705;2087;6516;1829;6105;116;426;1499;5044;1615;5470
211130;201705;170719;450078;159363;436091;23639;67871;78970;236565;102609;304436
211140;201705;5182;16675;4810;16113;226;893;4076;13653;4302;14546
211150;201705;9711;27701;8660;26422;363;1352;7373;22528;7736;23880
211153;201705;2715;8426;2460;8097;513;1743;1614;5545;2127;7288
211157;201705;1151;3683;990;3428;76;365;675;2358;751;2723
211160;201705;4181;13364;3522;12272;262;1256;2414;8154;2676;9410
211163;201705;1735;5888;1630;5743;39;114;1484;5351;1523;5465
211167;201705;1532;5017;1463;4915;34;146;1380;4630;1414;4776
211170;201705;6087;16070;5849;15783;90;305;5479;14703;5569;15008
211172;201705;2460;7115;2217;6771;90;381;1890;5676;1980;6057
211174;201705;2726;8049;2503;7767;57;309;2299;7045;2356;7354
211176;201705;4244;13170;3612;12335;293;1197;2761;9481;3054;10678
211178;201705;4358;10631;3981;10213;41;130;3774;9617;3815;9747
211180;201705;4226;14498;3976;14136;278;1067;3360;12037;3638;13104
211190;201705;2901;9357;2667;9009;79;388;2274;7620;2353;8008
211195;201705;1472;4354;1246;4068;74;232;1018;3422;1092;3654
211200;201705;2180;7037;1907;6663;315;1092;1184;4370;1499;5462
211210;201705;6825;20733;6444;20236;379;1256;5535;17492;5914;18748
211220;201705;34024;96318;29847;91017;4448;13967;20034;63041;24482;77008
211223;201705;5077;15488;4637;14810;452;1406;3518;11448;3970;12854
211227;201705;1713;6005;1560;5779;74;329;1326;4960;1400;5289
211230;201705;7970;25509;7211;24278;701;2515;5475;18633;6176;21148
211240;201705;7980;27347;7570;26818;249;1270;6830;23935;7079;25205
211245;201705;5728;16724;5692;16688;56;99;5607;16533;5663;16632
211250;201705;13617;42293;12768;41300;906;2702;10764;35725;11670;38427
211260;201705;8466;26074;7983;25445;337;1277;7192;22944;7529;24221
211270;201705;10354;34880;9286;33540;537;2448;7410;27233;7947;29681
211280;201705;13326;39163;12143;37663;905;2324;9849;31757;10754;34081
211285;201705;1780;6489;1565;6046;251;1059;792;3154;1043;4213
211290;201705;7112;23067;6786;22639;352;1187;5902;19953;6254;21140
211300;201705;8249;24421;7694;23672;124;378;7191;22241;7315;22619
211400;201705;11824;36475;10103;33956;2299;7840;5392;19798;7691;27638
220005;201705;1865;5258;1685;4993;66;268;1329;3816;1395;4084
220010;201705;1421;4145;1252;3881;31;136;999;3035;1030;3171
220020;201705;3313;10372;3093;10004;552;1819;1954;6378;2506;8197
220025;201705;2283;5525;2043;5194;36;112;1703;4257;1739;4369
220027;201705;1363;3605;1206;3401;56;163;960;2704;1016;2867
220030;201705;3270;8687;3156;8506;135;451;2712;7149;2847;7600
220040;201705;7643;23441;7000;22296;1251;4031;4497;14405;5748;18436
220045;201705;1411;4604;1272;4327;52;255;976;3235;1028;3490
220050;201705;4494;13417;3876;12404;184;770;3109;9878;3293;10648
220060;201705;2159;5182;1909;4894;33;81;1731;4435;1764;4516
220070;201705;2420;6927;2177;6544;116;332;1739;5234;1855;5566
220080;201705;679;2059;630;1984;40;162;530;1608;570;1770
220090;201705;1830;4553;1499;4103;46;170;1296;3501;1342;3671
220095;201705;727;1928;681;1865;13;51;629;1700;642;1751
220100;201705;1321;3920;1084;3483;60;251;864;2731;924;2982
220105;201705;2228;6988;1976;6502;131;446;1469;4879;1600;5325
220110;201705;3403;9754;3267;9543;85;324;2870;8274;2955;8598
220115;201705;2608;8585;2492;8387;131;532;2154;7171;2285;7703
220117;201705;1273;3357;1037;2994;37;107;866;2484;903;2591
220120;201705;11887;34698;11058;33692;134;599;10348;31448;10482;32047
220130;201705;910;2943;804;2786;30;178;692;2348;722;2526
220140;201705;1696;4454;1469;4182;146;309;1186;3496;1332;3805
220150;201705;7027;21023;6644;20500;191;843;5789;17652;5980;18495
220155;201705;1095;3304;866;2867;39;158;593;1931;632;2089
220157;201705;1084;2731;929;2479;21;78;758;1966;779;2044
220160;201705;2617;7856;2324;7316;80;380;1874;5771;1954;6151
220170;201705;1388;4063;1187;3744;36;167;979;3044;1015;3211
220173;201705;2005;6032;1692;5441;51;270;1330;4176;1381;4446
220177;201705;1821;5432;1783;5383;31;124;1704;5129;1735;5253
220180;201705;1183;3112;939;2669;16;65;678;1824;694;1889
220190;201705;4692;14837;4307;14333;448;1557;3326;11101;3774;12658
220191;201705;1409;4633;1322;4477;123;499;995;3299;1118;3798
220192;201705;1819;5124;1459;4491;60;211;1112;3396;1172;3607
220194;201705;1806;5331;1604;5034;92;353;1262;3875;1354;4228
220196;201705;2043;5818;1873;5527;95;364;1531;4441;1626;4805
220198;201705;1364;3832;1039;3401;12;44;964;3197;976;3241
220200;201705;4519;14662;4180;14224;295;1114;3457;11787;3752;12901
220202;201705;2165;6323;1886;5839;29;163;1614;4899;1643;5062
220205;201705;2752;7266;2458;6872;51;196;2148;5919;2199;6115
220207;201705;861;2643;739;2428;64;259;503;1620;567;1879
220208;201705;1801;5709;1540;5257;244;944;886;3004;1130;3948
220209;201705;1590;4700;1377;4331;32;145;1105;3466;1137;3611
220210;201705;1643;4373;1434;4036;41;176;1153;3139;1194;3315
220211;201705;1566;4373;1491;4274;38;159;1297;3679;1335;3838
220213;201705;1686;4760;1547;4487;30;120;1258;3572;1288;3692
220217;201705;2014;6326;1931;6229;37;143;1786;5820;1823;5963
220220;201705;10491;28696;9333;26959;661;1789;6890;20343;7551;22132
220225;201705;1115;3170;917;2899;27;108;753;2359;780;2467
220230;201705;5535;14610;5010;13890;191;526;4368;12171;4559;12697
220240;201705;2875;8789;2648;8358;99;389;2170;6809;2269;7198
220245;201705;1518;4001;1274;3672;22;78;1106;3244;1128;3322
220250;201705;3028;8860;2731;8418;72;305;2362;7282;2434;7587
220253;201705;1596;4639;1347;4195;140;474;998;3064;1138;3538
220255;201705;1771;4811;1514;4378;40;193;1216;3352;1256;3545
220260;201705;4554;14543;4049;13626;286;1027;3021;10253;3307;11280
220265;201705;1330;4516;1214;4325;106;435;828;2948;934;3383
220270;201705;6812;21835;6496;21261;430;1776;5224;16663;5654;18439
220271;201705;1479;4109;1307;3840;52;150;1081;3223;1133;3373
220272;201705;1787;5327;1613;5028;51;216;1246;3818;1297;4034
220273;201705;1219;3502;1064;3220;64;228;789;2371;853;2599
220275;201705;2175;5398;1742;4884;44;173;1490;4139;1534;4312
220277;201705;2238;6050;1952;5606;55;194;1572;4421;1627;4615
220280;201705;1511;4105;1319;3767;72;266;1046;2887;1118;3153
220285;201705;1672;4338;1371;3939;25;100;1245;3584;1270;3684
220290;201705;6123;19940;5205;18605;559;2194;3565;12809;4124;15003
220300;201705;1783;5952;1596;5660;77;431;1267;4368;1344;4799
220310;201705;2461;8091;2219;7810;78;384;1862;6566;1940;6950
220320;201705;2956;9027;2524;8242;245;932;1830;5942;2075;6874
220323;201705;1505;5196;1308;4896;127;523;1025;3836;1152;4359
220325;201705;1202;3745;1021;3388;59;242;773;2548;832;2790
220327;201705;1339;4232;1218;4014;55;267;990;3180;1045;3447
220330;201705;3711;10012;3283;9438;134;401;2810;8094;2944;8495
220335;201705;1793;5454;1611;5242;32;112;1502;4915;1534;5027
220340;201705;1875;5088;1544;4561;72;259;1129;3235;1201;3494
220342;201705;1155;3678;1086;3572;66;260;867;2863;933;3123
220345;201705;2900;7170;2559;6697;36;76;2357;6182;2393;6258
220350;201705;3766;9959;3147;8972;168;591;2381;6660;2549;7251
220360;201705;1271;3411;1084;3134;63;199;847;2394;910;2593
220370;201705;9362;26448;8494;25337;260;1018;7543;22382;7803;23400
220375;201705;1497;4603;1390;4467;13;36;1345;4363;1358;4399
220380;201705;1382;3661;1171;3360;30;115;988;2773;1018;2888
220385;201705;862;2185;687;1897;12;53;559;1506;571;1559
220390;201705;8895;27022;7863;25245;1972;6535;3281;10870;5253;17405
220400;201705;1510;3778;1176;3243;32;127;921;2439;953;2566
220410;201705;1181;3402;1002;3119;70;235;777;2389;847;2624
220415;201705;831;2272;724;2109;29;101;521;1478;550;1579
220420;201705;2159;6181;1791;5470;94;285;1316;3994;1410;4279
220430;201705;2505;6905;2444;6830;101;323;2192;6077;2293;6400
220435;201705;1703;4898;1548;4649;50;179;1196;3553;1246;3732
220440;201705;2409;7888;2260;7675;155;557;1807;6053;1962;6610
220450;201705;1972;6021;1665;5576;343;1269;1032;3446;1375;4715
220455;201705;1321;4104;1249;4001;41;147;1111;3555;1152;3702
220460;201705;902;2470;818;2367;45;140;694;1974;739;2114
220465;201705;2374;7726;2165;7404;223;808;1617;5565;1840;6373
220470;201705;3626;10684;3319;10205;134;463;2664;8078;2798;8541
220480;201705;2449;6873;2123;6346;134;334;1552;4628;1686;4962
220490;201705;2300;6372;2103;6135;47;172;1861;5404;1908;5576
220500;201705;3141;8419;2712;7712;90;378;2081;5712;2171;6090
220510;201705;2848;8299;2313;7364;96;339;1727;5534;1823;5873
220515;201705;1822;4420;1620;4153;100;254;1380;3530;1480;3784
220520;201705;5133;13816;4709;13256;110;324;4219;11910;4329;12234
220525;201705;1253;3503;1185;3407;41;154;1005;2860;1046;3014
220527;201705;1375;4118;1217;3820;91;294;900;2882;991;3176
220530;201705;1275;3567;1118;3342;52;213;972;2835;1024;3048
220535;201705;854;2546;810;2485;67;232;620;1878;687;2110
220540;201705;3525;11145;3364;10902;117;529;2925;9404;3042;9933
220545;201705;1408;4614;1332;4475;108;432;1052;3492;1160;3924
220550;201705;9291;29173;8514;27873;662;2425;6378;20691;7040;23116
220551;201705;1484;4564;1313;4287;71;307;1029;3263;1100;3570
220552;201705;1586;4865;1379;4485;78;390;1064;3320;1142;3710
220553;201705;1638;4642;1375;4244;54;201;1061;3344;1115;3545
220554;201705;787;2266;697;2134;42;114;549;1689;591;1803
220555;201705;2112;6775;1961;6558;52;275;1665;5473;1717;5748
220556;201705;1382;4209;1232;3915;51;232;920;2795;971;3027
220557;201705;1573;4955;1408;4639;104;393;1033;3373;1137;3766
220558;201705;1117;3337;979;3127;43;199;778;2422;821;2621
220559;201705;1571;4334;1392;4038;24;86;1175;3389;1199;3475
220560;201705;1624;3988;1324;3582;37;108;1132;3008;1169;3116
220570;201705;7185;23034;6767;22300;757;2632;4917;16417;5674;19049
220580;201705;6697;20114;6503;19813;222;746;5870;17764;6092;18510
220585;201705;2061;6842;1881;6516;107;459;1491;5096;1598;5555
220590;201705;1299;3808;1142;3578;106;350;816;2598;922;2948
220595;201705;2433;6937;2272;6725;32;156;2094;6119;2126;6275
220600;201705;1321;3168;1077;2849;77;119;870;2387;947;2506
220605;201705;1848;5440;1592;5002;53;213;1229;3767;1282;3980
220610;201705;2802;8229;2653;8020;51;223;2395;7185;2446;7408
220620;201705;7545;24855;7251;24453;257;1216;6454;21547;6711;22763
220630;201705;394;1205;324;1078;47;175;174;591;221;766
220635;201705;1686;5586;1497;5184;74;315;1130;3849;1204;4164
220640;201705;2722;7694;2403;7238;96;345;1985;5929;2081;6274
220650;201705;2142;6242;1898;5810;92;316;1409;4302;1501;4618
220660;201705;2857;8438;2571;8090;119;568;2231;6835;2350;7403
220665;201705;1197;3958;1093;3789;32;161;923;3177;955;3338
220667;201705;1680;5505;1530;5244;81;293;1245;4278;1326;4571
220669;201705;1813;5795;1727;5643;144;622;1326;4241;1470;4863
220670;201705;1987;5763;1735;5447;90;268;1490;4725;1580;4993
220672;201705;2478;7124;2281;6880;138;449;1971;5979;2109;6428
220675;201705;1268;3590;1177;3429;67;172;918;2689;985;2861
220680;201705;2435;7409;2315;7258;109;365;2018;6323;2127;6688
220690;201705;1717;4710;1485;4334;122;325;1108;3312;1230;3637
220695;201705;974;2755;880;2576;26;88;713;2072;739;2160
220700;201705;8319;23401;7195;21681;477;1647;5446;16224;5923;17871
220710;201705;814;2415;651;2097;42;131;455;1452;497;1583
220720;201705;2085;5270;1949;5076;59;184;1678;4328;1737;4512
220730;201705;1384;3944;1172;3615;29;128;973;2953;1002;3081
220735;201705;1017;2527;795;2160;25;76;642;1710;667;1786
220740;201705;1407;4267;1197;3988;54;193;1002;3386;1056;3579
220750;201705;3984;11031;3622;10490;230;656;2991;8691;3221;9347
220755;201705;1197;3309;1067;3099;51;186;829;2349;880;2535
220760;201705;2923;9239;2639;8859;122;535;2262;7535;2384;8070
220770;201705;21424;70602;19233;66428;6484;23468;6169;22417;12653;45885
220775;201705;1227;3266;1174;3209;14;58;1143;3115;1157;3173
220777;201705;1565;4218;1305;3816;55;152;1001;2930;1056;3082
220779;201705;1374;3517;1275;3385;41;151;1118;2919;1159;3070
220780;201705;5675;15357;5038;14357;352;1138;3969;11168;4321;12306
220785;201705;1435;3407;1334;3258;38;67;1238;3022;1276;3089
220790;201705;10412;30662;9523;29338;478;1846;7801;23735;8279;25581
220793;201705;818;2290;734;2163;40;134;592;1742;632;1876
220795;201705;1490;4068;1386;3934;49;170;1222;3459;1271;3629
220800;201705;16186;43279;14273;40357;1038;3299;10145;27960;11183;31259
220810;201705;3207;9171;2790;8458;85;329;2245;6690;2330;7019
220820;201705;5461;14621;4855;13758;357;975;3905;11040;4262;12015
220830;201705;7355;20644;6816;19807;460;1428;5468;15853;5928;17281
220840;201705;13577;42398;12010;39298;2310;7651;6444;21439;8754;29090
220850;201705;2993;9743;2809;9520;86;405;2550;8610;2636;9015
220855;201705;603;1817;522;1670;27;115;407;1276;434;1391
220860;201705;967;2552;856;2383;29;91;724;1982;753;2073
220865;201705;2638;7107;2091;6184;56;252;1666;4763;1722;5015
220870;201705;2213;7328;1968;7002;50;248;1755;6219;1805;6467
220880;201705;4732;12524;4385;12122;51;170;4131;11427;4182;11597
220885;201705;1277;4499;1119;4208;74;357;851;3183;925;3540
220887;201705;1395;3374;1219;3132;15;61;1121;2845;1136;2906
220890;201705;1641;5545;1421;5106;113;419;1031;3776;1144;4195
220900;201705;1914;5099;1686;4775;40;119;1462;4102;1502;4221
220910;201705;1514;4510;1321;4215;40;121;1155;3732;1195;3853
220915;201705;985;2780;846;2512;34;150;648;1858;682;2008
220920;201705;1319;4765;1191;4573;88;442;898;3383;986;3825
220930;201705;1481;4619;1347;4419;39;197;1153;3738;1192;3935
220935;201705;1079;3199;906;2832;38;158;609;1805;647;1963
220937;201705;1492;4027;1262;3662;41;157;995;2835;1036;2992
220940;201705;1317;4096;1206;3886;64;276;872;2725;936;3001
220945;201705;414;1519;371;1426;31;155;261;982;292;1137
220950;201705;1317;3210;926;2563;18;81;707;1886;725;1967
220955;201705;1480;4166;1301;3854;62;171;1024;3040;1086;3211
220960;201705;911;2317;722;2008;21;76;565;1549;586;1625
220965;201705;1660;4830;1543;4656;36;211;1335;3899;1371;4110
220970;201705;1916;5134;1510;4471;71;232;1157;3406;1228;3638
220975;201705;729;2291;660;2205;30;177;579;1853;609;2030
220980;201705;1253;3663;1111;3432;44;161;875;2678;919;2839
220985;201705;1202;3483;1123;3366;68;269;851;2438;919;2707
220987;201705;1462;4606;1313;4358;76;331;1041;3380;1117;3711
220990;201705;1805;5174;1541;4736;43;208;1186;3549;1229;3757
220995;201705;1251;3677;964;3220;82;297;665;2281;747;2578
220997;201705;2408;7117;2291;6957;39;173;2130;6412;2169;6585
221000;201705;4168;12442;3902;12002;250;977;3121;9454;3371;10431
221005;201705;1440;4340;1318;4122;187;540;875;2743;1062;3283
221010;201705;1223;3067;1050;2855;24;84;918;2449;942;2533
221020;201705;1676;5241;1553;5007;55;255;1130;3567;1185;3822
221030;201705;1469;4312;1306;4045;60;251;1043;3147;1103;3398
221035;201705;1507;4068;1399;3928;54;132;1270;3642;1324;3774
221037;201705;598;1764;529;1644;12;57;361;1069;373;1126
221038;201705;593;1663;469;1456;30;104;292;907;322;1011
221039;201705;956;2602;841;2429;23;84;690;1938;713;2022
221040;201705;4513;13885;4181;13330;206;704;3287;10557;3493;11261
221050;201705;3601;10431;3321;10073;91;347;2963;8929;3054;9276
221060;201705;8100;23604;6973;21730;404;1436;5360;16629;5764;18065
221062;201705;1297;4459;1160;4181;61;306;893;3171;954;3477
221063;201705;1105;3451;984;3248;99;341;686;2266;785;2607
221065;201705;2809;7405;2475;6876;77;233;2083;5704;2160;5937
221070;201705;3688;11673;3183;10718;179;708;2366;7916;2545;8624
221080;201705;3551;8821;2881;7877;84;317;2335;6326;2419;6643
221090;201705;1394;3821;1206;3504;36;145;1007;2856;1043;3001
221093;201705;1562;4603;1467;4416;179;581;923;2680;1102;3261
221095;201705;976;2599;848;2396;13;38;703;1950;716;1988
221097;201705;818;2239;656;1943;26;95;477;1368;503;1463
221100;201705;101489;296389;92545;281123;17654;56158;53213;159658;70867;215816
221110;201705;10483;32278;9706;31329;399;1825;8298;26434;8697;28259
221120;201705;4119;12930;3935;12620;510;1763;2880;9216;3390;10979
221130;201705;4552;12838;3717;11149;992;2888;1620;4959;2612;7847
221135;201705;1544;4528;1421;4355;67;248;1218;3702;1285;3950
221140;201705;1340;3270;1201;3072;23;58;1060;2680;1083;2738
221150;201705;1202;3020;959;2605;26;103;719;1889;745;1992
221160;201705;775;2014;723;1945;26;75;591;1578;617;1653
221170;201705;1155;3419;1051;3251;35;125;837;2563;872;2688
230010;201705;3391;9060;2739;7944;209;694;2064;5867;2273;6561
230015;201705;2915;9923;2730;9538;289;1140;1813;6267;2102;7407
230020;201705;13804;44316;13410;43717;601;2467;11466;37034;12067;39501
230030;201705;12137;33766;10765;31722;435;1637;8994;26235;9429;27872
230040;201705;4325;11894;3703;10820;239;848;2789;8022;3028;8870
230050;201705;2678;8870;1991;7060;495;1707;569;2084;1064;3791
230060;201705;2344;6558;1976;5918;91;360;1542;4508;1633;4868
230070;201705;4184;12034;3634;11002;237;842;2526;7729;2763;8571
230075;201705;9092;31067;8473;29919;574;2884;6559;22548;7133;25432
230080;201705;2422;6113;1973;5442;64;245;1623;4405;1687;4650
230090;201705;4061;11203;3590;10430;298;1002;2582;7395;2880;8397
230100;201705;16711;49054;15583;47094;2493;8091;9238;28092;11731;36183
230110;201705;12375;39021;11312;36801;2100;7247;6100;19645;8200;26892
230120;201705;7910;21793;6867;20211;734;2102;4772;14582;5506;16684
230125;201705;3028;8596;2550;7747;138;500;1863;5615;2001;6115
230130;201705;5716;18487;4850;16634;512;1917;3147;10615;3659;12532
230140;201705;3570;11130;3039;10174;192;762;2114;7046;2306;7808
230150;201705;1660;5098;1443;4636;300;991;752;2443;1052;3434
230160;201705;6398;18148;5683;17115;303;1201;4580;13623;4883;14824
230170;201705;6184;19077;5398;17587;310;1232;3862;12387;4172;13619
230180;201705;1702;4923;1483;4489;61;273;1091;3141;1152;3414
230185;201705;3856;12438;3441;11670;506;1780;2253;7771;2759;9551
230190;201705;12478;39216;10995;36214;1793;6286;5638;18534;7431;24820
230195;201705;5298;16031;4685;14964;249;1006;3658;11449;3907;12455
230200;201705;5063;14386;4566;13455;287;958;3474;10021;3761;10979
230205;201705;4096;13228;3745;12583;284;1221;2623;8687;2907;9908
230210;201705;8872;25025;7807;23322;946;3027;5214;15715;6160;18742
230220;201705;13186;36802;11911;34670;812;2769;8972;25715;9784;28484
230230;201705;7311;22943;6716;21825;591;2048;4773;15489;5364;17537
230240;201705;13534;36908;11860;34189;563;1742;9210;26386;9773;28128
230250;201705;9733;29494;9680;29398;578;2138;7439;22073;8017;24211
230260;201705;14428;46983;13205;44473;1853;6712;7655;26136;9508;32848
230270;201705;7579;21729;6304;19394;775;2558;3942;12206;4717;14764
230280;201705;20122;58057;17633;53749;1116;4137;13301;39681;14417;43818
230290;201705;4815;14328;4140;12945;491;1474;2811;8873;3302;10347
230300;201705;4442;12903;4230;12611;228;883;3493;10221;3721;11104
230310;201705;4913;14400;4247;13245;168;697;3015;9222;3183;9919
230320;201705;7389;22185;6653;20889;427;1711;5025;15505;5452;17216
230330;201705;4961;14102;4155;12551;305;1024;2933;8727;3238;9751
230340;201705;3504;11484;3158;10748;295;1149;2141;7182;2436;8331
230350;201705;18356;54435;16718;51568;1422;5271;10398;32439;11820;37710
230360;201705;3253;9069;2520;7733;184;654;1657;5036;1841;5690
230365;201705;3100;8016;2683;7323;92;363;2232;5999;2324;6362
230370;201705;54591;170233;49127;160973;12526;43068;21638;73964;34164;117032
230380;201705;6649;19036;5468;16818;230;855;3887;11796;4117;12651
230390;201705;3367;10569;3031;9986;196;851;2240;7230;2436;8081
230393;201705;3099;9971;2672;9149;174;858;1938;6359;2112;7217
230395;201705;5712;16287;5119;15278;664;2022;3183;9702;3847;11724
230400;201705;5590;16481;5024;15543;239;998;3922;11858;4161;12856
230410;201705;14666;45745;12475;41198;1664;5745;7358;24382;9022;30127
230420;201705;24132;75428;21754;70756;3958;13812;10798;35069;14756;48881
230423;201705;4245;13528;3889;12795;210;884;3030;9835;3240;10719
230425;201705;5553;18065;5077;17060;642;2213;3297;11117;3939;13330
230426;201705;2569;7141;2044;6132;65;284;1504;4420;1569;4704
230427;201705;1910;5570;1443;4544;110;342;878;2691;988;3033
230428;201705;8853;26814;8328;25821;1453;4929;4422;13445;5875;18374
230430;201705;4485;13865;4026;12992;293;1139;2916;9155;3209;10294
230435;201705;5268;15953;4671;14872;632;2237;2746;8727;3378;10964
230440;201705;371214;1053615;332988;989348;67771;212237;163965;490297;231736;702534
230445;201705;4489;12163;3842;11086;225;669;2736;7843;2961;8512
230450;201705;3719;11283;3256;10475;278;1156;2284;7214;2562;8370
230460;201705;1945;6151;1687;5674;145;551;1220;4089;1365;4640
230465;201705;4020;11780;3374;10595;180;727;2349;7151;2529;7878
230470;201705;11009;39153;10160;37447;1128;4899;7055;25729;8183;30628
230480;201705;1477;4512;1250;4067;133;527;859;2725;992;3252
230490;201705;2352;6983;2052;6418;282;926;1081;3294;1363;4220
230495;201705;5648;18222;5136;17213;552;2295;3126;10325;3678;12620
230500;201705;8744;30707;8325;29853;550;2485;6282;22404;6832;24889
230510;201705;1553;5328;1178;4369;269;1074;404;1505;673;2579
230520;201705;4335;13244;4034;12668;387;1368;2744;8467;3131;9835
230523;201705;15034;47502;13014;42939;3063;10730;3276;11231;6339;21961
230526;201705;4089;11977;3515;10965;196;825;2720;8318;2916;9143
230530;201705;5484;17296;4926;16519;665;2365;3348;11533;4013;13898
230533;201705;4129;11189;3587;10200;336;909;2579;7423;2915;8332
230535;201705;5534;16049;4798;14702;428;1352;3142;9834;3570;11186
230540;201705;17301;49925;15599;47273;529;2245;13023;38935;13552;41180
230550;201705;19542;56704;17097;52107;2696;9077;9247;27725;11943;36802
230560;201705;6945;19485;5971;17726;195;834;4604;13441;4799;14275
230565;201705;3510;9512;2848;8322;106;387;2092;6053;2198;6440
230570;201705;3631;9702;3178;9105;109;377;2584;7335;2693;7712
230580;201705;10142;29549;9264;28277;506;1924;7718;23285;8224;25209
230590;201705;9190;27541;7794;24900;548;2145;5412;16793;5960;18938
230600;201705;3765;10235;2883;8494;94;293;1885;5633;1979;5926
230610;201705;6329;19278;5759;18352;545;1770;4202;13442;4747;15212
230620;201705;2198;6175;1728;5175;192;600;964;2808;1156;3408
230625;201705;7856;24915;7064;23165;2114;7440;1976;6558;4090;13998
230630;201705;10654;33197;9738;31473;2575;7878;4414;15388;6989;23266
230640;201705;27025;84640;24572;80963;2316;8649;18599;61051;20915;69700
230650;201705;4824;14512;4350;13591;269;1028;3251;9929;3520;10957
230655;201705;9490;34416;9120;33713;692;3001;7098;26335;7790;29336
230660;201705;6259;19121;5316;17268;271;1330;4151;13124;4422;14454
230670;201705;6034;15759;4815;13640;179;616;3684;10156;3863;10772
230680;201705;2617;7643;2279;6973;290;916;1402;4291;1692;5207
230690;201705;6496;20532;6156;19788;650;2353;3781;11916;4431;14269
230700;201705;9659;26497;8529;24443;521;1872;6142;16971;6663;18843
230710;201705;7491;23892;6470;21995;732;2638;4485;15296;5217;17934
230720;201705;1865;5822;1593;5218;205;714;967;3147;1172;3861
230725;201705;3702;12330;3178;11046;762;2735;975;3411;1737;6146
230730;201705;54521;164065;46830;150891;13450;48139;10979;37541;24429;85680
230740;201705;6295;18287;5624;17170;243;939;4373;13203;4616;14142
230750;201705;8271;23554;7195;21766;341;1289;5453;16145;5794;17434
230760;201705;11215;32531;10277;30746;900;3195;7216;20893;8116;24088
230763;201705;4328;12883;3797;11860;225;946;2835;8509;3060;9455
230765;201705;39790;121781;35292;113215;9014;30614;11031;36580;20045;67194
230770;201705;25232;68633;22499;64646;2863;8649;14347;41330;17210;49979
230780;201705;5893;21977;5642;21416;1155;4413;3051;12056;4206;16469
230790;201705;2901;8910;2707;8596;204;718;2080;6609;2284;7327
230800;201705;7498;25906;6880;24565;1224;4912;3538;12371;4762;17283
230810;201705;11958;38065;11190;36738;739;2896;8481;27453;9220;30349
230820;201705;3305;11158;2899;10269;346;1440;1683;5804;2029;7244
230830;201705;7489;22314;6615;20700;340;1349;5066;15600;5406;16949
230835;201705;3933;10199;3228;9090;146;512;2498;6916;2644;7428
230837;201705;3152;10483;2748;9655;197;898;1977;6745;2174;7643
230840;201705;9000;28763;8306;27598;675;2568;6338;21094;7013;23662
230850;201705;9486;29040;8710;27662;832;2822;6025;19169;6857;21991
230860;201705;5192;14307;4550;13350;228;783;3693;10738;3921;11521
230870;201705;18121;46915;15808;43430;641;2056;12244;33380;12885;35436
230880;201705;1989;6570;1847;6297;115;563;1347;4457;1462;5020
230890;201705;4185;14605;3879;13971;408;1675;2618;9299;3026;10974
230900;201705;2833;9254;2410;8314;448;1459;1228;4341;1676;5800
230910;201705;3120;8985;2563;8003;151;662;1901;5780;2052;6442
230920;201705;4761;13430;4411;12979;165;598;3778;11163;3943;11761
230930;201705;6873;20464;6068;18916;528;1785;3988;12361;4516;14146
230940;201705;7575;21586;6831;20335;241;892;5534;16372;5775;17264
230945;201705;6284;18597;5513;17320;436;1518;3766;11996;4202;13514
230950;201705;6532;17127;5968;16422;182;471;5189;14596;5371;15067
230960;201705;14016;43007;12831;40691;2125;7109;6283;20164;8408;27273
230970;201705;13505;39988;11813;36995;2224;7614;5533;17304;7757;24918
230980;201705;2914;8870;2523;8175;533;1710;1368;4626;1901;6336
230990;201705;1810;5208;1493;4615;109;457;976;2889;1085;3346
231000;201705;2581;7040;2149;6186;104;348;1470;4147;1574;4495
231010;201705;3064;8331;2513;7396;235;756;1710;4967;1945;5723
231020;201705;8046;26516;7527;25350;1256;4194;4525;15630;5781;19824
231025;201705;7682;23320;7051;22175;1023;3395;4515;14377;5538;17772
231030;201705;7330;23320;6126;20807;1142;4046;3199;10936;4341;14982
231040;201705;3168;9723;2811;9032;140;614;2082;6516;2222;7130
231050;201705;11947;33017;10075;29704;659;2075;7406;21719;8065;23794
231060;201705;2460;7812;2284;7501;113;553;1714;5522;1827;6075
231070;201705;8472;26235;7574;24466;1321;4421;4090;13441;5411;17862
231080;201705;4054;12268;3674;11612;152;787;2800;8483;2952;9270
231085;201705;5002;15093;4773;14758;498;1531;3478;11128;3976;12659
231090;201705;4182;11512;3343;9866;143;490;2318;6687;2461;7177
231095;201705;2099;6657;1826;6064;176;665;1240;4084;1416;4749
231100;201705;3182;9692;2672;8738;226;779;1825;5936;2051;6715
231110;201705;3496;11279;3450;11199;317;1226;2399;7597;2716;8823
231120;201705;1964;6501;1835;6241;249;885;1157;3936;1406;4821
231123;201705;2034;5515;1782;5075;122;373;1298;3641;1420;4014
231126;201705;6167;17489;5072;15408;219;817;3565;10601;3784;11418
231130;201705;19166;57062;17288;54086;2424;8178;10842;34800;13266;42978
231135;201705;4115;12050;3514;10935;210;750;2518;7775;2728;8525
231140;201705;17447;52740;14925;48019;1104;4674;9941;31021;11045;35695
231150;201705;5617;16097;4889;14731;746;2327;2438;7511;3184;9838
231160;201705;5820;19024;5413;18221;870;3048;3198;10890;4068;13938
231170;201705;4261;13405;3742;12337;254;1058;2636;8437;2890;9495
231180;201705;14465;42314;12611;38509;2416;7596;6185;18699;8601;26295
231190;201705;4626;12876;3850;11682;219;900;2845;8334;3064;9234
231195;201705;4586;15159;4013;13964;337;1465;2753;9369;3090;10834
231200;201705;7866;26119;6902;24123;364;1880;4978;16860;5342;18740
231210;201705;4932;15393;4356;14465;241;1103;3238;10514;3479;11617
231220;201705;11721;32938;10228;30190;534;2016;7518;21623;8052;23639
231230;201705;8707;28589;7939;27430;652;2713;6034;20837;6686;23550
231240;201705;11721;36326;10707;34242;1971;6575;5804;18697;7775;25272
231250;201705;1924;5358;1339;3964;145;435;660;1914;805;2349
231260;201705;3339;9949;3017;9401;426;1320;1917;6110;2343;7430
231270;201705;7127;19177;6267;17846;252;1038;4806;13443;5058;14481
231280;201705;1761;5648;1644;5431;168;577;1102;3661;1270;4238
231290;201705;34932;113658;31476;106061;5904;21558;13899;46061;19803;67619
231300;201705;4303;12390;3542;10854;252;880;2360;7091;2612;7971
231310;201705;7403;20743;6102;18057;778;2350;3583;10467;4361;12817
231320;201705;7067;20998;5803;18453;222;921;4280;13455;4502;14376
231325;201705;2747;7838;2338;7196;468;1438;1201;3777;1669;5215
231330;201705;11080;34979;9570;31892;1707;5763;5176;17489;6883;23252
231335;201705;5579;15420;4781;14019;158;659;3912;11220;4070;11879
231340;201705;18004;57895;16503;55476;1217;4349;12650;43147;13867;47496
231350;201705;14851;42485;13891;41187;493;1443;12333;36931;12826;38374
231355;201705;4631;14413;4171;13611;274;1076;3068;9937;3342;11013
231360;201705;7679;24128;6810;22607;967;3336;4469;15109;5436;18445
231370;201705;2440;6724;1922;5857;57;208;1445;4366;1502;4574
231375;201705;4215;13987;3899;13387;201;951;3068;10365;3269;11316
231380;201705;5533;16303;5250;15949;237;683;4390;13687;4627;14370
231390;201705;3445;10583;3149;10035;280;1044;2222;6971;2502;8015
231395;201705;3884;12538;3492;11795;618;2140;1951;6663;2569;8803
231400;201705;9099;27582;8339;26077;486;1866;6248;19223;6734;21089
231410;201705;14777;48343;13497;46419;1259;4488;9942;34498;11201;38986
240010;201705;2437;7101;1986;6191;241;861;1141;3463;1382;4324
240020;201705;10318;31762;9266;29789;1501;5169;5209;16820;6710;21989
240030;201705;2577;7113;2477;6962;133;435;2150;5987;2283;6422
240040;201705;871;2512;725;2220;29;138;513;1510;542;1648
240050;201705;3431;9164;2872;8183;88;293;2249;6285;2337;6578
240060;201705;1424;3994;1241;3658;57;208;965;2748;1022;2956
240070;201705;2452;7323;2278;6970;276;899;1575;4739;1851;5638
240080;201705;3045;8059;2605;7423;137;470;1947;5485;2084;5955
240090;201705;2290;6024;1888;5319;42;161;1490;4117;1532;4278
240100;201705;8001;22500;7102;20663;608;1923;5029;14240;5637;16163
240110;201705;4714;14515;4144;13367;531;1951;2355;7471;2886;9422
240120;201705;2672;9191;2538;8903;322;1294;1619;5618;1941;6912
240130;201705;2786;7199;2435;6656;88;304;2056;5534;2144;5838
240140;201705;2249;6639;1891;5964;218;761;1172;3662;1390;4423
240145;201705;5837;17916;5170;16768;1010;3422;2903;9618;3913;13040
240150;201705;964;2924;816;2615;61;252;588;1825;649;2077
240160;201705;1462;4497;1243;4116;114;435;821;2744;935;3179
240165;201705;881;2712;754;2429;136;423;428;1408;564;1831
240170;201705;2310;6875;1990;6282;324;1108;1112;3446;1436;4554
240180;201705;2745;8482;2403;7781;386;1304;1447;4769;1833;6073
240185;201705;1371;4537;1264;4355;81;336;1013;3468;1094;3804
240190;201705;991;3093;876;2892;40;173;672;2218;712;2391
240200;201705;12301;32944;10467;30069;2107;6307;4458;13144;6565;19451
240210;201705;2853;7879;2574;7427;101;390;2088;5852;2189;6242
240220;201705;7437;24473;6840;23612;677;2864;4817;16595;5494;19459
240230;201705;5809;15152;4949;13808;224;663;3995;11134;4219;11797
240240;201705;1777;5415;1123;3781;195;689;209;647;404;1336
240250;201705;2682;7728;2508;7504;143;424;2079;6254;2222;6678
240260;201705;12159;40090;11526;39063;1605;5992;7636;25966;9241;31958
240270;201705;2311;7184;2120;6865;130;456;1712;5586;1842;6042
240280;201705;1564;4324;1399;4093;59;190;1129;3278;1188;3468
240290;201705;1179;3694;1036;3412;53;267;696;2137;749;2404
240300;201705;2317;6237;1730;5058;139;440;913;2619;1052;3059
240310;201705;9383;26319;8361;24635;1084;3479;4590;13577;5674;17056
240320;201705;1993;5757;1564;4877;45;199;1145;3398;1190;3597
240325;201705;32316;90147;26166;79966;7470;24304;6709;21734;14179;46038
240330;201705;1495;4484;1262;3994;75;309;813;2475;888;2784
240340;201705;2063;5220;1690;4630;125;353;1255;3390;1380;3743
240350;201705;2066;5634;1904;5440;68;242;1698;4818;1766;5060
240360;201705;6713;20602;6066;19608;1559;5034;2941;10066;4500;15100
240370;201705;2053;5622;1630;4802;160;453;1035;3051;1195;3504
240375;201705;848;2255;751;2079;43;170;546;1424;589;1594
240380;201705;2420;7140;1818;5781;209;688;958;3031;1167;3719
240390;201705;924;2536;751;2190;25;76;504;1412;529;1488
240400;201705;1364;3606;1057;3027;57;184;725;2001;782;2185
240410;201705;450;1478;406;1389;61;261;236;783;297;1044
240420;201705;4707;17799;4361;16990;746;3404;2331;8963;3077;12367
240430;201705;3413;9431;3078;8822;139;580;2400;6599;2539;7179
240440;201705;2505;6342;2231;5951;330;949;1405;3699;1735;4648
240450;201705;4044;11808;3415;10603;396;1383;1944;5892;2340;7275
240460;201705;2929;8785;2752;8556;211;841;2197;6676;2408;7517
240470;201705;3554;11095;2773;9409;557;1878;1400;4814;1957;6692
240480;201705;534;1446;405;1198;36;112;196;574;232;686
240485;201705;2019;6215;1749;5679;178;593;1179;3878;1357;4471
240490;201705;1770;4390;1437;3863;25;84;1235;3292;1260;3376
240500;201705;2210;6174;1982;5846;102;360;1610;4718;1712;5078
240510;201705;1675;4897;1600;4779;120;375;1318;3913;1438;4288
240520;201705;1268;3491;1090;3222;61;242;868;2471;929;2713
240530;201705;1957;6284;1818;6067;227;807;1312;4377;1539;5184
240540;201705;1862;5345;1737;5160;98;352;1478;4316;1576;4668
240550;201705;780;2197;666;2002;38;119;489;1463;527;1582
240560;201705;3304;9215;2994;8784;300;792;2334;6998;2634;7790
240570;201705;3040;8304;2214;6442;312;983;985;2597;1297;3580
240580;201705;7871;23746;7281;22768;547;1989;5814;17970;6361;19959
240590;201705;743;2072;651;1907;18;68;500;1445;518;1513
240600;201705;1646;4716;1263;3898;121;442;746;2209;867;2651
240610;201705;4625;13195;4014;12032;338;1124;2664;7827;3002;8951
240615;201705;978;2872;804;2528;113;386;496;1520;609;1906
240620;201705;1849;5484;1629;5109;125;404;1264;3936;1389;4340
240630;201705;2058;6203;1874;5895;166;483;1292;4154;1458;4637
240640;201705;958;2632;794;2370;44;176;572;1646;616;1822
240650;201705;3998;11611;3578;10957;178;644;2828;8594;3006;9238
240660;201705;2420;7502;2274;7291;148;552;1826;5783;1974;6335
240670;201705;2594;7641;2160;6732;218;771;1280;3842;1498;4613
240680;201705;1523;4379;1233;3865;82;287;821;2532;903;2819
240690;201705;928;2507;788;2269;33;124;631;1749;664;1873
240700;201705;2536;7403;2115;6643;75;325;1647;5050;1722;5375
240710;201705;17681;47190;15340;43313;3000;8391;8186;23743;11186;32134
240720;201705;5215;14643;4700;13733;1114;3359;2330;6681;3444;10040
240725;201705;1032;3087;828;2620;58;191;506;1565;564;1756
240730;201705;2072;6137;1800;5628;122;389;1332;4154;1454;4543
240740;201705;1938;5534;1708;5099;105;402;1212;3473;1317;3875
240750;201705;2154;7934;1984;7609;397;1711;1042;3994;1439;5705
240760;201705;1359;3632;1051;3161;70;195;775;2399;845;2594
240770;201705;3117;8785;2791;8332;145;565;2314;6776;2459;7341
240780;201705;5950;16298;4803;14464;594;1822;2898;8896;3492;10718
240790;201705;897;2657;736;2356;34;134;528;1696;562;1830
240800;201705;34639;98102;30496;91074;6344;19866;13269;40017;19613;59883
240810;201705;84081;239509;77078;227408;19604;58542;35600;107356;55204;165898
240820;201705;5606;17649;5020;16719;1126;3920;2372;8285;3498;12205
240830;201705;8880;26846;8265;25963;390;1594;6840;21216;7230;22810
240840;201705;1119;3057;951;2769;83;267;637;1795;720;2062
240850;201705;1297;3749;964;3006;97;329;512;1582;609;1911
240860;201705;1264;3590;1021;3137;41;178;765;2248;806;2426
240870;201705;1147;3071;918;2675;62;199;617;1715;679;1914
240880;201705;1233;4040;1165;3929;95;387;936;3089;1031;3476
240890;201705;4932;13824;4079;12185;797;2474;1774;5263;2571;7737
240895;201705;2626;9014;2426;8679;243;923;1791;6498;2034;7421
240910;201705;3016;8835;2658;8149;109;420;2129;6452;2238;6872
240920;201705;786;2492;686;2270;107;378;353;1155;460;1533
240930;201705;3503;8832;3062;8294;92;245;2484;6837;2576;7082
240933;201705;1602;4183;1381;3831;50;184;1133;3062;1183;3246
240940;201705;6460;16838;5209;14754;631;1775;3320;9306;3951;11081
240950;201705;950;3056;874;2906;57;243;641;2068;698;2311
240960;201705;795;2455;699;2261;50;176;504;1619;554;1795
240970;201705;1874;5110;1581;4611;75;265;1255;3542;1330;3807
240980;201705;2873;9425;2674;9059;381;1418;1771;5932;2152;7350
240990;201705;2636;7808;2497;7540;385;1234;1638;4893;2023;6127
241000;201705;1040;2855;876;2560;47;157;600;1729;647;1886
241010;201705;2776;9292;2611;8980;320;1321;1822;6021;2142;7342
241020;201705;2030;5587;1598;4708;212;585;917;2696;1129;3281
241025;201705;1706;5057;1488;4667;81;329;979;3040;1060;3369
241030;201705;2395;7795;2096;7185;204;826;1410;4768;1614;5594
241040;201705;2232;7472;2030;7103;134;593;1520;5301;1654;5894
241050;201705;1278;3712;1076;3353;67;240;784;2400;851;2640
241060;201705;834;2394;743;2228;57;183;510;1490;567;1673
241070;201705;696;1990;624;1861;51;188;475;1338;526;1526
241080;201705;1145;3357;931;2937;30;138;684;2113;714;2251
241090;201705;2151;6332;1790;5712;89;379;1342;4232;1431;4611
241100;201705;1170;3428;1004;3062;58;200;689;2059;747;2259
241105;201705;1197;3590;1032;3300;264;844;429;1422;693;2266
241110;201705;829;2531;681;2201;36;126;447;1382;483;1508
241120;201705;7322;22084;6607;20820;1560;4773;3367;11262;4927;16035
241140;201705;3404;9101;2920;8163;221;633;2091;5695;2312;6328
241142;201705;752;2177;581;1834;70;241;306;935;376;1176
241150;201705;5543;15887;4946;14885;362;1264;3594;10679;3956;11943
241160;201705;954;2790;854;2622;152;477;485;1493;637;1970
241170;201705;1162;3296;1081;3158;102;290;840;2428;942;2718
241180;201705;973;2689;765;2284;74;223;417;1225;491;1448
241190;201705;1180;3224;939;2719;49;182;629;1749;678;1931
241200;201705;19035;53872;16770;50423;4024;12694;7435;23089;11459;35783
241210;201705;1463;4054;1152;3429;125;426;704;2026;829;2452
241220;201705;8008;25785;7369;24611;2133;7186;3247;11337;5380;18523
241230;201705;3065;8646;2830;8275;134;476;2327;6655;2461;7131
241240;201705;1278;3707;842;2711;81;292;361;1171;442;1463
241250;201705;6122;18469;5088;16499;245;1201;3758;11762;4003;12963
241255;201705;1785;6524;1602;6114;273;1187;886;3369;1159;4556
241260;201705;5144;13741;4080;12048;172;725;2953;8529;3125;9254
241270;201705;1875;5635;1629;5146;104;433;1180;3648;1284;4081
241280;201705;1831;5238;1675;4951;138;429;1249;3656;1387;4085
241290;201705;2985;8147;2489;7293;136;508;1864;5339;2000;5847
241300;201705;1487;4175;1269;3781;45;157;862;2534;907;2691
241310;201705;1751;4971;1579;4691;72;273;1288;3775;1360;4048
241320;201705;938;3207;848;2999;113;447;525;1853;638;2300
241330;201705;1462;4378;1368;4258;78;322;1163;3572;1241;3894
241335;201705;2918;8580;2665;8130;130;461;2169;6518;2299;6979
241340;201705;1827;5546;1531;4873;337;1147;649;1999;986;3146
241350;201705;1924;5954;1732;5593;117;491;1305;4099;1422;4590
241355;201705;1431;3919;1147;3417;58;215;875;2569;933;2784
241360;201705;2116;5616;1721;4853;74;232;1254;3449;1328;3681
241370;201705;1373;4028;1132;3555;93;358;720;2172;813;2530
241380;201705;636;1787;531;1588;60;199;325;937;385;1136
241390;201705;2779;8845;2578;8532;242;925;1952;6430;2194;7355
241400;201705;3718;10537;3360;10016;314;1036;2545;7632;2859;8668
241410;201705;2456;7409;2178;6998;344;1172;1390;4470;1734;5642
241415;201705;1683;4985;1490;4660;138;463;1091;3330;1229;3793
241420;201705;2257;7709;2011;7284;639;2481;542;2008;1181;4489
241430;201705;569;1668;438;1382;42;154;249;741;291;895
241440;201705;6169;21930;5825;21356;626;2686;4316;15761;4942;18447
241445;201705;999;2825;947;2763;50;123;805;2457;855;2580
241450;201705;2985;7890;2606;7350;315;899;1818;5126;2133;6025
241460;201705;3433;9825;3021;8984;232;802;2139;6185;2371;6987
241470;201705;1431;3895;1166;3535;83;308;896;2699;979;3007
241475;201705;1256;3724;1033;3280;45;239;746;2257;791;2496
241480;201705;2691;8868;2458;8454;948;3314;653;2550;1601;5864
241490;201705;702;1826;581;1644;28;84;379;1033;407;1117
241500;201705;733;2301;625;2161;12;48;536;1862;548;1910
250010;201705;2789;8577;2333;7575;98;425;1712;5425;1810;5850
250020;201705;1582;4481;1203;3749;54;192;850;2580;904;2772
250030;201705;6950;19848;6412;19096;367;1260;5257;15435;5624;16695
250040;201705;3994;13329;3691;12670;434;1570;2473;8489;2907;10059
250050;201705;3292;10159;3049;9774;449;1493;1917;6067;2366;7560
250053;201705;1238;3690;1128;3524;123;394;781;2465;904;2859
250057;201705;633;2649;615;2630;2;2;587;2566;589;2568
250060;201705;5175;15045;4803;14514;415;1390;3748;11285;4163;12675
250070;201705;3875;11838;3602;11328;104;513;2752;8318;2856;8831
250073;201705;789;2293;688;2121;24;88;520;1550;544;1638
250077;201705;2163;6210;1743;5494;110;373;1210;3795;1320;4168
250080;201705;4215;11954;3992;11567;215;733;3243;9210;3458;9943
250090;201705;2609;7307;2431;7018;136;380;1976;5658;2112;6038
250100;201705;3871;12361;3629;11923;205;883;2930;9385;3135;10268
250110;201705;4807;14247;4524;13838;436;1575;3540;10620;3976;12195
250115;201705;495;1550;458;1485;19;103;344;1073;363;1176
250120;201705;1835;5664;1611;5227;82;335;1249;4040;1331;4375
250130;201705;5295;16257;4770;15285;173;837;3774;11856;3947;12693
250135;201705;1055;3185;988;3070;35;135;797;2452;832;2587
250140;201705;2108;6789;2033;6670;144;598;1614;5252;1758;5850
250150;201705;5025;16608;4594;15794;248;1167;3489;11733;3737;12900
250153;201705;1469;3930;1253;3609;34;142;1044;2956;1078;3098
250157;201705;1767;5628;1617;5327;242;750;1046;3515;1288;4265
250160;201705;3325;9541;3122;9233;91;319;2819;8322;2910;8641
250170;201705;1596;4643;1457;4431;85;307;1156;3492;1241;3799
250180;201705;15828;45173;14679;43473;1284;4508;10728;30953;12012;35461
250190;201705;4142;11845;3780;11270;497;1500;2465;7331;2962;8831
250200;201705;1952;5695;1628;5204;79;315;1304;4137;1383;4452
250205;201705;837;2856;786;2743;33;170;592;2042;625;2212
250210;201705;1496;4809;1396;4644;84;406;1059;3430;1143;3836
250215;201705;1420;4397;1296;4224;106;433;834;2676;940;3109
250220;201705;743;2190;619;1998;37;138;452;1452;489;1590
250230;201705;1588;3940;1262;3405;47;164;985;2545;1032;2709
250240;201705;2321;7477;2188;7233;102;396;1759;5772;1861;6168
250250;201705;4460;13258;4057;12708;159;557;3344;10486;3503;11043
250260;201705;1694;5025;1467;4651;50;195;1154;3646;1204;3841
250270;201705;1291;3959;1163;3797;97;324;854;2918;951;3242
250280;201705;3563;10392;3118;9686;225;725;2347;7266;2572;7991
250290;201705;1790;4807;1495;4407;17;58;1265;3718;1282;3776
250300;201705;5264;15474;5030;15183;362;1403;4290;12659;4652;14062
250310;201705;1118;3369;996;3158;58;241;761;2338;819;2579
250320;201705;8194;23526;7677;22782;853;2818;5696;16601;6549;19419
250330;201705;2425;7406;2071;6879;143;542;1577;5194;1720;5736
250340;201705;1090;3162;977;2968;28;100;802;2392;830;2492
250350;201705;4147;11469;3733;10960;141;478;3257;9555;3398;10033
250355;201705;1976;6115;1802;5886;40;218;1601;5173;1641;5391
250360;201705;1807;5254;1692;5066;42;146;1417;4227;1459;4373
250370;201705;11636;32948;10355;31463;657;2167;8743;26549;9400;28716
250375;201705;1082;3194;981;3053;32;110;842;2647;874;2757
250380;201705;1673;4686;1592;4582;69;271;1341;3744;1410;4015
250390;201705;1823;4951;1500;4404;214;593;950;2831;1164;3424
250400;201705;73163;192620;57739;168285;14631;45104;21050;62737;35681;107841
250403;201705;1578;5081;1456;4904;231;924;914;2982;1145;3906
250407;201705;1202;3311;1038;3066;86;232;756;2219;842;2451
250410;201705;540;1691;498;1612;21;111;399;1240;420;1351
250415;201705;1929;5647;1725;5292;84;274;1318;4025;1402;4299
250420;201705;1246;3594;1123;3413;20;69;1013;3074;1033;3143
250430;201705;6208;16465;5601;15549;231;768;4576;12439;4807;13207
250435;201705;1341;4115;1203;3870;70;275;886;2812;956;3087
250440;201705;4472;12578;4042;11980;102;389;3444;10106;3546;10495
250450;201705;1893;5330;1643;4986;50;202;1366;4080;1416;4282
250460;201705;6610;19244;6201;18726;375;1188;5237;16015;5612;17203
250470;201705;1563;4157;1311;3800;92;335;961;2693;1053;3028
250480;201705;3758;11151;3470;10750;74;327;3033;9399;3107;9726
250485;201705;640;1556;510;1378;22;67;422;1115;444;1182
250490;201705;3958;11796;3797;11579;436;1393;2932;8959;3368;10352
250500;201705;1788;5313;1615;5024;95;307;1268;3958;1363;4265
250510;201705;4983;13676;4434;12913;110;349;3912;11399;4022;11748
250520;201705;1781;5321;1661;5163;241;856;1041;3160;1282;4016
250523;201705;1786;5187;1724;5108;104;425;1460;4210;1564;4635
250527;201705;1462;4219;1390;4130;40;133;1277;3769;1317;3902
250530;201705;592;1813;525;1730;25;105;459;1499;484;1604
250535;201705;1333;4081;1239;3899;51;230;973;2982;1024;3212
250540;201705;2490;6786;2307;6579;44;145;2070;5867;2114;6012
250550;201705;874;2924;805;2813;39;205;653;2215;692;2420
250560;201705;1640;5071;1545;4919;78;299;1263;3945;1341;4244
250570;201705;2662;8210;2333;7587;113;489;1832;5810;1945;6299
250580;201705;1111;2913;975;2709;53;212;808;2166;861;2378
250590;201705;824;2534;755;2428;32;148;617;1914;649;2062
250600;201705;7005;20533;6566;19860;612;1850;5120;15568;5732;17418
250610;201705;3034;8780;2814;8467;240;774;2177;6509;2417;7283
250620;201705;682;1982;617;1851;68;229;414;1197;482;1426
250625;201705;2446;7580;2337;7397;52;189;2116;6628;2168;6817
250630;201705;9645;29453;8729;27566;1727;5711;4847;15177;6574;20888
250640;201705;3413;10347;3230;10100;148;662;2711;8270;2859;8932
250650;201705;874;2350;762;2201;42;170;584;1594;626;1764
250660;201705;1775;4649;1648;4472;30;66;1530;4179;1560;4245
250670;201705;2320;7714;2210;7525;100;488;1865;6213;1965;6701
250680;201705;4890;13225;4611;12905;168;623;4121;11423;4289;12046
250690;201705;6037;15193;5761;14879;246;679;5268;13545;5514;14224
250700;201705;4521;13282;4133;12693;575;1882;2803;8494;3378;10376
250710;201705;4451;13569;3993;12949;402;1410;2787;9168;3189;10578
250720;201705;2750;7710;2536;7373;56;246;2252;6485;2308;6731
250730;201705;3553;10507;3261;10095;231;838;2611;7906;2842;8744
250740;201705;1922;5391;1655;4991;146;527;1244;3638;1390;4165
250750;201705;97279;269580;88710;257067;10595;33716;59105;168500;69700;202216
250760;201705;2290;6307;2025;5926;122;439;1603;4607;1725;5046
250770;201705;3886;12678;3644;12361;367;1444;2635;8905;3002;10349
250780;201705;1741;5045;1498;4574;170;599;990;2949;1160;3548
250790;201705;2323;7466;2205;7253;414;1368;1327;4481;1741;5849
250800;201705;2644;7263;2326;6745;93;268;1902;5454;1995;5722
250810;201705;1266;3659;1097;3398;54;220;857;2613;911;2833
250820;201705;1891;5844;1816;5754;95;407;1601;5001;1696;5408
250830;201705;5575;17795;5145;16918;469;1855;3616;11658;4085;13513
250840;201705;912;2905;788;2646;43;172;515;1731;558;1903
250850;201705;1988;5968;1781;5633;75;364;1406;4318;1481;4682
250855;201705;1081;3142;951;2933;40;175;709;2126;749;2301
250860;201705;3241;10330;2775;9482;580;2112;1205;4207;1785;6319
250870;201705;1080;3071;938;2800;31;112;739;2184;770;2296
250880;201705;1517;4094;1256;3715;145;438;867;2620;1012;3058
250890;201705;9329;27485;8880;26874;958;3494;6635;19572;7593;23066
250900;201705;2736;8683;2418;8068;141;500;1867;6152;2008;6652
250905;201705;2034;6354;1958;6264;155;602;1608;5069;1763;5671
250910;201705;5013;14102;4704;13667;214;758;3974;11466;4188;12224
250915;201705;1458;4308;1417;4260;58;135;1288;3960;1346;4095
250920;201705;3211;8989;3023;8706;278;809;2268;6458;2546;7267
250930;201705;1983;5894;1880;5720;142;544;1472;4359;1614;4903
250933;201705;1115;3642;1017;3442;77;335;687;2266;764;2601
250937;201705;678;2036;588;1872;40;150;441;1379;481;1529
250939;201705;1627;4709;1471;4472;68;260;1131;3345;1199;3605
250940;201705;3776;10930;3530;10531;82;330;3074;9163;3156;9493
250950;201705;1350;3998;1176;3765;40;157;966;3110;1006;3267
250960;201705;1029;3294;976;3202;38;163;785;2533;823;2696
250970;201705;8471;23169;7399;21464;512;1652;5471;15655;5983;17307
250980;201705;2546;7360;2300;6906;89;377;1759;5084;1848;5461
250990;201705;1948;6508;1730;6024;189;818;1175;3951;1364;4769
251000;201705;2083;6040;1818;5618;52;246;1531;4665;1583;4911
251010;201705;2725;7961;2457;7521;81;311;2133;6517;2214;6828
251020;201705;1682;4649;1533;4463;64;205;1385;4020;1449;4225
251030;201705;1020;2876;926;2685;51;172;648;1824;699;1996
251040;201705;1764;5434;1573;5111;80;395;1235;3871;1315;4266
251050;201705;1049;3039;875;2706;113;352;561;1703;674;2055
251060;201705;1046;2347;776;2002;21;81;611;1543;632;1624
251065;201705;481;1374;402;1263;24;95;272;799;296;894
251070;201705;640;1735;570;1634;22;90;465;1285;487;1375
251080;201705;18659;51637;16687;48569;3690;11163;8627;25704;12317;36867
251090;201705;2903;8799;2546;8098;125;496;1944;6053;2069;6549
251100;201705;940;2940;852;2790;47;233;611;1909;658;2142
251110;201705;1827;5293;1611;4863;98;308;1166;3482;1264;3790
251120;201705;6256;20578;5929;20004;501;2028;4472;14860;4973;16888
251130;201705;3815;9591;3535;9292;90;207;3365;8908;3455;9115
251140;201705;4220;12655;3953;12224;132;563;3265;10028;3397;10591
251150;201705;2659;8232;2463;7940;167;734;1913;6011;2080;6745
251160;201705;1840;5951;1772;5847;57;229;1608;5302;1665;5531
251170;201705;1472;4301;1400;4222;38;164;1276;3818;1314;3982
251180;201705;2543;7556;2277;7148;292;992;1457;4536;1749;5528
251190;201705;4441;12060;4236;11811;108;354;3846;10590;3954;10944
251200;201705;3935;12662;3722;12395;93;401;3355;11208;3448;11609
251203;201705;997;3298;959;3220;50;218;708;2318;758;2536
251207;201705;1026;3172;878;2894;31;152;605;1929;636;2081
251210;201705;7882;21831;6730;20325;516;1573;5171;15833;5687;17406
251220;201705;1183;3101;977;2820;61;173;759;2212;820;2385
251230;201705;4643;13356;4218;12830;234;872;3632;10850;3866;11722
251240;201705;3269;9737;2981;9347;333;1073;2233;6991;2566;8064
251250;201705;10308;29778;9578;28733;841;2908;7147;20935;7988;23843
251260;201705;465;1454;428;1391;21;91;324;1036;345;1127
251270;201705;4286;13699;3916;13235;138;617;3346;11313;3484;11930
251272;201705;1343;3798;1275;3702;53;186;1144;3288;1197;3474
251274;201705;934;2823;812;2604;73;313;541;1648;614;1961
251275;201705;1233;3562;1150;3432;54;231;872;2485;926;2716
251276;201705;1207;3640;1148;3544;102;409;862;2605;964;3014
251278;201705;593;1800;520;1661;48;185;341;1089;389;1274
251280;201705;2329;6810;2143;6498;76;322;1699;4983;1775;5305
251290;201705;5655;15177;5313;14752;452;1609;4240;11386;4692;12995
251300;201705;753;2457;706;2382;19;80;583;1950;602;2030
251310;201705;2922;8679;2709;8382;135;609;2158;6467;2293;7076
251315;201705;1659;5528;1575;5383;120;458;1190;4026;1310;4484
251320;201705;1863;5043;1370;4241;69;256;933;2879;1002;3135
251330;201705;1777;4653;1496;4285;57;233;1320;3712;1377;3945
251335;201705;1027;3357;935;3205;73;319;675;2249;748;2568
251340;201705;3413;9658;3010;9098;144;550;2336;6933;2480;7483
251350;201705;1190;3770;1113;3632;48;212;886;2792;934;3004
251360;201705;1807;5578;1544;5215;45;190;1317;4493;1362;4683
251365;201705;711;2122;595;1859;18;78;444;1364;462;1442
251370;201705;23160;69784;22219;68519;1800;6696;17442;52763;19242;59459
251380;201705;1308;4024;1130;3725;40;201;940;2984;980;3185
251385;201705;738;1952;602;1736;34;113;415;1129;449;1242
251390;201705;5736;19094;5094;17826;1311;4765;2408;8455;3719;13220
251392;201705;1048;3055;913;2825;59;227;658;1990;717;2217
251394;201705;639;2231;554;2084;29;130;405;1549;434;1679
251396;201705;813;2281;697;2093;56;154;451;1353;507;1507
251398;201705;942;2646;769;2346;35;142;541;1585;576;1727
251400;201705;1150;3213;976;2957;70;249;707;2066;777;2315
251410;201705;1542;3921;1298;3537;30;124;1084;2847;1114;2971
251420;201705;1965;5556;1694;5234;136;494;1251;3806;1387;4300
251430;201705;1616;5349;1488;5144;59;298;1262;4286;1321;4584
251440;201705;1179;3499;970;3092;40;155;741;2360;781;2515
251445;201705;1523;4584;1442;4478;98;401;1133;3432;1231;3833
251450;201705;4624;14429;4263;13940;131;613;3523;11459;3654;12072
251455;201705;1064;3339;949;3116;81;343;673;2165;754;2508
251460;201705;823;2532;760;2426;46;175;620;1981;666;2156
251465;201705;441;1394;381;1260;16;85;287;916;303;1001
251470;201705;1142;3295;939;2873;77;262;576;1731;653;1993
251480;201705;924;2592;811;2407;30;136;602;1722;632;1858
251490;201705;1801;5231;1602;4920;163;537;1035;3135;1198;3672
251500;201705;1740;5472;1666;5337;98;399;1367;4294;1465;4693
251510;201705;2537;8211;2292;7728;316;1158;1392;4683;1708;5841
251520;201705;940;2592;804;2319;82;248;536;1501;618;1749
251530;201705;12204;33277;11383;32156;286;1247;9855;27237;10141;28484
251540;201705;2849;8905;2625;8482;164;637;1992;6327;2156;6964
251550;201705;3399;8900;2854;8162;86;315;2349;6661;2435;6976
251560;201705;655;2027;592;1920;96;347;347;1088;443;1435
251570;201705;962;2828;788;2490;31;131;556;1701;587;1832
251580;201705;1876;5132;1705;4898;249;646;1210;3556;1459;4202
251590;201705;1504;4418;1423;4304;61;219;1137;3428;1198;3647
251593;201705;995;3008;914;2892;120;403;561;1748;681;2151
251597;201705;1940;5838;1876;5757;41;160;1697;5168;1738;5328
251600;201705;6510;18758;6020;17998;282;962;4931;14609;5213;15571
251610;201705;3299;9686;2960;9073;380;1129;1986;6186;2366;7315
251615;201705;1144;3188;937;2831;37;151;655;1920;692;2071
251620;201705;15810;40983;14079;38969;478;1310;11529;33631;12007;34941
251630;201705;4662;11831;3948;10807;249;738;2933;7881;3182;8619
251640;201705;2213;6609;2001;6206;79;339;1644;4993;1723;5332
251650;201705;4021;11313;3680;10860;186;652;3085;9032;3271;9684
251660;201705;3512;11034;3183;10434;113;559;2627;8398;2740;8957
251670;201705;4415;12848;3922;12234;31;135;3658;11512;3689;11647
251675;201705;693;2136;640;2062;94;341;427;1341;521;1682
251680;201705;2764;7798;2240;7002;84;331;1748;5414;1832;5745
251690;201705;3285;9689;2975;9106;119;419;2170;6496;2289;6915
251700;201705;1901;6086;1773;5917;88;426;1468;4776;1556;5202
251710;201705;876;2302;588;1725;70;245;277;779;347;1024
251720;201705;1425;4267;1214;3867;49;226;908;2796;957;3022
251740;201705;757;2117;606;1871;49;164;381;1157;430;1321
260005;201705;25031;60520;21593;55589;3805;9557;12712;32966;16517;42523
260010;201705;9832;26530;8271;24360;829;2537;5080;15393;5909;17930
260020;201705;6313;16856;5340;15458;192;721;4339;12539;4531;13260
260030;201705;6136;17318;5442;16214;334;1164;4211;12492;4545;13656
260040;201705;9416;23928;7811;21999;840;2372;5570;16250;6410;18622
260050;201705;11262;34329;10554;33476;453;1750;9128;29175;9581;30925
260060;201705;3865;10742;3414;9936;304;871;2490;7363;2794;8234
260070;201705;9870;27844;8989;26440;880;2958;6360;18369;7240;21327
260080;201705;6213;15711;5553;14803;431;1194;4284;11278;4715;12472
260090;201705;5244;14020;4852;13478;524;1403;3678;10360;4202;11763
260100;201705;3305;9045;2842;8406;168;608;2296;6769;2464;7377
260105;201705;4996;13777;4731;13358;151;636;4036;11134;4187;11770
260110;201705;21538;58888;19749;56782;847;2645;17421;50231;18268;52876
260120;201705;13225;38338;11729;35862;2119;6658;6610;20755;8729;27413
260130;201705;3139;8680;2937;8357;296;910;2192;6149;2488;7059
260140;201705;12601;31072;10936;29085;686;2117;8856;23641;9542;25758
260150;201705;3169;8604;2860;8195;195;671;2273;6453;2468;7124
260160;201705;5533;17040;4781;16041;215;989;3925;13217;4140;14206
260170;201705;16547;45186;15669;43975;721;2316;13461;37485;14182;39801
260180;201705;3268;9690;2979;9271;167;597;2509;7768;2676;8365
260190;201705;16438;37273;14798;35279;328;965;12881;30222;13209;31187
260200;201705;11092;27719;10209;26608;370;1127;9023;23478;9393;24605
260210;201705;11897;35010;10561;32891;457;1769;8621;26773;9078;28542
260220;201705;9506;26300;9102;25793;343;1277;8084;22567;8427;23844
260230;201705;9837;27168;8984;26001;428;1512;7231;20793;7659;22305
260240;201705;2950;8640;2569;8089;234;809;1956;6198;2190;7007
260250;201705;2273;6226;1996;5831;104;352;1594;4571;1698;4923
260260;201705;12251;34291;11040;32518;759;2624;8612;25257;9371;27881
260270;201705;3640;10404;3339;9949;216;907;2518;7249;2734;8156
260280;201705;12980;41100;11939;39574;601;2277;10066;33499;10667;35776
260290;201705;32808;96172;30798;92697;4882;15645;19287;57445;24169;73090
260300;201705;9036;26718;7961;25120;345;1446;6220;19652;6565;21098
260310;201705;4478;12990;4073;12393;725;2061;2634;8344;3359;10405
260320;201705;7489;23161;6840;22056;382;1442;5484;17613;5866;19055
260330;201705;2580;8145;2386;7776;140;566;1863;5956;2003;6522
260340;201705;1908;5435;1749;5202;44;158;1552;4599;1596;4757
260345;201705;22324;67601;20760;64689;5051;17300;8512;25384;13563;42684
260350;201705;4922;12965;4535;12421;148;535;3951;10699;4099;11234
260360;201705;2443;6838;2222;6453;98;428;1537;4391;1635;4819
260370;201705;5597;17149;4931;15952;330;1375;3637;11605;3967;12980
260380;201705;4872;15629;4383;14844;266;1156;3250;10896;3516;12052
260390;201705;4246;13326;3667;12178;280;1021;2531;8318;2811;9339
260392;201705;3484;11108;3163;10697;202;944;2604;8641;2806;9585
260400;201705;13766;37935;12967;36670;1360;4286;9417;26179;10777;30465
260410;201705;60665;170002;52390;156992;13378;42691;20646;63572;34024;106263
260415;201705;3700;11389;3244;10477;190;872;2207;6801;2397;7673
260420;201705;12255;27652;10842;26119;182;621;9956;23803;10138;24424
260430;201705;2900;9235;2540;8547;199;738;1711;5744;1910;6482
260440;201705;3320;9725;2937;8987;276;1001;2068;6147;2344;7148
260450;201705;5051;14316;4846;14036;163;551;4360;12643;4523;13194
260460;201705;5520;17297;5032;16364;769;2874;2936;9315;3705;12189
260470;201705;4642;13380;4205;12860;135;382;3687;11622;3822;12004
260480;201705;4147;11617;3630;10873;425;1403;2365;7246;2790;8649
260490;201705;5036;12920;4383;11817;174;584;3653;9572;3827;10156
260500;201705;5867;16501;5179;15422;670;2012;3413;10266;4083;12278
260510;201705;8908;23218;8203;22258;343;1082;7170;19288;7513;20370
260515;201705;4748;13940;3613;11706;212;806;2285;7339;2497;8145
260520;201705;16663;42009;15759;40788;1408;3763;12376;31768;13784;35531
260530;201705;9535;29015;8395;27250;337;1397;7044;22813;7381;24210
260540;201705;6022;14848;5473;14254;621;1159;4363;11976;4984;13135
260545;201705;64;226;42;166;10;40;7;27;17;67
260550;201705;2770;8744;2333;7782;314;1190;1227;4033;1541;5223
260560;201705;6331;16410;5588;15396;158;655;4820;13088;4978;13743
260570;201705;6762;21585;6206;20702;606;2306;4630;15432;5236;17738
260580;201705;3786;10230;3467;9719;71;257;3022;8335;3093;8592
260590;201705;6295;15677;5866;15186;256;691;5114;13249;5370;13940
260600;201705;29198;82698;25730;77028;1714;6249;18939;56046;20653;62295
260610;201705;6186;18345;5884;17846;589;1964;4371;13041;4960;15005
260620;201705;15123;45255;14441;44058;2174;7653;9304;27542;11478;35195
260630;201705;2326;6535;2014;6079;75;314;1666;4961;1741;5275
260640;201705;17352;46629;16192;45078;1808;5471;11489;31808;13297;37279
260650;201705;5475;16609;4804;15467;248;993;3859;12431;4107;13424
260660;201705;7694;21013;6904;20018;239;927;5830;16693;6069;17620
260670;201705;2321;6110;1917;5527;108;321;1369;3931;1477;4252
260680;201705;21877;61033;19845;57440;3289;9761;10545;30479;13834;40240
260690;201705;3734;9903;3099;8875;168;504;2413;6899;2581;7403
260700;201705;5805;17299;5648;17130;26;47;5536;16961;5562;17008
260710;201705;1371;3878;1299;3781;91;320;966;2880;1057;3200
260720;201705;18135;55747;16938;53496;3012;9975;9803;30813;12815;40788
260730;201705;6776;21965;6338;21255;595;2330;4881;16106;5476;18436
260740;201705;1247;3713;1116;3482;48;167;922;2873;970;3040
260750;201705;7004;20387;6154;19311;218;645;5450;17455;5668;18100
260760;201705;4830;12788;4530;12420;193;632;3832;10520;4025;11152
260765;201705;7551;25343;7149;24671;861;3876;4889;16245;5750;20121
260770;201705;3807;10137;3409;9502;130;430;2691;7441;2821;7871
260775;201705;4941;14440;4686;14051;373;1443;3398;9877;3771;11320
260780;201705;3678;11519;3430;11047;612;2153;1991;6230;2603;8383
260790;201705;110030;274618;101262;261495;18833;49711;59118;151557;77951;201268
260795;201705;3120;8917;2750;8357;203;704;1967;6014;2170;6718
260800;201705;5157;13056;4783;12542;120;445;4231;10734;4351;11179
260805;201705;3737;11085;3213;10234;302;1120;2202;6917;2504;8037
260810;201705;6602;18298;6304;17813;393;1202;5188;14596;5581;15798
260820;201705;4089;11230;3631;10517;499;1656;2241;6331;2740;7987
260825;201705;2897;9121;2581;8593;138;590;1948;6436;2086;7026
260830;201705;3807;11937;3386;11145;447;1483;2271;7551;2718;9034
260840;201705;4193;11927;3735;11261;223;719;3005;9025;3228;9744
260845;201705;4069;11672;3867;11302;379;1156;2925;8570;3304;9726
260850;201705;4932;15584;4379;14342;711;2502;2274;7375;2985;9877
260860;201705;3644;10841;3145;9838;169;615;2393;7415;2562;8030
260870;201705;4289;11240;3789;10606;195;634;3135;8694;3330;9328
260875;201705;6598;18073;5764;16724;786;2306;3755;10987;4541;13293
260880;201705;9883;28905;8905;27333;464;1592;7160;22037;7624;23629
260890;201705;12894;36523;12008;35162;803;2767;8913;25738;9716;28505
260900;201705;5664;17201;4884;15723;344;1407;3229;10184;3573;11591
260910;201705;3089;9081;2767;8566;129;469;2085;6444;2214;6913
260915;201705;4671;15151;4367;14730;91;464;3957;13306;4048;13770
260920;201705;3280;9756;3039;9426;175;564;2449;7774;2624;8338
260930;201705;3844;12398;3417;11674;304;1118;2454;8404;2758;9522
260940;201705;13914;36270;12755;34395;1340;4110;8807;23229;10147;27339
260950;201705;6313;19137;5561;17612;827;3012;2855;8616;3682;11628
260960;201705;55550;150315;50252;141805;8978;27190;27187;75734;36165;102924
260970;201705;4948;14599;4531;14054;229;853;3533;10994;3762;11847
260980;201705;4092;12912;3779;12517;101;427;3353;11107;3454;11534
260990;201705;17199;51909;15438;49440;901;3602;11660;37066;12561;40668
261000;201705;15701;41704;12990;37621;1632;5100;7638;22563;9270;27663
261010;201705;2552;6930;2315;6634;95;216;2057;6007;2152;6223
261020;201705;6500;18464;5689;17015;483;1600;4189;12218;4672;13818
261030;201705;3821;11504;3360;10741;169;649;2645;8322;2814;8971
261040;201705;5114;16208;4327;14545;321;1262;3080;10166;3401;11428
261050;201705;7829;22499;7281;21545;912;2769;4764;14159;5676;16928
261060;201705;12548;35608;11573;33904;1001;3410;8643;24812;9644;28222
261070;201705;54114;129921;47716;120776;4765;12686;33489;83896;38254;96582
261080;201705;5732;16046;5432;15612;288;800;4726;13744;5014;14544
261090;201705;16702;44545;15302;42621;894;2685;12556;34949;13450;37634
261100;201705;8257;25403;7331;23817;1042;3607;4551;15023;5593;18630
261110;201705;60437;177964;53585;167530;13476;44723;23549;75569;37025;120292
261120;201705;3869;9969;3369;9377;76;262;2984;8312;3060;8574
261130;201705;7254;18217;6686;17587;168;524;5964;15639;6132;16163
261140;201705;3175;8695;2876;8236;367;1194;1866;5264;2233;6458
261150;201705;5393;14927;4910;14195;195;689;4215;12111;4410;12800
261153;201705;2063;6109;1758;5622;91;371;1247;3955;1338;4326
261160;201705;194455;505728;178792;482321;44435;125918;79076;215714;123511;341632
261170;201705;5689;15147;5201;14445;271;775;4207;11699;4478;12474
261180;201705;9740;26489;9041;25534;878;2770;6257;17464;7135;20234
261190;201705;5007;15316;4657;14883;468;1916;3312;10336;3780;12252
261200;201705;3612;8792;3218;8317;293;778;2506;6467;2799;7245
261210;201705;1885;4929;1735;4733;100;288;1498;4082;1598;4370
261220;201705;13555;41019;11521;36895;1546;5455;6477;20578;8023;26033
261230;201705;4612;14003;4152;13425;111;449;3526;11534;3637;11983
261240;201705;4906;13872;4494;13174;464;1301;3349;9905;3813;11206
261245;201705;3486;10628;3014;9788;143;673;2338;7361;2481;8034
261247;201705;3138;9541;2688;8718;164;654;1923;6239;2087;6893
261250;201705;19058;49969;17625;48040;3225;8425;11265;31953;14490;40378
261255;201705;4029;12340;3580;11550;200;904;2825;8863;3025;9767
261260;201705;12644;34859;11208;33125;478;1642;9373;27947;9851;29589
261270;201705;3744;10972;3380;10371;290;1020;2435;7277;2725;8297
261280;201705;2568;7640;2355;7296;94;369;1903;5808;1997;6177
261290;201705;2983;8350;2672;7942;154;552;2073;6183;2227;6735
261300;201705;10933;33950;9504;31345;972;3863;6260;20185;7232;24048
261310;201705;7099;21439;6637;20635;1569;4977;3634;11280;5203;16257
261320;201705;5882;17654;5353;16736;188;761;4330;13334;4518;14095
261330;201705;5746;15589;5376;15112;282;1046;4569;12576;4851;13622
261340;201705;3929;12838;3670;12415;317;1351;2586;8656;2903;10007
261350;201705;8149;25962;7661;25135;236;1238;6233;19939;6469;21177
261360;201705;8238;21223;7252;19880;485;1387;5726;15466;6211;16853
261370;201705;19107;55819;17896;53863;3501;11108;10132;30527;13633;41635
261380;201705;4090;13661;3782;13016;534;2114;2376;8016;2910;10130
261390;201705;16252;48720;14584;45893;1886;6474;8802;27751;10688;34225
261400;201705;4701;15891;4174;14762;237;1054;2996;10435;3233;11489
261410;201705;9081;24498;8043;22894;565;1818;6395;18088;6960;19906
261420;201705;7317;24276;6981;23825;1368;5269;4315;14536;5683;19805
261430;201705;3481;10453;2982;9699;179;615;2353;7706;2532;8321
261440;201705;1565;4875;1393;4575;56;295;1046;3334;1102;3629
261450;201705;14044;39682;13478;38977;323;1288;11953;34332;12276;35620
261460;201705;7052;20477;6580;19819;343;1131;5651;16998;5994;18129
261470;201705;4082;10935;3751;10492;68;269;3177;8928;3245;9197
261480;201705;3953;13530;3595;12907;244;1047;2712;9530;2956;10577
261485;201705;4963;14979;4398;14015;560;2058;2754;8631;3314;10689
261500;201705;5509;15308;4930;14531;472;1357;3558;10771;4030;12128
261510;201705;1890;5912;1679;5551;121;465;1235;4106;1356;4571
261520;201705;2713;8529;2563;8260;114;413;1669;5671;1783;6084
261530;201705;10867;34833;9825;32716;1727;6516;4597;15206;6324;21722
261540;201705;7076;22451;6599;21620;1399;4648;3756;12619;5155;17267
261550;201705;3496;9639;3250;9289;226;816;2475;6891;2701;7707
261560;201705;7382;23536;6646;22532;690;2820;4904;16600;5594;19420
261570;201705;3420;10007;2952;9228;307;1082;1895;5847;2202;6929
261580;201705;6148;18135;5573;17234;236;1038;4730;14397;4966;15435
261590;201705;2522;6963;2145;6377;136;417;1616;4828;1752;5245
261600;201705;5278;14078;4516;12984;290;908;3366;9676;3656;10584
261610;201705;2454;6799;2116;6304;67;266;1733;5162;1800;5428
261618;201705;2477;6752;2247;6448;135;443;1789;5036;1924;5479
261620;201705;3960;12223;3717;11817;812;2503;2244;7395;3056;9898
261630;201705;7471;21499;6304;19321;657;2429;3724;11052;4381;13481
261640;201705;35224;85630;32944;82939;1980;4494;26848;70449;28828;74943
261650;201705;3841;11012;3551;10630;209;790;2659;8027;2868;8817
270010;201705;4323;15738;3962;15043;260;1337;3028;11332;3288;12669
270020;201705;3920;10744;3618;10314;292;987;2907;8075;3199;9062
270030;201705;36935;108483;34043;103705;6498;20244;19967;61369;26465;81613
270040;201705;10750;31837;9877;30693;1166;3954;7157;22384;8323;26338
270050;201705;4585;12123;4146;11606;309;874;3475;9856;3784;10730
270060;201705;1924;5487;1769;5284;231;710;1241;3784;1472;4494
270070;201705;4434;13311;4039;12771;181;853;3397;10481;3578;11334
270080;201705;1282;3978;1107;3643;120;422;742;2397;862;2819
270090;201705;2137;6571;1925;6163;100;477;1505;4611;1605;5088
270100;201705;5650;16727;5288;16148;478;1740;4021;12068;4499;13808
270110;201705;2973;8263;2654;7903;297;934;1950;6016;2247;6950
270120;201705;3113;8508;2745;8046;81;322;2441;7130;2522;7452
270130;201705;5229;15363;4811;14901;498;1655;3769;11846;4267;13501
270135;201705;1835;4852;1633;4607;146;299;1377;4039;1523;4338
270140;201705;10666;24491;8973;22332;529;2028;7316;17222;7845;19250
270150;201705;2683;8496;2608;8410;40;145;2533;8176;2573;8321
270160;201705;4920;16136;4541;15659;157;779;3906;13320;4063;14099
270170;201705;3701;11640;3388;11208;428;1718;2266;7320;2694;9038
270180;201705;2300;7364;2115;7102;101;475;1764;5809;1865;6284
270190;201705;1756;5601;1664;5483;90;319;1399;4665;1489;4984
270200;201705;2523;8278;2349;8023;191;821;1746;5783;1937;6604
270210;201705;4925;13834;4573;13367;331;1032;3839;11213;4170;12245
270220;201705;1279;4090;1180;3917;246;900;654;2127;900;3027
270230;201705;10688;32770;9301;30588;1076;4309;5682;18108;6758;22417
270235;201705;6147;19656;5751;19035;309;1319;4706;15434;5015;16753
270240;201705;9938;29081;8449;27146;1814;6161;4701;15390;6515;21551
270250;201705;3134;8188;2833;7811;393;1044;2122;5940;2515;6984
270255;201705;4800;14427;3887;12745;267;1119;2742;8773;3009;9892
270260;201705;5919;18384;5682;18051;317;1379;4829;14914;5146;16293
270270;201705;1149;3187;1057;3063;181;537;643;1839;824;2376
270280;201705;3504;9649;3033;8990;386;976;2099;6390;2485;7366
270290;201705;7979;26877;7442;25959;484;2274;5966;20431;6450;22705
270300;201705;3747;11523;3353;11057;325;1202;2475;8155;2800;9357
270310;201705;7503;22192;6596;20865;244;1223;5420;16673;5664;17896
270320;201705;5812;17710;5423;17070;737;2508;3690;11469;4427;13977
270330;201705;4139;13998;3849;13609;361;1385;2978;10647;3339;12032
270340;201705;1647;4930;1450;4662;107;432;1152;3605;1259;4037
270350;201705;1928;5009;1712;4728;168;512;1220;3381;1388;3893
270360;201705;2110;6276;2008;6160;146;418;1735;5443;1881;5861
270370;201705;1447;4713;1316;4489;94;398;965;3278;1059;3676
270375;201705;2960;7847;2605;7386;69;215;2304;6531;2373;6746
270380;201705;5763;17408;5339;16830;415;1342;4147;13334;4562;14676
270390;201705;1262;3400;1089;3144;57;196;831;2336;888;2532
270400;201705;6386;18757;5699;17756;307;1241;4232;12847;4539;14088
270410;201705;4741;14733;4325;13982;350;1321;3130;9967;3480;11288
270420;201705;5941;18466;5660;18097;278;1258;4607;14387;4885;15645
270430;201705;137675;385179;119792;359161;34050;108033;42616;132800;76666;240833
270440;201705;4634;13683;4245;13161;157;676;3473;10701;3630;11377
270450;201705;6358;19068;6013;18607;371;1470;4882;14908;5253;16378
270460;201705;3461;8825;3127;8430;105;370;2750;7275;2855;7645
270470;201705;10310;32242;9460;30903;1050;3943;6459;21180;7509;25123
270480;201705;2863;8529;2498;7909;293;1092;1717;5238;2010;6330
270490;201705;999;3059;906;2933;56;227;703;2245;759;2472
270500;201705;4838;15910;4490;15480;223;1069;3755;12789;3978;13858
270510;201705;6053;17302;5414;16414;579;2280;4102;12001;4681;14281
270520;201705;3504;10939;3161;10344;1039;3635;1030;3579;2069;7214
270530;201705;1303;3997;1211;3860;100;331;862;2791;962;3122
270540;201705;2054;6590;1899;6371;91;466;1575;5114;1666;5580
270550;201705;6766;19747;6101;18926;708;2316;4455;14107;5163;16423
270560;201705;3145;9177;2898;8803;209;771;2191;6534;2400;7305
270570;201705;3745;11930;3391;11325;213;908;2676;8771;2889;9679
270580;201705;2120;6282;2001;6122;103;324;1718;5323;1821;5647
270590;201705;1397;4470;1353;4413;6;26;1330;4346;1336;4372
270600;201705;2877;9284;2608;8837;158;761;2129;7037;2287;7798
270610;201705;3353;9957;3082;9571;145;569;2623;8031;2768;8600
270620;201705;1386;4504;1290;4340;79;353;1046;3403;1125;3756
270630;201705;15976;46088;14533;43795;1681;5291;10248;31252;11929;36543
270640;201705;5759;17402;5158;16462;304;1274;4113;12858;4417;14132
270642;201705;2389;8176;2220;7938;194;960;1730;5990;1924;6950
270644;201705;2825;8050;2451;7534;257;810;1778;5590;2035;6400
270650;201705;3662;11244;3459;10968;424;1923;2497;7455;2921;9378
270660;201705;2114;5421;1671;4799;84;333;1221;3466;1305;3799
270670;201705;16790;42035;14547;39512;1542;4177;10926;30372;12468;34549
270680;201705;4420;12378;4196;12130;92;243;3952;11510;4044;11753
270690;201705;9358;24649;8312;23486;2013;5276;5171;15533;7184;20809
270700;201705;579;1831;514;1721;71;305;343;1095;414;1400
270710;201705;6001;18572;5656;18131;346;1465;4710;14814;5056;16279
270720;201705;3477;11295;3116;10662;123;701;2564;8551;2687;9252
270730;201705;6524;18068;6101;17600;402;1200;5238;15274;5640;16474
270740;201705;2344;6530;2189;6297;157;561;1796;5099;1953;5660
270750;201705;5255;15601;4818;14927;532;1871;3534;10880;4066;12751
270760;201705;3533;10262;3164;9678;129;506;2573;7767;2702;8273
270770;201705;19399;50329;16161;46434;3151;8800;9435;28803;12586;37603
270780;201705;1807;5633;1719;5499;172;615;1303;4160;1475;4775
270790;201705;1590;4939;1464;4752;284;972;871;2830;1155;3802
270800;201705;11136;32298;10337;31227;535;2217;8776;25952;9311;28169
270810;201705;3242;9729;2600;8557;227;888;1745;5707;1972;6595
270820;201705;1772;5600;1559;5244;227;877;1011;3352;1238;4229
270830;201705;5576;14405;4945;13665;364;1013;3975;11351;4339;12364
270840;201705;7948;24784;7291;23915;296;1566;6269;20005;6565;21571
270850;201705;7708;22636;7281;22080;678;2743;5548;16021;6226;18764
270860;201705;11425;30933;9612;28673;999;3488;6740;19728;7739;23216
270870;201705;2229;6580;1882;5883;208;691;1241;3846;1449;4537
270880;201705;8306;25875;7682;24958;422;1747;6213;19890;6635;21637
270890;201705;2450;7343;2272;7039;224;824;1655;4980;1879;5804
270895;201705;2953;10381;2844;10222;126;649;2472;8746;2598;9395
270900;201705;1805;4881;1488;4408;75;239;1147;3313;1222;3552
270910;201705;3611;11478;3302;10934;193;884;2512;8120;2705;9004
270915;201705;9431;30607;8419;28816;1130;4514;5167;17270;6297;21784
270920;201705;6226;19162;5908;18719;292;1419;5112;15727;5404;17146
270930;201705;16652;43976;14156;40977;2674;7485;8774;26474;11448;33959
270940;201705;5511;17787;5187;17439;432;2008;3847;12618;4279;14626
280010;201705;684;1930;588;1761;40;187;415;1130;455;1317
280020;201705;4864;13585;4241;12576;553;1734;2765;8152;3318;9886
280030;201705;73756;189591;62562;173139;17332;49744;23354;67607;40686;117351
280040;201705;3163;9294;2829;8795;296;1022;2013;6167;2309;7189
280050;201705;3706;11602;3414;11097;835;2891;1726;5645;2561;8536
280060;201705;5047;15286;4319;14043;812;2854;2171;7219;2983;10073
280067;201705;7066;19514;6136;18030;821;2491;3827;11239;4648;13730
280070;201705;1949;6201;1872;6080;160;521;1512;4924;1672;5445
280100;201705;3792;11481;3415;10833;448;1564;2280;7256;2728;8820
280110;201705;1372;4067;1257;3888;54;216;1049;3184;1103;3400
280120;201705;7889;24136;7153;22909;1039;3150;5001;16538;6040;19688
280130;201705;7966;20952;7387;20119;802;2415;5425;14782;6227;17197
280140;201705;5854;15122;5359;14425;390;1071;4327;11693;4717;12764
280150;201705;3563;10243;3335;9891;216;785;2629;7674;2845;8459
280160;201705;1317;3832;1114;3483;166;559;679;2083;845;2642
280170;201705;4852;14064;4419;13422;351;1068;3450;10638;3801;11706
280190;201705;1216;3049;1039;2783;75;242;807;2087;882;2329
280200;201705;1215;3536;1095;3353;98;350;795;2373;893;2723
280210;201705;14533;40691;12919;38483;2253;7167;7380;22322;9633;29489
280220;201705;1721;4899;1570;4677;78;259;1306;3863;1384;4122
280230;201705;3289;9584;2986;9111;314;1032;2088;6382;2402;7414
280240;201705;3509;9713;3166;9179;128;492;2603;7395;2731;7887
280250;201705;848;2220;671;1929;107;323;325;923;432;1246
280260;201705;2133;5464;1992;5299;62;191;1833;4873;1895;5064
280270;201705;2197;6652;2012;6369;111;408;1657;5176;1768;5584
280280;201705;4156;13400;3762;12749;684;1974;2286;8356;2970;10330
280290;201705;17627;51850;15874;49146;1849;6525;10134;31470;11983;37995
280300;201705;9797;28719;9097;27878;633;2208;6932;22077;7565;24285
280310;201705;1395;3826;1189;3475;42;171;874;2479;916;2650
280320;201705;8696;26663;7965;25498;1232;4378;4676;14824;5908;19202
280330;201705;4659;12634;4205;11914;361;1198;3221;8839;3582;10037
280340;201705;4162;10721;3880;10353;320;839;3115;8606;3435;9445
280350;201705;22471;61054;19787;57127;2678;8206;12990;37735;15668;45941
280360;201705;5747;17511;5285;16715;921;3208;3006;9391;3927;12599
280370;201705;1932;5147;1647;4681;158;407;1178;3372;1336;3779
280380;201705;1068;3174;960;2996;111;418;660;2002;771;2420
280390;201705;3125;8986;2674;8140;214;744;1857;5605;2071;6349
280400;201705;4122;11402;3742;10848;909;2608;1929;5828;2838;8436
280410;201705;2141;6690;1836;6087;202;742;1084;3486;1286;4228
280420;201705;4282;12020;3912;11456;191;566;3346;9865;3537;10431
280430;201705;2241;5694;2000;5353;100;376;1540;4028;1640;4404
280440;201705;4692;13263;4261;12712;323;1053;3366;9940;3689;10993
280445;201705;2468;6585;2228;6157;59;202;1739;4684;1798;4886
280450;201705;9438;23957;8678;22979;560;1250;7306;19880;7866;21130
280460;201705;6907;17429;6299;16569;736;1955;4720;12533;5456;14488
280470;201705;1853;5404;1639;5038;95;304;1219;3746;1314;4050
280480;201705;33339;92215;30994;88833;4032;13094;21079;59300;25111;72394
280490;201705;3880;11467;3414;10707;206;818;2547;7841;2753;8659
280500;201705;950;2461;837;2312;42;126;679;1866;721;1992
280510;201705;2530;7393;2262;7014;147;567;1647;5071;1794;5638
280520;201705;1768;4675;1604;4469;108;303;1345;3766;1453;4069
280530;201705;2510;6566;2301;6301;140;430;1887;5178;2027;5608
280540;201705;9372;25396;8615;24307;228;1009;7516;20649;7744;21658
280550;201705;6992;17515;5765;15682;425;1155;4178;11299;4603;12454
280560;201705;7497;21748;7070;21142;297;1159;6034;17749;6331;18908
280570;201705;6378;16998;5461;15768;445;1483;3816;10921;4261;12404
280580;201705;5421;16461;4681;15128;692;2220;2908;9649;3600;11869
280590;201705;2693;7285;2365;6876;210;815;1587;4497;1797;5312
280600;201705;3528;10462;3236;10034;261;950;2441;7489;2702;8439
280610;201705;2491;6744;2266;6424;173;581;1714;4750;1887;5331
280620;201705;5429;15190;4750;14098;510;1418;3257;10053;3767;11471
280630;201705;3663;11659;3416;11294;285;953;2677;9055;2962;10008
280640;201705;2229;6652;2105;6516;67;196;1955;6102;2022;6298
280650;201705;1100;3305;994;3135;111;375;695;2172;806;2547
280660;201705;2726;7415;2577;7242;231;643;2142;6069;2373;6712
280670;201705;17175;43285;15634;41243;1636;4693;11322;29636;12958;34329
280680;201705;2909;7595;2492;6932;178;499;1871;5125;2049;5624
280690;201705;989;2681;885;2540;84;266;648;1835;732;2101
280700;201705;1082;3083;982;2909;48;162;719;2100;767;2262
280710;201705;13057;31975;11636;30325;647;1274;10030;26944;10677;28218
280720;201705;2457;6161;2214;5883;197;554;1515;4275;1712;4829
280730;201705;1043;2819;960;2694;58;204;794;2183;852;2387
280740;201705;13319;34967;11441;32043;1270;3578;7481;21148;8751;24726
280750;201705;3476;10275;3184;9798;239;834;2281;6990;2520;7824
280760;201705;5802;17160;5305;16401;782;2565;3264;10357;4046;12922
290010;201705;2814;6356;2079;5213;53;226;1647;3911;1700;4137
290020;201705;4466;14215;4323;14032;308;950;3679;12054;3987;13004
290030;201705;3307;9632;3095;9351;309;935;2445;7424;2754;8359
290035;201705;4633;11448;4034;10639;204;619;3204;8582;3408;9201
290040;201705;4253;10979;3585;10226;199;774;2755;7868;2954;8642
290050;201705;2384;7717;2098;7214;140;593;1502;5110;1642;5703
290060;201705;1293;3242;1076;2967;124;416;759;2012;883;2428
290070;201705;33623;82078;29034;76230;4561;12308;16477;44739;21038;57047
290080;201705;5928;17386;5036;16149;668;2247;3348;10989;4016;13236
290090;201705;2115;4381;1739;3974;68;134;1557;3590;1625;3724
290100;201705;9218;26046;8182;24424;1096;3228;5200;15971;6296;19199
290110;201705;5000;14299;4718;13804;632;1974;3088;8946;3720;10920
290115;201705;4647;13696;4145;13031;190;575;3491;11203;3681;11778
290120;201705;6906;17563;5716;16153;252;899;4661;12969;4913;13868
290130;201705;4709;12057;3826;10964;156;614;3044;8499;3200;9113
290135;201705;4679;11294;3875;10046;272;808;2823;7074;3095;7882
290140;201705;4532;13065;3801;12120;203;769;3180;10169;3383;10938
290150;201705;2219;6484;2108;6323;221;697;1605;4717;1826;5414
290160;201705;3368;8360;3176;8122;241;572;2619;6687;2860;7259
290170;201705;2638;8416;2471;8196;140;605;2119;6927;2259;7532
290180;201705;2956;8374;2519;7698;133;502;1957;5930;2090;6432
290190;201705;3827;12406;3650;12147;223;973;2854;9397;3077;10370
290195;201705;2222;5917;1854;5334;75;321;1482;4176;1557;4497
290200;201705;3971;11909;3469;11155;216;765;2734;8722;2950;9487
290205;201705;3378;9314;3024;8753;163;623;2310;6508;2473;7131
290210;201705;14579;41022;13095;39091;1479;3845;9615;30146;11094;33991
290220;201705;2464;6952;2336;6766;209;656;1827;5251;2036;5907
290225;201705;3100;7230;2740;6823;68;156;2543;6365;2611;6521
290230;201705;2256;7083;2114;6915;107;439;1767;5780;1874;6219
290240;201705;3564;9833;3215;9325;191;606;2545;7298;2736;7904
290250;201705;3915;11903;3625;11519;120;324;3099;10331;3219;10655
290260;201705;5207;14310;4289;12934;302;1049;3248;9761;3550;10810
290265;201705;3586;10756;3069;9820;153;645;2338;7377;2491;8022
290270;201705;12102;42907;11562;42053;1024;4356;8776;31706;9800;36062
290280;201705;5681;17703;5216;16955;363;1302;3899;12665;4262;13967
290290;201705;10105;30559;8832;28437;935;3102;6197;20128;7132;23230
290300;201705;4624;12859;3352;10485;212;723;2318;7352;2530;8075
290310;201705;1507;4349;1299;4021;162;551;833;2562;995;3113
290320;201705;28190;78167;23861;72724;4915;15983;12627;39591;17542;55574
290323;201705;3807;10335;3410;9845;117;413;2886;8215;3003;8628
290327;201705;4576;13402;3918;12231;397;1253;2646;8266;3043;9519
290330;201705;1943;4542;1755;4345;84;202;1562;3928;1646;4130
290340;201705;5186;15360;4740;14818;1011;3277;2956;9373;3967;12650
290350;201705;4576;14122;4062;13285;378;1296;2887;9612;3265;10908
290360;201705;4815;13895;4144;12983;131;514;3467;10942;3598;11456
290370;201705;4757;12762;3999;11707;236;656;3166;9380;3402;10036
290380;201705;5605;15987;4904;14937;255;840;3926;12115;4181;12955
290390;201705;15219;44907;13522;42399;1680;5450;8834;28455;10514;33905
290395;201705;2674;8530;2377;7965;98;446;1818;6080;1916;6526
290400;201705;3747;10637;3099;9631;209;723;2239;6861;2448;7584
290405;201705;4831;14673;4065;13278;347;1230;2655;8746;3002;9976
290410;201705;5870;16991;4796;15243;286;1149;3460;10609;3746;11758
290420;201705;3251;9194;2688;8359;218;712;2036;6367;2254;7079
290430;201705;3191;9617;2780;8880;428;1387;1705;5556;2133;6943
290440;201705;3013;7747;2355;6805;122;405;1765;5142;1887;5547
290450;201705;3250;9252;2758;8520;154;615;2071;6243;2225;6858
290460;201705;12548;35876;11241;33612;3217;9925;4122;12325;7339;22250
290470;201705;4147;11583;3210;10105;625;2190;1473;4771;2098;6961
290475;201705;5849;18127;5150;16858;171;854;4024;12880;4195;13734
290480;201705;2370;6392;2204;6151;214;626;1493;4327;1707;4953
290485;201705;4828;14908;4184;13936;221;1094;3411;11149;3632;12243
290490;201705;8533;21655;8027;21013;565;1696;6584;17013;7149;18709
290500;201705;4039;12508;3288;10989;429;1548;1728;5739;2157;7287
290510;201705;3207;8978;2854;8493;118;464;2411;7114;2529;7578
290515;201705;3674;9987;3066;9206;118;314;2624;8060;2742;8374
290520;201705;11446;34657;9214;30261;547;2253;5826;18818;6373;21071
290530;201705;5178;15074;4544;14061;277;921;3659;11303;3936;12224
290540;201705;3709;10631;3470;10257;195;625;2882;8505;3077;9130
290550;201705;4573;11749;4078;11190;75;240;3760;10384;3835;10624
290560;201705;6471;18048;5636;16843;800;2549;3823;11358;4623;13907
290570;201705;42989;114479;39625;110030;3320;9583;29551;81949;32871;91532
290580;201705;7080;23258;6613;22519;652;2309;4970;17239;5622;19548
290590;201705;7174;22630;6233;20980;240;1031;5075;17082;5315;18113
290600;201705;17940;52471;16600;50581;1338;4197;12977;40339;14315;44536
290610;201705;2468;8162;2030;7314;110;519;1416;5000;1526;5519
290620;201705;6304;18651;5751;17756;316;1071;4745;14532;5061;15603
290630;201705;8377;21206;7261;19938;487;1346;6047;16759;6534;18105
290640;201705;2672;7528;2174;6752;121;462;1663;5085;1784;5547
290650;201705;10865;31152;10298;30374;2351;6862;6060;18501;8411;25363
290660;201705;3700;9911;3166;9133;131;382;2334;7045;2465;7427
290670;201705;7065;20947;6266;19631;593;1924;4472;14203;5065;16127
290680;201705;10242;30155;9137;28681;350;1626;7333;22562;7683;24188
290682;201705;4703;13036;4107;12186;172;631;3388;9919;3560;10550
290685;201705;3680;8633;2443;6899;245;701;1553;4502;1798;5203
290687;201705;7113;20381;5684;18007;1112;3574;2893;9552;4005;13126
290689;201705;3070;8774;2713;8238;225;775;1947;6063;2172;6838
290690;201705;5509;15287;4803;14346;701;2049;3121;9433;3822;11482
290700;201705;2485;7270;2323;7040;106;371;1939;5889;2045;6260
290710;201705;7728;23904;7156;23069;428;1456;5925;19187;6353;20643
290720;201705;18805;53538;17423;51821;1083;3202;14446;43709;15529;46911
290730;201705;7215;19203;6443;18188;430;1237;4877;13767;5307;15004
290740;201705;925;2677;735;2343;48;167;537;1712;585;1879
290750;201705;10717;29061;9225;26392;1278;3981;5559;15523;6837;19504
290755;201705;2313;6519;1827;5639;110;407;1271;3858;1381;4265
290760;201705;4113;12309;3318;10784;434;1288;1912;6494;2346;7782
290770;201705;2556;8709;2383;8481;107;507;1919;6866;2026;7373
290780;201705;9083;22540;7837;20765;657;1357;5960;16342;6617;17699
290790;201705;4524;13041;4135;12521;223;624;3524;10759;3747;11383
290800;201705;7182;14990;5628;13311;391;778;4379;10750;4770;11528
290810;201705;5506;16192;4555;14641;195;736;3386;10940;3581;11676
290820;201705;5398;14959;4868;14231;348;1184;3668;10771;4016;11955
290830;201705;4521;11372;4159;10880;171;560;3256;8391;3427;8951
290840;201705;17409;48969;15331;45800;1871;5335;10046;31317;11917;36652
290850;201705;6194;17170;5906;16814;664;1685;4465;13213;5129;14898
290860;201705;5322;17256;4940;16799;345;1283;3995;13889;4340;15172
290870;201705;4787;13692;3830;12081;202;821;2713;8513;2915;9334
290880;201705;1447;3795;1155;3347;88;224;795;2358;883;2582
290890;201705;7364;17979;6311;16803;309;797;5562;14918;5871;15715
290900;201705;2352;6603;1821;5661;145;501;1129;3477;1274;3978
290910;201705;5015;13249;4129;11940;78;329;3485;9974;3563;10303
290920;201705;5084;13229;4698;12739;179;515;4115;11119;4294;11634
290930;201705;8336;24159;7122;22263;269;1216;5635;17218;5904;18434
290940;201705;3636;11043;3197;10403;152;500;2432;8080;2584;8580
290950;201705;1584;4277;1380;3962;114;346;960;2769;1074;3115
290960;201705;5679;15779;5122;15084;175;579;4307;12725;4482;13304
290970;201705;3780;11289;3247;10416;248;803;2269;7346;2517;8149
290980;201705;10568;29374;9014;26498;2209;6763;3153;9320;5362;16083
290990;201705;9025;26275;7776;24181;597;2126;5818;17743;6415;19869
291000;201705;3113;8941;2790;8553;265;773;2239;6956;2504;7729
291005;201705;14766;37177;13060;35045;1058;2903;9944;26999;11002;29902
291010;201705;3283;9965;2586;8516;211;708;1661;5493;1872;6201
291020;201705;1280;3359;1038;2926;68;207;634;1698;702;1905
291030;201705;2349;6223;1692;4931;114;369;1042;2925;1156;3294
291040;201705;5586;16278;4898;15253;287;1158;3832;11879;4119;13037
291050;201705;7792;24478;7100;23251;1374;5058;4119;13144;5493;18202
291060;201705;5990;21527;5615;20911;774;3347;3685;13492;4459;16839
291070;201705;16147;45394;14064;42276;670;2474;11068;32993;11738;35467
291072;201705;23731;68402;19035;59000;4453;14787;6601;20721;11054;35508
291075;201705;5072;14082;4490;13159;291;756;3405;10043;3696;10799
291077;201705;1514;4239;1250;3787;61;203;896;2713;957;2916
291080;201705;78443;239158;69507;223014;24397;79758;12078;40193;36475;119951
291085;201705;5715;14853;4891;13740;286;911;4016;11247;4302;12158
291090;201705;1746;3822;1523;3569;115;174;1271;3063;1386;3237
291100;201705;2729;6698;2110;5966;123;453;1625;4489;1748;4942
291110;201705;5370;17959;4774;17024;499;2028;3463;12069;3962;14097
291120;201705;7459;19620;6819;18666;602;1703;5071;13904;5673;15607
291125;201705;1950;3798;1527;3345;52;137;1267;2764;1319;2901
291130;201705;2871;8794;2399;7919;89;424;1797;5766;1886;6190
291140;201705;4248;12369;3576;11088;482;1392;2222;7007;2704;8399
291150;201705;2107;5145;1925;4939;57;184;1629;4114;1686;4298
291160;201705;5027;15726;4459;14736;579;2148;2738;8900;3317;11048
291165;201705;2493;6904;1947;5895;42;179;1388;4098;1430;4277
291170;201705;21246;55325;18248;50779;1367;4192;11568;32201;12935;36393
291180;201705;6067;15760;5016;14092;346;1050;3673;10313;4019;11363
291185;201705;3521;9618;3108;8938;132;418;2527;7174;2659;7592
291190;201705;7398;19427;6434;18060;519;1588;5037;14070;5556;15658
291200;201705;2966;8652;2309;7405;103;350;1484;4764;1587;5114
291210;201705;6695;16126;5716;14947;245;859;4352;11230;4597;12089
291220;201705;4274;12841;3889;12228;461;1685;2605;8037;3066;9722
291230;201705;4011;9868;3595;9409;78;146;3379;8948;3457;9094
291240;201705;4512;11969;3941;10978;120;400;3277;8969;3397;9369
291250;201705;3434;10442;2764;9184;215;717;1850;6234;2065;6951
291260;201705;1099;3043;976;2887;54;243;819;2324;873;2567
291270;201705;4717;14440;4150;13403;912;3038;2292;7524;3204;10562
291280;201705;2248;6349;1794;5557;289;964;982;2994;1271;3958
291290;201705;5667;15586;4848;14474;710;2166;3052;9319;3762;11485
291300;201705;4120;11670;3159;10008;151;538;2252;7062;2403;7600
291310;201705;5398;15071;4681;13780;235;792;3623;10578;3858;11370
291320;201705;6128;18573;4901;16157;1223;3978;2184;7456;3407;11434
291330;201705;1626;4706;1422;4348;98;322;1006;3045;1104;3367
291340;201705;3943;10699;3303;9768;106;405;2680;7840;2786;8245
291345;201705;3275;10261;3051;9977;176;602;2503;8330;2679;8932
291350;201705;5768;16619;5045;15403;282;874;3932;12219;4214;13093
291360;201705;33588;88518;28619;81769;5851;17063;15018;44301;20869;61364
291370;201705;8159;23029;7670;22396;533;1755;5870;17088;6403;18843
291380;201705;3640;10740;3166;9994;145;583;2425;7645;2570;8228
291390;201705;10723;27696;9933;26748;724;2128;7955;21395;8679;23523
291400;201705;14396;38683;12475;35810;1991;5250;7923;23994;9914;29244
291410;201705;3063;8149;2376;7005;101;450;1745;4935;1846;5385
291420;201705;2009;5280;1704;4899;59;214;1436;4098;1495;4312
291430;201705;3248;9103;2843;8521;136;637;2293;6620;2429;7257
291440;201705;6458;19226;5645;17829;497;1636;4280;13622;4777;15258
291450;201705;8499;23763;7316;22208;274;759;5939;18772;6213;19531
291460;201705;13255;39222;11912;37193;1251;4316;8064;25358;9315;29674
291465;201705;7982;22321;6951;21109;364;1531;5688;16979;6052;18510
291470;201705;15640;40868;13777;38679;800;2295;10467;30265;11267;32560
291480;201705;36243;87769;29483;78780;3790;11064;16663;44970;20453;56034
291490;201705;4300;13373;4017;12980;487;1609;2903;9517;3390;11126
291500;201705;4325;12019;3654;11025;151;592;3018;9063;3169;9655
291510;201705;3788;10922;3390;10346;79;334;2855;8766;2934;9100
291520;201705;3953;10377;3393;9618;275;850;2374;6766;2649;7616
291530;201705;2155;5686;1716;5043;355;984;918;2977;1273;3961
291535;201705;3538;10756;3259;10304;217;723;2475;7911;2692;8634
291540;201705;2082;5033;1738;4654;111;289;1480;3930;1591;4219
291550;201705;5185;13304;4490;12341;669;1728;2765;7797;3434;9525
291560;201705;18777;43734;13337;37307;867;2441;9175;27077;10042;29518
291570;201705;2175;5543;1942;5264;142;287;1608;4524;1750;4811
291580;201705;5443;16005;4789;15061;477;1810;3373;10521;3850;12331
291590;201705;1764;5402;1599;5136;139;496;1221;3945;1360;4441
291600;201705;5255;14084;4019;12097;828;2619;1956;5796;2784;8415
291610;201705;4778;14731;4620;14557;125;462;4252;13444;4377;13906
291620;201705;3073;7075;2260;6192;148;453;1713;4783;1861;5236
291630;201705;3187;7576;2556;6798;152;405;2018;5403;2170;5808
291640;201705;16372;44029;12945;38744;3161;9892;3748;12103;6909;21995
291650;201705;8417;23857;7708;22991;526;1358;6443;19551;6969;20909
291660;201705;2267;5696;1702;4819;149;520;1061;2820;1210;3340
291670;201705;1854;5067;1672;4816;99;279;1334;3903;1433;4182
291680;201705;3907;11032;3401;10171;492;1595;2209;6583;2701;8178
291685;201705;4911;12100;4039;10961;498;1226;2725;7726;3223;8952
291690;201705;3766;9827;3008;8584;170;478;2212;6251;2382;6729
291700;201705;9086;27561;8089;25791;775;2492;6011;19360;6786;21852
291710;201705;5215;13334;4172;11934;398;1205;2848;8070;3246;9275
291720;201705;4685;14686;3905;13074;276;1081;2749;8977;3025;10058
291730;201705;6281;17959;5673;17143;381;1316;4516;13742;4897;15058
291733;201705;2803;7700;2324;7031;154;496;1592;4975;1746;5471
291735;201705;2988;8038;2526;7372;112;393;2060;5954;2172;6347
291740;201705;3862;10551;3223;9676;166;553;2573;7711;2739;8264
291750;201705;21360;54357;17038;47735;2871;8345;9248;26526;12119;34871
291760;201705;10558;33212;9206;30843;3443;12744;2217;7577;5660;20321
291770;201705;7530;21447;6311;19262;713;2396;4129;12308;4842;14704
291780;201705;4505;13245;4175;12700;209;699;3460;10489;3669;11188
291790;201705;2675;7934;2532;7727;110;398;2097;6327;2207;6725
291800;201705;30053;80113;26145;74774;3400;9920;16815;49272;20215;59192
291810;201705;10814;28082;9137;26023;337;1160;7532;21321;7869;22481
291820;201705;3766;10795;3356;10177;171;590;2562;7787;2733;8377
291830;201705;4144;10784;3816;10306;313;848;3005;8226;3318;9074
291835;201705;6256;19400;5135;17293;1036;3547;2779;9690;3815;13237
291840;201705;48166;133539;42071;126358;5553;16702;28776;89444;34329;106146
291845;201705;2562;7448;2367;7180;124;345;2048;6320;2172;6665
291850;201705;4429;12711;3658;11456;330;948;2628;8533;2958;9481
291855;201705;1908;4378;1636;4046;111;337;1292;3122;1403;3459
291860;201705;2250;6133;1693;5052;51;193;1134;3240;1185;3433
291870;201705;1384;3658;980;2917;71;265;607;1721;678;1986
291875;201705;2861;8716;2532;8187;133;517;1802;5710;1935;6227
291880;201705;5016;15788;4591;14951;465;1526;3269;10687;3734;12213
291890;201705;1332;3260;1052;2905;228;520;656;1920;884;2440
291900;201705;1261;3304;972;2821;45;182;739;2093;784;2275
291905;201705;2789;7310;2123;6116;78;264;1561;4391;1639;4655
291910;201705;2787;7342;2358;6835;110;390;1973;5719;2083;6109
291915;201705;7005;21226;5881;19226;320;1218;4474;14698;4794;15916
291920;201705;24783;72757;22873;70079;2800;9724;15191;46010;17991;55734
291930;201705;2551;7455;2251;6961;183;694;1609;4831;1792;5525
291940;201705;3348;9293;2472;7774;258;843;1481;4555;1739;5398
291950;201705;8729;28224;7771;26387;1164;4007;4457;15584;5621;19591
291955;201705;11479;32035;10631;30988;2178;6122;6380;19692;8558;25814
291960;201705;3103;8823;2522;7934;207;663;1829;5947;2036;6610
291970;201705;3990;11845;3665;11294;317;1151;2528;7755;2845;8906
291980;201705;11578;32593;9066;28990;697;2328;6288;20401;6985;22729
291990;201705;2116;6283;1961;6092;76;287;1731;5413;1807;5700
291992;201705;2894;8600;2820;8484;353;1021;2179;6604;2532;7625
291995;201705;2146;5975;1787;5457;75;293;1428;4273;1503;4566
292000;201705;2383;6548;2140;6206;198;640;1460;4277;1658;4917
292010;201705;6157;15129;5085;13638;378;1003;3911;10576;4289;11579
292020;201705;4118;13366;3841;12898;402;1495;2872;9562;3274;11057
292030;201705;1812;5804;1696;5623;168;626;978;3141;1146;3767
292040;201705;4363;11546;3734;10853;220;529;3083;9377;3303;9906
292045;201705;3479;10390;3078;9836;109;311;2759;8902;2868;9213
292050;201705;6432;19161;5418;17158;461;1616;3408;10715;3869;12331
292060;201705;12827;31055;11807;29800;680;1740;9927;24754;10607;26494
292070;201705;5114;14811;4685;14310;344;1082;3914;12012;4258;13094
292080;201705;3443;8852;2810;8046;159;544;2383;6811;2542;7355
292090;201705;4058;10020;3387;9231;229;735;2732;7494;2961;8229
292100;201705;10548;28302;9201;26395;1890;5665;4628;13712;6518;19377
292105;201705;3004;9048;2708;8559;100;458;2201;6904;2301;7362
292110;201705;6403;16891;4934;14529;1276;3766;2224;6746;3500;10512
292120;201705;7106;19695;5876;17449;903;2671;3506;10574;4409;13245
292130;201705;2917;7961;2517;7398;323;920;1696;5134;2019;6054
292140;201705;4833;12602;4024;11402;405;1076;2956;8512;3361;9588
292145;201705;2256;6918;1982;6449;237;728;1323;4444;1560;5172
292150;201705;13180;38399;12061;36728;429;1657;10014;30442;10443;32099
292160;201705;2367;6827;2155;6552;85;337;1919;5790;2004;6127
292170;201705;8663;24363;7238;21921;743;2378;4754;14440;5497;16818
292180;201705;3074;8613;2363;7402;480;1462;1168;3744;1648;5206
292190;201705;3157;8873;2675;8103;470;1529;1414;4342;1884;5871
292200;201705;6896;20341;5851;18567;1408;4630;2540;8271;3948;12901
292205;201705;3849;11332;3449;10742;133;621;2887;8788;3020;9409
292210;201705;6425;16349;5377;14946;176;628;4578;12534;4754;13162
292220;201705;1814;4906;1631;4630;231;634;1042;2966;1273;3600
292225;201705;3231;9893;2931;9436;131;587;2404;7614;2535;8201
292230;201705;7000;19029;6567;18371;226;947;5368;14560;5594;15507
292240;201705;4868;14604;4282;13397;354;1121;2883;9023;3237;10144
292250;201705;5188;15267;4844;14701;786;2422;2882;8881;3668;11303
292260;201705;3240;9206;2984;8863;178;523;2507;7546;2685;8069
292265;201705;3225;9522;2763;8744;99;453;2135;6584;2234;7037
292270;201705;4028;10134;3364;9341;196;605;2784;7777;2980;8382
292273;201705;2522;5924;2131;5433;127;238;1667;4408;1794;4646
292275;201705;1703;4970;1516;4691;103;254;1204;3915;1307;4169
292280;201705;2380;6257;2004;5817;104;266;1593;4831;1697;5097
292285;201705;2453;6524;2043;5935;122;393;1593;4617;1715;5010
292290;201705;6304;19371;5578;18262;322;1306;4341;14166;4663;15472
292300;201705;8622;24956;7429;23406;1663;5412;4160;13527;5823;18939
292303;201705;2886;8579;2595;8159;83;306;2224;6950;2307;7256
292305;201705;2826;7560;2655;7310;54;227;2392;6501;2446;6728
292310;201705;6172;17639;5667;16925;257;819;4641;13853;4898;14672
292320;201705;6866;18493;5730;16544;370;1171;4339;12337;4709;13508
292330;201705;2286;5816;2097;5566;118;375;1743;4548;1861;4923
292335;201705;5180;13342;4645;12620;323;797;3775;10440;4098;11237
292340;201705;6637;17813;5639;16217;307;892;4248;12180;4555;13072
292350;201705;2283;6587;1955;6127;92;354;1604;5033;1696;5387
292360;201705;5281;13640;4821;12886;344;1007;3623;9768;3967;10775
292370;201705;8813;23575;7690;22104;397;1072;6439;18581;6836;19653
292380;201705;7259;20999;6610;19942;566;1632;4983;15175;5549;16807
292390;201705;3829;8160;3036;7300;128;242;2684;6550;2812;6792
292400;201705;20787;63503;19047;60588;2653;8646;12493;40055;15146;48701
292405;201705;4516;11113;3698;10029;222;565;2958;8072;3180;8637
292410;201705;2058;5349;1850;5099;102;285;1549;4284;1651;4569
292420;201705;3774;11840;3546;11491;212;924;2905;9307;3117;10231
292430;201705;5468;15887;4110;13945;360;1363;2658;9099;3018;10462
292440;201705;8559;27807;7951;26934;167;747;7262;24758;7429;25505
292450;201705;4001;11824;3253;10507;229;804;2375;7738;2604;8542
292460;201705;4576;13635;3985;12591;373;1272;2829;8947;3202;10219
292465;201705;2413;6956;2015;6329;152;511;1364;4369;1516;4880
292467;201705;1769;5558;1697;5446;231;743;1187;3915;1418;4658
292470;201705;2952;7640;2409;6765;103;302;1890;5304;1993;5606
292480;201705;6427;16170;5345;14791;124;432;4737;12975;4861;13407
292490;201705;2401;6387;1967;5762;136;429;1480;4357;1616;4786
292500;201705;6455;18773;5549;17157;665;2093;3642;11408;4307;13501
292510;201705;12697;36021;10791;33109;759;2849;7862;24152;8621;27001
292520;201705;6274;16774;5457;15546;986;2830;3261;9500;4247;12330
292525;201705;5367;13847;4588;12949;200;575;3911;11154;4111;11729
292530;201705;27385;77270;24117;72599;5615;17285;11542;35984;17157;53269
292540;201705;3151;7926;2776;7482;302;761;2178;5989;2480;6750
292550;201705;6794;20231;5758;18888;507;1903;4390;14638;4897;16541
292560;201705;4099;11252;3615;10505;175;718;2842;8118;3017;8836
292570;201705;4277;11614;3819;11068;80;238;3525;10334;3605;10572
292575;201705;6417;20521;6185;20193;316;1085;5252;17213;5568;18298
292580;201705;6929;19707;6348;18877;308;966;5372;16033;5680;16999
292590;201705;7632;21113;7049;20283;306;1050;6012;16952;6318;18002
292593;201705;2949;7564;2518;6875;246;648;1866;5065;2112;5713
292595;201705;5786;15680;5107;14798;268;911;4117;11848;4385;12759
292600;201705;10934;30520;9719;28896;693;1820;7512;22804;8205;24624
292610;201705;4764;12741;3892;11311;233;648;2547;7653;2780;8301
292620;201705;6301;18352;5534;17482;118;368;5127;16415;5245;16783
292630;201705;9025;22848;7485;20411;523;1488;5229;14343;5752;15831
292640;201705;7809;24679;7212;23702;338;1366;5438;17932;5776;19298
292650;201705;4503;12028;4177;11598;258;746;3579;9902;3837;10648
292660;201705;11027;32150;9980;30616;785;2628;7666;23619;8451;26247
292665;201705;2259;7066;2107;6874;28;120;1895;6243;1923;6363
292670;201705;3618;10059;2832;8633;184;667;1843;5557;2027;6224
292680;201705;3791;10747;3306;9877;264;816;2403;7082;2667;7898
292690;201705;2741;7411;1983;6178;155;470;1310;4211;1465;4681
292700;201705;9713;27670;8430;25851;977;2845;5563;17878;6540;20723
292710;201705;2233;7247;2082;7046;71;274;1847;6280;1918;6554
292720;201705;9474;23418;8182;21989;289;907;6943;18879;7232;19786
292730;201705;3739;10718;3583;10496;169;520;2997;8780;3166;9300
292740;201705;335326;881923;313074;847832;55353;158521;185351;496083;240704;654604
292750;201705;6553;17577;5621;16218;255;841;4385;12707;4640;13548
292760;201705;3927;11897;3554;11232;311;1068;2545;8007;2856;9075
292770;201705;6052;17275;5245;16071;897;2890;3132;9930;4029;12820
292780;201705;1847;4148;1438;3634;82;248;1087;2678;1169;2926
292790;201705;3571;8177;3315;7895;45;98;3207;7673;3252;7771
292800;201705;9574;26966;8761;25643;504;1578;6970;20324;7474;21902
292805;201705;3055;8348;2663;7790;238;693;1974;5837;2212;6530
292810;201705;9573;27445;7735;24773;664;2291;5423;17597;6087;19888
292820;201705;7631;21091;5661;18222;374;1523;4267;13574;4641;15097
292830;201705;2187;5711;1969;5426;58;259;1789;4828;1847;5087
292840;201705;8166;23982;7727;23384;251;1062;6818;20219;7069;21281
292850;201705;3078;8112;2470;7184;209;717;1600;4525;1809;5242
292860;201705;15473;38584;14150;36885;933;2439;11216;29288;12149;31727
292870;201705;18694;50354;16375;46752;1490;4963;10149;28398;11639;33361
292880;201705;12102;34209;10869;32495;636;2505;8061;23341;8697;25846
292890;201705;5462;17611;4908;16656;529;1942;3446;11710;3975;13652
292895;201705;2892;6783;2154;5663;148;384;1549;4089;1697;4473
292900;201705;2756;8239;2612;8004;137;631;2032;5951;2169;6582
292905;201705;4210;12001;3365;10671;296;930;2264;7319;2560;8249
292910;201705;4990;14466;4521;13632;496;1594;2855;8583;3351;10177
292920;201705;9752;27664;9300;27060;422;1597;7955;22683;8377;24280
292925;201705;5122;15179;4673;14506;272;889;3662;11357;3934;12246
292930;201705;6548;20480;6066;19575;432;1873;4182;13169;4614;15042
292935;201705;2013;5824;1673;5442;69;292;1423;4729;1492;5021
292937;201705;3090;7878;2685;7381;107;317;2256;6219;2363;6536
292940;201705;3112;8471;2579;7706;184;580;1886;5738;2070;6318
292950;201705;8570;24210;7897;23101;417;1532;5974;17123;6391;18655
292960;201705;5411;13313;4634;12303;216;689;3587;9391;3803;10080
292970;201705;4245;12314;3724;11619;146;621;3041;9472;3187;10093
292975;201705;3741;9370;3466;9037;267;599;2964;7805;3231;8404
292980;201705;3200;8352;2558;7366;161;516;1929;5469;2090;5985
292990;201705;11820;32966;10174;30463;417;1449;8154;24462;8571;25911
293000;201705;2852;7134;2593;6821;34;113;1964;5497;1998;5610
293010;201705;17705;48206;15015;43878;2036;6250;9129;26643;11165;32893
293015;201705;7448;24871;6350;22702;682;2805;4203;14959;4885;17764
293020;201705;8923;29110;8505;28516;262;1207;7486;24929;7748;26136
293030;201705;5592;15734;4436;13892;217;715;3023;9860;3240;10575
293040;201705;3732;11834;3542;11528;157;581;3071;9964;3228;10545
293050;201705;21035;56012;18597;52868;2751;8147;10815;31925;13566;40072
293060;201705;3597;9558;2975;8526;222;725;2148;6061;2370;6786
293070;201705;24455;64339;20073;58230;4350;12676;9492;29230;13842;41906
293075;201705;3238;10911;3003;10525;176;818;2368;8315;2544;9133
293076;201705;3696;9893;3273;9332;146;399;2630;7664;2776;8063
293077;201705;5195;15447;4499;14489;684;2274;2825;9374;3509;11648
293080;201705;4684;14350;4211;13606;158;715;3462;10992;3620;11707
293090;201705;3160;9925;2616;9051;213;788;1833;6462;2046;7250
293100;201705;5898;16782;4871;14952;415;1319;3568;11015;3983;12334
293105;201705;3925;12699;3432;11752;370;1317;2296;7911;2666;9228
293110;201705;2070;5620;1797;5238;73;228;1448;4222;1521;4450
293120;201705;3847;11989;3664;11704;204;636;3066;9868;3270;10504
293130;201705;3763;10941;3416;10523;110;425;2990;9226;3100;9651
293135;201705;31425;78267;23886;67519;5031;16134;9172;26227;14203;42361
293140;201705;2020;5391;1900;5228;98;340;1556;4144;1654;4484
293150;201705;5497;17579;4660;15957;586;2050;2985;10387;3571;12437
293160;201705;3825;9651;3416;9164;381;711;2674;7669;3055;8380
293170;201705;3431;9677;3139;9241;195;673;2310;6817;2505;7490
293180;201705;5078;14075;4149;12526;173;740;3257;9561;3430;10301
293190;201705;14006;40656;12594;38541;475;2155;10537;31703;11012;33858
293200;201705;7591;19984;6598;18708;228;849;5026;14343;5254;15192
293210;201705;5208;14492;4554;13417;268;881;3442;10089;3710;10970
293220;201705;4994;14439;4158;12906;1041;3225;1546;5026;2587;8251
293230;201705;3646;10849;3218;10152;434;1508;2129;6728;2563;8236
293240;201705;4309;11837;3489;10445;127;403;2607;7859;2734;8262
293245;201705;4304;11772;3831;11122;184;585;3153;9123;3337;9708
293250;201705;5637;14933;5037;14012;441;1265;3682;10177;4123;11442
293260;201705;4533;13091;3772;11930;205;735;2671;8360;2876;9095
293270;201705;5848;15004;5173;14254;387;978;4310;12143;4697;13121
293280;201705;5240;14258;4427;13161;214;647;3403;10199;3617;10846
293290;201705;14032;45749;12983;43812;3278;11242;5662;20103;8940;31345
293300;201705;6687;15730;5664;14477;385;907;4221;11001;4606;11908
293305;201705;4761;11736;4012;10748;123;407;3339;8911;3462;9318
293310;201705;2366;6159;1904;5363;173;495;1279;3574;1452;4069
293315;201705;4278;10590;3590;9561;224;542;2839;7584;3063;8126
293317;201705;2434;6733;2188;6299;172;471;1556;4521;1728;4992
293320;201705;7537;24056;7281;23737;1105;3545;5290;17658;6395;21203
293325;201705;1742;4903;1453;4434;233;762;913;2761;1146;3523
293330;201705;48254;155824;43704;147521;9853;34964;19847;68052;29700;103016
293340;201705;2542;7272;2044;6397;237;792;1220;3821;1457;4613
293345;201705;3245;9494;2859;8995;257;610;2146;7181;2403;7791
293350;201705;6475;19022;6122;18606;136;294;5637;17591;5773;17885
293360;201705;13590;39103;12269;37477;667;2267;10683;32660;11350;34927
310010;201705;786;2157;654;1959;83;315;306;860;389;1175
310020;201705;2536;7899;2125;7132;567;2120;269;863;836;2983
310030;201705;2161;6617;1810;6024;340;1306;1040;3366;1380;4672
310040;201705;984;2596;806;2342;66;248;614;1723;680;1971
310050;201705;1793;6030;1670;5773;331;1313;751;2471;1082;3784
310060;201705;3351;9921;2913;9348;204;826;2320;7410;2524;8236
310070;201705;360;957;269;790;10;40;174;475;184;515
310080;201705;734;2137;594;1893;95;372;224;677;319;1049
310090;201705;4732;13571;4038;12393;475;1604;2709;8283;3184;9887
310100;201705;3530;10377;2959;9473;147;564;2272;7249;2419;7813
310110;201705;4935;13652;4164;12317;668;2225;2176;6223;2844;8448
310120;201705;655;1907;487;1595;116;461;187;501;303;962
310130;201705;372;1118;326;1033;68;267;174;492;242;759
310140;201705;172;570;145;526;47;206;45;130;92;336
310150;201705;4638;13902;3917;12489;918;3175;1265;3919;2183;7094
310160;201705;6693;20977;5571;18811;1792;6514;833;2838;2625;9352
310163;201705;1078;3410;909;3074;309;1119;236;767;545;1886
310170;201705;9025;24722;7966;23213;876;2738;5642;16547;6518;19285
310180;201705;1751;4847;1470;4432;187;669;896;2604;1083;3273
310190;201705;2943;9472;2609;8892;702;2671;539;1839;1241;4510
310200;201705;1715;5544;1437;4938;289;1117;538;1798;827;2915
310205;201705;1135;3192;859;2774;123;381;473;1585;596;1966
310210;201705;2801;7702;2392;7111;148;514;1719;5014;1867;5528
310220;201705;1038;3042;891;2798;129;470;570;1717;699;2187
310230;201705;2475;7421;2077;6536;260;1007;1220;3618;1480;4625
310240;201705;895;3197;819;3045;102;463;499;1810;601;2273
310250;201705;868;2753;800;2628;147;592;461;1397;608;1989
310260;201705;3003;9389;2221;7807;524;2107;344;1013;868;3120
310270;201705;2645;7146;2126;6416;144;549;1666;4948;1810;5497
310280;201705;2316;5873;1838;5157;147;589;1170;3130;1317;3719
310285;201705;1973;6891;1824;6644;189;784;1247;4669;1436;5453
310290;201705;1129;3314;1045;3172;235;836;560;1541;795;2377
310300;201705;1644;5430;1560;5277;351;1386;777;2475;1128;3861
310310;201705;326;872;231;699;38;110;125;383;163;493
310320;201705;403;1214;317;1058;32;135;162;508;194;643
310330;201705;521;1287;337;938;46;145;119;284;165;429
310340;201705;8169;23742;6684;21168;1396;4400;3062;10161;4458;14561
310350;201705;13762;35589;9634;28804;2504;8212;2271;6683;4775;14895
310360;201705;444;1220;398;1156;22;82;309;868;331;950
310370;201705;1363;4514;1200;4195;253;917;548;1942;801;2859
310375;201705;1230;3324;823;2610;125;432;284;901;409;1333
310380;201705;372;948;222;685;56;177;61;168;117;345
310390;201705;450;1523;388;1397;95;351;87;269;182;620
310400;201705;9968;27055;7524;23006;1713;5789;2440;7314;4153;13103
310410;201705;684;2221;491;1890;118;502;97;359;215;861
310420;201705;4456;12431;3074;9621;621;2177;493;1318;1114;3495
310430;201705;1270;4002;915;3266;229;871;134;448;363;1319
310440;201705;534;1537;403;1275;70;257;178;557;248;814
310445;201705;1306;4033;1031;3533;70;283;711;2410;781;2693
310450;201705;4479;12211;3566;10848;311;1003;2553;7857;2864;8860
310460;201705;1689;4827;1299;4151;326;1152;349;1144;675;2296
310470;201705;4138;9166;3494;8394;254;700;2961;7066;3215;7766
310480;201705;1268;3590;936;2946;189;622;418;1256;607;1878
310490;201705;2973;9324;2515;8433;521;2034;1031;3321;1552;5355
310500;201705;1305;4272;1122;3905;271;1026;454;1547;725;2573
310510;201705;1883;5896;1483;5021;388;1430;267;900;655;2330
310520;201705;1422;3600;1065;3048;68;191;730;2073;798;2264
310530;201705;931;2732;494;1657;81;304;53;142;134;446
310540;201705;3078;9536;2659;8806;700;2452;1022;3263;1722;5715
310550;201705;1156;3181;930;2816;145;552;556;1581;701;2133
310560;201705;14423;42969;12102;38679;3062;10892;3838;11478;6900;22370
310570;201705;1180;3434;997;3122;129;524;676;2018;805;2542
310590;201705;4298;12316;3603;11074;527;1772;1890;5710;2417;7482
310600;201705;1460;4645;1233;4147;221;823;543;1722;764;2545
310610;201705;443;1390;368;1251;86;377;148;432;234;809
310620;201705;145234;432806;123496;391183;29580;105258;42451;121884;72031;227142
310630;201705;4393;12856;3903;12005;319;1104;2884;8779;3203;9883
310640;201705;1250;3825;1023;3429;286;1074;289;933;575;2007
310650;201705;2695;8183;2077;7095;267;965;1138;3878;1405;4843
310660;201705;1348;3929;1178;3712;98;327;884;2771;982;3098
310665;201705;1314;3782;1154;3553;67;235;919;2872;986;3107
310670;201705;40786;122352;36201;113013;8227;27421;15128;45891;23355;73312
310680;201705;668;1836;591;1726;63;206;420;1207;483;1413
310690;201705;1335;4199;1107;3810;194;814;509;1665;703;2479
310700;201705;553;1331;431;1177;63;202;263;689;326;891
310710;201705;6164;19506;4671;17165;1068;4587;509;1728;1577;6315
310720;201705;822;2374;743;2260;61;220;545;1649;606;1869
310730;201705;9226;27813;8192;26085;1160;4133;4830;15205;5990;19338
310740;201705;5129;15879;3918;13367;854;3100;874;2885;1728;5985
310750;201705;1476;3662;1085;3133;216;668;424;1130;640;1798
310760;201705;572;1692;465;1508;63;220;203;688;266;908
310770;201705;979;2976;725;2565;106;423;361;1223;467;1646
310780;201705;3897;10368;3199;9203;322;949;2142;6126;2464;7075
310790;201705;1933;6157;1767;5858;381;1274;814;2832;1195;4106
310800;201705;2609;8239;1996;7019;565;2318;138;454;703;2772
310810;201705;1119;3114;984;2870;139;469;560;1543;699;2012
310820;201705;1257;3582;886;2855;206;734;223;698;429;1432
310825;201705;2909;9961;2368;9034;120;694;1800;6793;1920;7487
310830;201705;1384;4403;1132;3932;286;1064;383;1312;669;2376
310840;201705;2178;6345;1575;5239;313;1096;396;1238;709;2334
310850;201705;1551;4459;1342;4196;112;445;993;3046;1105;3491
310855;201705;2928;8881;2526;8283;339;1236;1720;5601;2059;6837
310860;201705;7201;21776;6006;19517;619;2208;3666;12012;4285;14220
310870;201705;1085;2820;830;2407;192;574;436;1272;628;1846
310880;201705;1010;3105;830;2753;110;429;475;1553;585;1982
310890;201705;2534;7440;1937;6444;488;1844;379;1121;867;2965
310900;201705;4210;12965;3314;11159;681;2580;1288;4048;1969;6628
310910;201705;1903;5327;1219;4004;175;636;124;331;299;967
310920;201705;1873;5348;1473;4702;282;1000;719;2268;1001;3268
310925;201705;972;3041;856;2837;215;789;451;1441;666;2230
310930;201705;6052;16706;4797;14817;688;2247;2751;8759;3439;11006
310940;201705;6173;16754;5110;15150;611;1987;3233;9494;3844;11481
310945;201705;1226;3673;1116;3500;94;348;760;2330;854;2678
310950;201705;2121;6468;1535;5227;327;1299;532;1700;859;2999
310960;201705;456;1324;378;1179;72;266;174;530;246;796
310970;201705;1219;3910;919;3270;226;870;201;648;427;1518
310980;201705;395;951;247;695;33;105;138;372;171;477
310990;201705;1170;3671;952;3187;208;747;322;1032;530;1779
311000;201705;3525;11608;3210;11010;983;3690;1118;3648;2101;7338
311010;201705;744;2440;672;2258;231;838;246;815;477;1653
311020;201705;956;2745;745;2368;105;403;373;1127;478;1530
311030;201705;1697;4576;1179;3649;313;1111;349;978;662;2089
311040;201705;438;1445;362;1262;89;316;75;242;164;558
311050;201705;2353;6998;2005;6440;467;1656;778;2483;1245;4139
311060;201705;2611;7526;1915;6040;315;1154;657;1881;972;3035
311070;201705;1444;4679;1231;4289;241;981;540;1806;781;2787
311080;201705;817;2442;687;2199;140;501;273;809;413;1310
311090;201705;1879;6509;1558;5935;428;1857;526;1927;954;3784
311100;201705;1959;6494;1537;5576;480;1924;199;674;679;2598
311110;201705;3451;8134;2445;6687;459;1332;1124;3108;1583;4440
311115;201705;1239;3541;1046;3247;91;350;743;2270;834;2620
311120;201705;7437;20675;5694;17551;1147;3958;1732;4896;2879;8854
311130;201705;2033;6111;1680;5556;275;1134;718;2247;993;3381
311140;201705;1351;3464;1021;3008;80;273;651;1933;731;2206
311150;201705;1630;5644;1488;5380;236;914;896;3243;1132;4157
311160;201705;3871;12614;3100;11225;1081;4286;699;2520;1780;6806
311170;201705;795;2345;630;2044;60;224;335;1107;395;1331
311180;201705;1095;3145;854;2704;251;853;238;749;489;1602
311190;201705;1092;3098;848;2651;164;598;252;740;416;1338
311200;201705;1816;5435;1410;4602;407;1449;247;748;654;2197
311205;201705;975;3182;837;2908;95;426;425;1459;520;1885
311210;201705;1008;3125;912;3000;121;379;662;2251;783;2630
311220;201705;813;2532;672;2230;151;560;240;750;391;1310
311230;201705;8337;26165;6479;22277;1324;4839;2042;7310;3366;12149
311240;201705;982;2913;775;2592;175;638;328;1069;503;1707
311250;201705;776;2464;685;2308;191;706;251;784;442;1490
311260;201705;2156;5773;1679;4984;391;1269;572;1639;963;2908
311265;201705;1220;3369;962;2942;119;403;585;1775;704;2178
311270;201705;3346;10434;2959;9895;271;1254;2075;6658;2346;7912
311280;201705;1161;3254;707;2257;138;507;165;510;303;1017
311290;201705;2011;6509;1886;6219;265;858;1218;4068;1483;4926
311300;201705;4426;14055;3938;13188;308;1420;2960;9701;3268;11121
311310;201705;623;1981;537;1816;116;398;155;487;271;885
311320;201705;3460;11368;3143;10672;547;2151;1226;3851;1773;6002
311330;201705;4417;12992;3839;11987;763;2609;1868;5821;2631;8430
311340;201705;11559;35895;9925;32792;2982;10488;2568;8659;5550;19147
311350;201705;2287;6242;1750;5232;238;827;834;2284;1072;3111
311360;201705;904;2679;786;2520;394;1302;108;380;502;1682
311370;201705;3886;11260;3218;10072;489;1860;1512;4342;2001;6202
311380;201705;446;1441;364;1276;108;395;110;401;218;796
311390;201705;1787;6264;1590;5977;685;2935;431;1461;1116;4396
311400;201705;1468;4500;1153;3868;207;811;460;1390;667;2201
311410;201705;1707;5790;1562;5602;383;1576;775;2769;1158;4345
311420;201705;1866;5979;1287;4607;230;890;132;364;362;1254
311430;201705;3552;10486;2479;8183;499;1816;389;1236;888;3052
311440;201705;2407;7629;1795;6479;561;2318;331;1207;892;3525
311450;201705;1966;6583;1569;5786;424;1723;286;967;710;2690
311455;201705;1010;2695;779;2304;210;648;277;787;487;1435
311460;201705;600;1901;440;1597;87;386;107;361;194;747
311470;201705;463;1537;373;1342;98;402;58;186;156;588
311480;201705;819;2116;744;2003;126;344;475;1270;601;1614
311490;201705;206;750;184;687;54;226;61;200;115;426
311500;201705;440;1264;352;1110;59;221;177;553;236;774
311510;201705;2795;8357;2115;7125;587;2284;458;1524;1045;3808
311520;201705;596;1889;556;1808;168;602;233;711;401;1313
311530;201705;10553;26838;7652;22223;1897;6461;1903;5252;3800;11713
311535;201705;767;2199;507;1699;112;450;94;293;206;743
311540;201705;593;2010;551;1940;133;479;280;969;413;1448
311545;201705;2178;6374;1930;6076;154;598;1430;4413;1584;5011
311547;201705;1494;4095;1269;3746;67;226;930;2724;997;2950
311550;201705;2935;8920;2389;7856;370;1456;917;2910;1287;4366
311560;201705;259;671;218;617;31;101;127;328;158;429
311570;201705;1981;5033;1523;4406;60;179;1207;3617;1267;3796
311580;201705;2460;4791;1777;4009;291;586;1094;2651;1385;3237
311590;201705;487;1456;409;1334;88;343;194;619;282;962
311600;201705;1271;3701;1060;3423;168;544;693;2292;861;2836
311610;201705;2727;9407;2435;8855;695;2440;976;3730;1671;6170
311615;201705;3185;9693;2636;8820;240;948;1875;6220;2115;7168
311620;201705;415;1229;364;1146;48;178;244;760;292;938
311630;201705;1354;3899;1120;3478;103;359;776;2349;879;2708
311640;201705;775;2445;631;2203;120;458;288;1013;408;1471
311650;201705;2228;6170;1899;5666;201;704;1181;3470;1382;4174
311660;201705;2747;8620;2140;7371;428;1557;346;1057;774;2614
311670;201705;1621;4513;1325;4057;308;1052;498;1521;806;2573
311680;201705;2089;6465;1742;5832;331;1179;990;3297;1321;4476
311690;201705;535;1310;453;1205;28;75;358;967;386;1042
311700;201705;2313;5882;1802;5216;90;307;1399;3978;1489;4285
311710;201705;1620;4949;1183;4077;371;1405;324;1143;695;2548
311720;201705;394;1305;356;1239;55;219;166;555;221;774
311730;201705;5955;14555;3413;10275;1037;3577;531;1305;1568;4882
311740;201705;795;2418;761;2371;104;309;601;1908;705;2217
311750;201705;4093;12890;3489;11887;528;2069;1954;6453;2482;8522
311760;201705;679;2216;593;2015;130;513;146;396;276;909
311770;201705;2160;6742;1759;5973;403;1509;548;1773;951;3282
311780;201705;1266;4240;1016;3685;252;1059;227;713;479;1772
311783;201705;2049;6407;1712;5759;66;314;1309;4338;1375;4652
311787;201705;623;2078;470;1654;78;315;144;422;222;737
311790;201705;1527;4459;1164;3795;262;989;381;1208;643;2197
311800;201705;4977;16445;4339;14904;795;3042;516;1666;1311;4708
311810;201705;1033;3350;900;3090;71;300;549;1869;620;2169
311820;201705;614;1858;519;1636;104;385;295;848;399;1233
311830;201705;8108;26063;6350;21958;1802;6811;629;2088;2431;8899
311840;201705;2804;8360;2556;7977;495;1758;1527;4694;2022;6452
311850;201705;304;914;263;841;44;144;149;474;193;618
311860;201705;50430;144692;42994;131937;7264;24241;23389;70326;30653;94567
311870;201705;2118;6129;1547;5000;288;1063;505;1489;793;2552
311880;201705;6699;18666;5884;17592;616;1794;4259;13061;4875;14855
311890;201705;1418;4116;1168;3655;231;775;553;1701;784;2476
311900;201705;699;2075;601;1907;79;289;367;1156;446;1445
311910;201705;4093;11785;3412;10797;720;2437;1595;5057;2315;7494
311920;201705;1940;6105;1657;5609;195;766;995;3336;1190;4102
311930;201705;3422;9411;2834;8472;1127;3590;765;2176;1892;5766
311940;201705;12884;37798;10377;32790;2026;7061;3528;10577;5554;17638
311950;201705;2214;6431;1763;5688;136;546;1261;4023;1397;4569
311960;201705;383;1164;344;1085;60;240;165;443;225;683
311970;201705;408;1348;290;1065;52;224;61;205;113;429
311980;201705;545;1545;355;1182;61;223;114;384;175;607
311990;201705;472;1277;359;1112;113;391;139;420;252;811
311995;201705;1159;3501;691;2378;40;158;53;124;93;282
312000;201705;609;1781;544;1682;52;170;368;1158;420;1328
312010;201705;889;2864;730;2486;103;390;324;1053;427;1443
312015;201705;1340;4256;1218;4035;127;504;811;2622;938;3126
312020;201705;1097;3506;974;3289;193;718;452;1488;645;2206
312030;201705;1888;5167;1684;4921;51;221;1510;4359;1561;4580
312040;201705;761;2650;623;2313;129;550;171;602;300;1152
312050;201705;1177;4123;1017;3744;280;1150;194;637;474;1787
312060;201705;739;2260;663;2128;132;465;364;1140;496;1605
312070;201705;1009;3037;673;2311;122;470;277;928;399;1398
312080;201705;2715;7219;2137;6347;249;903;1247;3452;1496;4355
312083;201705;953;2608;800;2383;93;299;591;1745;684;2044
312087;201705;2157;6292;1943;5985;139;444;1511;4758;1650;5202
312090;201705;8898;26479;7302;23762;1884;6484;2810;9077;4694;15561
312100;201705;1479;4662;1160;4152;174;756;525;1805;699;2561
312110;201705;993;3437;863;3158;263;1076;171;554;434;1630
312120;201705;678;2143;561;1924;130;522;202;606;332;1128
312125;201705;1214;3765;1083;3541;238;727;639;2216;877;2943
312130;201705;866;2408;684;2053;82;280;264;747;346;1027
312140;201705;787;2490;671;2220;174;614;201;605;375;1219
312150;201705;452;1340;392;1198;22;93;251;712;273;805
312160;201705;7470;24287;6463;22170;1384;5265;2567;8424;3951;13689
312170;201705;877;2504;729;2261;55;208;477;1437;532;1645
312180;201705;1372;4132;1183;3755;180;665;550;1656;730;2321
312190;201705;596;1887;453;1591;140;542;69;236;209;778
312200;201705;4872;13682;4076;12417;712;2217;2426;7452;3138;9669
312210;201705;1125;2901;854;2510;139;483;520;1453;659;1936
312220;201705;2000;6545;1847;6364;114;296;1580;5678;1694;5974
312230;201705;11434;34513;8736;29283;2843;10485;1077;3423;3920;13908
312235;201705;1589;4641;1403;4378;147;541;1010;3109;1157;3650
312240;201705;885;2952;703;2560;169;682;176;627;345;1309
312245;201705;2319;6536;2062;6202;98;355;1682;5046;1780;5401
312247;201705;792;2284;611;1985;152;516;263;890;415;1406
312250;201705;1137;3079;831;2546;158;560;320;925;478;1485
312260;201705;942;2858;771;2571;97;372;491;1572;588;1944
312270;201705;652;1940;536;1701;43;185;279;814;322;999
312280;201705;412;1355;368;1258;134;480;40;129;174;609
312290;201705;773;2525;701;2405;151;584;232;789;383;1373
312300;201705;885;2861;696;2404;182;688;60;140;242;828
312310;201705;793;2885;745;2776;176;737;340;1236;516;1973
312320;201705;1956;5481;1529;4703;429;1432;328;936;757;2368
312330;201705;1020;2932;837;2674;123;457;598;1873;721;2330
312340;201705;305;819;239;712;39;133;120;337;159;470
312350;201705;281;689;247;652;23;85;201;503;224;588
312352;201705;1588;4899;1424;4661;215;737;959;3256;1174;3993
312360;201705;2959;9334;2439;8234;548;1995;671;2229;1219;4224
312370;201705;1754;5297;1537;4919;388;1390;645;1958;1033;3348
312380;201705;2057;5270;1838;4983;60;172;1574;4352;1634;4524
312385;201705;1321;3758;1128;3450;90;333;804;2385;894;2718
312390;201705;2090;6548;1650;5694;407;1491;364;1184;771;2675
312400;201705;3039;9561;2514;8525;951;3335;577;2037;1528;5372
312410;201705;10188;32372;9059;30271;1840;6631;4162;13711;6002;20342
312420;201705;3861;11650;3618;11271;564;1845;2293;7220;2857;9065
312430;201705;8137;23150;6901;20985;895;2927;4308;13085;5203;16012
312440;201705;822;2571;684;2329;257;965;203;704;460;1669
312450;201705;1206;3895;938;3354;280;1063;321;1193;601;2256
312460;201705;342;1009;295;946;55;202;168;536;223;738
312470;201705;607;1627;401;1246;79;292;121;344;200;636
312480;201705;1171;2981;864;2633;149;536;495;1430;644;1966
312490;201705;1937;4994;1506;4326;253;775;802;2229;1055;3004
312500;201705;724;2057;621;1894;95;337;300;889;395;1226
312510;201705;3759;10809;3045;9353;404;1423;1581;4607;1985;6030
312520;201705;237;731;191;657;65;238;72;247;137;485
312530;201705;588;1710;518;1614;45;176;378;1166;423;1342
312540;201705;1380;4300;1048;3618;210;790;459;1564;669;2354
312550;201705;740;2163;618;1896;100;334;312;894;412;1228
312560;201705;2106;5401;1735;4926;95;348;1402;3934;1497;4282
312570;201705;2281;6550;1894;5927;524;1716;714;2267;1238;3983
312580;201705;534;1702;442;1492;59;227;168;564;227;791
312590;201705;1634;5237;1407;4757;195;818;674;2130;869;2948
312595;201705;1839;6076;1698;5758;317;1101;951;3270;1268;4371
312600;201705;816;2498;604;2118;110;486;287;953;397;1439
312610;201705;6557;18073;4771;14836;1101;3724;958;2808;2059;6532
312620;201705;2224;6317;1722;5604;98;370;1298;4330;1396;4700
312630;201705;313;996;267;909;61;240;99;333;160;573
312640;201705;532;1677;432;1466;79;269;129;412;208;681
312650;201705;2138;5982;1559;4847;153;547;923;2759;1076;3306
312660;201705;1432;3661;1128;3223;110;366;755;2129;865;2495
312670;201705;5414;15588;4578;14447;934;3414;2206;6744;3140;10158
312675;201705;1270;3912;1073;3505;105;425;756;2429;861;2854
312680;201705;1436;4245;1240;3973;147;595;826;2581;973;3176
312690;201705;2179;5670;1774;5105;213;665;1202;3372;1415;4037
312695;201705;855;2851;803;2768;141;468;529;1882;670;2350
312700;201705;1840;5483;1446;4692;177;607;791;2531;968;3138
312705;201705;1289;3588;1061;3186;57;203;761;2228;818;2431
312707;201705;1481;4677;1168;4057;128;557;637;2096;765;2653
312710;201705;6545;16165;4246;12577;1294;4288;797;2370;2091;6658
312720;201705;773;2562;666;2332;102;418;314;1041;416;1459
312730;201705;1880;4503;1340;3840;118;402;867;2468;985;2870
312733;201705;1567;4199;1197;3528;56;164;745;2167;801;2331
312735;201705;797;2154;698;2005;121;442;435;1137;556;1579
312737;201705;816;2037;591;1707;145;433;247;703;392;1136
312738;201705;507;1538;363;1250;90;356;125;397;215;753
312740;201705;321;798;201;658;71;239;43;127;114;366
312750;201705;1234;4243;1139;4092;196;830;584;2019;780;2849
312760;201705;1913;6008;1468;5095;319;1173;409;1400;728;2573
312770;201705;41583;111041;30516;92245;7569;24643;8563;25225;16132;49868
312780;201705;2698;8975;2393;8457;372;1473;1366;4841;1738;6314
312790;201705;331;839;206;641;27;97;81;227;108;324
312800;201705;4958;15765;3972;13711;1192;4453;881;3076;2073;7529
312810;201705;2018;6085;1409;4849;359;1348;288;908;647;2256
312820;201705;1923;5382;1634;4889;86;316;1127;3265;1213;3581
312825;201705;1315;3448;1155;3241;70;217;914;2564;984;2781
312830;201705;2577;7789;1795;6250;462;1748;317;1077;779;2825
312840;201705;1224;3843;978;3363;157;626;325;1010;482;1636
312850;201705;740;2191;588;1906;111;405;214;679;325;1084
312860;201705;1418;3794;955;3014;230;797;279;835;509;1632
312870;201705;5680;17095;3962;13423;656;2407;949;3033;1605;5440
312880;201705;1336;3819;1190;3605;87;286;766;2405;853;2691
312890;201705;1874;5513;1193;4018;219;785;430;1459;649;2244
312900;201705;1206;3470;1032;3220;101;335;704;2246;805;2581
312910;201705;1664;3239;976;2349;151;414;475;1067;626;1481
312920;201705;895;2759;717;2433;153;617;316;1005;469;1622
312930;201705;2130;5958;1797;5450;410;1287;816;2461;1226;3748
312940;201705;883;2799;767;2588;169;604;289;991;458;1595
312950;201705;2946;8165;2238;7095;791;2716;495;1601;1286;4317
312960;201705;1934;5419;1683;5073;114;329;1312;4035;1426;4364
312965;201705;1801;5569;1537;5071;135;500;960;3143;1095;3643
312970;201705;979;3169;779;2824;193;786;233;824;426;1610
312980;201705;18208;58688;16828;55899;4138;15019;7132;22660;11270;37679
312990;201705;477;1383;329;1121;94;379;109;360;203;739
313000;201705;479;1552;394;1386;87;412;143;434;230;846
313005;201705;2618;8061;2324;7541;299;994;1531;4970;1830;5964
313010;201705;3807;11910;3253;10940;797;2930;1575;5139;2372;8069
313020;201705;941;3115;686;2484;134;546;84;257;218;803
313030;201705;1449;3768;1063;3206;167;591;516;1518;683;2109
313040;201705;789;2560;685;2316;82;335;343;1095;425;1430
313050;201705;1803;5504;1321;4737;325;1325;330;1075;655;2400
313055;201705;1620;4942;1490;4754;59;215;1268;4048;1327;4263
313060;201705;821;2533;642;2132;186;643;95;308;281;951
313065;201705;1906;6068;1637;5637;196;803;1161;3993;1357;4796
313070;201705;977;2802;804;2504;151;525;350;1062;501;1587
313080;201705;437;1298;328;1071;79;314;98;262;177;576
313090;201705;5207;14791;4485;13627;1203;3973;2085;6312;3288;10285
313100;201705;1148;3392;1044;3232;82;259;828;2583;910;2842
313110;201705;1673;4703;1234;3832;171;597;530;1537;701;2134
313115;201705;2348;7633;2187;7291;437;1604;1021;3189;1458;4793
313120;201705;3487;9017;2986;8378;450;1390;1924;5447;2374;6837
313130;201705;25651;75656;21866;68198;4103;14270;9565;28250;13668;42520
313140;201705;511;1319;393;1132;23;78;286;803;309;881
313150;201705;1310;4083;1083;3660;409;1477;248;838;657;2315
313160;201705;962;2823;822;2556;147;533;447;1322;594;1855
313170;201705;10278;34046;7820;28196;1620;6155;2325;8246;3945;14401
313180;201705;2288;6152;1792;5438;345;1153;809;2371;1154;3524
313190;201705;3951;12857;3111;10879;645;2480;851;2801;1496;5281
313200;201705;1143;3579;1004;3317;81;332;741;2378;822;2710
313210;201705;3998;12136;3368;11147;624;2285;1738;5531;2362;7816
313220;201705;1641;4747;1167;3799;249;913;310;873;559;1786
313230;201705;2306;7815;2164;7622;205;838;1658;5766;1863;6604
313240;201705;8419;24835;6453;21176;1228;4549;2590;8087;3818;12636
313250;201705;6381;19970;5435;18265;546;2073;3025;10098;3571;12171
313260;201705;662;1904;451;1452;81;313;135;421;216;734
313270;201705;5362;15756;4468;14189;810;2768;2424;7670;3234;10438
313280;201705;365;1180;267;974;58;228;66;235;124;463
313290;201705;773;2736;646;2513;235;1023;93;326;328;1349
313300;201705;1777;5701;1463;4998;418;1569;203;602;621;2171
313310;201705;970;3267;865;3055;177;722;172;508;349;1230
313320;201705;2321;6485;1679;5464;339;1218;697;2260;1036;3478
313330;201705;4018;11983;3353;10851;309;1337;2110;6549;2419;7886
313340;201705;1661;4076;1293;3529;216;602;742;2041;958;2643
313350;201705;2486;7692;1983;6580;407;1476;512;1597;919;3073
313360;201705;1322;3680;982;3113;195;771;521;1525;716;2296
313370;201705;1183;3937;1108;3745;163;639;585;1889;748;2528
313375;201705;2122;5629;1510;4706;275;1040;479;1400;754;2440
313380;201705;4785;14411;4059;12971;1041;3645;1418;4202;2459;7847
313390;201705;895;3018;834;2914;84;357;553;1891;637;2248
313400;201705;3629;9728;3141;9150;285;805;2564;7590;2849;8395
313410;201705;1199;3335;1001;3028;157;536;671;1987;828;2523
313420;201705;16950;40561;10440;29667;2165;6955;1616;4602;3781;11557
313430;201705;978;3051;735;2548;141;579;256;794;397;1373
313440;201705;6381;14320;4392;11925;295;825;2794;7700;3089;8525
313450;201705;593;1759;468;1500;96;316;151;457;247;773
313460;201705;2083;6923;1808;6446;479;1951;713;2342;1192;4293
313470;201705;3071;8250;2705;7711;347;1001;1855;5282;2202;6283
313480;201705;806;2357;632;2042;98;366;217;641;315;1007
313490;201705;1559;4305;880;3240;291;1221;64;219;355;1440
313500;201705;416;1365;333;1148;56;214;111;361;167;575
313505;201705;9103;25979;8427;25221;243;603;7822;23730;8065;24333
313507;201705;1367;3694;1173;3409;93;318;811;2365;904;2683
313510;201705;14498;41808;12723;38815;1630;5414;6895;20717;8525;26131
313520;201705;14133;42776;11777;38620;1224;4634;7595;24666;8819;29300
313530;201705;564;1689;469;1521;47;192;170;502;217;694
313535;201705;2539;7288;2273;6818;189;601;1584;4715;1773;5316
313540;201705;959;2985;712;2340;188;657;192;607;380;1264
313545;201705;1245;4439;1109;4181;178;749;628;2257;806;3006
313550;201705;1824;5730;1598;5298;364;1273;793;2570;1157;3843
313560;201705;2225;5000;1803;4529;142;333;1418;3611;1560;3944
313570;201705;871;2963;753;2733;201;807;301;1061;502;1868
313580;201705;5643;15919;4430;14107;751;2598;2316;7545;3067;10143
313590;201705;936;2717;741;2434;304;1082;157;504;461;1586
313600;201705;3743;11034;3279;10283;294;1056;2422;7588;2716;8644
313610;201705;960;2737;816;2468;159;489;486;1474;645;1963
313620;201705;5307;15917;4608;14666;1135;3843;1829;5807;2964;9650
313630;201705;8146;22056;6077;19144;896;3105;3087;10227;3983;13332
313640;201705;903;2378;636;1986;180;628;227;670;407;1298
313650;201705;1801;5880;1607;5543;183;760;1046;3557;1229;4317
313652;201705;908;3085;832;2949;122;520;499;1678;621;2198
313655;201705;920;2874;775;2649;105;410;451;1536;556;1946
313657;201705;1339;3848;1073;3443;87;379;773;2325;860;2704
313660;201705;802;2564;686;2331;129;539;335;1066;464;1605
313665;201705;3879;12210;3320;11048;598;2201;1696;5495;2294;7696
313670;201705;44879;128192;32845;105016;7234;25441;10582;32686;17816;58127
313680;201705;1046;3024;925;2826;111;409;581;1741;692;2150
313690;201705;894;3123;753;2818;156;600;258;982;414;1582
313695;201705;1419;4460;1211;4075;113;457;823;2773;936;3230
313700;201705;3495;11710;3033;11132;375;1406;2274;8528;2649;9934
313710;201705;1327;3512;1006;3000;134;435;571;1700;705;2135
313720;201705;5534;16952;4309;14406;808;3021;1509;4649;2317;7670
313730;201705;1302;3331;978;2900;92;310;582;1709;674;2019
313740;201705;1832;6630;1556;5923;445;1849;105;382;550;2231
313750;201705;2100;6192;1688;5378;440;1538;494;1425;934;2963
313753;201705;1931;5231;1493;4478;218;752;773;2267;991;3019
313760;201705;4265;13370;3499;11841;948;3501;1093;3485;2041;6986
313770;201705;3402;10480;2905;9786;437;1565;1763;5976;2200;7541
313780;201705;4064;11093;3105;9572;473;1666;988;3055;1461;4721
313790;201705;454;1525;431;1486;65;237;266;909;331;1146
313800;201705;1197;3137;1033;2888;79;261;760;2159;839;2420
313810;201705;1578;4373;1358;4063;127;407;967;2920;1094;3327
313820;201705;12576;33207;9962;28847;1681;5634;4161;11248;5842;16882
313830;201705;371;1192;328;1116;76;287;144;487;220;774
313835;201705;874;2853;791;2709;98;412;450;1468;548;1880
313840;201705;7278;20570;5700;17911;1397;4835;1256;3906;2653;8741
313850;201705;1081;2910;947;2672;156;548;508;1300;664;1848
313860;201705;2799;8260;2104;6760;421;1423;621;1876;1042;3299
313862;201705;1265;3211;906;2617;108;302;490;1485;598;1787
313865;201705;2298;6834;2054;6466;128;479;1568;4883;1696;5362
313867;201705;1112;3762;972;3469;309;1126;331;1203;640;2329
313868;201705;1714;5719;1468;5224;113;496;1050;3683;1163;4179
313870;201705;799;2444;685;2228;163;597;212;604;375;1201
313880;201705;1296;3967;1090;3600;257;937;380;1103;637;2040
313890;201705;1967;4992;1519;4407;220;666;867;2663;1087;3329
313900;201705;3842;13459;3421;12529;1057;4251;876;3199;1933;7450
313910;201705;686;2263;565;2025;180;697;81;297;261;994
313920;201705;3240;10616;2792;9796;556;1985;1481;5396;2037;7381
313925;201705;1798;4835;1395;4071;217;606;809;2389;1026;2995
313930;201705;6335;22301;5341;20570;650;2378;3391;13978;4041;16356
313940;201705;8710;27743;6856;24654;1778;7165;1870;7251;3648;14416
313950;201705;4083;11090;3100;9523;883;3145;1190;3426;2073;6571
313960;201705;5530;14090;3913;11653;951;3130;1163;3332;2114;6462
313970;201705;1416;4144;1260;3925;123;444;737;2384;860;2828
313980;201705;1242;3815;942;3271;200;796;356;1188;556;1984
313990;201705;1632;6067;1425;5532;484;2018;339;1238;823;3256
314000;201705;8498;25836;7588;24031;970;3725;4621;14134;5591;17859
314010;201705;1206;3218;995;2934;73;268;712;2054;785;2322
314015;201705;1651;5180;1365;4691;249;985;694;2321;943;3306
314020;201705;510;1503;334;1116;60;237;71;228;131;465
314030;201705;808;2582;636;2178;100;361;269;912;369;1273
314040;201705;738;2103;618;1875;140;455;245;724;385;1179
314050;201705;1623;4915;1278;4223;240;932;542;1648;782;2580
314053;201705;1603;4995;1412;4730;174;574;977;3478;1151;4052
314055;201705;2211;6435;1933;6024;74;300;1588;4958;1662;5258
314060;201705;1178;3543;939;3128;82;326;597;1959;679;2285
314070;201705;4213;12901;3401;11336;872;3095;1002;3204;1874;6299
314080;201705;1768;5472;1284;4374;203;767;313;932;516;1699
314085;201705;1983;6493;1720;6102;454;1751;666;2376;1120;4127
314090;201705;3333;11027;2916;10237;433;1770;1536;5485;1969;7255
314100;201705;3336;8183;2929;7632;143;295;2469;6700;2612;6995
314110;201705;3948;12352;3459;11352;656;2394;1523;4654;2179;7048
314120;201705;1026;2434;487;1547;95;333;115;370;210;703
314130;201705;698;2002;365;1255;62;239;69;228;131;467
314140;201705;4843;14757;3919;12891;727;2575;1761;5744;2488;8319
314150;201705;1514;4166;1208;3644;154;515;681;2019;835;2534
314160;201705;2545;6619;1936;5669;262;845;982;2962;1244;3807
314170;201705;1064;3104;879;2730;121;409;486;1434;607;1843
314180;201705;5046;15573;4444;14630;1164;4018;1956;6574;3120;10592
314190;201705;684;1878;502;1580;110;418;183;518;293;936
314200;201705;2912;8816;2569;8205;241;967;1802;5549;2043;6516
314210;201705;2031;5719;1796;5333;163;574;1122;3258;1285;3832
314220;201705;1460;4460;1086;3726;346;1304;224;684;570;1988
314225;201705;1324;3770;1187;3589;77;273;877;2672;954;2945
314230;201705;681;2131;627;2039;91;354;359;1150;450;1504
314240;201705;1108;3311;910;2991;196;689;422;1445;618;2134
314250;201705;531;1575;401;1292;89;308;117;333;206;641
314260;201705;1017;3542;876;3214;185;802;270;899;455;1701
314270;201705;2913;9082;2403;8175;212;835;1665;5615;1877;6450
314280;201705;3093;8253;2108;6418;447;1572;780;2183;1227;3755
314290;201705;4705;12808;4030;11714;669;1993;2376;6874;3045;8867
314300;201705;1502;4892;1249;4300;348;1258;349;1165;697;2423
314310;201705;5593;15799;4545;14014;1259;4172;1456;4277;2715;8449
314315;201705;804;3100;732;2958;82;385;519;2084;601;2469
314320;201705;2994;8415;2126;7091;532;1891;902;3104;1434;4995
314330;201705;53452;158102;44590;143395;13270;45770;11791;37626;25061;83396
314340;201705;2835;7574;1607;5238;312;1155;140;341;452;1496
314345;201705;1238;4093;1114;3872;180;671;710;2421;890;3092
314350;201705;1155;3316;871;2821;240;832;176;536;416;1368
314360;201705;677;2141;438;1572;88;366;99;352;187;718
314370;201705;566;1751;518;1681;93;354;363;1127;456;1481
314380;201705;1276;3802;891;3008;249;908;124;429;373;1337
314390;201705;12686;35730;9222;29381;2223;7662;2133;6291;4356;13953
314400;201705;4421;12884;3684;11809;1127;3802;1294;4305;2421;8107
314410;201705;2727;8126;2060;6840;439;1623;662;2331;1101;3954
314420;201705;754;2038;579;1777;27;143;426;1259;453;1402
314430;201705;6180;18036;5243;16326;1273;4274;1789;5590;3062;9864
314435;201705;1397;4295;1234;4040;88;405;862;2765;950;3170
314437;201705;1008;2672;827;2394;26;87;611;1796;637;1883
314440;201705;552;1668;458;1522;149;560;137;403;286;963
314450;201705;1511;4390;1277;4012;203;806;675;1938;878;2744
314460;201705;3747;12389;2974;10685;712;2798;510;1749;1222;4547
314465;201705;2269;6950;2088;6625;83;409;1652;5094;1735;5503
314467;201705;970;2715;828;2481;46;134;608;1854;654;1988
314470;201705;2121;6581;1835;6002;426;1566;686;2095;1112;3661
314480;201705;5721;18725;4179;14815;734;2846;615;1964;1349;4810
314490;201705;834;2474;647;2088;99;365;352;1066;451;1431
314500;201705;1830;5130;1348;4259;263;903;431;1339;694;2242
314505;201705;1893;5195;1698;4947;167;535;1183;3488;1350;4023
314510;201705;1936;5139;1299;4256;317;1130;403;1348;720;2478
314520;201705;2855;9968;2099;8125;423;1884;212;758;635;2642
314530;201705;5741;19710;5393;19069;846;2979;3388;12271;4234;15250
314535;201705;2755;7483;2296;6835;205;686;1649;4899;1854;5585
314537;201705;1121;3419;914;3053;111;442;573;1869;684;2311
314540;201705;356;1056;282;905;55;195;104;311;159;506
314545;201705;1546;4390;1374;4154;91;286;1063;3375;1154;3661
314550;201705;644;1692;470;1438;66;259;204;558;270;817
314560;201705;4269;14328;3566;12703;653;2641;1157;3822;1810;6463
314570;201705;310;912;241;776;34;130;122;378;156;508
314580;201705;499;1648;390;1407;95;382;39;142;134;524
314585;201705;855;2721;623;2213;144;599;193;645;337;1244
314587;201705;1977;5885;1659;5341;315;991;854;2816;1169;3807
314590;201705;2971;9899;2265;8135;462;1843;540;1874;1002;3717
314600;201705;1573;5029;1107;4028;260;1063;134;400;394;1463
314610;201705;6974;23034;6168;21191;1338;5246;2617;8422;3955;13668
314620;201705;1617;4683;1434;4426;96;327;1124;3432;1220;3759
314625;201705;1564;4975;1414;4731;158;734;1005;3176;1163;3910
314630;201705;4794;13957;4170;12959;256;1057;3137;9643;3393;10700
314640;201705;591;1584;447;1332;110;359;141;370;251;729
314650;201705;1049;2861;759;2391;96;370;297;823;393;1193
314655;201705;1541;4525;1163;3802;262;850;463;1536;725;2386
314660;201705;304;800;208;611;16;44;102;290;118;334
314670;201705;1644;4311;1166;3475;139;456;686;1983;825;2439
314675;201705;1839;5320;1591;4889;131;493;1167;3527;1298;4020
314690;201705;2094;6707;1720;5992;523;2003;315;1057;838;3060
314700;201705;9273;30074;6540;24035;1729;7025;991;3620;2720;10645
314710;201705;8332;24715;5928;19593;1128;4188;904;2732;2032;6920
314720;201705;2339;7600;1861;6546;429;1662;465;1634;894;3296
314730;201705;2118;6292;1696;5578;445;1605;572;1745;1017;3350
314740;201705;2788;8638;2363;7812;319;1278;1225;3860;1544;5138
314750;201705;332;1007;266;865;32;125;139;426;171;551
314760;201705;1725;5572;1278;4511;185;741;281;819;466;1560
314770;201705;1031;3184;615;2095;56;218;127;363;183;581
314780;201705;316;822;233;701;46;170;114;320;160;490
314790;201705;9665;29195;7526;25188;2969;11031;587;1656;3556;12687
314795;201705;1590;4545;1384;4214;89;361;1025;2990;1114;3351
314800;201705;11411;32069;7549;24293;1870;6529;822;2473;2692;9002
314810;201705;10468;29937;7996;25638;2389;8217;1713;5571;4102;13788
314820;201705;898;2486;666;2081;150;525;277;832;427;1357
314830;201705;1558;5076;1379;4761;320;1254;682;2354;1002;3608
314840;201705;907;3153;746;2911;125;621;453;1674;578;2295
314850;201705;1946;5416;1543;4708;158;616;1104;3266;1262;3882
314860;201705;3279;10595;2866;9815;424;1708;1708;5718;2132;7426
314870;201705;5566;16678;4781;15597;432;1734;3515;11378;3947;13112
314875;201705;1749;5559;1649;5422;130;407;1383;4605;1513;5012
314880;201705;905;2330;737;2113;55;132;519;1579;574;1711
314890;201705;541;1666;402;1337;76;285;154;468;230;753
314900;201705;623;1704;506;1533;96;317;213;654;309;971
314910;201705;1643;5242;1334;4732;355;1447;527;1801;882;3248
314915;201705;2460;7648;2128;7059;161;676;1469;4710;1630;5386
314920;201705;530;1449;381;1228;31;111;202;625;233;736
314930;201705;4685;15454;4062;14119;1049;3921;1198;3957;2247;7878
314940;201705;403;1156;365;1091;48;150;222;632;270;782
314950;201705;360;1037;256;876;47;175;83;285;130;460
314960;201705;752;2244;593;1913;114;419;246;728;360;1147
314970;201705;582;1960;496;1791;112;454;155;554;267;1008
314980;201705;1388;4180;1138;3773;341;1260;75;225;416;1485
314990;201705;2507;7778;1896;6426;493;1917;382;1126;875;3043
314995;201705;1616;4883;1401;4542;142;586;895;2819;1037;3405
315000;201705;1086;3043;870;2693;84;311;553;1683;637;1994
315010;201705;421;1288;331;1105;67;279;117;346;184;625
315015;201705;2149;6448;1948;6199;234;776;1359;4546;1593;5322
315020;201705;830;2537;619;2094;85;315;276;901;361;1216
315030;201705;608;1825;468;1557;131;473;100;304;231;777
315040;201705;900;2693;835;2570;149;488;506;1535;655;2023
315050;201705;1280;3639;1008;3222;140;517;511;1615;651;2132
315053;201705;1103;3218;942;2902;143;548;478;1466;621;2014
315057;201705;1642;5533;1480;5226;258;915;799;2849;1057;3764
315060;201705;702;2250;488;1786;107;425;72;260;179;685
315070;201705;737;2159;585;1885;168;575;222;663;390;1238
315080;201705;2842;9165;2420;8257;596;2173;1058;3570;1654;5743
315090;201705;778;2654;629;2317;145;588;164;561;309;1149
315100;201705;1185;3915;836;3069;190;785;226;766;416;1551
315110;201705;1316;3824;1070;3396;213;747;436;1376;649;2123
315120;201705;13809;32193;9579;26694;1294;3730;4631;13802;5925;17532
315130;201705;1295;4174;1168;3925;278;1083;403;1263;681;2346
315140;201705;2820;8681;2318;7659;472;1787;941;2849;1413;4636
315150;201705;4488;11890;3294;9933;523;1742;1365;4107;1888;5849
315160;201705;1342;3849;1036;3304;229;771;412;1289;641;2060
315170;201705;1509;4683;1176;3986;266;970;242;793;508;1763
315180;201705;17275;47648;9756;31862;1679;6181;1677;4992;3356;11173
315190;201705;1991;5096;1659;4589;337;952;1058;2915;1395;3867
315200;201705;3662;12119;3047;10816;971;3763;582;2031;1553;5794
315210;201705;7942;22811;6285;19342;1029;3533;2407;6934;3436;10467
315213;201705;1133;3362;1026;3200;48;163;827;2565;875;2728
315217;201705;2447;8176;1987;7322;192;904;1255;4508;1447;5412
315220;201705;9513;27077;7961;24405;2460;7782;2444;7715;4904;15497
315230;201705;2942;7654;2612;7271;119;188;2315;6795;2434;6983
315240;201705;2996;9026;2535;8311;674;2359;1186;3821;1860;6180
315250;201705;10452;31107;8197;26848;1788;6451;2798;9092;4586;15543
315260;201705;950;2929;623;2187;139;522;80;245;219;767
315270;201705;669;2136;510;1823;101;431;127;413;228;844
315280;201705;2932;8191;1811;5797;396;1350;271;829;667;2179
315290;201705;1238;3384;837;2721;263;938;193;650;456;1588
315300;201705;542;1428;378;1222;147;491;145;477;292;968
315310;201705;1260;3921;1011;3449;121;462;604;1993;725;2455
315320;201705;745;2216;592;1988;89;387;268;859;357;1246
315330;201705;734;2631;457;1877;104;455;82;321;186;776
315340;201705;3489;9664;2744;8526;477;1609;1207;3674;1684;5283
315350;201705;1847;5008;1408;4367;122;422;926;2943;1048;3365
315360;201705;1639;5391;1321;4682;259;1014;421;1397;680;2411
315370;201705;465;1435;405;1316;80;267;177;567;257;834
315380;201705;181;601;137;493;29;125;33;102;62;227
315390;201705;1223;3961;935;3318;213;841;213;710;426;1551
315400;201705;4303;12690;3476;11123;566;1950;1721;5431;2287;7381
315410;201705;2177;5424;1783;4905;328;987;974;2664;1302;3651
315415;201705;1062;3335;913;3115;349;1273;277;972;626;2245
315420;201705;1165;3695;885;3113;211;768;127;415;338;1183
315430;201705;3598;9613;2715;8170;776;2621;690;1963;1466;4584
315440;201705;982;2893;850;2673;157;600;391;1099;548;1699
315445;201705;2049;5539;1584;4817;225;741;995;3038;1220;3779
315450;201705;2422;7366;2143;6924;317;1017;1330;4395;1647;5412
315460;201705;31274;100635;28077;94146;9993;35585;5795;18848;15788;54433
315470;201705;469;1392;389;1243;34;132;207;637;241;769
315480;201705;1665;5024;1155;3885;261;945;225;781;486;1726
315490;201705;3129;8159;2295;7009;410;1423;761;2199;1171;3622
315500;201705;480;1388;310;1001;34;133;129;351;163;484
315510;201705;1383;3882;1184;3562;80;289;925;2741;1005;3030
315520;201705;1069;3107;858;2777;92;355;555;1749;647;2104
315530;201705;642;2110;507;1760;171;657;155;479;326;1136
315540;201705;1049;3252;867;2908;160;644;301;996;461;1640
315550;201705;1807;5046;1383;4384;300;1086;466;1449;766;2535
315560;201705;6448;20996;5803;20072;581;2320;3888;13491;4469;15811
315570;201705;1852;5889;1694;5567;220;837;889;2827;1109;3664
315580;201705;2281;6385;1823;5614;460;1600;545;1603;1005;3203
315590;201705;840;2437;735;2270;110;371;379;1151;489;1522
315600;201705;2402;8390;1921;7403;286;1165;1062;4224;1348;5389
315610;201705;977;2710;788;2343;134;517;330;833;464;1350
315620;201705;305;1077;288;1043;65;222;168;656;233;878
315630;201705;852;2638;681;2291;165;553;142;471;307;1024
315640;201705;448;1302;380;1188;60;240;167;480;227;720
315645;201705;793;2331;636;2018;214;716;180;541;394;1257
315650;201705;1836;4945;1446;4380;89;352;1043;3105;1132;3457
315660;201705;2554;6481;2050;5667;161;421;1396;3830;1557;4251
315670;201705;10986;34985;9731;32524;2407;8708;3969;12912;6376;21620
315680;201705;2981;9721;2314;8384;662;2553;722;2607;1384;5160
315690;201705;3246;9011;2216;7164;540;1905;445;1554;985;3459
315700;201705;7348;22209;6120;19763;1065;3738;2833;8851;3898;12589
315710;201705;1845;5068;1402;4380;101;426;845;2517;946;2943
315720;201705;3842;11936;3425;11178;263;1140;2154;6758;2417;7898
315725;201705;1531;4681;1364;4441;206;689;997;3303;1203;3992
315727;201705;611;1785;470;1519;96;355;185;542;281;897
315730;201705;737;2301;681;2173;96;362;349;1054;445;1416
315733;201705;1069;3094;940;2864;247;849;350;1018;597;1867
315737;201705;1212;3627;960;3170;60;253;630;2064;690;2317
315740;201705;995;2988;829;2655;133;524;415;1201;548;1725
315750;201705;1181;3493;1054;3270;68;256;777;2410;845;2666
315760;201705;1104;2836;1057;2775;26;74;975;2550;1001;2624
315765;201705;1673;4875;1461;4603;70;242;1248;3986;1318;4228
315770;201705;1384;4380;1196;4062;329;1216;334;1141;663;2357
315780;201705;22333;71097;20111;66406;3996;14494;8482;27079;12478;41573
315790;201705;3672;11938;3201;11026;294;1026;2134;7569;2428;8595
315800;201705;1268;4896;990;4080;223;988;186;725;409;1713
315810;201705;1344;3525;1157;3242;129;407;818;2208;947;2615
315820;201705;2391;7847;2082;7296;482;1741;1086;3865;1568;5606
315830;201705;1167;3723;953;3303;100;431;364;1164;464;1595
315840;201705;767;2009;493;1482;84;260;146;429;230;689
315850;201705;966;3307;911;3222;217;865;531;1781;748;2646
315860;201705;527;1711;377;1407;84;365;97;327;181;692
315870;201705;449;1296;372;1171;37;128;228;684;265;812
315880;201705;1194;3052;944;2724;166;581;389;1090;555;1671
315890;201705;1512;5053;1342;4730;472;1765;515;1783;987;3548
315895;201705;5574;16953;4681;15063;820;2894;1835;5585;2655;8479
315900;201705;789;2232;750;2170;52;216;611;1669;663;1885
315910;201705;483;1608;449;1553;94;354;289;974;383;1328
315920;201705;1630;4422;914;2936;206;726;163;445;369;1171
315930;201705;1061;2771;774;2281;192;576;230;678;422;1254
315935;201705;895;2949;792;2740;203;796;212;722;415;1518
315940;201705;610;1936;528;1775;96;358;251;839;347;1197
315950;201705;1197;3548;1049;3280;212;649;651;2075;863;2724
315960;201705;3758;11597;2508;9128;853;3621;105;237;958;3858
315970;201705;690;1967;540;1756;56;165;370;1248;426;1413
315980;201705;3847;9402;2466;7126;609;1959;655;1687;1264;3646
315990;201705;3982;11008;3200;9681;470;1619;1629;4845;2099;6464
316000;201705;582;1681;479;1536;120;463;177;546;297;1009
316010;201705;647;2048;520;1805;53;233;259;821;312;1054
316020;201705;986;3131;870;2924;81;381;602;1910;683;2291
316030;201705;3143;9067;2311;7557;172;660;1415;4711;1587;5371
316040;201705;3074;9618;2329;8082;405;1588;433;1286;838;2874
316045;201705;2022;6121;1876;5879;201;621;1369;4356;1570;4977
316050;201705;358;1124;282;990;48;207;146;484;194;691
316060;201705;712;2055;562;1817;73;332;334;993;407;1325
316070;201705;6214;18872;5306;16926;1080;3853;2198;6669;3278;10522
316080;201705;731;2583;641;2364;162;657;73;264;235;921
316090;201705;522;1603;380;1305;62;258;124;397;186;655
316095;201705;1447;4517;1233;4139;145;501;751;2529;896;3030
316100;201705;2639;8485;1979;6954;454;1764;491;1591;945;3355
316105;201705;935;2627;705;2240;161;541;293;951;454;1492
316110;201705;12062;39565;10777;37385;1496;5460;6883;24415;8379;29875
316120;201705;1122;3539;868;2940;202;731;222;654;424;1385
316130;201705;1504;3446;898;2544;136;453;361;959;497;1412
316140;201705;966;2708;746;2396;95;317;458;1503;553;1820
316150;201705;1537;4073;1324;3713;188;596;737;1991;925;2587
316160;201705;1178;3409;924;2943;142;505;476;1435;618;1940
316165;201705;946;2429;774;2196;134;445;436;1231;570;1676
316170;201705;1274;3545;936;2981;143;498;409;1218;552;1716
316180;201705;1463;4492;1019;3538;237;924;164;485;401;1409
316190;201705;2865;8682;1563;5391;295;1007;333;1034;628;2041
316200;201705;3747;11763;2873;10036;623;2565;733;2433;1356;4998
316210;201705;4589;14564;3824;13023;1334;4819;503;1723;1837;6542
316220;201705;784;2411;554;1937;118;468;54;197;172;665
316225;201705;1245;3304;1023;2938;127;430;651;1786;778;2216
316230;201705;435;1232;358;1103;44;141;168;559;212;700
316240;201705;6531;19542;5754;18488;668;2218;4174;13524;4842;15742
316245;201705;3248;11076;2967;10634;250;1266;2241;7816;2491;9082
316250;201705;10374;29411;7967;24758;2150;7328;1707;5015;3857;12343
316255;201705;2578;7590;2256;7171;288;1020;1562;5032;1850;6052
316257;201705;1296;3471;974;2904;146;494;384;1100;530;1594
316260;201705;1871;5085;1448;4454;85;314;785;2535;870;2849
316265;201705;1353;3743;993;3053;78;272;624;1896;702;2168
316270;201705;3580;11955;3294;11319;799;2989;1319;4367;2118;7356
316280;201705;3144;9994;2868;9446;456;1694;1522;4845;1978;6539
316290;201705;3370;10245;2797;9129;520;1930;1026;3352;1546;5282
316292;201705;3721;11213;3242;10430;437;1636;2151;6708;2588;8344
316294;201705;813;2549;608;2146;122;490;69;254;191;744
316295;201705;1880;6015;1755;5784;168;707;1260;4013;1428;4720
316300;201705;1005;3167;851;2879;65;239;522;1813;587;2052
316310;201705;704;2016;482;1618;93;354;155;496;248;850
316320;201705;608;1895;501;1696;97;386;133;420;230;806
316330;201705;1013;3006;781;2488;81;291;504;1557;585;1848
316340;201705;951;2953;761;2572;124;517;394;1259;518;1776
316350;201705;1272;4009;1149;3799;156;568;713;2351;869;2919
316360;201705;731;1919;582;1696;55;172;402;1160;457;1332
316370;201705;4571;14174;3824;12707;1110;4151;680;2043;1790;6194
316380;201705;1633;4201;1290;3737;65;221;952;2762;1017;2983
316390;201705;874;2444;723;2207;146;484;332;1028;478;1512
316400;201705;1292;3911;974;3332;188;695;396;1324;584;2019
316410;201705;1013;3287;929;3162;114;403;689;2331;803;2734
316420;201705;1924;5973;1688;5660;153;617;1207;3972;1360;4589
316430;201705;945;2850;658;2233;153;571;155;490;308;1061
316440;201705;683;2189;560;2004;189;782;102;383;291;1165
316443;201705;640;1873;508;1626;117;423;172;528;289;951
316447;201705;1673;4819;1499;4579;94;336;1232;3766;1326;4102
316450;201705;2164;7071;1819;6387;196;770;1222;4234;1418;5004
316460;201705;818;2465;745;2333;235;751;322;990;557;1741
316470;201705;7278;22688;5847;19796;1407;5455;1559;4968;2966;10423
316480;201705;184;604;157;542;38;138;45;145;83;283
316490;201705;338;991;259;827;48;148;95;281;143;429
316500;201705;1206;4127;810;3003;150;611;61;200;211;811
316510;201705;738;2684;659;2536;214;901;185;691;399;1592
316520;201705;1039;3044;858;2738;150;556;350;1015;500;1571
316530;201705;836;2653;696;2396;135;585;286;856;421;1441
316540;201705;745;2362;661;2207;98;401;210;649;308;1050
316550;201705;1216;3968;1140;3836;172;640;724;2438;896;3078
316553;201705;2318;7785;1738;6302;508;1985;299;1032;807;3017
316555;201705;2842;9489;2508;9056;187;766;1886;6937;2073;7703
316556;201705;642;1600;481;1338;44;142;280;711;324;853
316557;201705;799;2833;739;2728;330;1284;209;727;539;2011
316560;201705;285;1025;245;941;69;312;60;212;129;524
316570;201705;1199;3824;1059;3536;262;917;365;1239;627;2156
316580;201705;337;884;220;659;59;186;59;174;118;360
316590;201705;1459;3915;1040;3196;190;672;539;1521;729;2193
316600;201705;1044;3366;937;3160;195;724;435;1453;630;2177
316610;201705;588;2075;507;1913;77;394;308;1090;385;1484
316620;201705;2240;6567;1905;6025;162;632;1284;4009;1446;4641
316630;201705;1507;4779;1224;4198;407;1382;407;1547;814;2929
316640;201705;166;518;144;476;32;135;61;167;93;302
316650;201705;950;3268;799;3048;86;357;545;2124;631;2481
316660;201705;193;498;95;294;6;27;17;44;23;71
316670;201705;1955;5300;1561;4624;504;1623;484;1375;988;2998
316680;201705;2066;5394;1627;4767;150;483;1182;3415;1332;3898
316690;201705;1170;3898;1035;3611;274;1094;314;1069;588;2163
316695;201705;1069;3292;940;3045;88;348;610;1949;698;2297
316700;201705;389;1100;338;1027;28;125;218;607;246;732
316710;201705;2714;9955;2309;9055;804;3285;633;2703;1437;5988
316720;201705;16582;52512;13714;46320;3302;11890;4187;13797;7489;25687
316730;201705;347;1061;308;974;82;291;115;336;197;627
316740;201705;692;2215;633;2117;72;313;431;1436;503;1749
316750;201705;407;1343;336;1194;55;229;115;383;170;612
316760;201705;3582;11573;3030;10784;1389;5205;1021;3701;2410;8906
316770;201705;1414;3799;1225;3532;57;222;1030;2961;1087;3183
316780;201705;589;1919;500;1733;151;573;54;152;205;725
316790;201705;762;2188;608;1924;164;558;189;603;353;1161
316800;201705;5222;16623;4480;15155;807;2987;2332;7526;3139;10513
316805;201705;817;2029;789;1990;33;57;685;1829;718;1886
316810;201705;653;1941;509;1641;137;505;194;558;331;1063
316820;201705;398;1012;219;693;39;143;29;93;68;236
316830;201705;575;1925;537;1847;127;503;273;899;400;1402
316840;201705;2742;8248;2419;7661;493;1740;1108;3380;1601;5120
316850;201705;2118;5923;1713;5267;229;819;992;2978;1221;3797
316860;201705;17876;55150;15247;50360;3327;12508;5985;19132;9312;31640
316870;201705;6312;19881;5093;17173;1413;5118;1100;3582;2513;8700
316880;201705;881;2595;759;2383;192;692;262;797;454;1489
316890;201705;1296;2971;898;2440;195;645;510;1263;705;1908
316900;201705;2538;7341;1996;6235;479;1699;588;1612;1067;3311
316905;201705;459;1481;391;1331;117;421;146;495;263;916
316910;201705;933;2788;649;2231;157;620;88;276;245;896
316920;201705;1591;4225;1127;3564;239;853;445;1386;684;2239
316930;201705;7798;25974;6179;22550;1432;5680;1032;3625;2464;9305
316935;201705;4422;13285;3227;10738;811;2917;748;2464;1559;5381
316940;201705;6757;21458;5376;18467;1197;4439;1297;4191;2494;8630
316950;201705;1630;4279;1338;3879;89;303;997;2852;1086;3155
316960;201705;4909;12190;3797;10617;631;1901;2154;5955;2785;7856
316970;201705;3224;10080;3022;9702;634;2316;1278;3819;1912;6135
316980;201705;919;2737;648;2225;203;765;96;330;299;1095
316990;201705;9851;30337;7971;26212;2310;8184;727;2292;3037;10476
317000;201705;2787;9253;2683;9137;214;666;2111;7923;2325;8589
317005;201705;2656;8044;2298;7438;488;1648;1155;3752;1643;5400
317010;201705;27246;67055;16658;50741;4127;14161;3158;10308;7285;24469
317020;201705;65770;175183;39212;122597;7764;26575;7341;21153;15105;47728
317030;201705;704;2048;598;1883;45;181;388;1200;433;1381
317040;201705;10288;29008;8045;25060;1999;6617;3015;9487;5014;16104
317043;201705;756;1964;622;1775;122;353;336;953;458;1306
317047;201705;1141;2967;861;2510;67;221;537;1558;604;1779
317050;201705;1457;4832;1107;3994;210;814;350;1145;560;1959
317052;201705;2263;7267;2096;6988;190;756;1531;5003;1721;5759
317057;201705;1629;4437;1241;3758;94;362;805;2334;899;2696
317060;201705;425;1192;262;849;57;211;63;180;120;391
317065;201705;1291;3793;1130;3526;58;244;869;2631;927;2875
317070;201705;9068;27785;6294;21650;1415;5468;801;2665;2216;8133
317075;201705;1069;3197;839;2714;185;627;192;588;377;1215
317080;201705;6241;16394;5132;14543;1610;4779;1467;3988;3077;8767
317090;201705;4754;15270;4412;14756;451;1583;3157;10654;3608;12237
317100;201705;2964;7881;2145;6512;703;2294;626;1859;1329;4153
317103;201705;1823;6223;1608;5813;208;983;901;3083;1109;4066
317107;201705;1382;4080;1189;3716;110;433;765;2206;875;2639
317110;201705;738;1775;415;1246;68;243;145;457;213;700
317115;201705;1162;3519;983;3141;83;280;682;2184;765;2464
317120;201705;10857;35063;8843;30580;1840;7051;3753;12543;5593;19594
317130;201705;7448;21357;5961;18669;1346;4653;2141;6637;3487;11290
317140;201705;573;1787;518;1697;78;278;320;1030;398;1308
317150;201705;988;2663;848;2493;63;209;672;1959;735;2168
317160;201705;3527;9059;2599;7780;214;685;1767;5277;1981;5962
317170;201705;1973;5230;1474;4385;219;748;517;1350;736;2098
317180;201705;1780;5897;1443;5169;363;1358;326;1126;689;2484
317190;201705;1375;3822;1064;3361;67;233;703;2205;770;2438
317200;201705;4486;13692;3778;12257;950;3402;1017;3123;1967;6525
317210;201705;946;2773;819;2603;102;416;549;1708;651;2124
317220;201705;276;931;261;907;64;253;126;425;190;678
320010;201705;4887;15083;4150;13640;656;2306;2276;7337;2932;9643
320013;201705;1907;5723;1339;4484;239;835;539;1855;778;2690
320016;201705;3013;8306;2557;7651;215;606;1933;5820;2148;6426
320020;201705;3773;11519;3094;10198;861;2997;932;3143;1793;6140
320030;201705;1701;5319;1274;4393;373;1359;370;1231;743;2590
320035;201705;1791;5246;1536;4832;518;1795;595;1768;1113;3563
320040;201705;3208;10160;2694;9168;561;2054;1064;3577;1625;5631
320050;201705;1692;4473;1471;4090;363;1026;677;1866;1040;2892
320060;201705;11304;35202;8527;29047;2124;7854;1724;5626;3848;13480
320070;201705;1474;4553;1172;3912;259;951;324;1044;583;1995
320080;201705;5601;15853;4275;13214;919;2938;1412;4453;2331;7391
320090;201705;7776;22283;6177;19078;1587;5183;2254;6768;3841;11951
320100;201705;2574;8002;2092;7017;634;2170;630;2143;1264;4313
320110;201705;1219;3568;1035;3222;266;847;263;841;529;1688
320115;201705;1856;6438;1667;6100;821;3092;446;1715;1267;4807
320120;201705;15638;46149;12060;39342;2967;10667;3270;10582;6237;21249
320130;201705;36039;113571;32396;106527;6317;23368;15591;49757;21908;73125
320140;201705;3348;10420;2429;8400;645;2483;462;1579;1107;4062
320150;201705;14159;39962;10826;33373;3230;10678;1221;3455;4451;14133
320160;201705;4999;15380;4215;13811;1023;3672;1621;5138;2644;8810
320170;201705;1635;5178;1355;4554;305;1084;571;1885;876;2969
320180;201705;737;2507;634;2314;224;852;157;599;381;1451
320190;201705;3490;11885;2758;10104;718;2751;458;1642;1176;4393
320200;201705;984;2992;792;2657;259;953;202;707;461;1660
320210;201705;4571;12759;3822;11305;745;2455;1808;5045;2553;7500
320220;201705;2244;6841;1877;6190;454;1645;834;2755;1288;4400
320225;201705;1286;4288;990;3563;328;1232;155;576;483;1808
320230;201705;4222;13283;3527;12046;996;3646;1344;4659;2340;8305
320240;201705;13092;37653;10532;33202;2607;8870;3421;10877;6028;19747
320245;201705;3100;10387;2840;9780;978;3558;714;2409;1692;5967
320250;201705;1902;5727;1360;4475;373;1374;217;657;590;2031
320255;201705;1692;5704;1483;5337;557;2089;576;2173;1133;4262
320260;201705;1044;3132;797;2597;234;837;195;533;429;1370
320265;201705;2467;7816;2088;7134;785;2803;726;2484;1511;5287
320270;201705;2701;7797;1987;6454;386;1341;902;3011;1288;4352
320280;201705;6324;19342;5453;17615;1419;4991;1438;4377;2857;9368
320290;201705;1430;4557;1016;3551;304;1144;158;533;462;1677
320300;201705;4149;13689;3599;12439;1193;4407;723;2470;1916;6877
320305;201705;4483;14121;3810;12631;938;3321;1461;4779;2399;8100
320310;201705;1872;5595;1554;4923;375;1228;594;1871;969;3099
320313;201705;2131;6002;1455;4533;335;1194;277;804;612;1998
320316;201705;1672;4981;1334;4283;410;1363;413;1321;823;2684
320320;201705;19731;58346;15373;50375;4182;14845;4850;15709;9032;30554
320330;201705;2931;8576;2388;7612;641;2049;977;3293;1618;5342
320332;201705;5392;16950;4651;15563;1368;4869;1823;6046;3191;10915
320334;201705;2059;6394;1423;5017;338;1321;325;1111;663;2432
320335;201705;2240;6564;1411;4628;381;1371;192;574;573;1945
320340;201705;5517;14810;4739;13519;1016;3118;2168;6333;3184;9451
320350;201705;5109;13414;3807;11025;680;2044;1696;4884;2376;6928
320360;201705;1631;4333;1207;3508;200;604;492;1384;692;1988
320370;201705;2799;9195;2253;7919;641;2333;678;2355;1319;4688
320380;201705;2182;6419;1933;5984;391;1336;999;3003;1390;4339
320390;201705;7091;20980;5732;18092;1577;5347;1754;5299;3331;10646
320400;201705;3484;10567;3033;9749;637;2211;1388;4423;2025;6634
320405;201705;4278;12284;3699;11263;695;2261;2031;6068;2726;8329
320410;201705;5290;14380;3974;12439;864;2921;1788;5749;2652;8670
320420;201705;2478;7333;1990;6456;610;2197;455;1450;1065;3647
320425;201705;2031;5194;1589;4467;156;474;979;2689;1135;3163
320430;201705;2586;7115;2189;6301;410;1260;1185;3274;1595;4534
320435;201705;2686;8541;2181;7547;916;3302;550;2019;1466;5321
320440;201705;1026;3311;896;2984;197;730;321;1022;518;1752
320450;201705;1926;5926;1567;5216;403;1489;654;2089;1057;3578
320455;201705;4122;13314;3070;10840;821;3064;695;2376;1516;5440
320460;201705;2619;8220;1907;6597;481;1802;360;1139;841;2941
320465;201705;1544;4680;1179;3889;165;601;552;1824;717;2425
320470;201705;4220;12393;2996;9762;839;2980;614;1920;1453;4900
320480;201705;1679;5218;1452;4752;319;1149;610;1953;929;3102
320490;201705;15557;46725;13113;42397;3515;12451;4178;13516;7693;25967
320495;201705;1337;3854;883;2926;271;948;132;469;403;1417
320500;201705;48086;141972;41760;130742;8901;30118;20252;62114;29153;92232
320501;201705;4735;14283;3697;12531;1111;4238;962;3161;2073;7399
320503;201705;1904;6356;1532;5551;549;2214;433;1423;982;3637
320506;201705;4089;12452;2898;9689;810;2882;103;270;913;3152
320510;201705;8427;25730;7333;23691;1490;5328;3608;11446;5098;16774
320515;201705;1876;5393;1526;4637;462;1465;345;1051;807;2516
320517;201705;2063;6574;1652;5761;537;2018;365;1261;902;3279
320520;201705;36383;107908;29926;96367;7187;25616;10594;33584;17781;59200
320530;201705;27891;82683;23213;73954;4152;15503;11590;34737;15742;50240
330010;201705;20246;61554;18181;57761;3945;13279;9586;30561;13531;43840
330015;201705;1500;4145;1293;3769;208;713;606;1719;814;2432
330020;201705;18072;51614;16412;48886;2864;9455;10078;29274;12942;38729
330022;201705;1908;5546;1591;5016;307;1065;882;2740;1189;3805
330023;201705;3167;9613;2741;8927;775;2731;821;2586;1596;5317
330025;201705;4697;12629;3567;10591;955;3020;1443;4318;2398;7338
330030;201705;8242;26814;7235;24849;1397;5330;3522;11592;4919;16922
330040;201705;11676;34804;10622;32754;2056;6903;5940;17765;7996;24668
330045;201705;74906;201819;64914;187828;8071;25185;44077;125983;52148;151168
330050;201705;2417;7264;2015;6526;541;1881;743;2287;1284;4168
330060;201705;5632;15951;4783;14639;1081;3726;2237;6618;3318;10344
330070;201705;19991;59769;17929;56327;3827;13024;8803;27692;12630;40716
330080;201705;8126;22575;7472;21555;691;2060;5295;15224;5986;17284
330090;201705;2615;6872;2328;6440;353;1095;1307;3496;1660;4591
330093;201705;1936;5745;1619;5184;292;963;781;2639;1073;3602
330095;201705;1017;3397;872;3070;172;681;336;1136;508;1817
330100;201705;60438;183626;54488;174259;7537;27684;32976;104174;40513;131858
330110;201705;2247;6971;1981;6514;475;1697;705;2272;1180;3969
330115;201705;1773;5091;1540;4733;279;976;849;2522;1128;3498
330120;201705;2730;7296;2384;6782;336;1102;1548;4320;1884;5422
330130;201705;3289;10500;2932;9879;689;2542;1417;4685;2106;7227
330140;201705;3103;9397;2829;8984;548;2017;1582;4904;2130;6921
330150;201705;2070;6104;1670;5319;439;1473;437;1400;876;2873
330160;201705;1149;3546;1002;3297;262;992;469;1453;731;2445
330170;201705;99266;294501;90240;279984;17491;57796;49822;153176;67313;210972
330180;201705;2089;5988;1748;5372;117;479;1164;3433;1281;3912
330185;201705;8332;25231;7221;23113;1337;4676;4008;12514;5345;17190
330187;201705;3817;10799;3258;9884;511;1709;2017;6026;2528;7735
330190;201705;25550;71311;23851;68743;3644;10997;16863;48458;20507;59455
330200;201705;13919;42904;12410;40393;3053;10173;6222;20643;9275;30816
330205;201705;2050;5614;1782;5158;201;659;1142;3222;1343;3881
330210;201705;3030;8388;2484;7346;571;1726;839;2443;1410;4169
330220;201705;10135;30366;8632;27225;2192;7494;2160;6327;4352;13821
330225;201705;3704;11379;3192;10425;398;1640;1840;5731;2238;7371
330227;201705;16625;47420;14940;44977;2943;9140;9004;27548;11947;36688
330230;201705;1245;3648;1120;3457;168;621;664;1963;832;2584
330240;201705;17757;53347;15133;48532;4594;15858;4911;15277;9505;31135
330245;201705;1237;3671;939;3143;237;844;188;604;425;1448
330250;201705;34939;101738;31712;96419;9013;27709;12799;40386;21812;68095
330260;201705;4146;12721;3560;11560;663;2365;1535;4765;2198;7130
330270;201705;19672;44321;13226;35679;3024;9162;4858;13156;7882;22318
330280;201705;2255;6588;1874;5850;313;1114;908;2661;1221;3775
330285;201705;18101;51177;16227;48326;2743;8947;9892;28957;12635;37904
330290;201705;3243;9326;2861;8717;475;1616;1583;4648;2058;6264
330300;201705;3200;10305;2873;9666;520;2002;1605;5163;2125;7165
330310;201705;2190;6146;1854;5565;217;674;1163;3491;1380;4165
330320;201705;12930;38612;12079;37282;1527;5209;8852;27037;10379;32246
330330;201705;28101;76044;24445;70363;4206;13553;14659;40824;18865;54377
330340;201705;14256;40791;11228;35337;2712;9204;3741;11502;6453;20706
330350;201705;87465;250537;78282;237421;10739;34966;52890;159960;63629;194926
330360;201705;6066;17500;5739;17028;585;1854;4378;12890;4963;14744
330370;201705;3554;12417;3187;11656;1072;4062;1009;3710;2081;7772
330380;201705;5087;16154;4275;14508;1055;3980;1436;4674;2491;8654
330385;201705;3856;13152;3515;12473;1022;3847;1385;4965;2407;8812
330390;201705;22197;71512;19348;65735;4805;17668;7849;26066;12654;43734
330395;201705;3035;8756;2770;8327;234;841;1850;5479;2084;6320
330400;201705;2681;8209;2433;7760;285;1140;1577;4663;1862;5803
330410;201705;2843;8483;2234;7347;427;1562;1015;3164;1442;4726
330411;201705;2339;7181;2036;6554;239;902;1258;3857;1497;4759
330412;201705;1392;4624;1176;4174;211;820;542;1798;753;2618
330414;201705;23777;66124;20688;61768;3916;11644;12139;36645;16055;48289
330415;201705;3282;10081;2796;9219;657;2192;1132;3807;1789;5999
330420;201705;9796;27412;6712;21879;1412;5002;1512;4739;2924;9741
330430;201705;7224;21103;6387;19548;1325;4417;2975;8798;4300;13215
330440;201705;1543;5091;1384;4782;429;1668;394;1217;823;2885
330450;201705;1343;4361;1201;4117;245;999;622;2071;867;3070
330452;201705;13893;40417;11196;35304;2631;9019;4697;14399;7328;23418
330455;201705;503123;1358345;409026;1206047;82053;259116;211395;614480;293448;873596
330460;201705;1160;3717;1011;3445;217;815;438;1458;655;2273
330470;201705;4277;12675;3798;11833;875;2961;1749;5318;2624;8279
330475;201705;7709;23500;6805;22001;2022;7113;2586;8132;4608;15245
330480;201705;5700;16381;5099;15492;812;2645;3052;9089;3864;11734
330490;201705;110441;286392;97936;267875;10783;31490;67512;182745;78295;214235
330500;201705;5319;15997;5072;15569;675;2277;3601;10937;4276;13214
330510;201705;36669;110808;32566;104263;10187;32973;13627;44727;23814;77700
330513;201705;1316;3938;1214;3760;376;1200;512;1601;888;2801
330515;201705;2995;9127;2594;8338;841;2787;705;2263;1546;5050
330520;201705;10986;33073;9790;30900;2001;6795;4498;13888;6499;20683
330530;201705;1460;4172;1242;3768;296;995;547;1566;843;2561
330540;201705;2904;8436;2380;7475;626;2090;852;2565;1478;4655
330550;201705;7729;25625;6825;23877;2857;10394;1175;4259;4032;14653
330555;201705;9549;28187;8544;26707;1559;5047;5203;16554;6762;21601
330560;201705;4273;12710;3787;11800;588;2018;2067;6216;2655;8234
330570;201705;3119;9150;2643;8334;627;2082;1269;3981;1896;6063
330575;201705;5260;14785;4692;13747;627;2109;3146;8843;3773;10952
330580;201705;13230;41044;11054;36635;3058;10748;4162;13706;7220;24454
330590;201705;1528;4618;1431;4468;209;705;982;3087;1191;3792
330600;201705;11273;32673;9027;28650;1494;5264;4262;13347;5756;18611
330610;201705;8638;26735;7756;25170;1298;4750;4333;13715;5631;18465
330615;201705;1604;5590;1490;5397;573;2170;539;2002;1112;4172
330620;201705;3480;11901;3086;11067;1136;4393;625;2171;1761;6564
330630;201705;23298;66401;18967;58737;2714;9808;10845;32203;13559;42011
350010;201705;1804;5206;1181;3983;301;1056;127;384;428;1440
350020;201705;452;1245;315;980;37;124;163;465;200;589
350030;201705;4495;13756;3446;11645;978;3575;849;2802;1827;6377
350040;201705;456;1500;335;1226;71;285;102;340;173;625
350050;201705;859;2594;691;2270;162;614;216;596;378;1210
350055;201705;676;1941;575;1773;79;269;376;1146;455;1415
350060;201705;112;343;91;310;24;91;43;147;67;238
350070;201705;3892;11268;2482;8367;495;1753;580;1779;1075;3532
350075;201705;555;1818;428;1553;173;641;69;236;242;877
350080;201705;668;1911;419;1350;65;242;162;495;227;737
350090;201705;610;1605;390;1156;94;262;129;380;223;642
350100;201705;1960;5978;1402;4853;259;1044;490;1576;749;2620
350110;201705;463;1412;345;1153;31;124;190;614;221;738
350115;201705;1243;3694;1088;3389;219;740;530;1516;749;2256
350120;201705;840;2438;521;1759;69;226;257;949;326;1175
350130;201705;3370;9829;2913;8924;375;1280;1628;4734;2003;6014
350140;201705;585;1910;486;1714;54;233;274;944;328;1177
350150;201705;461;1491;400;1362;134;491;100;342;234;833
350160;201705;8991;25145;6014;19459;1135;4143;2615;7842;3750;11985
350170;201705;1509;5037;1253;4411;311;1156;292;992;603;2148
350180;201705;1132;3068;691;2118;106;362;317;934;423;1296
350190;201705;3202;9722;2513;8293;523;1990;1009;2858;1532;4848
350200;201705;386;1172;346;1095;25;81;234;737;259;818
350210;201705;5101;13354;3612;10801;873;2717;1534;4548;2407;7265
350220;201705;2428;7648;2091;6869;442;1704;920;2803;1362;4507
350230;201705;770;2388;685;2221;158;540;298;960;456;1500
350240;201705;546;1617;415;1324;49;174;214;647;263;821
350250;201705;2062;7281;1870;6908;678;2688;554;2042;1232;4730
350260;201705;980;2553;649;1934;119;365;274;788;393;1153
350270;201705;4872;14589;4049;12842;763;2675;1758;5224;2521;7899
350275;201705;1878;6065;1691;5759;466;1681;647;2169;1113;3850
350280;201705;21833;52428;13685;38793;2772;8393;3638;10083;6410;18476
350290;201705;2299;7180;1798;6115;365;1381;592;1927;957;3308
350300;201705;562;1618;420;1306;86;256;165;494;251;750
350310;201705;890;2927;764;2626;105;421;302;986;407;1407
350315;201705;513;1583;384;1297;67;251;104;320;171;571
350320;201705;10658;32983;9495;30794;2758;9450;1621;5546;4379;14996
350330;201705;14667;39899;10102;29807;1826;5293;3996;11148;5822;16441
350335;201705;387;1187;343;1100;21;63;250;812;271;875
350340;201705;1102;3204;757;2509;150;559;239;792;389;1351
350350;201705;716;2190;609;2037;124;451;208;686;332;1137
350360;201705;858;2852;729;2562;179;622;291;1041;470;1663
350370;201705;576;1696;414;1320;102;328;82;248;184;576
350380;201705;4430;12840;3146;10424;745;2711;915;2821;1660;5532
350390;201705;9425;28356;8114;25867;2323;7575;2925;9178;5248;16753
350395;201705;368;1014;185;631;30;108;51;153;81;261
350400;201705;7967;22514;6251;19355;1561;5307;2079;6098;3640;11405
350410;201705;8402;27252;6648;23639;1810;7033;1355;4527;3165;11560
350420;201705;559;1739;424;1496;90;377;54;180;144;557
350430;201705;689;2113;583;1920;94;368;327;1029;421;1397
350440;201705;1317;4066;1096;3545;249;782;461;1471;710;2253
350450;201705;7474;22981;6070;20112;1418;5039;1611;5123;3029;10162
350460;201705;1418;3808;864;2703;165;579;286;832;451;1411
350470;201705;242;635;201;565;25;91;129;338;154;429
350480;201705;763;2220;539;1776;90;339;92;272;182;611
350490;201705;1851;5481;1542;4952;355;1233;510;1512;865;2745
350500;201705;562;1675;488;1532;79;296;253;759;332;1055
350510;201705;1082;3225;812;2652;114;428;355;1102;469;1530
350520;201705;1614;5736;1270;4920;265;1099;361;1360;626;2459
350530;201705;2292;6650;1846;5750;525;1714;470;1401;995;3115
350535;201705;1263;4007;1178;3863;158;644;791;2477;949;3121
350540;201705;1767;4891;1328;4117;322;1073;486;1522;808;2595
350550;201705;10445;27382;7265;22164;1221;4250;2803;8023;4024;12273
350560;201705;3386;10937;2955;9915;374;1327;1655;5490;2029;6817
350570;201705;18578;59060;16371;54683;4573;16626;6363;20247;10936;36873
350580;201705;1778;5586;1147;3980;230;846;122;346;352;1192
350590;201705;3941;12034;3072;10250;797;3007;1181;3602;1978;6609
350600;201705;43044;105261;28337;79368;4502;13834;12167;31634;16669;45468
350610;201705;6850;20140;5441;17517;1118;3960;2278;7128;3396;11088
350620;201705;416;1171;310;1005;46;188;142;423;188;611
350630;201705;1625;4582;1203;3772;176;662;527;1508;703;2170
350635;201705;6863;19634;5370;17068;1178;4101;2276;7046;3454;11147
350640;201705;814;2489;561;1869;98;347;138;422;236;769
350650;201705;8075;23922;5193;17152;1105;4008;1170;3616;2275;7624
350660;201705;4866;13947;3931;12275;740;2506;1877;5796;2617;8302
350670;201705;1534;4775;1409;4530;325;1099;689;2158;1014;3257
350680;201705;1067;3156;782;2593;177;666;324;1048;501;1714
350690;201705;861;2770;669;2355;140;549;240;784;380;1333
350700;201705;4249;12264;3002;10122;652;2444;1079;3361;1731;5805
350710;201705;2707;8280;2349;7585;365;1318;1335;4199;1700;5517
350715;201705;740;2223;659;2043;86;304;371;1072;457;1376
350720;201705;126;355;113;334;26;84;41;116;67;200
350730;201705;419;1487;388;1411;82;330;178;635;260;965
350740;201705;1763;5297;1246;4130;227;815;326;969;553;1784
350745;201705;527;1610;319;1086;53;193;140;434;193;627
350750;201705;9204;27777;7622;24664;1749;6330;2125;6308;3874;12638
350760;201705;13212;37928;10519;33155;2797;9624;2613;7406;5410;17030
350770;201705;676;1909;459;1467;53;176;233;735;286;911
350775;201705;615;1616;495;1415;52;186;243;665;295;851
350780;201705;1865;5597;1450;4794;388;1417;301;1037;689;2454
350790;201705;1851;5651;1361;4668;314;1143;244;728;558;1871
350800;201705;2991;9794;2793;9414;502;1914;1474;4782;1976;6696
350810;201705;1994;5559;1707;5154;411;1316;825;2594;1236;3910
350820;201705;620;1690;422;1301;67;219;151;442;218;661
350830;201705;855;2619;547;1906;73;271;140;446;213;717
350840;201705;2604;8823;2098;7753;666;2644;505;1772;1171;4416
350850;201705;6019;19655;5014;17493;1496;5462;1210;4217;2706;9679
350860;201705;3203;9648;3001;9326;152;646;2302;7037;2454;7683
350870;201705;2711;8425;2190;7529;459;1751;1201;4142;1660;5893
350880;201705;1312;4281;1050;3653;242;876;263;894;505;1770
350890;201705;654;1821;407;1281;50;166;115;301;165;467
350900;201705;5306;16140;3794;12850;1184;4402;446;1412;1630;5814
350910;201705;882;2538;757;2284;175;597;390;1126;565;1723
350920;201705;11432;31427;10075;29170;835;2800;7426;20665;8261;23465
350925;201705;4423;13620;3503;11792;828;3004;1168;3434;1996;6438
350930;201705;1520;4217;1087;3328;135;440;586;1709;721;2149
350940;201705;1812;5867;1654;5546;288;1123;933;3009;1221;4132
350945;201705;911;2812;760;2536;127;501;362;1126;489;1627
350950;201705;77006;226696;62569;195431;12085;41474;29660;87444;41745;128918
350960;201705;4801;15603;4107;14155;813;3187;2085;6845;2898;10032
350970;201705;4089;13861;3419;12220;1116;4336;552;1749;1668;6085
350980;201705;628;2029;543;1841;222;795;166;555;388;1350
350990;201705;1757;5723;1420;5094;381;1507;409;1385;790;2892
350995;201705;785;2616;741;2524;92;408;461;1471;553;1879
351000;201705;2816;8244;2268;7204;413;1446;886;2666;1299;4112
351010;201705;331;954;197;649;40;139;69;227;109;366
351015;201705;744;2512;632;2297;148;578;261;944;409;1522
351020;201705;8013;24537;6895;22706;1671;5768;3383;11121;5054;16889
351030;201705;2139;7151;1822;6366;391;1530;727;2381;1118;3911
351040;201705;3656;10705;3316;10132;374;1301;2338;6919;2712;8220
351050;201705;15737;42918;11066;34976;2582;8905;3447;10829;6029;19734
351060;201705;40345;112860;32637;99408;5720;19205;17175;50837;22895;70042
351070;201705;1412;3906;912;2986;244;877;94;264;338;1141
351080;201705;2743;7778;2078;6946;479;1770;932;2920;1411;4690
351090;201705;344;1162;269;1009;54;225;47;174;101;399
351100;201705;2442;7288;1675;5408;446;1515;472;1533;918;3048
351110;201705;6409;16343;3779;12044;809;2876;974;2923;1783;5799
351120;201705;676;1975;518;1655;81;274;213;591;294;865
351130;201705;1032;2904;517;1794;83;286;106;362;189;648
351140;201705;1665;5544;1372;4918;425;1655;301;1005;726;2660
351150;201705;1411;4856;997;3781;215;860;90;280;305;1140
351160;201705;1205;4100;1059;3756;272;1039;350;1072;622;2111
351170;201705;1373;4271;1174;3834;157;577;614;1883;771;2460
351190;201705;821;2583;640;2137;104;350;194;631;298;981
351200;201705;1861;5431;1567;4895;178;625;716;2098;894;2723
351210;201705;1290;3546;892;2740;125;447;356;986;481;1433
351220;201705;2955;9741;2706;9211;383;1469;1558;5157;1941;6626
351230;201705;1810;5459;1454;4810;297;1120;690;2150;987;3270
351240;201705;1152;3413;861;2811;206;692;330;1010;536;1702
351250;201705;966;2819;592;1921;96;324;208;643;304;967
351260;201705;901;2615;757;2320;249;766;182;531;431;1297
351270;201705;320;1037;279;948;72;284;113;323;185;607
351280;201705;5154;14531;3870;12021;707;2435;1480;4372;2187;6807
351290;201705;962;2709;672;2128;145;474;277;837;422;1311
351300;201705;13129;41081;9873;34279;2323;8796;3132;10867;5455;19663
351310;201705;2980;8956;2400;7869;440;1629;1137;3481;1577;5110
351320;201705;871;2846;709;2437;127;487;248;791;375;1278
351330;201705;610;2176;551;2081;70;207;377;1544;447;1751
351340;201705;5629;18460;4763;16746;1281;4707;1781;6255;3062;10962
351350;201705;7350;23198;6378;21244;1581;5535;2573;8182;4154;13717
351360;201705;3909;11943;3570;11301;922;3212;1095;3186;2017;6398
351370;201705;2278;6988;1764;5848;364;1345;696;2104;1060;3449
351380;201705;39763;112210;34829;103200;6727;21206;15989;46220;22716;67426
351385;201705;258;757;183;591;23;84;60;167;83;251
351390;201705;1203;3739;996;3301;255;1020;430;1254;685;2274
351400;201705;921;2978;870;2864;236;849;430;1387;666;2236
351410;201705;2372;7133;2032;6476;296;959;1160;3635;1456;4594
351420;201705;303;831;198;630;42;134;51;159;93;293
351430;201705;780;2434;729;2345;87;320;563;1781;650;2101
351440;201705;3212;9478;2362;7604;467;1584;351;1018;818;2602
351450;201705;1534;4299;1206;3724;285;937;388;1256;673;2193
351460;201705;648;1927;561;1762;265;833;159;503;424;1336
351470;201705;1035;3000;895;2725;133;470;469;1335;602;1805
351480;201705;2709;8612;2453;8179;372;1583;1362;4319;1734;5902
351490;201705;1788;5821;1592;5401;157;683;976;3131;1133;3814
351492;201705;298;936;253;822;16;62;145;451;161;513
351495;201705;208;670;159;541;27;107;69;220;96;327
351500;201705;31339;85334;23477;71226;5497;17892;9514;27723;15011;45615
351510;201705;9814;28763;7856;24865;1672;5712;3873;11945;5545;17657
351512;201705;494;1399;358;1097;48;138;164;489;212;627
351515;201705;2395;7074;1673;5527;377;1411;422;1268;799;2679
351518;201705;2181;6526;1508;5251;331;1287;575;1825;906;3112
351519;201705;767;2254;548;1766;94;342;132;314;226;656
351520;201705;780;2116;364;1261;64;246;107;339;171;585
351530;201705;369;1118;238;775;31;99;61;160;92;259
351535;201705;2337;5943;1777;5055;145;508;1152;3116;1297;3624
351540;201705;1797;5202;1373;4371;481;1655;195;556;676;2211
351550;201705;5138;15071;3633;11660;647;2289;1495;4513;2142;6802
351560;201705;438;1397;377;1255;84;313;75;242;159;555
351565;201705;167;571;149;525;32;116;58;194;90;310
351570;201705;14153;41187;11645;36195;2085;7096;6700;20014;8785;27110
351580;201705;301;826;185;587;34;95;53;179;87;274
351590;201705;468;1180;288;826;28;96;144;376;172;472
351600;201705;1759;4810;1417;4188;173;584;831;2329;1004;2913
351610;201705;682;1813;501;1500;50;180;241;625;291;805
351620;201705;18609;57977;14731;50150;2955;11390;4446;13635;7401;25025
351630;201705;22731;67733;20005;63205;3890;13108;11672;36103;15562;49211
351640;201705;14214;41384;11753;37062;1828;6402;7033;21582;8861;27984
351650;201705;436;1307;211;724;31;119;42;129;73;248
351660;201705;789;2444;563;1869;121;433;111;325;232;758
351670;201705;3971;12415;3190;10551;545;2011;1437;4418;1982;6429
351680;201705;549;1688;329;1124;70;232;69;239;139;471
351685;201705;430;1379;371;1255;88;271;165;567;253;838
351690;201705;1057;3095;761;2460;130;452;296;869;426;1321
351700;201705;1071;3124;921;2825;213;628;345;1059;558;1687
351710;201705;556;1805;456;1569;63;248;188;595;251;843
351720;201705;1560;4617;1088;3553;200;711;348;1080;548;1791
351730;201705;1072;2971;850;2630;168;626;358;1045;526;1671
351740;201705;4002;10801;3157;9128;591;1835;1259;3436;1850;5271
351750;201705;1190;3749;764;2752;136;532;237;847;373;1379
351760;201705;3277;10076;2548;8459;660;2400;692;2074;1352;4474
351770;201705;2118;6651;1766;5957;516;1800;655;2141;1171;3941
351780;201705;1427;3965;789;2515;131;470;163;480;294;950
351790;201705;1132;3143;951;2846;184;509;534;1634;718;2143
351800;201705;514;1122;282;729;40;113;97;246;137;359
351810;201705;1037;2936;863;2619;91;264;578;1720;669;1984
351820;201705;2552;8002;1856;6487;369;1409;191;669;560;2078
351830;201705;4380;13146;3367;11032;516;1948;1677;5275;2193;7223
351840;201705;6637;22176;5792;20435;1398;5369;2133;7216;3531;12585
351850;201705;2083;5535;1458;4461;223;851;643;1769;866;2620
351860;201705;3088;9792;2660;8896;598;2130;1205;3968;1803;6098
351870;201705;26871;78469;22093;69827;6861;22802;8201;25699;15062;48501
351880;201705;118576;358566;98509;319320;28606;99627;26609;82148;55215;181775
351885;201705;634;2145;578;2028;152;564;241;801;393;1365
351890;201705;622;1914;509;1694;121;425;78;229;199;654
351900;201705;1176;3556;957;3176;255;893;288;945;543;1838
351905;201705;453;1392;354;1192;45;168;170;524;215;692
351907;201705;19295;55480;16056;49422;1186;4493;11139;33297;12325;37790
351910;201705;1053;3183;838;2691;180;633;337;1019;517;1652
351920;201705;964;2580;776;2286;108;370;400;1141;508;1511
351925;201705;1006;2974;820;2605;143;500;362;1047;505;1547
351930;201705;2778;8669;2661;8449;366;1510;2024;6117;2390;7627
351940;201705;996;2911;810;2566;104;367;425;1332;529;1699
351950;201705;1570;4161;1113;3318;110;379;593;1715;703;2094
351960;201705;4589;13072;3430;10872;744;2612;1438;4461;2182;7073
351970;201705;5564;19450;4944;18222;1279;5146;1995;7022;3274;12168
351980;201705;911;2637;673;2122;123;426;279;800;402;1226
351990;201705;1481;4066;1143;3440;214;767;293;784;507;1551
352000;201705;2248;7261;2038;6809;339;1280;1048;3295;1387;4575
352010;201705;1620;5320;1403;4868;351;1294;233;822;584;2116
352020;201705;1443;4392;1230;3985;285;1008;497;1515;782;2523
352030;201705;4886;14142;4040;12890;823;2894;2125;6740;2948;9634
352040;201705;2011;6308;1507;5214;302;1134;242;778;544;1912
352042;201705;3554;9604;2161;6694;410;1351;931;2824;1341;4175
352044;201705;1794;5390;1133;3999;175;670;240;805;415;1475
352050;201705;11452;34414;7828;26295;1827;6928;1379;4135;3206;11063
352060;201705;716;2127;567;1817;102;368;229;672;331;1040
352070;201705;808;1990;638;1716;132;396;228;609;360;1005
352080;201705;450;1293;287;916;49;172;88;254;137;426
352090;201705;1330;4478;1071;3836;181;719;295;972;476;1691
352100;201705;3008;8981;2403;7854;562;1974;1006;3124;1568;5098
352110;201705;555;1896;465;1697;122;459;164;562;286;1021
352115;201705;472;1457;400;1317;50;165;243;806;293;971
352120;201705;862;2677;708;2374;108;449;359;1093;467;1542
352130;201705;1853;5543;1213;3986;282;975;283;897;565;1872
352140;201705;1731;4887;1058;3461;164;581;374;1154;538;1735
352150;201705;776;2277;615;1967;149;502;298;939;447;1441
352160;201705;970;2664;741;2257;172;579;243;665;415;1244
352170;201705;2735;8158;2384;7364;496;1649;1134;3284;1630;4933
352180;201705;3026;8582;2548;7645;669;2125;869;2481;1538;4606
352190;201705;1158;3441;944;3014;138;542;321;861;459;1403
352200;201705;386;1307;295;1106;37;151;103;365;140;516
352210;201705;16590;44244;13614;39840;2116;6647;8500;25040;10616;31687
352215;201705;524;1578;481;1519;54;205;291;887;345;1092
352220;201705;12527;38536;10001;33473;3212;11520;2342;7778;5554;19298
352230;201705;12343;40988;10478;37280;2933;11424;3337;11287;6270;22711
352240;201705;11777;33476;9088;28696;2345;8340;2900;8310;5245;16650
352250;201705;20868;65867;17907;60000;5407;19020;6536;21636;11943;40656
352260;201705;5794;17317;4043;13585;700;2514;1811;6122;2511;8636
352265;201705;881;2712;755;2499;65;287;507;1615;572;1902
352270;201705;1595;5431;1312;4804;334;1284;356;1271;690;2555
352280;201705;2235;6553;1824;5832;288;1100;863;2599;1151;3699
352290;201705;1128;3556;955;3138;168;667;413;1235;581;1902
352300;201705;987;2797;729;2277;136;493;328;915;464;1408
352310;201705;45802;131598;36030;114533;9414;31036;15827;50610;25241;81646
352320;201705;5556;16745;4687;14928;1076;3669;1682;4824;2758;8493
352330;201705;2006;6299;1688;5838;498;1855;550;1853;1048;3708
352340;201705;5051;15689;3868;13445;1067;3971;880;2939;1947;6910
352350;201705;1669;5486;1485;5067;267;1055;560;1759;827;2814
352360;201705;1059;3141;936;2923;157;575;629;1871;786;2446
352370;201705;857;2850;767;2625;84;348;455;1496;539;1844
352380;201705;901;2824;760;2556;217;805;182;575;399;1380
352390;201705;19360;50435;12817;38431;2115;7197;5979;16808;8094;24005
352400;201705;3637;10333;2593;8336;759;2600;796;2372;1555;4972
352410;201705;2853;8423;2394;7667;464;1622;1087;3357;1551;4979
352420;201705;872;2356;697;2020;130;411;272;766;402;1177
352430;201705;6274;18505;5303;16907;1643;5603;1797;5723;3440;11326
352440;201705;16348;49487;13367;43586;2949;10295;5426;17327;8375;27622
352450;201705;628;1906;405;1398;84;322;118;411;202;733
352460;201705;2451;7649;2006;6777;514;1894;593;1867;1107;3761
352470;201705;3849;10635;2844;8793;353;1234;1334;3828;1687;5062
352480;201705;4022;10658;2972;8764;572;1903;1186;3153;1758;5056
352490;201705;674;2301;528;1944;97;383;156;572;253;955
352500;201705;8746;24165;7080;21378;3551;11451;1314;3249;4865;14700
352510;201705;2964;9052;2327;7866;662;2413;648;2160;1310;4573
352520;201705;1998;6869;1761;6291;460;1728;693;2435;1153;4163
352530;201705;8592;26832;6340;21561;1522;5569;878;2451;2400;8020
352540;201705;527;1638;377;1297;64;235;108;367;172;602
352550;201705;837;2697;611;2182;137;542;128;426;265;968
352560;201705;622;1840;434;1401;71;227;104;298;175;525
352570;201705;1821;5797;1310;4683;339;1377;202;593;541;1970
352580;201705;837;2504;654;2124;101;363;222;652;323;1015
352585;201705;267;841;217;729;37;141;80;261;117;402
352590;201705;11928;35918;9577;31321;3228;11234;3340;10049;6568;21283
352600;201705;1812;5479;1459;4681;300;1033;615;1884;915;2917
352610;201705;3280;9941;2607;8720;646;2392;784;2443;1430;4835
352620;201705;5242;15572;4647;14594;1165;3741;2101;6582;3266;10323
352630;201705;611;1874;560;1754;128;481;236;671;364;1152
352640;201705;2593;7585;2163;6834;194;683;1451;4536;1645;5219
352650;201705;758;2279;567;1818;99;349;150;445;249;794
352660;201705;953;3355;807;3028;180;734;240;888;420;1622
352670;201705;10816;31991;6613;22658;1561;5948;480;1577;2041;7525
352680;201705;2993;9680;2273;8098;445;1779;835;2736;1280;4515
352690;201705;31263;84900;22659;67869;2851;9577;11992;34171;14843;43748
352700;201705;585;1738;499;1603;153;544;191;577;344;1121
352710;201705;5487;15658;4075;12846;1014;3547;1399;4182;2413;7729
352720;201705;7847;24633;6873;22502;2461;8244;1724;5442;4185;13686
352725;201705;428;1174;222;726;25;98;95;281;120;379
352730;201705;2213;7119;1994;6532;426;1545;896;2631;1322;4176
352740;201705;2160;5654;1673;4887;205;708;963;2704;1168;3412
352750;201705;462;1314;243;828;32;125;52;158;84;283
352760;201705;1275;4231;1042;3633;269;1015;349;1137;618;2152
352770;201705;771;2378;633;2085;141;504;250;790;391;1294
352780;201705;651;2139;513;1800;105;405;163;554;268;959
352790;201705;639;1797;447;1438;68;227;131;402;199;629
352800;201705;1119;3910;832;3124;175;711;231;794;406;1505
352810;201705;1038;2692;651;1931;129;388;218;619;347;1007
352820;201705;622;1657;438;1368;95;316;98;307;193;623
352830;201705;529;1498;301;949;43;137;45;121;88;258
352840;201705;3914;12884;3499;12028;980;3554;1422;4756;2402;8310
352850;201705;10225;28423;7490;24020;1958;6758;2534;7960;4492;14718
352860;201705;830;2792;758;2623;151;575;303;997;454;1572
352870;201705;897;2257;587;1595;68;227;299;724;367;951
352880;201705;2251;5992;1597;4740;247;777;682;1831;929;2608
352885;201705;260;819;223;746;24;70;147;488;171;558
352890;201705;671;1713;462;1284;65;216;205;498;270;714
352900;201705;19362;55619;14069;44904;2835;9978;5146;15495;7981;25473
352910;201705;385;1090;213;710;22;80;37;105;59;185
352920;201705;2417;7047;1831;5827;312;1113;848;2515;1160;3628
352930;201705;5671;17386;4568;14987;902;3182;1614;5060;2516;8242
352940;201705;21404;67308;17744;59160;5869;21432;1924;5710;7793;27142
352950;201705;371;1058;236;799;49;173;30;93;79;266
352960;201705;609;1800;360;1198;60;230;116;336;176;566
352965;201705;368;1055;230;741;59;203;35;97;94;300
352970;201705;3231;7987;2588;7018;234;686;1809;4893;2043;5579
352980;201705;1126;3521;961;3252;200;703;501;1740;701;2443
352990;201705;4083;12548;3586;11680;886;3253;1599;4916;2485;8169
353000;201705;450;1252;231;757;39;131;48;150;87;281
353010;201705;2941;8018;2137;6461;509;1713;608;1674;1117;3387
353020;201705;4046;10915;2350;7260;333;1116;771;2172;1104;3288
353030;201705;3574;10395;2813;8923;786;2650;535;1641;1321;4291
353040;201705;476;1341;394;1182;77;251;123;341;200;592
353050;201705;4803;15655;3882;13727;1011;3800;1374;4625;2385;8425
353060;201705;42829;122349;36999;112699;3875;14212;25734;75305;29609;89517
353070;201705;10030;30599;7309;24799;1669;6090;1999;6741;3668;12831
353080;201705;4785;14775;3392;11792;810;3086;862;2758;1672;5844
353090;201705;541;1814;491;1696;47;191;304;988;351;1179
353100;201705;295;830;131;447;19;68;23;64;42;132
353110;201705;7344;22288;6409;20772;1099;3935;3986;12944;5085;16879
353120;201705;652;1936;430;1425;81;306;116;342;197;648
353130;201705;2440;6858;1821;5861;567;1968;563;1775;1130;3743
353140;201705;2170;5930;1731;5071;311;997;852;2358;1163;3355
353150;201705;1576;4687;1249;4098;334;1108;356;1164;690;2272
353160;201705;675;1849;439;1389;78;257;143;401;221;658
353170;201705;444;1351;387;1278;86;377;197;587;283;964
353180;201705;8939;24598;7214;21712;1084;3579;4312;12808;5396;16387
353190;201705;3605;10700;2920;9208;443;1570;1525;4483;1968;6053
353200;201705;1115;3681;828;2878;204;772;203;681;407;1453
353205;201705;352;1177;317;1091;78;293;146;494;224;787
353210;201705;1038;2558;669;1872;40;146;414;1109;454;1255
353215;201705;442;1343;359;1151;63;238;121;333;184;571
353220;201705;574;1763;456;1523;111;380;101;331;212;711
353230;201705;702;2247;630;2116;157;583;199;614;356;1197
353240;201705;2099;6559;1804;5985;287;1109;1008;3212;1295;4321
353250;201705;1077;2873;803;2357;119;359;354;1008;473;1367
353260;201705;875;2427;609;1917;125;433;184;541;309;974
353270;201705;628;1846;543;1677;90;275;248;742;338;1017
353280;201705;631;1988;481;1620;115;416;120;381;235;797
353282;201705;1783;5540;1628;5229;224;775;936;2912;1160;3687
353284;201705;374;983;217;660;42;138;56;148;98;286
353286;201705;129;389;93;315;25;86;16;48;41;134
353290;201705;911;2725;720;2349;89;358;402;1198;491;1556
353300;201705;1483;4537;1210;3936;247;935;438;1267;685;2202
353310;201705;242;694;197;627;41;145;83;251;124;396
353320;201705;598;1687;493;1482;62;203;283;825;345;1028
353325;201705;627;2023;494;1725;79;281;146;519;225;800
353330;201705;608;1695;427;1285;51;178;213;591;264;769
353340;201705;2752;7929;1909;6340;554;1941;504;1717;1058;3658
353350;201705;3265;9722;2414;7854;654;2285;538;1612;1192;3897
353360;201705;450;1463;408;1374;51;192;256;850;307;1042
353370;201705;602;1961;522;1786;56;229;294;952;350;1181
353380;201705;316;1046;257;914;51;197;76;261;127;458
353390;201705;5845;15876;4218;12869;863;2732;1486;4409;2349;7141
353400;201705;471;1427;391;1269;72;266;84;208;156;474
353410;201705;604;1756;504;1564;99;356;246;719;345;1075
353420;201705;586;1646;370;1148;93;280;67;196;160;476
353430;201705;2138;7047;1614;5786;423;1635;302;1020;725;2655
353440;201705;56557;174968;44045;147700;11507;40248;15964;52085;27471;92333
353450;201705;408;1185;303;948;56;204;106;305;162;509
353460;201705;3230;9175;2501;7764;293;1075;1097;3412;1390;4487
353470;201705;7328;21745;5464;18058;1235;4531;1395;4336;2630;8867
353475;201705;1440;4079;1071;3255;165;542;375;1039;540;1581
353480;201705;1364;4140;1216;3842;128;430;863;2676;991;3106
353490;201705;918;2680;685;2160;145;447;253;759;398;1206
353500;201705;999;2628;821;2338;214;614;422;1192;636;1806
353510;201705;901;2868;672;2284;180;632;104;313;284;945
353520;201705;1124;3132;809;2578;116;411;373;1140;489;1551
353530;201705;2450;7035;2103;6396;286;1003;1126;3286;1412;4289
353540;201705;1979;5966;1673;5413;378;1286;761;2417;1139;3703
353550;201705;6097;17012;4945;15002;696;2416;2753;7894;3449;10310
353560;201705;2063;6707;1696;6037;533;2062;405;1346;938;3408
353570;201705;517;1505;381;1236;88;276;172;551;260;827
353580;201705;2353;6780;2022;6195;347;1167;1207;3620;1554;4787
353590;201705;675;1985;469;1515;95;336;172;542;267;878
353600;201705;1785;4894;1554;4450;203;645;808;2214;1011;2859
353610;201705;608;2064;459;1728;93;376;89;317;182;693
353620;201705;2269;7027;1851;6185;463;1629;484;1493;947;3122
353625;201705;458;1269;282;897;37;139;130;394;167;533
353630;201705;1391;4802;1088;4027;213;849;153;495;366;1344
353640;201705;1401;4004;1065;3311;140;494;544;1647;684;2141
353650;201705;8673;25125;6548;20692;1132;3766;2719;8263;3851;12029
353657;201705;301;924;253;832;41;154;85;241;126;395
353660;201705;1042;2724;766;2202;231;731;165;375;396;1106
353670;201705;3486;11044;2944;9928;850;3170;1104;3461;1954;6631
353680;201705;678;2108;547;1875;156;588;201;655;357;1243
353690;201705;514;1361;257;848;34;112;42;111;76;223
353700;201705;1998;5981;1719;5432;244;854;942;2824;1186;3678
353710;201705;3378;8029;1661;5208;354;1079;411;1260;765;2339
353715;201705;533;1502;378;1188;29;108;108;318;137;426
353720;201705;1930;5844;1621;5368;320;1181;824;2625;1144;3806
353730;201705;4281;12780;3351;10759;604;2134;1267;3719;1871;5853
353740;201705;1726;5013;1277;4132;333;1185;334;1018;667;2203
353750;201705;863;2905;649;2411;141;572;147;541;288;1113
353760;201705;10443;27717;8497;25037;1253;4179;5323;15396;6576;19575
353770;201705;659;2043;351;1250;66;271;31;71;97;342
353780;201705;4053;13761;3519;12620;1070;4095;835;2913;1905;7008
353790;201705;2196;7358;1788;6480;478;2007;450;1488;928;3495
353800;201705;16195;48649;12961;42778;3040;10819;5156;16756;8196;27575
353810;201705;987;3156;769;2671;147;592;241;797;388;1389
353820;201705;1431;4693;1240;4220;234;914;577;1863;811;2777
353830;201705;630;1691;497;1469;69;208;258;730;327;938
353850;201705;1650;5065;1405;4537;384;1282;492;1567;876;2849
353860;201705;2524;8106;2076;7106;577;2084;559;1900;1136;3984
353870;201705;27916;80186;19764;63630;3519;12626;7331;21488;10850;34114
353880;201705;2739;8536;2317;7757;322;1251;1254;4092;1576;5343
353890;201705;2353;5798;1655;4649;247;779;876;2340;1123;3119
353900;201705;805;2482;604;2082;132;487;166;560;298;1047
353910;201705;1852;6538;1717;6306;236;852;1206;4562;1442;5414
353920;201705;2284;6671;1583;5234;342;1245;282;826;624;2071
353930;201705;4484;13365;3196;10942;839;3143;504;1665;1343;4808
353940;201705;1118;3591;847;2941;160;595;251;823;411;1418
353950;201705;3128;9692;2642;8701;526;1888;1256;3859;1782;5747
353960;201705;571;1775;404;1396;82;275;103;348;185;623
353970;201705;594;1651;481;1462;54;176;294;876;348;1052
353980;201705;13620;39727;11413;35582;2219;7310;5781;17573;8000;24883
353990;201705;441;1328;393;1228;49;177;219;660;268;837
354000;201705;2336;6305;1426;4498;266;900;190;588;456;1488
354010;201705;364;1088;304;977;56;191;179;575;235;766
354020;201705;4045;12538;3452;11260;888;3142;1038;3087;1926;6229
354025;201705;850;2383;596;1895;122;404;189;607;311;1011
354030;201705;478;1267;301;915;42;139;125;358;167;497
354040;201705;775;2060;514;1546;42;147;306;853;348;1000
354050;201705;928;2892;714;2450;186;694;136;432;322;1126
354060;201705;4770;14598;3290;11247;856;3030;823;2644;1679;5674
354070;201705;2731;9000;2275;7938;590;2215;448;1440;1038;3655
354075;201705;1938;6958;1739;6491;361;1515;854;3072;1215;4587
354080;201705;1373;4143;957;3223;162;573;301;938;463;1511
354085;201705;334;806;306;767;9;40;246;597;255;637
354090;201705;1336;3923;1263;3781;128;438;860;2556;988;2994
354100;201705;14153;46813;11710;42063;2943;11364;4821;16908;7764;28272
354105;201705;927;2643;804;2459;120;388;518;1583;638;1971
354110;201705;688;1859;531;1634;176;603;115;310;291;913
354120;201705;1908;5260;1342;4094;223;744;528;1476;751;2220
354130;201705;6214;17633;4481;14251;1584;5361;292;758;1876;6119
354140;201705;25979;65207;16509;48245;3411;10694;4783;13052;8194;23746
354150;201705;3818;10086;2865;8372;562;1765;1165;3278;1727;5043
354160;201705;3332;10607;2603;8950;689;2489;816;2758;1505;5247
354165;201705;525;1687;442;1519;103;395;196;660;299;1055
354170;201705;1378;4294;1094;3615;158;570;496;1566;654;2136
354180;201705;468;1438;394;1269;63;233;158;437;221;670
354190;201705;1478;4606;1198;4004;241;892;381;1242;622;2134
354200;201705;951;2624;739;2239;84;279;356;997;440;1276
354210;201705;632;1969;519;1758;71;289;280;874;351;1163
354220;201705;3005;8579;2474;7563;456;1505;1219;3604;1675;5109
354230;201705;608;1949;547;1822;91;365;265;807;356;1172
354240;201705;1216;3943;908;3224;171;662;200;668;371;1330
354250;201705;663;1830;430;1433;127;441;108;384;235;825
354260;201705;7392;21718;6006;19282;1584;5368;1869;6195;3453;11563
354270;201705;1141;3719;933;3269;184;694;317;1098;501;1792
354280;201705;684;1982;610;1851;109;410;357;995;466;1405
354290;201705;908;3166;812;2926;166;626;332;1186;498;1812
354300;201705;3775;12026;3469;11445;1009;3462;1488;4776;2497;8238
354310;201705;799;2420;648;2118;135;456;321;1036;456;1492
354320;201705;734;2174;576;1856;124;468;210;608;334;1076
354323;201705;486;1300;354;1047;57;169;142;386;199;555
354325;201705;1214;3903;909;3196;158;585;317;1033;475;1618
354330;201705;6441;18762;5072;16076;986;3593;2396;6982;3382;10575
354340;201705;23494;70579;18991;62612;5242;18725;6883;21996;12125;40721
354350;201705;1070;3139;946;2886;193;670;521;1480;714;2150
354360;201705;452;1411;281;1017;43;141;20;74;63;215
354370;201705;1097;3627;935;3286;112;478;506;1724;618;2202
354380;201705;788;2361;592;1960;165;635;102;289;267;924
354390;201705;13288;37576;9049;29478;1827;6413;1840;5844;3667;12257
354400;201705;1581;5438;1280;4686;266;1049;375;1356;641;2405
354410;201705;5307;16049;4355;14187;1084;3830;1712;5372;2796;9202
354420;201705;1223;3634;887;2857;176;608;380;1184;556;1792
354425;201705;2132;6077;1803;5428;537;1686;484;1479;1021;3165
354430;201705;1336;4269;1191;3982;237;893;526;1695;763;2588
354440;201705;563;1644;390;1271;45;162;163;486;208;648
354450;201705;403;1174;242;808;32;118;43;136;75;254
354460;201705;992;2735;684;2119;122;411;296;921;418;1332
354470;201705;593;1560;463;1306;37;136;227;572;264;708
354480;201705;729;1998;585;1752;66;205;345;996;411;1201
354490;201705;733;2409;600;2086;81;316;264;877;345;1193
354500;201705;2103;6629;1852;6224;660;2485;407;1329;1067;3814
354510;201705;822;2264;751;2130;96;249;449;1259;545;1508
354515;201705;251;823;198;703;39;151;69;244;108;395
354520;201705;8000;25613;4624;15798;822;3233;2000;6305;2822;9538
354530;201705;3267;10882;2869;10021;720;2736;1142;3890;1862;6626
354540;201705;1181;3525;939;3067;293;1017;217;712;510;1729
354550;201705;476;1382;379;1203;81;280;188;573;269;853
354560;201705;1775;4876;1045;3235;151;498;454;1319;605;1817
354570;201705;1089;3027;500;1596;82;287;78;217;160;504
354580;201705;10587;29365;7325;23317;1272;4417;2837;8512;4109;12929
354600;201705;1618;5130;1369;4651;241;940;717;2364;958;3304
354610;201705;363;1055;207;686;27;96;62;190;89;286
354620;201705;400;1250;314;1093;57;245;141;449;198;694
354625;201705;304;931;191;659;29;111;45;119;74;230
354630;201705;2150;7015;1860;6410;748;2728;237;781;985;3509
354640;201705;3149;10299;2425;8570;506;2025;458;1460;964;3485
354650;201705;867;2542;740;2278;87;293;480;1482;567;1775
354660;201705;2408;6572;1738;5423;138;510;1119;3434;1257;3944
354670;201705;1109;3391;843;2751;207;738;207;609;414;1347
354680;201705;4408;14004;3995;13188;1056;3663;1868;6090;2924;9753
354690;201705;755;2425;515;1840;98;379;119;395;217;774
354700;201705;1080;3020;751;2304;151;542;307;825;458;1367
354710;201705;517;1511;380;1217;29;118;179;508;208;626
354720;201705;261;703;144;454;45;145;20;60;65;205
354730;201705;8965;27515;6742;23208;1273;4839;3148;10441;4421;15280
354740;201705;285;850;134;489;14;66;22;78;36;144
354750;201705;2453;7264;1781;5965;398;1511;653;2033;1051;3544
354760;201705;1836;5741;1464;4961;477;1719;227;779;704;2498
354765;201705;299;835;142;479;16;57;24;77;40;134
354770;201705;2313;6298;1718;5257;516;1695;546;1600;1062;3295
354780;201705;55949;152711;46440;133196;7083;22862;25051;67596;32134;90458
354790;201705;816;2642;715;2435;114;404;356;1182;470;1586
354800;201705;2371;6776;1996;6212;432;1477;975;2942;1407;4419
354805;201705;1013;2976;746;2400;92;343;237;663;329;1006
354810;201705;558;1784;350;1299;61;255;64;225;125;480
354820;201705;935;3147;781;2810;158;646;176;567;334;1213
354830;201705;455;1193;325;959;102;308;113;314;215;622
354840;201705;708;2012;516;1604;91;290;249;750;340;1040
354850;201705;17112;51133;12634;42258;2393;9052;5873;18284;8266;27336
354860;201705;1339;4102;1108;3722;258;988;400;1223;658;2211
354870;201705;46131;131323;40000;119221;7892;25627;19051;54908;26943;80535
354880;201705;4398;12028;2382;7535;335;1232;785;2112;1120;3344
354890;201705;15429;44039;12947;39561;2623;8738;5978;17581;8601;26319
354900;201705;467;1378;318;1056;52;186;78;247;130;433
354910;201705;6136;18107;3684;12929;670;2638;194;622;864;3260
354920;201705;381;1123;232;799;40;164;47;146;87;310
354925;201705;229;715;124;451;28;103;18;53;46;156
354930;201705;318;820;179;571;25;76;75;240;100;316
354940;201705;1657;5914;1368;5146;477;1915;137;477;614;2392
354950;201705;1460;4524;1222;4114;160;682;703;2242;863;2924
354960;201705;781;2288;651;2086;119;427;303;930;422;1357
354970;201705;3895;12483;3371;11399;560;2168;1811;5871;2371;8039
354980;201705;27427;71351;18492;55708;2989;10394;7938;22002;10927;32396
354990;201705;56118;159418;43703;135409;6790;22912;22023;65887;28813;88799
354995;201705;1892;5578;1547;5007;354;1227;792;2502;1146;3729
355000;201705;1335;4252;1185;3975;305;1173;223;625;528;1798
355010;201705;3345;10317;2502;8272;802;2844;455;1518;1257;4362
355020;201705;2952;9522;2271;8127;772;3028;578;1987;1350;5015
355030;201705;1210942;3199648;981721;2758095;202061;619412;439259;1167781;641320;1787193
355040;201705;2617;7879;2320;7361;387;1315;1451;4541;1838;5856
355050;201705;1065;3142;819;2655;242;786;140;450;382;1236
355060;201705;4464;14241;3603;12453;736;2891;1282;4021;2018;6912
355070;201705;6951;20814;5983;19175;1090;3983;3113;9342;4203;13325
355080;201705;865;2894;604;2286;105;456;36;128;141;584
355090;201705;1087;3622;908;3243;173;656;306;1076;479;1732
355100;201705;16202;49202;13472;44522;3149;11416;6970;22444;10119;33860
355110;201705;1129;3619;949;3284;306;1145;181;595;487;1740
355120;201705;618;1875;482;1608;87;335;190;608;277;943
355130;201705;642;1616;293;865;42;133;88;237;130;370
355140;201705;1163;3736;1071;3575;205;771;627;2121;832;2892
355150;201705;3566;10271;2904;9113;581;1967;1382;4312;1963;6279
355160;201705;1748;5417;1436;4863;409;1522;350;1131;759;2653
355170;201705;8148;23078;6438;20237;2099;6931;2002;6435;4101;13366
355180;201705;2728;8385;2177;7356;522;2125;688;2087;1210;4212
355190;201705;1453;4415;1218;3978;379;1348;411;1424;790;2772
355200;201705;764;2671;693;2514;299;1157;153;514;452;1671
355210;201705;2796;8529;2473;7833;298;1130;1567;4735;1865;5865
355220;201705;37558;111292;30723;97608;9527;32117;8460;24857;17987;56974
355230;201705;1451;3863;849;2608;161;486;196;553;357;1039
355240;201705;23962;67953;16753;53169;3601;12151;5736;17861;9337;30012
355250;201705;29983;90576;24502;80142;6704;23569;8322;26588;15026;50157
355255;201705;876;2388;530;1679;103;342;150;476;253;818
355260;201705;1215;3556;1008;3193;193;704;478;1396;671;2100
355270;201705;1573;4865;1325;4296;264;939;596;1777;860;2716
355280;201705;27558;78002;21870;66833;4083;13695;9254;27098;13337;40793
355290;201705;879;2755;692;2292;155;516;205;637;360;1153
355300;201705;1317;4172;1088;3675;241;876;301;987;542;1863
355310;201705;1013;2985;801;2609;121;442;420;1379;541;1821
355320;201705;583;1767;508;1610;101;377;198;543;299;920
355330;201705;1910;5740;1417;4761;265;983;669;2148;934;3131
355340;201705;2815;7011;2497;6529;352;917;1605;4173;1957;5090
355350;201705;1325;4318;1029;3666;235;922;298;1043;533;1965
355360;201705;1186;3634;1055;3337;165;543;672;2174;837;2717
355365;201705;336;988;206;727;47;160;35;117;82;277
355370;201705;6860;17540;5356;15559;1240;3820;2366;7267;3606;11087
355380;201705;3124;9153;2464;7759;519;1741;629;1750;1148;3491
355385;201705;1034;3271;929;3059;239;852;345;1069;584;1921
355390;201705;799;2316;602;1904;121;420;220;606;341;1026
355395;201705;1879;5642;1392;4498;209;683;588;1818;797;2501
355400;201705;9231;29905;7894;27117;2414;8950;2117;6930;4531;15880
355410;201705;18875;58613;14620;50102;4143;15545;2839;9825;6982;25370
355420;201705;717;2520;637;2347;173;748;170;611;343;1359
355430;201705;3755;10070;2997;8756;548;1748;1466;4163;2014;5911
355440;201705;893;2697;632;2100;121;409;178;546;299;955
355450;201705;3834;10849;2289;7461;455;1568;671;2023;1126;3591
355460;201705;567;1523;368;1155;64;236;133;357;197;593
355465;201705;346;1100;266;912;56;206;67;209;123;415
355470;201705;876;2580;602;1993;164;567;202;649;366;1216
355475;201705;185;547;177;528;29;110;126;353;155;463
355480;201705;3038;10266;2748;9683;580;2255;1410;4854;1990;7109
355490;201705;1012;2885;631;2053;87;295;202;623;289;918
355495;201705;784;2550;662;2290;140;541;181;588;321;1129
355500;201705;6990;20390;4640;15087;835;2926;922;2795;1757;5721
355510;201705;1866;4939;1016;3227;144;513;274;772;418;1285
355520;201705;423;986;210;578;23;71;100;252;123;323
355530;201705;449;1044;175;535;21;78;42;109;63;187
355535;201705;625;1864;498;1634;146;546;140;395;286;941
355540;201705;8090;24846;7519;23908;1725;5839;4098;12719;5823;18558
355550;201705;736;2244;601;1970;102;370;227;728;329;1098
355560;201705;1161;3468;698;2405;142;538;47;142;189;680
355570;201705;208;660;124;446;23;92;21;69;44;161
355580;201705;1217;3356;827;2614;135;491;320;974;455;1465
355590;201705;213;567;166;484;20;68;95;266;115;334
355600;201705;1357;3863;1008;3139;291;997;314;937;605;1934
355610;201705;1659;4554;1224;3731;213;702;535;1575;748;2277
355620;201705;4413;13493;3530;11458;549;2066;1650;4878;2199;6944
355630;201705;2720;7891;1858;6198;399;1369;550;1886;949;3255
355635;201705;947;2977;809;2753;94;350;547;1903;641;2253
355640;201705;2804;8861;2036;7300;457;1740;344;1235;801;2975
355645;201705;3894;12432;3331;11525;476;1938;1993;6780;2469;8718
355650;201705;7212;21251;6240;19423;1251;4454;3571;10312;4822;14766
355660;201705;1304;3960;1038;3373;150;601;516;1511;666;2112
355670;201705;2931;9045;2137;7107;372;1414;918;2706;1290;4120
355680;201705;1612;5255;1124;4029;291;1112;152;521;443;1633
355690;201705;501;1569;354;1267;116;435;20;47;136;482
355695;201705;247;801;148;525;12;46;16;50;28;96
355700;201705;5588;17812;4744;15912;1216;4154;1866;6128;3082;10282
355710;201705;9522;23490;5709;16517;1136;3497;1556;4237;2692;7734
355715;201705;331;962;219;715;58;203;44;138;102;341
355720;201705;1468;4763;1221;4218;268;983;428;1322;696;2305
355730;201705;866;2794;730;2469;222;752;205;659;427;1411
410010;201705;1333;4100;1108;3569;263;950;185;586;448;1536
410020;201705;1171;3718;982;3299;291;970;328;1102;619;2072
410030;201705;1120;3716;921;3256;249;911;178;650;427;1561
410040;201705;9789;31363;8406;28750;1940;7342;2711;9178;4651;16520
410045;201705;1061;2925;732;2297;144;504;192;549;336;1053
410050;201705;2697;7249;1718;5397;437;1465;210;579;647;2044
410060;201705;2222;6684;1870;5962;401;1301;736;2370;1137;3671
410070;201705;1705;4748;1289;3919;333;1102;389;1159;722;2261
410080;201705;1412;3972;1099;3394;193;680;440;1283;633;1963
410090;201705;1006;3033;937;2894;177;588;426;1365;603;1953
410100;201705;2632;8012;1967;6401;341;1297;274;839;615;2136
410105;201705;358;1095;226;771;36;156;37;104;73;260
410110;201705;3014;8548;2331;7180;370;1277;754;2258;1124;3535
410115;201705;542;1453;410;1209;77;248;141;378;218;626
410120;201705;2470;8420;2276;8022;867;3241;558;1977;1425;5218
410130;201705;1092;3370;1024;3217;384;1321;259;698;643;2019
410140;201705;17540;45012;11369;33943;2301;7514;2463;6881;4764;14395
410150;201705;15605;39860;8347;24882;1618;5164;1315;3715;2933;8879
410160;201705;2925;8887;2605;8280;601;2140;954;3074;1555;5214
410165;201705;709;2066;568;1736;87;279;272;778;359;1057
410170;201705;2270;6430;1686;5113;445;1489;242;686;687;2175
410180;201705;11623;36127;9927;32286;1982;6964;4465;13598;6447;20562
410185;201705;531;1468;394;1199;86;269;86;238;172;507
410190;201705;2042;5914;1632;5037;353;1195;293;843;646;2038
410200;201705;3912;10636;2740;8371;571;2012;432;1270;1003;3282
410210;201705;2636;7701;1869;6000;310;1133;404;1070;714;2203
410220;201705;662;1776;487;1457;79;279;133;400;212;679
410230;201705;1497;4612;1279;4151;267;981;525;1632;792;2613
410240;201705;4288;12827;3829;11869;1204;4249;554;1649;1758;5898
410250;201705;2727;7386;1907;5762;424;1377;390;1171;814;2548
410260;201705;1623;4533;1261;3929;264;913;533;1650;797;2563
410270;201705;573;1581;445;1322;50;166;202;583;252;749
410275;201705;774;2357;517;1732;82;305;216;719;298;1024
410280;201705;2154;6185;1545;4907;330;1170;414;1203;744;2373
410290;201705;3384;10056;2769;8868;592;1959;1075;3441;1667;5400
410300;201705;733;2015;582;1702;109;356;242;625;351;981
410302;201705;448;1224;255;827;26;88;134;440;160;528
410304;201705;1235;3876;1119;3619;282;969;450;1483;732;2452
410305;201705;1884;4986;1465;4274;361;1103;664;1918;1025;3021
410310;201705;2292;7193;2009;6690;442;1645;677;2249;1119;3894
410315;201705;682;1898;429;1416;75;274;127;394;202;668
410320;201705;1186;3597;792;2672;115;441;94;298;209;739
410322;201705;575;1669;328;1090;51;169;76;246;127;415
410330;201705;1360;3740;1082;3187;254;791;263;769;517;1560
410335;201705;925;2685;783;2401;124;435;332;926;456;1361
410337;201705;801;2098;575;1675;92;295;201;547;293;842
410340;201705;552;1560;373;1111;56;192;144;359;200;551
410345;201705;1997;5605;1281;4067;291;951;306;932;597;1883
410347;201705;726;1933;526;1557;58;207;157;433;215;640
410350;201705;1160;3429;865;2827;148;533;222;662;370;1195
410360;201705;3998;10493;3107;8910;344;1162;1676;4651;2020;5813
410370;201705;11849;34306;8468;26223;1453;4994;2539;6889;3992;11883
410380;201705;1360;3888;1200;3532;149;552;503;1406;652;1958
410390;201705;2477;7224;1854;5916;569;1920;369;1074;938;2994
410395;201705;933;2961;790;2664;193;722;336;1143;529;1865
410400;201705;4397;13445;3561;11628;706;2490;1305;4092;2011;6582
410405;201705;829;2316;676;2038;163;551;257;731;420;1282
410410;201705;1216;3716;1178;3665;278;1065;623;1856;901;2921
410420;201705;6779;21681;5512;18828;1355;5096;847;2559;2202;7655
410425;201705;2700;8485;2049;7056;392;1456;364;1160;756;2616
410430;201705;13901;37165;10129;30193;1854;6068;2913;8246;4767;14314
410440;201705;3032;10384;2727;9776;530;1962;1396;5275;1926;7237
410442;201705;2612;8551;2280;7816;695;2526;629;2107;1324;4633
410445;201705;2347;7451;1984;6754;486;1823;627;2209;1113;4032
410450;201705;1925;5441;1473;4528;348;1176;201;463;549;1639
410460;201705;1670;4847;1312;4180;357;1200;306;919;663;2119
410465;201705;2316;7424;1933;6588;435;1500;658;2161;1093;3661
410470;201705;1809;5674;1413;4776;304;1154;274;920;578;2074
410480;201705;31501;87228;19034;61366;3084;10785;1637;4733;4721;15518
410490;201705;11460;34304;8510;28024;1854;6734;2287;6995;4141;13729
410500;201705;1572;4870;1224;4063;388;1442;162;453;550;1895
410510;201705;2446;6426;1649;4829;306;904;523;1450;829;2354
410520;201705;3055;10392;2854;9985;797;2901;1296;4588;2093;7489
410530;201705;1541;4238;958;2906;178;572;148;373;326;945
410540;201705;2909;8666;2062;6857;386;1343;708;2437;1094;3780
410550;201705;6291;17988;4448;14021;910;3151;630;1777;1540;4928
410560;201705;1293;3767;1009;3207;258;896;325;940;583;1836
410570;201705;2608;8095;2280;7529;625;2271;607;2181;1232;4452
410580;201705;22509;65982;18279;57618;4126;14511;6057;17803;10183;32314
410590;201705;1361;4160;891;2912;161;551;192;552;353;1103
410600;201705;1849;5314;1466;4564;357;1113;477;1525;834;2638
410610;201705;765;2138;591;1809;67;227;217;632;284;859
410620;201705;1786;5879;1276;4608;319;1256;130;410;449;1666
410630;201705;2442;7233;1677;5472;352;1268;161;419;513;1687
410640;201705;4465;12048;3271;9810;829;2848;494;1373;1323;4221
410645;201705;1132;3813;1047;3666;450;1649;250;937;700;2586
410650;201705;2103;6472;1688;5556;523;1812;300;930;823;2742
410655;201705;1364;4897;1125;4427;65;247;728;3165;793;3412
410657;201705;783;2144;538;1629;118;396;175;457;293;853
410660;201705;3025;8406;1672;5370;335;1109;182;582;517;1691
410670;201705;919;2502;628;1879;123;381;232;664;355;1045
410680;201705;2877;9169;2215;7530;658;2225;488;1775;1146;4000
410685;201705;638;1788;538;1610;91;317;295;845;386;1162
410690;201705;117311;331904;82564;259420;15916;55392;21121;58532;37037;113924
410700;201705;2127;6233;1933;5846;455;1445;853;2454;1308;3899
410710;201705;920;2640;607;1963;138;458;162;472;300;930
410712;201705;810;2392;696;2177;230;785;251;784;481;1569
410715;201705;898;2862;635;2211;136;492;156;537;292;1029
410720;201705;3011;8966;2339;7573;416;1477;406;1162;822;2639
410725;201705;1105;3072;759;2392;133;434;117;333;250;767
410730;201705;516;1474;400;1254;107;362;76;240;183;602
410740;201705;895;2625;638;2101;116;430;250;810;366;1240
410750;201705;1847;5324;1515;4639;307;1021;486;1401;793;2422
410752;201705;312;818;148;453;27;84;41;102;68;186
410753;201705;357;1053;218;728;30;105;39;119;69;224
410754;201705;1201;3382;1035;3118;66;198;642;2131;708;2329
410755;201705;810;1998;591;1639;69;229;322;829;391;1058
410760;201705;2623;7664;2206;6931;579;1985;646;2023;1225;4008
410765;201705;14713;43999;11413;37565;1985;7374;1053;3296;3038;10670
410770;201705;913;2467;639;1939;132;419;151;447;283;866
410773;201705;1342;3757;1192;3536;187;647;833;2405;1020;3052
410775;201705;1431;4036;1291;3822;297;966;434;1262;731;2228
410780;201705;564;1538;374;1131;88;270;100;329;188;599
410785;201705;785;2402;662;2140;173;618;176;538;349;1156
410790;201705;443;1441;381;1275;121;423;34;90;155;513
410800;201705;2912;7153;2306;6143;274;829;911;2328;1185;3157
410810;201705;340;1021;274;888;42;156;114;367;156;523
410820;201705;791;2347;570;1833;128;437;79;253;207;690
410830;201705;29870;83323;23611;72274;6447;21798;7411;21725;13858;43523
410832;201705;1025;2927;878;2632;107;396;497;1409;604;1805
410840;201705;6789;19312;4432;14408;1043;3713;412;1084;1455;4797
410845;201705;1204;3539;991;3107;203;698;365;1103;568;1801
410850;201705;2641;7835;2315;7270;504;1772;861;2726;1365;4498
410855;201705;580;1598;427;1286;70;233;165;467;235;700
410860;201705;3896;10911;3111;9332;570;1870;962;2741;1532;4611
410865;201705;1479;4803;1404;4668;352;1232;751;2592;1103;3824
410870;201705;1250;3684;1137;3514;116;396;774;2420;890;2816
410880;201705;3686;11564;3059;10243;609;2225;443;1546;1052;3771
410890;201705;919;2946;708;2478;176;679;112;372;288;1051
410895;201705;1066;3632;945;3350;370;1419;178;590;548;2009
410900;201705;929;2547;622;1930;88;288;174;489;262;777
410910;201705;387;998;267;773;25;90;134;357;159;447
410920;201705;835;2317;670;2037;170;583;214;653;384;1236
410930;201705;1566;4636;1288;4057;360;1314;307;912;667;2226
410940;201705;21270;66433;17659;59451;5427;19784;3250;11159;8677;30943
410950;201705;1814;5737;1675;5504;124;459;1297;4229;1421;4688
410960;201705;7685;20916;4807;15466;1346;4767;1092;3397;2438;8164
410965;201705;1075;3131;835;2630;205;676;291;846;496;1522
410970;201705;4171;12175;3220;10293;833;3073;495;1457;1328;4530
410975;201705;1580;4396;1222;3699;222;769;414;1230;636;1999
410980;201705;6283;17497;4179;13369;683;2438;1352;4154;2035;6592
410990;201705;1007;2910;651;2133;192;711;98;256;290;967
411000;201705;484;1449;349;1145;57;210;65;175;122;385
411005;201705;473;1386;299;976;51;187;50;150;101;337
411007;201705;2331;7225;2044;6644;524;1813;607;1960;1131;3773
411010;201705;4039;13427;3624;12500;1056;3896;403;1315;1459;5211
411020;201705;2464;7409;2129;6817;633;2184;631;1949;1264;4133
411030;201705;683;1821;461;1332;71;232;135;341;206;573
411040;201705;765;2174;342;1099;63;210;56;174;119;384
411050;201705;1938;6626;1714;6141;526;2034;243;764;769;2798
411060;201705;1583;4689;1177;3811;243;937;160;478;403;1415
411065;201705;328;959;260;828;56;187;97;312;153;499
411070;201705;6259;18137;5014;15681;1142;3923;1426;4182;2568;8105
411080;201705;2175;6335;1887;5815;454;1556;548;1686;1002;3242
411090;201705;827;2147;574;1700;69;232;91;247;160;479
411095;201705;1456;3974;1077;3214;174;566;302;831;476;1397
411100;201705;1171;3410;846;2697;123;473;210;659;333;1132
411110;201705;571;1653;290;991;28;101;18;48;46;149
411120;201705;1593;4768;1205;3887;343;1283;251;692;594;1975
411125;201705;4214;13495;3956;12980;987;3389;1557;5185;2544;8574
411130;201705;698;2020;507;1614;128;415;139;477;267;892
411140;201705;2228;7369;1888;6561;458;1655;762;2712;1220;4367
411150;201705;3961;11032;2956;9025;650;2186;288;734;938;2920
411155;201705;977;2663;688;2113;87;288;285;817;372;1105
411160;201705;278;777;213;646;41;125;44;139;85;264
411170;201705;745;2300;597;1957;131;450;202;660;333;1110
411180;201705;5597;16344;4545;14331;924;3180;1547;4889;2471;8069
411190;201705;1417;4018;1147;3449;281;913;242;641;523;1554
411200;201705;4473;12972;3503;11243;926;3224;992;3079;1918;6303
411210;201705;1991;5548;1585;4817;419;1442;191;522;610;1964
411220;201705;933;2639;777;2333;175;599;293;809;468;1408
411230;201705;1251;3440;808;2574;177;592;199;620;376;1212
411240;201705;1587;3761;883;2541;132;403;368;997;500;1400
411250;201705;1991;5816;1623;5137;428;1495;452;1421;880;2916
411260;201705;344;893;218;665;30;94;86;244;116;338
411270;201705;1762;5398;1527;4915;241;900;710;2188;951;3088
411275;201705;1351;3838;1041;3177;229;744;258;721;487;1465
411280;201705;1553;4419;1006;3210;186;668;182;525;368;1193
411290;201705;722;2090;538;1727;115;387;185;585;300;972
411295;201705;983;2701;867;2478;148;473;325;918;473;1391
411300;201705;1192;3028;786;2245;74;235;280;717;354;952
411310;201705;826;2237;652;1934;48;161;213;624;261;785
411320;201705;5142;14743;3720;12051;943;3141;706;2156;1649;5297
411325;201705;1522;4755;1348;4391;268;921;656;2169;924;3090
411330;201705;3040;9324;2483;8195;723;2625;586;1978;1309;4603
411340;201705;788;2353;516;1685;47;184;201;624;248;808
411342;201705;695;1934;569;1688;149;464;175;484;324;948
411345;201705;967;2886;843;2651;193;673;392;1225;585;1898
411350;201705;2792;8208;2048;6661;556;2000;199;638;755;2638
411360;201705;591;1470;407;1175;48;167;143;373;191;540
411370;201705;46213;127987;36513;110011;4860;16888;17159;48177;22019;65065
411373;201705;1420;4245;1222;3889;231;846;362;1164;593;2010
411375;201705;1131;3072;831;2496;159;537;249;685;408;1222
411380;201705;1079;2942;685;2032;118;356;218;600;336;956
411390;201705;1767;5154;1379;4259;273;920;396;1107;669;2027
411400;201705;2159;5948;1714;5057;338;1109;537;1495;875;2604
411410;201705;2092;6262;1582;5106;373;1331;324;918;697;2249
411420;201705;4006;11098;2692;8407;423;1481;418;1049;841;2530
411430;201705;3322;9717;2757;8779;613;2117;1270;3985;1883;6102
411435;201705;485;1484;369;1228;79;276;136;414;215;690
411440;201705;2817;8788;2438;7995;666;2290;551;1904;1217;4194
411450;201705;2476;7258;2125;6647;447;1422;1017;3306;1464;4728
411460;201705;3602;10309;1945;6569;323;1263;147;461;470;1724
411470;201705;786;2314;540;1744;86;300;105;310;191;610
411480;201705;4510;13461;3349;11144;759;2783;582;1822;1341;4605
411490;201705;1433;4217;1166;3725;224;815;309;886;533;1701
411500;201705;1847;4862;1300;3891;238;810;380;1117;618;1927
411510;201705;2024;5955;1670;5227;407;1400;296;929;703;2329
411520;201705;25926;70076;15908;49105;2642;8844;3606;10071;6248;18915
411530;201705;968;2684;689;2170;121;434;221;666;342;1100
411535;201705;484;1453;223;800;23;106;13;31;36;137
411540;201705;3029;8093;2193;6371;463;1457;597;1584;1060;3041
411545;201705;1013;3207;884;2949;117;424;549;1882;666;2306
411550;201705;754;2032;617;1808;155;493;92;261;247;754
411560;201705;2233;6512;1504;4873;224;799;105;262;329;1061
411570;201705;7179;18651;5179;15422;1151;3901;1149;3499;2300;7400
411573;201705;834;2388;768;2279;82;263;486;1450;568;1713
411575;201705;1628;4973;1376;4465;324;1116;426;1378;750;2494
411580;201705;4011;11162;2609;8402;320;1244;336;935;656;2179
411585;201705;815;2555;405;1416;71;255;55;161;126;416
411590;201705;365;1085;309;983;43;153;139;409;182;562
411600;201705;320;880;222;725;49;190;84;269;133;459
411605;201705;1668;4564;1105;3374;173;606;410;1190;583;1796
411610;201705;2226;6226;1694;5135;371;1198;606;1783;977;2981
411620;201705;2831;8600;2548;8139;524;1838;1331;4224;1855;6062
411630;201705;573;1530;374;1197;80;297;50;130;130;427
411640;201705;471;1426;350;1128;47;147;110;341;157;488
411650;201705;218;666;159;545;31;110;22;73;53;183
411660;201705;931;2462;666;1981;74;235;322;932;396;1167
411670;201705;1089;3051;861;2547;158;493;286;814;444;1307
411680;201705;1540;4499;1302;4045;240;828;620;1919;860;2747
411690;201705;3372;9782;2649;8401;567;1852;682;2265;1249;4117
411695;201705;712;2274;543;1865;96;353;178;636;274;989
411700;201705;1633;4675;1136;3678;230;823;157;467;387;1290
411705;201705;1811;6225;1598;5798;390;1414;786;3022;1176;4436
411710;201705;1688;4876;1347;4196;349;1171;225;718;574;1889
411720;201705;930;2552;733;2156;114;361;218;592;332;953
411721;201705;785;2271;623;1922;153;486;89;271;242;757
411722;201705;674;2032;436;1479;90;356;101;271;191;627
411725;201705;1373;4358;865;3092;177;670;160;576;337;1246
411727;201705;1702;4965;1210;3876;331;1098;203;592;534;1690
411729;201705;633;1627;434;1255;101;303;99;240;200;543
411730;201705;5285;15091;4404;13370;1421;4449;1134;3440;2555;7889
411740;201705;638;1795;376;1217;65;232;65;180;130;412
411745;201705;902;2618;697;2166;111;373;177;512;288;885
411750;201705;5117;15042;3948;12440;645;2217;1499;4521;2144;6738
411760;201705;7809;22388;6514;20150;2141;7070;1363;4386;3504;11456
411770;201705;3406;10921;2765;9416;777;2820;421;1382;1198;4202
411780;201705;2909;8731;2649;8269;629;2126;1261;4035;1890;6161
411790;201705;3384;9426;2197;6927;543;1882;395;1188;938;3070
411800;201705;1130;3260;765;2419;98;342;112;320;210;662
411810;201705;1726;4810;1389;4161;258;875;611;1717;869;2592
411820;201705;12980;41665;10935;37281;3760;13299;2649;9221;6409;22520
411830;201705;548;1387;398;1123;106;342;31;97;137;439
411840;201705;10484;29494;7663;23866;1651;5615;1579;4925;3230;10540
411845;201705;497;1507;299;982;52;190;29;76;81;266
411850;201705;7561;22076;6166;19282;1706;5829;1356;4110;3062;9939
411860;201705;885;2687;695;2258;134;466;194;581;328;1047
411870;201705;841;2697;568;1948;107;407;104;333;211;740
411880;201705;2211;6333;1712;5414;462;1641;310;929;772;2570
411885;201705;1006;2766;815;2427;156;562;261;705;417;1267
411890;201705;1161;3493;775;2590;117;453;50;133;167;586
411900;201705;929;2891;607;2086;139;468;66;236;205;704
411910;201705;1154;3683;882;3042;243;888;222;716;465;1604
411915;201705;17737;47186;11084;34234;2067;6921;2391;6650;4458;13571
411920;201705;905;2987;778;2674;224;890;95;262;319;1152
411925;201705;605;1692;410;1330;98;332;98;302;196;634
411930;201705;5737;18871;5048;17462;2345;8777;436;1550;2781;10327
411940;201705;3173;10418;2724;9440;736;2703;548;1763;1284;4466
411950;201705;12649;38959;10799;35417;2287;8047;4812;15523;7099;23570
411960;201705;5482;15863;4960;14877;1014;3340;1958;5657;2972;8997
411965;201705;544;1500;380;1214;75;279;95;308;170;587
411970;201705;821;2200;698;2019;144;394;363;1157;507;1551
411980;201705;1626;4736;1394;4279;343;1115;416;1253;759;2368
411990;201705;33553;101909;25339;84657;5995;22199;7027;22470;13022;44669
411995;201705;2560;7535;2133;6783;612;2219;546;1623;1158;3842
412000;201705;2325;5647;1748;4672;208;694;935;2239;1143;2933
412010;201705;695;2309;540;1935;81;337;132;421;213;758
412015;201705;640;1876;526;1650;88;277;245;774;333;1051
412020;201705;383;1171;245;825;48;168;58;173;106;341
412030;201705;781;2343;555;1865;84;326;171;537;255;863
412033;201705;923;2743;655;2138;88;293;210;748;298;1041
412035;201705;949;2593;594;1936;114;390;196;625;310;1015
412040;201705;606;1815;442;1461;66;228;80;260;146;488
412050;201705;1755;4948;1318;4103;229;817;301;934;530;1751
412060;201705;7093;23562;6345;22065;1892;7114;1712;5944;3604;13058
412065;201705;796;2358;605;1955;120;416;178;551;298;967
412070;201705;1323;3506;974;2783;133;419;402;1117;535;1536
412080;201705;1525;4641;957;3364;121;477;30;84;151;561
412085;201705;442;1275;152;524;18;66;14;36;32;102
412090;201705;4767;13964;4379;13258;936;2871;2307;7199;3243;10070
412100;201705;1857;5605;1485;4884;433;1549;305;997;738;2546
412110;201705;1025;2854;709;2185;142;473;147;472;289;945
412120;201705;1674;5609;1419;5023;339;1317;399;1224;738;2541
412125;201705;669;2153;579;1946;137;486;186;610;323;1096
412130;201705;578;1731;446;1422;93;318;87;284;180;602
412135;201705;544;1526;301;935;51;156;97;273;148;429
412140;201705;1604;4611;1215;3818;267;923;220;640;487;1563
412150;201705;3065;8589;2598;7647;309;1025;1558;4447;1867;5472
412160;201705;1238;3913;762;2652;186;717;76;255;262;972
412170;201705;4597;13783;3791;12243;941;3348;1430;4333;2371;7681
412175;201705;1472;4696;1274;4282;266;960;579;1962;845;2922
412180;201705;1723;5115;1299;4296;255;995;486;1445;741;2440
412190;201705;3387;9279;2541;7711;422;1422;875;2767;1297;4189
412200;201705;2103;6570;1533;5145;310;1094;386;1310;696;2404
412210;201705;652;1756;379;1189;82;302;52;127;134;429
412215;201705;3528;10614;3126;9838;776;2445;1575;5169;2351;7614
412217;201705;1099;3067;971;2827;81;296;683;1891;764;2187
412220;201705;5849;18192;5375;17365;1448;4679;2291;7777;3739;12456
412230;201705;2890;9354;2455;8432;489;1894;650;2078;1139;3972
412240;201705;8957;22867;5340;16168;970;3333;1113;3141;2083;6474
412250;201705;1921;5498;1543;4715;360;1167;199;525;559;1692
412260;201705;1326;3669;883;2694;129;442;295;795;424;1237
412265;201705;964;2909;840;2687;222;769;315;1008;537;1777
412270;201705;877;2713;592;2004;99;379;215;678;314;1057
412280;201705;627;1923;473;1601;158;579;40;111;198;690
412290;201705;1039;2888;762;2381;131;462;238;705;369;1167
412300;201705;1652;4991;1431;4558;385;1336;302;903;687;2239
412310;201705;961;2807;808;2537;111;454;373;1170;484;1624
412320;201705;826;2222;597;1781;94;358;186;537;280;895
412330;201705;1479;4187;1066;3318;155;514;426;1328;581;1842
412340;201705;958;2958;650;2165;95;341;128;389;223;730
412350;201705;2555;7515;1732;5737;327;1183;57;115;384;1298
412360;201705;298;866;183;588;22;79;55;157;77;236
412370;201705;882;2613;649;2189;141;520;95;336;236;856
412380;201705;1617;4932;1246;4074;304;1030;252;848;556;1878
412382;201705;664;1835;464;1424;70;231;112;310;182;541
412385;201705;2315;6949;2028;6298;723;2305;484;1596;1207;3901
412390;201705;2188;6087;1946;5685;437;1384;839;2484;1276;3868
412395;201705;779;2219;594;1864;69;253;296;891;365;1144
412400;201705;897;2733;716;2319;176;604;164;557;340;1161
412402;201705;1858;5351;1465;4562;290;1014;272;784;562;1798
412405;201705;3451;9970;2137;6973;327;1222;92;249;419;1471
412410;201705;5105;14960;4066;13003;1010;3733;880;2684;1890;6417
412420;201705;412;1202;254;818;40;134;86;236;126;370
412430;201705;544;1515;388;1216;62;225;113;335;175;560
412440;201705;3085;9257;2336;7805;602;2193;490;1641;1092;3834
412450;201705;277;916;212;743;31;105;15;41;46;146
412460;201705;753;2343;639;2084;156;528;153;496;309;1024
412470;201705;1848;6167;1526;5352;474;1756;299;1107;773;2863
412480;201705;1133;3397;771;2484;120;429;96;239;216;668
412490;201705;911;2643;764;2341;150;468;281;818;431;1286
412500;201705;1916;5422;1575;4730;281;937;386;1031;667;1968
412510;201705;2206;7105;1727;5906;486;1797;304;954;790;2751
412520;201705;1457;4156;1064;3311;286;931;125;361;411;1292
412530;201705;574;1673;446;1375;83;279;78;227;161;506
412535;201705;1031;3258;774;2680;96;330;346;1300;442;1630
412540;201705;1242;3462;905;2755;122;438;251;766;373;1204
412545;201705;761;2123;531;1606;89;271;116;310;205;581
412550;201705;31495;93552;22009;72280;4741;16635;5018;15503;9759;32138
412555;201705;250;733;176;569;28;94;39;107;67;201
412560;201705;5381;16376;4088;13418;813;3035;962;3029;1775;6064
412570;201705;4233;12126;2781;9034;585;2112;366;1197;951;3309
412575;201705;863;2617;674;2149;129;445;202;607;331;1052
412580;201705;1317;3574;936;2821;166;559;359;1004;525;1563
412590;201705;446;1292;268;908;55;181;33;110;88;291
412600;201705;1435;4302;1076;3495;210;770;308;947;518;1717
412610;201705;766;2284;486;1581;102;343;148;456;250;799
412620;201705;1245;3816;977;3287;266;1048;196;561;462;1609
412625;201705;8607;24782;6286;20087;1216;4267;606;1746;1822;6013
412627;201705;1009;3086;712;2382;206;746;154;506;360;1252
412630;201705;3174;9917;2433;8221;489;1654;689;2246;1178;3900
412635;201705;463;1339;321;1017;63;209;40;101;103;310
412640;201705;957;2804;602;1971;98;357;95;286;193;643
412650;201705;1610;4797;1353;4289;267;982;420;1216;687;2198
412660;201705;2637;7375;2015;6169;391;1335;476;1324;867;2659
412665;201705;639;1643;360;1101;85;273;79;221;164;494
412667;201705;1713;4812;1331;4049;247;845;453;1324;700;2169
412670;201705;542;1658;439;1460;120;439;90;285;210;724
412680;201705;1406;4146;874;2971;148;545;204;614;352;1159
412690;201705;776;2311;606;1958;127;425;144;487;271;912
412700;201705;1918;5573;1571;5033;429;1576;475;1467;904;3043
412710;201705;6380;20099;5397;18036;1181;4340;1359;4185;2540;8525
412720;201705;1415;4353;1026;3399;165;582;182;512;347;1094
412730;201705;2139;6378;1247;4251;265;977;143;461;408;1438
412740;201705;1554;4820;1118;3829;239;906;134;500;373;1406
412750;201705;4174;12284;3669;11425;512;1859;2182;6618;2694;8477
412760;201705;2460;7616;2286;7291;317;1150;1424;4420;1741;5570
412770;201705;10768;29497;6109;19561;845;2935;1013;2861;1858;5796
412780;201705;1303;3900;1097;3494;224;792;445;1345;669;2137
412785;201705;2218;6068;1654;4967;400;1211;701;2161;1101;3372
412788;201705;1447;4488;1230;4038;338;1216;363;1084;701;2300
412790;201705;1086;3229;741;2459;163;583;151;423;314;1006
412795;201705;1027;2829;685;2081;117;382;219;651;336;1033
412796;201705;2643;7988;2375;7451;504;1725;961;2844;1465;4569
412800;201705;3230;9022;2410;7261;371;1275;843;2344;1214;3619
412810;201705;11545;31270;6831;21167;900;3213;1666;4312;2566;7525
412820;201705;7394;21391;5431;17429;1207;4118;1386;4504;2593;8622
412830;201705;364;1109;269;909;44;161;62;209;106;370
412840;201705;1838;5155;1458;4368;244;780;357;1047;601;1827
412850;201705;2875;8286;2265;7156;457;1570;662;1976;1119;3546
412853;201705;1801;5071;1579;4635;160;523;811;2200;971;2723
412855;201705;1395;4057;1038;3223;211;731;203;501;414;1232
412860;201705;1163;3335;910;2832;226;770;309;908;535;1678
412862;201705;752;1908;494;1441;74;241;140;414;214;655
412863;201705;1165;3854;1132;3797;120;438;837;2773;957;3211
412865;201705;732;2145;540;1763;110;368;155;536;265;904
412870;201705;924;2622;727;2280;277;971;105;323;382;1294
412880;201705;804;2384;621;1978;138;494;61;168;199;662
420005;201705;535;1584;314;1070;52;191;107;352;159;543
420010;201705;3244;8865;2551;7873;304;996;1734;5409;2038;6405
420020;201705;634;2031;379;1384;50;231;44;140;94;371
420030;201705;442;1145;224;753;52;211;21;74;73;285
420040;201705;677;2162;409;1547;78;338;31;94;109;432
420050;201705;726;2058;486;1555;101;349;201;623;302;972
420055;201705;190;585;108;383;21;87;18;56;39;143
420060;201705;223;715;152;542;21;94;26;74;47;168
420070;201705;1270;4043;949;3257;172;642;339;1181;511;1823
420075;201705;163;436;86;265;17;57;11;21;28;78
420080;201705;590;1816;476;1588;138;484;126;418;264;902
420090;201705;411;1395;290;1087;76;294;52;208;128;502
420100;201705;1182;3667;1081;3520;206;714;661;2144;867;2858
420110;201705;298;1003;279;959;82;302;83;271;165;573
420120;201705;263;898;212;782;63;260;53;173;116;433
420125;201705;316;1127;288;1070;78;321;129;459;207;780
420127;201705;456;1292;166;594;38;161;15;38;53;199
420130;201705;1892;6314;1518;5529;408;1676;341;1120;749;2796
420140;201705;4176;12384;3070;10211;712;2684;471;1401;1183;4085
420150;201705;542;1522;382;1253;47;174;183;562;230;736
420160;201705;259;688;146;478;26;89;40;128;66;217
420165;201705;223;696;133;465;27;104;29;93;56;197
420170;201705;213;647;131;479;38;169;14;41;52;210
420180;201705;360;1075;198;693;22;82;45;144;67;226
420190;201705;358;1094;194;699;37;136;20;63;57;199
420195;201705;1346;3959;1095;3502;289;1023;215;644;504;1667
420200;201705;2619;7973;1598;5677;336;1370;281;917;617;2287
420205;201705;1156;3604;920;3146;178;659;494;1688;672;2347
420207;201705;1525;4444;1052;3483;284;1070;226;698;510;1768
420208;201705;584;1546;323;1100;67;261;121;428;188;689
420209;201705;272;838;171;595;31;120;70;238;101;358
420210;201705;1987;5729;1277;4554;301;1255;468;1569;769;2824
420213;201705;804;2784;744;2651;194;746;362;1306;556;2052
420215;201705;314;997;204;740;56;207;15;64;71;271
420220;201705;172;605;141;542;36;157;46;166;82;323
420230;201705;4200;12347;3216;10587;623;2439;1193;3750;1816;6189
420240;201705;11268;31311;7381;23927;1102;4225;3344;9868;4446;14093
420243;201705;597;1774;469;1523;94;325;161;519;255;844
420245;201705;1300;3760;880;2920;124;482;347;1046;471;1528
420250;201705;507;1620;453;1519;99;389;206;657;305;1046
420253;201705;531;1355;387;1148;39;109;211;647;250;756
420257;201705;294;805;185;606;39;133;79;258;118;391
420260;201705;1166;3695;940;3283;185;719;404;1410;589;2129
420270;201705;683;2002;260;883;36;135;66;196;102;331
420280;201705;2083;5680;1283;4252;280;1020;378;1194;658;2214
420285;201705;139;402;67;247;12;48;5;11;17;59
420287;201705;508;1437;409;1285;132;448;125;397;257;845
420290;201705;5835;17454;4019;13283;797;2816;1201;3655;1998;6471
420300;201705;6712;19692;4224;14301;891;3394;806;2450;1697;5844
420310;201705;836;2156;642;1795;80;263;458;1221;538;1484
420315;201705;951;2980;725;2520;212;790;228;786;440;1576
420320;201705;4446;13712;3668;12286;1143;4279;1087;3514;2230;7793
420325;201705;209;697;180;631;35;130;62;210;97;340
420330;201705;968;3247;703;2589;138;555;207;726;345;1281
420340;201705;1412;4280;1033;3427;201;723;77;231;278;954
420350;201705;1480;4299;1065;3450;226;810;455;1428;681;2238
420360;201705;2913;8790;1776;6271;368;1464;160;532;528;1996
420370;201705;1752;4947;1393;4325;165;581;957;2906;1122;3487
420380;201705;5279;15451;3481;11592;798;2889;894;2899;1692;5788
420390;201705;1299;3537;781;2458;138;527;195;421;333;948
420395;201705;1262;3864;860;2949;132;514;92;270;224;784
420400;201705;1192;3539;832;2804;176;679;172;528;348;1207
420410;201705;704;1880;494;1516;78;285;305;908;383;1193
420415;201705;469;1433;345;1152;96;346;90;296;186;642
420417;201705;720;2274;577;1923;113;407;242;793;355;1200
420419;201705;306;990;214;781;72;288;12;45;84;333
420420;201705;10544;31629;8422;27508;2963;10473;1727;5277;4690;15750
420425;201705;1182;3123;789;2392;92;351;321;906;413;1257
420430;201705;3411;10277;2219;7449;483;1767;649;2060;1132;3827
420435;201705;266;782;165;562;35;144;77;247;112;391
420440;201705;816;2478;463;1550;157;571;99;289;256;860
420445;201705;381;1089;250;795;50;167;73;224;123;391
420450;201705;779;2381;545;1856;111;402;131;414;242;816
420455;201705;1959;5664;1620;5054;253;981;743;2162;996;3143
420460;201705;8795;25489;6770;21906;1469;5457;2596;7979;4065;13436
420470;201705;1044;2742;594;1885;114;403;167;480;281;883
420475;201705;100;290;52;183;20;69;5;15;25;84
420480;201705;4918;14072;3537;11449;823;2878;739;2350;1562;5228
420490;201705;649;1697;362;1218;92;340;73;261;165;601
420500;201705;1444;4509;1085;3794;330;1285;326;1122;656;2407
420510;201705;127;453;99;378;21;96;53;195;74;291
420515;201705;78;243;64;221;14;57;18;63;32;120
420517;201705;867;2578;765;2401;94;324;508;1580;602;1904
420519;201705;465;1202;301;912;52;175;77;214;129;389
420520;201705;636;1640;322;1049;48;157;56;145;104;302
420530;201705;1215;3792;877;3050;187;723;221;669;408;1392
420535;201705;269;763;129;436;32;111;12;48;44;159
420540;201705;22640;63292;15847;49216;3434;11704;4372;11881;7806;23585
420543;201705;354;916;281;800;46;105;182;541;228;646
420545;201705;1615;5004;1290;4296;313;1134;374;1190;687;2324
420550;201705;4014;12400;2925;10244;787;3204;572;1961;1359;5165
420555;201705;359;1072;270;896;48;173;95;294;143;467
420560;201705;467;1333;349;1119;61;201;182;567;243;768
420570;201705;2205;6883;1692;5755;399;1532;573;1802;972;3334
420580;201705;1585;4671;1248;4108;297;1116;516;1671;813;2787
420590;201705;3315;9770;2116;7013;439;1599;335;941;774;2540
420600;201705;946;3009;847;2810;153;531;495;1672;648;2203
420610;201705;510;1533;290;1026;69;263;56;193;125;456
420620;201705;548;1667;481;1536;133;453;135;430;268;883
420630;201705;989;3021;722;2382;172;629;267;805;439;1434
420640;201705;774;2290;382;1383;97;397;26;80;123;477
420650;201705;2500;7203;1603;5391;276;985;381;1139;657;2124
420660;201705;462;1355;325;1070;56;206;90;287;146;493
420665;201705;696;1949;468;1527;72;273;155;463;227;736
420670;201705;1689;4919;1184;3872;235;923;293;846;528;1769
420675;201705;177;580;133;468;25;107;29;93;54;200
420680;201705;347;876;219;689;37;123;89;266;126;389
420690;201705;873;3018;636;2343;112;444;96;295;208;739
420700;201705;3087;9027;2392;7637;453;1618;839;2540;1292;4158
420710;201705;646;2107;489;1759;124;516;160;532;284;1048
420720;201705;1680;4763;1291;4212;389;1333;542;1762;931;3095
420730;201705;3155;9349;2575;8347;554;1978;1122;3544;1676;5522
420740;201705;806;2466;621;2081;175;635;173;541;348;1176
420750;201705;2092;6663;1557;5439;253;985;508;1595;761;2580
420757;201705;89;192;31;104;5;19;12;39;17;58
420760;201705;380;1177;191;642;40;136;24;70;64;206
420765;201705;539;1699;282;1036;56;223;55;196;111;419
420768;201705;1211;4038;976;3563;344;1241;400;1543;744;2784
420770;201705;523;1538;304;1096;61;245;59;223;120;468
420775;201705;638;1913;371;1266;77;283;46;137;123;420
420780;201705;1411;4256;849;2924;161;586;131;428;292;1014
420785;201705;259;759;192;602;31;90;46;130;77;220
420790;201705;1223;4127;947;3519;244;982;349;1238;593;2220
420800;201705;902;2515;448;1466;89;320;134;421;223;741
420810;201705;1981;6628;1585;5785;512;2107;333;1132;845;3239
420820;201705;8716;25656;6115;21209;1488;5769;1680;5685;3168;11454
420830;201705;2862;8763;2322;7752;648;2380;748;2471;1396;4851
420840;201705;1008;2936;477;1693;92;364;84;277;176;641
420845;201705;1508;4380;1001;3453;257;1038;223;716;480;1754
420850;201705;1477;4652;898;3338;195;807;73;254;268;1061
420860;201705;394;1107;231;794;61;237;44;147;105;384
420870;201705;1073;3003;839;2623;307;1084;212;595;519;1679
420880;201705;983;3299;767;2735;173;690;132;413;305;1103
420890;201705;9027;24327;4761;15663;795;2873;1088;3154;1883;6027
420895;201705;215;628;121;397;30;103;25;72;55;175
420900;201705;1793;4992;1162;3809;228;858;312;930;540;1788
420910;201705;23908;69452;16466;55046;2941;11091;5272;16356;8213;27447
420915;201705;556;2155;389;1652;81;361;171;678;252;1039
420917;201705;491;1482;223;723;35;127;88;258;123;385
420920;201705;169;486;76;262;10;41;10;26;20;67
420930;201705;18420;51817;13980;44150;2911;10167;5514;16698;8425;26865
420940;201705;2860;8365;2113;6918;552;2000;165;478;717;2478
420945;201705;203;603;134;449;28;110;36;108;64;218
420950;201705;587;1627;300;1038;39;179;67;223;106;402
420960;201705;952;2684;747;2323;148;515;286;837;434;1352
420970;201705;2619;7994;2014;6846;620;2284;380;1321;1000;3605
420980;201705;444;1307;345;1158;125;450;122;453;247;903
420985;201705;483;1359;222;785;49;206;56;180;105;386
420990;201705;776;2180;434;1495;82;306;60;173;142;479
421000;201705;553;1865;359;1374;71;291;57;176;128;467
421003;201705;701;1855;251;840;29;100;21;58;50;158
421005;201705;139;426;106;370;28;102;49;186;77;288
421010;201705;5038;14219;3533;11549;805;2933;726;2178;1531;5111
421020;201705;438;1339;322;1133;32;134;194;676;226;810
421030;201705;749;2634;648;2377;212;871;108;366;320;1237
421040;201705;948;2334;593;1790;82;286;304;885;386;1171
421050;201705;1589;4496;931;3073;189;672;211;614;400;1286
421055;201705;209;587;114;369;24;76;24;63;48;139
421060;201705;551;1792;372;1342;88;343;118;415;206;758
421070;201705;672;2129;432;1529;100;396;55;180;155;576
421080;201705;767;3130;689;3012;89;291;528;2490;617;2781
421085;201705;509;1421;253;890;53;206;60;190;113;396
421090;201705;402;1109;191;621;29;106;45;135;74;241
421100;201705;972;2564;510;1598;117;393;57;160;174;553
421105;201705;1506;4478;1205;3983;241;852;443;1546;684;2398
421110;201705;957;3347;870;3147;328;1242;199;656;527;1898
421120;201705;1297;4158;870;3126;126;526;213;672;339;1198
421125;201705;402;1103;298;932;83;285;89;246;172;531
421130;201705;3327;10850;2865;9929;919;3451;998;3505;1917;6956
421140;201705;333;965;249;795;44;142;97;285;141;427
421145;201705;551;1690;348;1157;55;182;103;335;158;517
421150;201705;612;1741;443;1474;93;362;169;528;262;890
421160;201705;1150;3154;577;1864;109;401;198;594;307;995
421165;201705;225;757;190;677;26;88;90;338;116;426
421170;201705;1288;3640;1028;3238;173;588;592;1862;765;2450
421175;201705;1212;3390;840;2711;155;595;304;869;459;1464
421180;201705;544;1487;270;907;65;249;48;155;113;404
421185;201705;408;1109;290;890;61;183;122;394;183;577
421187;201705;358;1060;245;799;40;130;91;277;131;407
421189;201705;406;1259;325;1086;66;233;88;283;154;516
421190;201705;11526;32397;7071;23740;1450;5462;1118;3471;2568;8933
421200;201705;900;2905;749;2591;163;603;257;846;420;1449
421205;201705;216;641;157;521;40;161;45;129;85;290
421210;201705;1381;4152;1011;3319;259;869;266;885;525;1754
421220;201705;1716;5805;1506;5316;454;1788;234;720;688;2508
421223;201705;518;1617;372;1325;75;290;136;499;211;789
421225;201705;1121;3566;959;3227;210;767;398;1371;608;2138
421227;201705;936;2748;715;2344;149;566;381;1201;530;1767
421230;201705;467;1477;391;1343;93;337;160;541;253;878
421240;201705;400;1262;211;774;19;94;22;67;41;161
421250;201705;1640;4643;1048;3598;296;1112;203;691;499;1803
421260;201705;355;1003;83;298;14;44;12;42;26;86
421265;201705;783;2331;690;2186;109;399;424;1310;533;1709
421270;201705;749;2052;394;1305;75;253;88;304;163;557
421280;201705;1585;4977;1262;4397;324;1281;515;1752;839;3033
421290;201705;1007;2862;590;1909;101;351;106;307;207;658
421300;201705;288;861;215;710;54;225;87;254;141;479
421310;201705;208;641;163;528;29;101;55;176;84;277
421315;201705;326;959;192;665;33;116;22;79;55;195
421320;201705;646;1962;399;1368;77;268;59;150;136;418
421330;201705;601;1926;457;1643;125;484;104;387;229;871
421335;201705;473;1587;397;1432;87;360;83;310;170;670
421340;201705;1752;4901;1377;4292;192;740;745;2269;937;3009
421350;201705;1099;3510;906;3116;154;645;485;1585;639;2230
421360;201705;2819;7979;1771;5939;377;1490;500;1522;877;3012
421370;201705;554;1866;415;1536;122;497;113;406;235;903
421380;201705;919;2644;778;2379;128;422;384;1115;512;1537
421390;201705;182;510;78;261;16;58;25;78;41;136
421400;201705;297;984;213;827;62;272;69;247;131;519
421410;201705;308;877;185;626;22;83;73;250;95;333
421415;201705;370;1180;160;576;36;142;26;87;62;229
421420;201705;769;2296;585;1906;92;340;239;715;331;1055
421430;201705;197;629;151;538;30;113;39;144;69;257
421440;201705;858;2443;580;1974;116;445;242;817;358;1262
421450;201705;425;1296;258;924;37;155;23;93;60;248
421460;201705;590;1638;315;1119;59;222;74;272;133;494
421470;201705;380;1234;295;1057;74;307;83;274;157;581
421480;201705;3083;8575;2025;6733;697;2721;267;688;964;3409
421490;201705;268;794;125;465;22;94;22;74;44;168
421500;201705;2095;7074;1693;6209;534;2175;208;722;742;2897
421505;201705;360;1158;314;1059;70;245;150;506;220;751
421507;201705;533;1598;353;1224;82;309;88;308;170;617
421510;201705;199;632;156;538;29;116;75;212;104;328
421520;201705;714;1972;458;1394;69;246;183;494;252;740
421530;201705;326;1010;192;698;37;170;34;102;71;272
421535;201705;666;1925;373;1316;41;164;166;541;207;705
421540;201705;333;892;249;753;55;183;91;250;146;433
421545;201705;822;2546;595;2112;143;563;177;615;320;1178
421550;201705;2114;6512;1786;5956;495;1875;632;1996;1127;3871
421555;201705;284;834;94;339;14;59;11;29;25;88
421560;201705;137;422;75;269;14;52;12;46;26;98
421565;201705;794;2311;692;2172;206;718;316;1017;522;1735
421567;201705;586;2118;505;1923;254;1007;117;444;371;1451
421568;201705;507;1546;342;1165;72;270;98;331;170;601
421569;201705;230;686;101;368;20;73;15;57;35;130
421570;201705;1370;4099;805;2766;181;649;125;408;306;1057
421575;201705;350;1185;307;1058;54;204;155;520;209;724
421580;201705;3014;9497;2280;7890;531;2131;631;1935;1162;4066
421590;201705;214;648;169;561;25;90;86;279;111;369
421600;201705;466;1417;346;1141;83;286;72;223;155;509
421605;201705;626;1903;457;1586;90;349;133;454;223;803
421610;201705;1382;3736;969;2964;168;580;353;1030;521;1610
421620;201705;4472;13320;2934;10155;810;2981;738;2562;1548;5543
421625;201705;372;1026;153;517;29;98;21;69;50;167
421630;201705;3066;9016;1723;5847;332;1255;264;803;596;2058
421635;201705;224;659;120;389;16;64;34;80;50;144
421640;201705;1092;3145;777;2549;162;559;275;887;437;1446
421650;201705;2216;6909;1609;5562;403;1594;207;570;610;2164
421660;201705;7730;24910;6454;22330;1390;5361;2133;6879;3523;12240
421670;201705;1079;3166;734;2402;172;651;215;656;387;1307
421680;201705;1139;3618;930;3172;312;1127;220;730;532;1857
421690;201705;1457;4679;1083;3817;231;925;160;503;391;1428
421700;201705;470;1530;260;981;48;190;66;235;114;425
421710;201705;208;690;92;337;12;48;25;80;37;128
421715;201705;226;599;121;390;28;93;46;139;74;232
421720;201705;1963;5730;1195;4174;306;1175;176;555;482;1730
421725;201705;150;435;108;349;32;117;34;92;66;209
421730;201705;590;1678;288;952;41;141;74;219;115;360
421740;201705;702;2249;480;1696;107;430;93;302;200;732
421750;201705;1011;2637;612;1874;104;339;220;610;324;949
421755;201705;304;871;173;555;36;135;54;156;90;291
421760;201705;970;2921;499;1757;71;258;95;325;166;583
421770;201705;2942;8636;2205;7217;534;1822;705;2423;1239;4245
421775;201705;465;1348;320;1072;60;223;105;337;165;560
421780;201705;1035;3476;783;2877;179;756;218;725;397;1481
421790;201705;805;2115;469;1603;190;698;121;375;311;1073
421795;201705;364;1065;218;691;39;133;59;173;98;306
421800;201705;2705;8039;2019;6738;434;1578;790;2537;1224;4115
421810;201705;667;1941;471;1548;111;420;122;356;233;776
421820;201705;995;2871;593;2000;100;365;73;199;173;564
421825;201705;1454;4490;1361;4317;166;598;961;2965;1127;3563
421830;201705;2522;8428;2219;7820;535;2087;781;2615;1316;4702
421835;201705;159;471;118;412;17;76;76;259;93;335
421840;201705;291;907;204;719;44;186;69;215;113;401
421850;201705;445;1394;257;914;44;184;57;185;101;369
421860;201705;301;914;192;684;34;137;46;136;80;273
421870;201705;3744;10560;2620;8300;729;2531;618;1898;1347;4429
421875;201705;402;1171;185;653;33;128;21;58;54;186
421880;201705;808;2443;602;2002;141;511;120;376;261;887
421885;201705;289;887;234;799;71;252;64;202;135;454
421890;201705;829;2798;702;2550;238;994;211;689;449;1683
421895;201705;390;1208;346;1135;66;245;207;669;273;914
421900;201705;974;2704;618;1972;156;526;173;514;329;1040
421910;201705;467;1453;324;1128;61;257;66;190;127;447
421915;201705;485;1450;300;1009;58;192;48;158;106;350
421917;201705;607;1693;418;1412;125;477;110;352;235;829
421920;201705;683;1930;435;1576;212;787;121;470;333;1257
421930;201705;3044;7892;1613;5364;404;1472;229;679;633;2151
421935;201705;640;2059;481;1706;98;405;175;576;273;981
421940;201705;237;802;145;534;30;139;30;93;60;232
421950;201705;3513;9463;1676;5583;366;1350;215;704;581;2054
421960;201705;183;537;136;456;27;106;28;93;55;199
421970;201705;2351;6359;1361;4312;350;1155;338;985;688;2140
421985;201705;440;1137;242;750;39;145;65;213;104;358
422000;201705;1398;4145;1164;3693;281;1007;478;1489;759;2496
430003;201705;599;1897;504;1723;138;534;155;508;293;1042
430005;201705;342;998;239;799;59;209;93;297;152;506
430010;201705;2077;5606;1596;4780;349;1152;737;2198;1086;3350
430020;201705;677;1663;566;1510;84;265;355;908;439;1173
430030;201705;1122;2852;755;2170;216;646;178;507;394;1153
430040;201705;10732;28502;7609;22600;1967;6533;744;2040;2711;8573
430045;201705;701;1889;522;1527;80;242;215;619;295;861
430047;201705;295;689;135;400;17;54;44;129;61;183
430050;201705;1053;2858;598;1887;121;382;135;415;256;797
430055;201705;307;795;157;477;11;36;69;202;80;238
430057;201705;70;174;38;110;6;17;6;9;12;26
430060;201705;17108;53348;14642;49162;4040;14597;5627;19115;9667;33712
430063;201705;988;2848;772;2384;176;544;377;1173;553;1717
430064;201705;1246;3675;968;3137;267;902;291;939;558;1841
430066;201705;169;394;114;307;9;28;63;166;72;194
430070;201705;660;1760;169;563;20;73;16;40;36;113
430080;201705;735;2046;441;1456;103;377;140;416;243;793
430085;201705;955;2423;585;1753;108;347;160;503;268;850
430087;201705;801;2496;705;2310;135;508;348;1059;483;1567
430090;201705;689;1806;253;828;31;117;60;198;91;315
430100;201705;859;2263;442;1403;105;354;119;332;224;686
430105;201705;1037;2947;689;2305;162;616;249;813;411;1429
430107;201705;218;708;162;564;25;91;36;114;61;205
430110;201705;1946;5465;1578;4891;336;1098;743;2203;1079;3301
430120;201705;1640;4904;1157;3870;258;894;465;1595;723;2489
430130;201705;4113;11924;3506;10967;919;2612;1443;5330;2362;7942
430140;201705;1166;3553;775;2652;203;725;242;816;445;1541
430150;201705;733;1945;468;1429;100;333;122;382;222;715
430155;201705;318;881;185;600;27;100;46;138;73;238
430160;201705;16913;47924;14542;43971;3506;11432;5632;17358;9138;28790
430163;201705;2005;5728;1595;5030;235;811;892;2804;1127;3615
430165;201705;471;1151;123;408;15;50;13;30;28;80
430170;201705;947;2697;365;1321;62;250;48;141;110;391
430175;201705;887;2769;743;2426;179;572;317;1081;496;1653
430180;201705;801;2188;669;1961;122;425;368;1016;490;1441
430185;201705;510;1356;307;967;56;193;108;294;164;487
430187;201705;675;1967;537;1678;106;372;201;612;307;984
430190;201705;1588;4738;1374;4310;276;936;690;2126;966;3062
430192;201705;181;550;81;256;9;29;9;23;18;52
430195;201705;390;1183;99;325;10;37;3;8;13;45
430200;201705;1339;4248;1154;3862;342;1180;317;1058;659;2238
430205;201705;547;1545;416;1287;37;134;286;874;323;1008
430210;201705;6103;16035;3899;11445;564;1866;1269;3011;1833;4877
430215;201705;345;950;240;734;51;171;92;262;143;433
430220;201705;654;1673;226;750;41;158;39;110;80;268
430222;201705;263;819;213;707;40;147;90;282;130;429
430223;201705;364;1006;297;887;57;169;141;432;198;601
430225;201705;34;83;15;41;4;11;6;15;10;26
430230;201705;1609;4781;1538;4691;281;770;1170;3710;1451;4480
430235;201705;269;858;218;740;46;177;68;219;114;396
430237;201705;554;1399;398;1139;42;138;230;618;272;756
430240;201705;1038;2614;716;2105;90;327;371;1033;461;1360
430245;201705;837;2581;652;2197;197;650;251;904;448;1554
430250;201705;1071;3082;958;2902;289;937;85;236;374;1173
430258;201705;160;447;119;376;11;39;49;159;60;198
430260;201705;684;1944;509;1592;90;298;240;783;330;1081
430265;201705;273;839;213;727;50;168;34;120;84;288
430270;201705;2826;7809;2437;7167;335;1122;1479;4225;1814;5347
430280;201705;4805;12708;3822;11005;840;2505;1654;4807;2494;7312
430290;201705;2443;6315;2241;6015;116;358;1920;5116;2036;5474
430300;201705;9138;26387;7572;23411;1659;5545;3355;10444;5014;15989
430310;201705;6881;20175;5318;17205;1115;4024;2160;6601;3275;10625
430320;201705;850;2472;520;1743;106;315;236;838;342;1153
430330;201705;672;1765;521;1476;130;378;220;567;350;945
430340;201705;720;1741;374;1152;76;244;168;505;244;749
430350;201705;6075;18175;5157;16242;1786;5877;1606;4879;3392;10756
430355;201705;410;1025;154;484;29;104;16;49;45;153
430360;201705;994;2645;778;2234;174;542;263;698;437;1240
430367;201705;241;662;157;491;36;136;54;155;90;291
430370;201705;533;1473;330;1068;65;223;71;209;136;432
430380;201705;734;1905;413;1321;128;438;99;317;227;755
430390;201705;3856;10618;2396;7644;417;1494;266;786;683;2280
430400;201705;1358;3239;1008;2670;248;652;453;1163;701;1815
430410;201705;603;1571;423;1257;59;200;229;658;288;858
430420;201705;3512;10116;2764;8421;746;2360;904;2687;1650;5047
430430;201705;666;1812;423;1349;111;385;84;265;195;650
430435;201705;2046;5463;1480;4439;380;1165;418;1277;798;2442
430440;201705;4095;12709;3179;10617;674;2375;1314;4502;1988;6877
430450;201705;6961;19307;5734;16968;1620;5059;1780;5358;3400;10417
430460;201705;28307;83203;21874;71811;5774;20974;6563;21061;12337;42035
430461;201705;512;1348;164;519;21;67;33;99;54;166
430462;201705;296;829;195;655;32;116;37;143;69;259
430463;201705;4151;13053;3512;11846;781;2856;1640;5567;2421;8423
430465;201705;594;1629;502;1465;116;357;267;761;383;1118
430466;201705;3710;9802;3175;8977;698;2136;1651;4472;2349;6608
430467;201705;473;1369;394;1210;74;248;162;461;236;709
430468;201705;1394;3857;1174;3500;254;801;535;1567;789;2368
430469;201705;517;1421;61;206;8;18;11;26;19;44
430470;201705;7727;20526;5446;16726;1629;5343;999;3130;2628;8473
430471;201705;513;1693;465;1587;119;417;147;513;266;930
430480;201705;1014;2695;523;1677;84;285;92;262;176;547
430485;201705;165;472;77;249;14;53;15;38;29;91
430490;201705;297;873;197;657;38;135;83;293;121;428
430495;201705;389;1144;254;859;43;154;86;276;129;430
430500;201705;1140;3126;939;2803;220;734;418;1191;638;1925
430510;201705;22701;64582;17680;54841;4969;16856;5339;15495;10308;32351
430511;201705;380;1176;167;591;32;111;13;33;45;144
430512;201705;1055;2701;904;2443;237;688;265;755;502;1443
430513;201705;810;2090;458;1335;112;355;159;430;271;785
430515;201705;472;1328;336;1054;56;158;150;494;206;652
430517;201705;1167;3650;956;3216;175;612;466;1588;641;2200
430520;201705;1505;4116;919;2867;174;612;205;573;379;1185
430530;201705;1130;2963;479;1483;86;276;110;314;196;590
430535;201705;2559;7522;1938;6307;389;1371;744;2369;1133;3740
430537;201705;460;1503;386;1333;40;156;258;880;298;1036
430540;201705;725;1588;474;1248;82;220;286;751;368;971
430543;201705;495;1209;430;1139;77;200;295;805;372;1005
430544;201705;650;2068;536;1801;119;442;256;816;375;1258
430545;201705;1380;4372;1210;4149;368;1381;530;1809;898;3190
430550;201705;608;1703;349;1135;72;239;63;190;135;429
430558;201705;81;241;51;162;11;40;14;35;25;75
430560;201705;395;945;185;561;12;42;58;170;70;212
430570;201705;1087;2779;711;2059;134;450;301;754;435;1204
430580;201705;1223;3056;780;2333;115;380;364;1105;479;1485
430583;201705;172;454;40;127;4;13;7;24;11;37
430585;201705;303;767;177;514;29;100;76;191;105;291
430587;201705;168;526;131;430;29;101;52;179;81;280
430590;201705;1252;3381;1144;3194;100;324;893;2438;993;2762
430593;201705;25;95;23;88;6;25;9;33;15;58
430595;201705;304;878;86;301;10;46;10;27;20;73
430597;201705;350;1023;242;762;30;104;68;177;98;281
430600;201705;1933;5211;1011;3101;179;578;277;783;456;1361
430605;201705;1274;3746;979;3145;159;611;404;1278;563;1889
430607;201705;765;1804;561;1501;50;148;351;966;401;1114
430610;201705;7505;19954;5717;17144;1673;5470;1136;3425;2809;8895
430613;201705;273;670;110;342;8;28;29;75;37;103
430620;201705;696;1940;578;1709;153;491;233;662;386;1153
430630;201705;472;1433;175;582;24;86;28;82;52;168
430632;201705;657;1833;320;1008;45;156;112;317;157;473
430635;201705;593;1675;451;1385;86;300;238;702;324;1002
430637;201705;484;1364;430;1259;70;233;239;654;309;887
430640;201705;1607;4257;778;2488;109;354;102;293;211;647
430642;201705;472;1220;306;916;52;153;129;396;181;549
430645;201705;280;636;110;306;20;55;29;80;49;135
430650;201705;1774;5691;1511;5146;323;1136;797;2760;1120;3896
430655;201705;163;414;141;371;35;113;68;148;103;261
430660;201705;5449;15127;4371;13212;988;3212;1846;5536;2834;8748
430670;201705;497;1387;443;1290;38;123;314;935;352;1058
430673;201705;735;1723;322;961;71;218;82;239;153;457
430675;201705;237;700;76;266;12;54;18;52;30;106
430676;201705;3734;10925;3033;9629;713;2423;1044;3318;1757;5741
430680;201705;1090;3061;657;2146;128;423;134;412;262;835
430690;201705;3995;11349;3235;9869;1040;3350;708;2168;1748;5518
430692;201705;253;824;193;713;16;72;131;478;147;550
430693;201705;1222;3295;714;2242;160;545;122;350;282;895
430695;201705;573;1529;376;1113;58;199;168;467;226;666
430697;201705;453;1261;325;1032;75;251;124;406;199;657
430700;201705;9532;24249;4918;15693;902;3286;390;1192;1292;4478
430705;201705;273;822;209;668;52;175;57;167;109;342
430710;201705;1710;4296;1289;3573;254;777;538;1487;792;2264
430720;201705;777;1935;512;1521;121;374;165;508;286;882
430730;201705;1612;4151;1032;3174;191;609;427;1352;618;1961
430740;201705;636;1787;361;1197;69;239;74;270;143;509
430745;201705;494;1414;245;798;37;112;40;131;77;243
430750;201705;1509;4107;1148;3475;216;719;585;1734;801;2453
430755;201705;492;1304;319;944;29;97;146;395;175;492
430760;201705;2820;6913;1899;5592;445;1470;735;2238;1180;3708
430770;201705;6349;18172;5061;15802;876;2994;2695;8226;3571;11220
430780;201705;2477;6544;1552;4855;300;1010;476;1485;776;2495
430781;201705;431;1277;303;1002;69;234;73;245;142;479
430783;201705;546;1320;335;962;44;140;154;416;198;556
430786;201705;77;262;53;208;8;30;10;38;18;68
430790;201705;4571;12518;3145;9629;665;2225;1217;3524;1882;5749
430800;201705;904;2512;612;1876;114;391;245;720;359;1111
430805;201705;552;1527;326;1025;33;99;146;448;179;547
430807;201705;489;1338;325;1006;49;173;106;312;155;485
430810;201705;726;1982;258;900;45;164;50;174;95;338
430820;201705;1423;4035;801;2698;164;573;159;514;323;1087
430825;201705;315;853;130;395;26;68;26;62;52;130
430830;201705;1769;5358;1609;5131;217;765;1116;3555;1333;4320
430840;201705;992;2940;862;2705;211;656;397;1269;608;1925
430843;201705;102;260;35;106;6;16;10;29;16;45
430845;201705;274;791;217;677;92;313;24;60;116;373
430850;201705;2432;7074;2045;6335;530;1783;831;2540;1361;4323
430860;201705;1038;2647;494;1537;97;357;177;508;274;865
430865;201705;596;1569;534;1472;164;477;243;658;407;1135
430870;201705;764;2095;379;1253;78;263;75;226;153;489
430880;201705;1184;3253;831;2558;226;729;242;759;468;1488
430885;201705;249;578;138;413;12;41;99;304;111;345
430890;201705;1675;4466;1120;3372;71;272;197;487;268;759
430900;201705;2725;7072;2110;6019;403;1306;944;2551;1347;3857
430905;201705;1085;3076;698;2253;153;512;157;487;310;999
430910;201705;1643;4782;1100;3578;234;871;385;1100;619;1971
430912;201705;477;1344;351;1116;48;163;207;658;255;821
430915;201705;589;1815;422;1504;119;454;130;505;249;959
430920;201705;18243;53609;15853;49249;2875;9859;8834;26709;11709;36568
430925;201705;141;315;62;173;11;32;20;58;31;90
430930;201705;9749;26747;6562;20977;1780;6080;1398;4745;3178;10825
430940;201705;1244;3782;710;2435;191;702;85;243;276;945
430950;201705;900;2415;599;1807;130;416;230;627;360;1043
430955;201705;177;506;73;238;15;52;13;39;28;91
430957;201705;233;763;195;688;38;129;90;328;128;457
430960;201705;1465;3783;1100;3143;233;756;520;1475;753;2231
430965;201705;1598;4290;1346;3870;92;339;1002;2785;1094;3124
430970;201705;392;1077;227;728;35;115;87;266;122;381
430975;201705;556;1820;435;1529;100;373;152;548;252;921
430980;201705;376;965;243;745;50;164;88;260;138;424
430990;201705;584;1828;385;1309;70;256;115;381;185;637
430995;201705;647;1817;470;1470;113;358;194;579;307;937
431000;201705;1586;3948;742;2241;119;387;45;116;164;503
431010;201705;2629;7255;1556;5203;265;1017;162;455;427;1472
431020;201705;10360;25002;6799;18999;1649;4869;1780;4752;3429;9621
431030;201705;334;944;156;541;35;126;15;51;50;177
431033;201705;2577;7744;2241;7215;585;1922;957;3267;1542;5189
431036;201705;219;567;84;267;14;47;14;32;28;79
431040;201705;1035;2809;746;2306;136;510;353;1017;489;1527
431041;201705;500;1279;434;1188;110;310;188;529;298;839
431043;201705;475;1298;258;880;97;356;57;176;154;532
431046;201705;123;336;73;219;8;25;20;59;28;84
431050;201705;1654;4157;1192;3398;278;813;527;1515;805;2328
431053;201705;589;1833;458;1549;138;501;109;363;247;864
431055;201705;673;1763;610;1666;52;157;457;1228;509;1385
431057;201705;361;1040;223;736;43;158;56;164;99;322
431060;201705;5374;15988;4695;14822;1554;5199;1210;3965;2764;9164
431065;201705;545;1522;379;1194;66;224;117;339;183;563
431070;201705;627;1805;355;1154;86;288;56;141;142;429
431075;201705;247;765;183;626;35;136;55;189;90;325
431080;201705;681;2051;482;1591;97;337;129;414;226;751
431085;201705;757;2081;599;1737;104;294;331;955;435;1249
431087;201705;533;1526;477;1413;45;131;328;983;373;1114
431090;201705;504;1229;201;621;45;156;39;113;84;269
431100;201705;3328;9023;2678;7954;702;2287;894;2593;1596;4880
431110;201705;1472;3841;1107;3116;268;789;382;1008;650;1797
431112;201705;555;1788;504;1683;115;383;249;813;364;1196
431113;201705;463;1357;369;1168;116;384;105;348;221;732
431115;201705;1352;3846;1154;3507;199;640;632;1907;831;2547
431120;201705;2687;8077;2016;6667;611;2312;575;1726;1186;4038
431123;201705;446;1273;289;949;71;231;131;441;202;672
431125;201705;1331;3959;944;3117;284;957;211;775;495;1732
431127;201705;259;705;61;204;9;25;10;26;19;51
431130;201705;3409;9766;2363;7681;520;1789;694;2283;1214;4072
431140;201705;5125;12464;2848;8514;387;1272;844;2300;1231;3572
431142;201705;485;1387;406;1240;61;199;245;759;306;958
431150;201705;1025;3045;787;2527;171;597;276;887;447;1484
431160;201705;833;2363;674;2069;145;412;269;919;414;1331
431162;201705;555;1383;247;782;30;110;43;107;73;217
431164;201705;168;454;53;181;12;46;4;12;16;58
431170;201705;670;1827;470;1453;138;459;134;394;272;853
431171;201705;757;2186;656;1988;153;498;292;853;445;1351
431173;201705;468;1329;356;1132;136;464;76;240;212;704
431175;201705;1006;2754;797;2376;226;703;212;612;438;1315
431177;201705;759;2406;565;2017;163;647;195;678;358;1325
431179;201705;371;799;98;282;16;47;15;33;31;80
431180;201705;2192;6075;1485;4721;356;1229;274;822;630;2051
431190;201705;575;1578;319;1023;43;145;53;140;96;285
431198;201705;350;1141;311;1065;114;412;84;312;198;724
431200;201705;407;1131;113;393;12;36;0;0;12;36
431205;201705;256;740;110;390;26;88;35;129;61;217
431210;201705;704;1858;593;1699;152;429;303;912;455;1341
431213;201705;252;762;199;666;23;85;101;338;124;423
431215;201705;268;826;170;584;35;130;43;135;78;265
431217;201705;163;488;111;377;26;89;43;145;69;234
431220;201705;824;2249;459;1467;38;135;184;543;222;678
431225;201705;1321;3618;1011;3052;240;741;348;1085;588;1826
431230;201705;786;2309;589;1871;111;399;241;736;352;1135
431235;201705;133;375;36;113;7;22;4;9;11;31
431237;201705;472;1388;379;1237;65;254;194;610;259;864
431238;201705;29;101;23;84;8;35;6;20;14;55
431240;201705;3523;10289;3011;9404;768;2615;1199;3670;1967;6285
431242;201705;380;1115;318;1000;85;262;111;367;196;629
431244;201705;360;854;191;544;27;91;73;177;100;268
431245;201705;1230;3184;819;2391;145;454;348;998;493;1452
431247;201705;210;593;135;429;28;88;32;96;60;184
431250;201705;1404;4531;1238;4280;316;1149;492;1748;808;2897
431260;201705;341;956;168;575;22;97;39;112;61;209
431261;201705;259;843;216;742;47;185;84;275;131;460
431262;201705;422;1164;184;605;16;57;94;309;110;366
431265;201705;1419;3554;673;2065;101;327;187;472;288;799
431267;201705;292;821;171;522;14;56;107;299;121;355
431270;201705;2834;6910;1667;4954;408;1293;476;1438;884;2731
431275;201705;226;680;124;452;34;131;15;50;49;181
431280;201705;321;879;114;380;11;39;16;30;27;69
431290;201705;316;960;231;771;38;146;39;103;77;249
431295;201705;76;211;30;97;2;6;6;13;8;19
431300;201705;389;971;62;234;4;12;2;9;6;21
431301;201705;274;850;90;311;8;25;10;24;18;49
431303;201705;754;1993;445;1350;51;170;142;410;193;580
431306;201705;2214;5684;1334;4069;151;532;390;1047;541;1579
431308;201705;36;123;33;111;17;61;10;32;27;93
431310;201705;723;2121;425;1422;86;298;121;412;207;710
431320;201705;747;2073;379;1262;76;279;56;167;132;446
431330;201705;2501;6231;1278;3978;316;1095;124;332;440;1427
431333;201705;413;1103;151;447;21;52;32;87;53;139
431335;201705;42;125;29;99;9;31;4;8;13;39
431337;201705;2523;7520;1814;6133;444;1622;263;899;707;2521
431339;201705;542;1468;376;1133;70;227;199;587;269;814
431340;201705;23207;61215;16875;50145;3875;12625;4063;11726;7938;24351
431342;201705;540;1317;404;1099;95;300;243;618;338;918
431344;201705;364;987;254;779;9;32;179;548;188;580
431346;201705;302;768;113;350;18;56;16;48;34;104
431349;201705;745;2041;433;1306;68;220;155;421;223;641
431350;201705;4062;11743;3216;10147;787;2753;1039;3086;1826;5839
431360;201705;653;1640;403;1210;101;306;120;359;221;665
431365;201705;1508;4364;1284;3990;186;618;763;2422;949;3040
431370;201705;4880;13507;3785;11611;918;2991;1462;4656;2380;7647
431380;201705;825;2549;759;2423;109;389;429;1354;538;1743
431390;201705;2841;7461;1677;5255;310;1101;433;1212;743;2313
431395;201705;1231;3638;995;3218;235;800;414;1360;649;2160
431400;201705;402;1241;195;650;30;95;39;132;69;227
431402;201705;1096;2643;695;1925;127;376;364;951;491;1327
431403;201705;193;574;163;522;45;167;64;184;109;351
431405;201705;4161;11471;3388;10331;562;1919;1847;5579;2409;7498
431406;201705;623;1904;486;1637;104;362;263;885;367;1247
431407;201705;534;1501;358;1152;83;276;119;357;202;633
431410;201705;14433;40907;9735;31647;2597;9453;1825;5690;4422;15143
431413;201705;205;504;75;246;8;32;12;34;20;66
431415;201705;704;1994;498;1611;118;426;144;422;262;848
431417;201705;531;1341;443;1211;63;188;273;728;336;916
431420;201705;1326;3534;1151;3259;222;666;515;1536;737;2202
431430;201705;580;1513;347;1062;63;214;98;267;161;481
431440;201705;22494;61098;17734;53458;5081;16281;5027;16244;10108;32525
431442;201705;125;377;76;259;15;50;4;12;19;62
431445;201705;506;1433;194;640;26;86;47;150;73;236
431446;201705;391;1170;285;915;72;247;75;232;147;479
431447;201705;578;1616;432;1340;73;223;203;619;276;842
431449;201705;771;2091;572;1704;52;164;287;854;339;1018
431450;201705;2119;5055;1855;4677;204;612;1366;3299;1570;3911
431454;201705;61;212;53;191;11;41;21;83;32;124
431455;201705;703;1779;364;1032;66;191;120;314;186;505
431460;201705;3098;8435;2572;7432;659;1941;835;2507;1494;4448
431470;201705;1742;4994;1268;3985;261;817;441;1427;702;2244
431475;201705;202;597;36;143;4;19;2;5;6;24
431477;201705;710;1836;459;1320;57;167;202;536;259;703
431478;201705;257;656;83;244;12;37;9;19;21;56
431480;201705;3176;8566;2465;7374;448;1494;1159;3385;1607;4879
431490;201705;108671;291064;93006;267404;11156;37545;63514;178157;74670;215702
431500;201705;573;1566;447;1310;81;228;249;732;330;960
431505;201705;498;1203;330;945;33;91;196;568;229;659
431507;201705;374;902;201;564;37;108;89;234;126;342
431510;201705;1817;5114;1404;4280;300;998;499;1457;799;2455
431513;201705;322;847;160;487;21;61;83;249;104;310
431514;201705;96;263;44;145;3;14;9;21;12;35
431515;201705;582;1594;386;1190;88;305;153;432;241;737
431517;201705;74;254;56;203;10;37;13;41;23;78
431520;201705;521;1295;231;740;44;169;35;100;79;269
431530;201705;4159;9694;2897;8005;832;2419;598;1695;1430;4114
431531;201705;232;669;174;551;21;73;56;159;77;232
431532;201705;505;1377;398;1146;89;257;139;399;228;656
431535;201705;313;807;143;438;32;114;48;123;80;237
431540;201705;2050;6699;1846;6381;138;567;1258;4449;1396;5016
431545;201705;350;973;57;198;2;7;19;71;21;78
431550;201705;2169;6314;1867;5751;419;1409;767;2258;1186;3667
431555;201705;673;1651;469;1310;54;147;279;792;333;939
431560;201705;20696;59536;14545;48054;3148;11667;3351;11737;6499;23404
431570;201705;5912;14785;4643;13090;1106;3316;2214;6234;3320;9550
431575;201705;381;1022;284;859;46;158;40;105;86;263
431580;201705;589;1677;332;1116;75;272;89;288;164;560
431590;201705;936;2463;577;1760;128;403;167;518;295;921
431595;201705;410;1157;298;912;41;131;153;451;194;582
431600;201705;1945;5305;1438;4438;320;1146;322;978;642;2124
431610;201705;1412;3926;1025;3188;133;416;450;1428;583;1844
431620;201705;473;1347;234;727;46;140;102;289;148;429
431630;201705;1363;3672;775;2399;208;675;198;573;406;1248
431640;201705;6325;17219;5683;16323;958;2879;3550;10326;4508;13205
431642;201705;529;1390;371;1097;47;148;154;438;201;586
431643;201705;352;896;156;450;22;59;45;114;67;173
431645;201705;1673;4681;1403;4205;215;725;851;2540;1066;3265
431647;201705;137;409;90;298;11;39;17;49;28;88
431650;201705;311;940;222;735;41;160;65;194;106;354
431660;201705;994;2828;616;2024;113;419;127;363;240;782
431670;201705;1238;3216;924;2671;174;593;406;1087;580;1680
431673;201705;242;655;97;333;24;82;8;20;32;102
431675;201705;726;1855;145;501;18;68;40;127;58;195
431680;201705;9041;24756;6950;20773;1912;5990;1892;5740;3804;11730
431690;201705;22440;62001;17601;53815;4740;15329;5592;17596;10332;32925
431695;201705;148;428;103;334;23;80;28;68;51;148
431697;201705;476;1298;412;1195;101;308;188;557;289;865
431700;201705;1507;4222;1307;3852;198;597;721;2103;919;2700
431710;201705;12007;34391;10067;31339;3160;10469;2811;9612;5971;20081
431720;201705;6867;18896;5041;15212;1125;3616;1176;3367;2301;6983
431725;201705;30;83;18;58;3;11;4;10;7;21
431730;201705;3672;10547;2937;9273;777;2663;806;2740;1583;5403
431740;201705;5048;13663;3906;11651;1267;4174;636;1690;1903;5864
431750;201705;8402;23629;7224;21709;1698;5510;3080;9349;4778;14859
431755;201705;328;899;71;246;12;37;11;36;23;73
431760;201705;4231;11509;3345;9946;512;1733;1775;5022;2287;6755
431770;201705;1926;5131;1624;4694;259;772;983;2813;1242;3585
431775;201705;191;520;113;356;25;83;10;25;35;108
431780;201705;2153;5840;1570;4692;375;1179;408;1157;783;2336
431790;201705;1148;3354;885;2789;176;595;308;942;484;1537
431795;201705;378;1011;228;689;41;130;60;176;101;306
431800;201705;8264;23893;6582;20775;2168;7406;834;2622;3002;10028
431805;201705;337;826;101;339;11;41;22;80;33;121
431810;201705;3150;8411;2397;6941;470;1495;984;2705;1454;4200
431820;201705;2499;7598;2153;6938;469;1642;931;2954;1400;4596
431830;201705;10953;26130;8484;22546;2040;5935;3451;9189;5491;15124
431840;201705;2510;7512;2169;6894;467;1600;1086;3502;1553;5102
431842;201705;769;1950;275;852;39;130;61;168;100;298
431843;201705;354;1017;287;891;39;147;130;378;169;525
431844;201705;284;773;79;259;21;80;12;26;33;106
431845;201705;494;1414;356;1110;23;73;217;680;240;753
431846;201705;316;941;269;869;27;105;199;636;226;741
431848;201705;229;609;122;390;9;38;18;46;27;84
431849;201705;474;1144;91;257;14;37;14;29;28;66
431850;201705;4570;13330;3858;11841;843;2743;1288;3906;2131;6649
431860;201705;790;2080;547;1622;82;276;265;739;347;1015
431861;201705;105;310;58;205;9;33;16;45;25;78
431862;201705;488;1577;396;1411;76;303;176;621;252;924
431870;201705;18124;52440;14790;46300;3275;11206;5581;17320;8856;28526
431880;201705;4099;11916;3285;10296;749;2611;1204;3612;1953;6223
431890;201705;4886;13209;3411;10470;1016;3370;628;2038;1644;5408
431900;201705;1133;3081;720;2235;166;581;288;839;454;1420
431910;201705;954;2300;448;1276;57;161;124;333;181;494
431912;201705;461;1355;382;1201;81;254;191;608;272;862
431915;201705;1214;3276;929;2782;227;736;353;1037;580;1773
431920;201705;1280;3458;1116;3189;104;325;813;2301;917;2626
431930;201705;1098;3061;791;2527;178;546;389;1281;567;1827
431935;201705;64;209;53;186;14;52;12;38;26;90
431936;201705;333;993;223;729;55;196;70;222;125;418
431937;201705;281;750;164;500;40;132;21;53;61;185
431940;201705;2466;6628;1564;4797;349;1145;414;1206;763;2351
431950;201705;1602;4763;1421;4447;255;884;740;2265;995;3149
431960;201705;2740;7701;2329;6889;642;1991;695;2011;1337;4002
431970;201705;412;1153;197;657;46;155;47;138;93;293
431971;201705;90;273;58;205;8;30;10;31;18;61
431973;201705;456;1549;393;1423;43;147;267;991;310;1138
431975;201705;113;268;27;96;4;15;4;13;8;28
431980;201705;1345;3882;1073;3340;263;860;360;1072;623;1932
431990;201705;6896;18621;4851;15358;911;3234;1430;4471;2341;7705
432000;201705;10145;28000;8178;24615;2448;7541;2864;8774;5312;16315
432010;201705;2141;5900;1720;5146;251;835;848;2474;1099;3309
432020;201705;2273;5352;1650;4481;357;1073;910;2381;1267;3454
432023;201705;517;1376;306;933;49;173;132;342;181;515
432026;201705;1133;3424;857;2831;126;409;447;1466;573;1875
432030;201705;367;1040;268;821;56;175;112;324;168;499
432032;201705;517;1368;364;1072;45;151;160;433;205;584
432035;201705;811;2398;718;2236;239;824;199;617;438;1441
432040;201705;1014;2418;482;1492;64;230;165;493;229;723
432045;201705;258;701;134;449;28;102;39;135;67;237
432050;201705;588;1624;502;1474;100;328;238;701;338;1029
432055;201705;924;2536;632;1981;154;532;245;738;399;1270
432057;201705;395;969;278;761;45;111;140;365;185;476
432060;201705;481;1264;186;617;33;134;47;133;80;267
432065;201705;237;674;180;571;47;154;60;187;107;341
432067;201705;891;2691;683;2242;122;386;309;1018;431;1404
432070;201705;2358;6414;1504;4705;285;973;305;912;590;1885
432080;201705;3840;10587;3211;9492;876;2892;1191;3467;2067;6359
432085;201705;325;903;215;724;55;191;95;316;150;507
432090;201705;1477;4129;1155;3526;334;1087;427;1248;761;2335
432100;201705;1363;3887;615;2102;93;345;38;104;131;449
432110;201705;2473;7395;1823;6037;436;1679;158;480;594;2159
432120;201705;4188;12286;3464;10996;1213;4097;839;2657;2052;6754
432130;201705;2752;7471;2232;6807;695;2287;870;2696;1565;4983
432132;201705;306;865;153;521;28;101;37;116;65;217
432135;201705;756;2155;602;1843;97;319;367;1103;464;1422
432140;201705;1817;5745;1417;4975;301;1092;591;2178;892;3270
432143;201705;1341;3897;1113;3513;203;693;544;1754;747;2447
432145;201705;1358;4081;853;2907;140;531;132;420;272;951
432146;201705;173;539;117;408;33;121;23;73;56;194
432147;201705;596;1929;466;1641;141;534;91;325;232;859
432149;201705;372;1015;237;708;31;91;101;295;132;386
432150;201705;3612;10097;2718;8445;606;2104;782;2372;1388;4476
432160;201705;4352;13614;3782;12593;1152;4034;1205;4096;2357;8130
432162;201705;379;916;59;187;12;43;9;28;21;71
432163;201705;291;805;67;216;6;20;2;8;8;28
432166;201705;623;1838;495;1566;86;328;187;514;273;842
432170;201705;1208;3662;838;2877;194;700;174;578;368;1278
432180;201705;2529;6817;1515;4683;365;1193;259;684;624;1877
432183;201705;397;1246;305;1035;102;380;52;170;154;550
432185;201705;890;2343;604;1803;71;220;326;938;397;1158
432190;201705;2973;8002;1890;5716;408;1289;552;1591;960;2880
432195;201705;1062;2823;738;2271;182;543;256;799;438;1342
432200;201705;2912;8724;2364;7763;573;2075;1026;3320;1599;5395
432210;201705;393;1083;282;889;55;200;110;319;165;519
432215;201705;808;2460;699;2283;129;411;399;1354;528;1765
432218;201705;275;692;160;447;25;62;56;137;81;199
432220;201705;4218;10810;3298;9334;475;1537;1850;5013;2325;6550
432225;201705;108;318;85;272;24;76;28;93;52;169
432230;201705;1006;2678;588;1779;109;352;149;397;258;749
432232;201705;520;1433;401;1214;67;237;177;510;244;747
432234;201705;364;971;226;687;39;120;43;113;82;233
432235;201705;112;324;40;140;7;27;3;7;10;34
432237;201705;445;1183;389;1086;16;62;269;713;285;775
432240;201705;13763;42053;11645;39133;1423;5824;7111;24624;8534;30448
432250;201705;4656;15681;4202;14764;1261;4722;1391;5022;2652;9744
432252;201705;461;1177;302;910;48;154;149;450;197;604
432253;201705;1267;3970;725;2536;160;616;39;122;199;738
432254;201705;926;2491;255;829;49;182;20;52;69;234
432255;201705;205;521;110;354;18;68;35;97;53;165
432260;201705;7461;18379;5275;14846;1108;3163;2141;6364;3249;9527
432270;201705;2520;7465;2135;6745;630;2114;488;1547;1118;3661
432280;201705;1428;3806;759;2384;108;343;200;591;308;934
432285;201705;196;613;26;91;4;14;2;2;6;16
432290;201705;479;1421;304;1014;75;244;73;228;148;472
432300;201705;23913;69728;20743;64265;3538;12024;11801;36033;15339;48057
432310;201705;787;2296;618;2007;146;485;292;955;438;1440
432320;201705;208;521;86;272;16;48;11;33;27;81
432330;201705;311;816;115;380;12;37;20;71;32;108
432335;201705;160;466;71;251;11;43;14;41;25;84
432340;201705;356;861;180;544;34;120;50;140;84;260
432345;201705;645;1735;595;1659;71;265;391;1013;462;1278
432350;201705;376;1008;194;626;32;96;54;170;86;266
432360;201705;196;602;38;138;4;16;8;24;12;40
432370;201705;412;1126;301;902;29;93;178;544;207;637
432375;201705;715;1800;534;1497;77;218;297;821;374;1039
432377;201705;237;800;38;147;6;21;9;26;15;47
432380;201705;1093;3374;771;2676;193;744;310;1014;503;1758
500020;201705;2327;6563;1767;5631;368;1383;735;2269;1103;3652
500025;201705;1438;3334;857;2346;85;249;476;1281;561;1530
500060;201705;6981;20606;5466;17945;762;2549;3308;11298;4070;13847
500070;201705;4345;12280;3403;10614;749;2619;1279;4078;2028;6697
500080;201705;1442;4131;1057;3421;254;914;382;1201;636;2115
500085;201705;2184;5439;1497;4446;131;417;929;2721;1060;3138
500090;201705;2317;6536;1616;5242;325;1099;620;2136;945;3235
500100;201705;3116;8573;2508;7531;449;1513;1004;2860;1453;4373
500110;201705;8017;23486;6278;20748;1196;4223;2667;9524;3863;13747
500124;201705;2099;6642;1812;6153;425;1352;912;3476;1337;4828
500150;201705;1356;3420;892;2620;162;562;312;772;474;1334
500190;201705;5117;12871;3903;11253;814;2497;2002;5932;2816;8429
500200;201705;2528;6224;1850;5042;401;1152;744;1867;1145;3019
500210;201705;4745;13822;3860;12422;887;3024;1704;5583;2591;8607
500215;201705;1400;4244;1062;3574;170;636;406;1356;576;1992
500220;201705;3125;9354;2487;8261;436;1533;1104;3745;1540;5278
500230;201705;2987;7505;2100;6108;341;1043;1036;3069;1377;4112
500240;201705;4437;13690;3160;11056;563;2229;860;3186;1423;5415
500260;201705;3043;7195;1947;5557;258;767;967;2674;1225;3441
500270;201705;122600;315310;77317;234297;17260;56626;17798;53221;35058;109847
500280;201705;1380;3495;1073;3075;88;270;770;2231;858;2501
500290;201705;4403;9745;2467;7012;434;1360;850;2414;1284;3774
500295;201705;2614;7404;1521;4960;227;822;379;1031;606;1853
500310;201705;827;2157;665;1931;136;448;337;936;473;1384
500315;201705;3253;9994;2668;9021;377;1309;1610;5699;1987;7008
500320;201705;17687;55448;13660;47974;3873;14797;3531;13272;7404;28069
500325;201705;4519;11078;3120;8981;486;1521;1728;5037;2214;6558
500330;201705;6975;17771;4742;13776;564;1832;2284;6671;2848;8503
500345;201705;2144;5446;1620;4710;409;1255;682;1987;1091;3242
500348;201705;2241;6450;1936;5982;181;695;1280;3882;1461;4577
500350;201705;1308;3789;715;2424;64;215;229;807;293;1022
500370;201705;22384;66295;16734;56127;3579;13457;5183;17684;8762;31141
500375;201705;2901;7915;2084;6326;403;1349;563;1678;966;3027
500380;201705;3532;9408;2648;7910;585;1845;1052;3195;1637;5040
500390;201705;545;1224;314;863;47;149;154;411;201;560
500400;201705;1320;3943;971;3116;230;783;231;692;461;1475
500410;201705;2210;6210;1798;5610;300;972;1037;3345;1337;4317
500430;201705;2781;7490;2005;6351;367;1327;766;2562;1133;3889
500440;201705;1453;3763;944;2873;169;533;376;1179;545;1712
500450;201705;1341;3886;879;2958;194;722;128;367;322;1089
500460;201705;4066;11618;2777;9098;672;2444;527;1717;1199;4161
500470;201705;2973;8481;2052;6561;569;1973;320;937;889;2910
500480;201705;2308;6810;2124;6581;174;501;1659;5515;1833;6016
500490;201705;959;2555;698;2124;185;645;146;465;331;1110
500500;201705;3918;11538;3016;10173;1061;4099;720;2485;1781;6584
500510;201705;860;2206;532;1604;50;176;256;726;306;902
500515;201705;2085;5291;1658;4687;188;515;1030;3100;1218;3615
500520;201705;3309;11210;2847;10280;447;1891;1593;5651;2040;7542
500525;201705;1197;3686;969;3282;177;689;434;1508;611;2197
500540;201705;6402;17035;3686;12001;864;3336;383;1097;1247;4433
500560;201705;5003;15749;4451;14891;421;1512;3241;11036;3662;12548
500568;201705;4205;10151;2760;7984;644;2289;727;1879;1371;4168
500570;201705;7561;19482;4639;14116;1189;3911;758;2258;1947;6169
500580;201705;3694;10229;2954;9037;324;1011;1942;6035;2266;7046
500600;201705;4036;10468;2602;7893;593;1971;697;2085;1290;4056
500620;201705;7955;22351;5770;18112;922;3111;2486;7955;3408;11066
500625;201705;713;2015;393;1285;74;273;132;409;206;682
500627;201705;724;1905;478;1460;94;291;111;338;205;629
500630;201705;5868;15518;3902;12113;954;3144;1105;3427;2059;6571
500635;201705;2701;9811;2217;9074;258;1072;1551;6848;1809;7920
500640;201705;1690;3988;1256;3372;71;238;879;2281;950;2519
500660;201705;19539;55380;14969;48026;4522;16038;4088;13301;8610;29339
500690;201705;2445;7197;1924;6376;902;3178;324;1155;1226;4333
500710;201705;3416;9911;2762;8767;672;2374;966;3055;1638;5429
500720;201705;6207;16158;3851;12159;974;3447;669;2022;1643;5469
500730;201705;998;2711;668;2083;143;482;191;563;334;1045
500740;201705;4588;12065;3431;9971;350;1220;1736;5114;2086;6334
500750;201705;1004;2690;805;2343;134;431;383;1056;517;1487
500755;201705;1169;3321;777;2542;152;519;141;369;293;888
500769;201705;5579;14580;3041;9385;498;1720;570;1467;1068;3187
500770;201705;1730;4896;1154;3780;214;783;334;1089;548;1872
500780;201705;1270;3532;921;2860;235;740;206;649;441;1389
500790;201705;9698;25827;7992;23089;1490;4775;4182;11941;5672;16716
500793;201705;2186;6139;1601;5103;474;1565;249;706;723;2271
500795;201705;2393;6883;2028;6366;226;598;1458;4928;1684;5526
500797;201705;820;2188;548;1684;106;363;178;531;284;894
500800;201705;3070;7899;2226;6660;769;2629;432;1345;1201;3974
500830;201705;20263;52756;13992;41284;2576;8347;5147;14589;7723;22936
500840;201705;1369;3722;881;2751;108;365;298;876;406;1241
510010;201705;1304;3705;1045;3293;261;823;506;1643;767;2466
510020;201705;3546;9727;2095;6805;424;1448;412;1232;836;2680
510025;201705;7289;20676;5088;16374;1087;3799;1340;4068;2427;7867
510030;201705;1700;4428;1371;3957;261;808;683;1933;944;2741
510035;201705;1005;2821;688;2336;124;410;385;1393;509;1803
510040;201705;1861;4810;1429;4181;173;540;820;2394;993;2934
510050;201705;1868;5329;1369;4393;337;1203;433;1316;770;2519
510060;201705;1582;4373;1187;3634;187;631;517;1519;704;2150
510080;201705;1016;3240;824;2845;236;928;133;372;369;1300
510100;201705;701;1806;484;1381;46;149;225;583;271;732
510120;201705;312;646;202;505;12;30;135;340;147;370
510125;201705;3002;7707;2253;6412;366;1238;858;2261;1224;3499
510130;201705;1688;4670;1373;4126;356;1158;395;1169;751;2327
510140;201705;2912;8935;2229;7972;926;3751;501;1592;1427;5343
510160;201705;1266;4224;1140;4015;225;852;686;2422;911;3274
510170;201705;5118;15208;4112;13477;798;2847;1808;5863;2606;8710
510180;201705;12660;32380;8543;25729;2391;7739;2172;7510;4563;15249
510185;201705;1583;4305;1161;3711;261;792;594;2224;855;3016
510190;201705;2520;6790;1731;5610;358;1252;751;2517;1109;3769
510250;201705;14325;41698;12324;38808;3118;10507;5731;18695;8849;29202
510260;201705;2183;8930;1774;8105;304;1330;949;5044;1253;6374
510263;201705;3972;10778;2776;8735;642;2190;507;1544;1149;3734
510267;201705;5689;16526;3877;12628;901;3108;805;2606;1706;5714
510268;201705;1140;3100;896;2713;136;454;518;1547;654;2001
510269;201705;1035;3111;711;2439;252;953;142;433;394;1386
510270;201705;2867;9099;2317;8005;546;1905;809;2747;1355;4652
510279;201705;1757;5306;1398;4556;332;1165;475;1422;807;2587
510285;201705;1170;3346;871;2840;247;860;244;791;491;1651
510300;201705;3593;9956;2897;8979;230;758;2090;6624;2320;7382
510305;201705;1456;4475;1101;3793;239;850;353;1292;592;2142
510310;201705;776;2242;623;1989;207;692;195;625;402;1317
510320;201705;3871;10800;2923;9097;513;1834;986;2979;1499;4813
510325;201705;5041;15547;4208;14427;1004;3552;2436;8809;3440;12361
510330;201705;2781;8912;2157;7792;529;2003;795;3140;1324;5143
510335;201705;5054;14996;4011;13606;498;1730;2605;9419;3103;11149
510336;201705;581;1751;433;1468;76;268;206;712;282;980
510337;201705;1913;6129;1484;5333;572;2181;280;1067;852;3248
510340;201705;77971;203630;53325;164607;17008;59070;9646;30648;26654;89718
510343;201705;1099;3145;803;2557;138;466;335;1036;473;1502
510345;201705;1594;4695;1228;4023;275;946;425;1359;700;2305
510350;201705;3164;8478;2351;7312;582;1901;906;2914;1488;4815
510360;201705;1832;4309;1161;3502;92;371;817;2453;909;2824
510370;201705;1503;4770;1188;4240;212;797;662;2480;874;3277
510380;201705;528;1498;296;1019;83;306;28;103;111;409
510385;201705;977;3679;701;3048;87;416;334;1594;421;2010
510390;201705;1064;3362;926;3111;257;815;435;1582;692;2397
510395;201705;798;1902;565;1541;64;198;258;764;322;962
510410;201705;3970;12526;3340;11330;830;2901;1589;5652;2419;8553
510420;201705;2467;6023;1783;4954;190;633;939;2557;1129;3190
510450;201705;716;1847;471;1433;109;373;79;230;188;603
510452;201705;667;2121;493;1723;94;333;229;801;323;1134
510454;201705;883;2722;728;2428;125;450;411;1398;536;1848
510455;201705;970;2954;719;2396;135;515;246;764;381;1279
510460;201705;2347;6029;1719;5127;176;620;961;2780;1137;3400
510480;201705;4378;11182;3137;9001;518;1604;1246;3375;1764;4979
510490;201705;1567;4862;1313;4468;315;1167;618;2070;933;3237
510500;201705;1492;4371;1012;3428;199;816;439;1435;638;2251
510510;201705;2849;9538;2384;8663;692;2745;584;2251;1276;4996
510515;201705;6410;18185;4295;13917;914;3225;985;2894;1899;6119
510517;201705;1526;4504;1230;3959;343;1143;237;750;580;1893
510520;201705;2204;4830;1474;3918;26;70;951;2758;977;2828
510523;201705;958;2727;844;2535;97;274;595;1846;692;2120
510525;201705;5504;16482;4370;14201;908;3144;1532;4687;2440;7831
510530;201705;512;1413;415;1271;28;134;289;827;317;961
510550;201705;2845;9057;2195;7807;559;2091;708;2594;1267;4685
510558;201705;1897;5417;1634;5057;129;443;1020;3354;1149;3797
510560;201705;1634;4895;1046;3882;270;1103;232;919;502;2022
510562;201705;5416;15354;3969;12521;1080;3684;1024;3392;2104;7076
510590;201705;3285;8292;2536;7357;480;1320;1528;4732;2008;6052
510600;201705;1635;4085;1093;3186;246;738;356;1032;602;1770
510610;201705;2944;8177;2324;7248;244;868;1432;4426;1676;5294
510615;201705;2005;5973;1687;5460;506;1715;704;2365;1210;4080
510617;201705;682;1986;564;1790;32;95;442;1468;474;1563
510618;201705;1469;4178;1066;3394;204;765;503;1513;707;2278
510619;201705;761;2068;443;1471;85;307;54;164;139;471
510620;201705;1398;3460;766;2444;184;658;110;324;294;982
510621;201705;906;2954;788;2723;187;733;215;707;402;1440
510622;201705;4204;12428;3005;9869;853;3072;555;1696;1408;4768
510623;201705;3480;9365;2625;7970;587;2032;872;2523;1459;4555
510624;201705;1753;4786;868;2933;159;601;127;358;286;959
510625;201705;1995;5552;1503;4733;427;1516;243;782;670;2298
510626;201705;1606;4155;1014;3295;291;1078;196;644;487;1722
510627;201705;701;1984;478;1517;132;446;115;381;247;827
510628;201705;1565;3819;1060;3113;191;567;600;1806;791;2373
510629;201705;1728;5543;1393;4799;380;1417;419;1478;799;2895
510630;201705;2596;8432;1752;6649;388;1578;297;1203;685;2781
510631;201705;404;1112;329;981;10;25;268;809;278;834
510637;201705;3006;8340;2440;7414;805;2669;738;2232;1543;4901
510642;201705;4902;15775;4138;14633;1211;4642;1646;6106;2857;10748
510645;201705;964;2136;597;1653;174;484;179;531;353;1015
510650;201705;6439;20201;5748;19391;1214;4326;3697;12967;4911;17293
510665;201705;1789;4633;1117;3394;201;655;403;1259;604;1914
510670;201705;381;835;207;581;18;56;109;320;127;376
510675;201705;6394;19518;5030;16876;1416;5233;1109;3719;2525;8952
510677;201705;1983;5243;1522;4641;192;610;973;3091;1165;3701
510680;201705;714;2146;519;1748;120;420;78;249;198;669
510682;201705;2049;6421;1545;5482;452;1778;322;1121;774;2899
510685;201705;932;2474;716;2120;89;304;374;1047;463;1351
510700;201705;4232;10861;2851;8915;685;2165;1257;4138;1942;6303
510704;201705;10285;26622;7392;21605;1421;4658;2828;7809;4249;12467
510706;201705;1951;5771;1329;4871;266;1034;673;2624;939;3658
510710;201705;3187;8697;2228;6762;483;1523;682;1932;1165;3455
510715;201705;706;1690;491;1339;70;181;187;535;257;716
510718;201705;2527;5957;1541;4788;655;2130;292;1125;947;3255
510719;201705;398;905;247;703;29;96;120;333;149;429
510720;201705;1113;2720;777;2256;181;601;267;709;448;1310
510724;201705;757;2191;546;1799;113;402;213;673;326;1075
510726;201705;751;1722;492;1340;77;226;291;756;368;982
510729;201705;723;1800;387;1164;76;252;113;327;189;579
510730;201705;2977;8158;2122;6641;594;1988;548;1705;1142;3693
510735;201705;1011;3198;791;2881;125;506;435;1622;560;2128
510740;201705;1319;3498;940;2924;128;364;539;1857;667;2221
510757;201705;733;2377;605;2135;253;935;195;666;448;1601
510760;201705;33406;82581;21828;64061;6145;20058;4455;12183;10600;32241
510770;201705;4512;10811;3636;9781;358;889;2354;7045;2712;7934
510774;201705;355;979;288;833;54;151;131;420;185;571
510775;201705;660;1975;538;1750;146;553;116;335;262;888
510776;201705;552;1532;429;1278;90;268;171;524;261;792
510777;201705;1593;4546;1184;3993;97;341;960;3290;1057;3631
510779;201705;628;1843;501;1619;63;195;273;914;336;1109
510780;201705;3758;10793;3021;9688;705;2366;1220;4298;1925;6664
510785;201705;1781;5006;1203;3980;346;1223;183;644;529;1867
510787;201705;2426;7139;1871;6155;844;2907;257;815;1101;3722
510788;201705;619;1552;423;1255;101;286;160;573;261;859
510790;201705;15559;44532;10490;34857;2270;8724;1125;3694;3395;12418
510792;201705;8874;25015;5904;19488;1218;4414;1027;3304;2245;7718
510794;201705;1197;3705;944;3221;267;1013;260;841;527;1854
510795;201705;8209;24063;5999;19965;1644;6042;1123;4014;2767;10056
510800;201705;1600;4386;1224;3817;275;932;522;1538;797;2470
510805;201705;2029;5558;1469;4600;302;1045;592;1736;894;2781
510810;201705;686;1616;514;1381;133;350;251;654;384;1004
510820;201705;736;1666;466;1281;72;240;193;481;265;721
510830;201705;720;2030;566;1812;118;375;282;976;400;1351
510835;201705;641;1811;474;1526;83;296;211;639;294;935
510840;201705;45209;113032;36044;101032;8190;23906;16868;49320;25058;73226
510850;201705;1620;4356;1031;3308;307;1132;204;611;511;1743
510860;201705;2790;8358;1964;6837;669;2616;178;603;847;3219
510880;201705;593;1959;507;1805;130;496;221;807;351;1303
510885;201705;636;1738;501;1540;95;332;205;611;300;943
510890;201705;804;2433;658;2224;119;426;379;1311;498;1737
510895;201705;1230;3561;960;3074;214;790;345;1023;559;1813
520005;201705;1793;5365;1543;5030;455;1449;685;2449;1140;3898
520010;201705;1998;6407;1489;5306;530;2149;244;746;774;2895
520013;201705;3184;8847;2330;7202;523;1660;688;2226;1211;3886
520015;201705;506;1434;412;1305;104;357;136;452;240;809
520017;201705;1121;3194;896;2829;205;711;385;1179;590;1890
520020;201705;439;1112;342;973;77;234;154;424;231;658
520025;201705;31486;91578;28430;87948;3318;11073;21273;66013;24591;77086
520030;201705;4956;14734;4058;13249;635;2276;2139;7036;2774;9312
520050;201705;446;1117;274;791;21;56;157;475;178;531
520055;201705;860;2570;724;2306;127;396;382;1233;509;1629
520060;201705;1412;4304;1176;3868;294;1109;354;1102;648;2211
520080;201705;1923;5359;1564;4890;286;837;827;2799;1113;3636
520082;201705;1072;2817;942;2614;110;239;619;1785;729;2024
520085;201705;755;2247;646;2063;164;517;216;675;380;1192
520090;201705;959;2174;684;1829;134;307;367;1079;501;1386
520110;201705;42036;118871;32128;103817;11776;43574;2977;8972;14753;52546
520120;201705;193;497;118;369;15;51;38;121;53;172
520130;201705;3576;9735;3202;9189;701;2207;1669;4891;2370;7098
520140;201705;35336;111890;29842;101692;10876;40434;3863;13243;14739;53677
520145;201705;389;1087;286;901;56;199;90;275;146;474
520150;201705;488;1286;396;1185;57;193;244;713;301;906
520160;201705;937;2427;750;2154;170;501;278;805;448;1306
520170;201705;4812;10551;3643;9228;270;736;2958;7566;3228;8302
520180;201705;2253;6424;1888;5888;376;1323;846;2592;1222;3915
520215;201705;1986;5042;1617;4459;254;745;863;2379;1117;3124
520235;201705;690;1733;490;1433;81;271;193;539;274;810
520250;201705;1583;4340;1117;3594;304;1064;195;644;499;1708
520260;201705;816;2045;522;1506;79;235;197;561;276;796
520280;201705;585;1677;493;1505;148;446;202;678;350;1124
520310;201705;1261;2955;882;2359;225;639;286;862;511;1501
520320;201705;2015;6067;1644;5391;167;564;978;3295;1145;3859
520330;201705;2794;8531;2129;7382;581;2224;465;1627;1046;3851
520340;201705;1964;4836;1459;4112;210;518;925;2786;1135;3304
520350;201705;3345;8885;2525;7418;683;2165;841;2389;1524;4554
520355;201705;1447;4244;1198;3854;291;1024;566;1820;857;2844
520357;201705;830;2180;673;1938;63;196;459;1330;522;1526
520360;201705;765;2150;626;1917;192;610;206;653;398;1263
520380;201705;1335;3529;861;2596;130;436;354;988;484;1424
520390;201705;1011;2447;597;1868;206;744;147;406;353;1150
520393;201705;564;1345;433;1159;51;140;231;596;282;736
520396;201705;724;2222;609;2005;117;374;337;1127;454;1501
520400;201705;1630;4629;1384;4273;276;918;810;2479;1086;3397
520410;201705;1562;3640;1111;3015;170;522;666;1782;836;2304
520420;201705;340;933;248;739;35;107;124;345;159;452
520425;201705;1304;3498;999;2926;268;793;417;1276;685;2069
520430;201705;1868;4889;1114;3481;223;735;110;332;333;1067
520440;201705;3713;9448;2451;7198;693;2231;472;1367;1165;3598
520450;201705;11161;29835;7644;23697;2074;7082;422;1335;2496;8417
520455;201705;731;2131;577;1879;204;719;172;576;376;1295
520460;201705;934;2559;773;2314;121;397;459;1364;580;1761
520465;201705;844;2228;739;2078;66;234;531;1422;597;1656
520470;201705;1798;5689;1607;5397;325;1134;1009;3544;1334;4678
520480;201705;886;2571;599;2035;111;399;116;347;227;746
520485;201705;1439;4314;1249;4030;206;703;828;2704;1034;3407
520490;201705;3979;12074;3120;10720;617;2170;1688;5976;2305;8146
520495;201705;1469;3680;1210;3344;90;265;888;2559;978;2824
520500;201705;1349;3747;1110;3394;273;917;433;1298;706;2215
520505;201705;755;2068;616;1853;142;413;292;893;434;1306
520510;201705;8657;23456;6122;19516;1380;4945;1763;5666;3143;10611
520520;201705;1101;2990;878;2664;258;831;290;927;548;1758
520530;201705;2038;6526;1634;5830;573;2063;401;1607;974;3670
520540;201705;2898;7981;2048;6369;509;1651;364;1176;873;2827
520545;201705;1026;2997;827;2652;156;553;265;817;421;1370
520547;201705;686;2123;583;1942;178;602;193;636;371;1238
520549;201705;10227;29857;8480;27318;2045;6928;4149;13651;6194;20579
520551;201705;3888;11615;3498;11030;663;2331;2220;6913;2883;9244
520552;201705;795;2329;717;2230;107;339;508;1614;615;1953
520570;201705;608;1632;441;1366;121;396;155;473;276;869
520580;201705;3127;7373;2200;6118;348;1080;1232;3426;1580;4506
520590;201705;1456;4123;1109;3513;255;854;217;701;472;1555
520620;201705;8193;23332;6904;21671;1792;5817;3329;10647;5121;16464
520630;201705;1021;2569;720;2088;105;318;303;862;408;1180
520640;201705;2825;7572;2316;6719;549;1623;913;2715;1462;4338
520650;201705;914;2361;648;1873;93;285;327;934;420;1219
520660;201705;408;1034;258;799;87;299;64;213;151;512
520670;201705;994;2869;866;2683;61;204;670;2053;731;2257
520680;201705;798;2060;599;1744;137;401;248;731;385;1132
520690;201705;327;817;222;653;48;130;100;310;148;440
520710;201705;570;1461;359;1054;13;35;212;611;225;646
520725;201705;1708;4267;1254;3506;177;549;791;2188;968;2737
520735;201705;851;2245;591;1760;109;352;207;619;316;971
520740;201705;1803;4644;1454;4196;220;671;879;2536;1099;3207
520750;201705;676;1750;534;1540;102;268;245;759;347;1027
520753;201705;1566;4045;1402;3827;153;388;960;2812;1113;3200
520760;201705;801;2093;683;1935;80;205;477;1449;557;1654
520780;201705;1874;4545;1409;3880;147;416;825;2234;972;2650
520790;201705;3107;7673;2305;6478;176;470;1624;4773;1800;5243
520800;201705;16679;45318;14093;42254;2692;7710;8736;28046;11428;35756
520810;201705;1135;2721;876;2428;76;213;634;1873;710;2086
520815;201705;620;1930;458;1590;170;684;32;96;202;780
520830;201705;1692;4155;1322;3734;53;128;1092;3091;1145;3219
520840;201705;1764;5535;1522;5148;577;2078;392;1424;969;3502
520850;201705;635;1858;454;1562;115;460;117;397;232;857
520860;201705;6653;19502;5139;17016;1255;4448;1811;6226;3066;10674
520870;201705;95055;252392;70037;212950;21165;70763;15108;44779;36273;115542
520880;201705;6767;19258;5247;17066;2020;7313;792;2525;2812;9838
520890;201705;3848;10544;3030;9194;608;2110;1432;4283;2040;6393
520910;201705;3698;10387;2601;8318;884;3059;468;1419;1352;4478
520915;201705;654;1909;506;1611;104;360;208;658;312;1018
520920;201705;3659;9491;2568;7854;429;1436;1086;3432;1515;4868
520929;201705;637;1664;495;1430;91;227;252;809;343;1036
520940;201705;1158;3194;918;2845;82;279;674;2098;756;2377
520945;201705;652;1523;512;1298;84;198;283;687;367;885
520960;201705;1023;2921;809;2529;87;270;390;1255;477;1525
520970;201705;2707;8202;2338;7538;631;2213;578;1867;1209;4080
520980;201705;779;2169;654;1980;158;512;336;1030;494;1542
520990;201705;3026;9461;2832;9197;301;1022;1981;6759;2282;7781
520993;201705;988;2497;768;2155;46;132;553;1578;599;1710
520995;201705;2298;6161;1978;5736;385;1114;1160;3447;1545;4561
521000;201705;7429;21997;5938;19139;2008;6986;1256;3961;3264;10947
521010;201705;4134;11651;3223;10010;649;2012;1446;4516;2095;6528
521015;201705;721;1905;607;1722;107;307;387;1095;494;1402
521020;201705;2884;8182;1982;6311;560;1927;217;672;777;2599
521030;201705;642;1609;480;1344;84;228;198;583;282;811
521040;201705;6485;17138;5301;15290;1664;5054;1722;5150;3386;10204
521056;201705;867;2534;694;2243;220;762;196;684;416;1446
521060;201705;1060;2727;832;2374;93;275;472;1390;565;1665
521080;201705;1132;2718;641;1932;60;219;270;722;330;941
521090;201705;3053;7954;2336;6954;737;2347;634;1947;1371;4294
521100;201705;1925;4489;1406;3774;211;551;861;2376;1072;2927
521120;201705;4904;12306;3751;10827;722;2155;1614;5078;2336;7233
521130;201705;1034;2698;732;2126;62;225;409;1177;471;1402
521140;201705;1008;2963;807;2580;167;560;267;881;434;1441
521150;201705;12086;30033;7897;22932;2524;7847;2147;6422;4671;14269
521160;201705;899;2066;568;1537;90;269;258;674;348;943
521170;201705;1153;2819;841;2334;113;345;510;1370;623;1715
521180;201705;6315;19843;5613;18609;1445;5140;1915;6503;3360;11643
521190;201705;8670;24545;5741;19079;1417;5128;1142;3850;2559;8978
521200;201705;758;2029;599;1764;70;235;329;956;399;1191
521205;201705;634;1729;500;1503;46;152;316;940;362;1092
521210;201705;906;2487;557;1759;126;448;88;232;214;680
521220;201705;4404;10806;3195;9183;654;2036;1434;4214;2088;6250
521225;201705;385;942;318;868;32;77;232;668;264;745
521230;201705;1353;3997;1225;3764;417;1280;572;1790;989;3070
521250;201705;31083;92986;26035;85505;10928;37433;6733;23757;17661;61190
521260;201705;728;1727;574;1506;96;283;329;855;425;1138
521270;201705;1802;5100;1634;4872;134;326;1261;3928;1395;4254
521280;201705;1914;5773;1555;5063;477;1653;471;1529;948;3182
521290;201705;463;1244;346;1078;81;290;172;519;253;809
521295;201705;1213;2822;997;2538;114;281;727;1928;841;2209
521300;201705;1894;5215;1613;4787;184;577;1080;3232;1264;3809
521305;201705;735;2034;593;1814;98;287;324;1028;422;1315
521308;201705;4483;13145;3543;11324;740;2425;1614;5223;2354;7648
521310;201705;8508;24216;5958;19352;1514;5370;1387;4296;2901;9666
521340;201705;345;860;323;835;23;53;272;700;295;753
521350;201705;2022;5371;1608;4727;267;771;982;2941;1249;3712
521370;201705;1006;2806;679;2217;216;766;91;308;307;1074
521375;201705;1385;3851;1083;3407;243;821;442;1382;685;2203
521377;201705;1192;2873;1044;2707;66;152;892;2328;958;2480
521380;201705;5986;16500;4120;13045;525;1750;1067;3504;1592;5254
521385;201705;577;1479;480;1360;135;398;212;649;347;1047
521390;201705;757;2072;607;1871;186;633;195;605;381;1238
521400;201705;2049;5612;1815;5328;270;880;1286;3799;1556;4679
521405;201705;1423;3916;1117;3386;287;923;474;1464;761;2387
521410;201705;716;2126;667;2056;184;526;318;1060;502;1586
521440;201705;1438;4079;1142;3484;273;894;317;851;590;1745
521450;201705;3933;12499;3177;10985;911;3351;695;2428;1606;5779
521460;201705;6963;19471;5563;17007;1551;5125;2095;6276;3646;11401
521470;201705;683;1940;475;1494;103;321;89;273;192;594
521480;201705;377;1095;237;795;46;162;70;227;116;389
521483;201705;2809;7216;2072;5946;537;1576;544;1535;1081;3111
521486;201705;1708;4218;1368;3749;88;234;1044;2860;1132;3094
521487;201705;505;1325;365;1113;94;306;91;277;185;583
521490;201705;824;2300;629;1955;39;163;429;1286;468;1449
521500;201705;1437;4290;1085;3600;186;713;359;1099;545;1812
521520;201705;875;2008;636;1681;134;362;288;806;422;1168
521523;201705;13295;46321;11857;43295;3872;14993;2109;8534;5981;23527
521525;201705;1091;2749;888;2456;102;326;545;1454;647;1780
521530;201705;1857;5115;1187;3798;261;906;205;649;466;1555
521540;201705;898;2388;591;1858;99;376;243;748;342;1124
521550;201705;1613;4071;1043;2934;189;570;464;1287;653;1857
521560;201705;3711;11892;3000;10904;870;3447;1355;5137;2225;8584
521565;201705;611;1558;514;1435;79;218;332;919;411;1137
521570;201705;4800;13081;3077;9690;653;2235;407;1310;1060;3545
521580;201705;554;1292;327;955;63;187;58;167;121;354
521590;201705;624;1680;488;1462;136;463;181;510;317;973
521600;201705;434;1244;300;964;73;241;61;184;134;425
521630;201705;1393;3387;961;2768;216;721;249;640;465;1361
521640;201705;2220;5481;1691;4745;393;1068;741;2172;1134;3240
521645;201705;569;1678;406;1331;103;359;110;322;213;681
521680;201705;1291;4115;1069;3666;374;1366;111;384;485;1750
521690;201705;562;1605;492;1488;117;396;232;678;349;1074
521710;201705;2804;8085;2220;7053;494;1646;521;1671;1015;3317
521720;201705;1975;5474;1508;4612;249;780;760;2288;1009;3068
521730;201705;3850;12166;3232;10961;1164;4378;555;1646;1719;6024
521740;201705;3768;10338;2976;9177;606;2054;1291;4178;1897;6232
521760;201705;14713;45247;12427;41533;3374;12351;4500;15449;7874;27800
521770;201705;2692;7575;2085;6415;698;2300;521;1534;1219;3834
521800;201705;6799;20200;5768;18444;1729;5811;2013;6839;3742;12650
521805;201705;937;2092;674;1725;174;410;311;879;485;1289
521810;201705;786;1953;578;1653;106;324;246;739;352;1063
521830;201705;5234;16034;4574;15049;623;2246;2949;9670;3572;11916
521839;201705;699;1884;516;1547;109;367;207;580;316;947
521850;201705;6544;17334;4781;14376;1256;4085;947;2742;2203;6827
521860;201705;1945;5123;1466;4389;308;1067;472;1394;780;2461
521870;201705;486;1581;405;1414;105;389;132;435;237;824
521878;201705;794;2241;558;1764;97;340;181;528;278;868
521880;201705;22043;56416;15249;45679;3890;12400;4565;14278;8455;26678
521890;201705;3357;9722;2440;7880;614;2141;374;1171;988;3312
521900;201705;1479;3787;994;3050;238;791;338;981;576;1772
521910;201705;1140;2713;840;2360;111;334;485;1446;596;1780
521920;201705;304;947;245;827;72;269;61;206;133;475
521925;201705;709;2102;567;1836;114;383;151;465;265;848
521930;201705;3593;11206;3104;10315;1055;3592;710;2478;1765;6070
521935;201705;636;1763;535;1576;125;354;234;675;359;1029
521940;201705;997;2678;823;2433;172;567;443;1292;615;1859
521945;201705;648;1967;543;1781;91;305;258;913;349;1218
521950;201705;673;1685;534;1490;52;164;384;1073;436;1237
521960;201705;664;1950;514;1657;92;328;229;716;321;1044
521970;201705;2767;7099;2275;6513;149;365;1866;5586;2015;5951
521971;201705;988;2632;686;2090;130;411;167;495;297;906
521973;201705;1002;3020;841;2738;153;536;396;1291;549;1827
521975;201705;12846;34890;11435;33134;1928;5949;7521;21700;9449;27649
521980;201705;2243;5942;1878;5475;230;593;1412;4248;1642;4841
521990;201705;1170;3270;945;2925;112;367;610;1954;722;2321
522000;201705;2349;6311;1705;5489;220;756;879;3018;1099;3774
522005;201705;381;917;269;755;80;213;96;281;176;494
522010;201705;3447;9527;2804;8499;965;3005;660;2030;1625;5035
522015;201705;940;2717;763;2419;162;520;350;1125;512;1645
522020;201705;5285;13402;3900;11217;917;2737;1772;5136;2689;7873
522026;201705;713;1935;532;1710;75;257;304;1037;379;1294
522028;201705;572;1580;418;1233;56;169;191;528;247;697
522040;201705;2432;5793;1887;5117;345;939;1244;3449;1589;4388
522045;201705;15766;50102;12819;44196;3447;12983;2219;7561;5666;20544
522050;201705;1142;3235;807;2571;175;595;219;620;394;1215
522060;201705;2403;7097;1996;6481;401;1375;1016;3344;1417;4719
522068;201705;1712;5143;1515;4904;185;538;1094;3746;1279;4284
522070;201705;677;1975;599;1842;77;307;391;1143;468;1450
522100;201705;511;1498;426;1365;124;432;174;550;298;982
522108;201705;844;2586;698;2342;64;279;513;1672;577;1951
522119;201705;1511;4304;1237;3903;237;786;617;2003;854;2789
522130;201705;358;992;287;899;74;244;149;475;223;719
522140;201705;16720;47842;13468;41842;4045;13536;2482;7427;6527;20963
522145;201705;827;2166;662;1921;162;434;343;1093;505;1527
522150;201705;979;2506;778;2199;192;532;313;911;505;1443
522155;201705;892;2531;770;2337;175;500;403;1292;578;1792
522157;201705;662;1795;554;1637;34;127;406;1186;440;1313
522160;201705;6303;17424;4460;14116;1286;4454;440;1491;1726;5945
522170;201705;2341;6738;1763;5638;575;1961;323;1028;898;2989
522180;201705;386;1075;262;859;67;225;59;214;126;439
522185;201705;16410;44769;13003;40402;3965;13102;5442;17720;9407;30822
522190;201705;891;2174;683;1883;123;341;327;940;450;1281
522200;201705;1723;5487;1324;4580;308;1124;255;868;563;1992
522205;201705;1378;3710;1093;3271;151;503;651;1924;802;2427
522220;201705;1461;3664;1125;3219;154;449;677;2050;831;2499
522230;201705;1295;3501;1092;3195;165;555;629;1834;794;2389
530010;201705;190518;583378;167269;544278;42480;154168;70179;221990;112659;376158
110001;201704;3257;10667;2871;10037;681;2470;1416;5038;2097;7508
110002;201704;12669;36064;9694;30930;2992;10307;2907;9124;5899;19431
110003;201704;709;2204;591;1990;194;698;115;366;309;1064
110004;201704;9103;28286;7411;24949;2333;8406;1327;4815;3660;13221
110005;201704;1711;5346;1466;4890;437;1542;583;1949;1020;3491
110006;201704;1639;4978;1122;3904;344;1252;107;364;451;1616
110007;201704;1351;3987;1132;3575;333;1113;442;1597;775;2710
110008;201704;2394;8006;2212;7755;323;1072;1661;6071;1984;7143
110009;201704;4515;13618;3432;11841;1018;3742;993;3552;2011;7294
110010;201704;6943;22102;6056;20744;1761;6123;2657;10052;4418;16175
110011;201704;6818;20913;5776;18893;2013;6956;1697;5579;3710;12535
110012;201704;14887;42106;11477;36262;3114;10454;2698;8743;5812;19197
110013;201704;5401;16877;4527;15212;1801;6198;1049;3867;2850;10065
110014;201704;4030;11463;3320;10307;976;3164;1487;4576;2463;7740
110015;201704;4825;14201;3262;11070;853;3112;466;1590;1319;4702
110018;201704;3869;10646;2758;8885;711;2596;893;2766;1604;5362
110020;201704;67514;179605;49152;154792;11068;37191;20258;67205;31326;104396
110025;201704;4203;11819;3350;10333;480;1616;2078;6285;2558;7901
110026;201704;629;1903;561;1795;164;542;257;849;421;1391
110028;201704;6150;18584;4810;15891;1466;5244;575;1917;2041;7161
110029;201704;1312;3644;992;3158;267;878;419;1356;686;2234
110030;201704;10096;27470;7681;24055;1995;6938;2730;8580;4725;15518
110032;201704;3607;11166;2965;9854;984;3344;784;2626;1768;5970
110033;201704;4879;15629;4242;14473;1482;5138;1342;4911;2824;10049
110034;201704;3373;9005;2654;7987;800;2554;1323;3979;2123;6533
110037;201704;1827;6246;1592;5740;413;1572;702;2527;1115;4099
110040;201704;3223;9939;2639;8850;831;2969;818;2685;1649;5654
110045;201704;4863;15568;4222;14716;1360;5111;1800;6313;3160;11424
110050;201704;1625;5152;1362;4656;509;1796;433;1520;942;3316
110060;201704;802;2627;631;2251;222;851;96;356;318;1207
110070;201704;1942;6429;1670;5800;552;2039;575;1936;1127;3975
110080;201704;4716;12583;3888;11620;826;2510;2267;7063;3093;9573
110090;201704;688;1975;499;1630;123;447;227;713;350;1160
110092;201704;1296;4193;1150;3980;199;751;679;2425;878;3176
110094;201704;3426;10080;2852;9221;964;3311;1018;3330;1982;6641
110100;201704;2083;6491;1849;6077;427;1501;990;3269;1417;4770
110110;201704;1608;5015;1344;4611;517;1849;321;1170;838;3019
110120;201704;1680;5243;1301;4434;382;1377;266;902;648;2279
110130;201704;2453;6807;1735;5604;507;1779;459;1512;966;3291
110140;201704;2348;7550;1855;6569;529;2009;456;1518;985;3527
110143;201704;1364;3970;1024;3370;370;1267;346;1152;716;2419
110145;201704;1080;3039;750;2406;188;662;279;876;467;1538
110146;201704;388;1212;332;1120;64;206;169;587;233;793
110147;201704;674;1981;502;1653;137;474;171;529;308;1003
110148;201704;1111;3403;731;2512;140;522;80;273;220;795
110149;201704;3217;9466;2496;8327;869;2879;933;3349;1802;6228
110150;201704;2363;6741;1903;6073;617;2172;619;2004;1236;4176
110155;201704;814;2522;704;2278;165;576;296;921;461;1497
110160;201704;1796;5787;1493;5198;555;1954;434;1591;989;3545
110170;201704;2711;7583;1945;6196;431;1455;891;2827;1322;4282
110175;201704;1618;4903;1293;4444;203;751;707;2537;910;3288
110180;201704;1205;3538;990;3202;279;891;500;1661;779;2552
120001;201704;2788;9319;2513;8900;515;1880;1501;5540;2016;7420
120005;201704;1583;6521;1474;6319;180;816;1060;4739;1240;5555
120010;201704;4859;16205;4657;15915;536;1792;3614;12674;4150;14466
120013;201704;2065;8157;1966;8016;457;1825;1195;5218;1652;7043
120017;201704;1979;7093;1838;6836;484;1823;866;3580;1350;5403
120020;201704;14229;62573;13757;61683;1821;8616;9970;46067;11791;54683
120025;201704;2314;8062;2221;7925;400;1464;1418;5187;1818;6651
120030;201704;6573;25195;6378;24967;260;1283;5706;22404;5966;23687
120032;201704;1531;7351;1472;7205;154;906;1114;5464;1268;6370
120033;201704;3566;14226;3466;14051;229;1044;3040;12369;3269;13413
120034;201704;2022;8596;1937;8417;147;874;1539;6614;1686;7488
120035;201704;3190;14131;3093;13955;204;1092;2644;12016;2848;13108
120038;201704;2573;9104;2420;8821;564;2093;1331;5018;1895;7111
120039;201704;1804;8519;1756;8428;185;1085;1328;6408;1513;7493
120040;201704;43619;154764;40091;148538;9062;36317;21119;79846;30181;116163
120042;201704;3060;12493;2893;12127;213;1105;2216;9337;2429;10442
120043;201704;997;4558;962;4496;66;324;812;3905;878;4229
120045;201704;4547;15013;4382;14831;331;1278;3867;13066;4198;14344
120050;201704;8069;32586;7683;31764;973;4388;5450;23174;6423;27562
120060;201704;7908;34608;7702;34244;734;3819;6143;27602;6877;31421
120070;201704;2705;9905;2611;9714;407;1532;1742;6700;2149;8232
120080;201704;3616;13528;3457;13259;619;2501;2393;9367;3012;11868
130002;201704;3228;13011;3006;12685;154;782;2641;11233;2795;12015
130006;201704;2186;8889;1901;8386;185;978;1430;6317;1615;7295
130008;201704;2304;8815;2117;8459;241;1095;1582;6324;1823;7419
130010;201704;3279;10448;3038;10178;140;483;2747;9277;2887;9760
130014;201704;3233;10380;2775;9631;487;1831;1748;6146;2235;7977
130020;201704;2826;10549;2680;10299;118;655;2293;8705;2411;9360
130030;201704;8170;30075;7796;29649;235;723;7262;28180;7497;28903
130040;201704;3770;11514;3307;10923;283;1035;2656;8883;2939;9918
130050;201704;6285;25352;5929;24885;298;1243;5157;22275;5455;23518
130060;201704;5990;27408;5697;26950;506;2852;4561;21698;5067;24550
130063;201704;4228;17770;3982;17476;229;1131;3546;15690;3775;16821
130068;201704;3212;13271;2895;12614;252;1275;2106;9267;2358;10542
130070;201704;7544;24294;6703;23322;465;1568;5625;20124;6090;21692
130080;201704;5719;24425;5315;23860;611;3280;3967;17929;4578;21209
130083;201704;2318;8876;2173;8648;251;1173;1635;6493;1886;7666
130090;201704;2874;9912;2739;9709;84;368;2423;8706;2507;9074
130100;201704;5938;21378;5763;21176;133;521;5482;20273;5615;20794
130110;201704;6786;21644;6406;21208;608;1840;5313;18129;5921;19969
130115;201704;4736;16342;4496;15975;169;656;3887;13906;4056;14562
130120;201704;15057;56165;14033;54842;1444;5855;11244;45012;12688;50867
130130;201704;4104;16323;4031;16204;287;1369;3409;13709;3696;15078
130140;201704;6258;24528;6147;24408;263;1109;5717;22784;5980;23893
130150;201704;3447;13666;3379;13582;136;724;3058;12272;3194;12996
130160;201704;4394;17933;4185;17667;430;2192;3410;14409;3840;16601
130165;201704;2938;11959;2796;11712;159;841;2362;9959;2521;10800
130170;201704;9971;33836;8576;32183;881;3522;6776;26079;7657;29601
130180;201704;3625;11862;3560;11778;71;242;3391;11290;3462;11532
130185;201704;12488;38253;11042;36663;672;1754;9380;32822;10052;34576
130190;201704;17060;58451;14948;55649;2231;8391;10379;40181;12610;48572
130195;201704;1981;8402;1923;8329;111;454;1700;7542;1811;7996
130200;201704;2047;6919;1864;6644;295;1050;1282;4739;1577;5789
130210;201704;1377;5309;1250;5157;125;687;981;3989;1106;4676
130220;201704;1992;8129;1843;7847;201;1022;1291;5518;1492;6540
130230;201704;3757;17135;3519;16753;412;2142;2721;13262;3133;15404
130240;201704;9303;33302;8299;31850;340;1823;7190;27672;7530;29495
130250;201704;20541;70314;19290;68787;2314;8021;14818;55122;17132;63143
130255;201704;4300;14967;4011;14515;257;1055;3369;12262;3626;13317
130260;201704;251469;811762;224911;767625;65446;239853;95904;329967;161350;569820
130270;201704;7529;30825;6976;29975;820;3747;5249;23217;6069;26964
130280;201704;3352;13926;3229;13781;110;489;2991;12946;3101;13435
130290;201704;11207;39627;10592;38924;177;469;10089;37803;10266;38272
130300;201704;4630;17392;4378;17015;262;1242;3743;14651;4005;15893
130310;201704;5133;19443;4734;18919;386;1709;3885;15795;4271;17504
130320;201704;3095;11096;2832;10732;385;1497;1964;7711;2349;9208
130330;201704;3861;13707;3459;13218;159;817;2981;11381;3140;12198
130340;201704;18871;70359;17312;68477;1858;7356;14015;57214;15873;64570
130350;201704;3494;14030;3374;13856;246;1368;2848;11563;3094;12931
130353;201704;6269;19070;5486;18080;958;3072;3662;12931;4620;16003
130356;201704;4805;17105;4457;16555;504;1931;3262;12455;3766;14386
130360;201704;3348;9569;2943;9143;85;224;2749;8683;2834;8907
130370;201704;5533;21637;5029;20985;187;1019;4359;18360;4546;19379
130380;201704;8107;33393;7795;32943;529;2691;6627;28052;7156;30743
130390;201704;5318;23395;5022;22833;546;2911;3737;16982;4283;19893
130395;201704;2267;7813;2024;7370;223;850;1438;5290;1661;6140
130400;201704;2131;8017;1994;7817;111;528;1743;6858;1854;7386
130406;201704;10852;40880;9884;39563;1822;7664;6659;27153;8481;34817
130410;201704;3908;14630;3473;13867;1054;4471;1627;6678;2681;11149
130420;201704;11056;45491;10536;44751;1468;6533;8013;34872;9481;41405
130423;201704;3675;13296;3396;12917;237;1169;2889;10876;3126;12045
130426;201704;2419;10137;2341;10015;118;553;2069;8994;2187;9547
130430;201704;3604;12403;3449;12182;249;911;2915;10468;3164;11379
130440;201704;3714;13224;3477;12950;170;699;3110;11672;3280;12371
140002;201704;1749;5695;1592;5486;123;502;1241;4278;1364;4780
140005;201704;3635;9817;3494;9665;63;163;3372;9367;3435;9530
140010;201704;54697;155709;44605;141075;10764;36154;18395;61682;29159;97836
140015;201704;3048;9672;2816;9399;139;428;2503;8518;2642;8946
140017;201704;3296;10448;2955;10010;292;1021;2211;7801;2503;8822
140020;201704;4648;15255;4123;14530;530;2121;2929;10357;3459;12478
140023;201704;2240;7356;1934;6896;220;852;1358;4944;1578;5796
140028;201704;2106;5797;1913;5540;199;684;1440;4045;1639;4729
140030;201704;3680;11438;3407;11081;524;1494;2434;8302;2958;9796
140040;201704;1824;8284;1768;8208;103;638;1583;7278;1686;7916
140045;201704;2597;9565;2343;9214;431;1677;1537;6434;1968;8111
140047;201704;5736;17387;5011;16237;1215;3977;2421;8458;3636;12435
140050;201704;1447;4487;1279;4252;206;701;826;2819;1032;3520
140060;201704;1451;4342;1290;4091;201;678;899;2876;1100;3554
140070;201704;1657;9024;1603;8872;156;1054;1237;6860;1393;7914
150010;201704;37379;107514;35114;104485;2101;7090;29071;86343;31172;93433
150013;201704;1721;4963;1536;4755;161;463;1164;3713;1325;4176
150020;201704;12656;41878;12214;41273;1377;4154;9894;34562;11271;38716
150030;201704;7735;31938;7483;31581;529;2223;6415;27618;6944;29841
150034;201704;4209;11547;3816;10995;267;820;3154;9101;3421;9921
150040;201704;12765;39971;11325;38292;1196;3311;9044;32534;10240;35845
150050;201704;5715;22440;5441;21977;239;1257;4740;19137;4979;20394
150060;201704;18499;56787;16631;53831;3803;12231;9422;31850;13225;44081
150070;201704;6190;24724;5554;24040;194;1031;5121;22344;5315;23375
150080;201704;81611;205222;69784;189761;14932;41830;31747;94098;46679;135928
150085;201704;5832;19361;5576;19048;302;848;4973;17457;5275;18305
150090;201704;10462;39578;9883;38735;846;3577;7824;31142;8670;34719
150095;201704;5441;17446;4954;16772;320;1052;4009;13979;4329;15031
150100;201704;3235;11849;3001;11435;201;904;2366;8933;2567;9837
150110;201704;3685;17240;3662;17201;198;1003;3285;15576;3483;16579
150120;201704;6849;24281;6667;24017;447;1389;5659;21159;6106;22548
150125;201704;755;2114;651;1990;92;312;445;1365;537;1677
150130;201704;22692;68201;20794;65532;2361;7163;15332;49741;17693;56904
150140;201704;171415;467086;158075;449653;21429;60413;113489;329162;134918;389575
150145;201704;4614;14303;4186;13742;465;1496;3340;11198;3805;12694
150150;201704;12585;37182;11587;35751;1512;4960;8181;25555;9693;30515
150157;201704;3112;9210;2692;8642;328;1168;1843;6045;2171;7213
150160;201704;3093;9721;2909;9453;765;2530;1615;5443;2380;7973
150170;201704;21888;79570;20689;77624;2887;11134;14781;56698;17668;67832
150172;201704;3151;10474;2767;9858;273;1018;2095;7632;2368;8650
150175;201704;1868;5650;1736;5493;130;443;1413;4598;1543;5041
150178;201704;9919;30104;8504;28423;984;3411;6251;21657;7235;25068
150180;201704;18987;74911;18236;73923;1129;5185;15710;64233;16839;69418
150190;201704;7105;24101;6837;23754;192;829;6266;21880;6458;22709
150195;201704;5425;17457;5116;16980;131;444;4682;15675;4813;16119
150200;201704;5368;16826;5087;16499;90;309;4813;15724;4903;16033
150210;201704;24993;92767;24214;91721;1698;6623;20403;79355;22101;85978
150215;201704;7550;23576;6650;22181;2121;7285;2634;9190;4755;16475
150220;201704;11498;35363;10362;33641;2198;7233;5588;18787;7786;26020
150230;201704;12099;36888;10543;34756;1586;5296;6863;23578;8449;28874
150240;201704;34703;102489;29862;93901;10018;32590;7993;26379;18011;58969
150250;201704;4062;16894;3919;16692;773;3295;2662;11838;3435;15133
150260;201704;2048;7928;1945;7756;321;1303;1248;5112;1569;6415
150270;201704;8251;25002;6419;22650;1675;6066;3237;11990;4912;18056
150275;201704;6023;21472;5673;20941;621;2226;4287;16250;4908;18476
150276;201704;2143;6387;1910;6094;272;904;1434;4658;1706;5562
150277;201704;4778;14445;4094;13608;568;2025;2950;10077;3518;12102
150280;201704;5837;26101;5671;25755;675;3131;4360;20196;5035;23327
150285;201704;3083;11619;2845;11235;277;1220;2053;8260;2330;9480
150290;201704;10100;28410;9621;27881;534;1342;8498;25325;9032;26667
150293;201704;9207;24553;6856;21353;2020;6535;2492;8581;4512;15116
150295;201704;7557;21773;6236;20245;1398;4505;3538;12825;4936;17330
150300;201704;2052;6667;1914;6477;87;408;1599;5383;1686;5791
150304;201704;4170;13248;3647;12411;632;2131;2327;8248;2959;10379
150307;201704;6539;21573;6162;21049;342;1225;5286;18155;5628;19380
150309;201704;6123;20548;5432;19516;1281;4551;2917;11181;4198;15732
150310;201704;6570;27595;6261;27168;450;2238;5235;22866;5685;25104
150320;201704;9550;24640;8740;23720;535;1429;7264;19933;7799;21362
150330;201704;14100;47178;13210;45916;1773;6245;9729;34755;11502;41000
150340;201704;2569;7952;2372;7648;210;717;1820;5893;2030;6610
150345;201704;6919;22377;6470;21773;522;1811;5273;18076;5795;19887
150350;201704;8280;24535;7702;23836;1135;2931;5815;18896;6950;21827
150360;201704;21352;65284;18585;61801;2900;9478;12506;43463;15406;52941
150370;201704;9908;35098;9024;33892;924;3495;6831;26607;7755;30102
150375;201704;3026;13033;2791;12685;211;1008;2377;10926;2588;11934
150380;201704;9714;27836;8536;26196;490;1538;7156;22300;7646;23838
150390;201704;7761;33514;7260;32621;1189;5182;4869;22878;6058;28060
150400;201704;5964;22914;5732;22473;447;1749;4601;18376;5048;20125
150405;201704;8267;24553;7361;23440;692;1751;5626;19098;6318;20849
150410;201704;1609;5998;1482;5742;228;1012;927;3612;1155;4624
150420;201704;35697;117181;29620;107465;9897;38529;8486;33974;18383;72503
150430;201704;7688;25069;7283;24471;837;2728;5533;19100;6370;21828
150440;201704;5444;18433;5225;18148;432;1488;4310;15265;4742;16753
150442;201704;21850;61882;19173;57873;3163;9586;11676;36691;14839;46277
150445;201704;5568;18710;5123;18013;444;1582;3996;14332;4440;15914
150450;201704;4359;20701;4203;20437;443;2241;3379;16728;3822;18969
150460;201704;7278;26282;6736;25608;373;1624;5616;22243;5989;23867
150470;201704;17836;54210;17051;53272;1148;3022;14957;47733;16105;50755
150475;201704;3801;13059;3493;12629;270;1013;2834;10439;3104;11452
150480;201704;14114;47856;12903;45975;1468;5442;9723;35467;11191;40909
150490;201704;7245;27475;7047;27175;265;1233;6246;24246;6511;25479
150495;201704;5072;18441;4914;18236;168;676;4528;16941;4696;17617
150497;201704;2571;9348;2298;8829;696;2786;1054;4193;1750;6979
150500;201704;3180;8660;2930;8301;297;811;2313;6577;2610;7388
150503;201704;3536;10864;2939;10055;938;3255;1497;5367;2435;8622
150506;201704;10722;36843;9770;35501;2113;7177;6165;24124;8278;31301
150510;201704;9916;38060;8970;36123;1422;5564;5843;24764;7265;30328
150520;201704;6809;26738;6698;26599;231;948;6274;25134;6505;26082
150530;201704;12369;42476;11186;40628;1112;3810;8555;31870;9667;35680
150540;201704;4667;13936;4116;13165;244;862;3417;10932;3661;11794
150543;201704;5824;17692;5122;16720;960;3217;3234;10956;4194;14173
150548;201704;9421;29996;8751;29161;333;985;8027;27113;8360;28098
150549;201704;2073;6640;1890;6439;55;223;1734;5940;1789;6163
150550;201704;20165;63668;17602;59317;5171;17739;6662;23915;11833;41654
150553;201704;22966;77453;18971;69601;6690;25967;4956;19377;11646;45344
150555;201704;1771;5164;1464;4675;84;306;1067;3419;1151;3725
150560;201704;1856;6044;1713;5757;274;918;1019;3493;1293;4411
150563;201704;2562;8478;2359;8115;537;1973;1276;4405;1813;6378
150565;201704;3974;13556;3626;12998;147;708;3044;10982;3191;11690
150570;201704;5900;21136;5721;20837;445;1826;4549;16617;4994;18443
150580;201704;9872;40937;9569;40568;597;2631;8314;35934;8911;38565
150590;201704;6025;23578;5812;23309;158;745;5462;21944;5620;22689
150600;201704;8235;31171;7851;30628;279;1314;7058;27739;7337;29053
150610;201704;2405;8027;2219;7653;195;763;1677;5715;1872;6478
150611;201704;2737;9164;2569;8876;145;544;2140;7434;2285;7978
150613;201704;12153;35474;9750;31787;2619;8973;4184;14062;6803;23035
150616;201704;3131;9386;2378;8112;586;2230;731;2379;1317;4609
150618;201704;6490;21541;5770;20286;1303;4632;3173;11596;4476;16228
150619;201704;5143;17344;4713;16668;510;1959;3471;12299;3981;14258
150620;201704;6329;22456;5704;21660;628;2498;4403;16932;5031;19430
150630;201704;5891;17288;5560;16904;442;1412;4696;14500;5138;15912
150635;201704;3908;12526;3506;11759;916;3166;1497;5193;2413;8359
150640;201704;2071;5943;1937;5794;80;229;1771;5433;1851;5662
150650;201704;11580;35073;10446;33067;2900;9206;4520;15089;7420;24295
150655;201704;5071;16347;4755;15794;515;1831;3658;12224;4173;14055
150658;201704;4461;13183;3836;12358;712;2540;2394;8002;3106;10542
150660;201704;5632;17366;5135;16645;989;3213;3026;10081;4015;13294
150670;201704;7669;19799;6269;18102;646;1898;4869;14441;5515;16339
150680;201704;60926;202875;51423;187529;14511;53887;21648;87439;36159;141326
150690;201704;2013;6106;1818;5815;178;587;1364;4407;1542;4994
150700;201704;6131;19119;5632;18460;776;2537;3937;13334;4713;15871
150710;201704;4306;14323;3869;13641;376;1456;2792;9966;3168;11422
150715;201704;4863;15116;4255;14190;399;1514;3182;10671;3581;12185
150720;201704;6457;25573;6115;24966;629;2867;4700;19497;5329;22364
150730;201704;10312;34600;9493;33241;1171;4266;7080;25399;8251;29665
150740;201704;3617;11360;3232;10685;554;1896;1928;6430;2482;8326
150745;201704;4862;15489;4374;14809;1048;3719;2636;9017;3684;12736
150746;201704;1339;4384;1275;4264;104;357;991;3370;1095;3727
150747;201704;5376;16602;4761;15819;575;1719;3354;11974;3929;13693
150750;201704;3505;11234;3175;10778;195;789;2549;8748;2744;9537
150760;201704;11433;35885;10616;34847;1292;4350;7848;26289;9140;30639
150770;201704;5931;22409;5719;22082;211;709;5117;20648;5328;21357
150775;201704;1054;3187;899;2930;169;673;508;1611;677;2284
150780;201704;3603;11519;3477;11377;125;509;3162;10351;3287;10860
150790;201704;5085;16290;4639;15780;276;918;3796;13833;4072;14751
150795;201704;14967;48021;13500;45737;3024;9996;7789;27869;10813;37865
150796;201704;3189;9153;2869;8775;258;836;2266;7078;2524;7914
150797;201704;3761;12788;3449;12231;128;500;2871;10225;2999;10725
150800;201704;13841;44730;12715;43351;2345;7318;8743;31824;11088;39142
150803;201704;6775;23979;6353;23302;692;2744;4809;17770;5501;20514
150805;201704;2748;9705;2522;9325;328;1223;1811;6828;2139;8051
150808;201704;5633;18411;4548;16327;1744;6847;546;2058;2290;8905
150810;201704;19494;57881;15820;53415;2561;8477;9990;36016;12551;44493
150812;201704;5338;16535;4888;15765;599;2157;3454;10906;4053;13063
150815;201704;8388;27640;7518;26556;739;2593;5896;21448;6635;24041
150820;201704;11376;32798;10200;31487;757;2092;8266;26385;9023;28477
150830;201704;12557;47465;11883;46649;605;3015;9998;40355;10603;43370
150835;201704;2133;7436;1991;7157;434;1571;1085;4060;1519;5631
150840;201704;7334;22248;6041;20044;1296;4626;2860;9606;4156;14232
160005;201704;825;2744;789;2681;58;231;652;2199;710;2430
160010;201704;1395;4682;1392;4679;19;30;1360;4617;1379;4647
160015;201704;1777;6554;1731;6485;86;281;1574;6026;1660;6307
160020;201704;1862;6849;1736;6653;210;906;1295;5005;1505;5911
160021;201704;1045;4439;1007;4373;116;642;756;3268;872;3910
160023;201704;970;4063;960;4043;76;312;814;3487;890;3799
160025;201704;1481;4484;1461;4462;38;101;1403;4306;1441;4407
160027;201704;8206;24333;7643;23708;1061;3142;5865;18927;6926;22069
160030;201704;50846;171386;44836;162003;10720;38463;23264;90951;33984;129414
160040;201704;4276;16679;4178;16546;174;996;3792;14830;3966;15826
160050;201704;3322;12224;2941;11678;1458;5521;929;4303;2387;9824
160053;201704;2989;11047;2911;10936;738;2716;1847;7217;2585;9933
160055;201704;562;2237;557;2230;31;160;500;1980;531;2140
160060;201704;15727;53585;14940;52676;1631;5634;11783;42537;13414;48171
160070;201704;2783;10817;2609;10534;198;921;2165;8774;2363;9695
160080;201704;2578;9598;2517;9522;57;297;2360;8905;2417;9202
170025;201704;532;1702;464;1605;138;479;224;801;362;1280
170030;201704;1178;3817;1009;3514;202;734;478;1695;680;2429
170035;201704;1362;3802;1108;3358;127;414;624;1906;751;2320
170040;201704;1884;5761;1637;5444;165;603;861;3126;1026;3729
170070;201704;1580;4204;1194;3694;202;676;684;2136;886;2812
170100;201704;2297;6823;2010;6402;187;569;1505;4867;1692;5436
170105;201704;748;2320;579;1961;139;496;237;780;376;1276
170110;201704;902;2991;779;2751;168;646;347;1242;515;1888
170130;201704;1361;4285;1066;3704;249;905;473;1732;722;2637
170190;201704;1563;4592;1161;3929;375;1188;261;1102;636;2290
170200;201704;1604;4369;1019;3257;288;999;204;614;492;1613
170210;201704;30847;86709;24588;76803;8132;27566;4791;16099;12923;43665
170215;201704;1250;3779;1066;3508;98;390;762;2475;860;2865
170220;201704;5496;18537;5028;17601;1143;4105;2656;9577;3799;13682
170230;201704;1348;4260;1088;3745;226;836;449;1543;675;2379
170240;201704;2756;8095;2227;7255;223;865;1500;4845;1723;5710
170255;201704;3446;10798;2787;9610;798;2802;1125;4016;1923;6818
170270;201704;1007;2473;675;2022;37;114;464;1360;501;1474
170290;201704;2804;8063;2456;7669;239;475;1960;6670;2199;7145
170300;201704;1859;5607;1519;5048;164;546;976;3332;1140;3878
170305;201704;723;2133;590;1884;91;327;284;902;375;1229
170307;201704;981;3472;839;3199;186;749;409;1606;595;2355
170310;201704;1504;4214;1148;3594;263;888;551;1724;814;2612
170320;201704;1125;3190;817;2678;140;492;423;1432;563;1924
170330;201704;802;2608;731;2493;47;194;554;1857;601;2051
170360;201704;460;1419;372;1266;63;250;205;666;268;916
170370;201704;1318;3685;1010;3186;157;524;495;1567;652;2091
170380;201704;1764;5697;1430;5136;195;792;784;2893;979;3685
170382;201704;568;1767;471;1601;48;209;312;1050;360;1259
170384;201704;1588;6290;1436;6002;402;1781;678;2878;1080;4659
170386;201704;850;2448;653;2074;149;548;191;533;340;1081
170388;201704;595;1766;458;1529;88;313;187;607;275;920
170389;201704;898;3016;802;2858;63;256;595;2101;658;2357
170390;201704;1318;3663;1076;3367;88;287;812;2604;900;2891
170410;201704;536;1700;433;1511;26;114;276;958;302;1072
170460;201704;478;1291;334;1047;47;174;153;482;200;656
170510;201704;780;2525;603;2182;94;393;295;1039;389;1432
170550;201704;6548;18431;4825;15452;1544;5498;709;2318;2253;7816
170555;201704;1322;3749;1050;3334;156;537;550;1790;706;2327
170560;201704;1167;3508;898;3144;151;590;473;1812;624;2402
170600;201704;1258;3717;1094;3485;296;895;614;2053;910;2948
170610;201704;1618;4851;1291;4271;140;529;835;2734;975;3263
170625;201704;396;1177;294;961;37;124;107;329;144;453
170650;201704;1230;3896;995;3468;257;946;353;1321;610;2267
170700;201704;3935;12193;3185;10920;619;2314;1467;5240;2086;7554
170710;201704;1755;5106;1384;4420;273;957;646;2006;919;2963
170720;201704;1829;4827;1572;4445;128;299;1255;3705;1383;4004
170730;201704;944;2814;759;2501;201;704;316;1074;517;1778
170740;201704;2124;7545;1841;7018;274;1071;1167;4538;1441;5609
170755;201704;815;2484;609;2060;86;321;281;945;367;1266
170765;201704;1230;3355;905;2841;245;800;343;1153;588;1953
170770;201704;1707;5641;1523;5343;296;1023;894;3232;1190;4255
170820;201704;3881;13631;3516;13016;622;2246;2023;8048;2645;10294
170825;201704;972;2489;801;2235;103;274;481;1371;584;1645
170830;201704;1440;4104;1192;3719;66;164;952;3036;1018;3200
170900;201704;2529;8908;2371;8665;204;833;1907;7039;2111;7872
170930;201704;3708;10830;3189;10045;693;2379;1598;5202;2291;7581
170950;201704;13649;39481;10166;33432;3009;11228;1492;4989;4501;16217
170980;201704;492;1396;374;1208;60;208;176;534;236;742
171050;201704;1536;5052;1375;4748;90;408;1061;3621;1151;4029
171070;201704;1399;4292;1270;4111;247;744;818;2815;1065;3559
171090;201704;1107;2887;906;2619;60;180;667;1918;727;2098
171110;201704;576;1681;426;1416;115;436;176;516;291;952
171150;201704;1017;2748;666;2122;75;265;403;1299;478;1564
171180;201704;691;2065;465;1605;91;322;189;697;280;1019
171190;201704;1512;5646;1343;5305;269;1088;683;2838;952;3926
171195;201704;829;2849;717;2653;90;428;459;1674;549;2102
171200;201704;627;1938;493;1687;152;553;158;529;310;1082
171215;201704;446;1311;341;1101;65;245;159;509;224;754
171240;201704;687;2503;636;2408;64;319;399;1546;463;1865
171245;201704;580;1948;475;1696;109;429;180;626;289;1055
171250;201704;1047;2983;829;2627;167;566;424;1343;591;1909
171270;201704;392;1580;363;1518;118;450;148;704;266;1154
171280;201704;876;2705;731;2453;165;564;327;1178;492;1742
171320;201704;3759;11217;3140;10146;860;2784;1312;4479;2172;7263
171330;201704;2727;7905;2207;7055;538;1845;1075;3484;1613;5329
171360;201704;1418;4459;1263;4237;101;381;1001;3378;1102;3759
171370;201704;667;1879;565;1741;85;297;366;1140;451;1437
171380;201704;1257;4013;1047;3647;380;1335;295;1165;675;2500
171395;201704;904;2667;682;2230;114;445;329;1032;443;1477
171420;201704;1881;5868;1445;5002;330;1251;572;2001;902;3252
171430;201704;1019;3104;842;2796;132;434;504;1667;636;2101
171488;201704;2503;7589;2092;6972;428;1423;1114;3904;1542;5327
171500;201704;870;2480;689;2189;63;212;475;1513;538;1725
171510;201704;832;2896;743;2736;62;260;529;1974;591;2234
171515;201704;486;1373;372;1179;38;123;214;670;252;793
171525;201704;606;1927;521;1780;47;190;343;1132;390;1322
171550;201704;358;1119;270;969;62;250;105;376;167;626
171570;201704;1254;3865;1082;3537;192;589;690;2353;882;2942
171575;201704;1908;5227;1357;4272;236;796;618;1930;854;2726
171610;201704;5125;16034;4245;14501;1093;4115;1285;4522;2378;8637
171620;201704;2735;7784;2333;7253;116;436;1917;6012;2033;6448
171630;201704;880;2685;745;2484;193;673;400;1336;593;2009
171650;201704;2179;6675;1642;5568;374;1300;563;1950;937;3250
171660;201704;2359;6530;1758;5453;271;875;922;2837;1193;3712
171665;201704;1470;4240;1147;3752;225;785;537;1838;762;2623
171670;201704;1833;5091;1502;4566;362;1231;670;1990;1032;3221
171700;201704;1082;3407;892;3045;146;509;475;1654;621;2163
171720;201704;770;2242;656;2047;126;405;382;1215;508;1620
171750;201704;1139;3513;867;2986;246;845;245;902;491;1747
171780;201704;1202;3210;878;2747;77;266;539;1696;616;1962
171790;201704;1445;5111;1216;4580;268;1014;598;2413;866;3427
171800;201704;726;2188;590;1984;64;221;376;1308;440;1529
171820;201704;10035;29842;8184;26822;1691;5922;3610;12201;5301;18123
171830;201704;1317;4859;1183;4566;317;1197;509;2103;826;3300
171840;201704;709;1994;604;1843;39;140;458;1373;497;1513
171845;201704;672;1851;531;1620;80;274;282;874;362;1148
171850;201704;877;3136;778;2932;82;347;517;1956;599;2303
171855;201704;1135;3570;1034;3390;74;257;759;2489;833;2746
171865;201704;429;1446;373;1354;69;257;178;651;247;908
171870;201704;711;2118;567;1857;122;402;237;864;359;1266
171875;201704;1223;3851;1027;3535;79;335;724;2466;803;2801
171880;201704;876;3125;842;3080;86;275;681;2589;767;2864
171884;201704;905;2479;666;2120;141;511;194;713;335;1224
171886;201704;1353;4267;1037;3638;315;1202;209;758;524;1960
171888;201704;722;2157;538;1785;66;240;297;977;363;1217
171889;201704;502;1537;440;1427;74;249;226;793;300;1042
171890;201704;1200;3527;978;3203;171;566;554;1841;725;2407
171900;201704;488;1755;391;1508;94;370;149;595;243;965
172000;201704;587;1872;501;1703;72;281;267;882;339;1163
172010;201704;1163;4019;1068;3846;112;482;745;2661;857;3143
172015;201704;336;1309;275;1186;48;202;140;625;188;827
172020;201704;2331;7659;2168;7413;253;933;1527;5278;1780;6211
172025;201704;705;2042;518;1729;71;271;274;932;345;1203
172030;201704;1177;3711;1044;3496;53;223;816;2726;869;2949
172049;201704;1327;3365;939;2714;386;1221;378;1040;764;2261
172065;201704;1355;3512;1102;3225;65;192;988;2925;1053;3117
172080;201704;2417;7446;2012;6724;176;686;1349;4488;1525;5174
172085;201704;479;1351;341;1066;59;170;112;346;171;516
172090;201704;3889;10462;3175;9457;106;336;2695;8113;2801;8449
172093;201704;547;1655;419;1428;87;338;201;672;288;1010
172097;201704;660;1901;506;1648;105;356;185;628;290;984
172100;201704;36855;103838;27434;88077;7300;26192;7404;24623;14704;50815
172110;201704;1638;6150;1442;5834;175;769;1032;4305;1207;5074
172120;201704;5016;15591;4096;14226;797;2797;2274;8242;3071;11039
172125;201704;255;808;211;726;42;168;101;344;143;512
172130;201704;533;1497;409;1285;39;148;257;796;296;944
172208;201704;2128;6111;1854;5708;240;755;1138;3567;1378;4322
172210;201704;2542;7462;2186;6964;379;1306;1329;4244;1708;5550
210005;201704;21249;65194;17893;60039;5686;20301;6603;22875;12289;43176
210010;201704;1705;5969;1551;5705;73;317;1293;4794;1366;5111
210015;201704;3441;10721;3055;10129;183;490;2587;8873;2770;9363
210020;201704;7120;16944;6694;16450;171;463;6194;15159;6365;15622
210030;201704;5250;17519;4940;17106;325;1567;4123;14092;4448;15659
210040;201704;2157;6638;2037;6502;53;146;1887;6127;1940;6273
210043;201704;6872;18731;5853;17507;746;2090;4140;13235;4886;15325
210047;201704;6484;23344;5940;22568;427;1947;4811;18319;5238;20266
210050;201704;2248;8246;1873;7506;511;2105;835;3605;1346;5710
210055;201704;1710;5950;1570;5730;99;420;1230;4511;1329;4931
210060;201704;6981;27318;6480;26382;980;4155;4398;18422;5378;22577
210070;201704;7290;21026;6774;20408;101;363;6276;19077;6377;19440
210080;201704;3704;12780;3617;12681;27;114;3487;12296;3514;12410
210083;201704;4627;15821;4136;15285;103;491;3866;14360;3969;14851
210087;201704;3019;8802;2745;8444;268;824;2171;6802;2439;7626
210090;201704;10258;32382;9733;31573;361;1355;8689;28202;9050;29557
210095;201704;5830;20640;5561;20285;329;1326;4769;17581;5098;18907
210100;201704;7177;21472;6592;20715;297;1207;5566;17364;5863;18571
210110;201704;2759;9497;2647;9349;93;422;2384;8407;2477;8829
210120;201704;26150;71871;22840;68016;2873;7333;16253;51640;19126;58973
210125;201704;3657;11311;3508;11156;158;349;3171;10377;3329;10726
210130;201704;4165;12216;3827;11751;249;838;3164;9700;3413;10538
210135;201704;1611;4783;1403;4480;75;224;1143;3709;1218;3933
210140;201704;16867;52960;14362;49554;2821;10425;8214;29106;11035;39531
210150;201704;4607;11320;4101;10697;61;214;3753;9716;3814;9930
210160;201704;17322;54067;16276;52506;1321;3968;13019;43296;14340;47264
210170;201704;13939;48422;13479;47843;687;2558;12022;43081;12709;45639
210173;201704;2384;9306;2261;9123;55;302;2086;8494;2141;8796
210177;201704;3092;9336;2917;9126;88;242;2705;8586;2793;8828
210180;201704;1504;4498;1425;4387;42;173;1231;3763;1273;3936
210190;201704;4778;14987;4404;14314;171;829;3505;11143;3676;11972
210193;201704;1324;4149;1197;3949;66;235;980;3250;1046;3485
210197;201704;2044;6831;1877;6631;227;777;1425;5243;1652;6020
210200;201704;8166;27083;7562;26243;799;2631;5973;21417;6772;24048
210203;201704;6767;20979;6363;20456;301;886;5670;18577;5971;19463
210207;201704;3304;10992;3126;10683;250;779;2483;8770;2733;9549
210210;201704;8370;28233;7968;27702;114;456;7342;25957;7456;26413
210215;201704;1133;4713;1089;4638;88;444;864;3731;952;4175
210220;201704;5898;22229;5623;21788;286;1424;4804;18593;5090;20017
210230;201704;5204;16591;4857;16079;225;779;4296;14305;4521;15084
210232;201704;12727;40443;10675;37848;1607;5840;6885;26466;8492;32306
210235;201704;3775;11521;3338;10983;168;677;2862;9482;3030;10159
210237;201704;2267;8675;2202;8587;27;127;2102;8257;2129;8384
210240;201704;2963;9225;2749;8903;136;497;2331;7544;2467;8041
210250;201704;5282;16884;4967;16483;139;691;4520;14883;4659;15574
210255;201704;2609;8286;2370;7855;221;805;1807;5989;2028;6794
210260;201704;5181;16705;4817;16157;401;1346;3826;13083;4227;14429
210270;201704;5200;14809;4609;13990;124;594;4011;12043;4135;12637
210275;201704;3500;8642;3311;8436;106;197;3111;8060;3217;8257
210280;201704;5633;16846;4799;15676;271;1287;3586;11445;3857;12732
210290;201704;5755;18722;5319;18211;212;801;4656;16109;4868;16910
210300;201704;37183;102164;30752;94273;2223;7191;23041;73701;25264;80892
210310;201704;2885;8028;2638;7707;82;195;2305;6822;2387;7017
210312;201704;2327;7125;2184;6939;77;365;1936;6120;2013;6485
210315;201704;2818;8665;2471;8239;109;395;2138;7269;2247;7664
210317;201704;4021;12697;3853;12501;143;550;3545;11526;3688;12076
210320;201704;19476;62750;17989;60947;821;3180;15667;53915;16488;57095
210325;201704;3751;11291;3343;10688;175;630;2734;8851;2909;9481
210330;201704;32930;84915;26972;78272;5123;13675;16043;53066;21166;66741
210340;201704;11504;34298;10440;32901;1118;3077;7692;25928;8810;29005
210350;201704;9827;29669;8803;28265;446;1581;7275;23591;7721;25172
210355;201704;3954;14289;3577;13709;163;773;3008;11716;3171;12489
210360;201704;14975;45493;13622;43624;916;3500;10918;34873;11834;38373
210370;201704;9426;22510;7878;20857;323;626;6935;19116;7258;19742
210375;201704;3156;9401;2603;8685;743;2575;1250;4348;1993;6923
210380;201704;5824;15999;5255;15269;374;1015;4380;12986;4754;14001
210390;201704;2990;10523;2733;10121;156;761;2257;8354;2413;9115
210400;201704;4898;15219;4609;14866;112;286;4320;14112;4432;14398
210405;201704;7660;21316;6180;19193;1658;5203;2790;9297;4448;14500
210407;201704;1971;7039;1690;6532;185;745;1224;4761;1409;5506
210408;201704;2436;9395;2282;9200;160;784;1858;7686;2018;8470
210409;201704;3715;13393;3526;13111;208;976;2958;11005;3166;11981
210410;201704;3727;11908;3531;11609;302;813;2816;9702;3118;10515
210420;201704;4100;13432;3731;12799;221;812;3063;10602;3284;11414
210430;201704;2113;6504;2036;6418;90;285;1796;5692;1886;5977
210440;201704;4020;12137;3861;11940;117;358;3578;11140;3695;11498
210450;201704;2705;8476;2390;8011;128;475;1913;6397;2041;6872
210455;201704;3758;10811;3405;10387;612;1806;2359;7573;2971;9379
210460;201704;3512;11370;3229;10955;157;668;2672;9051;2829;9719
210462;201704;1331;4838;1227;4651;78;386;987;3725;1065;4111
210465;201704;2578;8350;2381;8074;125;361;2077;7219;2202;7580
210467;201704;6111;20321;5749;19915;343;1227;5019;17640;5362;18867
210470;201704;2065;5567;1515;4759;90;273;1147;3685;1237;3958
210480;201704;14621;46364;12833;44147;1821;6070;9116;33652;10937;39722
210490;201704;3746;10057;3188;9281;76;271;2747;7981;2823;8252
210500;201704;6107;25407;5897;25019;536;2459;4699;20167;5235;22626
210510;201704;6460;21848;6070;21384;332;1036;5222;18938;5554;19974
210515;201704;3666;11491;3494;11300;141;333;3212;10665;3353;10998
210520;201704;2631;7906;2385;7572;140;480;2022;6474;2162;6954
210530;201704;50258;136117;42807;125120;6856;26007;13117;46102;19973;72109
210535;201704;3227;11033;3056;10808;119;429;2705;9727;2824;10156
210540;201704;13033;42995;11640;41061;1796;6287;7730;28831;9526;35118
210542;201704;5781;16256;5238;15666;306;737;4582;14103;4888;14840
210545;201704;2322;7386;2215;7229;48;257;1976;6372;2024;6629
210547;201704;3711;13198;3449;12747;367;1318;2527;9635;2894;10953
210550;201704;6100;17752;5455;17065;276;813;4874;15565;5150;16378
210560;201704;3910;12204;3514;11545;142;561;2984;9750;3126;10311
210565;201704;1456;5218;1253;4899;64;317;989;3952;1053;4269
210570;201704;11985;33752;11017;32668;583;1444;9743;29538;10326;30982
210580;201704;3156;9148;2854;8779;292;588;2289;7481;2581;8069
210590;201704;3900;12463;3614;12096;214;885;3136;10432;3350;11317
210592;201704;2531;7864;2419;7683;50;249;2130;6728;2180;6977
210594;201704;2673;7622;2131;6801;106;291;1567;5227;1673;5518
210596;201704;2585;9583;2461;9350;241;1003;1851;7138;2092;8141
210598;201704;1760;5502;1642;5358;92;394;1449;4685;1541;5079
210600;201704;3202;9075;2722;8437;131;460;2171;6724;2302;7184
210610;201704;2517;8119;2334;7888;135;612;2018;6701;2153;7313
210620;201704;2060;6584;1884;6371;47;107;1721;5970;1768;6077
210630;201704;3310;11742;3043;11317;262;1228;2318;8491;2580;9719
210632;201704;4525;15490;4162;14959;450;1785;3198;11542;3648;13327
210635;201704;1873;6556;1767;6385;69;253;1555;5710;1624;5963
210637;201704;2645;9091;2421;8770;137;564;1952;7175;2089;7739
210640;201704;4680;18747;4603;18666;14;56;4495;18369;4509;18425
210650;201704;6995;20896;6768;20608;140;431;6450;19710;6590;20141
210660;201704;8394;24472;7606;23337;245;922;6757;20589;7002;21511
210663;201704;2700;8275;2580;8129;122;396;2238;7176;2360;7572
210667;201704;1900;6408;1787;6230;75;336;1547;5421;1622;5757
210670;201704;4574;16479;4340;16107;218;1024;3669;13649;3887;14673
210675;201704;5054;13997;4612;13454;426;1068;3725;11256;4151;12324
210680;201704;3972;10686;3468;10083;143;370;3045;8983;3188;9353
210690;201704;7506;25139;7188;24802;314;1069;6283;22473;6597;23542
210700;201704;2642;7700;2416;7450;323;773;1762;6080;2085;6853
210710;201704;4870;15940;4588;15528;207;935;3891;13110;4098;14045
210720;201704;2652;9361;2491;9142;101;500;2239;8165;2340;8665
210725;201704;1088;4150;988;3947;47;190;744;3088;791;3278
210730;201704;1199;3511;1034;3282;75;230;815;2615;890;2845
210735;201704;4172;13950;3783;13312;431;1587;2867;10291;3298;11878
210740;201704;5100;14953;4778;14622;191;885;4277;12837;4468;13722
210745;201704;4208;12022;3957;11724;228;603;3389;10147;3617;10750
210750;201704;19503;52921;17172;50244;2032;5967;12550;37801;14582;43768
210760;201704;5882;16880;5391;16365;34;97;5224;15964;5258;16061
210770;201704;5895;16110;5083;15172;92;387;4590;13720;4682;14107
210780;201704;7740;25908;7129;24875;819;2827;5101;18361;5920;21188
210790;201704;4803;15020;4414;14555;201;535;3583;12477;3784;13012
210800;201704;4797;13335;4300;12742;116;431;3871;11494;3987;11925
210805;201704;3832;15353;3703;15155;188;948;3182;13098;3370;14046
210810;201704;5338;16032;4951;15544;286;591;4334;14174;4620;14765
210820;201704;7639;22038;6818;20781;806;2371;4764;14922;5570;17293
210825;201704;5834;19861;5574;19514;557;1839;4513;16331;5070;18170
210830;201704;8364;24001;7889;23429;732;1829;6483;19990;7215;21819
210840;201704;3562;9721;3201;9224;93;327;2733;7818;2826;8145
210845;201704;6039;17635;5832;17413;63;142;5669;17080;5732;17222
210850;201704;6249;21624;5590;20589;533;2329;4130;15186;4663;17515
210860;201704;17863;52120;15889;49350;1058;3358;12719;40179;13777;43537
210870;201704;5791;19112;5289;18474;503;1769;4232;15090;4735;16859
210880;201704;4329;13969;4111;13698;265;1049;3440;11450;3705;12499
210890;201704;4824;14499;4449;14068;319;822;3743;12430;4062;13252
210900;201704;4812;14367;3934;12929;1554;5388;980;3541;2534;8929
210905;201704;1835;5685;1617;5371;96;281;1295;4427;1391;4708
210910;201704;8221;26087;7262;24467;869;3190;5017;16966;5886;20156
210920;201704;2811;10329;2676;10105;140;721;2240;8435;2380;9156
210923;201704;1492;4993;1380;4822;140;544;950;3420;1090;3964
210927;201704;4784;15393;4516;15106;93;309;4247;14368;4340;14677
210930;201704;2493;8963;2335;8746;118;640;1956;7215;2074;7855
210940;201704;3142;11153;3028;10964;161;763;2608;9313;2769;10076
210945;201704;5699;17478;5488;17243;231;532;4986;15874;5217;16406
210950;201704;5254;15962;4419;14679;469;1552;3160;10822;3629;12374
210955;201704;1829;5852;1628;5553;140;496;1163;4064;1303;4560
210960;201704;9071;28612;8312;27594;1724;5465;5058;18053;6782;23518
210970;201704;1339;4611;1176;4337;127;545;850;3085;977;3630
210975;201704;1766;5870;1675;5706;121;449;1303;4446;1424;4895
210980;201704;10101;23473;9676;23041;411;786;8848;21493;9259;22279
210990;201704;16186;49917;13350;45855;3055;10921;6668;24135;9723;35056
211000;201704;15506;48439;13733;46423;774;3284;11471;39388;12245;42672
211003;201704;4618;16633;4211;16110;283;1330;3264;12752;3547;14082
211010;201704;6554;23967;6191;23529;65;316;5843;22443;5908;22759
211020;201704;7534;24254;7237;23821;464;1797;6068;19911;6532;21708
211023;201704;2177;7373;2093;7242;163;681;1716;5894;1879;6575
211027;201704;2899;10624;2838;10521;286;1125;2313;8626;2599;9751
211030;201704;3837;11578;3583;11311;424;929;2899;9808;3323;10737
211040;201704;4507;16662;4310;16372;171;970;3746;14219;3917;15189
211050;201704;10072;25633;9549;25072;185;507;9055;23782;9240;24289
211060;201704;6072;21209;5876;20946;389;1520;5075;18205;5464;19725
211065;201704;2043;6307;1826;6007;52;173;1639;5450;1691;5623
211070;201704;7899;26833;7255;25794;373;1438;6031;21720;6404;23158
211080;201704;1314;3930;1147;3676;75;365;882;2678;957;3043
211085;201704;2010;6583;1834;6295;203;706;1370;4787;1573;5493
211090;201704;3460;9819;3210;9485;94;423;2807;8184;2901;8607
211100;201704;6448;17137;6298;16974;30;107;6143;16564;6173;16671
211102;201704;2861;10929;2707;10713;217;938;2280;9162;2497;10100
211105;201704;2484;8196;2154;7671;208;830;1569;5548;1777;6378
211107;201704;4564;14511;4071;13842;237;799;3305;11575;3542;12374
211110;201704;6258;18336;5015;16482;754;2402;3319;11373;4073;13775
211120;201704;36042;101907;33106;98522;4591;13075;24511;75595;29102;88670
211125;201704;2075;6489;1821;6086;118;427;1492;5028;1610;5455
211130;201704;169341;447737;158110;433935;23603;68043;78330;235346;101933;303389
211140;201704;5184;16760;4821;16215;231;922;4083;13728;4314;14650
211150;201704;9648;27625;8603;26353;367;1373;7338;22523;7705;23896
211153;201704;2713;8433;2460;8105;526;1798;1606;5518;2132;7316
211157;201704;1155;3682;994;3428;76;361;683;2381;759;2742
211160;201704;4174;13370;3515;12278;265;1276;2436;8262;2701;9538
211163;201704;1720;5755;1616;5612;40;116;1470;5219;1510;5335
211167;201704;1519;4991;1453;4896;34;148;1374;4622;1408;4770
211170;201704;6055;16067;5824;15787;89;302;5454;14706;5543;15008
211172;201704;2460;7123;2223;6800;92;400;1910;5755;2002;6155
211174;201704;2718;8033;2496;7751;57;310;2294;7036;2351;7346
211176;201704;4216;13150;3593;12326;295;1223;2766;9549;3061;10772
211178;201704;4311;10597;3945;10192;44;141;3738;9600;3782;9741
211180;201704;4225;14478;3976;14118;273;1050;3366;12036;3639;13086
211190;201704;2860;9295;2644;8976;87;426;2261;7619;2348;8045
211195;201704;1468;4347;1242;4061;72;219;1017;3430;1089;3649
211200;201704;2154;7014;1894;6658;319;1116;1181;4379;1500;5495
211210;201704;6762;20650;6394;20168;380;1271;5484;17403;5864;18674
211220;201704;33693;95725;29614;90538;4451;14070;19864;62632;24315;76702
211223;201704;5051;15537;4619;14865;440;1401;3519;11539;3959;12940
211227;201704;1686;5919;1536;5699;76;333;1301;4880;1377;5213
211230;201704;7924;25465;7172;24240;705;2540;5465;18683;6170;21223
211240;201704;7927;27259;7524;26742;253;1294;6794;23874;7047;25168
211245;201704;5678;16622;5644;16588;54;96;5561;16436;5615;16532
211250;201704;13525;42270;12696;41299;937;2807;10683;35722;11620;38529
211260;201704;8445;26048;7975;25438;340;1287;7186;22947;7526;24234
211270;201704;10290;34857;9243;33555;532;2425;7404;27382;7936;29807
211280;201704;13256;39117;12090;37638;888;2286;9809;31737;10697;34023
211285;201704;1762;6436;1550;5996;246;1046;796;3178;1042;4224
211290;201704;7087;23045;6764;22625;350;1192;5886;19949;6236;21141
211300;201704;8205;24356;7661;23622;129;402;7148;22141;7277;22543
211400;201704;11798;36498;10094;34010;2335;7981;5368;19773;7703;27754
220005;201704;1848;5242;1671;4984;69;281;1312;3794;1381;4075
220010;201704;1416;4131;1251;3880;30;131;1003;3056;1033;3187
220020;201704;3293;10347;3078;9988;544;1789;1948;6400;2492;8189
220025;201704;2275;5511;2040;5185;36;112;1699;4243;1735;4355
220027;201704;1358;3595;1204;3396;58;172;964;2720;1022;2892
220030;201704;3237;8647;3140;8493;131;447;2716;7200;2847;7647
220040;201704;7622;23368;6978;22221;1237;3997;4501;14422;5738;18419
220045;201704;1404;4581;1266;4308;51;245;979;3262;1030;3507
220050;201704;4467;13376;3855;12371;189;803;3084;9817;3273;10620
220060;201704;2150;5173;1903;4888;35;92;1721;4413;1756;4505
220070;201704;2409;6912;2172;6537;118;342;1743;5252;1861;5594
220080;201704;683;2072;634;1997;41;167;533;1615;574;1782
220090;201704;1806;4519;1480;4081;46;172;1283;3492;1329;3664
220095;201704;723;1921;676;1857;12;49;625;1695;637;1744
220100;201704;1312;3913;1084;3496;63;274;857;2704;920;2978
220105;201704;2224;6972;1975;6492;129;443;1484;4920;1613;5363
220110;201704;3379;9721;3244;9509;89;352;2856;8258;2945;8610
220115;201704;2604;8564;2489;8365;131;532;2153;7156;2284;7688
220117;201704;1259;3329;1027;2972;35;99;859;2474;894;2573
220120;201704;11861;34656;11038;33658;134;612;10331;31415;10465;32027
220130;201704;908;2948;805;2794;31;180;694;2363;725;2543
220140;201704;1699;4471;1473;4200;147;317;1189;3509;1336;3826
220150;201704;6988;20989;6616;20493;192;842;5778;17721;5970;18563
220155;201704;1088;3295;862;2863;39;158;592;1930;631;2088
220157;201704;1079;2722;926;2475;21;78;754;1959;775;2037
220160;201704;2590;7783;2303;7257;76;360;1860;5742;1936;6102
220170;201704;1371;4043;1176;3734;40;183;969;3039;1009;3222
220173;201704;2004;6033;1694;5447;50;261;1337;4207;1387;4468
220177;201704;1810;5405;1774;5358;32;128;1697;5108;1729;5236
220180;201704;1181;3117;940;2678;18;75;685;1854;703;1929
220190;201704;4639;14779;4260;14285;449;1575;3283;11049;3732;12624
220191;201704;1394;4615;1309;4464;119;496;992;3308;1111;3804
220192;201704;1819;5125;1461;4496;59;210;1117;3409;1176;3619
220194;201704;1797;5318;1598;5027;88;333;1267;3907;1355;4240
220196;201704;2026;5800;1859;5512;98;378;1519;4435;1617;4813
220198;201704;1353;3820;1030;3395;10;34;955;3195;965;3229
220200;201704;4470;14581;4137;14153;283;1072;3440;11798;3723;12870
220202;201704;2157;6331;1879;5848;29;162;1607;4900;1636;5062
220205;201704;2742;7253;2449;6860;51;197;2146;5931;2197;6128
220207;201704;863;2649;741;2434;65;264;504;1622;569;1886
220208;201704;1799;5702;1541;5260;237;903;905;3091;1142;3994
220209;201704;1586;4700;1375;4333;34;154;1103;3467;1137;3621
220210;201704;1644;4373;1436;4039;41;178;1164;3175;1205;3353
220211;201704;1564;4376;1493;4285;38;165;1301;3693;1339;3858
220213;201704;1656;4709;1521;4444;28;122;1234;3519;1262;3641
220217;201704;2011;6327;1930;6232;34;135;1788;5833;1822;5968
220220;201704;10415;28557;9302;26900;660;1798;6893;20371;7553;22169
220225;201704;1110;3178;916;2915;29;120;745;2342;774;2462
220230;201704;5493;14570;4974;13858;185;516;4341;12145;4526;12661
220240;201704;2850;8753;2632;8348;93;374;2177;6868;2270;7242
220245;201704;1516;4000;1272;3670;23;79;1105;3247;1128;3326
220250;201704;3004;8802;2712;8369;74;310;2343;7236;2417;7546
220253;201704;1589;4635;1339;4192;135;465;992;3067;1127;3532
220255;201704;1752;4786;1501;4367;41;199;1209;3350;1250;3549
220260;201704;4522;14494;4024;13593;276;1014;3015;10249;3291;11263
220265;201704;1322;4507;1210;4323;103;427;827;2951;930;3378
220270;201704;6798;21817;6484;21245;438;1825;5222;16667;5660;18492
220271;201704;1476;4105;1308;3843;52;150;1085;3236;1137;3386
220272;201704;1787;5325;1615;5028;50;208;1251;3837;1301;4045
220273;201704;1208;3478;1061;3217;68;250;789;2374;857;2624
220275;201704;2165;5388;1735;4877;44;173;1483;4131;1527;4304
220277;201704;2219;6037;1938;5605;59;210;1561;4424;1620;4634
220280;201704;1501;4092;1312;3758;72;265;1043;2890;1115;3155
220285;201704;1673;4337;1373;3939;21;86;1251;3595;1272;3681
220290;201704;6085;19874;5172;18549;560;2216;3537;12740;4097;14956
220300;201704;1782;5950;1595;5658;77;431;1266;4366;1343;4797
220310;201704;2420;8039;2200;7783;82;407;1843;6528;1925;6935
220320;201704;2912;8936;2502;8180;234;917;1828;5940;2062;6857
220323;201704;1500;5198;1307;4909;124;516;1028;3857;1152;4373
220325;201704;1184;3706;1008;3359;67;277;761;2516;828;2793
220327;201704;1333;4212;1215;4003;50;251;994;3190;1044;3441
220330;201704;3693;9828;3277;9294;126;363;2866;8191;2992;8554
220335;201704;1791;5457;1610;5246;30;100;1506;4942;1536;5042
220340;201704;1872;5079;1546;4562;76;272;1145;3287;1221;3559
220342;201704;1142;3673;1081;3575;62;260;868;2876;930;3136
220345;201704;2885;7162;2547;6694;34;70;2346;6175;2380;6245
220350;201704;3753;9950;3140;8976;168;594;2379;6679;2547;7273
220360;201704;1257;3401;1075;3137;69;217;835;2386;904;2603
220370;201704;9314;26363;8454;25263;260;1025;7509;22322;7769;23347
220375;201704;1478;4581;1376;4451;13;36;1331;4347;1344;4383
220380;201704;1371;3656;1162;3358;31;123;979;2765;1010;2888
220385;201704;863;2186;688;1897;14;56;559;1506;573;1562
220390;201704;8895;27040;7863;25265;1967;6507;3286;10899;5253;17406
220400;201704;1505;3769;1172;3237;34;129;920;2451;954;2580
220410;201704;1184;3412;1006;3132;67;221;783;2411;850;2632
220415;201704;827;2263;721;2102;29;101;521;1478;550;1579
220420;201704;2151;6170;1783;5459;95;286;1310;3989;1405;4275
220430;201704;2482;6876;2421;6799;95;310;2183;6082;2278;6392
220435;201704;1685;4888;1538;4653;48;178;1198;3592;1246;3770
220440;201704;2385;7828;2242;7626;166;605;1795;6018;1961;6623
220450;201704;1940;5948;1639;5511;347;1285;996;3350;1343;4635
220455;201704;1320;4112;1249;4009;39;143;1113;3568;1152;3711
220460;201704;895;2452;811;2349;41;125;692;1975;733;2100
220465;201704;2354;7692;2153;7384;233;852;1597;5514;1830;6366
220470;201704;3631;10699;3324;10220;133;461;2672;8101;2805;8562
220480;201704;2434;6851;2112;6333;136;354;1542;4610;1678;4964
220490;201704;2264;6305;2073;6075;49;185;1833;5342;1882;5527
220500;201704;3132;8412;2714;7723;88;378;2083;5717;2171;6095
220510;201704;2836;8298;2310;7378;99;356;1731;5559;1830;5915
220515;201704;1820;4433;1625;4176;99;248;1388;3572;1487;3820
220520;201704;5106;13793;4688;13241;112;332;4204;11908;4316;12240
220525;201704;1240;3488;1176;3396;42;160;998;2853;1040;3013
220527;201704;1372;4124;1219;3837;98;320;896;2876;994;3196
220530;201704;1275;3570;1119;3346;52;213;971;2834;1023;3047
220535;201704;852;2549;808;2488;66;233;620;1881;686;2114
220540;201704;3512;11125;3355;10891;118;541;2927;9422;3045;9963
220545;201704;1406;4613;1330;4474;110;441;1048;3484;1158;3925
220550;201704;9220;28996;8455;27721;655;2387;6373;20750;7028;23137
220551;201704;1475;4555;1316;4301;71;303;1039;3310;1110;3613
220552;201704;1580;4848;1379;4479;78;386;1065;3320;1143;3706
220553;201704;1637;4647;1376;4252;52;199;1062;3352;1114;3551
220554;201704;781;2256;693;2126;41;110;552;1701;593;1811
220555;201704;2103;6755;1953;6540;50;262;1667;5500;1717;5762
220556;201704;1378;4210;1232;3923;52;240;926;2822;978;3062
220557;201704;1567;4973;1406;4664;106;405;1031;3390;1137;3795
220558;201704;1116;3337;984;3130;41;190;788;2446;829;2636
220559;201704;1570;4346;1391;4050;25;87;1187;3444;1212;3531
220560;201704;1607;3972;1318;3579;37;115;1123;2987;1160;3102
220570;201704;7152;22993;6738;22266;782;2754;4850;16223;5632;18977
220580;201704;6677;20126;6491;19838;226;767;5864;17792;6090;18559
220585;201704;2058;6847;1881;6529;110;470;1491;5109;1601;5579
220590;201704;1290;3795;1134;3569;101;336;829;2654;930;2990
220595;201704;2410;6912;2252;6703;33;162;2074;6096;2107;6258
220600;201704;1316;3164;1073;2847;74;110;868;2389;942;2499
220605;201704;1845;5443;1592;5011;58;234;1230;3782;1288;4016
220610;201704;2800;8247;2652;8042;50;215;2407;7256;2457;7471
220620;201704;7456;24734;7172;24347;260;1247;6365;21380;6625;22627
220630;201704;396;1213;326;1086;49;179;173;591;222;770
220635;201704;1683;5598;1495;5197;72;302;1129;3865;1201;4167
220640;201704;2670;7645;2365;7210;96;362;1960;5914;2056;6276
220650;201704;2128;6215;1896;5803;91;319;1404;4280;1495;4599
220660;201704;2860;8450;2574;8102;119;568;2234;6846;2353;7414
220665;201704;1193;3955;1090;3787;32;161;918;3165;950;3326
220667;201704;1677;5515;1533;5264;81;299;1255;4317;1336;4616
220669;201704;1815;5802;1730;5652;145;629;1329;4244;1474;4873
220670;201704;1965;5742;1721;5432;92;271;1469;4687;1561;4958
220672;201704;2464;7099;2273;6863;135;440;1966;5971;2101;6411
220675;201704;1248;3564;1167;3417;68;182;915;2693;983;2875
220680;201704;2377;7365;2260;7220;111;380;1963;6273;2074;6653
220690;201704;1715;4706;1481;4327;119;321;1113;3331;1232;3652
220695;201704;968;2739;874;2560;27;94;707;2054;734;2148
220700;201704;8255;23289;7147;21592;490;1715;5397;16124;5887;17839
220710;201704;814;2417;653;2103;37;104;468;1503;505;1607
220720;201704;2072;5263;1938;5071;60;187;1672;4340;1732;4527
220730;201704;1377;3924;1167;3599;29;128;971;2947;1000;3075
220735;201704;1014;2533;804;2185;25;73;647;1726;672;1799
220740;201704;1401;4264;1193;3986;52;183;1008;3426;1060;3609
220750;201704;3972;10990;3615;10456;228;641;2988;8676;3216;9317
220755;201704;1192;3295;1062;3085;46;170;834;2368;880;2538
220760;201704;2901;9210;2617;8830;120;527;2247;7537;2367;8064
220770;201704;21306;70327;19133;66187;6385;23199;6172;22408;12557;45607
220775;201704;1223;3261;1170;3205;14;58;1139;3111;1153;3169
220777;201704;1550;4191;1300;3804;58;164;995;2914;1053;3078
220779;201704;1364;3502;1266;3371;40;148;1109;2906;1149;3054
220780;201704;5624;15236;5000;14260;353;1139;3946;11130;4299;12269
220785;201704;1418;3388;1319;3241;36;65;1225;3007;1261;3072
220790;201704;10340;30583;9469;29285;486;1877;7761;23726;8247;25603
220793;201704;811;2281;728;2157;40;137;587;1733;627;1870
220795;201704;1487;4061;1384;3928;49;170;1226;3475;1275;3645
220800;201704;16057;43085;14177;40208;1037;3333;10088;27892;11125;31225
220810;201704;3209;9194;2796;8487;87;336;2259;6746;2346;7082
220820;201704;5437;14577;4839;13725;335;905;3918;11092;4253;11997
220830;201704;7309;20558;6779;19736;469;1479;5430;15770;5899;17249
220840;201704;13517;42298;11972;39232;2306;7646;6427;21423;8733;29069
220850;201704;2969;9702;2789;9482;88;415;2546;8627;2634;9042
220855;201704;600;1809;520;1664;27;115;404;1266;431;1381
220860;201704;959;2537;850;2370;30;98;719;1970;749;2068
220865;201704;2633;7115;2090;6197;61;278;1686;4845;1747;5123
220870;201704;2199;7319;1959;7000;53;267;1747;6207;1800;6474
220880;201704;4687;12482;4345;12084;49;166;4097;11403;4146;11569
220885;201704;1271;4487;1118;4209;77;373;849;3173;926;3546
220887;201704;1367;3344;1202;3113;13;50;1111;2851;1124;2901
220890;201704;1632;5527;1416;5102;109;415;1038;3807;1147;4222
220900;201704;1900;5096;1679;4781;39;120;1459;4118;1498;4238
220910;201704;1507;4527;1315;4233;40;123;1153;3762;1193;3885
220915;201704;988;2792;849;2524;34;150;651;1869;685;2019
220920;201704;1322;4779;1194;4587;88;443;901;3395;989;3838
220930;201704;1474;4618;1342;4420;39;197;1142;3716;1181;3913
220935;201704;1087;3221;931;2904;39;168;623;1855;662;2023
220937;201704;1486;4011;1256;3640;41;159;991;2816;1032;2975
220940;201704;1295;4052;1197;3872;61;266;873;2742;934;3008
220945;201704;411;1516;368;1423;32;159;257;978;289;1137
220950;201704;1310;3211;935;2594;17;76;713;1914;730;1990
220955;201704;1473;4164;1294;3852;62;176;1020;3049;1082;3225
220960;201704;908;2308;719;1999;19;68;565;1552;584;1620
220965;201704;1652;4826;1535;4649;38;217;1333;3910;1371;4127
220970;201704;1927;5186;1528;4535;72;246;1181;3497;1253;3743
220975;201704;725;2284;658;2201;29;166;580;1871;609;2037
220980;201704;1250;3679;1108;3448;47;166;877;2720;924;2886
220985;201704;1173;3448;1105;3351;68;282;840;2443;908;2725
220987;201704;1451;4609;1307;4373;79;346;1042;3411;1121;3757
220990;201704;1793;5159;1537;4731;45;219;1190;3561;1235;3780
220995;201704;1244;3669;959;3218;84;307;666;2298;750;2605
220997;201704;2382;7048;2271;6898;38;156;2121;6410;2159;6566
221000;201704;4160;12441;3896;12004;255;1007;3121;9464;3376;10471
221005;201704;1427;4331;1308;4116;203;587;847;2689;1050;3276
221010;201704;1211;3055;1042;2847;22;74;912;2449;934;2523
221020;201704;1671;5220;1548;4986;56;258;1132;3572;1188;3830
221030;201704;1452;4290;1292;4026;60;256;1029;3125;1089;3381
221035;201704;1496;4054;1388;3914;54;132;1261;3630;1315;3762
221037;201704;600;1770;533;1655;15;73;369;1092;384;1165
221038;201704;589;1658;466;1452;33;113;290;904;323;1017
221039;201704;949;2588;836;2418;24;88;684;1927;708;2015
221040;201704;4492;13849;4169;13312;204;694;3284;10568;3488;11262
221050;201704;3569;10440;3295;10092;96;379;2933;8915;3029;9294
221060;201704;8044;23551;6940;21709;405;1439;5337;16646;5742;18085
221062;201704;1295;4456;1158;4181;63;306;892;3185;955;3491
221063;201704;1085;3438;970;3243;108;375;669;2250;777;2625
221065;201704;2808;7407;2478;6885;75;222;2091;5739;2166;5961
221070;201704;3683;11687;3185;10744;180;710;2386;8021;2566;8731
221080;201704;3543;8807;2885;7889;82;305;2359;6420;2441;6725
221090;201704;1389;3811;1204;3500;40;165;1008;2861;1048;3026
221093;201704;1555;4590;1465;4414;178;573;928;2706;1106;3279
221095;201704;974;2599;848;2401;14;39;707;1974;721;2013
221097;201704;813;2235;658;1956;26;98;475;1365;501;1463
221100;201704;105385;306768;96076;291045;18379;58646;55297;165156;73676;223802
221110;201704;10427;32187;9662;31257;398;1821;8270;26415;8668;28236
221120;201704;4078;12877;3901;12576;526;1821;2832;9112;3358;10933
221130;201704;4522;12808;3699;11139;983;2871;1655;5082;2638;7953
221135;201704;1534;4518;1414;4349;67;245;1212;3700;1279;3945
221140;201704;1330;3257;1194;3064;24;62;1049;2659;1073;2721
221150;201704;1202;3026;964;2619;27;109;722;1894;749;2003
221160;201704;772;2010;721;1942;25;70;590;1580;615;1650
221170;201704;1149;3415;1045;3247;35;125;835;2570;870;2695
230010;201704;3381;9041;2731;7931;218;729;2045;5812;2263;6541
230015;201704;2905;9907;2722;9531;301;1200;1825;6327;2126;7527
230020;201704;13733;44171;13349;43588;605;2490;11410;36924;12015;39414
230030;201704;12064;33646;10713;31626;434;1659;8955;26156;9389;27815
230040;201704;4291;11850;3678;10786;254;906;2743;7914;2997;8820
230050;201704;2674;8886;1999;7098;490;1707;584;2143;1074;3850
230060;201704;2332;6530;1969;5895;94;371;1529;4467;1623;4838
230070;201704;4164;12027;3622;11007;239;853;2517;7753;2756;8606
230075;201704;9040;31002;8431;29867;592;3006;6513;22444;7105;25450
230080;201704;2412;6128;1970;5467;64;245;1621;4429;1685;4674
230090;201704;4036;11178;3570;10410;306;1044;2574;7394;2880;8438
230100;201704;16668;48969;15544;47017;2478;8069;9276;28281;11754;36350
230110;201704;12374;39042;11319;36839;2100;7257;6101;19653;8201;26910
230120;201704;7876;21695;6834;20121;735;2131;4739;14489;5474;16620
230125;201704;3003;8572;2532;7733;149;542;1847;5592;1996;6134
230130;201704;5689;18480;4833;16643;496;1912;3172;10735;3668;12647
230140;201704;3535;11044;3017;10116;200;791;2097;7025;2297;7816
230150;201704;1654;5078;1438;4621;297;981;755;2451;1052;3432
230160;201704;6393;18197;5690;17184;299;1185;4602;13742;4901;14927
230170;201704;6149;19070;5377;17604;310;1250;3851;12416;4161;13666
230180;201704;1690;4894;1476;4474;64;287;1084;3126;1148;3413
230185;201704;3829;12398;3416;11632;496;1781;2242;7754;2738;9535
230190;201704;12411;39061;10940;36074;1826;6435;5613;18499;7439;24934
230195;201704;5296;16032;4683;14963;247;1002;3666;11474;3913;12476
230200;201704;5047;14348;4557;13433;297;988;3462;9997;3759;10985
230205;201704;4066;13193;3718;12550;289;1257;2606;8657;2895;9914
230210;201704;8780;24939;7736;23272;1013;3259;5085;15476;6098;18735
230220;201704;13128;36727;11867;34615;833;2833;8883;25521;9716;28354
230230;201704;7283;22943;6728;21922;597;2078;4802;15612;5399;17690
230240;201704;13466;36869;11828;34208;537;1728;9219;26483;9756;28211
230250;201704;9692;29467;9639;29371;581;2163;7461;22264;8042;24427
230260;201704;14311;46803;13127;44367;1880;6895;7570;25919;9450;32814
230270;201704;7567;21760;6293;19433;766;2535;3959;12318;4725;14853
230280;201704;20051;57997;17606;53763;1130;4161;13326;39919;14456;44080
230290;201704;4791;14305;4128;12954;500;1500;2789;8832;3289;10332
230300;201704;4401;12830;4199;12560;228;889;3469;10185;3697;11074
230310;201704;4896;14372;4235;13231;165;683;3009;9232;3174;9915
230320;201704;7297;22008;6578;20745;435;1744;4958;15360;5393;17104
230330;201704;4930;14053;4137;12527;311;1042;2906;8676;3217;9718
230340;201704;3469;11384;3131;10669;298;1167;2122;7117;2420;8284
230350;201704;18255;54273;16639;51455;1441;5349;10402;32596;11843;37945
230360;201704;3237;9065;2511;7748;183;656;1653;5054;1836;5710
230365;201704;3062;7949;2656;7274;89;342;2207;5967;2296;6309
230370;201704;54351;169822;48935;160644;12545;43248;21527;73761;34072;117009
230380;201704;6592;18950;5445;16793;229;856;3868;11781;4097;12637
230390;201704;3354;10571;3026;10001;205;906;2228;7212;2433;8118
230393;201704;3095;9976;2669;9155;174;858;1933;6356;2107;7214
230395;201704;5691;16274;5105;15277;663;2047;3179;9723;3842;11770
230400;201704;5540;16421;4988;15501;247;1054;3905;11861;4152;12915
230410;201704;14620;45662;12473;41203;1646;5748;7421;24569;9067;30317
230420;201704;23987;75209;21662;70658;3991;13986;10739;34972;14730;48958
230423;201704;4119;13325;3784;12646;228;991;2930;9664;3158;10655
230425;201704;5508;17959;5042;16977;650;2265;3271;11061;3921;13326
230426;201704;2557;7136;2040;6143;67;290;1502;4441;1569;4731
230427;201704;1905;5571;1447;4564;116;371;868;2659;984;3030
230428;201704;8766;26625;8253;25654;1457;4955;4365;13333;5822;18288
230430;201704;4434;13764;3994;12928;285;1131;2897;9126;3182;10257
230435;201704;5232;15862;4647;14795;647;2285;2722;8664;3369;10949
230440;201704;368662;1049291;331041;985960;67993;213625;162551;487686;230544;701311
230445;201704;4449;12060;3817;11017;226;683;2733;7854;2959;8537
230450;201704;3691;11240;3235;10443;278;1157;2269;7194;2547;8351
230460;201704;1923;6145;1670;5676;146;574;1200;4054;1346;4628
230465;201704;3993;11740;3355;10566;192;769;2331;7137;2523;7906
230470;201704;10982;39172;10142;37489;1131;4923;7040;25752;8171;30675
230480;201704;1469;4513;1244;4074;133;531;858;2744;991;3275
230490;201704;2321;6942;2027;6386;283;958;1050;3223;1333;4181
230495;201704;5622;18208;5119;17218;562;2353;3104;10281;3666;12634
230500;201704;8723;30696;8306;29844;564;2554;6265;22391;6829;24945
230510;201704;1528;5269;1172;4355;282;1125;387;1459;669;2584
230520;201704;4303;13189;4020;12642;388;1358;2739;8492;3127;9850
230523;201704;14964;47345;12971;42849;3075;10806;3270;11257;6345;22063
230526;201704;4065;11922;3495;10918;200;841;2701;8276;2901;9117
230530;201704;5454;17278;4906;16526;683;2440;3358;11658;4041;14098
230533;201704;4122;11196;3582;10211;341;915;2568;7421;2909;8336
230535;201704;5492;15997;4770;14674;447;1424;3123;9818;3570;11242
230540;201704;17256;49812;15563;47183;532;2258;12990;38855;13522;41113
230550;201704;19466;56628;17055;52101;2729;9278;9207;27637;11936;36915
230560;201704;6907;19429;5943;17686;204;871;4567;13355;4771;14226
230565;201704;3487;9469;2828;8287;101;375;2082;6044;2183;6419
230570;201704;3610;9676;3174;9100;112;386;2583;7349;2695;7735
230580;201704;10022;29407;9168;28178;493;1878;7664;23291;8157;25169
230590;201704;9115;27433;7744;24861;548;2183;5382;16787;5930;18970
230600;201704;3770;10251;2874;8480;97;304;1875;5622;1972;5926
230610;201704;6292;19246;5732;18335;548;1794;4189;13458;4737;15252
230620;201704;2189;6149;1721;5154;189;592;965;2817;1154;3409
230625;201704;7815;24840;7028;23095;2107;7434;1972;6541;4079;13975
230630;201704;10622;33164;9722;31475;2553;7823;4460;15564;7013;23387
230640;201704;26667;83916;24288;80371;2296;8718;18391;60557;20687;69275
230650;201704;4798;14476;4327;13562;264;1041;3236;9894;3500;10935
230655;201704;9407;34335;9046;33648;686;2999;7058;26344;7744;29343
230660;201704;6230;19080;5292;17243;275;1346;4127;13099;4402;14445
230670;201704;6023;15768;4823;13698;173;594;3698;10228;3871;10822
230680;201704;2611;7632;2278;6972;299;952;1396;4271;1695;5223
230690;201704;6488;20517;6152;19783;656;2379;3778;11905;4434;14284
230700;201704;9613;26406;8497;24382;525;1882;6145;17020;6670;18902
230710;201704;7478;23891;6466;22010;736;2639;4485;15344;5221;17983
230720;201704;1853;5788;1581;5180;204;720;966;3143;1170;3863
230725;201704;3674;12293;3166;11054;752;2726;973;3408;1725;6134
230730;201704;54239;163767;46598;150661;13598;48957;10425;35904;24023;84861
230740;201704;6287;18276;5626;17182;248;965;4370;13207;4618;14172
230750;201704;8218;23480;7154;21706;348;1339;5435;16140;5783;17479
230760;201704;11235;32605;10298;30820;930;3299;7193;20803;8123;24102
230763;201704;4303;12854;3779;11845;219;918;2832;8562;3051;9480
230765;201704;39493;121217;35039;112713;9050;30926;10865;36180;19915;67106
230770;201704;25119;68440;22413;64492;2811;8535;14432;41627;17243;50162
230780;201704;5840;21947;5601;21409;1165;4512;3031;12051;4196;16563
230790;201704;2855;8844;2659;8528;206;745;2043;6561;2249;7306
230800;201704;7469;25838;6852;24502;1234;4940;3508;12288;4742;17228
230810;201704;11878;37959;11126;36656;751;2956;8426;27389;9177;30345
230820;201704;3299;11158;2899;10285;349;1452;1687;5828;2036;7280
230830;201704;7448;22256;6588;20669;347;1408;5069;15667;5416;17075
230835;201704;3903;10170;3218;9087;140;508;2502;6949;2642;7457
230837;201704;3137;10468;2737;9653;201;927;1959;6699;2160;7626
230840;201704;8965;28770;8288;27633;673;2588;6339;21166;7012;23754
230850;201704;9443;28991;8678;27632;857;2884;5982;19117;6839;22001
230860;201704;5111;14142;4517;13276;236;823;3670;10690;3906;11513
230870;201704;18033;46797;15738;43338;641;2069;12186;33316;12827;35385
230880;201704;1984;6558;1844;6287;113;555;1353;4487;1466;5042
230890;201704;4130;14495;3829;13872;390;1669;2596;9257;2986;10926
230900;201704;2791;9194;2366;8240;470;1552;1181;4242;1651;5794
230910;201704;3098;8963;2556;8006;152;671;1900;5794;2052;6465
230920;201704;4710;13332;4380;12919;161;579;3789;11262;3950;11841
230930;201704;6840;20406;6048;18879;529;1800;3996;12416;4525;14216
230940;201704;7573;21601;6830;20355;245;910;5531;16384;5776;17294
230945;201704;6267;18543;5511;17318;433;1515;3780;12051;4213;13566
230950;201704;6515;17096;5953;16393;181;469;5177;14572;5358;15041
230960;201704;13986;42916;12804;40607;2177;7239;6229;20055;8406;27294
230970;201704;13362;39658;11692;36693;2159;7464;5501;17201;7660;24665
230980;201704;2915;8881;2526;8188;534;1711;1370;4641;1904;6352
230990;201704;1803;5208;1490;4621;110;460;974;2903;1084;3363
231000;201704;2569;7017;2145;6184;106;377;1467;4133;1573;4510
231010;201704;3058;8355;2514;7439;245;794;1682;4908;1927;5702
231020;201704;8021;26478;7501;25311;1259;4223;4505;15579;5764;19802
231025;201704;7659;23255;7034;22119;998;3312;4539;14459;5537;17771
231030;201704;7298;23277;6099;20773;1143;4100;3205;10965;4348;15065
231040;201704;3136;9686;2792;9021;139;629;2056;6447;2195;7076
231050;201704;11873;32945;10068;29765;666;2103;7402;21773;8068;23876
231060;201704;2441;7769;2270;7471;115;567;1702;5498;1817;6065
231070;201704;8444;26230;7558;24485;1325;4471;4078;13435;5403;17906
231080;201704;4027;12256;3663;11630;155;813;2812;8578;2967;9391
231085;201704;4947;14994;4725;14674;498;1547;3448;11074;3946;12621
231090;201704;4174;11522;3347;9907;147;512;2317;6710;2464;7222
231095;201704;2077;6621;1810;6044;180;685;1227;4067;1407;4752
231100;201704;3159;9664;2658;8731;215;775;1843;6008;2058;6783
231110;201704;3479;11255;3435;11178;313;1213;2398;7616;2711;8829
231120;201704;1929;6395;1813;6164;254;927;1140;3866;1394;4793
231123;201704;2028;5524;1781;5091;122;376;1299;3663;1421;4039
231126;201704;6141;17444;5068;15406;215;806;3578;10662;3793;11468
231130;201704;19067;57030;17232;54128;2441;8309;10869;35099;13310;43408
231135;201704;4096;12008;3507;10921;215;776;2513;7755;2728;8531
231140;201704;17246;52448;14803;47890;1131;4863;9905;31082;11036;35945
231150;201704;5596;16051;4879;14704;733;2316;2434;7482;3167;9798
231160;201704;5830;19074;5422;18270;867;3035;3213;10961;4080;13996
231170;201704;4253;13421;3743;12369;265;1117;2643;8485;2908;9602
231180;201704;14410;42150;12581;38413;2378;7490;6244;18863;8622;26353
231190;201704;4613;12849;3842;11668;223;930;2838;8313;3061;9243
231195;201704;4553;15105;3990;13937;351;1537;2731;9328;3082;10865
231200;201704;7843;26112;6883;24126;370;1907;4967;16881;5337;18788
231210;201704;4905;15361;4335;14444;247;1134;3221;10483;3468;11617
231220;201704;11672;32852;10189;30126;539;2059;7510;21643;8049;23702
231230;201704;8672;28520;7909;27370;638;2685;6050;20909;6688;23594
231240;201704;11626;36092;10626;34042;1983;6630;5713;18406;7696;25036
231250;201704;1905;5322;1325;3937;147;451;639;1842;786;2293
231260;201704;3320;9911;3013;9389;427;1338;1916;6093;2343;7431
231270;201704;7122;19184;6277;17892;256;1048;4827;13539;5083;14587
231280;201704;1749;5632;1632;5414;173;600;1088;3628;1261;4228
231290;201704;34778;113362;31363;105855;5926;21717;13785;45724;19711;67441
231300;201704;4284;12365;3533;10848;249;882;2363;7126;2612;8008
231310;201704;7369;20686;6072;18010;769;2335;3577;10495;4346;12830
231320;201704;7007;20907;5749;18372;230;956;4212;13313;4442;14269
231325;201704;2742;7831;2354;7240;461;1424;1214;3806;1675;5230
231330;201704;11060;34948;9557;31878;1673;5677;5226;17660;6899;23337
231335;201704;5550;15356;4780;13997;158;649;3927;11284;4085;11933
231340;201704;17882;57666;16395;55276;1184;4299;12594;43042;13778;47341
231350;201704;14789;42471;13848;41208;500;1466;12288;36958;12788;38424
231355;201704;4621;14398;4166;13610;264;1045;3077;9979;3341;11024
231360;201704;7628;24026;6791;22569;1000;3466;4434;15008;5434;18474
231370;201704;2424;6708;1907;5844;59;211;1432;4353;1491;4564
231375;201704;4188;13960;3878;13365;211;998;3052;10351;3263;11349
231380;201704;5520;16337;5262;16026;239;706;4413;13794;4652;14500
231390;201704;3427;10563;3134;10024;276;1037;2212;6967;2488;8004
231395;201704;3863;12512;3482;11787;603;2109;1972;6734;2575;8843
231400;201704;9000;27404;8275;25978;503;1939;6205;19179;6708;21118
231410;201704;14705;48330;13439;46424;1160;4255;10009;34835;11169;39090
240010;201704;2421;7079;1982;6189;255;920;1125;3410;1380;4330
240020;201704;10155;31412;9121;29463;1536;5300;5069;16474;6605;21774
240030;201704;2552;7071;2452;6920;133;446;2128;5941;2261;6387
240040;201704;864;2494;720;2206;28;136;507;1491;535;1627
240050;201704;3422;9151;2869;8179;92;301;2248;6296;2340;6597
240060;201704;1416;3983;1238;3657;57;207;964;2752;1021;2959
240070;201704;2441;7300;2271;6955;274;899;1571;4720;1845;5619
240080;201704;3035;8032;2593;7392;137;469;1937;5453;2074;5922
240090;201704;2285;6019;1884;5315;41;155;1491;4132;1532;4287
240100;201704;7858;22262;6974;20463;631;2052;4892;13950;5523;16002
240110;201704;4700;14492;4139;13358;547;2026;2332;7384;2879;9410
240120;201704;2662;9159;2530;8874;327;1326;1610;5575;1937;6901
240130;201704;2769;7189;2427;6659;87;303;2047;5533;2134;5836
240140;201704;2240;6622;1882;5947;228;815;1162;3617;1390;4432
240145;201704;5783;17815;5139;16705;1031;3504;2893;9643;3924;13147
240150;201704;960;2908;812;2599;60;253;584;1805;644;2058
240160;201704;1452;4492;1236;4115;111;432;821;2756;932;3188
240165;201704;878;2719;752;2437;143;442;417;1383;560;1825
240170;201704;2288;6834;1975;6261;334;1137;1092;3413;1426;4550
240180;201704;2730;8458;2397;7780;382;1300;1442;4768;1824;6068
240185;201704;1365;4530;1262;4358;77;322;1021;3505;1098;3827
240190;201704;983;3080;869;2882;38;162;669;2222;707;2384
240200;201704;12262;32894;10434;30032;2152;6473;4391;12977;6543;19450
240210;201704;2840;7871;2564;7422;99;380;2087;5877;2186;6257
240220;201704;7364;24376;6778;23532;682;2858;4781;16625;5463;19483
240230;201704;5775;15093;4933;13786;195;602;4055;11333;4250;11935
240240;201704;1781;5421;1135;3810;202;713;206;640;408;1353
240250;201704;2663;7697;2495;7483;122;352;2104;6355;2226;6707
240260;201704;12095;39965;11468;38950;1597;6007;7615;25945;9212;31952
240270;201704;2294;7141;2103;6822;137;483;1677;5482;1814;5965
240280;201704;1526;4264;1370;4054;61;202;1101;3236;1162;3438
240290;201704;1178;3704;1041;3438;57;286;700;2162;757;2448
240300;201704;2318;6251;1736;5081;152;489;917;2632;1069;3121
240310;201704;9358;26301;8350;24645;1054;3396;4636;13755;5690;17151
240320;201704;1971;5723;1560;4887;48;214;1136;3394;1184;3608
240325;201704;32133;89665;26051;79629;7449;24299;6736;21818;14185;46117
240330;201704;1481;4455;1253;3981;74;304;803;2456;877;2760
240340;201704;2038;5197;1675;4629;129;386;1242;3380;1371;3766
240350;201704;2052;5611;1892;5419;70;256;1687;4793;1757;5049
240360;201704;6611;20354;5983;19401;1531;4961;2918;10030;4449;14991
240370;201704;2039;5603;1619;4794;157;444;1037;3080;1194;3524
240375;201704;845;2256;752;2088;45;178;543;1412;588;1590
240380;201704;2411;7120;1817;5781;218;710;955;3024;1173;3734
240390;201704;927;2550;755;2208;24;75;512;1441;536;1516
240400;201704;1347;3575;1051;3010;58;187;728;2020;786;2207
240410;201704;452;1485;408;1396;61;261;238;790;299;1051
240420;201704;4694;17781;4357;16997;748;3425;2333;8984;3081;12409
240430;201704;3389;9378;3064;8789;135;555;2406;6646;2541;7201
240440;201704;2489;6318;2223;5936;337;972;1398;3693;1735;4665
240450;201704;4018;11768;3413;10620;372;1337;1959;5911;2331;7248
240460;201704;2909;8764;2735;8539;210;847;2175;6630;2385;7477
240470;201704;3558;11109;2774;9411;623;2081;1330;4605;1953;6686
240480;201704;527;1430;398;1182;37;116;193;567;230;683
240485;201704;2005;6196;1739;5667;176;606;1175;3859;1351;4465
240490;201704;1759;4368;1430;3846;27;94;1233;3288;1260;3382
240500;201704;2199;6141;1972;5815;104;367;1600;4686;1704;5053
240510;201704;1662;4875;1591;4769;123;378;1311;3923;1434;4301
240520;201704;1242;3472;1086;3226;61;243;866;2477;927;2720
240530;201704;1948;6280;1810;6065;238;841;1295;4348;1533;5189
240540;201704;1854;5341;1730;5156;101;363;1467;4302;1568;4665
240550;201704;774;2194;660;1999;38;114;484;1462;522;1576
240560;201704;3308;9235;2999;8807;300;793;2341;7024;2641;7817
240570;201704;3024;8277;2217;6463;331;1050;974;2571;1305;3621
240580;201704;7830;23698;7248;22729;553;2025;5785;17936;6338;19961
240590;201704;741;2065;649;1900;19;72;497;1433;516;1505
240600;201704;1636;4708;1262;3911;122;452;746;2211;868;2663
240610;201704;4597;13148;3990;11988;342;1141;2647;7803;2989;8944
240615;201704;957;2814;785;2473;118;397;470;1438;588;1835
240620;201704;1841;5474;1624;5102;125;410;1266;3946;1391;4356
240630;201704;2059;6202;1878;5901;167;492;1293;4154;1460;4646
240640;201704;952;2623;791;2364;42;173;578;1667;620;1840
240650;201704;3982;11595;3565;10947;174;635;2816;8579;2990;9214
240660;201704;2377;7448;2235;7244;150;569;1780;5700;1930;6269
240670;201704;2582;7623;2162;6743;227;788;1280;3867;1507;4655
240680;201704;1519;4384;1231;3872;82;294;821;2533;903;2827
240690;201704;925;2505;785;2266;34;131;628;1744;662;1875
240700;201704;2520;7376;2106;6633;75;327;1640;5045;1715;5372
240710;201704;17576;46973;15269;43165;2927;8169;8220;23887;11147;32056
240720;201704;5205;14646;4692;13737;1129;3405;2303;6628;3432;10033
240725;201704;1024;3068;824;2610;58;198;505;1551;563;1749
240730;201704;2064;6150;1800;5653;116;378;1344;4206;1460;4584
240740;201704;1932;5540;1705;5110;108;412;1205;3477;1313;3889
240750;201704;2145;7908;1981;7602;396;1683;1049;4051;1445;5734
240760;201704;1350;3618;1050;3162;73;207;778;2412;851;2619
240770;201704;3095;8737;2781;8302;143;568;2312;6770;2455;7338
240780;201704;5944;16312;4802;14492;606;1865;2894;8908;3500;10773
240790;201704;895;2658;738;2367;36;142;527;1693;563;1835
240800;201704;34248;97308;30196;90438;6389;20079;13146;39821;19535;59900
240810;201704;83671;238779;76780;226887;19635;58745;35493;107333;55128;166078
240820;201704;5583;17590;4992;16647;1134;3968;2348;8238;3482;12206
240830;201704;8838;26791;8231;25926;396;1631;6830;21237;7226;22868
240840;201704;1113;3055;945;2766;83;267;628;1780;711;2047
240850;201704;1291;3734;961;2996;101;340;508;1568;609;1908
240860;201704;1259;3572;1019;3126;38;158;766;2254;804;2412
240870;201704;1148;3082;923;2692;63;197;618;1726;681;1923
240880;201704;1224;4006;1155;3890;87;365;946;3120;1033;3485
240890;201704;4866;13705;4059;12150;803;2499;1767;5243;2570;7742
240895;201704;2624;9014;2426;8684;238;915;1792;6498;2030;7413
240910;201704;3006;8826;2653;8152;115;433;2120;6442;2235;6875
240920;201704;773;2470;679;2258;112;410;350;1142;462;1552
240930;201704;3469;8791;3038;8264;92;249;2473;6820;2565;7069
240933;201704;1575;4156;1365;3820;50;189;1117;3044;1167;3233
240940;201704;6402;16765;5177;14737;624;1766;3303;9313;3927;11079
240950;201704;938;3040;865;2896;59;256;633;2063;692;2319
240960;201704;794;2457;700;2267;50;175;508;1644;558;1819
240970;201704;1861;5104;1573;4617;73;263;1245;3542;1318;3805
240980;201704;2851;9370;2655;9012;396;1472;1742;5856;2138;7328
240990;201704;2611;7766;2476;7503;389;1272;1619;4853;2008;6125
241000;201704;1035;2840;875;2552;47;161;602;1728;649;1889
241010;201704;2762;9269;2599;8960;323;1336;1819;6023;2142;7359
241020;201704;2018;5553;1597;4705;202;557;927;2734;1129;3291
241025;201704;1703;5046;1492;4673;80;320;993;3083;1073;3403
241030;201704;2385;7782;2094;7183;206;842;1417;4794;1623;5636
241040;201704;2212;7434;2021;7095;137;597;1505;5273;1642;5870
241050;201704;1274;3707;1077;3357;67;238;790;2418;857;2656
241060;201704;834;2403;745;2244;58;190;514;1507;572;1697
241070;201704;696;1993;624;1864;50;185;476;1343;526;1528
241080;201704;1140;3341;929;2926;31;142;678;2089;709;2231
241090;201704;2148;6329;1792;5722;92;394;1343;4233;1435;4627
241100;201704;1166;3424;1004;3067;59;212;690;2065;749;2277
241105;201704;1194;3580;1030;3292;261;840;438;1454;699;2294
241110;201704;825;2524;681;2204;41;156;445;1379;486;1535
241120;201704;7286;22036;6595;20817;1548;4735;3376;11329;4924;16064
241140;201704;3393;9100;2921;8185;232;676;2108;5755;2340;6431
241142;201704;746;2168;577;1829;79;272;298;918;377;1190
241150;201704;5489;15805;4900;14816;373;1308;3551;10615;3924;11923
241160;201704;947;2781;851;2619;150;479;488;1499;638;1978
241170;201704;1149;3288;1070;3152;104;294;827;2414;931;2708
241180;201704;965;2678;766;2294;75;228;414;1216;489;1444
241190;201704;1178;3221;940;2723;49;182;627;1748;676;1930
241200;201704;18877;53581;16637;50155;4023;12715;7325;22856;11348;35571
241210;201704;1451;4034;1150;3427;126;434;702;2023;828;2457
241220;201704;7966;25694;7335;24542;2124;7178;3269;11425;5393;18603
241230;201704;3045;8634;2814;8271;142;506;2307;6631;2449;7137
241240;201704;1275;3689;858;2747;91;329;366;1173;457;1502
241250;201704;6110;18495;5082;16532;259;1280;3772;11844;4031;13124
241255;201704;1757;6450;1579;6053;277;1228;862;3280;1139;4508
241260;201704;5112;13714;4057;12031;174;736;2940;8544;3114;9280
241270;201704;1852;5590;1618;5121;102;427;1172;3632;1274;4059
241280;201704;1803;5193;1652;4912;132;410;1228;3616;1360;4026
241290;201704;2963;8152;2489;7330;133;500;1865;5368;1998;5868
241300;201704;1483;4182;1267;3790;44;154;867;2566;911;2720
241310;201704;1726;4932;1558;4658;75;288;1273;3749;1348;4037
241320;201704;933;3189;848;3002;111;439;533;1885;644;2324
241330;201704;1443;4354;1357;4245;81;338;1160;3577;1241;3915
241335;201704;2886;8528;2642;8094;121;431;2163;6539;2284;6970
241340;201704;1817;5519;1524;4853;332;1133;657;2031;989;3164
241350;201704;1911;5937;1722;5582;117;506;1297;4081;1414;4587
241355;201704;1429;3921;1149;3426;58;209;879;2591;937;2800
241360;201704;2107;5596;1714;4837;75;235;1248;3437;1323;3672
241370;201704;1372;4025;1131;3553;91;348;723;2189;814;2537
241380;201704;621;1753;523;1566;55;186;329;949;384;1135
241390;201704;2770;8819;2570;8509;235;907;1954;6436;2189;7343
241400;201704;3692;10518;3346;10020;327;1090;2526;7605;2853;8695
241410;201704;2441;7372;2167;6971;343;1172;1393;4487;1736;5659
241415;201704;1667;4953;1480;4646;144;492;1094;3352;1238;3844
241420;201704;2239;7665;1994;7241;630;2468;530;1955;1160;4423
241430;201704;570;1675;438;1385;42;155;249;743;291;898
241440;201704;6135;21842;5812;21314;659;2809;4301;15738;4960;18547
241445;201704;981;2791;930;2731;48;116;791;2436;839;2552
241450;201704;2965;7874;2590;7342;321;926;1789;5070;2110;5996
241460;201704;3388;9759;2995;8958;232;821;2138;6213;2370;7034
241470;201704;1413;3857;1153;3506;86;322;881;2668;967;2990
241475;201704;1251;3721;1031;3286;45;238;743;2261;788;2499
241480;201704;2674;8835;2449;8440;954;3363;650;2526;1604;5889
241490;201704;698;1830;580;1657;29;86;373;1030;402;1116
241500;201704;728;2267;620;2127;14;58;529;1816;543;1874
250010;201704;2777;8554;2329;7566;81;358;1751;5574;1832;5932
250020;201704;1574;4477;1203;3762;58;224;856;2598;914;2822
250030;201704;6917;19791;6390;19052;370;1248;5243;15440;5613;16688
250040;201704;3977;13324;3677;12673;453;1649;2454;8466;2907;10115
250050;201704;3256;10125;3015;9740;462;1547;1897;6031;2359;7578
250053;201704;1229;3676;1120;3511;118;384;788;2485;906;2869
250057;201704;634;2649;616;2630;2;2;588;2565;590;2567
250060;201704;5140;15007;4776;14486;413;1417;3731;11255;4144;12672
250070;201704;3859;11830;3591;11331;110;538;2750;8358;2860;8896
250073;201704;783;2283;684;2114;23;85;518;1549;541;1634
250077;201704;2158;6208;1739;5497;112;383;1210;3808;1322;4191
250080;201704;4170;11901;3956;11529;242;810;3183;9094;3425;9904
250090;201704;2582;7275;2406;6987;139;384;1948;5612;2087;5996
250100;201704;3848;12306;3610;11878;207;889;2900;9307;3107;10196
250110;201704;4813;14278;4531;13871;410;1483;3580;10762;3990;12245
250115;201704;486;1526;449;1460;20;107;336;1048;356;1155
250120;201704;1824;5662;1604;5235;84;345;1254;4085;1338;4430
250130;201704;5286;16293;4773;15341;183;860;3785;11965;3968;12825
250135;201704;1049;3175;984;3062;36;138;793;2442;829;2580
250140;201704;2090;6769;2015;6650;150;631;1589;5197;1739;5828
250150;201704;5007;16590;4578;15780;246;1145;3486;11776;3732;12921
250153;201704;1458;3911;1249;3600;34;147;1044;2954;1078;3101
250157;201704;1746;5584;1598;5286;242;755;1030;3477;1272;4232
250160;201704;3297;9526;3102;9230;83;294;2811;8352;2894;8646
250170;201704;1592;4647;1455;4438;89;323;1153;3492;1242;3815
250180;201704;15726;44963;14587;43277;1292;4542;10641;30753;11933;35295
250190;201704;4124;11818;3766;11248;479;1433;2472;7372;2951;8805
250200;201704;1946;5697;1624;5207;81;329;1310;4159;1391;4488
250205;201704;835;2861;781;2737;34;172;587;2033;621;2205
250210;201704;1478;4747;1381;4589;88;425;1057;3406;1145;3831
250215;201704;1403;4370;1289;4208;103;418;838;2693;941;3111
250220;201704;737;2184;614;1993;36;137;451;1459;487;1596
250230;201704;1567;3894;1252;3376;45;160;973;2508;1018;2668
250240;201704;2303;7454;2179;7232;104;401;1758;5796;1862;6197
250250;201704;4380;12916;3981;12375;162;578;3266;10138;3428;10716
250260;201704;1687;5020;1463;4650;53;205;1146;3630;1199;3835
250270;201704;1285;3947;1157;3784;92;310;852;2912;944;3222
250280;201704;3551;10360;3108;9656;225;722;2339;7247;2564;7969
250290;201704;1782;4812;1492;4418;17;58;1261;3723;1278;3781
250300;201704;5254;15467;5021;15178;365;1421;4302;12731;4667;14152
250310;201704;1112;3361;992;3153;58;241;762;2348;820;2589
250320;201704;8100;23363;7594;22637;847;2808;5612;16426;6459;19234
250330;201704;2406;7371;2057;6849;150;560;1561;5161;1711;5721
250340;201704;1086;3171;978;2991;29;107;824;2482;853;2589
250350;201704;4102;11376;3698;10884;135;466;3238;9523;3373;9989
250355;201704;1964;6093;1794;5869;42;230;1595;5149;1637;5379
250360;201704;1800;5250;1684;5062;44;152;1414;4231;1458;4383
250370;201704;11564;32828;10325;31411;633;2072;8789;26756;9422;28828
250375;201704;1073;3191;975;3054;34;120;829;2621;863;2741
250380;201704;1668;4680;1588;4577;68;271;1340;3742;1408;4013
250390;201704;1807;4921;1485;4377;213;598;941;2815;1154;3413
250400;201704;72809;191929;57512;167862;14567;44941;21125;63136;35692;108077
250403;201704;1558;5052;1440;4883;238;958;914;3008;1152;3966
250407;201704;1200;3311;1037;3067;86;235;758;2228;844;2463
250410;201704;526;1675;490;1609;21;111;389;1231;410;1342
250415;201704;1923;5641;1720;5291;85;281;1313;4015;1398;4296
250420;201704;1246;3602;1124;3422;21;74;1012;3075;1033;3149
250430;201704;6177;16412;5581;15518;226;760;4568;12435;4794;13195
250435;201704;1338;4057;1200;3812;69;261;882;2762;951;3023
250440;201704;4504;12707;4072;12110;111;431;3450;10150;3561;10581
250450;201704;1887;5331;1638;4989;54;219;1367;4103;1421;4322
250460;201704;6568;19198;6160;18681;379;1224;5190;15920;5569;17144
250470;201704;1550;4144;1307;3804;92;335;962;2717;1054;3052
250480;201704;3750;11169;3465;10774;79;344;3042;9487;3121;9831
250485;201704;632;1542;511;1378;22;67;423;1115;445;1182
250490;201704;3936;11767;3780;11557;454;1461;2909;8908;3363;10369
250500;201704;1771;5284;1602;5005;103;334;1257;3947;1360;4281
250510;201704;4959;13660;4421;12911;116;372;3888;11352;4004;11724
250520;201704;1780;5315;1661;5157;243;869;1040;3161;1283;4030
250523;201704;1764;5163;1709;5092;106;422;1445;4210;1551;4632
250527;201704;1432;4190;1367;4109;59;172;1239;3723;1298;3895
250530;201704;595;1824;529;1744;25;105;462;1509;487;1614
250535;201704;1322;4068;1233;3896;50;227;978;3012;1028;3239
250540;201704;2480;6780;2298;6574;39;128;2069;5884;2108;6012
250550;201704;871;2924;802;2813;37;194;656;2242;693;2436
250560;201704;1637;5062;1544;4915;78;299;1261;3940;1339;4239
250570;201704;2640;8167;2318;7558;116;504;1818;5782;1934;6286
250580;201704;1099;2897;965;2695;48;185;815;2216;863;2401
250590;201704;819;2535;753;2436;35;158;625;1956;660;2114
250600;201704;6983;20539;6555;19889;595;1835;5132;15637;5727;17472
250610;201704;3010;8747;2796;8441;241;776;2180;6551;2421;7327
250620;201704;677;1975;612;1844;71;242;406;1178;477;1420
250625;201704;2431;7631;2345;7496;51;174;2170;6916;2221;7090
250630;201704;9554;29295;8666;27455;1739;5791;4794;15065;6533;20856
250640;201704;3396;10319;3213;10072;149;666;2710;8300;2859;8966
250650;201704;868;2349;756;2200;44;179;578;1590;622;1769
250660;201704;1755;4645;1629;4469;29;66;1514;4180;1543;4246
250670;201704;2314;7721;2209;7541;105;521;1867;6227;1972;6748
250680;201704;4855;13186;4579;12869;167;621;4088;11379;4255;12000
250690;201704;6006;15148;5728;14832;249;703;5234;13478;5483;14181
250700;201704;4513;13295;4135;12724;584;1919;2793;8482;3377;10401
250710;201704;4438;13564;3985;12950;400;1404;2792;9214;3192;10618
250720;201704;2726;7695;2513;7358;57;250;2229;6472;2286;6722
250730;201704;3526;10486;3240;10089;239;891;2586;7873;2825;8764
250740;201704;1904;5371;1643;4979;152;565;1238;3626;1390;4191
250750;201704;97110;269347;88592;256914;10620;33893;59037;168380;69657;202273
250760;201704;2284;6303;2021;5925;119;428;1611;4649;1730;5077
250770;201704;3877;12686;3638;12374;368;1453;2638;8928;3006;10381
250780;201704;1737;5041;1497;4577;178;633;978;2905;1156;3538
250790;201704;2334;7529;2220;7327;433;1429;1339;4543;1772;5972
250800;201704;2641;7272;2334;6774;90;260;1912;5482;2002;5742
250810;201704;1258;3642;1092;3384;49;204;858;2615;907;2819
250820;201704;1871;5795;1796;5705;88;373;1591;4999;1679;5372
250830;201704;5551;17765;5133;16917;463;1839;3620;11710;4083;13549
250840;201704;890;2863;768;2609;45;181;510;1737;555;1918
250850;201704;1983;5988;1789;5679;76;370;1414;4370;1490;4740
250855;201704;1078;3141;950;2938;42;185;709;2129;751;2314
250860;201704;3233;10348;2770;9503;593;2158;1171;4123;1764;6281
250870;201704;1077;3079;940;2815;33;122;735;2173;768;2295
250880;201704;1516;4067;1259;3705;118;365;929;2768;1047;3133
250890;201704;9310;27485;8875;26889;991;3600;6583;19442;7574;23042
250900;201704;2710;8662;2403;8069;147;526;1851;6149;1998;6675
250905;201704;2021;6333;1947;6245;161;623;1596;5053;1757;5676
250910;201704;4951;14036;4644;13603;209;761;3919;11400;4128;12161
250915;201704;1446;4293;1408;4248;60;145;1279;3940;1339;4085
250920;201704;3182;8948;2998;8673;246;734;2281;6517;2527;7251
250930;201704;1953;5857;1849;5682;145;564;1442;4311;1587;4875
250933;201704;1115;3650;1019;3455;78;325;699;2328;777;2653
250937;201704;673;2039;587;1884;43;163;437;1379;480;1542
250939;201704;1588;4646;1457;4442;72;272;1115;3309;1187;3581
250940;201704;3766;10936;3523;10543;85;353;3066;9158;3151;9511
250950;201704;1352;4023;1181;3794;46;185;966;3115;1012;3300
250960;201704;1033;3316;982;3231;39;166;788;2547;827;2713
250970;201704;8441;23136;7376;21440;510;1662;5468;15675;5978;17337
250980;201704;2529;7338;2288;6894;90;382;1747;5071;1837;5453
250990;201704;1932;6484;1722;6028;208;902;1146;3859;1354;4761
251000;201704;2065;6014;1807;5601;54;255;1524;4661;1578;4916
251010;201704;2721;7945;2456;7511;89;327;2127;6503;2216;6830
251020;201704;1676;4646;1529;4463;63;201;1382;4024;1445;4225
251030;201704;1012;2860;921;2680;50;174;659;1864;709;2038
251040;201704;1737;5395;1560;5094;82;412;1223;3854;1305;4266
251050;201704;1044;3030;868;2692;115;357;546;1667;661;2024
251060;201704;1038;2333;767;1985;21;81;607;1544;628;1625
251065;201704;476;1365;400;1260;24;95;272;805;296;900
251070;201704;629;1725;564;1630;18;77;467;1302;485;1379
251080;201704;18567;51541;16614;48504;3897;11838;8294;24850;12191;36688
251090;201704;2880;8745;2528;8062;131;517;1928;6020;2059;6537
251100;201704;937;2939;848;2787;48;238;603;1896;651;2134
251110;201704;1807;5258;1599;4842;99;316;1155;3461;1254;3777
251120;201704;6246;20575;5924;20010;509;2080;4469;14842;4978;16922
251130;201704;3795;9619;3519;9325;88;197;3354;8957;3442;9154
251140;201704;4214;12660;3951;12237;133;562;3284;10105;3417;10667
251150;201704;2601;8137;2406;7847;170;749;1852;5890;2022;6639
251160;201704;1807;5877;1759;5802;53;215;1607;5290;1660;5505
251170;201704;1450;4269;1380;4192;42;179;1248;3758;1290;3937
251180;201704;2523;7521;2264;7125;290;997;1451;4535;1741;5532
251190;201704;4412;12031;4211;11787;108;354;3826;10584;3934;10938
251200;201704;3923;12628;3714;12372;95;401;3350;11196;3445;11597
251203;201704;994;3282;959;3213;46;196;717;2356;763;2552
251207;201704;1022;3167;879;2898;34;169;606;1930;640;2099
251210;201704;7838;21774;6703;20288;527;1618;5162;15865;5689;17483
251220;201704;1177;3082;971;2799;63;181;751;2185;814;2366
251230;201704;4553;13230;4156;12735;216;808;3607;10875;3823;11683
251240;201704;3256;9716;2972;9335;330;1071;2239;7022;2569;8093
251250;201704;10268;29763;9546;28733;799;2809;7216;21265;8015;24074
251260;201704;466;1459;427;1397;23;98;326;1047;349;1145
251270;201704;4225;13594;3861;13137;132;596;3314;11267;3446;11863
251272;201704;1338;3785;1273;3694;60;208;1148;3301;1208;3509
251274;201704;930;2809;812;2598;71;306;545;1663;616;1969
251275;201704;1229;3559;1147;3431;52;222;877;2509;929;2731
251276;201704;1194;3616;1137;3522;101;409;858;2600;959;3009
251278;201704;593;1806;519;1666;49;190;338;1087;387;1277
251280;201704;2318;6789;2135;6483;80;344;1691;4966;1771;5310
251290;201704;5592;15088;5257;14672;462;1665;4194;11346;4656;13011
251300;201704;750;2450;705;2379;19;83;581;1943;600;2026
251310;201704;2913;8666;2703;8374;137;618;2174;6527;2311;7145
251315;201704;1649;5507;1566;5366;122;469;1186;4022;1308;4491
251320;201704;1849;5034;1376;4267;69;258;935;2887;1004;3145
251330;201704;1763;4626;1488;4264;54;221;1310;3685;1364;3906
251335;201704;1023;3357;933;3211;72;319;678;2269;750;2588
251340;201704;3423;9764;3032;9219;152;589;2362;7062;2514;7651
251350;201704;1185;3767;1109;3631;50;219;884;2800;934;3019
251360;201704;1805;5571;1545;5212;47;200;1321;4499;1368;4699
251365;201704;707;2113;592;1857;18;79;442;1359;460;1438
251370;201704;23030;69566;22110;68323;1781;6708;17424;52755;19205;59463
251380;201704;1306;4012;1131;3718;40;206;950;3011;990;3217
251385;201704;732;1944;600;1735;35;118;413;1131;448;1249
251390;201704;5698;19029;5060;17770;1334;4845;2345;8292;3679;13137
251392;201704;1045;3056;910;2826;61;237;658;1998;719;2235
251394;201704;613;2031;529;1885;32;145;374;1322;406;1467
251396;201704;806;2273;693;2091;56;158;448;1347;504;1505
251398;201704;875;2543;775;2361;35;144;543;1588;578;1732
251400;201704;1142;3193;969;2938;70;249;709;2069;779;2318
251410;201704;1531;3901;1290;3520;31;130;1078;2834;1109;2964
251420;201704;1955;5549;1689;5232;141;517;1246;3800;1387;4317
251430;201704;1609;5336;1479;5127;59;299;1255;4270;1314;4569
251440;201704;1178;3498;977;3107;42;167;745;2361;787;2528
251445;201704;1508;4563;1433;4463;99;415;1131;3432;1230;3847
251450;201704;4612;14400;4255;13915;134;618;3518;11453;3652;12071
251455;201704;1060;3339;948;3120;82;348;673;2173;755;2521
251460;201704;820;2521;759;2418;47;173;617;1976;664;2149
251465;201704;438;1382;378;1248;16;85;285;907;301;992
251470;201704;1134;3272;936;2861;74;250;577;1735;651;1985
251480;201704;915;2561;807;2384;30;135;599;1707;629;1842
251490;201704;1782;5190;1587;4882;169;568;1032;3120;1201;3688
251500;201704;1734;5457;1659;5321;97;397;1362;4287;1459;4684
251510;201704;2515;8164;2275;7686;328;1212;1380;4648;1708;5860
251520;201704;929;2550;801;2307;85;259;544;1531;629;1790
251530;201704;12128;33207;11331;32118;290;1254;9795;27192;10085;28446
251540;201704;2820;8866;2612;8478;163;628;2003;6402;2166;7030
251550;201704;3377;8883;2841;8156;81;301;2337;6654;2418;6955
251560;201704;654;2030;591;1923;90;340;354;1108;444;1448
251570;201704;961;2826;788;2490;34;143;554;1693;588;1836
251580;201704;1835;5131;1673;4905;288;749;1124;3418;1412;4167
251590;201704;1498;4410;1416;4295;61;219;1132;3420;1193;3639
251593;201704;979;2974;903;2868;122;412;559;1745;681;2157
251597;201704;1930;5821;1867;5741;43;177;1683;5120;1726;5297
251600;201704;6461;18704;5987;17967;284;995;4920;14616;5204;15611
251610;201704;3285;9679;2954;9081;369;1108;2002;6253;2371;7361
251615;201704;1139;3179;931;2821;41;162;646;1897;687;2059
251620;201704;15708;40943;14026;38989;462;1293;11550;33852;12012;35145
251630;201704;4640;11813;3936;10806;252;762;2948;7957;3200;8719
251640;201704;2207;6603;2000;6209;78;338;1643;4991;1721;5329
251650;201704;3983;11255;3648;10811;189;662;3050;8980;3239;9642
251660;201704;3493;11013;3170;10427;112;553;2624;8426;2736;8979
251670;201704;4388;12819;3901;12221;28;107;3669;11626;3697;11733
251675;201704;686;2129;633;2055;96;355;420;1325;516;1680
251680;201704;2749;7753;2228;6963;85;337;1732;5369;1817;5706
251690;201704;3267;9667;2964;9091;118;423;2162;6478;2280;6901
251700;201704;1885;6051;1757;5882;88;427;1452;4740;1540;5167
251710;201704;877;2298;589;1718;71;251;278;779;349;1030
251720;201704;1415;4246;1205;3848;50;228;898;2773;948;3001
251740;201704;752;2107;601;1861;51;172;376;1149;427;1321
260005;201704;24766;60135;21385;55257;3847;9709;12460;32473;16307;42182
260010;201704;9792;26486;8247;24339;865;2648;5055;15364;5920;18012
260020;201704;6253;16814;5293;15429;186;713;4319;12568;4505;13281
260030;201704;6132;17358;5439;16258;342;1202;4204;12506;4546;13708
260040;201704;9469;23649;7855;21735;706;1968;5844;16757;6550;18725
260050;201704;11145;34168;10450;33333;459;1796;9032;29012;9491;30808
260060;201704;3838;10698;3396;9909;300;855;2479;7369;2779;8224
260070;201704;9808;27758;8938;26376;882;3012;6339;18341;7221;21353
260080;201704;6122;15550;5490;14692;451;1251;4200;11107;4651;12358
260090;201704;5209;14015;4827;13483;501;1371;3683;10406;4184;11777
260100;201704;3310;9067;2846;8427;168;613;2301;6791;2469;7404
260105;201704;5013;13818;4747;13400;150;631;4077;11251;4227;11882
260110;201704;21309;58515;19580;56489;787;2500;17354;50195;18141;52695
260120;201704;13109;38152;11647;35732;2136;6732;6547;20638;8683;27370
260130;201704;3137;8700;2935;8378;293;908;2199;6186;2492;7094
260140;201704;12534;30989;10915;29059;699;2195;8821;23551;9520;25746
260150;201704;3166;8622;2860;8222;185;665;2295;6531;2480;7196
260160;201704;5499;17007;4760;16026;231;1072;3893;13133;4124;14205
260170;201704;16396;44976;15533;43789;714;2353;13351;37309;14065;39662
260180;201704;3244;9684;2962;9277;153;541;2519;7867;2672;8408
260190;201704;16332;37164;14737;35224;331;984;12827;30171;13158;31155
260200;201704;10999;27584;10143;26521;361;1134;8988;23430;9349;24564
260210;201704;11795;34869;10493;32802;456;1783;8585;26750;9041;28533
260220;201704;9405;26226;9023;25744;352;1341;8014;22498;8366;23839
260230;201704;9748;27077;8929;25955;418;1511;7223;20862;7641;22373
260240;201704;2926;8576;2553;8047;232;802;1936;6141;2168;6943
260250;201704;2250;6184;1982;5800;101;346;1593;4581;1694;4927
260260;201704;12179;34188;10983;32443;777;2696;8563;25173;9340;27869
260270;201704;3620;10373;3320;9920;213;931;2514;7242;2727;8173
260280;201704;12866;40970;11832;39452;625;2346;9921;33253;10546;35599
260290;201704;32582;95702;30633;92343;4901;15746;19319;57731;24220;73477
260300;201704;8952;26621;7909;25067;341;1444;6186;19642;6527;21086
260310;201704;4456;12953;4057;12363;730;2076;2621;8314;3351;10390
260320;201704;7474;23202;6831;22108;384;1459;5493;17719;5877;19178
260330;201704;2566;8148;2377;7791;135;575;1869;5999;2004;6574
260340;201704;1890;5421;1738;5199;45;162;1547;4610;1592;4772
260345;201704;22166;67251;20627;64393;5063;17358;8411;25176;13474;42534
260350;201704;4899;12940;4519;12407;151;553;3929;10659;4080;11212
260360;201704;2422;6810;2200;6423;99;428;1526;4400;1625;4828
260370;201704;5572;17116;4905;15915;340;1409;3611;11576;3951;12985
260380;201704;4852;15617;4365;14840;269;1186;3241;10906;3510;12092
260390;201704;4242;13317;3669;12185;276;1012;2548;8378;2824;9390
260392;201704;3469;11053;3157;10654;202;924;2611;8665;2813;9589
260400;201704;13683;37823;12889;36566;1396;4418;9288;25904;10684;30322
260410;201704;60147;169195;52052;156462;13338;42648;20553;63568;33891;106216
260415;201704;3686;11385;3234;10481;196;894;2201;6822;2397;7716
260420;201704;12258;27626;10852;26097;184;629;9964;23773;10148;24402
260430;201704;2879;9187;2528;8517;211;771;1695;5709;1906;6480
260440;201704;3267;9668;2889;8934;286;1026;2001;6030;2287;7056
260450;201704;5004;14244;4806;13979;151;512;4343;12650;4494;13162
260460;201704;5490;17292;5006;16370;778;2893;2890;9239;3668;12132
260470;201704;4620;13370;4190;12864;134;378;3677;11625;3811;12003
260480;201704;4107;11561;3592;10818;433;1428;2346;7217;2779;8645
260490;201704;4975;12793;4341;11727;181;596;3616;9511;3797;10107
260500;201704;5774;16359;5123;15323;678;2059;3377;10203;4055;12262
260510;201704;8765;23019;8104;22121;329;1063;7110;19254;7439;20317
260515;201704;4726;13930;3610;11726;229;880;2283;7371;2512;8251
260520;201704;16512;41784;15620;40583;1405;3781;12281;31676;13686;35457
260530;201704;9501;28979;8375;27241;338;1417;7036;22824;7374;24241
260540;201704;6006;14805;5457;14211;646;1228;4319;11871;4965;13099
260545;201704;62;221;42;165;9;37;8;29;17;66
260550;201704;2731;8685;2304;7742;335;1277;1170;3872;1505;5149
260560;201704;6295;16395;5558;15393;159;665;4821;13156;4980;13821
260570;201704;6746;21618;6191;20738;601;2331;4607;15374;5208;17705
260580;201704;3728;10158;3432;9672;73;258;2990;8299;3063;8557
260590;201704;6213;15498;5794;15017;264;733;5045;13079;5309;13812
260600;201704;28947;82339;25563;76799;1737;6389;18820;55909;20557;62298
260610;201704;6060;18202;5758;17685;584;1997;4246;12827;4830;14824
260620;201704;15034;45123;14359;43937;2156;7622;9270;27526;11426;35148
260630;201704;2305;6520;2005;6080;82;339;1653;4950;1735;5289
260640;201704;17171;46386;16040;44883;1879;5685;11272;31382;13151;37067
260650;201704;5450;16608;4783;15470;251;1008;3851;12470;4102;13478
260660;201704;7666;21011;6885;20029;240;926;5807;16696;6047;17622
260670;201704;2305;6086;1904;5508;108;316;1364;3941;1472;4257
260680;201704;21532;60531;19586;57064;3312;9914;10324;30078;13636;39992
260690;201704;3729;9909;3099;8890;177;517;2395;6868;2572;7385
260700;201704;5802;17288;5650;17124;27;50;5535;16949;5562;16999
260710;201704;1365;3895;1292;3797;93;321;962;2902;1055;3223
260720;201704;18116;55765;16929;53536;3020;9992;9795;30847;12815;40839
260730;201704;6709;21842;6278;21140;594;2347;4831;16012;5425;18359
260740;201704;1239;3708;1113;3481;50;171;916;2867;966;3038
260750;201704;6975;20389;6125;19312;218;654;5431;17485;5649;18139
260760;201704;4748;12641;4453;12276;186;621;3765;10391;3951;11012
260765;201704;7532;25257;7131;24592;864;3909;4899;16240;5763;20149
260770;201704;3781;10085;3394;9472;126;413;2688;7441;2814;7854
260775;201704;4902;14340;4648;13954;376;1449;3370;9827;3746;11276
260780;201704;3644;11478;3400;11013;633;2251;1932;6055;2565;8306
260790;201704;109369;273466;100713;260518;18765;49741;58849;151211;77614;200952
260795;201704;3116;8937;2749;8378;204;723;1974;6061;2178;6784
260800;201704;5111;13032;4754;12548;125;468;4201;10727;4326;11195
260805;201704;3718;11053;3197;10206;295;1115;2207;6954;2502;8069
260810;201704;6586;18275;6291;17798;361;1098;5228;14728;5589;15826
260820;201704;4041;11201;3585;10492;523;1740;2163;6192;2686;7932
260825;201704;2874;9082;2558;8551;143;612;1937;6433;2080;7045
260830;201704;3763;11835;3345;11046;422;1417;2272;7575;2694;8992
260840;201704;4192;11938;3737;11270;218;711;3021;9065;3239;9776
260845;201704;4023;11588;3832;11242;387;1189;2918;8594;3305;9783
260850;201704;4866;15523;4327;14297;729;2608;2203;7213;2932;9821
260860;201704;3626;10830;3136;9845;168;621;2381;7409;2549;8030
260870;201704;4234;11136;3748;10520;210;694;3068;8512;3278;9206
260875;201704;6483;17949;5686;16654;778;2311;3723;10989;4501;13300
260880;201704;9812;28811;8850;27264;471;1614;7106;21970;7577;23584
260890;201704;12802;36379;11927;35032;753;2643;8928;25874;9681;28517
260900;201704;5645;17164;4872;15703;354;1464;3223;10183;3577;11647
260910;201704;3079;9085;2758;8573;130;477;2074;6441;2204;6918
260915;201704;4638;15135;4340;14722;91;467;3931;13294;4022;13761
260920;201704;3248;9709;3012;9387;169;555;2433;7743;2602;8298
260930;201704;3832;12370;3406;11646;304;1125;2445;8378;2749;9503
260940;201704;13762;36030;12622;34179;1329;4127;8708;23061;10037;27188
260950;201704;6283;19085;5537;17574;819;3027;2844;8565;3663;11592
260960;201704;54686;148606;49529;140334;8927;27143;26698;74755;35625;101898
260970;201704;4900;14535;4493;14001;224;860;3519;10984;3743;11844
260980;201704;4017;12784;3721;12414;105;445;3302;11017;3407;11462
260990;201704;17179;51914;15560;49670;899;3619;12267;38915;13166;42534
261000;201704;15567;41572;12880;37530;1706;5374;7417;22084;9123;27458
261010;201704;2523;6905;2301;6639;101;234;2047;6025;2148;6259
261020;201704;6477;18455;5676;17027;488;1642;4175;12218;4663;13860
261030;201704;3801;11470;3348;10724;169;656;2643;8330;2812;8986
261040;201704;5084;16138;4312;14507;326;1287;3070;10126;3396;11413
261050;201704;7802;22487;7267;21556;912;2777;4760;14190;5672;16967
261060;201704;12374;35315;11410;33629;973;3350;8518;24613;9491;27963
261070;201704;53783;129313;47440;120273;4714;12631;33337;83656;38051;96287
261080;201704;5650;15981;5363;15567;289;820;4662;13693;4951;14513
261090;201704;16597;44429;15209;42523;917;2762;12441;34783;13358;37545
261100;201704;8220;25357;7313;23801;1045;3649;4524;14948;5569;18597
261110;201704;60176;177363;53358;167007;13397;44480;23548;75810;36945;120290
261120;201704;3841;9934;3345;9349;82;290;2964;8285;3046;8575
261130;201704;7188;18118;6641;17516;167;534;5935;15592;6102;16126
261140;201704;3141;8669;2847;8217;365;1204;1832;5184;2197;6388
261150;201704;5386;14945;4913;14236;198;710;4223;12167;4421;12877
261153;201704;2054;6080;1749;5594;96;397;1241;3939;1337;4336
261160;201704;192950;502837;177545;479860;44016;125051;78975;215999;122991;341050
261170;201704;5681;15161;5195;14465;276;791;4200;11714;4476;12505
261180;201704;9651;26352;8954;25398;854;2738;6194;17353;7048;20091
261190;201704;4987;15309;4646;14893;477;2003;3314;10344;3791;12347
261200;201704;3600;8785;3205;8308;295;793;2488;6433;2783;7226
261210;201704;1872;4917;1727;4729;100;281;1494;4094;1594;4375
261220;201704;13509;40987;11477;36860;1511;5362;6477;20649;7988;26011
261230;201704;4560;13956;4129;13412;110;455;3514;11544;3624;11999
261240;201704;4883;13850;4473;13157;478;1353;3319;9853;3797;11206
261245;201704;3466;10569;2998;9735;142;665;2325;7329;2467;7994
261247;201704;3126;9521;2681;8707;158;633;1937;6315;2095;6948
261250;201704;18940;49758;17523;47853;3190;8363;11237;31939;14427;40302
261255;201704;3971;12278;3530;11502;210;950;2783;8814;2993;9764
261260;201704;12475;34575;11093;32901;476;1625;9293;27839;9769;29464
261270;201704;3684;10873;3323;10276;288;1021;2379;7175;2667;8196
261280;201704;2547;7610;2340;7277;93;377;1894;5800;1987;6177
261290;201704;2959;8307;2656;7911;154;561;2062;6158;2216;6719
261300;201704;10921;34040;9489;31448;1021;4063;6223;20192;7244;24255
261310;201704;7023;21315;6568;20524;1562;4969;3587;11220;5149;16189
261320;201704;5837;17618;5329;16728;182;744;4326;13380;4508;14124
261330;201704;5673;15499;5316;15040;289;1107;4512;12492;4801;13599
261340;201704;3912;12786;3654;12367;322;1381;2580;8634;2902;10015
261350;201704;8110;25928;7628;25113;239;1265;6234;20016;6473;21281
261360;201704;8178;21155;7216;19844;501;1437;5681;15408;6182;16845
261370;201704;19005;55656;17808;53719;3508;11156;10056;30357;13564;41513
261380;201704;4071;13667;3771;13036;515;2038;2421;8256;2936;10294
261390;201704;16172;48612;14552;45862;1910;6594;8831;27902;10741;34496
261400;201704;4662;15834;4144;14731;241;1077;2980;10437;3221;11514
261410;201704;8996;24331;7993;22781;559;1794;6371;18061;6930;19855
261420;201704;7311;24281;6980;23836;1371;5279;4318;14571;5689;19850
261430;201704;3445;10387;2964;9662;185;635;2339;7692;2524;8327
261440;201704;1557;4880;1392;4594;54;283;1065;3427;1119;3710
261450;201704;13992;39576;13440;38891;308;1241;11953;34342;12261;35583
261460;201704;7022;20416;6556;19771;327;1078;5654;17041;5981;18119
261470;201704;4056;10903;3733;10469;69;272;3181;8986;3250;9258
261480;201704;3907;13433;3552;12816;249;1073;2679;9466;2928;10539
261485;201704;4932;14919;4379;13980;574;2124;2733;8589;3307;10713
261500;201704;5467;15211;4890;14441;469;1352;3534;10725;4003;12077
261510;201704;1856;5871;1674;5549;120;460;1236;4118;1356;4578
261520;201704;2710;8575;2561;8308;115;420;1681;5762;1796;6182
261530;201704;10790;34685;9762;32600;1743;6596;4547;15075;6290;21671
261540;201704;7011;22365;6556;21563;1436;4799;3706;12481;5142;17280
261550;201704;3484;9627;3239;9276;224;808;2467;6894;2691;7702
261560;201704;7335;23486;6609;22500;705;2892;4874;16578;5579;19470
261570;201704;3397;9974;2947;9229;309;1093;1890;5854;2199;6947
261580;201704;6118;18100;5546;17207;247;1079;4701;14358;4948;15437
261590;201704;2487;6908;2119;6336;148;454;1579;4752;1727;5206
261600;201704;5235;14039;4488;12969;278;891;3383;9780;3661;10671
261610;201704;2443;6787;2118;6310;66;246;1736;5185;1802;5431
261618;201704;2467;6736;2239;6436;144;474;1762;4964;1906;5438
261620;201704;3935;12162;3693;11757;787;2428;2251;7417;3038;9845
261630;201704;7458;21530;6302;19372;662;2457;3760;11230;4422;13687
261640;201704;34957;85221;32741;82623;1987;4551;26677;70216;28664;74767
261650;201704;3822;11033;3540;10663;216;825;2658;8086;2874;8911
270010;201704;4306;15726;3959;15054;268;1365;3017;11318;3285;12683
270020;201704;3904;10710;3607;10290;294;988;2904;8088;3198;9076
270030;201704;36722;108140;33898;103484;6666;20858;19713;60711;26379;81569
270040;201704;10692;31826;9831;30699;1234;4175;7006;22049;8240;26224
270050;201704;4501;11954;4068;11446;292;876;3413;9692;3705;10568
270060;201704;1917;5481;1763;5279;242;744;1229;3754;1471;4498
270070;201704;4424;13293;4036;12764;187;879;3401;10499;3588;11378
270080;201704;1275;3956;1102;3623;130;460;734;2369;864;2829
270090;201704;2133;6566;1924;6164;98;468;1514;4651;1612;5119
270100;201704;5650;16804;5288;16225;496;1807;4020;12135;4516;13942
270110;201704;2953;8216;2639;7863;293;923;1940;5985;2233;6908
270120;201704;3091;8476;2733;8027;79;316;2446;7152;2525;7468
270130;201704;5198;15343;4781;14881;512;1719;3727;11776;4239;13495
270135;201704;1812;4820;1617;4583;148;304;1357;4002;1505;4306
270140;201704;10596;24435;8934;22317;539;2102;7291;17209;7830;19311
270150;201704;2673;8498;2598;8411;42;148;2522;8177;2564;8325
270160;201704;4898;16097;4524;15625;157;775;3894;13309;4051;14084
270170;201704;3692;11642;3383;11215;439;1776;2245;7264;2684;9040
270180;201704;2291;7354;2109;7097;100;486;1759;5793;1859;6279
270190;201704;1732;5580;1641;5463;81;303;1383;4649;1464;4952
270200;201704;2515;8252;2342;7999;191;828;1743;5770;1934;6598
270210;201704;4847;13763;4510;13315;318;1037;3796;11177;4114;12214
270220;201704;1265;4077;1170;3908;244;901;653;2141;897;3042
270230;201704;10637;32703;9257;30530;1051;4250;5675;18140;6726;22390
270235;201704;6140;19630;5742;19005;308;1313;4706;15435;5014;16748
270240;201704;9647;28581;8184;26683;1777;6164;4485;14912;6262;21076
270250;201704;3126;8194;2827;7819;391;1051;2127;5970;2518;7021
270255;201704;4795;14432;3885;12763;267;1130;2743;8797;3010;9927
270260;201704;5875;18329;5655;18016;329;1433;4808;14894;5137;16327
270270;201704;1151;3198;1060;3075;185;554;645;1847;830;2401
270280;201704;3490;9649;3020;8990;382;971;2092;6394;2474;7365
270290;201704;7918;26819;7398;25928;486;2314;5936;20412;6422;22726
270300;201704;3703;11468;3324;11017;321;1212;2480;8200;2801;9412
270310;201704;7451;22138;6552;20821;245;1241;5393;16672;5638;17913
270320;201704;5807;17703;5435;17103;733;2531;3767;11708;4500;14239
270330;201704;4138;14007;3851;13623;364;1403;2991;10691;3355;12094
270340;201704;1641;4918;1445;4653;103;411;1150;3612;1253;4023
270350;201704;1910;4976;1695;4698;153;462;1225;3419;1378;3881
270360;201704;2085;6228;1986;6117;152;443;1706;5374;1858;5817
270370;201704;1439;4706;1311;4489;100;429;957;3256;1057;3685
270375;201704;2938;7819;2595;7371;68;216;2305;6542;2373;6758
270380;201704;5759;17398;5338;16829;415;1332;4151;13368;4566;14700
270390;201704;1255;3401;1084;3149;54;190;827;2344;881;2534
270400;201704;6358;18711;5678;17718;315;1271;4205;12780;4520;14051
270410;201704;4737;14726;4327;13982;360;1368;3126;9946;3486;11314
270420;201704;5935;18478;5659;18113;284;1284;4605;14403;4889;15687
270430;201704;136412;383126;118945;357636;34078;108480;42059;131669;76137;240149
270440;201704;4606;13653;4224;13138;163;703;3453;10674;3616;11377
270450;201704;6285;18921;5944;18467;342;1433;4869;14880;5211;16313
270460;201704;3429;8794;3113;8420;103;360;2735;7266;2838;7626
270470;201704;10226;32068;9397;30761;1036;3913;6428;21123;7464;25036
270480;201704;2844;8516;2484;7902;303;1122;1699;5222;2002;6344
270490;201704;981;3017;891;2896;54;211;689;2222;743;2433
270500;201704;4890;16098;4563;15700;251;1179;3808;12960;4059;14139
270510;201704;6061;17317;5424;16433;578;2293;4109;11996;4687;14289
270520;201704;3483;10930;3154;10357;1045;3694;1033;3589;2078;7283
270530;201704;1301;3999;1210;3863;104;342;862;2796;966;3138
270540;201704;2012;6545;1862;6332;97;499;1546;5095;1643;5594
270550;201704;6742;19738;6087;18927;705;2301;4455;14162;5160;16463
270560;201704;3151;9231;2912;8872;210;796;2215;6628;2425;7424
270570;201704;3723;11897;3378;11304;208;906;2666;8743;2874;9649
270580;201704;2099;6225;1980;6064;108;334;1693;5256;1801;5590
270590;201704;1381;4440;1339;4385;6;22;1318;4327;1324;4349
270600;201704;2869;9292;2603;8849;161;780;2126;7062;2287;7842
270610;201704;3320;9927;3056;9550;145;572;2600;8010;2745;8582
270620;201704;1384;4503;1289;4340;79;353;1046;3405;1125;3758
270630;201704;15926;46045;14489;43758;1697;5369;10218;31239;11915;36608
270640;201704;5726;17347;5131;16418;304;1291;4101;12852;4405;14143
270642;201704;2364;8139;2200;7907;197;981;1719;5991;1916;6972
270644;201704;2799;8019;2433;7511;250;799;1774;5607;2024;6406
270650;201704;3657;11250;3455;10974;428;1979;2512;7493;2940;9472
270660;201704;2140;5461;1678;4814;78;326;1223;3455;1301;3781
270670;201704;16703;41895;14468;39380;1553;4220;10844;30229;12397;34449
270680;201704;4382;12333;4165;12092;94;250;3922;11465;4016;11715
270690;201704;9299;24625;8258;23468;2066;5429;5034;15267;7100;20696
270700;201704;578;1834;516;1729;73;311;342;1093;415;1404
270710;201704;5975;18577;5634;18141;359;1513;4679;14793;5038;16306
270720;201704;3466;11280;3110;10655;123;713;2559;8537;2682;9250
270730;201704;6457;18026;6040;17564;410;1244;5164;15182;5574;16426
270740;201704;2335;6543;2182;6313;154;551;1796;5134;1950;5685
270750;201704;5246;15638;4817;14970;572;1992;3501;10829;4073;12821
270760;201704;3515;10229;3146;9644;132;521;2555;7732;2687;8253
270770;201704;19169;49848;15976;46003;3105;8738;9355;28581;12460;37319
270780;201704;1798;5637;1713;5507;182;658;1288;4131;1470;4789
270790;201704;1588;4930;1464;4748;301;1029;873;2833;1174;3862
270800;201704;11076;32230;10291;31178;535;2241;8766;26007;9301;28248
270810;201704;3206;9662;2569;8494;237;917;1715;5653;1952;6570
270820;201704;1762;5590;1555;5245;231;901;1006;3341;1237;4242
270830;201704;5566;14475;4949;13751;346;938;4011;11557;4357;12495
270840;201704;7890;24709;7247;23858;305;1619;6233;19957;6538;21576
270850;201704;7652;22624;7235;22079;704;2888;5484;15897;6188;18785
270860;201704;11265;30611;9471;28374;997;3520;6613;19426;7610;22946
270870;201704;2220;6574;1877;5886;201;666;1247;3884;1448;4550
270880;201704;8264;25823;7650;24916;419;1755;6240;20064;6659;21819
270890;201704;2425;7271;2251;6972;230;850;1644;4949;1874;5799
270895;201704;2929;10355;2821;10198;129;660;2448;8719;2577;9379
270900;201704;1798;4890;1487;4428;88;288;1140;3313;1228;3601
270910;201704;3603;11462;3298;10928;203;929;2509;8122;2712;9051
270915;201704;9384;30566;8397;28825;1169;4711;5150;17283;6319;21994
270920;201704;6226;19197;5916;18765;298;1451;5121;15781;5419;17232
270930;201704;16499;43739;14050;40796;2677;7564;8682;26286;11359;33850
270940;201704;5481;17739;5163;17403;432;2023;3833;12590;4265;14613
280010;201704;680;1920;588;1761;39;183;411;1118;450;1301
280020;201704;4847;13574;4234;12579;553;1759;2767;8166;3320;9925
280030;201704;73346;189075;62295;172875;17297;49709;23359;67996;40656;117705
280040;201704;3124;9248;2795;8757;286;1003;2004;6182;2290;7185
280050;201704;3677;11530;3395;11046;860;2981;1692;5536;2552;8517
280060;201704;5018;15247;4296;14008;815;2882;2166;7218;2981;10100
280067;201704;7008;19474;6100;18031;837;2521;3789;11245;4626;13766
280070;201704;1920;6154;1844;6037;164;556;1480;4849;1644;5405
280100;201704;3772;11454;3395;10806;441;1562;2285;7278;2726;8840
280110;201704;1367;4046;1255;3876;54;211;1048;3184;1102;3395
280120;201704;7852;24091;7122;22876;1021;3112;4998;16589;6019;19701
280130;201704;7893;20836;7321;20010;826;2503;5334;14587;6160;17090
280140;201704;5828;15103;5341;14416;382;1058;4333;11748;4715;12806
280150;201704;3553;10229;3325;9877;218;803;2613;7628;2831;8431
280160;201704;1320;3855;1123;3520;176;597;683;2109;859;2706
280170;201704;4852;14080;4419;13438;359;1101;3446;10634;3805;11735
280190;201704;1206;3052;1030;2786;73;247;801;2083;874;2330
280200;201704;1201;3517;1082;3335;100;362;781;2351;881;2713
280210;201704;14373;40534;12798;38379;2226;7194;7346;22336;9572;29530
280220;201704;1690;4872;1550;4660;74;255;1291;3859;1365;4114
280230;201704;3255;9541;2960;9081;323;1081;2064;6352;2387;7433
280240;201704;3485;9690;3149;9169;139;514;2572;7350;2711;7864
280250;201704;841;2207;674;1935;109;332;341;962;450;1294
280260;201704;2131;5456;1991;5292;62;186;1834;4878;1896;5064
280270;201704;2161;6612;1979;6336;104;384;1634;5161;1738;5545
280280;201704;4130;13326;3737;12678;697;2015;2252;8256;2949;10271
280290;201704;17528;51658;15791;48981;1847;6531;10094;31387;11941;37918
280300;201704;9757;28704;9074;27885;642;2264;6957;22229;7599;24493
280310;201704;1393;3826;1189;3480;41;171;875;2484;916;2655
280320;201704;8649;26626;7932;25477;1234;4383;4641;14806;5875;19189
280330;201704;4571;12546;4131;11838;381;1289;3146;8705;3527;9994
280340;201704;4061;10603;3798;10254;322;857;3055;8509;3377;9366
280350;201704;22364;60897;19717;57023;2664;8231;12970;37726;15634;45957
280360;201704;5707;17423;5249;16635;919;3213;3005;9398;3924;12611
280370;201704;1869;5066;1593;4617;161;432;1125;3285;1286;3717
280380;201704;1054;3161;947;2984;109;421;648;1982;757;2403
280390;201704;3095;8943;2652;8110;219;766;1842;5598;2061;6364
280400;201704;4105;11389;3726;10836;918;2645;1911;5792;2829;8437
280410;201704;2123;6659;1820;6062;203;753;1078;3493;1281;4246
280420;201704;4259;11998;3893;11438;196;586;3327;9841;3523;10427
280430;201704;2234;5689;1997;5354;103;391;1533;4020;1636;4411
280440;201704;4663;13225;4238;12685;308;1031;3380;9995;3688;11026
280445;201704;2451;6553;2233;6176;60;207;1757;4735;1817;4942
280450;201704;9311;23876;8583;22935;521;1159;7253;19917;7774;21076
280460;201704;6881;17393;6279;16544;732;1963;4706;12518;5438;14481
280470;201704;1843;5403;1633;5042;96;312;1216;3757;1312;4069
280480;201704;33029;91694;30729;88378;4051;13262;20871;58917;24922;72179
280490;201704;3853;11419;3392;10667;210;833;2524;7784;2734;8617
280500;201704;938;2453;828;2308;41;123;673;1871;714;1994
280510;201704;2514;7370;2249;6998;152;591;1647;5096;1799;5687
280520;201704;1769;4688;1605;4482;107;301;1351;3793;1458;4094
280530;201704;2488;6523;2280;6260;132;414;1883;5184;2015;5598
280540;201704;9356;25384;8606;24309;234;1035;7522;20693;7756;21728
280550;201704;6943;17455;5732;15644;435;1182;4134;11242;4569;12424
280560;201704;7462;21698;7041;21099;304;1169;6007;17704;6311;18873
280570;201704;6329;16932;5432;15728;471;1582;3781;10835;4252;12417
280580;201704;5392;16453;4653;15120;679;2223;2909;9687;3588;11910
280590;201704;2670;7261;2344;6855;211;820;1579;4506;1790;5326
280600;201704;3492;10424;3231;10036;259;947;2453;7538;2712;8485
280610;201704;2465;6722;2248;6411;170;576;1692;4725;1862;5301
280620;201704;5398;15171;4728;14083;530;1513;3244;10045;3774;11558
280630;201704;3631;11614;3386;11248;285;957;2650;9008;2935;9965
280640;201704;2215;6616;2094;6483;68;198;1946;6076;2014;6274
280650;201704;1093;3312;990;3147;111;380;692;2178;803;2558
280660;201704;2691;7363;2550;7200;227;649;2121;6017;2348;6666
280670;201704;17014;43061;15499;41050;1668;4828;11153;29278;12821;34106
280680;201704;2873;7526;2475;6900;167;478;1873;5128;2040;5606
280690;201704;974;2655;874;2519;85;271;640;1823;725;2094
280700;201704;1032;3034;939;2864;50;168;689;2075;739;2243
280710;201704;12777;31601;11436;30044;607;1254;9893;26695;10500;27949
280720;201704;2417;6136;2190;5873;193;546;1511;4295;1704;4841
280730;201704;1024;2800;943;2681;59;216;777;2160;836;2376
280740;201704;13317;35012;11439;32090;1256;3567;7502;21245;8758;24812
280750;201704;3455;10242;3172;9775;237;828;2286;7036;2523;7864
280760;201704;5747;17067;5258;16324;777;2580;3236;10295;4013;12875
290010;201704;2785;6308;2070;5199;51;216;1655;3952;1706;4168
290020;201704;4377;14148;4240;13971;331;1034;3572;11907;3903;12941
290030;201704;3277;9596;3068;9319;322;997;2401;7331;2723;8328
290035;201704;4569;11374;3991;10587;201;624;3157;8515;3358;9139
290040;201704;4195;10894;3548;10167;195;787;2741;7844;2936;8631
290050;201704;2382;7730;2100;7230;143;612;1506;5130;1649;5742
290060;201704;1288;3247;1074;2977;128;437;754;2000;882;2437
290070;201704;33381;81792;28818;75993;4627;12500;16194;44265;20821;56765
290080;201704;5935;17417;5045;16185;660;2215;3375;11090;4035;13305
290090;201704;2113;4465;1740;4063;66;137;1562;3680;1628;3817
290100;201704;9160;25926;8136;24318;1075;3179;5232;16087;6307;19266
290110;201704;4958;14230;4690;13764;628;1981;3076;8935;3704;10916
290115;201704;4638;13709;4144;13055;192;582;3503;11273;3695;11855
290120;201704;6850;17479;5668;16077;253;912;4614;12902;4867;13814
290130;201704;4659;11986;3789;10905;154;620;3017;8448;3171;9068
290135;201704;4652;11239;3865;10022;269;805;2826;7067;3095;7872
290140;201704;4500;13044;3787;12118;205;777;3170;10174;3375;10951
290150;201704;2188;6465;2081;6309;218;706;1592;4733;1810;5439
290160;201704;3362;8341;3180;8114;248;576;2625;6696;2873;7272
290170;201704;2602;8365;2438;8149;143;626;2084;6860;2227;7486
290180;201704;2938;8364;2511;7704;134;513;1964;5982;2098;6495
290190;201704;3811;12385;3635;12127;221;970;2841;9377;3062;10347
290195;201704;2202;5883;1839;5313;75;324;1480;4197;1555;4521
290200;201704;3943;11888;3454;11156;208;740;2732;8767;2940;9507
290205;201704;3359;9292;3004;8727;162;619;2300;6512;2462;7131
290210;201704;14536;40950;13071;39055;1495;3916;9596;30108;11091;34024
290220;201704;2423;6898;2296;6711;200;648;1804;5223;2004;5871
290225;201704;3061;7175;2712;6779;69;162;2511;6299;2580;6461
290230;201704;2232;7044;2096;6883;108;450;1760;5773;1868;6223
290240;201704;3544;9647;3199;9140;197;627;2526;7117;2723;7744
290250;201704;3890;11854;3610;11483;115;315;3099;10347;3214;10662
290260;201704;5185;14271;4279;12915;299;1047;3258;9787;3557;10834
290265;201704;3507;10607;3023;9741;146;624;2316;7360;2462;7984
290270;201704;12059;42879;11530;42042;1032;4397;8749;31714;9781;36111
290280;201704;5626;17596;5176;16882;366;1314;3874;12649;4240;13963
290290;201704;9982;30331;8759;28297;958;3199;6116;19946;7074;23145
290300;201704;4599;12820;3333;10453;214;740;2309;7354;2523;8094
290310;201704;1494;4344;1289;4018;161;545;820;2543;981;3088
290320;201704;28159;78212;23851;72807;4899;15954;12635;39683;17534;55637
290323;201704;3759;10257;3386;9800;115;407;2859;8168;2974;8575
290327;201704;4548;13341;3900;12185;401;1267;2631;8237;3032;9504
290330;201704;1927;4513;1748;4325;88;213;1553;3904;1641;4117
290340;201704;5157;15323;4723;14801;1046;3398;2916;9270;3962;12668
290350;201704;4527;14219;4020;13401;341;1180;2911;9941;3252;11121
290360;201704;4754;13850;4101;12963;137;557;3418;10885;3555;11442
290370;201704;4741;12741;3999;11722;239;683;3193;9459;3432;10142
290380;201704;5574;15989;4884;14957;266;891;3892;12089;4158;12980
290390;201704;15132;44756;13460;42284;1689;5541;8777;28313;10466;33854
290395;201704;2623;8441;2332;7884;99;474;1785;6011;1884;6485
290400;201704;3718;10594;3089;9613;211;733;2231;6846;2442;7579
290405;201704;4815;14652;4064;13281;347;1234;2654;8739;3001;9973
290410;201704;5840;16979;4786;15271;303;1224;3440;10622;3743;11846
290420;201704;3230;9167;2675;8344;215;710;2034;6384;2249;7094
290430;201704;3170;9598;2771;8891;420;1385;1710;5582;2130;6967
290440;201704;3003;7760;2355;6834;124;402;1779;5225;1903;5627
290450;201704;3230;9230;2743;8507;161;639;2049;6221;2210;6860
290460;201704;12482;35735;11182;33491;3220;9978;4103;12284;7323;22262
290470;201704;4120;11562;3197;10110;638;2265;1466;4782;2104;7047
290475;201704;5809;18030;5121;16787;172;865;4004;12834;4176;13699
290480;201704;2359;6399;2200;6167;215;619;1510;4425;1725;5044
290485;201704;4769;14820;4146;13875;227;1117;3369;11076;3596;12193
290490;201704;8410;21447;7917;20827;536;1640;6554;16972;7090;18612
290500;201704;4027;12491;3282;10988;451;1651;1748;5814;2199;7465
290510;201704;3179;8938;2839;8473;118;461;2403;7120;2521;7581
290515;201704;3644;9934;3042;9155;121;341;2595;7972;2716;8313
290520;201704;11391;34564;9196;30234;559;2287;5787;18739;6346;21026
290530;201704;5147;15034;4524;14035;278;927;3644;11291;3922;12218
290540;201704;3691;10616;3453;10240;204;654;2841;8413;3045;9067
290550;201704;4544;11704;4060;11160;77;257;3747;10351;3824;10608
290560;201704;6400;17903;5593;16744;805;2608;3785;11248;4590;13856
290570;201704;42620;113694;39275;109291;3293;9592;29299;81398;32592;90990
290580;201704;7003;23141;6544;22413;639;2313;4928;17171;5567;19484
290590;201704;7154;22619;6229;20992;249;1074;5079;17117;5328;18191
290600;201704;17802;52266;16480;50409;1381;4344;12842;40113;14223;44457
290610;201704;2456;8137;2023;7302;109;514;1419;5013;1528;5527
290620;201704;6256;18630;5715;17750;318;1076;4714;14538;5032;15614
290630;201704;8301;21040;7196;19791;474;1337;6033;16714;6507;18051
290640;201704;2654;7488;2168;6728;111;438;1675;5108;1786;5546
290650;201704;10782;30972;10221;30205;2303;6735;6053;18497;8356;25232
290660;201704;3676;9866;3151;9101;127;383;2330;7021;2457;7404
290670;201704;7019;20884;6225;19576;590;1932;4437;14126;5027;16058
290680;201704;10154;29964;9082;28533;354;1652;7303;22491;7657;24143
290682;201704;4688;13015;4097;12173;184;689;3400;9974;3584;10663
290685;201704;3664;8618;2440;6907;241;700;1572;4564;1813;5264
290687;201704;7110;20440;5689;18087;1136;3694;2880;9547;4016;13241
290689;201704;3065;8775;2716;8251;223;769;1967;6140;2190;6909
290690;201704;5494;15253;4799;14334;688;2031;3133;9465;3821;11496
290700;201704;2456;7228;2300;7004;111;384;1907;5823;2018;6207
290710;201704;7652;23843;7102;23036;464;1554;5809;18966;6273;20520
290720;201704;18639;53494;17289;51821;1079;3195;14360;43885;15439;47080
290730;201704;7151;19156;6400;18165;442;1281;4851;13799;5293;15080
290740;201704;910;2653;723;2327;44;166;533;1707;577;1873
290750;201704;10603;28899;9158;26274;1280;4000;5490;15367;6770;19367
290755;201704;2308;6523;1829;5657;114;425;1275;3881;1389;4306
290760;201704;4115;12333;3324;10819;429;1278;1930;6561;2359;7839
290770;201704;2538;8688;2366;8461;104;514;1913;6857;2017;7371
290780;201704;9049;22444;7815;20685;638;1321;5985;16365;6623;17686
290790;201704;4495;12996;4119;12492;225;641;3512;10739;3737;11380
290800;201704;7142;14887;5603;13227;362;682;4402;10797;4764;11479
290810;201704;5458;16159;4536;14651;200;754;3376;10957;3576;11711
290820;201704;5374;14924;4848;14202;357;1199;3648;10752;4005;11951
290830;201704;4486;11338;4140;10870;173;583;3244;8387;3417;8970
290840;201704;17270;48676;15248;45603;1832;5214;10088;31508;11920;36722
290850;201704;6136;17116;5851;16765;671;1719;4399;13104;5070;14823
290860;201704;5262;17115;4884;16664;339;1265;3949;13772;4288;15037
290870;201704;4749;13633;3812;12055;205;832;2700;8499;2905;9331
290880;201704;1435;3787;1147;3345;86;224;792;2365;878;2589
290890;201704;7289;17933;6241;16769;328;847;5469;14824;5797;15671
290900;201704;2343;6592;1818;5659;149;521;1126;3472;1275;3993
290910;201704;4981;13231;4106;11944;76;318;3476;10011;3552;10329
290920;201704;5034;13169;4645;12672;179;526;4060;11024;4239;11550
290930;201704;8261;24051;7069;22193;272;1234;5619;17278;5891;18512
290940;201704;3629;11057;3193;10419;140;474;2453;8172;2593;8646
290950;201704;1578;4278;1376;3965;112;341;957;2776;1069;3117
290960;201704;5663;15744;5110;15053;170;567;4308;12739;4478;13306
290970;201704;3756;11252;3237;10414;241;797;2270;7358;2511;8155
290980;201704;10449;29159;8909;26310;2262;6959;3011;8951;5273;15910
290990;201704;8990;26247;7748;24175;603;2202;5818;17799;6421;20001
291000;201704;3107;8913;2786;8532;242;705;2289;7103;2531;7808
291005;201704;14639;36966;12944;34842;1090;2996;9788;26682;10878;29678
291010;201704;3261;9928;2574;8498;207;706;1678;5577;1885;6283
291020;201704;1262;3322;1026;2900;72;220;616;1652;688;1872
291030;201704;2341;6206;1686;4916;118;382;1036;2910;1154;3292
291040;201704;5568;16235;4886;15219;284;1158;3825;11852;4109;13010
291050;201704;7716;24379;7038;23182;1361;5041;4071;13094;5432;18135
291060;201704;5960;21468;5590;20862;786;3381;3668;13487;4454;16868
291070;201704;16051;45286;14008;42231;680;2523;11036;33002;11716;35525
291072;201704;23592;68199;18958;58926;4451;14856;6582;20753;11033;35609
291075;201704;4997;13941;4434;13061;289;752;3362;9980;3651;10732
291077;201704;1485;4169;1230;3733;61;212;888;2684;949;2896
291080;201704;77459;237183;68922;221611;24219;79452;12141;40253;36360;119705
291085;201704;5655;14762;4852;13668;283;906;4005;11273;4288;12179
291090;201704;1735;3829;1516;3579;99;154;1283;3097;1382;3251
291100;201704;2655;6601;2111;5969;121;452;1629;4501;1750;4953
291110;201704;5339;17903;4759;17007;504;2049;3445;12038;3949;14087
291120;201704;7373;19471;6743;18537;621;1752;4977;13728;5598;15480
291125;201704;1916;3754;1499;3308;51;131;1247;2745;1298;2876
291130;201704;2838;8758;2375;7904;92;443;1781;5767;1873;6210
291140;201704;4231;12347;3564;11070;471;1362;2219;7014;2690;8376
291150;201704;2076;5092;1903;4895;62;207;1602;4048;1664;4255
291160;201704;4972;15636;4420;14677;592;2212;2707;8824;3299;11036
291165;201704;2489;6912;1946;5908;43;185;1401;4156;1444;4341
291170;201704;21111;55170;18155;50694;1383;4249;11545;32311;12928;36560
291180;201704;6029;15695;5000;14078;346;1043;3663;10326;4009;11369
291185;201704;3516;9605;3110;8941;134;422;2532;7188;2666;7610
291190;201704;7287;19231;6354;17920;429;1445;5112;14254;5541;15699
291200;201704;2937;8602;2295;7382;108;373;1469;4734;1577;5107
291210;201704;6671;16086;5698;14927;226;809;4374;11322;4600;12131
291220;201704;4257;12821;3882;12224;468;1709;2603;8034;3071;9743
291230;201704;3973;9837;3570;9394;75;146;3358;8931;3433;9077
291240;201704;4492;11957;3933;10984;120;401;3267;8970;3387;9371
291250;201704;3418;10420;2755;9174;210;709;1850;6243;2060;6952
291260;201704;1075;3009;966;2869;50;230;818;2337;868;2567
291270;201704;4704;14452;4144;13425;940;3142;2271;7464;3211;10606
291280;201704;2230;6319;1788;5552;302;1017;964;2932;1266;3949
291290;201704;5618;15483;4811;14385;700;2155;3033;9283;3733;11438
291300;201704;4110;11685;3159;10034;159;582;2259;7100;2418;7682
291310;201704;5390;15063;4693;13811;238;800;3633;10620;3871;11420
291320;201704;6039;18458;4855;16134;1228;4034;2146;7407;3374;11441
291330;201704;1610;4697;1414;4357;95;324;1008;3069;1103;3393
291340;201704;3899;10618;3263;9696;101;382;2668;7844;2769;8226
291345;201704;3271;10279;3048;9997;180;623;2504;8367;2684;8990
291350;201704;5631;16371;4938;15197;296;936;3796;11904;4092;12840
291360;201704;33324;88065;28477;81492;5880;17137;14939;44147;20819;61284
291370;201704;8108;22858;7626;22234;515;1707;5883;17102;6398;18809
291380;201704;3628;10738;3158;10000;152;598;2414;7654;2566;8252
291390;201704;10565;27442;9790;26526;742;2194;7814;21162;8556;23356
291400;201704;14333;38604;12435;35769;1997;5291;7915;24014;9912;29305
291410;201704;3056;8154;2372;7014;104;464;1750;4974;1854;5438
291420;201704;2005;5280;1699;4897;61;229;1429;4081;1490;4310
291430;201704;3238;9101;2835;8525;135;632;2296;6660;2431;7292
291440;201704;6418;19155;5614;17774;500;1660;4255;13562;4755;15222
291450;201704;8459;23735;7296;22212;276;773;5925;18787;6201;19560
291460;201704;13184;39100;11859;37096;1231;4276;8049;25350;9280;29626
291465;201704;7973;22327;6966;21155;358;1529;5731;17109;6089;18638
291470;201704;15562;40799;13723;38639;790;2279;10442;30264;11232;32543
291480;201704;35808;87094;29201;78316;3759;11030;16557;44872;20316;55902
291490;201704;4254;13311;3971;12919;503;1667;2818;9310;3321;10977
291500;201704;4235;11896;3582;10919;162;636;2931;8881;3093;9517
291510;201704;3755;10877;3375;10334;80;335;2857;8816;2937;9151
291520;201704;3884;10285;3338;9547;268;868;2352;6730;2620;7598
291530;201704;2141;5667;1706;5030;356;990;915;2971;1271;3961
291535;201704;3558;10831;3282;10385;217;723;2513;8043;2730;8766
291540;201704;2053;4952;1729;4602;111;268;1483;3940;1594;4208
291550;201704;5152;13266;4464;12314;672;1746;2756;7787;3428;9533
291560;201704;18536;43391;13242;37137;824;2355;9176;27099;10000;29454
291570;201704;2167;5544;1937;5269;147;301;1600;4518;1747;4819
291580;201704;5380;15917;4745;15005;455;1736;3382;10657;3837;12393
291590;201704;1745;5383;1583;5123;144;509;1202;3929;1346;4438
291600;201704;5225;14048;3988;12059;830;2656;1938;5752;2768;8408
291610;201704;4737;14662;4579;14487;117;409;4234;13490;4351;13899
291620;201704;3043;7032;2237;6160;127;413;1722;4824;1849;5237
291630;201704;3158;7539;2552;6792;158;416;2016;5408;2174;5824
291640;201704;16272;43892;12885;38669;3169;9916;3684;11948;6853;21864
291650;201704;8373;23817;7677;22966;530;1376;6414;19524;6944;20900
291660;201704;2250;5691;1694;4828;149;523;1052;2820;1201;3343
291670;201704;1856;5088;1674;4837;99;279;1336;3924;1435;4203
291680;201704;3855;10952;3360;10115;484;1592;2166;6492;2650;8084
291685;201704;4873;12054;4011;10929;491;1223;2718;7725;3209;8948
291690;201704;3740;9814;2985;8571;170;485;2178;6180;2348;6665
291700;201704;9053;27538;8082;25811;778;2497;6015;19438;6793;21935
291710;201704;5183;13251;4149;11869;336;1017;2900;8248;3236;9265
291720;201704;4656;14648;3894;13083;280;1114;2765;9065;3045;10179
291730;201704;6223;17847;5631;17066;380;1315;4491;13707;4871;15022
291733;201704;2761;7651;2291;6992;147;491;1560;4910;1707;5401
291735;201704;2958;8015;2524;7393;111;396;2075;6021;2186;6417
291740;201704;3834;10520;3205;9668;167;556;2558;7710;2725;8266
291750;201704;21228;54195;16952;47627;2906;8463;9152;26363;12058;34826
291760;201704;10545;33219;9215;30888;3473;12873;2242;7691;5715;20564
291770;201704;7464;21317;6257;19158;722;2447;4083;12207;4805;14654
291780;201704;4476;13216;4160;12692;194;671;3484;10588;3678;11259
291790;201704;2664;7913;2524;7711;99;384;2114;6376;2213;6760
291800;201704;29914;79760;26074;74531;3421;9973;16839;49375;20260;59348
291810;201704;10738;28041;9074;26005;334;1190;7497;21325;7831;22515
291820;201704;3728;10755;3324;10148;179;619;2527;7740;2706;8359
291830;201704;4107;10737;3789;10273;291;784;3007;8277;3298;9061
291835;201704;6208;19336;5104;17265;1025;3560;2778;9706;3803;13266
291840;201704;47830;132813;41796;125734;5567;16745;28601;89157;34168;105902
291845;201704;2555;7382;2366;7125;123;343;2052;6277;2175;6620
291850;201704;4423;12727;3653;11477;331;967;2635;8587;2966;9554
291855;201704;1900;4388;1633;4062;114;347;1289;3135;1403;3482
291860;201704;2228;6116;1683;5055;50;188;1123;3232;1173;3420
291870;201704;1376;3646;973;2909;71;268;606;1727;677;1995
291875;201704;2840;8686;2518;8172;143;562;1781;5662;1924;6224
291880;201704;4958;15698;4550;14885;460;1535;3250;10660;3710;12195
291890;201704;1322;3254;1050;2910;222;501;655;1923;877;2424
291900;201704;1253;3298;972;2826;47;185;738;2099;785;2284
291905;201704;2754;7254;2093;6061;72;249;1548;4363;1620;4612
291910;201704;2772;7316;2353;6823;112;403;1970;5704;2082;6107
291915;201704;6968;21160;5861;19181;315;1209;4476;14722;4791;15931
291920;201704;24627;72579;22759;69952;2840;9947;15107;45884;17947;55831
291930;201704;2538;7421;2243;6936;175;667;1612;4846;1787;5513
291940;201704;3337;9288;2468;7787;263;870;1476;4551;1739;5421
291950;201704;8686;28144;7748;26344;1165;4033;4469;15645;5634;19678
291955;201704;11358;31668;10500;30603;2245;6369;6127;18917;8372;25286
291960;201704;3086;8846;2518;7972;188;618;1864;6113;2052;6731
291970;201704;3969;11834;3651;11290;320;1188;2518;7755;2838;8943
291980;201704;11530;32570;9050;29018;710;2407;6309;20505;7019;22912
291990;201704;2113;6280;1958;6088;76;283;1731;5421;1807;5704
291992;201704;2873;8562;2800;8447;344;1017;2169;6576;2513;7593
291995;201704;2129;5930;1775;5427;76;292;1418;4263;1494;4555
292000;201704;2364;6540;2133;6225;185;596;1483;4404;1668;5000
292010;201704;6113;15114;5052;13644;394;1043;3853;10524;4247;11567
292020;201704;4053;13304;3798;12876;405;1524;2833;9527;3238;11051
292030;201704;1785;5763;1666;5575;171;640;950;3085;1121;3725
292040;201704;4331;11484;3704;10796;198;461;3099;9463;3297;9924
292045;201704;3430;10330;3048;9806;115;340;2727;8850;2842;9190
292050;201704;6397;19087;5386;17090;466;1640;3394;10687;3860;12327
292060;201704;12673;30956;11658;29707;659;1724;9829;24769;10488;26493
292070;201704;5027;14702;4615;14222;351;1096;3825;11864;4176;12960
292080;201704;3419;8815;2794;8015;161;551;2369;6783;2530;7334
292090;201704;4029;10008;3369;9230;224;733;2719;7489;2943;8222
292100;201704;10473;28153;9137;26264;1879;5646;4614;13698;6493;19344
292105;201704;2995;9054;2702;8570;103;473;2192;6902;2295;7375
292110;201704;6345;16807;4918;14516;1289;3807;2199;6681;3488;10488
292120;201704;7077;19657;5862;17436;929;2748;3479;10521;4408;13269
292130;201704;2889;7910;2496;7358;328;925;1661;5060;1989;5985
292140;201704;4779;12540;3991;11362;435;1156;2897;8403;3332;9559
292145;201704;2251;6920;1983;6464;232;718;1354;4559;1586;5277
292150;201704;12770;37993;11875;36580;406;1663;9972;30478;10378;32141
292160;201704;2339;6784;2134;6517;85;339;1897;5754;1982;6093
292170;201704;8630;24268;7211;21830;760;2446;4719;14305;5479;16751
292180;201704;3049;8575;2353;7392;483;1479;1156;3729;1639;5208
292190;201704;3139;8893;2661;8128;488;1605;1375;4266;1863;5871
292200;201704;6828;20195;5794;18436;1443;4777;2454;8026;3897;12803
292205;201704;3809;11285;3424;10714;135;627;2863;8765;2998;9392
292210;201704;6408;16339;5418;15046;190;676;4676;12872;4866;13548
292220;201704;1812;4901;1630;4626;233;644;1039;2954;1272;3598
292225;201704;3197;9813;2903;9365;138;622;2383;7560;2521;8182
292230;201704;6866;18821;6450;18183;237;1010;5248;14335;5485;15345
292240;201704;4869;14615;4285;13415;361;1162;2890;9021;3251;10183
292250;201704;5100;15177;4769;14635;788;2502;2812;8740;3600;11242
292260;201704;3231;9187;2979;8852;174;512;2512;7553;2686;8065
292265;201704;3200;9476;2747;8716;105;484;2123;6555;2228;7039
292270;201704;3997;10075;3336;9289;184;573;2776;7788;2960;8361
292273;201704;2502;5882;2115;5400;126;243;1664;4409;1790;4652
292275;201704;1696;5044;1518;4783;108;276;1213;4016;1321;4292
292280;201704;2356;6214;1991;5790;109;288;1578;4787;1687;5075
292285;201704;2434;6485;2029;5901;129;420;1583;4591;1712;5011
292290;201704;6212;19270;5529;18217;337;1370;4292;14116;4629;15486
292300;201704;8485;24720;7331;23247;1680;5520;4074;13337;5754;18857
292303;201704;2876;8579;2590;8164;80;301;2225;6972;2305;7273
292305;201704;2818;7554;2651;7311;55;233;2389;6500;2444;6733
292310;201704;6097;17535;5621;16857;241;803;4600;13755;4841;14558
292320;201704;6850;18502;5722;16574;360;1133;4358;12459;4718;13592
292330;201704;2287;5822;2098;5572;119;380;1745;4556;1864;4936
292335;201704;5143;13291;4617;12580;309;772;3769;10443;4078;11215
292340;201704;6589;17743;5609;16174;302;883;4241;12191;4543;13074
292350;201704;2269;6572;1945;6116;99;389;1588;5000;1687;5389
292360;201704;5251;13565;4827;12865;331;947;3680;9939;4011;10886
292370;201704;8577;23343;7476;21894;432;1182;6180;18242;6612;19424
292380;201704;7226;20953;6590;19915;570;1635;4972;15171;5542;16806
292390;201704;3745;8068;3005;7264;132;252;2652;6507;2784;6759
292400;201704;20648;63834;18945;60991;2656;8662;12412;40465;15068;49127
292405;201704;4464;11029;3647;9945;217;563;2912;7993;3129;8556
292410;201704;2050;5337;1852;5105;104;288;1548;4285;1652;4573
292420;201704;3758;11852;3534;11509;216;952;2884;9283;3100;10235
292430;201704;5457;15863;4103;13930;363;1379;2652;9081;3015;10460
292440;201704;8437;27625;7843;26768;168;747;7162;24616;7330;25363
292450;201704;3965;11765;3239;10490;249;878;2340;7641;2589;8519
292460;201704;4531;13529;3965;12548;364;1264;2808;8887;3172;10151
292465;201704;2401;6946;2006;6323;154;516;1352;4345;1506;4861
292467;201704;1766;5583;1698;5478;236;774;1181;3904;1417;4678
292470;201704;2922;7588;2388;6727;101;309;1877;5278;1978;5587
292480;201704;6395;16150;5331;14792;125;439;4734;13020;4859;13459
292490;201704;2388;6359;1962;5747;135;426;1484;4374;1619;4800
292500;201704;6423;18756;5532;17170;672;2130;3615;11395;4287;13525
292510;201704;12649;35951;10761;33073;763;2878;7850;24171;8613;27049
292520;201704;6107;16439;5313;15251;966;2793;3153;9265;4119;12058
292525;201704;5287;13725;4538;12864;185;564;3879;11083;4064;11647
292530;201704;27119;76655;23922;72132;5558;17160;11648;36381;17206;53541
292540;201704;3092;7841;2736;7421;319;811;2119;5871;2438;6682
292550;201704;6726;20115;5710;18793;515;1942;4344;14526;4859;16468
292560;201704;4082;11251;3606;10515;180;748;2827;8107;3007;8855
292570;201704;4255;11594;3804;11057;80;238;3507;10312;3587;10550
292575;201704;6364;20469;6137;20144;320;1104;5226;17230;5546;18334
292580;201704;6791;19538;6256;18779;285;964;5314;15961;5599;16925
292590;201704;7549;21048;7030;20312;289;1007;6038;17106;6327;18113
292593;201704;2915;7507;2496;6839;255;679;1841;5013;2096;5692
292595;201704;5755;15638;5099;14789;267;915;4115;11855;4382;12770
292600;201704;10864;30413;9664;28809;700;1854;7489;22817;8189;24671
292610;201704;4711;12680;3859;11273;231;649;2513;7586;2744;8235
292620;201704;6259;18321;5508;17466;119;372;5103;16403;5222;16775
292630;201704;8971;22766;7450;20361;530;1528;5230;14388;5760;15916
292640;201704;7744;24579;7165;23639;337;1383;5436;17988;5773;19371
292650;201704;4465;11994;4152;11578;262;772;3554;9869;3816;10641
292660;201704;10933;32020;9913;30532;797;2685;7613;23547;8410;26232
292665;201704;2256;7078;2104;6886;26;107;1894;6267;1920;6374
292670;201704;3593;10023;2814;8607;187;670;1834;5580;2021;6250
292680;201704;3758;10717;3305;9910;266;812;2412;7153;2678;7965
292690;201704;2729;7390;1979;6177;158;489;1310;4225;1468;4714
292700;201704;9692;27654;8420;25859;967;2842;5582;17957;6549;20799
292710;201704;2188;7146;2041;6951;71;274;1808;6191;1879;6465
292720;201704;9436;23387;8156;21973;289;929;6921;18852;7210;19781
292730;201704;3708;10702;3554;10483;174;547;2964;8744;3138;9291
292740;201704;332863;877012;310957;843496;54915;157641;184722;495370;239637;653011
292750;201704;6505;17487;5605;16189;244;825;4391;12728;4635;13553
292760;201704;3901;11887;3532;11222;322;1131;2530;8007;2852;9138
292770;201704;5992;17146;5200;15964;884;2868;3128;9922;4012;12790
292780;201704;1825;4135;1419;3624;80;250;1072;2673;1152;2923
292790;201704;3513;8119;3297;7881;46;97;3192;7665;3238;7762
292800;201704;9512;26873;8715;25578;507;1631;6941;20281;7448;21912
292805;201704;3045;8351;2659;7801;234;694;1987;5889;2221;6583
292810;201704;9511;27401;7687;24749;691;2392;5361;17506;6052;19898
292820;201704;7583;21010;5629;18166;359;1504;4274;13640;4633;15144
292830;201704;2115;5595;1911;5325;58;257;1738;4746;1796;5003
292840;201704;8158;24016;7727;23431;254;1058;6831;20333;7085;21391
292850;201704;3083;8116;2477;7193;227;764;1599;4531;1826;5295
292860;201704;15353;38384;14043;36704;879;2314;11201;29312;12080;31626
292870;201704;18578;50192;16290;46643;1501;5039;10079;28245;11580;33284
292880;201704;11997;33792;10773;32087;630;2506;8008;23044;8638;25550
292890;201704;5392;17506;4842;16553;530;1955;3392;11622;3922;13577
292895;201704;2858;6745;2138;5640;151;401;1537;4063;1688;4464
292900;201704;2734;8190;2593;7960;141;642;2018;5920;2159;6562
292905;201704;4175;11954;3344;10644;299;943;2237;7268;2536;8211
292910;201704;4963;14398;4496;13566;504;1597;2803;8460;3307;10057
292920;201704;9643;27450;9197;26850;424;1622;7849;22444;8273;24066
292925;201704;5090;15122;4656;14480;265;872;3697;11515;3962;12387
292930;201704;6520;20424;6049;19540;424;1836;4202;13259;4626;15095
292935;201704;1971;5749;1645;5380;69;297;1398;4670;1467;4967
292937;201704;3053;7824;2654;7335;106;315;2224;6164;2330;6479
292940;201704;3099;8463;2575;7721;184;591;1879;5729;2063;6320
292950;201704;8437;23964;7784;22884;417;1567;5928;17054;6345;18621
292960;201704;5290;13163;4546;12193;220;706;3505;9278;3725;9984
292970;201704;4216;12299;3709;11628;193;769;2979;9326;3172;10095
292975;201704;3674;9301;3408;8978;280;628;2894;7722;3174;8350
292980;201704;3171;8295;2543;7333;166;549;1916;5420;2082;5969
292990;201704;11741;32841;10122;30398;404;1432;8130;24422;8534;25854
293000;201704;2846;7135;2584;6820;36;122;1956;5490;1992;5612
293010;201704;17555;47923;14912;43693;2025;6235;9094;26619;11119;32854
293015;201704;7402;24827;6326;22688;681;2809;4203;15040;4884;17849
293020;201704;8859;29103;8454;28524;269;1236;7446;24959;7715;26195
293030;201704;5576;15713;4435;13900;216;714;3031;9894;3247;10608
293040;201704;3720;11856;3539;11560;160;588;3072;10010;3232;10598
293050;201704;20817;55848;18402;52746;2848;8526;10475;31259;13323;39785
293060;201704;3564;9507;2953;8498;222;744;2128;6029;2350;6773
293070;201704;24169;63717;19798;57632;4285;12551;9215;28559;13500;41110
293075;201704;3228;10885;2995;10502;172;819;2371;8319;2543;9138
293076;201704;3692;9894;3271;9335;145;403;2635;7676;2780;8079
293077;201704;5137;15359;4460;14429;703;2363;2776;9264;3479;11627
293080;201704;4658;14296;4191;13561;161;741;3456;10979;3617;11720
293090;201704;3156;9927;2617;9060;212;783;1846;6516;2058;7299
293100;201704;5856;16744;4844;14946;433;1377;3526;10959;3959;12336
293105;201704;3920;12701;3432;11767;376;1344;2311;7995;2687;9339
293110;201704;2043;5602;1778;5230;74;235;1426;4198;1500;4433
293120;201704;3807;11944;3629;11670;212;662;3034;9847;3246;10509
293130;201704;3727;10845;3388;10444;105;397;2976;9202;3081;9599
293135;201704;31227;77864;23755;67232;5053;16215;9052;25909;14105;42124
293140;201704;2001;5368;1884;5207;101;366;1535;4093;1636;4459
293150;201704;5452;17564;4639;15988;587;2095;2971;10403;3558;12498
293160;201704;3789;9562;3391;9093;385;713;2650;7612;3035;8325
293170;201704;3414;9665;3121;9227;194;673;2290;6777;2484;7450
293180;201704;5050;14058;4136;12534;175;751;3259;9617;3434;10368
293190;201704;13801;40391;12472;38383;479;2165;10440;31597;10919;33762
293200;201704;7441;19803;6496;18585;222;870;4943;14229;5165;15099
293210;201704;5171;14416;4522;13350;255;854;3431;10073;3686;10927
293220;201704;4971;14433;4153;12931;1055;3269;1527;5005;2582;8274
293230;201704;3642;10840;3216;10145;428;1496;2134;6728;2562;8224
293240;201704;4287;11812;3477;10433;128;400;2595;7846;2723;8246
293245;201704;4262;11697;3806;11067;179;574;3146;9122;3325;9696
293250;201704;5598;14885;5007;13977;447;1293;3660;10155;4107;11448
293260;201704;4488;13019;3740;11881;203;729;2633;8294;2836;9023
293270;201704;5754;14843;5109;14124;381;983;4270;12062;4651;13045
293280;201704;5253;14306;4444;13217;214;648;3415;10242;3629;10890
293290;201704;13933;45627;12908;43736;3248;11202;5654;20141;8902;31343
293300;201704;6664;15699;5648;14458;371;888;4237;11040;4608;11928
293305;201704;4757;11718;4008;10731;124;410;3328;8871;3452;9281
293310;201704;2355;6140;1900;5357;172;490;1276;3572;1448;4062
293315;201704;4242;10542;3577;9552;221;562;2844;7616;3065;8178
293317;201704;2415;6701;2171;6272;166;454;1550;4518;1716;4972
293320;201704;7481;24033;7227;23716;1146;3698;5174;17424;6320;21122
293325;201704;1728;4882;1443;4421;230;763;920;2793;1150;3556
293330;201704;48058;155444;43547;147240;9834;34991;19833;68133;29667;103124
293340;201704;2514;7213;2022;6356;242;802;1203;3791;1445;4593
293345;201704;3234;9465;2844;8963;252;610;2157;7214;2409;7824
293350;201704;6436;18964;6095;18562;137;299;5619;17580;5756;17879
293360;201704;13319;38668;12046;37103;688;2388;10451;32199;11139;34587
310010;201704;779;2148;651;1954;85;326;304;854;389;1180
310020;201704;2523;7875;2112;7114;558;2100;269;857;827;2957
310030;201704;2143;6590;1795;6006;343;1324;1029;3359;1372;4683
310040;201704;983;2598;805;2345;67;255;614;1723;681;1978
310050;201704;1788;6031;1666;5776;334;1328;756;2504;1090;3832
310060;201704;3335;9907;2899;9340;207;845;2309;7399;2516;8244
310070;201704;359;965;268;798;11;45;173;479;184;524
310080;201704;730;2128;594;1892;106;404;215;653;321;1057
310090;201704;4707;13532;4018;12360;472;1600;2690;8248;3162;9848
310100;201704;3524;10380;2956;9479;142;546;2275;7282;2417;7828
310110;201704;4894;13563;4147;12277;655;2184;2183;6262;2838;8446
310120;201704;647;1889;481;1583;120;476;179;481;299;957
310130;201704;370;1113;323;1027;68;267;174;495;242;762
310140;201704;171;565;145;526;46;201;45;128;91;329
310150;201704;4594;13810;3888;12426;931;3232;1251;3897;2182;7129
310160;201704;6626;20859;5508;18706;1786;6518;789;2689;2575;9207
310163;201704;1074;3406;906;3069;309;1119;230;749;539;1868
310170;201704;8991;24657;7944;23169;876;2745;5641;16553;6517;19298
310180;201704;1746;4855;1464;4433;191;678;894;2614;1085;3292
310190;201704;2932;9459;2603;8886;700;2664;536;1840;1236;4504
310200;201704;1682;5461;1423;4895;281;1085;535;1797;816;2882
310205;201704;1132;3191;859;2780;124;382;473;1592;597;1974
310210;201704;2784;7679;2380;7101;152;528;1705;4987;1857;5515
310220;201704;1028;3023;885;2789;128;470;566;1712;694;2182
310230;201704;2455;7396;2059;6510;256;1001;1212;3613;1468;4614
310240;201704;893;3206;818;3057;103;464;501;1830;604;2294
310250;201704;850;2701;785;2582;145;583;457;1393;602;1976
310260;201704;2989;9350;2218;7797;522;2090;352;1054;874;3144
310270;201704;2633;7130;2116;6400;145;553;1655;4922;1800;5475
310280;201704;2313;5878;1837;5162;146;589;1173;3139;1319;3728
310285;201704;1975;6904;1825;6653;191;801;1260;4707;1451;5508
310290;201704;1118;3304;1036;3163;237;843;558;1552;795;2395
310300;201704;1634;5423;1550;5272;347;1373;771;2480;1118;3853
310310;201704;317;852;226;685;38;109;121;373;159;482
310320;201704;406;1232;324;1085;32;137;168;537;200;674
310330;201704;522;1294;340;953;45;139;120;291;165;430
310340;201704;8131;23733;6662;21195;1406;4489;3055;10189;4461;14678
310350;201704;13659;35357;9562;28622;2495;8180;2255;6658;4750;14838
310360;201704;441;1224;397;1162;22;87;309;878;331;965
310370;201704;1350;4481;1196;4179;252;899;568;2017;820;2916
310375;201704;1228;3326;823;2613;127;440;285;906;412;1346
310380;201704;368;932;220;676;58;186;63;178;121;364
310390;201704;450;1526;388;1400;93;345;89;278;182;623
310400;201704;9838;26763;7418;22767;1729;5871;2355;7078;4084;12949
310410;201704;684;2224;493;1899;120;510;100;371;220;881
310420;201704;4426;12390;3085;9650;635;2214;482;1292;1117;3506
310430;201704;1262;3984;907;3250;232;883;132;451;364;1334
310440;201704;523;1516;397;1262;70;258;169;536;239;794
310445;201704;1243;3933;1013;3503;68;281;706;2395;774;2676
310450;201704;4439;12156;3551;10825;316;1012;2527;7809;2843;8821
310460;201704;1658;4757;1284;4111;327;1150;346;1145;673;2295
310470;201704;4105;9114;3476;8366;239;655;2986;7155;3225;7810
310480;201704;1240;3547;930;2934;193;638;414;1248;607;1886
310490;201704;2952;9302;2506;8428;533;2104;1024;3303;1557;5407
310500;201704;1299;4262;1121;3911;268;1018;456;1558;724;2576
310510;201704;1879;5885;1478;5004;390;1438;263;890;653;2328
310520;201704;1415;3586;1063;3044;67;190;734;2086;801;2276
310530;201704;920;2695;482;1622;77;292;55;152;132;444
310540;201704;3064;9537;2663;8853;678;2406;1093;3505;1771;5911
310550;201704;1147;3169;924;2812;148;571;548;1562;696;2133
310560;201704;14245;42722;12038;38567;3048;10875;3804;11404;6852;22279
310570;201704;1172;3418;991;3109;129;524;671;2013;800;2537
310590;201704;4262;12247;3572;11007;526;1776;1878;5703;2404;7479
310600;201704;1446;4612;1226;4131;218;818;537;1713;755;2531
310610;201704;433;1369;359;1229;91;395;136;398;227;793
310620;201704;143422;428650;122141;387967;29329;104631;42342;122412;71671;227043
310630;201704;4353;12766;3877;11943;306;1057;2891;8830;3197;9887
310640;201704;1248;3818;1023;3427;284;1067;286;922;570;1989
310650;201704;2689;8192;2077;7110;276;1010;1153;3962;1429;4972
310660;201704;1334;3922;1166;3707;96;325;879;2781;975;3106
310665;201704;1304;3779;1148;3558;71;245;915;2889;986;3134
310670;201704;40455;121621;35923;112378;8296;27711;14823;45116;23119;72827
310680;201704;665;1828;589;1719;67;221;417;1202;484;1423
310690;201704;1310;4151;1091;3782;190;808;499;1634;689;2442
310700;201704;550;1320;429;1167;63;202;265;691;328;893
310710;201704;6122;19446;4645;17126;1080;4655;502;1705;1582;6360
310720;201704;816;2358;737;2243;57;201;547;1664;604;1865
310730;201704;9166;27763;8158;26060;1191;4248;4784;15122;5975;19370
310740;201704;5042;15719;3854;13258;855;3120;854;2894;1709;6014
310750;201704;1477;3666;1088;3139;221;682;430;1156;651;1838
310760;201704;553;1650;451;1473;70;245;185;621;255;866
310770;201704;973;2959;722;2555;107;431;356;1207;463;1638
310780;201704;3885;10347;3193;9199;327;975;2140;6121;2467;7096
310790;201704;1930;6150;1765;5854;379;1274;820;2853;1199;4127
310800;201704;2598;8205;1995;7007;562;2302;140;458;702;2760
310810;201704;1106;3091;971;2845;141;491;551;1519;692;2010
310820;201704;1257;3579;886;2856;207;744;221;688;428;1432
310825;201704;2896;9935;2359;9013;122;701;1793;6783;1915;7484
310830;201704;1387;4418;1135;3947;287;1068;385;1322;672;2390
310840;201704;2162;6308;1562;5205;310;1082;401;1262;711;2344
310850;201704;1538;4434;1331;4178;117;476;989;3051;1106;3527
310855;201704;2904;8851;2512;8265;340;1244;1706;5584;2046;6828
310860;201704;7161;21734;5980;19511;631;2250;3660;12050;4291;14300
310870;201704;1084;2822;829;2411;194;583;434;1265;628;1848
310880;201704;999;3092;829;2761;116;451;464;1529;580;1980
310890;201704;2520;7421;1935;6452;484;1831;397;1182;881;3013
310900;201704;4173;12898;3285;11113;687;2629;1260;3968;1947;6597
310910;201704;1901;5321;1227;4025;179;662;134;361;313;1023
310920;201704;1858;5319;1459;4675;280;1018;712;2249;992;3267
310925;201704;974;3036;859;2835;225;817;442;1401;667;2218
310930;201704;6022;16678;4799;14850;638;2104;2847;9090;3485;11194
310940;201704;6118;16640;5077;15087;599;1993;3228;9462;3827;11455
310945;201704;1218;3672;1109;3500;94;352;754;2328;848;2680
310950;201704;2107;6436;1523;5199;328;1328;532;1704;860;3032
310960;201704;453;1312;377;1171;73;271;172;525;245;796
310970;201704;1205;3881;908;3246;224;864;191;620;415;1484
310980;201704;392;946;247;700;32;107;140;374;172;481
310990;201704;1163;3663;943;3175;204;751;324;1027;528;1778
311000;201704;3495;11535;3186;10951;981;3697;1096;3586;2077;7283
311010;201704;734;2419;669;2253;235;851;255;856;490;1707
311020;201704;942;2717;739;2355;105;405;376;1140;481;1545
311030;201704;1678;4521;1169;3610;305;1085;356;999;661;2084
311040;201704;437;1443;362;1263;91;323;75;242;166;565
311050;201704;2314;6923;1983;6390;453;1620;793;2550;1246;4170
311060;201704;2572;7436;1885;5974;307;1137;645;1857;952;2994
311070;201704;1402;4607;1204;4236;246;1004;517;1754;763;2758
311080;201704;814;2442;683;2196;144;520;262;774;406;1294
311090;201704;1834;6405;1540;5873;427;1853;523;1914;950;3767
311100;201704;1924;6422;1512;5538;484;1942;188;677;672;2619
311110;201704;3412;8075;2424;6658;433;1259;1134;3162;1567;4421
311115;201704;1237;3546;1043;3249;91;350;741;2275;832;2625
311120;201704;7381;20555;5655;17461;1144;3956;1713;4865;2857;8821
311130;201704;2025;6111;1672;5555;276;1143;715;2249;991;3392
311140;201704;1333;3433;1005;2979;76;258;647;1938;723;2196
311150;201704;1594;5574;1455;5317;236;929;867;3186;1103;4115
311160;201704;3822;12548;3093;11234;1090;4345;715;2582;1805;6927
311170;201704;789;2334;626;2039;62;227;325;1091;387;1318
311180;201704;1068;3088;840;2668;243;832;238;752;481;1584
311190;201704;1074;3049;835;2611;159;583;244;716;403;1299
311200;201704;1799;5393;1404;4583;407;1448;244;738;651;2186
311205;201704;977;3183;840;2911;104;461;423;1447;527;1908
311210;201704;1000;3105;907;2985;117;368;667;2264;784;2632
311220;201704;805;2508;667;2213;142;529;251;792;393;1321
311230;201704;8289;26063;6450;22226;1302;4794;2084;7488;3386;12282
311240;201704;973;2908;771;2599;181;671;320;1055;501;1726
311250;201704;772;2454;681;2298;191;711;245;763;436;1474
311260;201704;2145;5743;1676;4973;395;1279;575;1655;970;2934
311265;201704;1209;3347;958;2926;124;426;576;1746;700;2172
311270;201704;3333;10427;2945;9887;269;1261;2089;6729;2358;7990
311280;201704;1152;3228;707;2257;141;518;166;516;307;1034
311290;201704;2009;6519;1884;6228;268;867;1211;4065;1479;4932
311300;201704;4393;14052;3914;13199;314;1458;2938;9689;3252;11147
311310;201704;613;1966;528;1802;116;397;151;477;267;874
311320;201704;3446;11337;3130;10643;548;2155;1227;3876;1775;6031
311330;201704;4374;12915;3801;11915;778;2668;1822;5702;2600;8370
311340;201704;11485;35744;9889;32720;2990;10533;2586;8753;5576;19286
311350;201704;2272;6218;1744;5226;250;873;823;2245;1073;3118
311360;201704;896;2656;778;2497;389;1283;109;391;498;1674
311370;201704;3838;11197;3187;10055;522;2002;1467;4241;1989;6243
311380;201704;424;1404;353;1255;104;385;110;399;214;784
311390;201704;1771;6229;1578;5949;682;2944;425;1441;1107;4385
311400;201704;1455;4474;1148;3863;207;809;464;1418;671;2227
311410;201704;1697;5780;1554;5597;385;1577;778;2800;1163;4377
311420;201704;1836;5890;1272;4552;227;873;123;349;350;1222
311430;201704;3550;10515;2489;8237;514;1869;391;1269;905;3138
311440;201704;2387;7585;1776;6433;567;2354;325;1186;892;3540
311450;201704;1940;6527;1556;5752;428;1746;289;984;717;2730
311455;201704;994;2640;768;2259;211;654;271;757;482;1411
311460;201704;599;1914;442;1612;86;378;111;382;197;760
311470;201704;464;1535;375;1346;104;421;59;187;163;608
311480;201704;814;2103;742;1994;135;373;477;1280;612;1653
311490;201704;207;755;185;692;55;229;61;200;116;429
311500;201704;440;1266;352;1112;59;222;177;556;236;778
311510;201704;2779;8332;2128;7170;620;2438;475;1579;1095;4017
311520;201704;588;1875;549;1795;167;599;227;704;394;1303
311530;201704;10495;26747;7621;22171;1899;6511;1900;5253;3799;11764
311535;201704;764;2194;505;1698;113;457;92;283;205;740
311540;201704;591;2009;549;1939;134;487;278;968;412;1455
311545;201704;2166;6360;1918;6061;156;615;1424;4407;1580;5022
311547;201704;1489;4081;1266;3734;70;229;919;2693;989;2922
311550;201704;2921;8903;2382;7853;368;1463;925;2944;1293;4407
311560;201704;260;677;219;623;31;103;129;336;160;439
311570;201704;1972;5026;1520;4415;65;192;1203;3624;1268;3816
311580;201704;2446;4768;1768;3995;297;597;1089;2646;1386;3243
311590;201704;479;1442;403;1326;92;362;186;599;278;961
311600;201704;1262;3689;1055;3414;176;567;678;2253;854;2820
311610;201704;2727;9441;2440;8905;710;2540;1001;3834;1711;6374
311615;201704;3168;9655;2624;8789;239;946;1872;6219;2111;7165
311620;201704;416;1233;365;1150;49;183;242;756;291;939
311630;201704;1341;3862;1114;3461;109;382;774;2345;883;2727
311640;201704;763;2417;622;2185;119;457;283;1005;402;1462
311650;201704;2216;6151;1891;5653;195;675;1182;3503;1377;4178
311660;201704;2723;8572;2120;7340;428;1579;343;1057;771;2636
311670;201704;1612;4495;1321;4043;318;1090;476;1438;794;2528
311680;201704;2056;6376;1723;5779;330;1169;977;3283;1307;4452
311690;201704;519;1287;440;1185;25;69;347;952;372;1021
311700;201704;2304;5863;1799;5206;93;320;1398;3980;1491;4300
311710;201704;1608;4922;1180;4069;369;1413;320;1126;689;2539
311720;201704;390;1289;352;1223;51;203;162;543;213;746
311730;201704;5929;14512;3397;10250;1035;3576;533;1311;1568;4887
311740;201704;796;2421;762;2374;105;312;601;1908;706;2220
311750;201704;4079;12870;3481;11876;546;2136;1943;6445;2489;8581
311760;201704;670;2184;587;1988;131;505;139;375;270;880
311770;201704;2158;6739;1759;5981;418;1566;545;1770;963;3336
311780;201704;1248;4197;1006;3662;249;1047;221;708;470;1755
311783;201704;2037;6385;1703;5743;63;304;1298;4309;1361;4613
311787;201704;611;2040;461;1627;84;334;139;412;223;746
311790;201704;1529;4464;1166;3800;262;988;382;1213;644;2201
311800;201704;4945;16351;4318;14843;802;3065;504;1624;1306;4689
311810;201704;1029;3341;898;3086;75;322;546;1857;621;2179
311820;201704;604;1826;511;1609;102;380;294;841;396;1221
311830;201704;8102;26080;6386;22076;1826;6914;646;2148;2472;9062
311840;201704;2764;8283;2523;7913;512;1818;1490;4606;2002;6424
311850;201704;302;913;263;845;43;143;148;471;191;614
311860;201704;49934;143677;42606;131126;7212;24197;23262;70210;30474;94407
311870;201704;2117;6136;1550;5013;289;1065;504;1482;793;2547
311880;201704;6668;18614;5856;17547;614;1805;4237;13026;4851;14831
311890;201704;1409;4092;1159;3630;242;811;534;1642;776;2453
311900;201704;696;2069;600;1904;79;291;362;1139;441;1430
311910;201704;4043;11705;3378;10739;716;2424;1578;5028;2294;7452
311920;201704;1925;6083;1648;5596;193;766;997;3361;1190;4127
311930;201704;3386;9335;2806;8405;1124;3570;750;2150;1874;5720
311940;201704;12761;37538;10287;32589;2026;7077;3429;10320;5455;17397
311950;201704;2194;6389;1758;5681;142;576;1252;3988;1394;4564
311960;201704;385;1168;347;1091;60;239;168;450;228;689
311970;201704;399;1320;287;1051;52;222;61;203;113;425
311980;201704;545;1545;356;1184;62;229;116;390;178;619
311990;201704;469;1269;357;1107;111;386;137;415;248;801
311995;201704;1157;3501;689;2377;43;170;51;122;94;292
312000;201704;607;1792;542;1693;51;168;366;1168;417;1336
312010;201704;878;2840;721;2468;102;388;317;1038;419;1426
312015;201704;1339;4262;1217;4043;133;521;812;2639;945;3160
312020;201704;1088;3485;966;3269;191;703;461;1532;652;2235
312030;201704;1860;5133;1659;4889;53;237;1490;4329;1543;4566
312040;201704;755;2638;618;2301;131;562;167;585;298;1147
312050;201704;1173;4122;1016;3753;287;1196;193;634;480;1830
312060;201704;728;2236;654;2106;132;464;358;1128;490;1592
312070;201704;1004;3031;673;2316;127;493;272;911;399;1404
312080;201704;2689;7170;2116;6308;253;928;1235;3433;1488;4361
312083;201704;945;2581;793;2359;81;257;599;1775;680;2032
312087;201704;2140;6285;1931;5986;138;450;1504;4762;1642;5212
312090;201704;8804;26225;7233;23552;1871;6430;2793;9036;4664;15466
312100;201704;1468;4638;1151;4132;179;776;514;1772;693;2548
312110;201704;992;3431;860;3146;273;1111;167;541;440;1652
312120;201704;667;2116;557;1909;129;521;208;631;337;1152
312125;201704;1175;3694;1056;3488;235;731;620;2169;855;2900
312130;201704;860;2388;677;2031;83;286;268;751;351;1037
312140;201704;782;2482;667;2213;173;615;197;596;370;1211
312150;201704;429;1271;395;1201;21;91;255;720;276;811
312160;201704;7413;24125;6426;22053;1419;5401;2561;8440;3980;13841
312170;201704;877;2505;729;2265;56;211;477;1440;533;1651
312180;201704;1367;4124;1182;3760;186;693;545;1637;731;2330
312190;201704;592;1887;451;1593;142;554;69;241;211;795
312200;201704;4839;13613;4046;12352;715;2235;2390;7359;3105;9594
312210;201704;1100;2849;833;2459;140;498;504;1406;644;1904
312220;201704;1990;6528;1842;6352;107;250;1627;5855;1734;6105
312230;201704;11273;34103;8625;28983;2821;10465;1061;3374;3882;13839
312235;201704;1577;4623;1394;4363;151;557;1003;3097;1154;3654
312240;201704;882;2935;701;2545;167;666;181;643;348;1309
312245;201704;2286;6501;2044;6195;86;316;1682;5088;1768;5404
312247;201704;782;2271;608;1984;155;535;261;883;416;1418
312250;201704;1130;3074;829;2550;157;567;320;923;477;1490
312260;201704;930;2849;768;2580;104;391;479;1551;583;1942
312270;201704;650;1928;535;1690;46;194;274;791;320;985
312280;201704;405;1333;362;1238;131;472;40;130;171;602
312290;201704;767;2517;696;2398;151;587;230;789;381;1376
312300;201704;876;2842;691;2399;178;681;57;136;235;817
312310;201704;778;2850;730;2741;176;747;330;1205;506;1952
312320;201704;1940;5449;1512;4672;441;1490;325;935;766;2425
312330;201704;1019;2928;837;2671;123;459;599;1871;722;2330
312340;201704;299;803;237;704;38;138;118;319;156;457
312350;201704;280;687;246;650;23;85;200;501;223;586
312352;201704;1589;4904;1427;4670;217;744;963;3268;1180;4012
312360;201704;2939;9285;2444;8244;559;2036;694;2301;1253;4337
312370;201704;1734;5248;1521;4876;393;1398;631;1924;1024;3322
312380;201704;2019;5224;1803;4939;61;177;1540;4300;1601;4477
312385;201704;1306;3744;1117;3444;88;341;802;2396;890;2737
312390;201704;2077;6517;1640;5667;402;1471;363;1186;765;2657
312400;201704;3010;9484;2492;8462;953;3349;566;1998;1519;5347
312410;201704;10049;32000;8937;29932;1820;6551;4092;13559;5912;20110
312420;201704;3843;11621;3607;11257;544;1776;2329;7365;2873;9141
312430;201704;8100;23106;6877;20973;854;2779;4360;13309;5214;16088
312440;201704;807;2519;669;2277;234;874;215;754;449;1628
312450;201704;1194;3854;929;3321;275;1041;320;1191;595;2232
312460;201704;341;1003;295;941;54;199;169;535;223;734
312470;201704;604;1629;399;1248;80;296;123;353;203;649
312480;201704;1151;2940;849;2596;146;534;492;1427;638;1961
312490;201704;1916;4947;1501;4312;251;774;801;2219;1052;2993
312500;201704;709;2029;610;1876;94;337;285;852;379;1189
312510;201704;3731;10732;3026;9297;407;1440;1581;4607;1988;6047
312520;201704;232;728;186;654;64;235;67;238;131;473
312530;201704;566;1640;496;1543;48;188;347;1069;395;1257
312540;201704;1368;4280;1044;3624;206;774;474;1651;680;2425
312550;201704;730;2134;615;1886;102;340;307;879;409;1219
312560;201704;2098;5393;1729;4920;93;340;1398;3934;1491;4274
312570;201704;2257;6501;1872;5881;523;1729;698;2210;1221;3939
312580;201704;524;1674;433;1465;57;222;169;567;226;789
312590;201704;1631;5228;1408;4760;208;880;666;2101;874;2981
312595;201704;1822;6046;1682;5730;319;1116;946;3255;1265;4371
312600;201704;796;2462;597;2098;110;482;282;945;392;1427
312610;201704;6503;17983;4734;14779;1101;3732;943;2805;2044;6537
312620;201704;2200;6265;1700;5553;99;373;1276;4279;1375;4652
312630;201704;312;994;266;907;65;255;96;325;161;580
312640;201704;533;1690;433;1479;82;286;129;418;211;704
312650;201704;2124;5966;1554;4855;154;552;913;2756;1067;3308
312660;201704;1432;3666;1128;3228;111;387;765;2152;876;2539
312670;201704;5379;15585;4543;14444;1035;3783;2047;6315;3082;10098
312675;201704;1271;3932;1077;3529;106;423;753;2433;859;2856
312680;201704;1434;4268;1242;4002;151;610;825;2605;976;3215
312690;201704;2159;5617;1757;5055;217;684;1187;3318;1404;4002
312695;201704;842;2834;796;2761;136;459;533;1909;669;2368
312700;201704;1807;5419;1435;4667;179;622;780;2494;959;3116
312705;201704;1288;3594;1058;3190;62;224;753;2209;815;2433
312707;201704;1473;4666;1162;4050;130;561;642;2142;772;2703
312710;201704;6470;16012;4195;12467;1279;4234;789;2379;2068;6613
312720;201704;775;2567;668;2337;102;418;316;1046;418;1464
312730;201704;1874;4492;1335;3832;123;428;865;2460;988;2888
312733;201704;1559;4177;1197;3527;58;174;742;2156;800;2330
312735;201704;790;2131;692;1988;122;439;432;1138;554;1577
312737;201704;812;2025;589;1700;143;427;239;682;382;1109
312738;201704;501;1543;361;1263;91;374;124;399;215;773
312740;201704;307;775;194;642;70;246;44;130;114;376
312750;201704;1226;4236;1139;4095;200;852;592;2054;792;2906
312760;201704;1890;5947;1449;5036;322;1176;406;1404;728;2580
312770;201704;41264;110258;30349;91847;7557;24686;8515;25109;16072;49795
312780;201704;2674;8947;2377;8444;372;1488;1367;4883;1739;6371
312790;201704;331;839;206;641;28;104;80;221;108;325
312800;201704;4906;15646;3939;13658;1194;4478;861;3031;2055;7509
312810;201704;2010;6070;1401;4833;362;1365;282;892;644;2257
312820;201704;1920;5384;1632;4892;87;321;1127;3276;1214;3597
312825;201704;1306;3451;1146;3244;74;231;900;2548;974;2779
312830;201704;2562;7757;1789;6241;458;1735;325;1123;783;2858
312840;201704;1223;3839;983;3376;154;621;333;1035;487;1656
312850;201704;731;2171;580;1888;110;403;209;668;319;1071
312860;201704;1405;3766;952;3009;232;809;279;830;511;1639
312870;201704;5654;17045;3994;13570;681;2507;933;3013;1614;5520
312880;201704;1321;3783;1177;3572;89;289;758;2389;847;2678
312890;201704;1863;5497;1180;3993;226;809;413;1406;639;2215
312900;201704;1203;3471;1031;3222;99;328;709;2265;808;2593
312910;201704;1657;3231;974;2346;156;427;469;1051;625;1478
312920;201704;879;2727;709;2414;159;637;307;980;466;1617
312930;201704;2123;5944;1793;5439;405;1262;817;2473;1222;3735
312940;201704;870;2771;759;2572;163;588;282;970;445;1558
312950;201704;2899;8067;2214;7039;800;2762;463;1496;1263;4258
312960;201704;1915;5393;1667;5048;114;326;1304;4028;1418;4354
312965;201704;1794;5567;1532;5076;137;522;958;3148;1095;3670
312970;201704;953;3107;765;2788;197;801;228;810;425;1611
312980;201704;17949;58034;16628;55358;4167;15168;7023;22387;11190;37555
312990;201704;464;1352;320;1096;91;366;104;346;195;712
313000;201704;476;1550;392;1385;85;404;144;443;229;847
313005;201704;2612;8080;2322;7570;309;1027;1515;4953;1824;5980
313010;201704;3754;11786;3204;10822;802;2966;1528;5013;2330;7979
313020;201704;920;3055;676;2455;132;542;82;255;214;797
313030;201704;1444;3766;1057;3203;172;627;523;1548;695;2175
313040;201704;778;2527;681;2300;83;342;338;1072;421;1414
313050;201704;1791;5477;1313;4713;317;1292;339;1113;656;2405
313055;201704;1603;4912;1479;4735;60;227;1256;4020;1316;4247
313060;201704;799;2485;628;2095;182;634;89;289;271;923
313065;201704;1891;6038;1622;5607;201;817;1146;3962;1347;4779
313070;201704;969;2782;796;2484;153;537;354;1082;507;1619
313080;201704;437;1298;328;1071;79;316;99;265;178;581
313090;201704;5166;14712;4456;13576;1197;3973;2104;6380;3301;10353
313100;201704;1141;3369;1037;3209;79;252;824;2568;903;2820
313110;201704;1669;4715;1239;3871;173;624;539;1569;712;2193
313115;201704;2304;7509;2154;7193;427;1586;1012;3172;1439;4758
313120;201704;3474;9014;2975;8376;464;1439;1900;5388;2364;6827
313130;201704;25455;75183;21718;67845;4108;14291;9465;28010;13573;42301
313140;201704;506;1314;391;1131;23;78;288;814;311;892
313150;201704;1306;4079;1080;3661;417;1513;240;816;657;2329
313160;201704;944;2790;806;2524;145;525;433;1294;578;1819
313170;201704;10192;33821;7762;28043;1605;6100;2297;8181;3902;14281
313180;201704;2270;6110;1791;5433;351;1176;803;2348;1154;3524
313190;201704;3902;12728;3086;10795;653;2501;828;2729;1481;5230
313200;201704;1133;3567;995;3307;86;357;733;2366;819;2723
313210;201704;3979;12114;3355;11138;633;2316;1699;5434;2332;7750
313220;201704;1599;4650;1145;3742;252;922;292;822;544;1744
313230;201704;2253;7729;2113;7543;232;936;1557;5498;1789;6434
313240;201704;8336;24632;6398;21044;1206;4483;2593;8151;3799;12634
313250;201704;6359;19968;5421;18281;543;2061;3039;10223;3582;12284
313260;201704;647;1888;448;1452;84;324;123;385;207;709
313270;201704;5313;15686;4428;14128;776;2663;2404;7638;3180;10301
313280;201704;365;1185;267;979;59;231;67;238;126;469
313290;201704;767;2721;643;2507;241;1058;89;313;330;1371
313300;201704;1762;5666;1449;4964;423;1588;194;573;617;2161
313310;201704;959;3237;859;3036;186;758;164;495;350;1253
313320;201704;2305;6454;1674;5455;344;1235;690;2239;1034;3474
313330;201704;3995;11959;3331;10828;312;1346;2092;6542;2404;7888
313340;201704;1648;4054;1284;3514;213;594;737;2037;950;2631
313350;201704;2455;7597;1962;6509;413;1506;492;1529;905;3035
313360;201704;1312;3666;977;3112;195;770;520;1538;715;2308
313370;201704;1170;3896;1098;3711;156;609;586;1889;742;2498
313375;201704;2112;5602;1513;4699;270;1017;494;1446;764;2463
313380;201704;4734;14318;4020;12903;1045;3686;1394;4158;2439;7844
313390;201704;892;3012;832;2908;85;369;554;1894;639;2263
313400;201704;3630;9732;3141;9154;287;814;2569;7606;2856;8420
313410;201704;1187;3315;991;3011;160;556;658;1948;818;2504
313420;201704;16748;40127;10354;29470;2148;6915;1605;4574;3753;11489
313430;201704;970;3035;727;2527;137;567;256;800;393;1367
313440;201704;6292;14134;4324;11777;269;752;2768;7675;3037;8427
313450;201704;588;1744;466;1491;93;303;150;459;243;762
313460;201704;2068;6873;1797;6409;483;1972;707;2321;1190;4293
313470;201704;3057;8222;2690;7682;352;1025;1835;5225;2187;6250
313480;201704;807;2367;636;2056;96;356;225;675;321;1031
313490;201704;1534;4258;862;3201;284;1209;63;216;347;1425
313500;201704;415;1365;331;1145;56;214;106;348;162;562
313505;201704;9039;25868;8376;25123;220;490;7820;23817;8040;24307
313507;201704;1353;3660;1160;3378;96;327;800;2337;896;2664
313510;201704;14455;41687;12686;38700;1632;5425;6914;20815;8546;26240
313520;201704;14051;42683;11737;38596;1240;4714;7555;24612;8795;29326
313530;201704;560;1678;465;1510;45;177;168;502;213;679
313535;201704;2538;7287;2273;6818;190;603;1599;4774;1789;5377
313540;201704;957;2980;710;2332;187;653;193;609;380;1262
313545;201704;1240;4446;1107;4193;181;771;636;2307;817;3078
313550;201704;1806;5680;1584;5256;357;1244;797;2597;1154;3841
313560;201704;2210;4973;1787;4505;146;348;1399;3585;1545;3933
313570;201704;868;2956;750;2726;203;819;296;1042;499;1861
313580;201704;5613;15916;4407;14114;744;2601;2310;7566;3054;10167
313590;201704;930;2689;735;2406;295;1046;147;464;442;1510
313600;201704;3724;11037;3263;10289;298;1082;2404;7566;2702;8648
313610;201704;958;2737;816;2471;163;505;483;1463;646;1968
313620;201704;5262;15791;4569;14551;1143;3862;1797;5719;2940;9581
313630;201704;7999;21777;5989;18958;860;3027;3136;10451;3996;13478
313640;201704;877;2332;619;1955;177;636;218;647;395;1283
313650;201704;1789;5868;1597;5533;192;798;1036;3536;1228;4334
313652;201704;901;3081;829;2951;123;524;498;1688;621;2212
313655;201704;915;2868;774;2648;111;435;444;1517;555;1952
313657;201704;1342;3861;1076;3456;88;385;775;2332;863;2717
313660;201704;794;2554;681;2327;128;531;333;1069;461;1600
313665;201704;3851;12104;3294;10949;591;2178;1674;5408;2265;7586
313670;201704;44427;127269;32545;104362;7219;25438;10416;32391;17635;57829
313680;201704;1047;3033;926;2835;115;440;577;1717;692;2157
313690;201704;887;3109;747;2804;153;594;266;1021;419;1615
313695;201704;1376;4386;1190;4028;109;452;822;2785;931;3237
313700;201704;3465;11657;3010;11085;369;1404;2259;8497;2628;9901
313710;201704;1325;3527;1007;3023;132;429;576;1740;708;2169
313720;201704;5483;16810;4269;14287;808;3034;1494;4604;2302;7638
313730;201704;1298;3332;978;2907;95;325;581;1709;676;2034
313740;201704;1823;6600;1554;5910;451;1878;105;375;556;2253
313750;201704;2063;6134;1687;5382;445;1557;487;1414;932;2971
313753;201704;1852;5140;1445;4429;212;742;734;2211;946;2953
313760;201704;4220;13262;3463;11754;937;3482;1086;3472;2023;6954
313770;201704;3363;10396;2873;9713;450;1619;1721;5857;2171;7476
313780;201704;4046;11036;3095;9531;483;1703;990;3054;1473;4757
313790;201704;451;1515;428;1476;62;223;271;932;333;1155
313800;201704;1180;3099;1018;2850;80;264;741;2113;821;2377
313810;201704;1576;4379;1356;4069;128;414;961;2914;1089;3328
313820;201704;12365;32712;9842;28551;1685;5683;4108;11136;5793;16819
313830;201704;368;1186;325;1110;77;292;141;479;218;771
313835;201704;872;2857;790;2712;106;449;453;1478;559;1927
313840;201704;7254;20546;5688;17910;1400;4858;1274;3984;2674;8842
313850;201704;1081;2911;950;2679;157;549;512;1310;669;1859
313860;201704;2780;8224;2097;6748;420;1444;629;1898;1049;3342
313862;201704;1252;3177;895;2589;98;269;491;1497;589;1766
313865;201704;2284;6811;2043;6448;127;473;1559;4873;1686;5346
313867;201704;1109;3762;969;3465;309;1127;330;1203;639;2330
313868;201704;1705;5701;1460;5204;110;485;1047;3680;1157;4165
313870;201704;787;2418;679;2219;166;615;210;607;376;1222
313880;201704;1273;3901;1070;3539;248;911;371;1072;619;1983
313890;201704;1848;4853;1511;4410;231;688;868;2724;1099;3412
313900;201704;3818;13418;3400;12493;1053;4244;868;3183;1921;7427
313910;201704;680;2251;561;2016;185;716;81;296;266;1012
313920;201704;3224;10615;2786;9817;561;2017;1488;5457;2049;7474
313925;201704;1791;4823;1398;4078;207;579;813;2406;1020;2985
313930;201704;6342;22375;5355;20650;656;2411;3401;14050;4057;16461
313940;201704;8634;27596;6824;24590;1793;7221;1893;7360;3686;14581
313950;201704;4045;11038;3071;9484;889;3177;1142;3302;2031;6479
313960;201704;5442;13845;3848;11465;946;3122;1134;3244;2080;6366
313970;201704;1401;4099;1248;3890;121;434;739;2396;860;2830
313980;201704;1224;3769;943;3273;205;810;367;1238;572;2048
313990;201704;1634;6083;1427;5548;485;2027;340;1249;825;3276
314000;201704;8395;25647;7507;23882;979;3754;4561;14001;5540;17755
314010;201704;1199;3199;989;2918;70;257;706;2042;776;2299
314015;201704;1624;5113;1340;4627;257;1038;660;2191;917;3229
314020;201704;509;1502;332;1114;61;238;73;241;134;479
314030;201704;797;2551;632;2165;100;367;267;899;367;1266
314040;201704;734;2100;616;1874;144;473;237;700;381;1173
314050;201704;1608;4880;1266;4197;240;931;535;1636;775;2567
314053;201704;1598;4976;1407;4711;180;600;962;3419;1142;4019
314055;201704;2195;6408;1918;5997;76;311;1572;4926;1648;5237
314060;201704;1178;3541;939;3124;71;297;616;2012;687;2309
314070;201704;4179;12849;3369;11287;865;3090;972;3112;1837;6202
314080;201704;1755;5455;1274;4359;207;789;301;889;508;1678
314085;201704;1969;6473;1715;6096;465;1798;663;2367;1128;4165
314090;201704;3277;10928;2871;10160;441;1813;1471;5320;1912;7133
314100;201704;3305;8160;2901;7614;135;279;2454;6706;2589;6985
314110;201704;3917;12285;3436;11297;655;2390;1502;4593;2157;6983
314120;201704;1025;2436;486;1547;95;333;117;377;212;710
314130;201704;684;1952;354;1214;63;244;64;204;127;448
314140;201704;4819;14723;3907;12888;722;2577;1762;5769;2484;8346
314150;201704;1511;4155;1208;3640;158;522;680;2016;838;2538
314160;201704;2536;6597;1931;5665;250;818;994;3010;1244;3828
314170;201704;1051;3067;866;2693;112;379;486;1440;598;1819
314180;201704;4998;15493;4412;14570;1209;4201;1895;6395;3104;10596
314190;201704;683;1882;503;1588;108;410;186;528;294;938
314200;201704;2870;8737;2531;8132;243;976;1772;5503;2015;6479
314210;201704;2009;5682;1792;5320;168;598;1127;3275;1295;3873
314220;201704;1451;4450;1080;3723;341;1293;223;690;564;1983
314225;201704;1322;3765;1186;3586;76;272;873;2658;949;2930
314230;201704;668;2104;616;2015;93;362;356;1152;449;1514
314240;201704;1091;3283;900;2972;189;676;425;1455;614;2131
314250;201704;530;1570;402;1294;89;309;120;342;209;651
314260;201704;991;3492;869;3197;188;818;266;896;454;1714
314270;201704;2828;8972;2331;8084;208;841;1603;5541;1811;6382
314280;201704;3026;8113;2068;6327;440;1561;761;2129;1201;3690
314290;201704;4687;12782;4017;11697;688;2060;2349;6806;3037;8866
314300;201704;1488;4857;1241;4277;351;1265;342;1145;693;2410
314310;201704;5579;15780;4542;14022;1221;4046;1517;4474;2738;8520
314315;201704;790;3055;720;2917;81;380;503;2031;584;2411
314320;201704;2976;8370;2119;7069;490;1729;984;3413;1474;5142
314330;201704;53101;157366;44343;142857;13201;45663;11857;37951;25058;83614
314340;201704;2827;7557;1600;5225;314;1164;135;329;449;1493
314345;201704;1228;4067;1111;3864;186;702;709;2416;895;3118
314350;201704;1145;3289;865;2807;243;849;169;516;412;1365
314360;201704;672;2139;436;1577;90;379;100;360;190;739
314370;201704;552;1734;506;1667;85;332;355;1119;440;1451
314380;201704;1266;3789;887;3001;247;904;124;432;371;1336
314390;201704;12548;35479;9168;29287;2218;7674;2100;6212;4318;13886
314400;201704;4402;12832;3676;11778;1128;3792;1280;4274;2408;8066
314410;201704;2673;8024;2043;6803;441;1638;662;2329;1103;3967
314420;201704;748;2041;574;1781;28;151;416;1240;444;1391
314430;201704;6074;17807;5162;16155;1275;4327;1768;5566;3043;9893
314435;201704;1381;4278;1221;4024;85;384;852;2774;937;3158
314437;201704;992;2647;821;2385;27;94;606;1782;633;1876
314440;201704;539;1629;445;1484;151;572;121;347;272;919
314450;201704;1496;4372;1271;4014;205;811;670;1938;875;2749
314460;201704;3705;12288;2966;10659;720;2818;516;1778;1236;4596
314465;201704;2261;6943;2082;6621;84;413;1649;5098;1733;5511
314467;201704;974;2733;833;2500;47;137;611;1866;658;2003
314470;201704;2104;6531;1821;5962;423;1555;677;2077;1100;3632
314480;201704;5671;18603;4143;14725;737;2873;601;1916;1338;4789
314490;201704;824;2447;640;2065;109;400;343;1042;452;1442
314500;201704;1803;5071;1336;4227;268;940;437;1341;705;2281
314505;201704;1873;5170;1685;4929;160;514;1178;3498;1338;4012
314510;201704;1922;5104;1290;4232;324;1161;387;1295;711;2456
314520;201704;2771;9677;2055;7954;419;1875;202;724;621;2599
314530;201704;5726;19725;5386;19101;875;3054;3397;12403;4272;15457
314535;201704;2742;7473;2284;6827;211;709;1631;4859;1842;5568
314537;201704;1110;3396;909;3036;111;443;568;1849;679;2292
314540;201704;354;1054;281;906;55;197;103;310;158;507
314545;201704;1529;4372;1358;4136;88;266;1049;3378;1137;3644
314550;201704;638;1690;469;1445;72;286;202;559;274;845
314560;201704;4197;14158;3518;12594;646;2607;1120;3767;1766;6374
314570;201704;309;910;240;774;36;140;122;377;158;517
314580;201704;499;1651;390;1410;96;386;38;140;134;526
314585;201704;852;2712;618;2196;145;603;189;631;334;1234
314587;201704;1971;5866;1655;5329;326;1029;847;2786;1173;3815
314590;201704;2910;9714;2217;7981;457;1835;507;1756;964;3591
314600;201704;1556;4998;1104;4023;255;1048;139;411;394;1459
314610;201704;6872;22794;6097;21013;1336;5260;2603;8417;3939;13677
314620;201704;1600;4662;1420;4409;101;349;1104;3388;1205;3737
314625;201704;1543;4923;1392;4673;177;819;961;3030;1138;3849
314630;201704;4745;13867;4128;12879;262;1077;3087;9528;3349;10605
314640;201704;585;1572;447;1333;113;366;139;367;252;733
314650;201704;1042;2837;751;2364;91;346;293;818;384;1164
314655;201704;1535;4528;1170;3831;263;878;470;1557;733;2435
314660;201704;303;802;208;614;18;51;102;289;120;340
314670;201704;1632;4292;1156;3459;136;447;675;1962;811;2409
314675;201704;1826;5299;1584;4878;129;482;1163;3529;1292;4011
314690;201704;2091;6723;1719;6012;530;2047;322;1087;852;3134
314700;201704;9172;29851;6489;23926;1766;7193;962;3540;2728;10733
314710;201704;8224;24415;5854;19396;1099;4092;900;2744;1999;6836
314720;201704;2320;7542;1845;6489;426;1654;465;1637;891;3291
314730;201704;2090;6226;1676;5532;439;1599;577;1771;1016;3370
314740;201704;2777;8636;2363;7829;326;1305;1230;3888;1556;5193
314750;201704;327;999;262;855;31;121;135;413;166;534
314760;201704;1698;5474;1266;4468;184;751;282;827;466;1578
314770;201704;1042;3214;626;2122;61;235;124;345;185;580
314780;201704;311;806;229;686;46;170;112;311;158;481
314790;201704;9618;29097;7502;25152;2977;11070;548;1534;3525;12604
314795;201704;1586;4554;1382;4227;87;354;1028;3020;1115;3374
314800;201704;11300;31840;7509;24195;1875;6558;776;2347;2651;8905
314810;201704;10347;29666;7931;25481;2387;8241;1694;5532;4081;13773
314820;201704;877;2445;654;2054;157;545;260;794;417;1339
314830;201704;1539;5033;1364;4726;327;1292;671;2315;998;3607
314840;201704;899;3149;741;2912;129;642;445;1664;574;2306
314850;201704;1944;5408;1541;4700;161;632;1101;3249;1262;3881
314860;201704;3265;10580;2857;9802;426;1730;1700;5692;2126;7422
314870;201704;5493;16574;4721;15505;434;1780;3466;11260;3900;13040
314875;201704;1741;5558;1645;5425;131;413;1381;4617;1512;5030
314880;201704;903;2319;733;2098;54;129;518;1574;572;1703
314890;201704;541;1672;404;1348;75;282;156;477;231;759
314900;201704;583;1656;479;1503;89;308;206;638;295;946
314910;201704;1622;5164;1314;4655;349;1423;510;1738;859;3161
314915;201704;2454;7668;2131;7097;163;695;1488;4820;1651;5515
314920;201704;527;1442;378;1221;29;109;202;626;231;735
314930;201704;4622;15258;4020;13981;1045;3919;1177;3887;2222;7806
314940;201704;402;1153;365;1089;50;158;224;636;274;794
314950;201704;352;1017;252;864;47;180;85;289;132;469
314960;201704;751;2243;591;1909;116;421;239;713;355;1134
314970;201704;579;1964;493;1795;113;458;151;547;264;1005
314980;201704;1381;4174;1134;3771;345;1275;75;230;420;1505
314990;201704;2467;7647;1878;6357;499;1949;374;1084;873;3033
314995;201704;1612;4866;1397;4526;140;579;904;2852;1044;3431
315000;201704;1088;3058;873;2709;88;328;557;1700;645;2028
315010;201704;418;1274;330;1096;67;277;118;348;185;625
315015;201704;2131;6399;1930;6151;231;769;1356;4538;1587;5307
315020;201704;819;2498;609;2051;87;316;267;866;354;1182
315030;201704;602;1810;463;1544;133;476;101;308;234;784
315040;201704;896;2685;834;2570;150;496;507;1533;657;2029
315050;201704;1275;3637;1008;3229;140;516;516;1636;656;2152
315053;201704;1087;3181;932;2875;145;554;475;1462;620;2016
315057;201704;1630;5520;1471;5218;257;929;809;2912;1066;3841
315060;201704;702;2254;491;1795;110;439;70;252;180;691
315070;201704;735;2155;584;1885;167;573;221;661;388;1234
315080;201704;2817;9128;2416;8266;594;2169;1067;3620;1661;5789
315090;201704;774;2639;624;2301;150;610;162;555;312;1165
315100;201704;1175;3908;832;3077;200;829;220;759;420;1588
315110;201704;1290;3788;1056;3371;219;773;431;1369;650;2142
315120;201704;13739;32109;9538;26657;1300;3734;4659;13964;5959;17698
315130;201704;1283;4167;1159;3925;290;1142;400;1268;690;2410
315140;201704;2800;8669;2303;7657;473;1794;928;2851;1401;4645
315150;201704;4414;11755;3265;9866;521;1736;1352;4078;1873;5814
315160;201704;1298;3762;1020;3252;229;777;405;1262;634;2039
315170;201704;1476;4632;1149;3953;266;971;217;765;483;1736
315180;201704;17154;47426;9666;31684;1681;6209;1648;4964;3329;11173
315190;201704;1963;5052;1643;4563;314;905;1062;2936;1376;3841
315200;201704;3614;12013;3022;10750;979;3813;572;2000;1551;5813
315210;201704;7871;22682;6245;19279;1033;3551;2396;6959;3429;10510
315213;201704;1123;3343;1015;3180;46;161;821;2552;867;2713
315217;201704;2429;8143;1973;7300;199;942;1252;4518;1451;5460
315220;201704;9488;27084;7960;24456;2467;7791;2484;7893;4951;15684
315230;201704;2890;7571;2565;7192;120;180;2270;6722;2390;6902
315240;201704;2987;9008;2528;8297;676;2371;1180;3813;1856;6184
315250;201704;10331;30857;8104;26642;1796;6504;2738;8931;4534;15435
315260;201704;944;2916;627;2204;138;512;79;244;217;756
315270;201704;658;2099;502;1794;100;424;124;406;224;830
315280;201704;2911;8154;1809;5791;394;1342;262;795;656;2137
315290;201704;1226;3365;828;2706;264;942;192;655;456;1597
315300;201704;511;1340;348;1133;134;451;120;406;254;857
315310;201704;1254;3899;1012;3453;126;485;607;1998;733;2483
315320;201704;738;2204;586;1977;88;372;265;860;353;1232
315330;201704;734;2629;457;1878;100;441;81;315;181;756
315340;201704;3475;9646;2733;8512;493;1664;1168;3556;1661;5220
315350;201704;1834;4975;1401;4344;126;436;920;2915;1046;3351
315360;201704;1637;5390;1320;4681;262;1029;416;1383;678;2412
315370;201704;461;1430;403;1318;76;256;178;579;254;835
315380;201704;182;607;139;502;32;137;39;114;71;251
315390;201704;1207;3912;923;3277;209;824;207;694;416;1518
315400;201704;4269;12629;3460;11095;579;2017;1700;5369;2279;7386
315410;201704;2173;5413;1780;4897;300;896;1002;2739;1302;3635
315415;201704;1062;3334;915;3120;350;1263;276;975;626;2238
315420;201704;1155;3670;881;3099;208;765;129;419;337;1184
315430;201704;3578;9600;2706;8176;789;2665;663;1902;1452;4567
315440;201704;972;2872;842;2656;163;626;387;1094;550;1720
315445;201704;2039;5533;1580;4820;216;725;998;3055;1214;3780
315450;201704;2411;7349;2136;6912;324;1049;1323;4384;1647;5433
315460;201704;30939;99759;27786;93362;9961;35572;5650;18415;15611;53987
315470;201704;462;1380;385;1236;34;132;202;627;236;759
315480;201704;1661;5026;1157;3899;264;959;230;799;494;1758
315490;201704;3127;8174;2297;7030;403;1413;777;2255;1180;3668
315500;201704;476;1377;307;990;37;146;130;353;167;499
315510;201704;1379;3869;1181;3550;82;296;922;2725;1004;3021
315520;201704;1067;3101;855;2769;100;375;542;1710;642;2085
315530;201704;638;2106;503;1756;171;659;155;486;326;1145
315540;201704;1034;3221;860;2893;156;636;301;999;457;1635
315550;201704;1767;4954;1356;4305;304;1104;449;1404;753;2508
315560;201704;6430;20970;5787;20052;596;2386;3874;13468;4470;15854
315570;201704;1848;5884;1691;5563;226;865;883;2807;1109;3672
315580;201704;2256;6341;1802;5575;459;1611;536;1589;995;3200
315590;201704;828;2419;726;2257;114;396;371;1133;485;1529
315600;201704;2375;8335;1904;7366;286;1174;1051;4205;1337;5379
315610;201704;972;2701;784;2334;135;522;325;821;460;1343
315620;201704;305;1081;288;1047;67;232;167;654;234;886
315630;201704;837;2601;671;2265;165;549;134;451;299;1000
315640;201704;449;1305;381;1191;60;240;168;483;228;723
315645;201704;788;2321;632;2010;224;756;173;519;397;1275
315650;201704;1815;4904;1431;4352;91;366;1029;3078;1120;3444
315660;201704;2550;6498;2052;5688;162;426;1415;3909;1577;4335
315670;201704;10842;34676;9621;32293;2410;8760;3890;12705;6300;21465
315680;201704;2970;9700;2308;8373;665;2565;712;2587;1377;5152
315690;201704;3213;8958;2198;7133;533;1900;436;1526;969;3426
315700;201704;7296;22093;6093;19708;1062;3755;2819;8812;3881;12567
315710;201704;1826;5062;1396;4387;109;465;841;2523;950;2988
315720;201704;3807;11861;3394;11110;269;1168;2113;6646;2382;7814
315725;201704;1500;4600;1332;4359;198;667;975;3245;1173;3912
315727;201704;612;1791;472;1529;98;363;187;552;285;915
315730;201704;736;2300;680;2172;95;354;352;1074;447;1428
315733;201704;1046;3040;917;2809;241;838;343;1002;584;1840
315737;201704;1212;3641;962;3187;63;268;630;2076;693;2344
315740;201704;984;2956;821;2632;130;515;416;1213;546;1728
315750;201704;1158;3459;1038;3242;71;258;760;2387;831;2645
315760;201704;1096;2814;1053;2758;19;48;984;2576;1003;2624
315765;201704;1650;4825;1441;4556;62;219;1234;3964;1296;4183
315770;201704;1367;4321;1182;4008;317;1170;328;1121;645;2291
315780;201704;22084;70529;19894;65897;4055;14715;8261;26524;12316;41239
315790;201704;3648;11892;3186;10994;292;1014;2135;7576;2427;8590
315800;201704;1264;4896;992;4101;224;990;189;752;413;1742
315810;201704;1338;3521;1148;3233;134;420;806;2187;940;2607
315820;201704;2368;7834;2065;7288;497;1803;1055;3795;1552;5598
315830;201704;1148;3670;942;3263;101;431;353;1128;454;1559
315840;201704;767;2012;494;1487;83;257;148;437;231;694
315850;201704;958;3283;904;3202;210;831;531;1791;741;2622
315860;201704;523;1706;378;1407;85;380;97;317;182;697
315870;201704;448;1293;370;1167;36;127;231;697;267;824
315880;201704;1192;3045;942;2720;177;613;390;1098;567;1711
315890;201704;1489;5001;1325;4688;476;1790;505;1748;981;3538
315895;201704;5438;16686;4606;14887;822;2898;1806;5537;2628;8435
315900;201704;783;2220;745;2159;50;214;609;1666;659;1880
315910;201704;482;1606;448;1551;95;359;287;967;382;1326
315920;201704;1620;4400;909;2928;200;715;165;448;365;1163
315930;201704;1054;2771;768;2279;195;604;225;656;420;1260
315935;201704;895;2952;793;2746;206;807;213;730;419;1537
315940;201704;612;1938;529;1775;98;368;252;838;350;1206
315950;201704;1194;3552;1048;3287;211;643;652;2088;863;2731
315960;201704;3722;11498;2490;9058;855;3617;107;245;962;3862
315970;201704;692;1975;542;1764;55;164;373;1257;428;1421
315980;201704;3821;9328;2455;7092;621;1996;643;1654;1264;3650
315990;201704;3963;10997;3195;9693;478;1663;1616;4819;2094;6482
316000;201704;581;1680;478;1534;120;464;176;540;296;1004
316010;201704;642;2030;517;1792;52;224;258;821;310;1045
316020;201704;979;3124;864;2917;86;399;592;1891;678;2290
316030;201704;3122;9021;2290;7510;172;677;1398;4657;1570;5334
316040;201704;3018;9491;2305;8020;404;1587;409;1228;813;2815
316045;201704;2003;6095;1857;5853;194;613;1357;4334;1551;4947
316050;201704;356;1115;280;981;47;203;145;479;192;682
316060;201704;706;2050;558;1814;69;315;334;1008;403;1323
316070;201704;6159;18761;5264;16841;1101;3935;2166;6617;3267;10552
316080;201704;725;2564;635;2343;154;625;79;294;233;919
316090;201704;523;1606;381;1308;63;262;125;399;188;661
316095;201704;1441;4507;1228;4133;140;479;763;2578;903;3057
316100;201704;2623;8464;1973;6950;449;1735;488;1592;937;3327
316105;201704;934;2631;704;2240;164;554;279;909;443;1463
316110;201704;11996;39542;10728;37400;1474;5415;6894;24567;8368;29982
316120;201704;1116;3529;865;2933;201;726;218;642;419;1368
316130;201704;1491;3416;892;2527;134;450;355;934;489;1384
316140;201704;962;2707;748;2401;97;321;463;1521;560;1842
316150;201704;1521;4044;1317;3694;186;594;747;2019;933;2613
316160;201704;1171;3395;921;2935;147;519;468;1416;615;1935
316165;201704;938;2435;767;2204;136;464;430;1225;566;1689
316170;201704;1275;3551;937;2989;143;499;408;1216;551;1715
316180;201704;1452;4462;1012;3514;240;928;163;494;403;1422
316190;201704;2860;8687;1554;5373;297;1008;317;990;614;1998
316200;201704;3749;11759;2872;10027;615;2513;738;2454;1353;4967
316210;201704;4566;14527;3814;13013;1331;4807;535;1849;1866;6656
316220;201704;783;2409;554;1938;119;471;54;198;173;669
316225;201704;1215;3246;1003;2901;129;427;638;1783;767;2210
316230;201704;434;1230;358;1101;42;136;173;574;215;710
316240;201704;6487;19497;5721;18472;655;2179;4183;13647;4838;15826
316245;201704;3228;11030;2956;10602;255;1296;2226;7761;2481;9057
316250;201704;10293;29246;7909;24626;2135;7304;1713;5053;3848;12357
316255;201704;2561;7553;2240;7139;276;983;1562;5056;1838;6039
316257;201704;1287;3445;970;2886;150;507;382;1091;532;1598
316260;201704;1834;4994;1435;4411;85;315;784;2540;869;2855
316265;201704;1349;3733;990;3048;78;274;619;1879;697;2153
316270;201704;3561;11898;3279;11265;800;2998;1326;4399;2126;7397
316280;201704;3128;9960;2854;9416;469;1734;1516;4850;1985;6584
316290;201704;3367;10244;2797;9130;515;1911;1044;3416;1559;5327
316292;201704;3648;11017;3176;10259;443;1661;2081;6517;2524;8178
316294;201704;809;2534;604;2130;123;504;70;252;193;756
316295;201704;1832;5906;1713;5684;168;708;1225;3938;1393;4646
316300;201704;1001;3145;849;2864;64;233;523;1814;587;2047
316310;201704;701;2016;478;1615;89;345;153;496;242;841
316320;201704;607;1892;499;1691;99;400;131;408;230;808
316330;201704;1001;2995;774;2485;76;283;502;1559;578;1842
316340;201704;936;2934;751;2564;129;536;388;1251;517;1787
316350;201704;1262;3992;1144;3790;155;567;711;2354;866;2921
316360;201704;727;1918;582;1705;55;173;404;1176;459;1349
316370;201704;4500;14023;3765;12567;1100;4128;644;1967;1744;6095
316380;201704;1624;4176;1285;3717;65;223;950;2750;1015;2973
316390;201704;871;2438;722;2204;145;483;333;1030;478;1513
316400;201704;1283;3878;972;3314;187;698;396;1307;583;2005
316410;201704;1006;3279;926;3159;120;426;681;2307;801;2733
316420;201704;1921;5987;1686;5676;160;635;1194;3949;1354;4584
316430;201704;937;2834;653;2222;151;562;150;479;301;1041
316440;201704;675;2173;555;1996;189;783;105;398;294;1181
316443;201704;635;1866;506;1625;116;422;178;546;294;968
316447;201704;1651;4766;1482;4536;94;335;1224;3754;1318;4089
316450;201704;2150;7041;1812;6373;189;747;1224;4261;1413;5008
316460;201704;805;2447;733;2316;230;745;319;993;549;1738
316470;201704;7232;22592;5809;19714;1447;5640;1546;4965;2993;10605
316480;201704;182;603;155;541;39;142;41;137;80;279
316490;201704;332;978;257;824;51;161;97;285;148;446
316500;201704;1186;4076;803;2988;150;614;58;194;208;808
316510;201704;734;2667;656;2521;215;897;180;674;395;1571
316520;201704;1024;3011;846;2710;145;538;343;997;488;1535
316530;201704;836;2647;696;2390;139;599;284;841;423;1440
316540;201704;736;2339;654;2186;94;387;209;647;303;1034
316550;201704;1202;3929;1127;3800;166;629;721;2423;887;3052
316553;201704;2228;7532;1689;6143;506;1989;301;1059;807;3048
316555;201704;2837;9498;2507;9078;204;839;1882;6955;2086;7794
316556;201704;636;1583;477;1325;42;133;282;720;324;853
316557;201704;795;2835;737;2735;322;1258;209;736;531;1994
316560;201704;282;1017;242;933;66;298;60;214;126;512
316570;201704;1198;3813;1055;3519;244;850;386;1310;630;2160
316580;201704;334;877;218;655;59;186;56;170;115;356
316590;201704;1447;3889;1034;3192;189;675;539;1531;728;2206
316600;201704;1040;3358;935;3157;196;725;436;1460;632;2185
316610;201704;578;2055;500;1897;78;401;303;1080;381;1481
316620;201704;2210;6510;1881;5977;161;640;1260;3956;1421;4596
316630;201704;1442;4680;1208;4187;414;1420;427;1594;841;3014
316640;201704;166;518;145;478;32;135;61;167;93;302
316650;201704;933;3250;796;3050;87;363;546;2134;633;2497
316660;201704;192;496;93;289;7;29;15;39;22;68
316670;201704;1937;5282;1553;4621;505;1638;484;1371;989;3009
316680;201704;2026;5300;1591;4677;141;458;1158;3361;1299;3819
316690;201704;1160;3878;1029;3600;281;1125;307;1051;588;2176
316695;201704;1065;3293;936;3045;88;349;606;1945;694;2294
316700;201704;385;1086;337;1019;34;144;225;625;259;769
316710;201704;2704;9925;2303;9041;814;3310;619;2663;1433;5973
316720;201704;16349;51865;13540;45793;3297;11866;4049;13390;7346;25256
316730;201704;344;1055;305;968;78;283;118;344;196;627
316740;201704;691;2217;634;2122;69;301;437;1461;506;1762
316750;201704;402;1324;333;1177;56;229;113;381;169;610
316760;201704;3556;11516;3016;10742;1382;5188;1030;3741;2412;8929
316770;201704;1412;3797;1223;3531;55;219;1029;2954;1084;3173
316780;201704;580;1906;498;1734;152;577;56;165;208;742
316790;201704;760;2186;608;1925;164;563;191;607;355;1170
316800;201704;5202;16594;4470;15146;811;3002;2326;7535;3137;10537
316805;201704;811;2030;783;1991;32;53;682;1837;714;1890
316810;201704;631;1879;495;1603;135;502;191;549;326;1051
316820;201704;398;1012;221;701;37;137;30;96;67;233
316830;201704;568;1919;533;1846;129;509;271;906;400;1415
316840;201704;2732;8233;2413;7653;500;1787;1104;3383;1604;5170
316850;201704;2094;5869;1697;5227;227;814;992;2985;1219;3799
316860;201704;17713;54817;15104;50056;3332;12581;5932;19047;9264;31628
316870;201704;6249;19742;5047;17073;1433;5207;1053;3448;2486;8655
316880;201704;871;2580;751;2372;192;691;254;786;446;1477
316890;201704;1298;2988;901;2458;201;663;512;1276;713;1939
316900;201704;2524;7308;1991;6225;469;1675;596;1636;1065;3311
316905;201704;456;1475;389;1326;118;426;145;493;263;919
316910;201704;923;2760;648;2219;158;620;88;277;246;897
316920;201704;1581;4209;1121;3554;241;860;445;1389;686;2249
316930;201704;7751;25905;6145;22490;1442;5770;956;3366;2398;9136
316935;201704;4386;13201;3203;10679;827;2973;733;2426;1560;5399
316940;201704;6741;21442;5365;18463;1216;4543;1280;4114;2496;8657
316950;201704;1604;4232;1321;3844;87;295;989;2831;1076;3126
316960;201704;4765;11957;3761;10536;633;1910;2130;5907;2763;7817
316970;201704;3198;10007;3003;9648;627;2321;1289;3854;1916;6175
316980;201704;916;2737;647;2227;201;759;95;330;296;1089
316990;201704;9730;30090;7923;26105;2324;8237;726;2312;3050;10549
317000;201704;2769;9230;2667;9116;212;656;2102;7934;2314;8590
317005;201704;2646;8030;2296;7438;490;1660;1154;3755;1644;5415
317010;201704;26992;66425;16478;50233;4046;13929;3115;10191;7161;24120
317020;201704;65352;174343;38979;122128;7756;26684;7308;21183;15064;47867
317030;201704;699;2040;594;1876;44;180;385;1195;429;1375
317040;201704;10128;28694;7931;24810;1977;6583;2988;9476;4965;16059
317043;201704;744;1943;614;1760;119;352;325;917;444;1269
317047;201704;1131;2956;854;2504;68;219;516;1512;584;1731
317050;201704;1451;4829;1105;4007;215;841;349;1142;564;1983
317052;201704;2245;7239;2080;6963;186;739;1515;4971;1701;5710
317057;201704;1609;4391;1224;3718;96;372;787;2293;883;2665
317060;201704;426;1195;265;860;61;226;64;188;125;414
317065;201704;1286;3796;1126;3532;65;260;872;2680;937;2940
317070;201704;9032;27696;6267;21594;1408;5437;785;2629;2193;8066
317075;201704;1059;3175;835;2710;188;650;197;619;385;1269
317080;201704;6209;16366;5119;14551;1596;4748;1503;4117;3099;8865
317090;201704;4735;15287;4405;14792;451;1597;3163;10714;3614;12311
317100;201704;2952;7860;2134;6493;699;2285;621;1845;1320;4130
317103;201704;1806;6182;1590;5772;217;1000;894;3106;1111;4106
317107;201704;1352;4037;1174;3702;112;447;765;2235;877;2682
317110;201704;735;1765;415;1243;66;239;147;460;213;699
317115;201704;1145;3480;975;3126;79;268;686;2204;765;2472
317120;201704;10684;34695;8707;30252;1834;7046;3662;12353;5496;19399
317130;201704;7337;21170;5903;18569;1337;4646;2146;6674;3483;11320
317140;201704;559;1760;506;1671;72;259;319;1037;391;1296
317150;201704;990;2686;851;2518;62;210;673;1975;735;2185
317160;201704;3473;8973;2563;7713;184;605;1780;5325;1964;5930
317170;201704;1965;5212;1468;4374;214;736;519;1358;733;2094
317180;201704;1770;5866;1434;5143;371;1393;329;1150;700;2543
317190;201704;1368;3806;1059;3353;67;232;703;2220;770;2452
317200;201704;4437;13581;3746;12177;965;3474;1020;3163;1985;6637
317210;201704;943;2768;815;2597;102;413;547;1704;649;2117
317220;201704;277;934;262;910;65;255;126;426;191;681
320010;201704;4848;14996;4120;13573;655;2317;2255;7299;2910;9616
320013;201704;1896;5706;1341;4498;237;825;541;1876;778;2701
320016;201704;3007;8306;2552;7653;216;610;1931;5834;2147;6444
320020;201704;3748;11481;3077;10170;869;3035;927;3140;1796;6175
320030;201704;1692;5296;1274;4392;374;1363;373;1237;747;2600
320035;201704;1784;5230;1531;4818;522;1816;589;1746;1111;3562
320040;201704;3142;9968;2636;8985;575;2111;1008;3397;1583;5508
320050;201704;1637;4359;1433;4007;342;1001;670;1841;1012;2842
320060;201704;11075;34722;8398;28720;2114;7866;1675;5506;3789;13372
320070;201704;1436;4451;1157;3858;260;953;317;1015;577;1968
320080;201704;5542;15718;4233;13110;947;3040;1367;4326;2314;7366
320090;201704;7734;22230;6153;19052;1577;5173;2234;6733;3811;11906
320100;201704;2562;7974;2086;7004;636;2185;630;2140;1266;4325
320110;201704;1204;3550;1026;3217;267;852;259;837;526;1689
320115;201704;1808;6316;1645;6032;823;3118;437;1680;1260;4798
320120;201704;15526;45902;11988;39188;2951;10613;3279;10679;6230;21292
320130;201704;35854;113173;32252;106200;6312;23442;15501;49532;21813;72974
320140;201704;3318;10347;2407;8346;645;2491;441;1517;1086;4008
320150;201704;14098;39929;10804;33396;3222;10678;1203;3468;4425;14146
320160;201704;4954;15292;4187;13753;1039;3740;1577;5015;2616;8755
320170;201704;1640;5194;1360;4570;304;1080;575;1899;879;2979
320180;201704;739;2512;638;2325;225;852;161;611;386;1463
320190;201704;3491;11885;2754;10092;710;2721;464;1670;1174;4391
320200;201704;966;2956;785;2639;250;925;208;728;458;1653
320210;201704;4524;12685;3786;11251;747;2462;1781;4987;2528;7449
320220;201704;2218;6784;1854;6136;462;1675;807;2693;1269;4368
320225;201704;1284;4289;997;3592;337;1275;153;567;490;1842
320230;201704;4173;13170;3497;11971;1000;3690;1345;4677;2345;8367
320240;201704;12825;37086;10382;32816;2592;8847;3320;10618;5912;19465
320245;201704;3081;10358;2823;9755;968;3530;708;2406;1676;5936
320250;201704;1893;5714;1359;4482;378;1410;217;641;595;2051
320255;201704;1693;5708;1485;5345;558;2088;577;2182;1135;4270
320260;201704;1056;3168;810;2643;236;849;203;557;439;1406
320265;201704;2449;7757;2079;7098;766;2732;743;2548;1509;5280
320270;201704;2697;7795;1985;6456;389;1355;901;3015;1290;4370
320280;201704;6282;19255;5418;17539;1413;4972;1422;4332;2835;9304
320290;201704;1419;4543;1011;3550;309;1166;152;520;461;1686
320300;201704;4126;13647;3587;12420;1196;4414;731;2510;1927;6924
320305;201704;4452;14087;3797;12632;937;3334;1474;4849;2411;8183
320310;201704;1864;5572;1551;4912;375;1225;594;1872;969;3097
320313;201704;2125;5998;1452;4533;334;1196;281;824;615;2020
320316;201704;1660;4950;1323;4255;411;1367;401;1283;812;2650
320320;201704;19615;58134;15308;50267;4160;14854;4850;15766;9010;30620
320330;201704;2924;8569;2391;7631;642;2046;980;3315;1622;5361
320332;201704;5306;16732;4585;15382;1389;4943;1758;5853;3147;10796
320334;201704;2040;6330;1408;4963;334;1306;314;1075;648;2381
320335;201704;2235;6546;1404;4601;380;1365;187;557;567;1922
320340;201704;5499;14778;4725;13491;1022;3145;2147;6283;3169;9428
320350;201704;5061;13333;3800;11029;669;2040;1736;4985;2405;7025
320360;201704;1627;4319;1210;3517;198;600;497;1386;695;1986
320370;201704;2791;9186;2249;7916;644;2340;681;2379;1325;4719
320380;201704;2153;6348;1910;5922;390;1330;998;3010;1388;4340
320390;201704;7027;20854;5694;18025;1600;5436;1710;5190;3310;10626
320400;201704;3475;10561;3030;9757;629;2193;1399;4468;2028;6661
320405;201704;4261;12274;3691;11267;712;2346;2023;6048;2735;8394
320410;201704;5254;14313;3943;12382;870;2936;1776;5737;2646;8673
320420;201704;2443;7262;1959;6386;594;2162;449;1441;1043;3603
320425;201704;2003;5177;1588;4496;160;487;979;2730;1139;3217
320430;201704;2559;7055;2171;6258;408;1259;1174;3246;1582;4505
320435;201704;2682;8541;2188;7571;931;3365;548;2008;1479;5373
320440;201704;1028;3323;899;2998;198;735;322;1024;520;1759
320450;201704;1914;5911;1560;5215;399;1475;651;2093;1050;3568
320455;201704;4109;13271;3067;10820;828;3103;689;2348;1517;5451
320460;201704;2605;8187;1901;6584;476;1792;364;1161;840;2953
320465;201704;1545;4686;1179;3893;167;604;556;1844;723;2448
320470;201704;4188;12314;2973;9708;836;2986;606;1908;1442;4894
320480;201704;1671;5211;1446;4750;321;1151;602;1933;923;3084
320490;201704;15317;46174;12927;41933;3502;12456;4068;13227;7570;25683
320495;201704;1331;3831;875;2899;274;956;126;451;400;1407
320500;201704;47734;141123;41494;130042;8879;30092;20105;61734;28984;91826
320501;201704;4707;14191;3683;12469;1111;4228;971;3201;2082;7429
320503;201704;1901;6360;1531;5557;550;2237;431;1412;981;3649
320506;201704;4077;12430;2888;9673;817;2911;102;268;919;3179
320510;201704;8312;25467;7231;23462;1489;5328;3539;11288;5028;16616
320515;201704;1859;5354;1521;4626;466;1479;344;1049;810;2528
320517;201704;2061;6568;1656;5769;529;1983;377;1300;906;3283
320520;201704;35748;106365;29440;95108;7134;25518;10326;32924;17460;58442
320530;201704;27754;82421;23106;73732;4157;15515;11509;34599;15666;50114
330010;201704;20024;61172;18011;57453;3954;13317;9398;30139;13352;43456
330015;201704;1488;4125;1285;3761;207;718;603;1720;810;2438
330020;201704;17894;51310;16252;48620;2855;9453;9903;28920;12758;38373
330022;201704;1893;5514;1578;4984;303;1052;875;2726;1178;3778
330023;201704;3135;9536;2714;8863;768;2717;820;2591;1588;5308
330025;201704;4620;12430;3505;10427;930;2942;1453;4358;2383;7300
330030;201704;8194;26748;7207;24823;1405;5371;3501;11551;4906;16922
330040;201704;11530;34436;10503;32436;2056;6898;5839;17488;7895;24386
330045;201704;74174;200448;64276;186574;8011;25159;43519;124711;51530;149870
330050;201704;2400;7210;2000;6476;541;1883;735;2255;1276;4138
330060;201704;5601;15889;4765;14609;1061;3685;2296;6799;3357;10484
330070;201704;19612;58819;17625;55542;3758;12853;8649;27284;12407;40137
330080;201704;8035;22387;7395;21391;680;2033;5239;15112;5919;17145
330090;201704;2604;6867;2323;6445;352;1100;1305;3504;1657;4604
330093;201704;1924;5723;1610;5168;301;998;756;2564;1057;3562
330095;201704;1004;3370;866;3053;180;708;328;1112;508;1820
330100;201704;59312;181625;53902;173040;7647;28172;32474;103045;40121;131217
330110;201704;2237;6951;1973;6498;482;1718;694;2239;1176;3957
330115;201704;1755;5051;1524;4694;271;948;843;2509;1114;3457
330120;201704;2698;7267;2369;6777;353;1171;1512;4236;1865;5407
330130;201704;3273;10489;2922;9874;686;2528;1416;4705;2102;7233
330140;201704;3080;9375;2808;8963;544;2000;1567;4908;2111;6908
330150;201704;2044;6040;1644;5258;434;1466;427;1375;861;2841
330160;201704;1125;3489;985;3254;259;980;456;1418;715;2398
330170;201704;98710;293441;89798;279126;17528;58013;49439;152399;66967;210412
330180;201704;2073;5942;1732;5328;120;494;1146;3380;1266;3874
330185;201704;8239;25021;7141;22922;1349;4728;3922;12296;5271;17024
330187;201704;3804;10774;3251;9875;503;1678;2021;6052;2524;7730
330190;201704;25390;70987;23712;68445;3627;10954;16766;48249;20393;59203
330200;201704;13843;42816;12350;40337;3054;10259;6218;20666;9272;30925
330205;201704;2032;5576;1767;5126;210;681;1114;3153;1324;3834
330210;201704;3034;8403;2505;7390;598;1796;827;2426;1425;4222
330220;201704;10062;30214;8593;27149;2183;7487;2132;6248;4315;13735
330225;201704;3676;11328;3181;10401;404;1670;1828;5695;2232;7365
330227;201704;16537;47299;14870;44883;2998;9318;8848;27192;11846;36510
330230;201704;1229;3626;1112;3450;168;624;655;1944;823;2568
330240;201704;17577;52931;14992;48183;4570;15843;4805;14963;9375;30806
330245;201704;1228;3661;937;3140;234;846;189;602;423;1448
330250;201704;34702;101177;31513;95923;9068;27939;12597;39813;21665;67752
330260;201704;4112;12675;3542;11536;663;2367;1529;4776;2192;7143
330270;201704;19543;44075;13142;35521;3019;9143;4785;13011;7804;22154
330280;201704;2222;6527;1860;5832;314;1128;902;2655;1216;3783
330285;201704;18018;51040;16165;48228;2745;8982;9879;28988;12624;37970
330290;201704;3219;9276;2845;8688;475;1626;1574;4625;2049;6251
330300;201704;3171;10230;2845;9593;513;1984;1594;5139;2107;7123
330310;201704;2173;6094;1844;5533;220;685;1154;3466;1374;4151
330320;201704;12889;38560;12048;37244;1537;5264;8827;26986;10364;32250
330330;201704;27671;75079;24090;69531;4188;13558;14400;40188;18588;53746
330340;201704;14153;40551;11138;35124;2715;9218;3678;11341;6393;20559
330350;201704;86724;249067;77720;236208;10688;34817;52540;159358;63228;194175
330360;201704;6000;17381;5676;16910;553;1762;4359;12881;4912;14643
330370;201704;3502;12261;3146;11526;1067;4063;988;3625;2055;7688
330380;201704;5040;16066;4245;14460;1044;3948;1431;4680;2475;8628
330385;201704;3843;13121;3507;12447;1027;3864;1381;4959;2408;8823
330390;201704;22031;71123;19238;65464;4790;17615;7827;26091;12617;43706
330395;201704;3018;8707;2763;8290;240;869;1829;5408;2069;6277
330400;201704;2651;8151;2402;7697;287;1168;1553;4608;1840;5776
330410;201704;2819;8439;2230;7335;427;1574;1016;3162;1443;4736
330411;201704;2289;7069;1996;6462;247;924;1204;3718;1451;4642
330412;201704;1384;4613;1168;4167;219;854;536;1789;755;2643
330414;201704;23573;65761;20539;61482;3952;11812;11990;36338;15942;48150
330415;201704;3224;9943;2774;9142;671;2232;1101;3701;1772;5933
330420;201704;9587;26882;6560;21464;1394;4955;1425;4529;2819;9484
330430;201704;7122;20882;6299;19347;1341;4475;2899;8622;4240;13097
330440;201704;1534;5084;1376;4777;429;1667;381;1187;810;2854
330450;201704;1330;4331;1191;4091;246;1025;616;2036;862;3061
330452;201704;13794;40227;11108;35127;2637;9056;4620;14253;7257;23309
330455;201704;497923;1347314;404891;1197010;81612;258376;209049;610146;290661;868522
330460;201704;1162;3728;1014;3458;217;816;439;1462;656;2278
330470;201704;4265;12650;3788;11811;861;2915;1767;5382;2628;8297
330475;201704;7662;23415;6758;21918;2018;7132;2539;8004;4557;15136
330480;201704;5643;16268;5055;15403;826;2686;2986;8909;3812;11595
330490;201704;109510;284525;97150;266270;10666;31169;67054;182096;77720;213265
330500;201704;5229;15835;5004;15442;683;2319;3519;10747;4202;13066
330510;201704;36375;110188;32357;103785;10155;32949;13566;44575;23721;77524
330513;201704;1314;3943;1214;3768;368;1173;523;1649;891;2822
330515;201704;2975;9082;2579;8302;842;2787;705;2263;1547;5050
330520;201704;10896;32866;9709;30712;2004;6821;4426;13702;6430;20523
330530;201704;1453;4157;1236;3755;301;1019;544;1553;845;2572
330540;201704;2883;8375;2362;7418;612;2041;846;2554;1458;4595
330550;201704;7679;25528;6783;23793;2853;10389;1146;4183;3999;14572
330555;201704;9572;28265;8566;26784;1563;5058;5217;16611;6780;21669
330560;201704;4227;12627;3767;11753;597;2047;2036;6134;2633;8181
330570;201704;3108;9131;2634;8317;636;2121;1257;3946;1893;6067
330575;201704;5213;14683;4652;13664;623;2101;3117;8791;3740;10892
330580;201704;13112;40822;10991;36510;3042;10706;4152;13708;7194;24414
330590;201704;1517;4600;1423;4453;209;708;978;3077;1187;3785
330600;201704;11214;32528;9001;28569;1498;5302;4266;13369;5764;18671
330610;201704;8510;26510;7676;25010;1286;4770;4282;13594;5568;18364
330615;201704;1600;5593;1488;5402;579;2192;533;1988;1112;4180
330620;201704;3419;11754;3038;10949;1118;4318;611;2159;1729;6477
330630;201704;23130;66104;18872;58577;2740;9908;10774;32118;13514;42026
350010;201704;1743;5093;1168;3938;298;1055;127;385;425;1440
350020;201704;447;1220;314;962;40;135;168;480;208;615
350030;201704;4473;13784;3430;11688;998;3660;847;2864;1845;6524
350040;201704;449;1493;330;1222;71;285;99;345;170;630
350050;201704;859;2596;691;2272;162;611;217;603;379;1214
350055;201704;663;1916;563;1750;86;302;360;1101;446;1403
350060;201704;112;344;91;311;23;89;44;150;67;239
350070;201704;3872;11237;2470;8360;501;1793;562;1736;1063;3529
350075;201704;545;1805;424;1548;168;635;74;255;242;890
350080;201704;660;1891;415;1338;64;237;162;500;226;737
350090;201704;607;1601;387;1155;93;257;127;381;220;638
350100;201704;1943;5944;1397;4843;259;1048;479;1543;738;2591
350110;201704;463;1411;344;1150;31;122;192;622;223;744
350115;201704;1231;3658;1080;3366;210;713;537;1532;747;2245
350120;201704;836;2458;518;1778;68;225;254;964;322;1189
350130;201704;3323;9720;2879;8844;371;1281;1608;4688;1979;5969
350140;201704;581;1897;485;1712;56;243;272;935;328;1178
350150;201704;455;1480;396;1355;130;478;96;328;226;806
350160;201704;8722;24540;5859;19034;1119;4104;2535;7632;3654;11736
350170;201704;1491;4987;1242;4371;317;1179;280;951;597;2130
350180;201704;1120;3039;685;2101;105;356;320;950;425;1306
350190;201704;3151;9619;2489;8244;519;1978;1015;2910;1534;4888
350200;201704;383;1160;344;1086;25;81;233;728;258;809
350210;201704;4982;13056;3537;10587;872;2723;1485;4416;2357;7139
350220;201704;2400;7576;2072;6820;426;1675;935;2843;1361;4518
350230;201704;757;2361;674;2197;159;548;291;948;450;1496
350240;201704;540;1622;415;1338;50;188;224;687;274;875
350250;201704;2018;7167;1851;6847;671;2672;553;2034;1224;4706
350260;201704;974;2543;645;1929;117;361;273;788;390;1149
350270;201704;4886;14651;4055;12878;744;2577;1795;5380;2539;7957
350275;201704;1848;5972;1665;5676;484;1728;627;2120;1111;3848
350280;201704;21670;52161;13606;38672;2781;8446;3562;9953;6343;18399
350290;201704;2263;7085;1770;6045;362;1380;590;1926;952;3306
350300;201704;550;1574;410;1273;80;238;172;518;252;756
350310;201704;881;2903;757;2606;106;422;299;983;405;1405
350315;201704;503;1569;376;1279;71;274;98;306;169;580
350320;201704;10499;32536;9366;30415;2721;9337;1578;5419;4299;14756
350330;201704;14469;39532;9957;29515;1843;5329;3821;10750;5664;16079
350335;201704;388;1196;344;1109;20;62;260;845;280;907
350340;201704;1078;3141;750;2492;151;558;231;769;382;1327
350350;201704;713;2187;606;2034;123;452;206;682;329;1134
350360;201704;833;2784;708;2505;166;577;290;1052;456;1629
350370;201704;551;1620;406;1297;100;325;79;243;179;568
350380;201704;4333;12594;3068;10217;735;2693;867;2699;1602;5392
350390;201704;9355;28209;8075;25777;2322;7627;2918;9169;5240;16796
350395;201704;364;1000;183;623;31;109;51;153;82;262
350400;201704;7909;22390;6227;19292;1542;5257;2110;6178;3652;11435
350410;201704;8347;27137;6595;23527;1801;7016;1327;4457;3128;11473
350420;201704;555;1728;422;1489;90;374;53;177;143;551
350430;201704;685;2107;583;1924;93;368;332;1051;425;1419
350440;201704;1301;4028;1087;3525;245;769;462;1495;707;2264
350450;201704;7436;22888;6044;20045;1411;5015;1600;5092;3011;10107
350460;201704;1406;3793;859;2704;165;588;286;834;451;1422
350470;201704;243;640;202;570;25;91;131;349;156;440
350480;201704;767;2242;543;1799;94;359;96;283;190;642
350490;201704;1832;5451;1531;4932;354;1238;511;1528;865;2766
350500;201704;566;1687;492;1544;78;294;257;773;335;1067
350510;201704;1072;3211;806;2643;115;438;347;1083;462;1521
350520;201704;1577;5661;1255;4877;263;1101;342;1288;605;2389
350530;201704;2287;6634;1846;5748;529;1728;478;1418;1007;3146
350535;201704;1262;4009;1176;3863;163;665;783;2451;946;3116
350540;201704;1758;4887;1323;4120;323;1066;483;1533;806;2599
350550;201704;10362;27213;7214;22067;1270;4442;2730;7846;4000;12288
350560;201704;3362;10882;2939;9880;378;1349;1642;5457;2020;6806
350570;201704;18289;58279;16146;54037;4529;16478;6304;20136;10833;36614
350580;201704;1749;5509;1137;3954;228;847;123;348;351;1195
350590;201704;3871;11849;3033;10156;790;2987;1157;3534;1947;6521
350600;201704;42747;104559;28179;78949;4483;13767;12085;31478;16568;45245
350610;201704;6774;19985;5406;17425;1124;3966;2255;7075;3379;11041
350620;201704;410;1150;303;983;46;187;136;404;182;591
350630;201704;1630;4601;1207;3796;181;687;521;1492;702;2179
350635;201704;6757;19421;5315;16937;1170;4099;2245;6974;3415;11073
350640;201704;803;2454;549;1830;95;336;137;421;232;757
350650;201704;7978;23632;5117;16919;1091;3976;1130;3482;2221;7458
350660;201704;4839;13881;3923;12252;727;2486;1902;5857;2629;8343
350670;201704;1519;4728;1397;4489;323;1095;692;2172;1015;3267
350680;201704;1048;3094;774;2563;172;642;323;1045;495;1687
350690;201704;844;2733;661;2336;141;556;237;776;378;1332
350700;201704;4214;12192;2962;10039;639;2420;1052;3282;1691;5702
350710;201704;2653;8156;2295;7460;360;1306;1286;4075;1646;5381
350715;201704;743;2227;656;2044;95;326;373;1100;468;1426
350720;201704;126;355;113;334;26;84;41;116;67;200
350730;201704;412;1475;384;1409;84;342;173;625;257;967
350740;201704;1753;5281;1236;4105;229;824;322;969;551;1793
350745;201704;520;1599;316;1076;48;180;142;438;190;618
350750;201704;9060;27462;7542;24452;1732;6253;2076;6224;3808;12477
350760;201704;13095;37694;10418;32941;2756;9530;2614;7458;5370;16988
350770;201704;647;1816;449;1429;48;160;242;759;290;919
350775;201704;609;1598;493;1406;51;181;244;671;295;852
350780;201704;1845;5565;1437;4773;386;1423;298;1028;684;2451
350790;201704;1825;5612;1342;4639;305;1117;243;744;548;1861
350800;201704;2940;9651;2749;9286;494;1908;1451;4705;1945;6613
350810;201704;1982;5534;1696;5130;414;1330;818;2574;1232;3904
350820;201704;614;1662;423;1296;68;232;157;460;225;692
350830;201704;845;2593;539;1884;75;281;139;439;214;720
350840;201704;2580;8760;2079;7704;660;2626;519;1847;1179;4473
350850;201704;5947;19493;4985;17438;1495;5474;1181;4113;2676;9587
350860;201704;3156;9536;2958;9226;152;645;2283;7004;2435;7649
350870;201704;2692;8400;2175;7509;450;1730;1192;4138;1642;5868
350880;201704;1300;4259;1038;3632;243;890;262;889;505;1779
350890;201704;649;1811;403;1278;52;173;108;294;160;467
350900;201704;5225;15931;3747;12715;1160;4317;445;1417;1605;5734
350910;201704;879;2534;755;2282;175;596;388;1123;563;1719
350920;201704;11254;31103;9935;28912;850;2868;7253;20286;8103;23154
350925;201704;4399;13570;3505;11805;833;3034;1184;3504;2017;6538
350930;201704;1510;4193;1077;3303;131;431;578;1690;709;2121
350940;201704;1795;5822;1638;5502;285;1111;921;2981;1206;4092
350945;201704;907;2809;759;2538;128;512;367;1136;495;1648
350950;201704;75908;224084;61726;193405;12010;41355;29053;86017;41063;127372
350960;201704;4763;15526;4075;14094;799;3164;2064;6792;2863;9956
350970;201704;4051;13762;3392;12157;1103;4293;556;1777;1659;6070
350980;201704;622;2011;537;1823;223;806;167;559;390;1365
350990;201704;1751;5728;1417;5105;378;1500;412;1410;790;2910
350995;201704;775;2592;729;2496;91;407;458;1469;549;1876
351000;201704;2798;8196;2258;7173;406;1421;885;2652;1291;4073
351010;201704;327;941;196;644;42;147;67;219;109;366
351015;201704;722;2456;614;2251;143;575;281;1010;424;1585
351020;201704;7939;24380;6867;22649;1695;5848;3310;10929;5005;16777
351030;201704;2103;7048;1796;6286;388;1510;701;2311;1089;3821
351040;201704;3596;10582;3261;10015;374;1303;2292;6830;2666;8133
351050;201704;15522;42470;10925;34655;2571;8867;3347;10597;5918;19464
351060;201704;39623;111276;32087;98103;5713;19264;16699;49697;22412;68961
351070;201704;1389;3855;895;2946;233;835;93;267;326;1102
351080;201704;2709;7679;2048;6855;474;1769;929;2924;1403;4693
351090;201704;341;1152;266;999;53;224;49;176;102;400
351100;201704;2399;7159;1640;5295;439;1506;459;1486;898;2992
351110;201704;6419;16348;3754;11993;815;2918;934;2825;1749;5743
351120;201704;675;1979;523;1674;78;268;221;609;299;877
351130;201704;1020;2862;509;1760;82;286;105;355;187;641
351140;201704;1658;5525;1368;4904;423;1649;301;1008;724;2657
351150;201704;1404;4837;990;3763;214;857;99;310;313;1167
351160;201704;1178;4046;1034;3706;268;1022;333;1055;601;2077
351170;201704;1359;4244;1161;3811;158;586;611;1890;769;2476
351190;201704;814;2568;636;2125;105;360;193;626;298;986
351200;201704;1836;5376;1550;4854;175;620;694;2042;869;2662
351210;201704;1267;3509;876;2718;126;445;349;981;475;1426
351220;201704;2931;9691;2682;9161;394;1516;1527;5073;1921;6589
351230;201704;1802;5449;1456;4821;295;1124;696;2165;991;3289
351240;201704;1109;3306;833;2726;203;690;320;975;523;1665
351250;201704;929;2728;575;1881;94;307;196;616;290;923
351260;201704;906;2632;765;2342;237;721;204;604;441;1325
351270;201704;319;1034;277;943;70;270;110;319;180;589
351280;201704;5136;14493;3879;12053;698;2405;1502;4467;2200;6872
351290;201704;953;2691;671;2127;145;469;274;833;419;1302
351300;201704;12905;40532;9690;33814;2263;8649;3084;10735;5347;19384
351310;201704;2929;8835;2363;7772;443;1644;1111;3419;1554;5063
351320;201704;850;2803;703;2418;130;507;243;773;373;1280
351330;201704;607;2181;550;2089;70;208;378;1557;448;1765
351340;201704;5561;18286;4700;16584;1272;4721;1746;6161;3018;10882
351350;201704;7203;22844;6242;20904;1594;5608;2422;7760;4016;13368
351360;201704;3885;11939;3550;11302;913;3206;1096;3207;2009;6413
351370;201704;2267;6950;1761;5828;363;1351;700;2101;1063;3452
351380;201704;39046;110724;34355;102155;6653;21072;15751;45784;22404;66856
351385;201704;257;751;182;585;22;82;61;170;83;252
351390;201704;1189;3713;989;3288;253;1012;426;1251;679;2263
351400;201704;918;2972;867;2857;238;861;430;1388;668;2249
351410;201704;2366;7123;2028;6472;294;947;1163;3656;1457;4603
351420;201704;300;820;196;622;42;134;51;157;93;291
351430;201704;776;2425;727;2340;88;319;557;1768;645;2087
351440;201704;3161;9371;2331;7539;471;1596;333;984;804;2580
351450;201704;1524;4296;1203;3737;293;970;387;1271;680;2241
351460;201704;648;1928;560;1762;267;842;156;494;423;1336
351470;201704;1028;2988;889;2716;132;473;464;1322;596;1795
351480;201704;2696;8625;2449;8204;375;1599;1364;4345;1739;5944
351490;201704;1745;5708;1556;5301;163;705;934;3008;1097;3713
351492;201704;295;933;251;821;14;52;144;455;158;507
351495;201704;199;643;150;514;24;97;64;206;88;303
351500;201704;30806;84139;23091;70300;5389;17625;9315;27282;14704;44907
351510;201704;9585;28218;7693;24450;1637;5599;3773;11733;5410;17332
351512;201704;496;1405;359;1101;50;144;165;495;215;639
351515;201704;2355;7036;1652;5508;382;1415;412;1255;794;2670
351518;201704;2161;6469;1487;5199;333;1297;561;1792;894;3089
351519;201704;767;2253;551;1772;93;336;132;317;225;653
351520;201704;763;2080;361;1256;62;242;104;331;166;573
351530;201704;365;1109;237;775;31;101;61;161;92;262
351535;201704;2302;5882;1747;5005;138;498;1142;3113;1280;3611
351540;201704;1776;5170;1366;4362;483;1667;194;553;677;2220
351550;201704;5064;14892;3581;11512;644;2277;1474;4485;2118;6762
351560;201704;422;1352;363;1214;83;311;65;212;148;523
351565;201704;167;571;149;525;32;116;58;194;90;310
351570;201704;13754;40173;11354;35390;2066;7041;6473;19411;8539;26452
351580;201704;303;827;189;593;34;95;55;180;89;275
351590;201704;459;1170;285;826;25;85;142;378;167;463
351600;201704;1752;4813;1412;4190;169;589;841;2372;1010;2961
351610;201704;677;1800;495;1484;52;187;234;611;286;798
351620;201704;18441;57602;14602;49849;2934;11345;4359;13439;7293;24784
351630;201704;22342;66897;19760;62601;3891;13204;11561;35883;15452;49087
351640;201704;13999;41047;11572;36781;1803;6338;6917;21523;8720;27861
351650;201704;436;1301;210;717;31;119;43;132;74;251
351660;201704;789;2449;561;1872;122;439;110;322;232;761
351670;201704;3925;12297;3153;10452;546;2015;1408;4357;1954;6372
351680;201704;549;1689;330;1132;71;235;68;234;139;469
351685;201704;423;1357;365;1236;88;271;161;554;249;825
351690;201704;1050;3075;757;2446;131;458;297;871;428;1329
351700;201704;1072;3130;922;2831;211;623;345;1060;556;1683
351710;201704;546;1786;455;1567;63;247;189;603;252;850
351720;201704;1540;4572;1078;3524;201;710;337;1051;538;1761
351730;201704;1054;2920;834;2586;153;573;373;1108;526;1681
351740;201704;3985;10784;3165;9171;603;1881;1267;3478;1870;5359
351750;201704;1164;3680;751;2705;136;526;229;823;365;1349
351760;201704;3290;10133;2569;8536;680;2471;720;2195;1400;4666
351770;201704;2113;6630;1766;5951;510;1778;670;2182;1180;3960
351780;201704;1432;3983;794;2543;136;489;170;513;306;1002
351790;201704;1121;3116;942;2826;183;509;529;1622;712;2131
351800;201704;511;1120;279;725;41;115;93;242;134;357
351810;201704;1038;2939;866;2626;91;264;582;1729;673;1993
351820;201704;2535;7970;1844;6460;376;1425;187;650;563;2075
351830;201704;4337;13076;3340;10983;518;1965;1655;5228;2173;7193
351840;201704;6570;22036;5761;20374;1404;5400;2099;7147;3503;12547
351850;201704;2083;5498;1473;4475;208;781;703;1958;911;2739
351860;201704;3081;9769;2653;8873;591;2100;1207;3982;1798;6082
351870;201704;26696;78164;21991;69639;6819;22674;8166;25688;14985;48362
351880;201704;117191;355351;97670;317098;28325;98893;26512;81976;54837;180869
351885;201704;634;2146;578;2029;152;566;244;811;396;1377
351890;201704;617;1899;505;1684;118;415;80;239;198;654
351900;201704;1169;3545;949;3164;251;883;287;952;538;1835
351905;201704;457;1408;362;1222;46;172;177;548;223;720
351907;201704;19094;55000;15873;48974;1205;4580;10959;32833;12164;37413
351910;201704;1049;3175;836;2687;183;644;335;1012;518;1656
351920;201704;955;2562;771;2277;109;374;398;1144;507;1518
351925;201704;1001;2959;818;2594;143;512;365;1053;508;1565
351930;201704;2719;8535;2605;8319;356;1479;1984;6038;2340;7517
351940;201704;980;2886;802;2556;108;381;406;1279;514;1660
351950;201704;1530;4109;1077;3273;110;376;555;1663;665;2039
351960;201704;4530;12934;3395;10788;732;2567;1446;4524;2178;7091
351970;201704;5495;19276;4888;18073;1279;5161;1955;6914;3234;12075
351980;201704;878;2560;636;2032;121;417;233;662;354;1079
351990;201704;1472;4053;1148;3460;214;767;286;756;500;1523
352000;201704;2229;7230;2020;6773;332;1263;1043;3296;1375;4559
352010;201704;1601;5268;1387;4825;349;1290;230;813;579;2103
352020;201704;1427;4362;1217;3961;287;1023;488;1504;775;2527
352030;201704;4832;13989;3999;12755;813;2855;2115;6702;2928;9557
352040;201704;1989;6267;1502;5212;302;1146;238;768;540;1914
352042;201704;3545;9603;2158;6687;408;1348;935;2839;1343;4187
352044;201704;1795;5381;1142;4013;177;674;238;794;415;1468
352050;201704;11298;33976;7741;26018;1838;6998;1368;4112;3206;11110
352060;201704;705;2099;561;1802;102;374;227;665;329;1039
352070;201704;785;1947;623;1681;126;383;223;595;349;978
352080;201704;438;1257;285;912;50;169;90;263;140;432
352090;201704;1313;4420;1055;3785;174;710;289;947;463;1657
352100;201704;2953;8839;2357;7734;574;2026;966;3013;1540;5039
352110;201704;537;1850;450;1656;123;466;153;528;276;994
352115;201704;475;1473;404;1335;52;173;245;817;297;990
352120;201704;868;2716;717;2420;108;446;355;1093;463;1539
352130;201704;1840;5483;1208;3955;286;994;279;877;565;1871
352140;201704;1717;4860;1052;3453;164;583;367;1144;531;1727
352150;201704;768;2262;608;1954;149;503;296;943;445;1446
352160;201704;965;2647;740;2246;171;574;244;662;415;1236
352170;201704;2702;8082;2361;7315;484;1615;1138;3324;1622;4939
352180;201704;3019;8558;2543;7628;680;2155;856;2436;1536;4591
352190;201704;1129;3355;919;2939;142;568;310;810;452;1378
352200;201704;387;1313;296;1112;37;151;104;371;141;522
352210;201704;16432;43983;13475;39618;2125;6736;8377;24816;10502;31552
352215;201704;530;1592;483;1524;52;197;297;913;349;1110
352220;201704;12364;38208;9886;33235;3197;11485;2307;7714;5504;19199
352230;201704;12265;40815;10419;37152;2915;11403;3355;11409;6270;22812
352240;201704;11724;33344;9077;28674;2354;8377;2880;8255;5234;16632
352250;201704;21466;67492;18523;61656;5526;19475;6488;21474;12014;40949
352260;201704;5555;16299;3806;12580;703;2530;1574;5093;2277;7623
352265;201704;869;2686;742;2470;66;288;497;1593;563;1881
352270;201704;1582;5397;1301;4776;329;1277;349;1242;678;2519
352280;201704;2209;6505;1808;5789;293;1122;850;2554;1143;3676
352290;201704;1122;3538;949;3120;167;662;413;1240;580;1902
352300;201704;974;2769;725;2266;135;492;331;928;466;1420
352310;201704;45264;130355;35643;113545;9254;30598;15749;50511;25003;81109
352320;201704;5518;16648;4663;14871;1103;3777;1643;4730;2746;8507
352330;201704;1997;6286;1684;5834;496;1828;539;1831;1035;3659
352340;201704;5021;15634;3851;13413;1060;3965;871;2905;1931;6870
352350;201704;1639;5392;1457;4978;264;1051;550;1742;814;2793
352360;201704;1049;3116;926;2898;153;565;625;1864;778;2429
352370;201704;840;2806;754;2589;85;358;444;1458;529;1816
352380;201704;899;2820;760;2556;219;820;187;585;406;1405
352390;201704;19267;50255;12759;38322;2129;7294;5929;16666;8058;23960
352400;201704;3553;10116;2509;8120;760;2604;700;2104;1460;4708
352410;201704;2826;8366;2374;7622;474;1654;1069;3314;1543;4968
352420;201704;859;2326;685;1992;130;408;266;756;396;1164
352430;201704;6148;18246;5182;16662;1625;5577;1725;5603;3350;11180
352440;201704;16193;49080;13252;43276;2945;10318;5379;17248;8324;27566
352450;201704;617;1880;399;1385;83;320;116;401;199;721
352460;201704;2435;7601;1994;6737;521;1933;596;1880;1117;3813
352470;201704;3823;10563;2822;8722;351;1233;1322;3808;1673;5041
352480;201704;4000;10627;2960;8751;579;1928;1177;3135;1756;5063
352490;201704;668;2283;526;1936;100;395;153;565;253;960
352500;201704;8620;23852;7011;21173;3526;11353;1304;3243;4830;14596
352510;201704;2904;8874;2277;7710;647;2362;639;2142;1286;4504
352520;201704;1948;6729;1712;6157;447;1693;668;2371;1115;4064
352530;201704;8482;26559;6293;21432;1544;5650;865;2427;2409;8077
352540;201704;529;1641;379;1298;62;232;107;358;169;590
352550;201704;837;2707;608;2188;144;574;118;401;262;975
352560;201704;621;1847;432;1405;71;228;100;289;171;517
352570;201704;1819;5805;1315;4720;340;1381;207;619;547;2000
352580;201704;832;2488;653;2117;102;368;222;652;324;1020
352585;201704;266;830;215;716;36;136;79;253;115;389
352590;201704;11940;36073;9656;31647;3260;11338;3406;10301;6666;21639
352600;201704;1787;5415;1439;4630;301;1045;602;1845;903;2890
352610;201704;3241;9859;2573;8645;647;2409;770;2426;1417;4835
352620;201704;5202;15501;4618;14536;1154;3733;2076;6508;3230;10241
352630;201704;609;1872;558;1752;132;496;229;653;361;1149
352640;201704;2560;7525;2140;6788;195;691;1431;4487;1626;5178
352650;201704;751;2264;562;1809;96;340;149;448;245;788
352660;201704;944;3339;798;3011;183;744;227;845;410;1589
352670;201704;10773;31861;6590;22588;1560;5941;470;1548;2030;7489
352680;201704;2918;9463;2220;7927;438;1759;786;2577;1224;4336
352690;201704;31020;84421;22473;67499;2850;9600;11867;33972;14717;43572
352700;201704;584;1743;499;1611;156;557;189;574;345;1131
352710;201704;5441;15537;4043;12752;1011;3544;1377;4113;2388;7657
352720;201704;7709;24367;6831;22395;2408;8085;1782;5652;4190;13737
352725;201704;425;1168;221;722;27;105;95;283;122;388
352730;201704;2169;7021;1954;6439;419;1528;870;2574;1289;4102
352740;201704;2140;5602;1656;4840;200;691;952;2677;1152;3368
352750;201704;459;1304;241;820;30;115;51;155;81;270
352760;201704;1245;4144;1012;3545;274;1030;320;1056;594;2086
352770;201704;761;2342;627;2059;143;509;246;782;389;1291
352780;201704;649;2140;513;1805;105;405;164;563;269;968
352790;201704;639;1816;453;1470;69;235;135;427;204;662
352800;201704;1103;3866;823;3105;170;690;232;803;402;1493
352810;201704;1031;2672;648;1922;129;386;215;616;344;1002
352820;201704;621;1656;438;1367;96;324;100;306;196;630
352830;201704;514;1463;301;954;47;153;43;118;90;271
352840;201704;3881;12768;3468;11912;948;3448;1435;4800;2383;8248
352850;201704;10047;28104;7410;23824;1924;6675;2540;7994;4464;14669
352860;201704;813;2749;741;2581;147;561;295;987;442;1548
352870;201704;896;2259;593;1612;68;229;307;749;375;978
352880;201704;2222;5936;1586;4719;244;766;678;1834;922;2600
352885;201704;259;816;223;746;26;77;144;477;170;554
352890;201704;667;1715;462;1294;63;212;202;496;265;708
352900;201704;19196;55213;13941;44574;2804;9899;5111;15441;7915;25340
352910;201704;378;1075;214;710;24;86;51;152;75;238
352920;201704;2410;7036;1825;5818;309;1114;846;2520;1155;3634
352930;201704;5617;17280;4528;14909;902;3186;1584;4997;2486;8183
352940;201704;21293;67135;17653;59036;5856;21443;1910;5711;7766;27154
352950;201704;366;1045;234;795;51;186;28;85;79;271
352960;201704;608;1802;362;1215;61;235;114;327;175;562
352965;201704;368;1052;230;740;59;201;36;102;95;303
352970;201704;3202;7930;2566;6967;215;628;1819;4940;2034;5568
352980;201704;1107;3471;950;3219;185;638;512;1798;697;2436
352990;201704;4061;12468;3565;11601;886;3261;1583;4849;2469;8110
353000;201704;447;1254;230;760;39;134;44;140;83;274
353010;201704;2927;7973;2124;6417;508;1711;603;1664;1111;3375
353020;201704;4026;10867;2350;7263;326;1086;776;2185;1102;3271
353030;201704;3525;10271;2782;8842;790;2658;526;1629;1316;4287
353040;201704;470;1323;388;1164;76;249;120;333;196;582
353050;201704;4756;15549;3851;13647;1012;3815;1376;4661;2388;8476
353060;201704;42212;120967;36488;111478;3836;14092;25342;74450;29178;88542
353070;201704;9991;30497;7281;24727;1665;6083;1980;6693;3645;12776
353080;201704;4784;14775;3391;11793;808;3080;865;2773;1673;5853
353090;201704;527;1789;480;1680;47;193;298;980;345;1173
353100;201704;294;827;129;439;19;68;22;60;41;128
353110;201704;7246;22014;6326;20531;1113;3957;3919;12764;5032;16721
353120;201704;652;1936;430;1425;81;306;116;342;197;648
353130;201704;2429;6831;1814;5845;565;1966;563;1769;1128;3735
353140;201704;2152;5888;1717;5038;317;1023;837;2312;1154;3335
353150;201704;1561;4645;1235;4055;328;1076;347;1141;675;2217
353160;201704;666;1821;431;1363;79;266;133;359;212;625
353170;201704;439;1329;383;1257;83;363;198;587;281;950
353180;201704;8836;24431;7139;21587;1063;3512;4266;12768;5329;16280
353190;201704;3586;10664;2904;9171;445;1585;1518;4476;1963;6061
353200;201704;1089;3582;816;2822;204;770;201;669;405;1439
353205;201704;350;1173;316;1089;77;290;145;490;222;780
353210;201704;1035;2559;669;1876;37;140;422;1140;459;1280
353215;201704;426;1302;349;1124;62;236;118;329;180;565
353220;201704;620;1899;494;1642;126;435;104;333;230;768
353230;201704;684;2214;616;2095;158;594;181;570;339;1164
353240;201704;2065;6467;1773;5898;292;1120;979;3143;1271;4263
353250;201704;1067;2847;795;2335;119;367;347;981;466;1348
353260;201704;859;2391;607;1913;123;426;180;527;303;953
353270;201704;619;1825;532;1653;92;285;241;728;333;1013
353280;201704;601;1933;465;1592;119;440;107;352;226;792
353282;201704;1781;5533;1631;5234;215;757;953;2964;1168;3721
353284;201704;373;986;215;659;42;138;55;148;97;286
353286;201704;129;391;93;317;25;87;15;47;40;134
353290;201704;887;2672;704;2315;89;364;398;1197;487;1561
353300;201704;1447;4471;1193;3909;248;938;430;1261;678;2199
353310;201704;238;684;194;620;41;145;80;245;121;390
353320;201704;590;1676;488;1477;62;204;277;815;339;1019
353325;201704;618;2001;490;1710;75;267;146;515;221;782
353330;201704;606;1685;425;1274;48;171;219;607;267;778
353340;201704;2718;7873;1884;6293;552;1946;487;1672;1039;3618
353350;201704;3226;9646;2397;7827;664;2329;545;1639;1209;3968
353360;201704;450;1465;407;1371;49;185;256;853;305;1038
353370;201704;598;1951;520;1778;56;233;292;946;348;1179
353380;201704;312;1025;253;893;52;204;76;256;128;460
353390;201704;5795;15777;4190;12825;870;2766;1454;4338;2324;7104
353400;201704;465;1419;388;1266;71;262;84;212;155;474
353410;201704;603;1756;504;1566;101;364;245;717;346;1081
353420;201704;583;1637;367;1138;94;283;68;199;162;482
353430;201704;2111;6983;1592;5737;417;1604;289;985;706;2589
353440;201704;55672;172822;43498;146250;11403;39979;15674;51392;27077;91371
353450;201704;406;1178;303;947;57;209;110;314;167;523
353460;201704;3171;9055;2485;7728;295;1091;1106;3440;1401;4531
353470;201704;7285;21640;5432;17985;1222;4506;1386;4313;2608;8819
353475;201704;1432;4068;1062;3239;164;544;365;1011;529;1555
353480;201704;1342;4092;1195;3796;122;405;852;2670;974;3075
353490;201704;908;2654;678;2141;147;456;254;776;401;1232
353500;201704;988;2613;810;2323;212;607;413;1184;625;1791
353510;201704;898;2865;670;2284;181;636;103;312;284;948
353520;201704;1097;3074;807;2571;117;413;371;1140;488;1553
353530;201704;2446;7034;2101;6399;281;987;1132;3314;1413;4301
353540;201704;1939;5860;1639;5321;376;1291;752;2396;1128;3687
353550;201704;6070;16921;4933;14939;664;2299;2799;8042;3463;10341
353560;201704;2047;6674;1687;6021;521;2021;410;1374;931;3395
353570;201704;512;1504;385;1249;92;291;169;532;261;823
353580;201704;2333;6733;2009;6170;321;1098;1227;3686;1548;4784
353590;201704;657;1936;458;1483;97;341;165;523;262;864
353600;201704;1775;4884;1547;4445;195;621;811;2242;1006;2863
353610;201704;608;2064;459;1729;95;385;87;309;182;694
353620;201704;2241;6996;1836;6182;463;1642;493;1545;956;3187
353625;201704;437;1214;277;886;37;142;124;375;161;517
353630;201704;1379;4769;1083;4008;211;842;143;457;354;1299
353640;201704;1369;3937;1041;3255;140;493;524;1606;664;2099
353650;201704;8586;24904;6471;20499;1128;3774;2658;8115;3786;11889
353657;201704;297;913;251;824;40;152;83;236;123;388
353660;201704;1017;2672;742;2148;235;748;126;278;361;1026
353670;201704;3432;10881;2892;9772;848;3183;1062;3330;1910;6513
353680;201704;666;2077;541;1857;153;582;203;665;356;1247
353690;201704;512;1357;255;844;35;117;42;111;77;228
353700;201704;1984;5966;1705;5418;238;841;940;2838;1178;3679
353710;201704;3367;8008;1672;5231;380;1164;383;1175;763;2339
353715;201704;531;1504;379;1199;30;109;108;325;138;434
353720;201704;1916;5811;1610;5337;321;1200;815;2588;1136;3788
353730;201704;4220;12650;3300;10643;608;2154;1217;3583;1825;5737
353740;201704;1682;4954;1256;4098;328;1159;331;1041;659;2200
353750;201704;853;2869;643;2390;140;575;145;536;285;1111
353760;201704;10267;27351;8361;24737;1211;4077;5294;15352;6505;19429
353770;201704;660;2035;348;1241;65;265;30;69;95;334
353780;201704;4007;13641;3480;12510;1067;4098;837;2936;1904;7034
353790;201704;2171;7278;1777;6437;480;2015;454;1520;934;3535
353800;201704;16060;48345;12854;42539;3056;10925;5096;16589;8152;27514
353810;201704;979;3150;763;2669;141;558;247;837;388;1395
353820;201704;1411;4632;1224;4170;230;893;580;1883;810;2776
353830;201704;624;1673;492;1455;70;212;255;718;325;930
353850;201704;1641;5029;1404;4529;372;1247;504;1603;876;2850
353860;201704;2494;8032;2048;7036;558;2022;558;1909;1116;3931
353870;201704;27711;79678;19635;63306;3500;12566;7230;21236;10730;33802
353880;201704;2710;8470;2298;7709;309;1200;1254;4124;1563;5324
353890;201704;2348;5783;1654;4647;250;789;874;2333;1124;3122
353900;201704;791;2444;595;2052;128;476;166;561;294;1037
353910;201704;1802;6483;1677;6264;232;850;1174;4544;1406;5394
353920;201704;2271;6621;1578;5210;341;1241;287;843;628;2084
353930;201704;4437;13253;3168;10876;825;3130;503;1662;1328;4792
353940;201704;1107;3555;835;2900;157;583;246;810;403;1393
353950;201704;3106;9629;2622;8645;522;1872;1260;3899;1782;5771
353960;201704;553;1719;393;1356;86;302;89;285;175;587
353970;201704;587;1647;474;1456;53;181;292;882;345;1063
353980;201704;13569;39666;11384;35551;2239;7388;5740;17479;7979;24867
353990;201704;416;1268;372;1176;45;166;207;626;252;792
354000;201704;2301;6230;1413;4463;265;893;179;563;444;1456
354010;201704;365;1088;305;977;56;192;181;580;237;772
354020;201704;4033;12507;3444;11242;874;3107;1045;3117;1919;6224
354025;201704;838;2339;595;1883;114;378;204;650;318;1028
354030;201704;477;1274;303;927;42;151;126;358;168;509
354040;201704;767;2047;509;1539;40;137;304;854;344;991
354050;201704;905;2837;700;2419;176;652;135;439;311;1091
354060;201704;4702;14424;3256;11134;856;3066;820;2623;1676;5689
354070;201704;2701;8939;2258;7900;588;2202;440;1431;1028;3633
354075;201704;1911;6876;1716;6417;359;1526;840;3018;1199;4544
354080;201704;1337;4058;943;3181;157;560;304;951;461;1511
354085;201704;328;799;301;762;11;47;241;593;252;640
354090;201704;1336;3924;1265;3785;129;445;863;2554;992;2999
354100;201704;14021;46516;11607;41817;2932;11320;4773;16837;7705;28157
354105;201704;928;2650;805;2466;121;393;519;1586;640;1979
354110;201704;691;1867;533;1642;181;627;116;315;297;942
354120;201704;1903;5251;1345;4102;224;750;542;1521;766;2271
354130;201704;6147;17465;4455;14180;1594;5399;304;803;1898;6202
354140;201704;25819;64836;16389;47941;3420;10740;4719;12912;8139;23652
354150;201704;3746;9964;2827;8314;550;1753;1190;3385;1740;5138
354160;201704;3285;10498;2570;8874;665;2403;823;2799;1488;5202
354165;201704;518;1678;437;1512;103;396;188;648;291;1044
354170;201704;1363;4247;1085;3594;160;580;490;1553;650;2133
354180;201704;465;1435;394;1273;66;245;158;437;224;682
354190;201704;1461;4563;1186;3973;247;912;382;1249;629;2161
354200;201704;950;2625;737;2234;86;287;352;978;438;1265
354210;201704;629;1962;520;1760;72;295;279;870;351;1165
354220;201704;2956;8444;2431;7438;451;1501;1177;3464;1628;4965
354230;201704;609;1961;545;1825;91;370;266;819;357;1189
354240;201704;1204;3914;899;3203;171;664;197;658;368;1322
354250;201704;661;1828;430;1436;125;436;110;392;235;828
354260;201704;7349;21633;5975;19218;1583;5374;1877;6239;3460;11613
354270;201704;1128;3691;923;3243;180;682;315;1096;495;1778
354280;201704;691;2003;617;1872;112;420;359;1000;471;1420
354290;201704;907;3186;809;2940;170;640;335;1219;505;1859
354300;201704;3741;11985;3459;11460;984;3388;1543;5004;2527;8392
354310;201704;799;2414;646;2110;138;465;316;1019;454;1484
354320;201704;721;2137;572;1837;126;475;210;605;336;1080
354323;201704;479;1293;350;1045;60;188;136;367;196;555
354325;201704;1208;3879;912;3199;156;579;332;1088;488;1667
354330;201704;6383;18626;5027;15973;973;3553;2377;6941;3350;10494
354340;201704;23279;70058;18824;62177;5173;18540;6868;21984;12041;40524
354350;201704;1064;3124;945;2884;193;670;521;1485;714;2155
354360;201704;447;1410;279;1022;45;152;15;56;60;208
354370;201704;1099;3635;937;3294;111;473;502;1707;613;2180
354380;201704;790;2371;596;1972;169;650;106;296;275;946
354390;201704;13136;37244;8947;29252;1823;6423;1770;5674;3593;12097
354400;201704;1543;5322;1257;4609;277;1090;374;1349;651;2439
354410;201704;5261;15955;4317;14112;1083;3827;1682;5327;2765;9154
354420;201704;1201;3560;881;2822;180;617;379;1176;559;1793
354425;201704;2108;6019;1783;5379;535;1684;486;1493;1021;3177
354430;201704;1326;4243;1181;3955;239;907;519;1674;758;2581
354440;201704;536;1567;376;1229;43;157;156;469;199;626
354450;201704;401;1164;239;799;30;113;41;130;71;243
354460;201704;982;2707;680;2105;122;408;291;911;413;1319
354470;201704;589;1553;461;1302;38;139;228;578;266;717
354480;201704;716;1953;572;1710;65;203;337;968;402;1171
354490;201704;721;2371;590;2054;76;297;262;871;338;1168
354500;201704;2082;6578;1837;6183;667;2508;405;1327;1072;3835
354510;201704;813;2247;742;2113;99;257;440;1243;539;1500
354515;201704;252;824;199;706;39;155;69;243;108;398
354520;201704;7940;25441;4580;15664;814;3191;1965;6220;2779;9411
354530;201704;3174;10618;2804;9816;712;2709;1133;3882;1845;6591
354540;201704;1174;3511;940;3068;303;1054;204;665;507;1719
354550;201704;464;1356;370;1183;77;269;184;568;261;837
354560;201704;1761;4844;1043;3235;147;479;450;1317;597;1796
354570;201704;1074;2984;500;1597;79;283;77;214;156;497
354580;201704;10504;29173;7281;23225;1275;4448;2807;8431;4082;12879
354600;201704;1604;5099;1358;4630;240;941;710;2347;950;3288
354610;201704;361;1047;209;685;26;93;65;198;91;291
354620;201704;394;1234;308;1077;56;243;138;444;194;687
354625;201704;303;929;190;657;29;111;45;121;74;232
354630;201704;2127;6955;1848;6375;744;2713;248;811;992;3524
354640;201704;3135;10226;2420;8517;501;2011;482;1500;983;3511
354650;201704;856;2507;730;2244;82;276;472;1457;554;1733
354660;201704;2372;6488;1715;5362;141;517;1096;3372;1237;3889
354670;201704;1095;3361;842;2747;201;716;205;610;406;1326
354680;201704;4359;13885;3958;13090;1042;3617;1852;6042;2894;9659
354690;201704;746;2408;512;1845;97;371;121;412;218;783
354700;201704;1075;2993;747;2281;153;547;308;835;461;1382
354710;201704;515;1512;379;1219;30;123;177;506;207;629
354720;201704;262;709;145;460;44;141;19;58;63;199
354730;201704;8848;27200;6649;22948;1271;4843;3077;10238;4348;15081
354740;201704;278;840;136;496;13;62;23;84;36;146
354750;201704;2410;7212;1783;5989;402;1532;652;2039;1054;3571
354760;201704;1821;5708;1454;4939;475;1722;223;766;698;2488
354765;201704;299;836;143;483;16;57;25;81;41;138
354770;201704;2254;6184;1694;5207;527;1738;530;1568;1057;3306
354780;201704;55523;151786;46126;132546;7021;22729;24903;67414;31924;90143
354790;201704;809;2625;709;2422;121;428;347;1160;468;1588
354800;201704;2330;6669;1961;6121;428;1481;969;2920;1397;4401
354805;201704;1007;2963;743;2395;91;341;232;655;323;996
354810;201704;557;1785;349;1300;59;249;63;221;122;470
354820;201704;930;3131;777;2800;158;647;174;566;332;1213
354830;201704;453;1198;329;975;100;306;117;325;217;631
354840;201704;699;1991;513;1599;92;294;245;740;337;1034
354850;201704;16899;50586;12470;41806;2384;9022;5769;18025;8153;27047
354860;201704;1324;4073;1103;3714;260;998;404;1241;664;2239
354870;201704;45834;130627;39760;118620;7880;25570;18868;54508;26748;80078
354880;201704;4349;11913;2369;7502;332;1216;777;2092;1109;3308
354890;201704;15214;43589;12775;39216;2615;8711;5864;17395;8479;26106
354900;201704;438;1326;314;1059;55;203;74;235;129;438
354910;201704;6093;17999;3661;12857;665;2630;192;615;857;3245
354920;201704;381;1123;232;799;40;164;47;146;87;310
354925;201704;228;710;124;446;28;103;18;53;46;156
354930;201704;308;784;173;551;25;76;72;230;97;306
354940;201704;1640;5866;1354;5109;470;1888;132;470;602;2358
354950;201704;1449;4503;1210;4092;161;691;693;2227;854;2918
354960;201704;739;2247;647;2095;121;441;300;929;421;1370
354970;201704;3877;12427;3355;11347;560;2178;1801;5834;2361;8012
354980;201704;27042;70451;18222;55053;2989;10394;7737;21554;10726;31948
354990;201704;55629;158263;43333;134514;6794;22978;21792;65444;28586;88422
354995;201704;1860;5509;1523;4949;356;1235;771;2452;1127;3687
355000;201704;1328;4237;1178;3963;305;1184;228;645;533;1829
355010;201704;3340;10279;2503;8261;804;2845;462;1549;1266;4394
355020;201704;2905;9392;2228;8010;756;2993;572;1986;1328;4979
355030;201704;1189673;3149006;967709;2723460;200236;615036;433576;1157749;633812;1772785
355040;201704;2583;7794;2296;7293;384;1320;1431;4474;1815;5794
355050;201704;1076;3198;835;2715;244;804;151;485;395;1289
355060;201704;4365;14004;3515;12229;719;2849;1220;3865;1939;6714
355070;201704;6797;20522;5888;18977;1098;4014;3045;9225;4143;13239
355080;201704;857;2870;598;2263;102;451;37;124;139;575
355090;201704;1081;3615;902;3231;170;646;311;1103;481;1749
355100;201704;15925;48476;13229;43868;3100;11281;6807;22003;9907;33284
355110;201704;1111;3566;934;3235;293;1101;176;572;469;1673
355120;201704;609;1861;479;1606;90;345;182;591;272;936
355130;201704;636;1603;294;868;43;135;87;233;130;368
355140;201704;1138;3666;1048;3509;199;764;611;2075;810;2839
355150;201704;3537;10171;2885;9042;586;1981;1366;4252;1952;6233
355160;201704;1719;5328;1419;4805;400;1473;339;1109;739;2582
355170;201704;8062;22881;6363;20059;2085;6910;1960;6342;4045;13252
355180;201704;2709;8327;2165;7316;526;2137;694;2115;1220;4252
355190;201704;1423;4333;1195;3908;380;1361;384;1338;764;2699
355200;201704;751;2605;678;2442;283;1083;153;511;436;1594
355210;201704;2760;8462;2448;7786;297;1131;1548;4701;1845;5832
355220;201704;37071;109965;30345;96561;9461;31962;8341;24607;17802;56569
355230;201704;1441;3856;848;2612;157;474;196;553;353;1027
355240;201704;23824;67533;16623;52781;3577;12062;5631;17553;9208;29615
355250;201704;29466;89391;24136;79214;6611;23334;8172;26234;14783;49568
355255;201704;878;2385;529;1674;103;342;146;460;249;802
355260;201704;1196;3521;991;3161;202;744;450;1316;652;2060
355270;201704;1571;4860;1326;4298;247;864;610;1830;857;2694
355280;201704;27280;77355;21706;66400;4058;13603;9178;26921;13236;40524
355290;201704;878;2755;692;2293;152;504;206;645;358;1149
355300;201704;1312;4154;1080;3657;244;894;292;958;536;1852
355310;201704;1017;2989;806;2617;121;438;425;1395;546;1833
355320;201704;568;1740;497;1589;96;361;193;543;289;904
355330;201704;1889;5692;1400;4712;257;948;656;2113;913;3061
355340;201704;2765;6905;2446;6421;354;932;1560;4061;1914;4993
355350;201704;1306;4272;1023;3647;239;936;294;1018;533;1954
355360;201704;1160;3591;1030;3296;165;555;644;2109;809;2664
355365;201704;337;991;209;735;48;168;36;118;84;286
355370;201704;6804;17410;5312;15445;1277;3943;2308;7097;3585;11040
355380;201704;3112;9133;2458;7749;537;1808;623;1740;1160;3548
355385;201704;1029;3274;926;3065;247;882;334;1052;581;1934
355390;201704;804;2343;607;1931;121;425;224;623;345;1048
355395;201704;1884;5662;1401;4527;212;689;591;1822;803;2511
355400;201704;9097;29521;7780;26781;2371;8815;2096;6909;4467;15724
355410;201704;18550;57795;14411;49508;4109;15456;2786;9721;6895;25177
355420;201704;711;2505;636;2349;170;732;177;644;347;1376
355430;201704;3699;9951;2958;8668;539;1731;1444;4117;1983;5848
355440;201704;880;2668;622;2077;121;411;169;528;290;939
355450;201704;3796;10780;2261;7410;452;1564;664;2026;1116;3590
355460;201704;562;1510;364;1144;65;248;129;343;194;591
355465;201704;344;1100;269;931;57;208;68;224;125;432
355470;201704;837;2478;594;1983;160;557;211;681;371;1238
355475;201704;183;549;175;530;31;119;121;342;152;461
355480;201704;3024;10232;2737;9657;579;2248;1406;4862;1985;7110
355490;201704;997;2845;625;2042;85;288;202;630;287;918
355495;201704;777;2550;656;2292;140;545;176;579;316;1124
355500;201704;6926;20216;4606;14981;848;2969;893;2704;1741;5673
355510;201704;1862;4934;1012;3226;149;537;270;771;419;1308
355520;201704;422;990;210;584;25;77;98;249;123;326
355530;201704;446;1047;177;543;23;83;44;117;67;200
355535;201704;625;1864;498;1633;146;545;138;391;284;936
355540;201704;7946;24554;7443;23719;1720;5842;4054;12612;5774;18454
355550;201704;739;2254;604;1980;104;374;232;742;336;1116
355560;201704;1152;3450;697;2402;148;567;41;113;189;680
355570;201704;205;651;122;441;21;82;19;67;40;149
355580;201704;1205;3335;819;2594;131;475;325;1002;456;1477
355590;201704;212;563;164;478;19;66;94;262;113;328
355600;201704;1284;3688;979;3056;290;990;306;921;596;1911
355610;201704;1645;4512;1215;3704;204;672;544;1603;748;2275
355620;201704;4315;13248;3460;11278;546;2064;1613;4813;2159;6877
355630;201704;2696;7841;1842;6163;398;1375;548;1885;946;3260
355635;201704;934;2958;797;2735;89;333;546;1917;635;2250
355640;201704;2757;8726;1993;7168;440;1698;338;1211;778;2909
355645;201704;3849;12322;3300;11443;471;1920;1978;6764;2449;8684
355650;201704;7225;21350;6258;19535;1237;4428;3621;10495;4858;14923
355660;201704;1287;3921;1022;3337;150;616;508;1490;658;2106
355670;201704;2874;8879;2103;7003;371;1409;907;2695;1278;4104
355680;201704;1602;5227;1129;4043;289;1098;155;533;444;1631
355690;201704;491;1527;347;1233;119;446;20;50;139;496
355695;201704;244;789;145;517;11;42;16;49;27;91
355700;201704;5430;17475;4598;15594;1169;4038;1794;6003;2963;10041
355710;201704;9420;23263;5647;16368;1130;3478;1518;4154;2648;7632
355715;201704;327;953;215;707;56;202;45;143;101;345
355720;201704;1450;4743;1203;4195;270;1023;427;1326;697;2349
355730;201704;860;2771;724;2441;223;755;203;654;426;1409
410010;201704;1327;4097;1109;3593;259;936;192;626;451;1562
410020;201704;1163;3713;978;3299;283;952;339;1148;622;2100
410030;201704;1089;3659;898;3204;247;911;166;615;413;1526
410040;201704;9640;30950;8295;28423;1923;7278;2637;8988;4560;16266
410045;201704;1036;2886;723;2283;152;533;191;548;343;1081
410050;201704;2668;7186;1702;5354;442;1492;197;528;639;2020
410060;201704;2189;6609;1851;5919;395;1283;740;2407;1135;3690
410070;201704;1687;4704;1276;3886;337;1119;375;1129;712;2248
410080;201704;1412;3966;1097;3385;194;688;440;1272;634;1960
410090;201704;996;3014;929;2881;185;618;410;1318;595;1936
410100;201704;2637;8031;1973;6422;349;1324;275;842;624;2166
410105;201704;355;1087;224;767;37;157;36;104;73;261
410110;201704;2926;8371;2285;7096;358;1231;735;2244;1093;3475
410115;201704;536;1437;409;1202;75;240;140;374;215;614
410120;201704;2439;8371;2255;7988;857;3234;573;2037;1430;5271
410130;201704;1096;3382;1027;3224;388;1334;255;692;643;2026
410140;201704;17478;44899;11340;33887;2289;7498;2496;6987;4785;14485
410150;201704;15274;39151;8246;24633;1598;5126;1292;3644;2890;8770
410160;201704;2918;8886;2604;8288;597;2112;961;3113;1558;5225
410165;201704;707;2057;568;1732;85;270;272;772;357;1042
410170;201704;2252;6390;1678;5102;448;1509;241;697;689;2206
410180;201704;11468;35793;9810;32040;1978;6982;4397;13471;6375;20453
410185;201704;528;1462;392;1195;87;276;83;230;170;506
410190;201704;2025;5883;1620;5013;345;1173;289;836;634;2009
410200;201704;3844;10490;2706;8290;570;1998;410;1218;980;3216
410210;201704;2624;7673;1864;5978;310;1145;402;1060;712;2205
410220;201704;655;1765;486;1453;79;276;133;400;212;676
410230;201704;1475;4533;1263;4092;254;936;526;1632;780;2568
410240;201704;4257;12755;3811;11832;1213;4312;560;1660;1773;5972
410250;201704;2697;7321;1888;5710;418;1376;378;1123;796;2499
410260;201704;1606;4507;1247;3906;261;903;529;1649;790;2552
410270;201704;568;1562;447;1318;56;189;206;589;262;778
410275;201704;782;2370;529;1765;82;301;219;727;301;1028
410280;201704;2127;6119;1534;4877;338;1212;408;1182;746;2394
410290;201704;3364;10012;2760;8852;586;1945;1086;3476;1672;5421
410300;201704;724;2000;578;1700;107;356;240;625;347;981
410302;201704;426;1173;252;822;26;89;133;439;159;528
410304;201704;1211;3816;1100;3576;278;958;442;1471;720;2429
410305;201704;1853;4948;1461;4278;351;1086;677;1958;1028;3044
410310;201704;2274;7163;2002;6681;441;1648;681;2277;1122;3925
410315;201704;678;1886;425;1404;66;240;131;408;197;648
410320;201704;1188;3603;791;2673;116;450;99;315;215;765
410322;201704;570;1647;332;1097;50;164;81;258;131;422
410330;201704;1344;3704;1079;3176;252;783;261;761;513;1544
410335;201704;920;2676;781;2398;130;454;331;923;461;1377
410337;201704;795;2085;571;1664;86;281;198;532;284;813
410340;201704;551;1555;374;1109;53;184;146;363;199;547
410345;201704;1901;5405;1269;4030;295;971;306;940;601;1911
410347;201704;724;1924;523;1549;58;208;158;440;216;648
410350;201704;1120;3319;844;2768;150;542;215;644;365;1186
410360;201704;3937;10385;3061;8823;353;1185;1623;4532;1976;5717
410370;201704;11763;34111;8443;26173;1464;5050;2498;6789;3962;11839
410380;201704;1338;3828;1195;3512;146;544;522;1473;668;2017
410390;201704;2400;7072;1844;5885;573;1929;371;1088;944;3017
410395;201704;911;2932;775;2649;194;725;330;1146;524;1871
410400;201704;4336;13265;3507;11461;688;2435;1277;4001;1965;6436
410405;201704;822;2319;674;2052;166;571;245;708;411;1279
410410;201704;1205;3703;1168;3653;274;1067;617;1842;891;2909
410420;201704;6646;21308;5422;18564;1350;5093;787;2370;2137;7463
410425;201704;2662;8373;2020;6960;387;1440;340;1086;727;2526
410430;201704;13798;36946;10087;30112;1855;6104;2901;8269;4756;14373
410440;201704;3032;10500;2739;9924;538;2011;1413;5409;1951;7420
410442;201704;2599;8522;2271;7795;683;2488;651;2184;1334;4672
410445;201704;2331;7432;1972;6743;496;1878;632;2224;1128;4102
410450;201704;1901;5390;1464;4516;345;1164;189;446;534;1610
410460;201704;1644;4807;1293;4151;363;1228;283;864;646;2092
410465;201704;2283;7340;1915;6538;429;1503;657;2160;1086;3663
410470;201704;1783;5621;1399;4747;300;1159;273;912;573;2071
410480;201704;31216;86610;18841;60946;3058;10695;1552;4534;4610;15229
410490;201704;11362;34129;8492;28026;1849;6758;2281;6990;4130;13748
410500;201704;1541;4803;1209;4032;378;1406;169;483;547;1889
410510;201704;2433;6381;1645;4803;307;901;518;1428;825;2329
410520;201704;3027;10322;2831;9921;798;2911;1288;4570;2086;7481
410530;201704;1525;4201;965;2918;179;580;161;407;340;987
410540;201704;2908;8543;2064;6738;399;1400;691;2224;1090;3624
410550;201704;6200;17752;4392;13864;902;3133;612;1735;1514;4868
410560;201704;1282;3754;1000;3197;264;927;316;924;580;1851
410570;201704;2607;8089;2282;7535;619;2244;629;2271;1248;4515
410580;201704;22187;65235;18041;57041;4086;14406;5955;17606;10041;32012
410590;201704;1375;4211;900;2950;161;556;192;556;353;1112
410600;201704;1836;5281;1457;4543;354;1108;475;1517;829;2625
410610;201704;744;2065;579;1755;66;211;216;633;282;844
410620;201704;1758;5793;1269;4577;322;1265;130;424;452;1689
410630;201704;2427;7200;1669;5459;355;1290;162;422;517;1712
410640;201704;4642;12569;3388;10214;866;3001;512;1434;1378;4435
410645;201704;1136;3835;1051;3688;453;1672;251;935;704;2607
410650;201704;2084;6420;1675;5526;524;1822;285;880;809;2702
410655;201704;1367;4945;1131;4477;71;263;730;3208;801;3471
410657;201704;781;2139;544;1644;119;399;180;472;299;871
410660;201704;3011;8393;1664;5364;336;1117;178;571;514;1688
410670;201704;913;2496;624;1875;123;383;227;653;350;1036
410680;201704;2852;9140;2232;7622;690;2313;492;1809;1182;4122
410685;201704;633;1789;534;1612;89;317;293;846;382;1163
410690;201704;115767;328156;81603;256885;15877;55452;20777;57773;36654;113225
410700;201704;2112;6222;1923;5839;467;1482;842;2444;1309;3926
410710;201704;920;2642;609;1970;139;461;161;469;300;930
410712;201704;805;2403;696;2194;232;801;248;787;480;1588
410715;201704;888;2840;636;2212;137;493;159;552;296;1045
410720;201704;3031;9041;2359;7644;424;1513;407;1169;831;2682
410725;201704;1095;3039;749;2358;128;414;117;338;245;752
410730;201704;508;1449;395;1240;105;354;73;231;178;585
410740;201704;896;2634;644;2126;113;433;260;840;373;1273
410750;201704;1812;5257;1495;4607;305;1014;475;1389;780;2403
410752;201704;312;818;148;453;27;84;41;102;68;186
410753;201704;356;1048;218;727;30;105;41;125;71;230
410754;201704;1190;3367;1024;3103;67;202;636;2119;703;2321
410755;201704;810;1997;591;1639;67;223;325;837;392;1060
410760;201704;2603;7610;2190;6886;575;1974;636;1989;1211;3963
410765;201704;14625;43778;11358;37431;2003;7465;1026;3225;3029;10690
410770;201704;900;2443;629;1919;129;411;139;418;268;829
410773;201704;1331;3722;1183;3507;183;624;831;2402;1014;3026
410775;201704;1410;3991;1277;3791;299;975;430;1261;729;2236
410780;201704;553;1505;369;1111;87;268;101;332;188;600
410785;201704;784;2398;660;2135;169;603;177;545;346;1148
410790;201704;455;1470;387;1292;118;417;38;97;156;514
410800;201704;2885;7110;2278;6096;286;873;883;2268;1169;3141
410810;201704;336;1007;270;874;42;156;112;361;154;517
410820;201704;787;2337;564;1816;126;428;78;254;204;682
410830;201704;29614;82814;23450;71933;6419;21754;7368;21709;13787;43463
410832;201704;1009;2879;862;2584;102;382;485;1375;587;1757
410840;201704;6740;19277;4431;14452;1039;3711;400;1048;1439;4759
410845;201704;1190;3533;995;3127;208;711;373;1142;581;1853
410850;201704;2630;7845;2324;7308;527;1837;864;2760;1391;4597
410855;201704;586;1610;432;1294;74;243;162;453;236;696
410860;201704;3845;10812;3073;9260;571;1879;946;2707;1517;4586
410865;201704;1455;4743;1381;4607;356;1259;733;2535;1089;3794
410870;201704;1243;3677;1132;3510;116;399;775;2433;891;2832
410880;201704;3642;11474;3035;10179;595;2181;434;1524;1029;3705
410890;201704;909;2935;701;2472;175;674;110;376;285;1050
410895;201704;1056;3615;935;3333;361;1395;189;627;550;2022
410900;201704;919;2515;616;1907;86;285;172;484;258;769
410910;201704;386;994;269;779;26;91;138;375;164;466
410920;201704;824;2295;663;2023;163;564;216;658;379;1222
410930;201704;1561;4629;1286;4060;360;1311;315;947;675;2258
410940;201704;21075;65927;17514;59063;5419;19756;3199;11045;8618;30801
410950;201704;1807;5725;1672;5499;123;456;1294;4223;1417;4679
410960;201704;7623;20778;4770;15379;1353;4781;1074;3356;2427;8137
410965;201704;1065;3105;827;2613;214;698;280;828;494;1526
410970;201704;4140;12122;3205;10268;841;3110;493;1460;1334;4570
410975;201704;1570;4357;1213;3665;224;773;410;1210;634;1983
410980;201704;6214;17333;4127;13239;674;2427;1286;3966;1960;6393
410990;201704;993;2880;641;2112;192;713;98;261;290;974
411000;201704;494;1475;356;1172;61;231;66;170;127;401
411005;201704;471;1382;299;977;53;198;48;139;101;337
411007;201704;2310;7182;2027;6607;519;1801;602;1958;1121;3759
411010;201704;4020;13395;3623;12514;1057;3910;428;1411;1485;5321
411020;201704;2444;7394;2115;6817;641;2235;626;1950;1267;4185
411030;201704;667;1778;454;1320;70;233;133;337;203;570
411040;201704;762;2171;346;1114;63;214;59;181;122;395
411050;201704;1926;6588;1709;6124;533;2064;242;764;775;2828
411060;201704;1565;4636;1159;3752;242;937;153;453;395;1390
411065;201704;327;963;261;838;53;177;101;328;154;505
411070;201704;6205;18020;4966;15566;1144;3936;1381;4064;2525;8000
411080;201704;2141;6280;1879;5795;455;1565;553;1697;1008;3262
411090;201704;812;2105;562;1666;65;221;93;257;158;478
411095;201704;1424;3923;1043;3141;157;521;279;763;436;1284
411100;201704;1164;3392;838;2675;122;471;204;640;326;1111
411110;201704;563;1637;285;978;27;104;17;46;44;150
411120;201704;1584;4752;1200;3879;337;1265;257;719;594;1984
411125;201704;4168;13376;3912;12863;971;3348;1539;5135;2510;8483
411130;201704;684;2005;502;1617;122;410;138;478;260;888
411140;201704;2214;7348;1885;6562;455;1649;760;2712;1215;4361
411150;201704;3916;10950;2940;8992;650;2193;297;762;947;2955
411155;201704;968;2648;680;2098;89;298;279;808;368;1106
411160;201704;274;776;214;654;43;132;46;143;89;275
411170;201704;736;2273;592;1940;134;464;198;644;332;1108
411180;201704;5548;16228;4504;14231;926;3200;1525;4819;2451;8019
411190;201704;1405;3990;1140;3444;282;922;242;648;524;1570
411200;201704;4431;12903;3480;11216;927;3244;990;3093;1917;6337
411210;201704;1958;5486;1562;4772;407;1411;185;506;592;1917
411220;201704;925;2620;773;2320;167;573;307;848;474;1421
411230;201704;1248;3439;809;2582;181;605;201;631;382;1236
411240;201704;1584;3753;879;2532;136;416;366;989;502;1405
411250;201704;1974;5781;1612;5114;422;1469;450;1422;872;2891
411260;201704;333;858;212;645;27;86;86;242;113;328
411270;201704;1753;5386;1521;4909;243;907;705;2175;948;3082
411275;201704;1334;3813;1032;3163;231;751;248;695;479;1446
411280;201704;1544;4403;1013;3241;187;669;190;563;377;1232
411290;201704;715;2082;532;1721;119;400;174;558;293;958
411295;201704;934;2583;836;2400;124;394;332;960;456;1354
411300;201704;1183;3010;780;2231;73;233;276;711;349;944
411310;201704;820;2227;648;1928;48;161;206;608;254;769
411320;201704;5075;14631;3699;12013;941;3152;692;2128;1633;5280
411325;201704;1516;4744;1345;4383;274;936;647;2149;921;3085
411330;201704;3002;9223;2454;8114;728;2650;570;1926;1298;4576
411340;201704;764;2307;520;1710;45;176;199;627;244;803
411342;201704;687;1904;566;1669;148;462;175;479;323;941
411345;201704;946;2833;834;2626;196;680;381;1197;577;1877
411350;201704;2774;8172;2042;6654;558;2010;198;645;756;2655
411360;201704;597;1486;410;1184;52;182;142;373;194;555
411370;201704;45724;126855;36182;109186;4877;16986;16914;47586;21791;64572
411373;201704;1403;4210;1210;3868;244;920;341;1086;585;2006
411375;201704;1123;3063;827;2493;162;546;240;669;402;1215
411380;201704;1074;2935;682;2031;123;382;208;558;331;940
411390;201704;1754;5116;1374;4249;271;908;381;1076;652;1984
411400;201704;2145;5915;1696;5018;332;1083;538;1514;870;2597
411410;201704;2060;6199;1574;5087;367;1322;329;937;696;2259
411420;201704;3954;10979;2664;8339;414;1454;415;1051;829;2505
411430;201704;3303;9676;2748;8759;612;2121;1279;4011;1891;6132
411435;201704;481;1475;370;1228;77;266;137;419;214;685
411440;201704;2754;8678;2421;7965;673;2305;541;1885;1214;4190
411450;201704;2373;7116;2123;6646;445;1425;1010;3293;1455;4718
411460;201704;3525;10134;1910;6476;311;1213;131;410;442;1623
411470;201704;782;2310;543;1761;92;330;102;292;194;622
411480;201704;4485;13387;3331;11089;764;2805;569;1776;1333;4581
411490;201704;1429;4213;1162;3718;221;802;303;878;524;1680
411500;201704;1843;4860;1293;3883;243;826;380;1125;623;1951
411510;201704;2010;5924;1656;5195;420;1471;283;879;703;2350
411520;201704;25668;69440;15778;48777;2632;8811;3554;9958;6186;18769
411530;201704;957;2658;683;2156;120;430;213;645;333;1075
411535;201704;483;1451;227;813;23;106;13;33;36;139
411540;201704;3006;8042;2190;6378;494;1582;586;1546;1080;3128
411545;201704;1010;3212;883;2957;121;442;549;1894;670;2336
411550;201704;753;2033;616;1809;159;505;97;279;256;784
411560;201704;2218;6482;1504;4866;226;806;108;282;334;1088
411570;201704;7131;18552;5152;15368;1158;3939;1127;3455;2285;7394
411573;201704;830;2375;766;2269;83;264;489;1450;572;1714
411575;201704;1615;4939;1372;4448;321;1099;434;1411;755;2510
411580;201704;3936;11011;2583;8325;315;1222;329;909;644;2131
411585;201704;808;2541;405;1418;72;261;58;175;130;436
411590;201704;365;1085;308;981;42;150;140;416;182;566
411600;201704;316;874;218;718;48;181;82;274;130;455
411605;201704;1651;4512;1093;3331;169;592;402;1172;571;1764
411610;201704;2215;6200;1692;5130;375;1211;608;1796;983;3007
411620;201704;2811;8557;2528;8097;526;1851;1319;4208;1845;6059
411630;201704;537;1439;361;1160;76;287;51;131;127;418
411640;201704;463;1416;348;1139;41;137;117;362;158;499
411650;201704;216;667;161;555;33;118;20;65;53;183
411660;201704;930;2463;665;1980;76;246;323;934;399;1180
411670;201704;1077;3027;853;2532;164;512;280;818;444;1330
411680;201704;1525;4462;1297;4034;244;844;625;1941;869;2785
411690;201704;3337;9709;2631;8359;578;1905;677;2250;1255;4155
411695;201704;704;2267;537;1858;95;355;178;641;273;996
411700;201704;1621;4643;1133;3668;233;837;156;466;389;1303
411705;201704;1810;6240;1598;5812;390;1426;790;3041;1180;4467
411710;201704;1672;4842;1336;4171;339;1138;228;739;567;1877
411720;201704;909;2507;718;2121;113;363;204;553;317;916
411721;201704;771;2242;616;1905;150;482;89;273;239;755
411722;201704;663;2003;427;1453;84;329;96;269;180;598
411725;201704;1369;4350;862;3092;180;683;162;588;342;1271
411727;201704;1700;4969;1221;3920;337;1124;206;609;543;1733
411729;201704;625;1611;431;1248;101;309;104;249;205;558
411730;201704;5348;15235;4465;13532;1446;4531;1146;3456;2592;7987
411740;201704;638;1796;378;1224;66;235;65;182;131;417
411745;201704;898;2607;704;2183;124;412;184;537;308;949
411750;201704;5087;14954;3928;12372;636;2178;1490;4495;2126;6673
411760;201704;7675;22142;6475;20080;2149;7091;1376;4451;3525;11542
411770;201704;3384;10864;2757;9401;785;2845;422;1392;1207;4237
411780;201704;2882;8689;2631;8250;621;2102;1267;4104;1888;6206
411790;201704;3368;9416;2209;6972;552;1899;408;1230;960;3129
411800;201704;1123;3249;763;2420;103;364;106;307;209;671
411810;201704;1717;4792;1381;4144;259;877;595;1673;854;2550
411820;201704;12814;41255;10813;36961;3724;13185;2616;9158;6340;22343
411830;201704;542;1384;410;1155;110;361;25;83;135;444
411840;201704;10375;29285;7603;23761;1643;5616;1549;4852;3192;10468
411845;201704;494;1507;302;997;52;196;30;85;82;281
411850;201704;7493;21920;6116;19161;1647;5652;1437;4360;3084;10012
411860;201704;886;2699;700;2282;134;470;205;619;339;1089
411870;201704;828;2666;564;1945;106;411;110;355;216;766
411880;201704;2196;6294;1709;5406;458;1628;312;937;770;2565
411885;201704;993;2739;812;2418;156;572;263;719;419;1291
411890;201704;1126;3423;771;2588;116;453;48;132;164;585
411900;201704;919;2865;608;2089;136;460;65;226;201;686
411910;201704;1160;3693;884;3053;243;890;221;707;464;1597
411915;201704;17476;46650;10954;33965;2053;6908;2346;6611;4399;13519
411920;201704;894;2960;771;2656;226;896;91;253;317;1149
411925;201704;601;1684;409;1325;96;328;99;302;195;630
411930;201704;5722;18859;5044;17476;2340;8770;472;1677;2812;10447
411940;201704;3147;10380;2714;9427;754;2775;546;1773;1300;4548
411950;201704;12666;39141;10814;35584;2328;8261;4799;15534;7127;23795
411960;201704;5394;15659;4912;14764;1000;3323;1951;5631;2951;8954
411965;201704;543;1499;381;1220;73;268;97;320;170;588
411970;201704;805;2147;683;1967;146;407;349;1101;495;1508
411980;201704;1619;4715;1391;4268;346;1117;411;1244;757;2361
411990;201704;32997;100577;25131;84059;6022;22316;6966;22341;12988;44657
411995;201704;2518;7425;2104;6697;606;2194;544;1628;1150;3822
412000;201704;2303;5586;1734;4631;216;729;920;2194;1136;2923
412010;201704;690;2300;544;1950;81;335;135;433;216;768
412015;201704;635;1867;521;1638;86;272;244;772;330;1044
412020;201704;371;1126;241;801;46;155;53;152;99;307
412030;201704;777;2324;551;1850;83;325;166;517;249;842
412033;201704;911;2663;644;2061;90;299;195;656;285;955
412035;201704;947;2584;596;1935;116;399;193;607;309;1006
412040;201704;603;1812;442;1465;65;228;79;259;144;487
412050;201704;1765;4983;1327;4138;227;806;300;933;527;1739
412060;201704;7076;23540;6338;22067;1900;7159;1752;6098;3652;13257
412065;201704;797;2365;609;1967;125;439;178;547;303;986
412070;201704;1316;3495;970;2780;130;409;400;1114;530;1523
412080;201704;1503;4585;952;3343;121;478;29;82;150;560
412085;201704;440;1270;151;524;18;65;13;36;31;101
412090;201704;4722;13878;4338;13183;922;2845;2287;7176;3209;10021
412100;201704;1849;5599;1475;4875;432;1546;305;1013;737;2559
412110;201704;1061;2959;735;2270;148;493;148;476;296;969
412120;201704;1660;5579;1406;4996;330;1278;404;1262;734;2540
412125;201704;661;2154;577;1956;139;514;187;610;326;1124
412130;201704;573;1720;445;1420;100;339;85;280;185;619
412135;201704;536;1501;304;948;57;178;98;277;155;455
412140;201704;1564;4543;1203;3788;262;904;217;632;479;1536
412150;201704;3042;8537;2581;7606;308;1022;1543;4409;1851;5431
412160;201704;1222;3867;758;2642;177;685;79;259;256;944
412170;201704;4564;13719;3763;12174;939;3341;1427;4371;2366;7712
412175;201704;1462;4686;1265;4274;262;954;593;2010;855;2964
412180;201704;1713;5089;1293;4277;259;1012;478;1424;737;2436
412190;201704;3370;9257;2525;7693;439;1487;853;2722;1292;4209
412200;201704;2093;6549;1525;5128;301;1065;406;1393;707;2458
412210;201704;649;1746;380;1193;79;292;52;128;131;420
412215;201704;3515;10588;3123;9835;781;2462;1583;5198;2364;7660
412217;201704;1098;3080;968;2834;79;294;685;1906;764;2200
412220;201704;5768;18046;5311;17240;1465;4763;2213;7530;3678;12293
412230;201704;2877;9320;2453;8425;479;1855;651;2092;1130;3947
412240;201704;8847;22655;5288;16043;968;3335;1075;3055;2043;6390
412250;201704;1894;5446;1540;4714;350;1130;201;524;551;1654
412260;201704;1318;3638;879;2676;125;435;301;813;426;1248
412265;201704;954;2884;833;2669;216;751;315;1007;531;1758
412270;201704;864;2674;579;1967;95;368;213;679;308;1047
412280;201704;626;1917;475;1602;165;603;37;95;202;698
412290;201704;1026;2865;757;2370;137;478;237;704;374;1182
412300;201704;1635;4961;1426;4548;381;1324;312;938;693;2262
412310;201704;954;2785;802;2518;112;459;368;1153;480;1612
412320;201704;823;2208;600;1784;93;354;186;542;279;896
412330;201704;1467;4178;1059;3318;151;509;424;1332;575;1841
412340;201704;944;2925;643;2149;92;325;122;382;214;707
412350;201704;2501;7386;1707;5650;330;1195;58;120;388;1315
412360;201704;299;869;184;591;22;79;55;158;77;237
412370;201704;871;2576;641;2158;142;519;95;333;237;852
412380;201704;1609;4915;1255;4091;304;1028;262;866;566;1894
412382;201704;662;1831;464;1425;69;229;111;309;180;538
412385;201704;2300;6941;2024;6317;726;2349;482;1586;1208;3935
412390;201704;2136;5985;1912;5613;443;1391;813;2445;1256;3836
412395;201704;775;2202;592;1851;70;260;298;893;368;1153
412400;201704;888;2719;714;2321;171;585;168;574;339;1159
412402;201704;1832;5282;1450;4517;298;1046;278;803;576;1849
412405;201704;3433;9938;2121;6950;319;1200;91;252;410;1452
412410;201704;5044;14844;4035;12929;1013;3734;857;2648;1870;6382
412420;201704;404;1184;249;805;39;133;81;225;120;358
412430;201704;544;1515;388;1216;64;231;111;329;175;560
412440;201704;3055;9208;2328;7787;597;2168;502;1690;1099;3858
412450;201704;274;902;212;739;28;96;21;58;49;154
412460;201704;737;2293;623;2035;155;522;140;456;295;978
412470;201704;1849;6184;1530;5383;477;1775;306;1135;783;2910
412480;201704;1123;3362;765;2456;117;413;98;250;215;663
412490;201704;900;2628;757;2333;147;465;279;818;426;1283
412500;201704;1891;5378;1557;4699;277;929;375;1007;652;1936
412510;201704;2198;7097;1733;5938;495;1819;314;1004;809;2823
412520;201704;1430;4069;1061;3283;291;942;133;383;424;1325
412530;201704;554;1622;433;1341;81;274;76;231;157;505
412535;201704;1023;3253;774;2685;93;315;353;1334;446;1649
412540;201704;1209;3394;903;2754;120;428;261;800;381;1228
412545;201704;720;2055;530;1630;100;335;138;374;238;709
412550;201704;30962;91996;21715;71373;4696;16506;4912;15241;9608;31747
412555;201704;249;733;176;570;28;93;37;102;65;195
412560;201704;5348;16285;4074;13376;789;2975;984;3097;1773;6072
412570;201704;4194;12066;2769;9026;591;2136;371;1215;962;3351
412575;201704;856;2609;673;2155;130;450;203;616;333;1066
412580;201704;1297;3540;923;2795;168;569;349;980;517;1549
412590;201704;443;1284;268;905;50;166;38;125;88;291
412600;201704;1424;4280;1066;3472;216;788;295;910;511;1698
412610;201704;752;2238;476;1543;104;345;142;437;246;782
412620;201704;1228;3788;967;3273;267;1051;192;555;459;1606
412625;201704;8442;24419;6199;19876;1218;4282;565;1682;1783;5964
412627;201704;980;3002;704;2349;206;757;150;493;356;1250
412630;201704;3159;9869;2434;8213;497;1681;679;2199;1176;3880
412635;201704;463;1339;323;1027;66;222;40;102;106;324
412640;201704;932;2745;592;1952;93;338;83;263;176;601
412650;201704;1593;4772;1339;4270;269;994;414;1211;683;2205
412660;201704;2550;7179;1992;6104;413;1431;448;1223;861;2654
412665;201704;637;1637;359;1098;85;273;80;224;165;497
412667;201704;1710;4817;1337;4073;256;869;448;1314;704;2183
412670;201704;528;1622;428;1431;127;467;82;256;209;723
412680;201704;1385;4086;857;2926;141;525;198;600;339;1125
412690;201704;766;2287;597;1933;127;430;140;477;267;907
412700;201704;1895;5539;1554;5014;445;1640;444;1373;889;3013
412710;201704;6303;19880;5342;17873;1182;4368;1323;4077;2505;8445
412720;201704;1386;4266;1006;3337;160;565;173;496;333;1061
412730;201704;2122;6337;1241;4236;263;966;139;449;402;1415
412740;201704;1530;4790;1109;3824;247;949;136;507;383;1456
412750;201704;4139;12225;3642;11380;501;1817;2183;6670;2684;8487
412760;201704;2442;7584;2279;7285;303;1104;1438;4486;1741;5590
412770;201704;10615;29118;6060;19434;829;2872;1009;2857;1838;5729
412780;201704;1287;3854;1088;3469;226;791;444;1358;670;2149
412785;201704;2190;6025;1649;4971;395;1196;703;2190;1098;3386
412788;201704;1439;4494;1223;4047;335;1220;355;1069;690;2289
412790;201704;1073;3211;742;2458;166;594;146;405;312;999
412795;201704;1017;2789;690;2091;122;399;230;682;352;1081
412796;201704;2633;7986;2383;7490;507;1742;982;2913;1489;4655
412800;201704;3188;8921;2388;7204;369;1263;828;2310;1197;3573
412810;201704;11427;30950;6787;21046;894;3180;1623;4228;2517;7408
412820;201704;7337;21252;5390;17326;1200;4101;1354;4415;2554;8516
412830;201704;362;1105;269;909;44;161;61;207;105;368
412840;201704;1833;5155;1458;4380;250;807;353;1038;603;1845
412850;201704;2834;8201;2243;7120;445;1572;665;1973;1110;3545
412853;201704;1774;5013;1560;4592;163;539;801;2184;964;2723
412855;201704;1383;4024;1030;3195;209;718;207;513;416;1231
412860;201704;1153;3295;918;2840;236;800;311;904;547;1704
412862;201704;744;1894;486;1427;76;243;129;396;205;639
412863;201704;1158;3849;1125;3792;125;473;834;2772;959;3245
412865;201704;724;2128;535;1753;111;369;153;535;264;904
412870;201704;914;2604;723;2267;282;992;98;299;380;1291
412880;201704;792;2352;611;1956;149;543;49;126;198;669
420005;201704;533;1579;314;1074;54;206;108;354;162;560
420010;201704;3229;8854;2550;7884;309;1010;1736;5430;2045;6440
420020;201704;629;2006;374;1358;49;226;43;134;92;360
420030;201704;443;1147;225;755;52;211;22;76;74;287
420040;201704;677;2167;406;1540;83;349;30;94;113;443
420050;201704;720;2040;479;1533;100;343;197;615;297;958
420055;201704;186;568;104;366;19;75;17;55;36;130
420060;201704;225;721;154;548;21;93;28;81;49;174
420070;201704;1265;4032;952;3265;175;652;346;1209;521;1861
420075;201704;163;437;86;266;17;57;11;21;28;78
420080;201704;581;1813;474;1603;144;512;130;443;274;955
420090;201704;402;1366;289;1084;76;294;53;211;129;505
420100;201704;1173;3649;1074;3504;206;718;653;2119;859;2837
420110;201704;293;989;274;945;80;297;82;269;162;566
420120;201704;263;898;212;782;63;260;53;173;116;433
420125;201704;306;1095;278;1038;81;333;122;433;203;766
420127;201704;454;1294;167;600;39;164;15;42;54;206
420130;201704;1860;6203;1493;5437;402;1648;327;1078;729;2726
420140;201704;4142;12297;3044;10139;711;2684;457;1357;1168;4041
420150;201704;534;1498;377;1233;45;165;180;552;225;717
420160;201704;261;700;148;490;29;102;40;128;69;230
420165;201704;219;680;129;449;26;99;30;96;56;195
420170;201704;206;623;126;460;38;170;13;39;51;209
420180;201704;363;1083;202;709;25;91;45;148;70;239
420190;201704;360;1099;192;696;34;125;19;60;53;185
420195;201704;1334;3918;1081;3458;282;995;218;660;500;1655
420200;201704;2564;7811;1566;5574;332;1359;274;905;606;2264
420205;201704;1143;3584;912;3138;181;670;485;1676;666;2346
420207;201704;1503;4390;1044;3457;286;1075;222;689;508;1764
420208;201704;585;1559;325;1114;64;252;123;439;187;691
420209;201704;273;837;171;592;31;120;71;239;102;359
420210;201704;1959;5671;1259;4509;300;1260;463;1563;763;2823
420213;201704;782;2729;728;2606;183;708;362;1308;545;2016
420215;201704;313;998;205;742;60;224;18;73;78;297
420220;201704;170;594;139;531;37;161;45;162;82;323
420230;201704;4147;12170;3161;10408;615;2406;1155;3635;1770;6041
420240;201704;11031;30638;7189;23356;1106;4231;3172;9359;4278;13590
420243;201704;592;1757;466;1512;93;321;160;514;253;835
420245;201704;1278;3704;865;2871;129;499;332;989;461;1488
420250;201704;506;1618;452;1517;99;389;207;661;306;1050
420253;201704;519;1329;385;1144;43;124;223;689;266;813
420257;201704;292;798;184;601;39;133;78;253;117;386
420260;201704;1154;3662;930;3252;182;704;400;1402;582;2106
420270;201704;678;1986;258;873;39;146;65;190;104;336
420280;201704;2076;5660;1279;4238;275;1008;393;1241;668;2249
420285;201704;149;428;70;259;11;48;5;11;16;59
420287;201704;506;1444;407;1292;131;448;125;405;256;853
420290;201704;5812;17412;4002;13249;802;2851;1189;3618;1991;6469
420300;201704;6671;19659;4210;14313;896;3422;788;2445;1684;5867
420310;201704;819;2128;630;1773;78;257;449;1206;527;1463
420315;201704;946;2980;722;2523;219;820;224;778;443;1598
420320;201704;4484;13792;3697;12365;1139;4259;1117;3632;2256;7891
420325;201704;207;694;178;628;34;128;62;210;96;338
420330;201704;961;3237;702;2594;136;549;207;725;343;1274
420340;201704;1407;4267;1033;3423;201;726;79;235;280;961
420350;201704;1473;4287;1062;3450;232;835;448;1416;680;2251
420360;201704;2896;8755;1775;6278;369;1471;160;534;529;2005
420370;201704;1738;4942;1380;4319;166;587;941;2888;1107;3475
420380;201704;5292;15529;3497;11654;798;2898;892;2895;1690;5793
420390;201704;1256;3493;739;2414;136;518;161;397;297;915
420395;201704;1259;3865;856;2945;131;514;93;275;224;789
420400;201704;1184;3517;827;2790;181;702;168;516;349;1218
420410;201704;697;1868;487;1501;80;292;297;885;377;1177
420415;201704;469;1433;345;1152;95;337;93;313;188;650
420417;201704;712;2255;569;1901;106;383;244;803;350;1186
420419;201704;306;999;215;791;73;294;11;45;84;339
420420;201704;10424;31403;8349;27353;2948;10468;1742;5350;4690;15818
420425;201704;1186;3139;801;2426;91;349;336;950;427;1299
420430;201704;3369;10165;2197;7386;470;1729;654;2096;1124;3825
420435;201704;264;775;163;555;35;144;75;240;110;384
420440;201704;803;2455;457;1540;156;568;100;301;256;869
420445;201704;384;1102;254;812;52;176;74;228;126;404
420450;201704;770;2359;545;1854;107;394;137;436;244;830
420455;201704;1932;5615;1606;5030;253;978;740;2169;993;3147
420460;201704;8708;25261;6699;21718;1467;5459;2547;7838;4014;13297
420470;201704;1033;2704;589;1861;113;397;173;508;286;905
420475;201704;98;284;50;177;19;67;5;15;24;82
420480;201704;4883;13995;3520;11404;822;2883;716;2283;1538;5166
420490;201704;643;1678;357;1198;90;336;69;248;159;584
420500;201704;1438;4502;1082;3794;331;1292;322;1114;653;2406
420510;201704;125;454;97;379;22;100;50;192;72;292
420515;201704;77;240;63;218;14;57;18;63;32;120
420517;201704;855;2551;754;2373;97;339;488;1516;585;1855
420519;201704;466;1210;302;920;52;175;77;218;129;393
420520;201704;636;1633;322;1049;50;161;57;146;107;307
420530;201704;1180;3712;851;2993;191;761;213;646;404;1407
420535;201704;266;765;130;448;31;111;14;59;45;170
420540;201704;22348;62655;15629;48731;3379;11561;4255;11684;7634;23245
420543;201704;354;918;280;800;46;105;181;541;227;646
420545;201704;1602;4971;1278;4263;311;1140;372;1188;683;2328
420550;201704;3973;12307;2900;10181;786;3226;541;1836;1327;5062
420555;201704;353;1056;269;888;48;168;95;296;143;464
420560;201704;466;1339;349;1126;62;208;178;559;240;767
420570;201704;2163;6767;1661;5659;400;1539;548;1724;948;3263
420580;201704;1567;4661;1234;4101;297;1126;507;1661;804;2787
420590;201704;3300;9727;2109;6982;440;1600;338;952;778;2552
420600;201704;935;2986;848;2812;155;542;497;1679;652;2221
420610;201704;502;1516;285;1017;68;264;59;206;127;470
420620;201704;547;1676;480;1545;132;451;135;437;267;888
420630;201704;983;3002;720;2372;170;614;269;816;439;1430
420640;201704;772;2290;384;1393;96;395;31;107;127;502
420650;201704;2471;7165;1590;5384;281;1012;381;1171;662;2183
420660;201704;464;1365;327;1080;56;206;92;297;148;503
420665;201704;687;1925;464;1517;69;267;153;451;222;718
420670;201704;1676;4907;1176;3867;235;930;286;830;521;1760
420675;201704;177;583;133;471;25;107;28;92;53;199
420680;201704;348;880;220;693;39;131;90;270;129;401
420690;201704;860;2972;630;2317;109;433;94;291;203;724
420700;201704;3067;8973;2371;7578;453;1611;814;2465;1267;4076
420710;201704;638;2088;485;1749;125;525;157;519;282;1044
420720;201704;1666;4733;1284;4194;383;1310;543;1775;926;3085
420730;201704;3119;9263;2552;8288;550;1972;1108;3506;1658;5478
420740;201704;795;2446;623;2086;184;666;179;569;363;1235
420750;201704;2077;6620;1554;5422;250;972;504;1586;754;2558
420757;201704;90;195;32;107;5;19;13;42;18;61
420760;201704;377;1175;192;654;41;148;24;69;65;217
420765;201704;540;1708;285;1058;61;243;57;203;118;446
420768;201704;1203;4022;969;3548;353;1277;385;1494;738;2771
420770;201704;526;1556;309;1120;70;282;61;230;131;512
420775;201704;632;1898;365;1253;74;273;45;144;119;417
420780;201704;1405;4238;842;2901;160;585;125;407;285;992
420785;201704;262;779;198;629;32;101;49;139;81;240
420790;201704;1218;4120;948;3526;251;1018;346;1232;597;2250
420800;201704;888;2478;444;1452;86;313;137;432;223;745
420810;201704;1960;6568;1577;5758;500;2059;331;1128;831;3187
420820;201704;8575;25298;6013;20921;1488;5801;1608;5478;3096;11279
420830;201704;2819;8670;2296;7694;642;2370;751;2485;1393;4855
420840;201704;1010;2937;481;1700;96;376;85;278;181;654
420845;201704;1476;4282;978;3367;249;1010;216;689;465;1699
420850;201704;1478;4675;909;3385;197;822;71;251;268;1073
420860;201704;389;1094;228;786;62;241;42;139;104;380
420870;201704;1062;2985;832;2611;301;1076;208;589;509;1665
420880;201704;981;3296;766;2734;175;696;130;410;305;1106
420890;201704;9029;24281;4762;15655;801;2900;1087;3168;1888;6068
420895;201704;205;590;117;379;31;100;22;65;53;165
420900;201704;1770;4938;1149;3771;226;847;304;911;530;1758
420910;201704;23864;69470;16472;55177;2980;11252;5249;16343;8229;27595
420915;201704;549;2136;391;1661;80;358;174;685;254;1043
420917;201704;482;1464;224;733;36;138;88;256;124;394
420920;201704;169;488;77;268;10;41;10;27;20;68
420930;201704;18300;51599;13917;44023;2905;10173;5496;16690;8401;26863
420940;201704;2847;8353;2107;6917;554;2016;163;476;717;2492
420945;201704;202;603;134;451;30;120;35;102;65;222
420950;201704;588;1635;302;1050;40;180;67;224;107;404
420960;201704;933;2641;740;2302;148;510;284;836;432;1346
420970;201704;2591;7928;1996;6798;606;2235;386;1340;992;3575
420980;201704;444;1310;345;1161;125;450;122;456;247;906
420985;201704;478;1343;221;781;47;199;56;179;103;378
420990;201704;778;2183;435;1497;84;316;59;169;143;485
421000;201704;550;1862;357;1375;68;278;60;196;128;474
421003;201704;691;1829;252;842;28;96;21;58;49;154
421005;201704;138;423;105;367;27;97;49;188;76;285
421010;201704;5020;14192;3528;11558;811;2968;739;2225;1550;5193
421020;201704;433;1332;320;1130;34;143;190;662;224;805
421030;201704;749;2637;650;2387;212;874;110;375;322;1249
421040;201704;929;2313;589;1787;85;301;301;878;386;1179
421050;201704;1586;4553;932;3143;193;703;210;657;403;1360
421055;201704;203;570;111;357;24;74;22;55;46;129
421060;201704;551;1801;373;1352;88;343;119;421;207;764
421070;201704;665;2110;430;1525;93;359;56;194;149;553
421080;201704;758;3111;682;2998;88;288;523;2483;611;2771
421085;201704;508;1418;253;890;52;202;59;188;111;390
421090;201704;400;1106;189;618;28;104;46;140;74;244
421100;201704;969;2557;508;1593;115;393;59;162;174;555
421105;201704;1493;4446;1196;3956;250;880;410;1430;660;2310
421110;201704;942;3323;861;3139;332;1264;185;613;517;1877
421120;201704;1290;4140;865;3119;129;544;210;665;339;1209
421125;201704;404;1108;300;937;84;287;89;248;173;535
421130;201704;3278;10709;2817;9790;917;3437;954;3372;1871;6809
421140;201704;320;926;238;759;46;149;90;265;136;414
421145;201704;556;1718;346;1158;53;179;104;341;157;520
421150;201704;613;1744;445;1478;95;368;171;535;266;903
421160;201704;1148;3161;575;1871;110;408;194;591;304;999
421165;201704;226;760;191;680;26;88;91;341;117;429
421170;201704;1285;3630;1024;3226;168;572;590;1860;758;2432
421175;201704;1197;3356;834;2696;160;619;303;872;463;1491
421180;201704;544;1487;270;907;63;239;50;165;113;404
421185;201704;405;1104;286;882;65;199;117;381;182;580
421187;201704;346;1031;236;777;37;120;87;270;124;390
421189;201704;404;1250;320;1070;61;214;89;291;150;505
421190;201704;11435;32194;7021;23623;1472;5560;1102;3454;2574;9014
421200;201704;899;2910;749;2599;162;603;259;853;421;1456
421205;201704;213;634;154;514;39;156;45;129;84;285
421210;201704;1385;4170;1015;3337;263;882;264;884;527;1766
421220;201704;1706;5783;1502;5311;468;1842;226;688;694;2530
421223;201704;513;1602;370;1316;78;301;134;492;212;793
421225;201704;1107;3519;946;3182;204;745;385;1329;589;2074
421227;201704;863;2596;686;2269;138;528;371;1187;509;1715
421230;201704;458;1457;386;1331;91;333;163;552;254;885
421240;201704;399;1258;214;783;21;101;25;77;46;178
421250;201704;1607;4564;1033;3559;289;1092;198;669;487;1761
421260;201704;355;1004;86;309;17;59;12;42;29;101
421265;201704;786;2341;693;2196;110;403;425;1313;535;1716
421270;201704;739;2017;386;1275;76;254;83;288;159;542
421280;201704;1556;4897;1233;4316;312;1253;511;1739;823;2992
421290;201704;1031;2915;607;1946;103;361;108;304;211;665
421300;201704;288;861;215;710;54;225;87;254;141;479
421310;201704;207;633;162;520;29;101;55;176;84;277
421315;201704;326;969;192;670;34;127;31;102;65;229
421320;201704;630;1903;389;1326;75;260;58;147;133;407
421330;201704;586;1878;450;1614;129;501;102;382;231;883
421335;201704;474;1589;398;1434;87;359;83;310;170;669
421340;201704;1750;4906;1382;4311;190;733;756;2307;946;3040
421350;201704;1084;3479;903;3109;153;641;486;1598;639;2239
421360;201704;2796;7940;1766;5941;378;1483;495;1519;873;3002
421370;201704;547;1847;409;1520;124;507;110;397;234;904
421380;201704;915;2634;774;2369;128;427;381;1103;509;1530
421390;201704;181;508;78;263;17;63;25;79;42;142
421400;201704;289;966;209;814;58;257;70;249;128;506
421410;201704;308;877;188;635;22;81;76;261;98;342
421415;201704;371;1185;161;581;36;142;26;87;62;229
421420;201704;765;2285;580;1889;92;340;234;700;326;1040
421430;201704;196;626;150;535;31;117;38;142;69;259
421440;201704;847;2400;571;1935;116;443;239;809;355;1252
421450;201704;422;1288;255;916;36;146;26;105;62;251
421460;201704;585;1639;312;1126;58;226;73;278;131;504
421470;201704;381;1242;296;1064;76;316;83;276;159;592
421480;201704;3076;8567;2021;6728;698;2740;266;672;964;3412
421490;201704;268;796;125;467;24;105;21;70;45;175
421500;201704;2066;6989;1682;6176;531;2167;209;739;740;2906
421505;201704;359;1159;315;1063;72;251;148;499;220;750
421507;201704;530;1595;352;1226;83;314;87;306;170;620
421510;201704;197;634;154;542;30;125;74;214;104;339
421520;201704;708;1957;465;1416;70;251;186;501;256;752
421530;201704;320;989;190;692;34;160;34;103;68;263
421535;201704;663;1922;370;1313;42;169;160;526;202;695
421540;201704;331;889;246;745;55;181;90;248;145;429
421545;201704;804;2492;582;2073;147;589;164;560;311;1149
421550;201704;2090;6457;1761;5896;506;1919;609;1935;1115;3854
421555;201704;297;875;108;384;14;59;14;40;28;99
421560;201704;139;433;76;276;13;50;14;53;27;103
421565;201704;772;2262;680;2141;202;712;318;1026;520;1738
421567;201704;583;2109;506;1928;256;1007;120;462;376;1469
421568;201704;509;1554;344;1173;72;270;100;339;172;609
421569;201704;230;687;101;369;20;73;15;58;35;131
421570;201704;1363;4075;800;2747;185;661;124;411;309;1072
421575;201704;347;1178;304;1051;51;187;156;532;207;719
421580;201704;2961;9348;2244;7775;524;2099;613;1899;1137;3998
421590;201704;213;647;168;560;25;90;86;279;111;369
421600;201704;475;1452;353;1172;84;295;75;227;159;522
421605;201704;614;1882;448;1572;88;347;129;444;217;791
421610;201704;1376;3734;969;2978;168;572;355;1044;523;1616
421620;201704;4427;13259;2912;10140;800;2977;752;2619;1552;5596
421625;201704;372;1024;152;516;31;107;19;59;50;166
421630;201704;3023;8894;1699;5761;321;1224;268;831;589;2055
421635;201704;225;663;121;393;17;68;34;80;51;148
421640;201704;1080;3116;765;2520;159;556;273;886;432;1442
421650;201704;2196;6862;1604;5552;411;1634;206;571;617;2205
421660;201704;7623;24620;6370;22091;1381;5339;2109;6818;3490;12157
421670;201704;1055;3119;732;2404;177;670;217;668;394;1338
421680;201704;1135;3609;927;3163;308;1122;221;731;529;1853
421690;201704;1432;4608;1067;3767;232;928;142;443;374;1371
421700;201704;468;1519;260;980;48;194;69;240;117;434
421710;201704;210;696;93;341;14;54;25;81;39;135
421715;201704;221;581;116;372;27;87;40;119;67;206
421720;201704;1943;5687;1194;4172;303;1164;169;528;472;1692
421725;201704;143;422;103;337;32;117;31;86;63;203
421730;201704;583;1657;282;935;39;134;73;221;112;355
421740;201704;696;2237;476;1687;107;433;92;304;199;737
421750;201704;1010;2642;611;1875;106;347;220;613;326;960
421755;201704;302;866;171;550;35;130;53;156;88;286
421760;201704;951;2859;483;1703;72;259;88;306;160;565
421770;201704;2897;8549;2178;7156;527;1805;704;2430;1231;4235
421775;201704;465;1349;324;1083;58;211;111;360;169;571
421780;201704;1025;3455;777;2866;182;771;216;726;398;1497
421790;201704;801;2104;467;1596;192;712;115;348;307;1060
421795;201704;362;1058;216;684;39;133;59;174;98;307
421800;201704;2681;7974;2002;6689;436;1582;780;2504;1216;4086
421810;201704;633;1866;448;1492;107;416;112;323;219;739
421820;201704;990;2858;593;2006;101;370;74;207;175;577
421825;201704;1439;4461;1349;4297;169;609;958;2973;1127;3582
421830;201704;2507;8402;2207;7804;532;2092;790;2657;1322;4749
421835;201704;159;472;118;413;17;76;76;260;93;336
421840;201704;288;901;202;713;44;187;69;214;113;401
421850;201704;436;1377;258;918;43;179;59;192;102;371
421860;201704;299;905;191;678;33;133;45;130;78;263
421870;201704;3709;10459;2595;8220;727;2528;599;1839;1326;4367
421875;201704;401;1171;185;655;33;126;22;64;55;190
421880;201704;806;2451;603;2014;144;528;118;371;262;899
421885;201704;292;906;239;820;74;271;66;208;140;479
421890;201704;831;2799;705;2552;244;1017;211;691;455;1708
421895;201704;389;1210;346;1138;67;244;206;673;273;917
421900;201704;959;2663;604;1934;152;516;165;495;317;1011
421910;201704;473;1470;330;1153;67;281;63;180;130;461
421915;201704;483;1454;301;1021;59;201;48;165;107;366
421917;201704;595;1676;415;1408;131;497;116;383;247;880
421920;201704;678;1928;435;1583;215;800;119;465;334;1265
421930;201704;3024;7853;1608;5349;400;1452;230;687;630;2139
421935;201704;635;2041;477;1689;99;410;170;559;269;969
421940;201704;230;778;140;519;24;108;30;96;54;204
421950;201704;3483;9382;1659;5529;365;1348;218;721;583;2069
421960;201704;183;538;136;457;26;101;29;99;55;200
421970;201704;2334;6321;1353;4298;354;1177;337;993;691;2170
421985;201704;451;1165;246;759;37;138;67;215;104;353
422000;201704;1335;3974;1105;3528;283;1025;427;1340;710;2365
430003;201704;596;1895;502;1723;136;530;158;520;294;1050
430005;201704;342;997;239;798;55;198;98;309;153;507
430010;201704;2040;5564;1583;4764;357;1178;716;2152;1073;3330
430020;201704;671;1639;559;1484;82;254;347;884;429;1138
430030;201704;1091;2778;742;2141;217;655;169;480;386;1135
430040;201704;10666;28307;7607;22554;2006;6635;769;2121;2775;8756
430045;201704;698;1881;522;1524;79;243;219;621;298;864
430047;201704;295;690;135;401;16;49;43;128;59;177
430050;201704;1050;2855;603;1903;126;407;137;416;263;823
430055;201704;306;800;156;475;12;41;69;204;81;245
430057;201704;70;174;38;110;6;17;6;9;12;26
430060;201704;17000;53132;14560;48988;4006;14537;5634;19169;9640;33706
430063;201704;976;2838;763;2381;180;567;370;1167;550;1734
430064;201704;1223;3639;968;3162;262;893;299;971;561;1864
430066;201704;168;391;113;304;8;25;62;164;70;189
430070;201704;656;1747;170;568;21;78;15;39;36;117
430080;201704;735;2048;441;1458;102;373;137;407;239;780
430085;201704;958;2444;588;1774;116;386;159;500;275;886
430087;201704;798;2495;704;2310;136;508;340;1029;476;1537
430090;201704;671;1763;246;798;31;117;60;192;91;309
430100;201704;855;2244;440;1388;109;373;117;318;226;691
430105;201704;1028;2942;680;2300;164;624;237;794;401;1418
430107;201704;217;706;162;563;25;94;38;119;63;213
430110;201704;1936;5444;1571;4876;338;1100;738;2198;1076;3298
430120;201704;1612;4847;1156;3873;263;914;461;1585;724;2499
430130;201704;3948;10787;3334;9814;920;2642;1257;4107;2177;6749
430140;201704;1165;3560;772;2653;207;743;234;795;441;1538
430150;201704;730;1940;467;1429;102;344;122;385;224;729
430155;201704;316;875;185;600;28;101;47;143;75;244
430160;201704;16775;47637;14462;43777;3479;11360;5656;17450;9135;28810
430163;201704;1989;5693;1579;4990;239;825;874;2757;1113;3582
430165;201704;468;1141;120;398;16;54;13;30;29;84
430170;201704;943;2686;369;1326;60;238;50;151;110;389
430175;201704;881;2748;742;2420;183;583;314;1067;497;1650
430180;201704;793;2187;664;1966;129;445;355;997;484;1442
430185;201704;506;1347;306;962;57;194;104;279;161;473
430187;201704;670;1963;534;1678;108;383;199;600;307;983
430190;201704;1579;4698;1367;4271;277;942;689;2105;966;3047
430192;201704;181;550;83;265;10;37;10;24;20;61
430195;201704;387;1171;96;316;9;34;3;8;12;42
430200;201704;1326;4217;1140;3829;344;1190;308;1035;652;2225
430205;201704;544;1535;413;1277;40;152;285;865;325;1017
430210;201704;6057;15941;3868;11398;562;1854;1253;3019;1815;4873
430215;201704;341;933;236;716;49;162;88;247;137;409
430220;201704;657;1676;228;755;41;156;40;115;81;271
430222;201704;261;813;210;697;39;143;89;280;128;423
430223;201704;361;1002;294;883;60;180;138;424;198;604
430225;201704;34;83;15;41;4;11;6;15;10;26
430230;201704;1608;4788;1538;4699;279;762;1173;3726;1452;4488
430235;201704;266;851;215;731;45;174;69;222;114;396
430237;201704;551;1389;398;1140;45;153;231;616;276;769
430240;201704;1029;2602;711;2097;89;326;369;1032;458;1358
430245;201704;833;2571;650;2190;188;623;262;938;450;1561
430250;201704;1069;3086;958;2905;300;973;92;257;392;1230
430258;201704;160;448;119;377;11;39;49;160;60;199
430260;201704;676;1925;508;1588;92;303;241;790;333;1093
430265;201704;269;826;210;716;50;168;33;117;83;285
430270;201704;2818;7784;2431;7144;347;1176;1463;4166;1810;5342
430280;201704;4778;12665;3807;10977;833;2481;1665;4856;2498;7337
430290;201704;2421;6276;2225;5985;114;348;1908;5104;2022;5452
430300;201704;9039;26160;7496;23231;1633;5458;3351;10490;4984;15948
430310;201704;6788;20021;5237;17064;1120;4056;2093;6473;3213;10529
430320;201704;844;2461;525;1765;100;297;238;842;338;1139
430330;201704;672;1774;523;1492;130;378;221;580;351;958
430340;201704;721;1750;375;1162;76;243;169;516;245;759
430350;201704;6001;17986;5102;16085;1806;5923;1543;4716;3349;10639
430355;201704;410;1025;155;487;29;104;17;53;46;157
430360;201704;991;2643;776;2234;168;533;272;729;440;1262
430367;201704;240;656;157;487;37;136;56;162;93;298
430370;201704;531;1465;329;1059;67;225;69;201;136;426
430380;201704;727;1896;410;1318;126;436;101;325;227;761
430390;201704;3847;10610;2398;7665;425;1530;268;801;693;2331
430400;201704;1337;3204;995;2649;251;659;434;1126;685;1785
430410;201704;600;1575;419;1258;62;212;221;643;283;855
430420;201704;3494;10080;2764;8437;745;2357;906;2717;1651;5074
430430;201704;665;1821;425;1364;108;377;95;305;203;682
430435;201704;2041;5468;1484;4468;374;1155;431;1336;805;2491
430440;201704;4072;12644;3161;10565;663;2326;1311;4495;1974;6821
430450;201704;6934;19260;5718;16942;1645;5147;1735;5229;3380;10376
430460;201704;28022;82586;21697;71389;5763;20987;6419;20695;12182;41682
430461;201704;510;1344;163;515;21;66;33;99;54;165
430462;201704;295;829;196;661;37;138;35;132;72;270
430463;201704;4051;12805;3448;11654;763;2783;1621;5532;2384;8315
430465;201704;593;1636;503;1477;115;357;270;774;385;1131
430466;201704;3651;9673;3128;8868;691;2126;1633;4445;2324;6571
430467;201704;465;1352;387;1194;74;250;155;441;229;691
430468;201704;1383;3847;1166;3493;254;807;524;1549;778;2356
430469;201704;518;1422;65;213;8;18;10;22;18;40
430470;201704;7698;20460;5426;16688;1613;5293;1006;3156;2619;8449
430471;201704;507;1672;459;1565;116;403;145;511;261;914
430480;201704;1010;2677;526;1680;80;271;90;248;170;519
430485;201704;160;453;78;254;14;53;14;35;28;88
430490;201704;286;833;190;626;41;146;78;271;119;417
430495;201704;381;1130;250;859;46;173;85;273;131;446
430500;201704;1135;3120;936;2802;211;706;430;1233;641;1939
430510;201704;22433;63917;17535;54436;4970;16857;5272;15360;10242;32217
430511;201704;380;1175;168;593;31;108;13;33;44;141
430512;201704;1047;2681;897;2424;236;687;262;744;498;1431
430513;201704;800;2064;451;1310;108;340;164;443;272;783
430515;201704;471;1332;334;1055;53;157;153;504;206;661
430517;201704;1160;3627;952;3202;172;599;465;1589;637;2188
430520;201704;1504;4124;923;2891;174;621;209;593;383;1214
430530;201704;1135;2981;486;1519;82;270;116;329;198;599
430535;201704;2527;7441;1914;6248;397;1406;721;2301;1118;3707
430537;201704;459;1498;386;1332;37;149;260;882;297;1031
430540;201704;707;1560;467;1233;84;232;279;729;363;961
430543;201704;488;1201;425;1133;73;196;295;805;368;1001
430544;201704;653;2078;542;1823;119;447;264;842;383;1289
430545;201704;1339;4267;1175;4060;363;1359;521;1811;884;3170
430550;201704;609;1712;351;1145;77;260;66;198;143;458
430558;201704;81;241;51;162;11;40;14;35;25;75
430560;201704;393;937;185;559;12;42;58;169;70;211
430570;201704;1079;2762;702;2036;134;453;287;707;421;1160
430580;201704;1218;3043;775;2323;113;368;368;1126;481;1494
430583;201704;171;453;39;126;4;13;7;24;11;37
430585;201704;305;768;180;518;30;106;78;194;108;300
430587;201704;166;520;130;427;30;105;50;173;80;278
430590;201704;1217;3292;1113;3118;101;328;862;2363;963;2691
430593;201704;23;85;21;78;5;20;8;28;13;48
430595;201704;301;868;85;296;10;46;10;27;20;73
430597;201704;344;1007;237;749;30;105;67;174;97;279
430600;201704;1933;5211;1020;3127;180;587;288;819;468;1406
430605;201704;1266;3742;978;3159;165;628;409;1309;574;1937
430607;201704;763;1800;560;1499;53;154;348;961;401;1115
430610;201704;7399;19776;5684;17092;1675;5488;1147;3482;2822;8970
430613;201704;274;671;110;342;7;23;29;75;36;98
430620;201704;692;1928;576;1701;149;478;238;679;387;1157
430630;201704;452;1383;171;571;23;83;28;82;51;165
430632;201704;650;1824;322;1019;46;164;113;315;159;479
430635;201704;585;1668;454;1399;87;303;237;707;324;1010
430637;201704;483;1361;428;1253;69;228;238;653;307;881
430640;201704;1593;4233;768;2468;105;345;99;283;204;628
430642;201704;469;1218;306;922;53;158;124;387;177;545
430645;201704;280;638;110;308;20;55;29;82;49;137
430650;201704;1767;5682;1507;5144;317;1119;801;2783;1118;3902
430655;201704;164;423;142;380;35;115;69;155;104;270
430660;201704;5415;15055;4346;13160;988;3231;1840;5515;2828;8746
430670;201704;470;1337;429;1263;39;127;310;931;349;1058
430673;201704;732;1713;321;956;74;228;83;241;157;469
430675;201704;237;698;76;264;11;49;19;55;30;104
430676;201704;3679;10788;2986;9506;717;2450;998;3187;1715;5637
430680;201704;1073;3028;644;2124;129;436;127;385;256;821
430690;201704;3963;11314;3206;9841;1030;3321;706;2177;1736;5498
430692;201704;259;855;199;744;16;72;135;498;151;570
430693;201704;1218;3286;716;2249;161;551;121;347;282;898
430695;201704;571;1528;376;1114;58;195;162;453;220;648
430697;201704;449;1255;324;1029;72;242;125;412;197;654
430700;201704;9450;24106;4894;15651;887;3243;385;1194;1272;4437
430705;201704;271;822;210;675;54;182;58;172;112;354
430710;201704;1698;4273;1277;3548;253;779;533;1486;786;2265
430720;201704;775;1939;510;1524;119;377;168;514;287;891
430730;201704;1598;4132;1028;3173;189;605;427;1359;616;1964
430740;201704;629;1758;357;1179;71;245;69;248;140;493
430745;201704;491;1406;246;796;36;114;39;126;75;240
430750;201704;1477;4046;1143;3462;218;727;581;1730;799;2457
430755;201704;485;1284;312;923;26;89;145;391;171;480
430760;201704;2802;6885;1887;5572;444;1475;722;2205;1166;3680
430770;201704;6305;18074;5027;15722;864;2970;2687;8218;3551;11188
430780;201704;2472;6523;1544;4828;295;989;465;1450;760;2439
430781;201704;428;1263;304;999;74;247;76;260;150;507
430783;201704;540;1306;331;954;45;142;151;412;196;554
430786;201704;75;256;51;202;8;30;10;38;18;68
430790;201704;4556;12432;3155;9638;669;2248;1220;3512;1889;5760
430800;201704;896;2495;604;1858;117;392;228;678;345;1070
430805;201704;549;1523;325;1026;31;93;147;454;178;547
430807;201704;482;1334;324;1008;53;185;104;311;157;496
430810;201704;718;1960;254;886;49;179;43;150;92;329
430820;201704;1388;3979;801;2699;165;579;152;490;317;1069
430825;201704;309;841;127;393;24;62;23;56;47;118
430830;201704;1739;5301;1582;5078;221;790;1094;3502;1315;4292
430840;201704;989;2939;861;2709;214;663;394;1269;608;1932
430843;201704;89;223;37;113;6;18;11;30;17;48
430845;201704;262;760;213;662;95;326;21;48;116;374
430850;201704;2390;6985;2014;6265;524;1766;795;2446;1319;4212
430860;201704;1040;2664;499;1557;99;365;176;507;275;872
430865;201704;598;1574;537;1479;167;486;246;660;413;1146
430870;201704;757;2074;383;1261;83;280;75;223;158;503
430880;201704;1180;3246;828;2552;230;746;238;748;468;1494
430885;201704;249;583;140;420;13;46;100;306;113;352
430890;201704;1656;4445;1094;3324;72;276;180;471;252;747
430900;201704;2681;6986;2088;5976;397;1294;930;2542;1327;3836
430905;201704;1076;3058;691;2238;152;508;153;476;305;984
430910;201704;1634;4763;1094;3572;231;848;383;1116;614;1964
430912;201704;462;1286;343;1071;49;170;203;628;252;798
430915;201704;587;1812;421;1502;128;494;123;477;251;971
430920;201704;17833;52697;15560;48531;2807;9698;8763;26580;11570;36278
430925;201704;140;314;61;172;11;32;19;57;30;89
430930;201704;9668;26601;6502;20855;1770;6076;1371;4690;3141;10766
430940;201704;1225;3726;696;2399;191;719;85;242;276;961
430950;201704;896;2412;597;1807;135;440;228;625;363;1065
430955;201704;173;497;72;237;14;51;12;32;26;83
430957;201704;233;766;195;691;38;129;89;324;127;453
430960;201704;1453;3756;1094;3125;237;769;511;1450;748;2219
430965;201704;1586;4287;1341;3877;94;345;995;2782;1089;3127
430970;201704;395;1081;229;728;38;121;88;267;126;388
430975;201704;556;1814;435;1524;99;370;157;564;256;934
430980;201704;374;959;244;749;53;171;87;256;140;427
430990;201704;575;1803;377;1284;69;260;112;368;181;628
430995;201704;643;1808;466;1461;119;378;181;536;300;914
431000;201704;1565;3910;737;2235;118;381;44;114;162;495
431010;201704;2613;7219;1557;5197;263;1001;171;489;434;1490
431020;201704;10276;24897;6769;18982;1659;4922;1766;4765;3425;9687
431030;201704;332;941;157;550;35;130;16;56;51;186
431033;201704;2568;7736;2239;7224;587;1932;961;3296;1548;5228
431036;201704;219;565;87;283;14;47;14;33;28;80
431040;201704;975;2690;732;2265;134;504;355;1021;489;1525
431041;201704;499;1285;433;1194;113;321;190;547;303;868
431043;201704;475;1291;259;877;99;361;56;166;155;527
431046;201704;118;328;74;227;8;30;20;60;28;90
431050;201704;1649;4151;1189;3398;277;821;534;1535;811;2356
431053;201704;589;1843;460;1562;140;509;111;371;251;880
431055;201704;674;1768;612;1674;55;171;458;1233;513;1404
431057;201704;358;1029;220;726;43;158;54;157;97;315
431060;201704;5356;15969;4701;14854;1572;5246;1244;4090;2816;9336
431065;201704;541;1515;378;1192;68;233;116;335;184;568
431070;201704;607;1764;349;1143;86;290;56;143;142;433
431075;201704;247;765;184;627;35;136;55;189;90;325
431080;201704;678;2047;481;1593;96;331;128;417;224;748
431085;201704;752;2075;595;1732;104;297;327;946;431;1243
431087;201704;526;1508;470;1395;43;123;325;982;368;1105
431090;201704;496;1214;202;621;46;159;39;108;85;267
431100;201704;3299;8991;2661;7936;698;2281;889;2586;1587;4867
431110;201704;1468;3838;1103;3114;265;779;376;998;641;1777
431112;201704;556;1791;506;1688;118;398;249;809;367;1207
431113;201704;455;1341;366;1160;114;378;104;345;218;723
431115;201704;1353;3845;1155;3506;195;621;637;1924;832;2545
431120;201704;2672;8035;2011;6658;608;2322;593;1781;1201;4103
431123;201704;443;1268;288;950;67;223;135;454;202;677
431125;201704;1325;3954;938;3115;283;964;207;766;490;1730
431127;201704;253;684;59;197;9;25;10;26;19;51
431130;201704;3388;9733;2350;7660;519;1797;686;2274;1205;4071
431140;201704;5070;12328;2821;8427;378;1250;832;2269;1210;3519
431142;201704;470;1348;397;1212;57;188;243;750;300;938
431150;201704;1019;3037;781;2518;169;593;272;877;441;1470
431160;201704;830;2356;671;2062;143;406;272;930;415;1336
431162;201704;544;1349;242;767;30;107;34;80;64;187
431164;201704;168;454;53;181;12;46;4;12;16;58
431170;201704;668;1825;472;1463;136;459;135;398;271;857
431171;201704;751;2178;650;1980;153;499;286;842;439;1341
431173;201704;462;1320;351;1125;131;452;81;256;212;708
431175;201704;1000;2754;796;2384;227;717;212;615;439;1332
431177;201704;752;2394;560;2009;165;656;193;671;358;1327
431179;201704;371;805;102;294;17;50;17;40;34;90
431180;201704;2171;6029;1472;4689;350;1211;274;824;624;2035
431190;201704;577;1589;321;1034;43;145;54;147;97;292
431198;201704;346;1135;309;1063;111;402;86;321;197;723
431200;201704;405;1128;117;403;13;37;0;0;13;37
431205;201704;256;741;110;391;26;88;35;129;61;217
431210;201704;706;1865;597;1708;150;417;309;932;459;1349
431213;201704;246;756;196;663;24;92;100;338;124;430
431215;201704;261;811;167;582;37;135;38;123;75;258
431217;201704;163;491;111;380;26;89;44;149;70;238
431220;201704;826;2258;461;1477;38;135;187;558;225;693
431225;201704;1308;3606;1002;3040;246;769;332;1041;578;1810
431230;201704;786;2317;589;1880;106;383;248;763;354;1146
431235;201704;125;350;34;104;7;22;3;5;10;27
431237;201704;472;1389;380;1240;63;251;202;633;265;884
431238;201704;29;101;23;84;8;35;6;20;14;55
431240;201704;3496;10218;2994;9353;752;2556;1215;3730;1967;6286
431242;201704;375;1105;313;990;84;263;108;361;192;624
431244;201704;354;833;193;551;28;93;74;181;102;274
431245;201704;1223;3166;812;2376;141;440;345;997;486;1437
431247;201704;203;579;132;425;29;93;31;95;60;188
431250;201704;1373;4476;1218;4246;319;1166;472;1699;791;2865
431260;201704;341;955;167;573;21;92;39;116;60;208
431261;201704;253;826;211;727;40;157;90;300;130;457
431262;201704;413;1127;183;596;15;49;94;311;109;360
431265;201704;1414;3542;682;2084;108;351;194;489;302;840
431267;201704;283;804;172;522;18;69;107;298;125;367
431270;201704;2810;6878;1671;4975;406;1286;480;1459;886;2745
431275;201704;226;680;125;456;34;131;15;50;49;181
431280;201704;317;859;112;366;11;40;17;33;28;73
431290;201704;316;966;235;789;40;154;36;86;76;240
431295;201704;76;211;30;97;2;6;6;13;8;19
431300;201704;389;971;62;234;4;12;2;9;6;21
431301;201704;272;846;95;328;9;31;11;26;20;57
431303;201704;750;1985;445;1348;51;172;145;420;196;592
431306;201704;2188;5636;1328;4059;152;559;377;1004;529;1563
431308;201704;36;124;33;112;17;61;10;33;27;94
431310;201704;720;2118;423;1418;88;307;126;432;214;739
431320;201704;740;2065;375;1265;78;290;60;182;138;472
431330;201704;2714;6766;1406;4376;332;1156;128;344;460;1500
431333;201704;411;1101;152;454;24;69;32;82;56;151
431335;201704;41;120;28;94;8;26;4;8;12;34
431337;201704;2474;7398;1784;6045;429;1570;262;905;691;2475
431339;201704;538;1461;373;1127;68;219;197;585;265;804
431340;201704;23042;60913;16747;49910;3892;12708;3983;11575;7875;24283
431342;201704;538;1313;402;1095;95;301;240;610;335;911
431344;201704;359;985;254;785;5;21;184;563;189;584
431346;201704;304;766;114;350;19;62;15;45;34;107
431349;201704;743;2042;430;1304;69;222;152;417;221;639
431350;201704;4037;11695;3192;10105;766;2683;1037;3114;1803;5797
431360;201704;641;1619;399;1203;104;313;113;340;217;653
431365;201704;1446;4220;1229;3856;190;638;716;2292;906;2930
431370;201704;4848;13451;3760;11572;926;3032;1438;4592;2364;7624
431380;201704;871;2698;808;2579;110;389;446;1405;556;1794
431390;201704;2839;7454;1679;5262;310;1109;436;1224;746;2333
431395;201704;1229;3637;998;3230;236;816;418;1365;654;2181
431400;201704;388;1196;193;645;32;103;37;124;69;227
431402;201704;1094;2645;693;1929;128;383;361;950;489;1333
431403;201704;195;574;164;521;45;166;63;177;108;343
431405;201704;4096;11336;3326;10197;565;1947;1792;5451;2357;7398
431406;201704;621;1900;485;1635;100;348;269;907;369;1255
431407;201704;529;1489;356;1149;82;274;121;365;203;639
431410;201704;14283;40555;9640;31423;2632;9579;1725;5420;4357;14999
431413;201704;206;508;76;250;8;32;12;34;20;66
431415;201704;695;1978;492;1601;120;438;134;391;254;829
431417;201704;527;1337;441;1209;62;188;274;727;336;915
431420;201704;1281;3444;1116;3187;218;655;497;1507;715;2162
431430;201704;584;1525;353;1079;64;222;107;288;171;510
431440;201704;22307;60708;17625;53209;5057;16251;5016;16241;10073;32492
431442;201704;126;379;77;261;15;50;4;12;19;62
431445;201704;504;1429;198;646;29;93;48;152;77;245
431446;201704;387;1159;281;904;74;249;76;233;150;482
431447;201704;573;1599;431;1334;73;225;205;627;278;852
431449;201704;762;2072;582;1727;50;153;296;884;346;1037
431450;201704;2111;5047;1851;4673;204;608;1364;3306;1568;3914
431454;201704;62;215;54;194;12;43;21;83;33;126
431455;201704;698;1767;364;1031;66;192;118;302;184;494
431460;201704;3086;8433;2572;7448;656;1941;839;2529;1495;4470
431470;201704;1736;4997;1274;4021;265;842;444;1446;709;2288
431475;201704;201;592;36;143;4;19;2;5;6;24
431477;201704;709;1839;460;1326;57;164;205;550;262;714
431478;201704;257;656;83;244;12;37;9;19;21;56
431480;201704;3155;8531;2451;7352;453;1516;1139;3341;1592;4857
431490;201704;107868;289755;92391;266399;11165;37768;63070;177411;74235;215179
431500;201704;570;1562;448;1315;76;211;255;758;331;969
431505;201704;490;1185;328;944;29;78;198;573;227;651
431507;201704;372;900;201;566;33;93;95;257;128;350
431510;201704;1812;5107;1403;4283;302;995;486;1428;788;2423
431513;201704;317;838;158;482;21;61;81;243;102;304
431514;201704;95;268;44;152;3;14;9;28;12;42
431515;201704;581;1595;384;1187;88;306;152;429;240;735
431517;201704;74;254;56;203;10;37;13;41;23;78
431520;201704;519;1289;231;737;44;167;35;100;79;267
431530;201704;4088;9609;2869;7973;835;2427;592;1717;1427;4144
431531;201704;230;665;173;548;20;71;57;164;77;235
431532;201704;506;1385;401;1157;90;261;142;410;232;671
431535;201704;304;776;138;420;29;104;47;119;76;223
431540;201704;2010;6630;1805;6312;138;574;1213;4358;1351;4932
431545;201704;343;957;53;187;2;7;16;64;18;71
431550;201704;2149;6269;1858;5730;413;1413;776;2285;1189;3698
431555;201704;667;1634;466;1300;52;140;278;789;330;929
431560;201704;20507;59166;14427;47808;3150;11730;3272;11510;6422;23240
431570;201704;5863;14705;4598;13017;1131;3401;2133;6058;3264;9459
431575;201704;381;1014;283;850;47;160;43;112;90;272
431580;201704;583;1648;328;1093;75;265;86;276;161;541
431590;201704;928;2453;576;1769;132;419;161;501;293;920
431595;201704;413;1171;301;925;38;119;159;474;197;593
431600;201704;1937;5285;1434;4429;322;1158;321;971;643;2129
431610;201704;1404;3927;1022;3192;135;417;450;1438;585;1855
431620;201704;466;1329;226;704;44;133;99;282;143;415
431630;201704;1351;3635;776;2401;216;699;192;556;408;1255
431640;201704;6284;17178;5655;16301;965;2940;3521;10269;4486;13209
431642;201704;525;1383;375;1113;45;144;156;440;201;584
431643;201704;346;879;152;436;21;61;47;117;68;178
431645;201704;1663;4661;1393;4181;210;719;854;2542;1064;3261
431647;201704;137;409;90;298;11;39;17;49;28;88
431650;201704;308;930;219;725;38;151;67;198;105;349
431660;201704;989;2813;615;2021;112;415;129;371;241;786
431670;201704;1231;3196;920;2656;174;591;408;1090;582;1681
431673;201704;242;650;105;349;26;89;11;31;37;120
431675;201704;721;1844;145;500;17;61;42;136;59;197
431680;201704;8995;24681;6934;20761;1919;6067;1868;5678;3787;11745
431690;201704;22268;61712;17486;53616;4721;15323;5559;17558;10280;32881
431695;201704;148;428;104;334;24;82;28;67;52;149
431697;201704;467;1283;403;1180;99;308;189;562;288;870
431700;201704;1499;4220;1301;3856;195;603;718;2097;913;2700
431710;201704;11922;34221;10000;31208;3174;10531;2762;9473;5936;20004
431720;201704;6813;18765;5010;15145;1069;3434;1254;3667;2323;7101
431725;201704;29;80;17;55;3;11;3;7;6;18
431730;201704;3639;10482;2912;9220;763;2620;807;2758;1570;5378
431740;201704;5019;13623;3884;11616;1253;4143;646;1732;1899;5875
431750;201704;8365;23594;7203;21700;1713;5581;3050;9282;4763;14863
431755;201704;330;895;71;243;13;39;12;39;25;78
431760;201704;4185;11409;3319;9884;515;1742;1763;4995;2278;6737
431770;201704;1912;5101;1613;4667;262;786;977;2798;1239;3584
431775;201704;191;523;114;362;26;89;10;25;36;114
431780;201704;2135;5793;1564;4666;380;1190;404;1136;784;2326
431790;201704;1135;3330;876;2767;172;589;299;912;471;1501
431795;201704;378;1010;229;691;41;130;60;174;101;304
431800;201704;8230;23838;6566;20757;2168;7418;834;2617;3002;10035
431805;201704;332;817;101;339;11;41;20;72;31;113
431810;201704;3139;8411;2397;6965;458;1457;1022;2845;1480;4302
431820;201704;2495;7607;2154;6955;471;1653;937;2970;1408;4623
431830;201704;10881;26008;8427;22446;2034;5919;3435;9193;5469;15112
431840;201704;2487;7444;2148;6829;465;1600;1072;3463;1537;5063
431842;201704;772;1950;280;862;40;133;60;158;100;291
431843;201704;353;1016;288;893;38;147;134;393;172;540
431844;201704;282;772;77;258;20;73;11;30;31;103
431845;201704;496;1426;360;1129;24;75;220;699;244;774
431846;201704;312;931;265;859;27;105;195;626;222;731
431848;201704;229;609;123;392;9;38;19;48;28;86
431849;201704;473;1143;91;258;13;35;14;29;27;64
431850;201704;4544;13267;3837;11790;841;2751;1290;3914;2131;6665
431860;201704;778;2044;541;1596;78;259;267;743;345;1002
431861;201704;103;305;55;197;9;33;14;37;23;70
431862;201704;486;1579;396;1415;75;302;175;619;250;921
431870;201704;17950;52031;14659;45970;3284;11234;5492;17137;8776;28371
431880;201704;4077;11881;3277;10289;753;2626;1193;3590;1946;6216
431890;201704;4862;13152;3396;10441;1015;3375;635;2060;1650;5435
431900;201704;1127;3068;717;2229;167;588;286;834;453;1422
431910;201704;942;2272;456;1304;62;175;125;335;187;510
431912;201704;457;1345;379;1194;87;272;186;595;273;867
431915;201704;1208;3266;927;2780;220;712;362;1071;582;1783
431920;201704;1254;3414;1093;3147;112;348;780;2229;892;2577
431930;201704;1098;3062;791;2528;178;547;388;1278;566;1825
431935;201704;64;211;53;188;13;50;12;38;25;88
431936;201704;334;994;227;738;54;190;74;236;128;426
431937;201704;279;744;163;496;35;116;26;68;61;184
431940;201704;2456;6604;1569;4807;348;1138;418;1229;766;2367
431950;201704;1578;4712;1402;4402;257;903;720;2203;977;3106
431960;201704;2725;7681;2318;6879;639;1986;702;2045;1341;4031
431970;201704;410;1151;197;660;46;155;47;138;93;293
431971;201704;90;273;58;205;8;30;10;31;18;61
431973;201704;450;1546;390;1422;44;160;262;968;306;1128
431975;201704;107;247;24;86;3;11;4;13;7;24
431980;201704;1318;3838;1054;3303;264;864;347;1052;611;1916
431990;201704;6867;18584;4838;15358;928;3308;1426;4482;2354;7790
432000;201704;9934;27441;8014;24150;2387;7367;2798;8589;5185;15956
432010;201704;2127;5880;1715;5148;260;868;839;2462;1099;3330
432020;201704;2256;5332;1640;4468;350;1059;911;2390;1261;3449
432023;201704;512;1374;306;941;49;171;130;336;179;507
432026;201704;1133;3437;859;2849;126;413;453;1491;579;1904
432030;201704;366;1034;270;824;56;178;120;346;176;524
432032;201704;519;1377;366;1085;47;159;160;430;207;589
432035;201704;806;2385;715;2224;237;814;201;626;438;1440
432040;201704;1004;2389;475;1474;66;236;164;496;230;732
432045;201704;256;698;133;449;26;94;41;143;67;237
432050;201704;585;1620;501;1474;87;290;253;750;340;1040
432055;201704;919;2534;633;1993;150;520;249;758;399;1278
432057;201704;395;969;278;761;45;111;140;365;185;476
432060;201704;476;1254;185;614;33;134;48;137;81;271
432065;201704;233;667;179;571;50;161;57;182;107;343
432067;201704;888;2690;681;2243;122;384;306;1016;428;1400
432070;201704;2346;6406;1503;4725;289;995;298;910;587;1905
432080;201704;3818;10560;3197;9479;880;2921;1188;3464;2068;6385
432085;201704;322;896;213;719;55;188;94;317;149;505
432090;201704;1464;4113;1152;3528;323;1059;441;1298;764;2357
432100;201704;1349;3851;615;2111;96;357;37;102;133;459
432110;201704;2462;7382;1820;6047;436;1675;160;491;596;2166
432120;201704;4190;12314;3468;11028;1220;4120;854;2729;2074;6849
432130;201704;2741;7453;2223;6794;682;2239;882;2756;1564;4995
432132;201704;306;863;153;519;28;101;40;125;68;226
432135;201704;742;2125;602;1847;96;311;367;1115;463;1426
432140;201704;1802;5719;1407;4956;299;1080;586;2178;885;3258
432143;201704;1325;3848;1099;3471;204;700;532;1714;736;2414
432145;201704;1355;4079;848;2892;141;534;132;419;273;953
432146;201704;174;542;119;413;33;121;22;68;55;189
432147;201704;596;1930;466;1641;142;539;91;324;233;863
432149;201704;367;997;238;705;36;105;97;277;133;382
432150;201704;3598;10060;2710;8423;599;2072;785;2384;1384;4456
432160;201704;4292;13472;3747;12492;1134;3991;1206;4095;2340;8086
432162;201704;378;912;58;183;12;43;8;24;20;67
432163;201704;288;800;67;216;6;20;2;8;8;28
432166;201704;619;1832;491;1560;88;341;184;510;272;851
432170;201704;1194;3629;832;2855;195;702;177;591;372;1293
432180;201704;2502;6764;1506;4666;365;1183;263;708;628;1891
432183;201704;391;1237;305;1041;102;380;53;175;155;555
432185;201704;877;2310;600;1802;73;232;322;932;395;1164
432190;201704;2986;8047;1899;5749;416;1329;553;1589;969;2918
432195;201704;1049;2794;731;2254;181;543;254;790;435;1333
432200;201704;2873;8631;2345;7705;572;2075;1013;3273;1585;5348
432210;201704;392;1085;281;891;54;199;109;320;163;519
432215;201704;804;2461;698;2290;137;439;397;1358;534;1797
432218;201704;275;689;162;454;24;62;58;144;82;206
432220;201704;4173;10750;3279;9318;471;1530;1844;5031;2315;6561
432225;201704;107;322;84;274;25;85;26;89;51;174
432230;201704;1004;2679;589;1783;111;359;147;389;258;748
432232;201704;481;1372;397;1207;67;237;176;509;243;746
432234;201704;362;970;224;686;40;128;45;124;85;252
432235;201704;110;317;38;133;6;23;2;4;8;27
432237;201704;442;1175;388;1083;15;58;270;721;285;779
432240;201704;13640;41861;11563;39005;1437;5905;7079;24610;8516;30515
432250;201704;4644;15662;4192;14746;1266;4740;1381;4998;2647;9738
432252;201704;459;1174;302;916;49;158;154;476;203;634
432253;201704;1269;3983;728;2555;155;606;37;122;192;728
432254;201704;912;2459;253;823;52;188;19;51;71;239
432255;201704;202;512;107;345;17;65;35;98;52;163
432260;201704;7397;18236;5243;14771;1105;3157;2158;6437;3263;9594
432270;201704;2508;7429;2126;6714;625;2097;496;1573;1121;3670
432280;201704;1415;3784;759;2399;104;337;201;589;305;926
432285;201704;195;610;26;90;3;8;2;2;5;10
432290;201704;475;1412;303;1015;73;236;76;245;149;481
432300;201704;23702;69300;20582;63943;3540;12085;11706;35852;15246;47937
432310;201704;784;2282;616;1996;145;480;289;942;434;1422
432320;201704;208;524;87;277;16;48;11;33;27;81
432330;201704;310;816;119;397;12;37;21;75;33;112
432335;201704;158;459;69;244;10;40;13;35;23;75
432340;201704;357;867;181;550;34;120;50;140;84;260
432345;201704;644;1732;594;1656;74;280;386;993;460;1273
432350;201704;379;1022;196;636;32;96;56;177;88;273
432360;201704;196;602;38;138;4;16;8;24;12;40
432370;201704;409;1121;298;897;30;99;177;541;207;640
432375;201704;709;1787;530;1488;79;226;295;815;374;1041
432377;201704;236;797;37;143;6;25;9;26;15;51
432380;201704;1073;3331;765;2655;192;731;311;1026;503;1757
500020;201704;2260;6440;1734;5566;356;1335;733;2284;1089;3619
500025;201704;1435;3328;860;2352;84;245;481;1293;565;1538
500060;201704;6930;20527;5440;17910;765;2563;3297;11309;4062;13872
500070;201704;4320;12220;3388;10570;742;2597;1300;4135;2042;6732
500080;201704;1434;4119;1050;3409;254;922;381;1199;635;2121
500085;201704;2171;5422;1488;4433;125;400;923;2709;1048;3109
500090;201704;2297;6484;1605;5208;323;1098;617;2124;940;3222
500100;201704;3064;8459;2467;7435;438;1489;983;2812;1421;4301
500110;201704;7952;23342;6243;20655;1189;4211;2679;9557;3868;13768
500124;201704;2088;6614;1807;6137;417;1329;929;3537;1346;4866
500150;201704;1342;3402;883;2615;163;578;310;783;473;1361
500190;201704;5070;12756;3868;11158;789;2428;1997;5919;2786;8347
500200;201704;2509;6185;1838;5015;405;1178;732;1844;1137;3022
500210;201704;4713;13801;3838;12412;890;3041;1688;5565;2578;8606
500215;201704;1397;4246;1059;3576;175;660;402;1352;577;2012
500220;201704;3097;9308;2475;8240;442;1563;1123;3823;1565;5386
500230;201704;2951;7490;2075;6104;345;1062;1019;3085;1364;4147
500240;201704;4424;13673;3156;11066;567;2245;856;3189;1423;5434
500260;201704;2842;6899;1896;5472;253;768;956;2687;1209;3455
500270;201704;121348;312521;76617;232744;17238;56802;17559;52921;34797;109723
500280;201704;1378;3497;1079;3092;90;272;777;2259;867;2531
500290;201704;4397;9742;2471;7035;436;1368;862;2455;1298;3823
500295;201704;2574;7286;1500;4888;223;809;373;1022;596;1831
500310;201704;796;2097;641;1878;129;437;324;900;453;1337
500315;201704;3229;9938;2647;8965;381;1332;1594;5640;1975;6972
500320;201704;17535;55152;13578;47788;3889;14883;3492;13181;7381;28064
500325;201704;4471;10978;3086;8897;479;1501;1699;4968;2178;6469
500330;201704;6928;17676;4716;13708;583;1898;2233;6509;2816;8407
500345;201704;2129;5413;1613;4686;403;1237;689;2009;1092;3246
500348;201704;2221;6417;1923;5956;175;678;1287;3911;1462;4589
500350;201704;1305;3790;718;2437;67;229;229;805;296;1034
500370;201704;22099;65700;16580;55775;3594;13572;5074;17421;8668;30993
500375;201704;2885;7884;2087;6341;401;1350;579;1737;980;3087
500380;201704;3513;9381;2628;7881;573;1817;1053;3214;1626;5031
500390;201704;546;1227;314;864;46;144;154;412;200;556
500400;201704;1309;3908;968;3108;233;799;228;681;461;1480
500410;201704;2195;6174;1786;5578;309;1015;1008;3251;1317;4266
500430;201704;2738;7393;1990;6303;371;1331;767;2572;1138;3903
500440;201704;1446;3758;942;2872;165;517;383;1204;548;1721
500450;201704;1324;3850;869;2936;191;711;130;373;321;1084
500460;201704;4032;11540;2754;9037;675;2461;527;1728;1202;4189
500470;201704;2955;8462;2053;6583;572;2003;332;994;904;2997
500480;201704;2290;6779;2112;6555;165;474;1666;5545;1831;6019
500490;201704;954;2546;694;2118;186;650;144;464;330;1114
500500;201704;3891;11478;2995;10127;1053;4083;749;2589;1802;6672
500510;201704;848;2179;522;1583;52;188;245;698;297;886
500515;201704;2030;5189;1630;4633;202;560;989;3006;1191;3566
500520;201704;3282;11133;2831;10229;427;1819;1612;5727;2039;7546
500525;201704;1191;3690;963;3286;167;653;442;1563;609;2216
500540;201704;6350;16933;3681;11996;883;3412;395;1142;1278;4554
500560;201704;4946;15635;4416;14803;421;1528;3211;10932;3632;12460
500568;201704;4198;10166;2757;8008;637;2287;733;1895;1370;4182
500570;201704;7485;19367;4626;14098;1196;3942;748;2251;1944;6193
500580;201704;3685;10197;2958;9030;316;993;1983;6144;2299;7137
500600;201704;3998;10401;2580;7855;590;1978;691;2079;1281;4057
500620;201704;7910;22233;5750;18058;934;3127;2464;7899;3398;11026
500625;201704;713;2013;392;1280;72;266;134;413;206;679
500627;201704;717;1893;477;1461;92;291;108;330;200;621
500630;201704;5797;15407;3892;12106;946;3135;1108;3445;2054;6580
500635;201704;2687;9776;2204;9041;259;1087;1548;6839;1807;7926
500640;201704;1673;3955;1250;3357;73;242;874;2276;947;2518
500660;201704;19445;55191;14919;47919;4509;16029;4097;13379;8606;29408
500690;201704;2446;7212;1934;6407;913;3217;333;1191;1246;4408
500710;201704;3391;9878;2752;8760;668;2369;975;3103;1643;5472
500720;201704;6179;16105;3836;12133;969;3423;678;2065;1647;5488
500730;201704;991;2695;668;2083;148;493;188;560;336;1053
500740;201704;4544;11993;3395;9912;359;1256;1697;5026;2056;6282
500750;201704;997;2683;799;2338;134;444;383;1053;517;1497
500755;201704;1170;3329;778;2548;153;525;141;371;294;896
500769;201704;5517;14441;3032;9369;490;1694;583;1516;1073;3210
500770;201704;1722;4888;1151;3779;214;794;328;1074;542;1868
500780;201704;1189;3348;900;2798;240;765;206;658;446;1423
500790;201704;9645;25740;7955;23021;1475;4739;4186;11975;5661;16714
500793;201704;2182;6125;1597;5085;467;1539;252;715;719;2254
500795;201704;2381;6860;2017;6345;235;628;1432;4861;1667;5489
500797;201704;820;2197;549;1695;103;350;183;555;286;905
500800;201704;3020;7808;2200;6605;759;2603;441;1389;1200;3992
500830;201704;20059;52283;13901;41047;2586;8399;5026;14273;7612;22672
500840;201704;1361;3701;875;2733;102;345;309;913;411;1258
510010;201704;1291;3681;1037;3284;250;792;523;1705;773;2497
510020;201704;3495;9612;2071;6748;437;1503;394;1184;831;2687
510025;201704;7237;20598;5076;16369;1107;3902;1318;3974;2425;7876
510030;201704;1679;4420;1362;3961;262;806;686;1957;948;2763
510035;201704;988;2781;676;2309;119;399;383;1387;502;1786
510040;201704;1839;4773;1411;4148;164;518;817;2397;981;2915
510050;201704;1847;5308;1354;4379;341;1206;411;1291;752;2497
510060;201704;1546;4288;1159;3564;187;641;496;1463;683;2104
510080;201704;1027;3287;837;2899;253;993;135;385;388;1378
510100;201704;705;1812;487;1386;46;149;228;588;274;737
510120;201704;312;646;203;510;13;31;135;344;148;375
510125;201704;3000;7705;2258;6422;365;1246;862;2257;1227;3503
510130;201704;1672;4630;1362;4094;353;1145;388;1147;741;2292
510140;201704;2863;8831;2200;7891;922;3752;478;1506;1400;5258
510160;201704;1252;4195;1129;3991;222;847;679;2409;901;3256
510170;201704;5082;15134;4086;13423;795;2840;1806;5869;2601;8709
510180;201704;12568;32210;8495;25642;2381;7730;2188;7576;4569;15306
510185;201704;1561;4253;1159;3693;251;757;606;2257;857;3014
510190;201704;2518;6780;1731;5611;344;1198;774;2586;1118;3784
510250;201704;14188;41453;12208;38586;3171;10746;5562;18183;8733;28929
510260;201704;2176;8911;1770;8091;306;1335;943;5020;1249;6355
510263;201704;3927;10662;2756;8675;648;2206;517;1582;1165;3788
510267;201704;5611;16322;3846;12543;908;3155;801;2601;1709;5756
510268;201704;1110;3014;875;2646;135;457;503;1496;638;1953
510269;201704;1029;3106;714;2452;250;943;146;459;396;1402
510270;201704;2844;9067;2308;7991;545;1902;801;2734;1346;4636
510279;201704;1736;5246;1376;4496;336;1181;448;1343;784;2524
510285;201704;1164;3340;867;2836;244;855;247;795;491;1650
510300;201704;3557;9906;2874;8949;225;754;2082;6632;2307;7386
510305;201704;1462;4488;1104;3802;244;865;354;1291;598;2156
510310;201704;773;2235;622;1984;204;689;196;619;400;1308
510320;201704;3838;10731;2902;9052;510;1824;983;2983;1493;4807
510325;201704;5016;15503;4191;14395;982;3478;2460;8914;3442;12392
510330;201704;2737;8807;2145;7739;531;2020;785;3081;1316;5101
510335;201704;4992;14843;3970;13489;496;1727;2582;9354;3078;11081
510336;201704;578;1750;430;1465;76;270;202;699;278;969
510337;201704;1911;6134;1484;5343;571;2179;284;1082;855;3261
510340;201704;77128;201950;52753;163404;16833;58607;9495;30420;26328;89027
510343;201704;1095;3136;805;2560;130;443;348;1070;478;1513
510345;201704;1583;4665;1226;4016;280;970;422;1345;702;2315
510350;201704;3117;8345;2324;7226;577;1893;905;2934;1482;4827
510360;201704;1810;4282;1141;3476;93;385;799;2417;892;2802
510370;201704;1480;4697;1176;4187;217;816;647;2418;864;3234
510380;201704;522;1489;295;1017;84;310;27;99;111;409
510385;201704;962;3639;698;3034;87;418;329;1577;416;1995
510390;201704;1049;3323;916;3077;248;791;433;1558;681;2349
510395;201704;782;1883;564;1547;60;184;258;781;318;965
510410;201704;3927;12400;3318;11253;827;2875;1570;5597;2397;8472
510420;201704;2451;6000;1772;4934;187;622;937;2556;1124;3178
510450;201704;707;1829;471;1436;107;368;94;272;201;640
510452;201704;660;2097;488;1705;90;325;231;804;321;1129
510454;201704;882;2720;729;2429;127;456;414;1410;541;1866
510455;201704;967;2946;719;2397;133;507;247;766;380;1273
510460;201704;2337;6016;1720;5130;180;626;968;2801;1148;3427
510480;201704;4342;11115;3106;8937;527;1631;1198;3255;1725;4886
510490;201704;1556;4825;1310;4444;308;1142;627;2088;935;3230
510500;201704;1482;4342;1015;3432;196;799;445;1459;641;2258
510510;201704;2822;9483;2364;8619;685;2723;572;2230;1257;4953
510515;201704;6379;18144;4291;13942;912;3231;983;2892;1895;6123
510517;201704;1533;4526;1233;3976;341;1125;241;775;582;1900
510520;201704;2194;4814;1475;3923;27;71;958;2785;985;2856
510523;201704;957;2726;845;2537;104;295;585;1815;689;2110
510525;201704;5416;16285;4350;14149;911;3167;1543;4774;2454;7941
510530;201704;497;1404;414;1281;30;141;289;838;319;979
510550;201704;2824;9024;2181;7782;569;2147;707;2598;1276;4745
510558;201704;1886;5381;1623;5022;133;463;1013;3325;1146;3788
510560;201704;1622;4853;1034;3844;273;1126;225;893;498;2019
510562;201704;5385;15319;3957;12525;1081;3718;1036;3463;2117;7181
510590;201704;3263;8225;2522;7303;471;1285;1541;4777;2012;6062
510600;201704;1624;4061;1085;3174;239;724;356;1030;595;1754
510610;201704;2932;8177;2322;7262;249;883;1446;4494;1695;5377
510615;201704;1985;5957;1673;5452;509;1739;702;2361;1211;4100
510617;201704;658;1917;553;1745;29;91;434;1428;463;1519
510618;201704;1460;4162;1058;3385;205;775;501;1517;706;2292
510619;201704;751;2064;440;1467;82;302;48;137;130;439
510620;201704;1391;3445;762;2436;191;682;107;312;298;994
510621;201704;880;2895;771;2682;193;758;208;690;401;1448
510622;201704;4163;12343;2986;9847;856;3090;544;1672;1400;4762
510623;201704;3454;9310;2608;7929;587;2034;873;2531;1460;4565
510624;201704;1744;4780;864;2933;157;599;129;370;286;969
510625;201704;1989;5525;1501;4715;427;1513;243;786;670;2299
510626;201704;1605;4167;1020;3323;295;1085;194;643;489;1728
510627;201704;692;1957;468;1489;134;458;106;351;240;809
510628;201704;1547;3787;1055;3102;188;559;608;1829;796;2388
510629;201704;1714;5516;1390;4796;373;1377;427;1524;800;2901
510630;201704;2565;8334;1739;6603;395;1628;296;1188;691;2816
510631;201704;402;1112;329;985;11;29;267;807;278;836
510637;201704;2973;8275;2421;7371;806;2664;730;2217;1536;4881
510642;201704;4875;15750;4127;14641;1212;4670;1655;6170;2867;10840
510645;201704;969;2150;604;1671;178;492;182;539;360;1031
510650;201704;6408;20151;5722;19346;1233;4409;3657;12858;4890;17267
510665;201704;1779;4611;1113;3384;204;662;409;1276;613;1938
510670;201704;377;829;207;589;19;58;110;327;129;385
510675;201704;6349;19420;4991;16785;1424;5250;1073;3628;2497;8878
510677;201704;1957;5185;1532;4636;201;638;1031;3276;1232;3914
510680;201704;704;2115;519;1746;119;416;78;247;197;663
510682;201704;2034;6387;1543;5471;461;1825;316;1084;777;2909
510685;201704;925;2469;714;2125;92;323;377;1058;469;1381
510700;201704;4210;10808;2833;8865;681;2156;1250;4125;1931;6281
510704;201704;10195;26452;7358;21524;1425;4683;2817;7774;4242;12457
510706;201704;1945;5761;1325;4863;266;1041;675;2628;941;3669
510710;201704;3177;8690;2222;6769;493;1558;668;1911;1161;3469
510715;201704;707;1690;491;1338;67;175;189;542;256;717
510718;201704;2472;5879;1526;4755;652;2123;294;1134;946;3257
510719;201704;391;888;242;690;21;75;124;349;145;424
510720;201704;1106;2713;778;2262;184;612;265;699;449;1311
510724;201704;748;2181;539;1786;116;414;207;658;323;1072
510726;201704;743;1703;483;1320;77;224;281;734;358;958
510729;201704;718;1789;384;1162;75;247;116;344;191;591
510730;201704;2928;8067;2084;6566;592;2001;527;1639;1119;3640
510735;201704;1000;3166;784;2858;134;545;411;1535;545;2080
510740;201704;1268;3347;891;2772;129;368;497;1722;626;2090
510757;201704;730;2372;604;2133;257;954;192;652;449;1606
510760;201704;33000;81829;21577;63604;6090;19954;4332;11983;10422;31937
510770;201704;4482;10786;3612;9763;346;881;2338;7013;2684;7894
510774;201704;352;973;287;830;52;148;131;418;183;566
510775;201704;654;1958;537;1743;146;548;117;338;263;886
510776;201704;550;1531;426;1276;89;266;171;529;260;795
510777;201704;1552;4451;1150;3911;98;353;931;3212;1029;3565
510779;201704;623;1825;494;1596;64;197;267;895;331;1092
510780;201704;3737;10763;2999;9656;707;2382;1210;4284;1917;6666
510785;201704;1758;4968;1200;3984;347;1223;185;652;532;1875
510787;201704;2379;7030;1845;6082;825;2840;257;820;1082;3660
510788;201704;606;1521;419;1233;103;291;156;557;259;848
510790;201704;15317;43950;10347;34502;2233;8583;1092;3690;3325;12273
510792;201704;8777;24781;5849;19332;1217;4434;1010;3260;2227;7694
510794;201704;1178;3653;927;3172;265;1009;257;840;522;1849
510795;201704;8168;23973;5977;19915;1642;6068;1104;3961;2746;10029
510800;201704;1575;4340;1207;3783;270;916;510;1513;780;2429
510805;201704;2018;5522;1466;4579;303;1047;598;1761;901;2808
510810;201704;683;1616;512;1384;133;349;255;683;388;1032
510820;201704;735;1659;464;1273;74;250;188;460;262;710
510830;201704;717;2022;564;1805;118;376;283;978;401;1354
510835;201704;635;1815;474;1538;84;299;210;648;294;947
510840;201704;44772;112293;35731;100439;8125;23814;16749;49050;24874;72864
510850;201704;1603;4315;1017;3269;300;1113;197;587;497;1700
510860;201704;2760;8288;1949;6789;667;2601;174;593;841;3194
510880;201704;589;1947;504;1796;131;498;220;805;351;1303
510885;201704;636;1743;503;1552;96;341;210;629;306;970
510890;201704;806;2458;659;2248;121;437;378;1322;499;1759
510895;201704;1185;3468;942;3029;206;767;339;1008;545;1775
520005;201704;1725;5199;1489;4881;440;1409;665;2379;1105;3788
520010;201704;1937;6266;1473;5268;531;2158;244;746;775;2904
520013;201704;3150;8779;2319;7176;526;1673;683;2212;1209;3885
520015;201704;493;1396;399;1266;98;330;134;455;232;785
520017;201704;1090;3147;891;2818;203;701;380;1164;583;1865
520020;201704;426;1091;335;961;76;230;147;412;223;642
520025;201704;31098;90693;28098;87157;3335;11214;21034;65429;24369;76643
520030;201704;4862;14556;3994;13121;644;2335;2092;6929;2736;9264
520050;201704;446;1117;277;800;22;59;161;486;183;545
520055;201704;845;2524;714;2269;131;411;372;1197;503;1608
520060;201704;1383;4241;1156;3818;287;1093;351;1097;638;2190
520080;201704;1906;5329;1555;4871;285;849;829;2803;1114;3652
520082;201704;1070;2821;943;2623;118;269;623;1805;741;2074
520085;201704;740;2205;631;2021;164;520;213;674;377;1194
520090;201704;955;2173;683;1832;133;302;366;1085;499;1387
520110;201704;41270;117380;31798;102947;11778;43567;3133;9520;14911;53087
520120;201704;193;498;119;372;16;55;38;121;54;176
520130;201704;3533;9669;3176;9145;706;2229;1655;4870;2361;7099
520140;201704;34616;110567;29509;101094;10886;40604;3887;13419;14773;54023
520145;201704;374;1050;271;860;54;197;87;268;141;465
520150;201704;470;1243;385;1150;55;186;238;690;293;876
520160;201704;911;2359;733;2108;179;521;260;760;439;1281
520170;201704;4690;10384;3549;9090;252;708;2900;7491;3152;8199
520180;201704;2236;6410;1874;5880;369;1301;854;2649;1223;3950
520215;201704;1977;5019;1608;4436;220;644;926;2579;1146;3223
520235;201704;680;1714;490;1428;85;283;194;541;279;824
520250;201704;1583;4349;1122;3612;302;1059;201;665;503;1724
520260;201704;815;2040;524;1512;82;246;196;554;278;800
520280;201704;581;1670;489;1498;148;452;200;672;348;1124
520310;201704;1254;2951;876;2352;223;647;279;850;502;1497
520320;201704;2012;6080;1657;5434;162;548;1013;3421;1175;3969
520330;201704;2675;8202;2059;7156;569;2195;429;1488;998;3683
520340;201704;1943;4808;1451;4105;205;507;930;2814;1135;3321
520350;201704;3316;8814;2515;7382;661;2093;872;2478;1533;4571
520355;201704;1407;4164;1176;3801;282;1001;553;1782;835;2783
520357;201704;828;2190;672;1949;64;198;454;1328;518;1526
520360;201704;760;2142;624;1915;186;592;214;684;400;1276
520380;201704;1332;3535;863;2615;122;403;370;1061;492;1464
520390;201704;1001;2418;593;1854;201;728;152;420;353;1148
520393;201704;561;1335;429;1148;49;136;233;604;282;740
520396;201704;714;2198;600;1982;119;390;327;1093;446;1483
520400;201704;1629;4627;1384;4272;276;914;806;2469;1082;3383
520410;201704;1558;3611;1106;2985;175;538;653;1734;828;2272
520420;201704;334;924;243;731;35;107;118;333;153;440
520425;201704;1285;3465;990;2908;270;799;407;1251;677;2050
520430;201704;1851;4841;1115;3469;237;765;123;371;360;1136
520440;201704;3680;9384;2436;7172;670;2165;476;1386;1146;3551
520450;201704;11005;29546;7554;23499;1995;6868;413;1320;2408;8188
520455;201704;710;2078;562;1839;198;701;173;583;371;1284
520460;201704;929;2550;770;2307;123;410;453;1340;576;1750
520465;201704;839;2213;733;2059;69;247;526;1405;595;1652
520470;201704;1752;5582;1573;5309;316;1109;997;3513;1313;4622
520480;201704;884;2569;599;2037;111;399;117;351;228;750
520485;201704;1409;4249;1223;3968;207;719;799;2617;1006;3336
520490;201704;3981;12105;3127;10756;614;2156;1694;6015;2308;8171
520495;201704;1464;3680;1209;3350;92;276;888;2563;980;2839
520500;201704;1330;3702;1098;3365;270;916;432;1298;702;2214
520505;201704;725;2009;599;1807;132;383;296;904;428;1287
520510;201704;8644;23448;6122;19537;1391;4991;1776;5716;3167;10707
520520;201704;1092;2982;873;2663;259;839;289;918;548;1757
520530;201704;2028;6528;1628;5838;572;2080;406;1630;978;3710
520540;201704;2858;7874;2026;6313;510;1654;357;1160;867;2814
520545;201704;1030;3013;831;2668;157;558;267;824;424;1382
520547;201704;678;2100;578;1927;176;595;190;628;366;1223
520549;201704;10062;29386;8350;26939;2056;6996;4049;13343;6105;20339
520551;201704;3839;11506;3458;10942;673;2387;2186;6834;2859;9221
520552;201704;781;2297;706;2203;101;322;503;1601;604;1923
520570;201704;606;1634;440;1369;120;398;156;475;276;873
520580;201704;3113;7374;2189;6124;367;1142;1200;3378;1567;4520
520590;201704;1458;4126;1113;3516;256;853;221;712;477;1565
520620;201704;8139;23229;6869;21602;1734;5617;3447;11075;5181;16692
520630;201704;1013;2570;715;2092;100;307;305;877;405;1184
520640;201704;2805;7525;2293;6667;531;1573;909;2710;1440;4283
520650;201704;915;2353;648;1868;89;274;332;945;421;1219
520660;201704;393;1000;255;791;85;292;73;243;158;535
520670;201704;985;2857;865;2683;59;200;675;2073;734;2273
520680;201704;798;2065;600;1750;139;411;251;741;390;1152
520690;201704;314;788;217;638;51;139;101;310;152;449
520710;201704;568;1457;358;1051;11;29;211;608;222;637
520725;201704;1665;4173;1220;3427;172;535;764;2124;936;2659
520735;201704;841;2221;586;1748;107;348;208;619;315;967
520740;201704;1789;4610;1443;4165;221;672;862;2489;1083;3161
520750;201704;647;1711;519;1518;102;273;241;756;343;1029
520753;201704;1543;4007;1381;3790;155;396;940;2768;1095;3164
520760;201704;786;2051;671;1898;60;155;489;1472;549;1627
520780;201704;1867;4533;1409;3881;143;405;829;2239;972;2644
520790;201704;3090;7652;2295;6467;174;458;1624;4794;1798;5252
520800;201704;16662;45295;14089;42254;2697;7726;8745;28080;11442;35806
520810;201704;1120;2692;864;2402;68;192;639;1895;707;2087
520815;201704;615;1920;455;1583;177;705;28;88;205;793
520830;201704;1664;4115;1303;3707;48;124;1083;3077;1131;3201
520840;201704;1703;5386;1468;5009;571;2072;359;1317;930;3389
520850;201704;624;1837;448;1546;115;461;111;374;226;835
520860;201704;6599;19371;5101;16917;1248;4434;1785;6136;3033;10570
520870;201704;93170;248792;68878;210450;20902;70235;14988;44702;35890;114937
520880;201704;6586;18776;5081;16610;2015;7344;693;2231;2708;9575
520890;201704;3809;10443;3011;9117;601;2059;1429;4290;2030;6349
520910;201704;3662;10332;2587;8302;887;3071;477;1457;1364;4528
520915;201704;653;1910;507;1617;102;351;221;704;323;1055
520920;201704;3578;9356;2544;7785;432;1438;1087;3454;1519;4892
520929;201704;638;1666;499;1438;93;231;255;814;348;1045
520940;201704;1151;3179;912;2832;85;289;665;2076;750;2365
520945;201704;645;1510;506;1285;88;210;272;658;360;868
520960;201704;1012;2909;800;2514;72;229;393;1256;465;1485
520970;201704;2669;8132;2311;7485;645;2263;551;1799;1196;4062
520980;201704;780;2180;656;1991;162;528;348;1066;510;1594
520990;201704;3017;9437;2827;9186;299;1020;1989;6796;2288;7816
520993;201704;978;2482;765;2154;43;121;553;1585;596;1706
520995;201704;2282;6121;1970;5707;378;1081;1186;3518;1564;4599
521000;201704;7250;21613;5817;18857;2039;7131;1156;3653;3195;10784
521010;201704;4101;11576;3199;9966;658;2044;1421;4467;2079;6511
521015;201704;714;1895;602;1716;110;310;380;1087;490;1397
521020;201704;2863;8139;1969;6285;551;1908;220;682;771;2590
521030;201704;642;1613;480;1347;84;229;197;581;281;810
521040;201704;6395;16945;5236;15133;1622;4927;1706;5144;3328;10071
521056;201704;868;2535;694;2243;220;762;196;684;416;1446
521060;201704;1063;2724;837;2380;96;280;475;1396;571;1676
521080;201704;1116;2686;633;1910;55;207;271;722;326;929
521090;201704;3045;7970;2341;6995;737;2321;709;2223;1446;4544
521100;201704;1919;4482;1410;3787;201;525;870;2400;1071;2925
521120;201704;4860;12241;3722;10800;736;2198;1602;5096;2338;7294
521130;201704;1025;2691;726;2118;62;226;397;1159;459;1385
521140;201704;983;2931;788;2558;162;553;275;917;437;1470
521150;201704;11923;29736;7801;22744;2503;7800;2116;6381;4619;14181
521160;201704;895;2061;568;1535;92;273;257;672;349;945
521170;201704;1138;2778;840;2322;123;359;504;1364;627;1723
521180;201704;6239;19656;5555;18473;1444;5140;1921;6545;3365;11685
521190;201704;8708;24694;5800;19300;1445;5250;1155;3876;2600;9126
521200;201704;755;2033;600;1773;71;238;329;963;400;1201
521205;201704;628;1717;496;1493;45;150;312;932;357;1082
521210;201704;908;2493;565;1781;130;459;92;248;222;707
521220;201704;4367;10714;3176;9133;660;2070;1435;4230;2095;6300
521225;201704;381;937;314;863;30;75;230;665;260;740
521230;201704;1335;3961;1206;3725;407;1262;565;1773;972;3035
521250;201704;30921;92838;25911;85408;10905;37534;6695;23719;17600;61253
521260;201704;719;1706;568;1489;96;284;326;843;422;1127
521270;201704;1786;5079;1617;4851;124;312;1241;3879;1365;4191
521280;201704;1897;5718;1551;5049;472;1635;477;1545;949;3180
521290;201704;454;1234;338;1069;83;308;164;494;247;802
521295;201704;1203;2805;987;2515;113;279;717;1904;830;2183
521300;201704;1869;5176;1589;4747;175;558;1056;3171;1231;3729
521305;201704;733;2037;598;1824;102;304;325;1027;427;1331
521308;201704;4397;12911;3478;11137;748;2440;1557;5069;2305;7509
521310;201704;8385;23974;5889;19197;1521;5408;1352;4226;2873;9634
521340;201704;338;850;318;827;17;44;277;714;294;758
521350;201704;1993;5333;1587;4702;253;728;982;2977;1235;3705
521370;201704;985;2768;674;2203;214;761;95;322;309;1083
521375;201704;1371;3829;1071;3385;243;827;444;1395;687;2222
521377;201704;1163;2826;1021;2667;60;134;872;2299;932;2433
521380;201704;5881;16284;4066;12911;555;1848;1080;3590;1635;5438
521385;201704;572;1466;477;1351;138;407;211;646;349;1053
521390;201704;754;2063;604;1863;181;625;196;604;377;1229
521400;201704;2048;5620;1817;5339;274;899;1286;3796;1560;4695
521405;201704;1412;3901;1108;3373;291;939;468;1452;759;2391
521410;201704;718;2134;669;2064;185;528;319;1066;504;1594
521440;201704;1417;4038;1125;3450;278;920;302;810;580;1730
521450;201704;3785;12132;3065;10680;892;3314;663;2319;1555;5633
521460;201704;6943;19454;5565;17031;1547;5115;2110;6344;3657;11459
521470;201704;688;1963;487;1540;107;337;93;290;200;627
521480;201704;367;1079;236;792;47;166;70;228;117;394
521483;201704;2800;7221;2068;5960;528;1567;546;1553;1074;3120
521486;201704;1692;4192;1356;3732;91;241;1028;2836;1119;3077
521487;201704;507;1328;367;1116;95;310;92;277;187;587
521490;201704;814;2287;623;1950;39;166;425;1285;464;1451
521500;201704;1399;4221;1052;3519;196;757;300;907;496;1664
521520;201704;909;2085;664;1751;139;371;302;853;441;1224
521523;201704;13147;46009;11736;43030;4213;16305;2203;9014;6416;25319
521525;201704;1093;2754;890;2461;102;326;547;1459;649;1785
521530;201704;1820;5035;1149;3711;259;899;193;615;452;1514
521540;201704;899;2390;601;1884;106;396;243;751;349;1147
521550;201704;1607;4068;1037;2929;186;561;465;1294;651;1855
521560;201704;3704;11972;2999;10988;885;3495;1353;5209;2238;8704
521565;201704;607;1545;511;1423;80;223;329;906;409;1129
521570;201704;4757;12982;3052;9629;644;2197;411;1331;1055;3528
521580;201704;542;1261;319;936;67;199;55;160;122;359
521590;201704;612;1665;481;1454;138;472;177;501;315;973
521600;201704;436;1257;307;987;76;249;63;196;139;445
521630;201704;1347;3282;937;2706;208;714;243;624;451;1338
521640;201704;2181;5409;1663;4685;398;1104;725;2128;1123;3232
521645;201704;565;1675;409;1346;109;384;107;318;216;702
521680;201704;1290;4110;1074;3688;392;1431;111;389;503;1820
521690;201704;558;1603;489;1487;122;420;232;679;354;1099
521710;201704;2765;7985;2192;6980;486;1616;526;1689;1012;3305
521720;201704;1947;5436;1487;4581;252;804;750;2257;1002;3061
521730;201704;3783;12039;3192;10874;1151;4341;559;1666;1710;6007
521740;201704;3732;10244;2949;9100;579;1981;1316;4251;1895;6232
521760;201704;14631;45025;12355;41337;3369;12338;4466;15370;7835;27708
521770;201704;2668;7533;2090;6435;711;2374;539;1583;1250;3957
521800;201704;6768;20166;5751;18443;1731;5832;2023;6883;3754;12715
521805;201704;932;2077;669;1711;172;404;307;867;479;1271
521810;201704;787;1950;578;1649;105;319;253;763;358;1082
521830;201704;5181;15929;4543;14978;619;2255;2972;9757;3591;12012
521839;201704;696;1881;516;1550;109;359;210;601;319;960
521850;201704;6485;17272;4755;14353;1254;4095;929;2701;2183;6796
521860;201704;1938;5102;1463;4373;314;1090;468;1385;782;2475
521870;201704;480;1565;398;1396;103;385;129;425;232;810
521878;201704;785;2219;549;1737;91;326;189;554;280;880
521880;201704;21827;55969;15091;45326;3839;12270;4576;14377;8415;26647
521890;201704;3279;9562;2409;7819;625;2200;382;1204;1007;3404
521900;201704;1467;3761;989;3034;245;818;344;1008;589;1826
521910;201704;1010;2578;830;2346;116;350;477;1429;593;1779
521920;201704;300;939;242;824;77;288;55;189;132;477
521925;201704;709;2099;569;1836;114;383;152;463;266;846
521930;201704;3543;11111;3060;10229;1039;3592;679;2377;1718;5969
521935;201704;621;1729;523;1549;117;335;237;685;354;1020
521940;201704;963;2595;799;2362;151;503;455;1325;606;1828
521945;201704;650;1969;546;1786;91;300;266;938;357;1238
521950;201704;676;1692;538;1499;52;165;385;1073;437;1238
521960;201704;646;1905;504;1627;97;348;224;702;321;1050
521970;201704;2751;7112;2263;6535;145;356;1871;5655;2016;6011
521971;201704;980;2614;682;2078;128;409;171;508;299;917
521973;201704;973;2943;817;2671;145;498;395;1307;540;1805
521975;201704;12776;34748;11389;33030;1907;5874;7541;21793;9448;27667
521980;201704;2214;5892;1863;5452;229;579;1408;4286;1637;4865
521990;201704;1163;3247;937;2898;109;362;613;1951;722;2313
522000;201704;2334;6262;1690;5444;220;768;877;3012;1097;3780
522005;201704;381;918;269;756;80;214;97;283;177;497
522010;201704;3393;9448;2786;8464;969;3021;656;2018;1625;5039
522015;201704;925;2678;755;2400;163;528;347;1120;510;1648
522020;201704;5262;13356;3882;11186;917;2748;1764;5109;2681;7857
522026;201704;698;1907;525;1696;72;247;302;1041;374;1288
522028;201704;570;1580;419;1247;52;159;196;560;248;719
522040;201704;2379;5705;1866;5079;335;916;1252;3472;1587;4388
522045;201704;15506;49459;12658;43742;3436;12988;2210;7553;5646;20541
522050;201704;1129;3198;798;2537;170;574;215;603;385;1177
522060;201704;2371;7019;1974;6420;407;1390;1008;3332;1415;4722
522068;201704;1703;5121;1507;4883;171;503;1099;3755;1270;4258
522070;201704;674;1983;598;1855;78;305;397;1186;475;1491
522100;201704;494;1454;413;1326;123;434;166;525;289;959
522108;201704;840;2593;696;2351;65;288;512;1679;577;1967
522119;201704;1476;4247;1209;3857;235;785;599;1966;834;2751
522130;201704;346;955;280;871;73;236;150;476;223;712
522140;201704;16486;47320;13341;41524;4028;13504;2511;7530;6539;21034
522145;201704;820;2162;657;1919;164;443;339;1088;503;1531
522150;201704;972;2511;776;2210;184;519;324;948;508;1467
522155;201704;879;2491;760;2303;171;481;409;1315;580;1796
522157;201704;660;1785;552;1627;33;124;406;1183;439;1307
522160;201704;6244;17307;4436;14063;1280;4458;435;1467;1715;5925
522170;201704;2320;6701;1761;5638;585;1995;334;1069;919;3064
522180;201704;372;1033;257;834;68;232;59;209;127;441
522185;201704;16294;44560;12917;40241;3890;12893;5493;17892;9383;30785
522190;201704;889;2169;680;1877;121;333;322;934;443;1267
522200;201704;1713;5468;1333;4614;321;1175;261;886;582;2061
522205;201704;1351;3667;1071;3235;153;509;618;1845;771;2354
522220;201704;1447;3650;1120;3221;160;469;669;2045;829;2514
522230;201704;1279;3469;1078;3162;150;520;649;1902;799;2422
530010;201704;188873;579677;165907;541091;42376;154151;69235;219689;111611;373840
110001;201703;3220;10605;2851;10000;682;2480;1403;5004;2085;7484
110002;201703;12656;36090;9704;31011;3018;10404;2897;9085;5915;19489
110003;201703;697;2181;586;1980;192;693;116;370;308;1063
110004;201703;9065;28202;7388;24898;2325;8394;1317;4782;3642;13176
110005;201703;1690;5304;1447;4847;433;1531;577;1937;1010;3468
110006;201703;1696;5153;1161;4051;356;1314;124;405;480;1719
110007;201703;1349;3991;1133;3584;329;1100;450;1624;779;2724
110008;201703;2354;7889;2177;7644;319;1059;1625;5958;1944;7017
110009;201703;4505;13576;3426;11810;1020;3749;992;3541;2012;7290
110010;201703;6932;22014;6053;20678;1762;6093;2664;10067;4426;16160
110011;201703;6794;20872;5761;18865;2015;6966;1700;5585;3715;12551
110012;201703;14754;41828;11416;36130;3080;10341;2759;8963;5839;19304
110013;201703;5338;16718;4483;15090;1793;6208;1037;3805;2830;10013
110014;201703;3994;11450;3313;10334;936;3053;1543;4782;2479;7835
110015;201703;4798;14169;3253;11077;856;3133;463;1591;1319;4724
110018;201703;3842;10618;2748;8875;700;2548;897;2793;1597;5341
110020;201703;66610;177713;48515;153262;10815;36506;20021;66580;30836;103086
110025;201703;4149;11714;3311;10250;479;1619;2040;6196;2519;7815
110026;201703;613;1865;552;1773;149;488;273;918;422;1406
110028;201703;6080;18437;4777;15832;1455;5239;576;1924;2031;7163
110029;201703;1292;3593;983;3121;264;866;416;1338;680;2204
110030;201703;9949;27095;7551;23714;1974;6872;2611;8275;4585;15147
110032;201703;3601;11172;2972;9889;984;3345;794;2666;1778;6011
110033;201703;4863;15594;4241;14470;1481;5142;1349;4945;2830;10087
110034;201703;3358;9001;2651;7998;800;2561;1320;3973;2120;6534
110037;201703;1825;6248;1588;5734;411;1568;701;2526;1112;4094
110040;201703;3203;9906;2625;8829;818;2940;845;2785;1663;5725
110045;201703;4829;15471;4186;14617;1347;5070;1793;6295;3140;11365
110050;201703;1622;5153;1358;4652;491;1734;456;1595;947;3329
110060;201703;798;2613;629;2245;222;848;99;368;321;1216
110070;201703;1930;6401;1680;5822;556;2045;587;1983;1143;4028
110080;201703;4674;12437;3891;11551;681;1965;2545;7974;3226;9939
110090;201703;689;1980;499;1633;123;447;227;714;350;1161
110092;201703;1284;4183;1142;3975;197;742;678;2440;875;3182
110094;201703;3411;10027;2843;9187;968;3315;1022;3353;1990;6668
110100;201703;2077;6503;1847;6102;435;1536;981;3263;1416;4799
110110;201703;1600;5014;1350;4638;529;1892;328;1204;857;3096
110120;201703;1679;5244;1304;4443;376;1346;269;919;645;2265
110130;201703;2350;6648;1666;5492;497;1770;425;1445;922;3215
110140;201703;2318;7483;1833;6509;532;2023;443;1470;975;3493
110143;201703;1245;3771;920;3195;338;1240;302;1061;640;2301
110145;201703;1075;3030;754;2416;188;658;287;903;475;1561
110146;201703;383;1195;328;1105;66;211;165;571;231;782
110147;201703;652;1933;493;1621;132;455;164;507;296;962
110148;201703;1105;3391;731;2513;141;524;80;273;221;797
110149;201703;3206;9473;2494;8351;862;2873;948;3405;1810;6278
110150;201703;2336;6673;1895;6047;583;2042;668;2189;1251;4231
110155;201703;806;2502;699;2262;161;562;297;925;458;1487
110160;201703;1789;5765;1488;5180;554;1960;435;1582;989;3542
110170;201703;2703;7590;1951;6224;427;1442;899;2862;1326;4304
110175;201703;1606;4893;1284;4439;200;736;710;2566;910;3302
110180;201703;1195;3512;985;3186;278;888;501;1666;779;2554
120001;201703;2769;9280;2510;8883;512;1873;1494;5492;2006;7365
120005;201703;1563;6477;1459;6280;175;806;1047;4693;1222;5499
120010;201703;4791;16043;4595;15766;512;1731;3611;12685;4123;14416
120013;201703;2041;8090;1944;7951;453;1811;1181;5168;1634;6979
120017;201703;1949;7013;1810;6759;499;1889;836;3473;1335;5362
120020;201703;14118;62338;13657;61467;1870;8859;9833;45634;11703;54493
120025;201703;2317;8096;2228;7965;404;1495;1422;5204;1826;6699
120030;201703;6562;25130;6368;24904;235;1203;5726;22432;5961;23635
120032;201703;1513;7322;1454;7174;157;934;1094;5401;1251;6335
120033;201703;3548;14235;3451;14066;234;1072;3030;12405;3264;13477
120034;201703;2015;8606;1928;8422;149;900;1533;6608;1682;7508
120035;201703;3192;14134;3100;13969;201;1069;2651;12048;2852;13117
120038;201703;2558;9117;2416;8856;570;2136;1338;5064;1908;7200
120039;201703;1800;8512;1753;8423;180;1057;1343;6499;1523;7556
120040;201703;43403;154412;39927;148270;9122;36658;20890;79170;30012;115828
120042;201703;3056;12513;2894;12157;212;1117;2209;9341;2421;10458
120043;201703;979;4506;947;4452;66;317;797;3860;863;4177
120045;201703;4466;14808;4309;14633;331;1287;3798;12882;4129;14169
120050;201703;7995;32454;7614;31638;975;4458;5393;23018;6368;27476
120060;201703;7844;34417;7647;34070;737;3840;6072;27351;6809;31191
120070;201703;2689;9893;2598;9708;413;1565;1728;6675;2141;8240
120080;201703;3572;13435;3423;13175;622;2509;2370;9319;2992;11828
130002;201703;3220;12991;3003;12670;162;824;2633;11181;2795;12005
130006;201703;2167;8847;1881;8338;180;970;1411;6251;1591;7221
130008;201703;2283;8789;2104;8451;152;713;1685;6796;1837;7509
130010;201703;3217;10394;2990;10140;134;477;2712;9258;2846;9735
130014;201703;3203;10343;2750;9604;498;1888;1716;6064;2214;7952
130020;201703;2795;10456;2660;10218;120;665;2268;8598;2388;9263
130030;201703;8083;29844;7721;29431;224;703;7202;27989;7426;28692
130040;201703;3794;11594;3334;11005;288;1060;2671;8919;2959;9979
130050;201703;6173;25087;5822;24626;309;1311;5033;21927;5342;23238
130060;201703;5896;27155;5625;26725;528;3029;4461;21265;4989;24294
130063;201703;4009;17428;3832;17212;246;1225;3409;15462;3655;16687
130068;201703;3194;13239;2879;12587;255;1291;2081;9191;2336;10482
130070;201703;7439;24223;6604;23258;470;1597;5518;20015;5988;21612
130080;201703;5646;24326;5271;23794;618;3329;3918;17793;4536;21122
130083;201703;2290;8806;2148;8586;261;1207;1605;6407;1866;7614
130090;201703;2848;9848;2715;9651;85;378;2397;8628;2482;9006
130100;201703;5890;21328;5725;21137;138;565;5435;20168;5573;20733
130110;201703;6695;21423;6330;21004;589;1785;5268;17998;5857;19783
130115;201703;4696;16247;4460;15888;158;653;3856;13804;4014;14457
130120;201703;14907;55965;13890;54650;1416;5835;11132;44831;12548;50666
130130;201703;4104;16364;4032;16246;231;1148;3494;14075;3725;15223
130140;201703;6260;24540;6150;24421;261;1107;5718;22786;5979;23893
130150;201703;3442;13672;3375;13589;141;748;3052;12264;3193;13012
130160;201703;4353;17852;4156;17600;438;2246;3380;14301;3818;16547
130165;201703;2907;11888;2766;11643;161;861;2329;9862;2490;10723
130170;201703;9855;33593;8499;31985;902;3616;6674;25757;7576;29373
130180;201703;3595;11801;3530;11715;72;249;3362;11219;3434;11468
130185;201703;12286;37860;10867;36298;674;1818;9205;32395;9879;34213
130190;201703;16930;58085;14852;55329;2265;8595;10252;39660;12517;48255
130195;201703;1978;8366;1923;8297;110;442;1701;7517;1811;7959
130200;201703;2045;6947;1864;6674;314;1130;1263;4690;1577;5820
130210;201703;1356;5247;1235;5101;124;671;967;3947;1091;4618
130220;201703;1981;8104;1837;7831;202;1023;1285;5495;1487;6518
130230;201703;3729;17010;3497;16641;416;2175;2687;13082;3103;15257
130240;201703;9166;33155;8183;31730;357;1914;7078;27515;7435;29429
130250;201703;20046;69140;18823;67644;2444;8551;14162;53249;16606;61800
130255;201703;4302;14950;4020;14510;207;848;3471;12605;3678;13453
130260;201703;249137;806684;223273;763719;64729;237718;95646;329753;160375;567471
130270;201703;7503;30784;6970;29972;808;3708;5276;23323;6084;27031
130280;201703;3346;13910;3229;13771;110;490;2989;12931;3099;13421
130290;201703;11199;39725;10592;39031;178;471;10089;37906;10267;38377
130300;201703;4603;17327;4353;16952;264;1255;3720;14577;3984;15832
130310;201703;5043;19222;4651;18707;379;1713;3797;15530;4176;17243
130320;201703;3031;10945;2781;10595;382;1517;1922;7562;2304;9079
130330;201703;3846;13667;3445;13178;167;855;2966;11337;3133;12192
130340;201703;18733;70058;17205;68213;1838;7388;13929;56906;15767;64294
130350;201703;3450;13976;3339;13817;252;1423;2817;11506;3069;12929
130353;201703;6218;18929;5438;17944;952;3063;3629;12817;4581;15880
130356;201703;4792;17071;4450;16528;508;1916;3255;12465;3763;14381
130360;201703;3320;9529;2928;9117;84;213;2739;8683;2823;8896
130370;201703;5473;21483;4985;20848;193;1046;4315;18218;4508;19264
130380;201703;8038;33210;7734;32771;509;2620;6590;27960;7099;30580
130390;201703;5284;23252;4995;22709;559;3001;3709;16830;4268;19831
130395;201703;2257;7808;2023;7376;225;856;1439;5312;1664;6168
130400;201703;2133;8060;1998;7865;114;551;1751;6909;1865;7460
130406;201703;10779;40719;9859;39468;1829;7696;6630;27047;8459;34743
130410;201703;3912;14680;3483;13925;1055;4471;1622;6676;2677;11147
130420;201703;10934;45303;10432;44582;1490;6638;7884;34573;9374;41211
130423;201703;3617;13261;3348;12897;241;1176;2832;10806;3073;11982
130426;201703;2397;10113;2319;9991;127;604;2034;8897;2161;9501
130430;201703;3586;12387;3435;12172;249;914;2901;10458;3150;11372
130440;201703;3676;13097;3443;12829;170;701;3071;11542;3241;12243
140002;201703;1742;5669;1586;5461;124;507;1233;4245;1357;4752
140005;201703;3632;9794;3499;9652;63;158;3379;9366;3442;9524
140010;201703;54502;155694;44534;141269;10721;36068;18494;62311;29215;98379
140015;201703;3019;9553;2792;9285;139;420;2478;8414;2617;8834
140017;201703;3262;10361;2930;9930;291;1021;2195;7746;2486;8767
140020;201703;4597;15172;4084;14463;537;2147;2882;10250;3419;12397
140023;201703;2203;7290;1903;6837;219;861;1331;4885;1550;5746
140028;201703;2101;5792;1911;5539;202;700;1432;4023;1634;4723
140030;201703;3636;11389;3364;11032;535;1529;2376;8203;2911;9732
140040;201703;1810;8251;1756;8176;111;687;1560;7188;1671;7875
140045;201703;2582;9480;2334;9138;435;1673;1530;6383;1965;8056
140047;201703;5638;17137;4932;16024;1200;3957;2368;8306;3568;12263
140050;201703;1429;4455;1264;4225;207;719;809;2779;1016;3498
140060;201703;1456;4368;1294;4116;208;704;893;2874;1101;3578
140070;201703;1658;9027;1605;8878;157;1060;1238;6859;1395;7919
150010;201703;36849;106884;34636;103918;2143;7253;28542;85531;30685;92784
150013;201703;1724;4986;1537;4774;159;473;1168;3734;1327;4207
150020;201703;12596;41798;12157;41197;1412;4292;9798;34332;11210;38624
150030;201703;7632;31692;7383;31339;525;2211;6325;27411;6850;29622
150034;201703;4187;11510;3809;10973;162;530;3291;9499;3453;10029
150040;201703;12659;39933;11252;38293;1199;3355;8981;32500;10180;35855
150050;201703;5613;22129;5339;21665;252;1320;4629;18759;4881;20079
150060;201703;18195;56085;16374;53193;3695;11927;9298;31529;12993;43456
150070;201703;6156;24659;5524;23981;197;1047;5091;22279;5288;23326
150080;201703;80374;203235;68740;188038;14659;41106;31910;94890;46569;135996
150085;201703;5731;19114;5480;18807;316;903;4862;17157;5178;18060
150090;201703;10444;39520;9869;38689;838;3544;7819;31134;8657;34678
150095;201703;5402;17364;4922;16701;324;1078;3968;13871;4292;14949
150100;201703;3226;11862;2994;11450;200;919;2365;8947;2565;9866
150110;201703;3671;17185;3651;17144;206;1046;3267;15481;3473;16527
150120;201703;6763;24107;6595;23860;448;1422;5583;20961;6031;22383
150125;201703;741;2078;639;1958;93;314;439;1348;532;1662
150130;201703;22445;67649;20596;65060;2319;7104;15216;49417;17535;56521
150140;201703;169476;463621;156587;446788;20952;59327;112889;328345;133841;387672
150145;201703;4558;14239;4130;13678;460;1509;3291;11121;3751;12630
150150;201703;12311;36597;11344;35219;1547;5075;7884;24840;9431;29915
150157;201703;3082;9131;2670;8572;323;1156;1828;5988;2151;7144
150160;201703;3069;9697;2888;9432;772;2560;1595;5416;2367;7976
150170;201703;21700;79216;20541;77345;2842;11067;14738;56679;17580;67746
150172;201703;3121;10438;2745;9830;296;1104;2051;7515;2347;8619
150175;201703;1848;5632;1730;5490;129;443;1411;4611;1540;5054
150178;201703;9810;30022;8436;28401;969;3498;6170;21475;7139;24973
150180;201703;18877;74601;18140;73634;1135;5233;15601;63861;16736;69094
150190;201703;7064;24096;6801;23753;195;836;6225;21864;6420;22700
150195;201703;5336;17281;5027;16804;125;441;4585;15450;4710;15891
150200;201703;5310;16680;5038;16367;96;353;4755;15545;4851;15898
150210;201703;24961;92668;24190;91633;1712;6698;20374;79201;22086;85899
150215;201703;7533;23547;6645;22166;2079;7127;2718;9450;4797;16577
150220;201703;11422;35307;10298;33601;2199;7353;5531;18630;7730;25983
150230;201703;11819;36534;10357;34509;1485;5075;6880;23694;8365;28769
150240;201703;34442;101973;29713;93584;9991;32511;7933;26297;17924;58808
150250;201703;4020;16775;3877;16571;802;3425;2590;11587;3392;15012
150260;201703;2029;7898;1928;7729;328;1324;1225;5067;1553;6391
150270;201703;8152;24855;6370;22563;1638;5956;3277;12181;4915;18137
150275;201703;5978;21416;5638;20896;626;2283;4254;16157;4880;18440
150276;201703;2143;6383;1908;6086;271;907;1433;4651;1704;5558
150277;201703;4745;14450;4064;13617;599;2160;2899;9975;3498;12135
150280;201703;5821;26090;5656;25745;680;3148;4338;20156;5018;23304
150285;201703;3061;11599;2838;11236;276;1213;2063;8316;2339;9529
150290;201703;10057;28292;9589;27776;556;1426;8438;25124;8994;26550
150293;201703;9162;24469;6822;21283;1996;6504;2464;8479;4460;14983
150295;201703;7558;21831;6243;20307;1404;4561;3535;12822;4939;17383
150300;201703;2047;6648;1912;6464;86;407;1595;5360;1681;5767
150304;201703;4133;13126;3608;12289;632;2142;2285;8099;2917;10241
150307;201703;6472;21463;6110;20956;337;1228;5235;18042;5572;19270
150309;201703;6094;20587;5423;19585;1283;4588;2930;11279;4213;15867
150310;201703;6546;27593;6246;27178;481;2366;5188;22735;5669;25101
150320;201703;9517;24477;8713;23566;529;1414;7256;19819;7785;21233
150330;201703;14025;47046;13141;45783;1776;6254;9676;34651;11452;40905
150340;201703;2566;7960;2369;7656;208;712;1819;5902;2027;6614
150345;201703;6822;22147;6386;21558;531;1849;5166;17789;5697;19638
150350;201703;8169;24383;7595;23688;1121;2936;5712;18720;6833;21656
150360;201703;20890;64271;18242;60955;2868;9460;12277;42861;15145;52321
150370;201703;9904;35231;9047;34067;944;3587;6873;26819;7817;30406
150375;201703;2944;12871;2779;12639;225;1086;2355;10830;2580;11916
150380;201703;9649;27689;8482;26067;488;1543;7113;22185;7601;23728
150390;201703;7717;33368;7223;32484;1185;5200;4845;22767;6030;27967
150400;201703;5929;22826;5702;22398;462;1799;4558;18251;5020;20050
150405;201703;8174;24436;7284;23342;727;1857;5511;18883;6238;20740
150410;201703;1588;5965;1464;5716;227;1024;909;3561;1136;4585
150420;201703;35377;116656;29417;107110;9831;38415;8444;33910;18275;72325
150430;201703;7577;24898;7177;24304;831;2763;5449;18925;6280;21688
150440;201703;5395;18341;5181;18063;446;1545;4250;15109;4696;16654
150442;201703;21659;61523;19007;57554;3204;9785;11471;36147;14675;45932
150445;201703;5508;18611;5072;17925;478;1722;3936;14183;4414;15905
150450;201703;4243;20402;4092;20145;464;2330;3248;16341;3712;18671
150460;201703;7194;26212;6663;25559;383;1700;5533;22090;5916;23790
150470;201703;17679;53945;16914;53026;1100;2924;14904;47715;16004;50639
150475;201703;3748;12876;3452;12463;273;1028;2790;10265;3063;11293
150480;201703;14040;47626;12851;45787;1356;5050;9825;35770;11181;40820
150490;201703;7231;27476;7036;27183;264;1233;6245;24278;6509;25511
150495;201703;4970;18156;4818;17964;150;631;4453;16701;4603;17332
150497;201703;2558;9344;2293;8834;712;2884;1035;4103;1747;6987
150500;201703;3166;8629;2920;8279;284;785;2318;6586;2602;7371
150503;201703;3391;10420;2820;9644;910;3183;1452;5210;2362;8393
150506;201703;10617;36521;9668;35182;2085;7120;6112;23903;8197;31023
150510;201703;9834;37873;8909;35991;1414;5620;5801;24587;7215;30207
150520;201703;6736;26532;6625;26393;235;964;6201;24928;6436;25892
150530;201703;12297;42298;11129;40471;1078;3769;8543;31794;9621;35563
150540;201703;4619;13869;4076;13116;242;862;3372;10866;3614;11728
150543;201703;5785;17624;5090;16655;964;3224;3189;10863;4153;14087
150548;201703;9262;29620;8619;28819;338;1010;7894;26757;8232;27767
150549;201703;2054;6617;1873;6418;55;230;1717;5914;1772;6144
150550;201703;20038;63403;17508;59105;5155;17792;6640;23760;11795;41552
150553;201703;22683;76918;18804;69269;6666;25988;4865;19061;11531;45049
150555;201703;1772;5184;1466;4696;85;311;1067;3438;1152;3749
150560;201703;1861;6080;1723;5798;276;926;1026;3525;1302;4451
150563;201703;2544;8474;2352;8128;537;1992;1276;4436;1813;6428
150565;201703;3959;13541;3613;12985;150;721;3021;10933;3171;11654
150570;201703;5894;21142;5715;20841;443;1844;4539;16571;4982;18415
150580;201703;9793;40590;9501;40237;580;2585;8273;35695;8853;38280
150590;201703;5887;23249;5690;23000;168;816;5329;21561;5497;22377
150600;201703;8128;30946;7753;30417;265;1258;6981;27603;7246;28861
150610;201703;2398;8037;2215;7668;201;790;1665;5686;1866;6476
150611;201703;2716;9131;2553;8852;141;525;2132;7435;2273;7960
150613;201703;11883;34879;9601;31412;2643;9098;4090;13779;6733;22877
150616;201703;3112;9363;2364;8106;598;2285;720;2366;1318;4651
150618;201703;6369;21287;5682;20083;1282;4578;3150;11557;4432;16135
150619;201703;5058;17230;4643;16573;496;1989;3407;12134;3903;14123
150620;201703;6255;22265;5643;21490;629;2522;4361;16811;4990;19333
150630;201703;5867;17284;5539;16903;449;1434;4671;14473;5120;15907
150635;201703;3859;12484;3480;11750;923;3209;1461;5124;2384;8333
150640;201703;2020;5868;1906;5739;83;241;1735;5364;1818;5605
150650;201703;11432;34768;10316;32783;2800;8973;4509;15040;7309;24013
150655;201703;5042;16354;4738;15820;533;1915;3618;12167;4151;14082
150658;201703;4457;13202;3833;12381;707;2526;2402;8046;3109;10572
150660;201703;5625;17390;5128;16665;1006;3297;2993;9986;3999;13283
150670;201703;7559;19571;6185;17903;602;1811;4837;14349;5439;16160
150680;201703;59868;200767;50837;186206;14463;53987;21357;86623;35820;140610
150690;201703;1987;6085;1800;5805;189;630;1329;4337;1518;4967
150700;201703;6108;19061;5611;18407;803;2633;3890;13175;4693;15808
150710;201703;4278;14300;3844;13621;368;1442;2773;9950;3141;11392
150715;201703;4857;15120;4254;14202;398;1524;3186;10685;3584;12209
150720;201703;6391;25484;6056;24897;641;2956;4636;19359;5277;22315
150730;201703;10201;34341;9403;33022;1159;4259;7015;25235;8174;29494
150740;201703;3580;11326;3201;10661;578;1993;1856;6227;2434;8220
150745;201703;4797;15320;4328;14663;1050;3743;2591;8850;3641;12593
150746;201703;1339;4380;1275;4259;108;369;991;3365;1099;3734
150747;201703;5335;16486;4729;15723;519;1574;3401;12129;3920;13703
150750;201703;3474;11096;3144;10640;195;786;2531;8655;2726;9441
150760;201703;11360;35747;10550;34717;1329;4505;7732;25961;9061;30466
150770;201703;5910;22392;5697;22064;218;742;5085;20585;5303;21327
150775;201703;1045;3168;891;2913;170;673;499;1594;669;2267
150780;201703;3594;11511;3469;11370;130;528;3148;10319;3278;10847
150790;201703;5053;16218;4613;15713;276;938;3767;13741;4043;14679
150795;201703;14918;47929;13463;45673;3001;9941;7791;27900;10792;37841
150796;201703;3152;9088;2836;8717;259;856;2237;7006;2496;7862
150797;201703;3711;12682;3404;12130;129;523;2827;10103;2956;10626
150800;201703;13705;44389;12590;43022;2329;7253;8651;31590;10980;38843
150803;201703;6699;23871;6294;23216;704;2805;4732;17592;5436;20397
150805;201703;2687;9560;2471;9194;332;1239;1753;6670;2085;7909
150808;201703;5537;18158;4478;16113;1737;6862;541;2021;2278;8883
150810;201703;18846;57061;15575;53035;2502;8407;9927;35964;12429;44371
150812;201703;5287;16444;4846;15690;600;2183;3405;10781;4005;12964
150815;201703;8316;27422;7462;26366;720;2524;5879;21373;6599;23897
150820;201703;11317;32732;10148;31432;762;2150;8194;26202;8956;28352
150830;201703;12476;47351;11842;46573;609;3057;9965;40268;10574;43325
150835;201703;2126;7416;1984;7147;437;1573;1093;4108;1530;5681
150840;201703;7278;22123;6011;19968;1231;4488;3016;10081;4247;14569
160005;201703;805;2720;769;2657;60;249;631;2160;691;2409
160010;201703;1373;4637;1370;4634;18;29;1342;4582;1360;4611
160015;201703;1732;6431;1689;6367;78;257;1548;5949;1626;6206
160020;201703;1859;6835;1733;6639;210;899;1297;5013;1507;5912
160021;201703;1035;4420;998;4355;112;625;744;3240;856;3865
160023;201703;974;4080;964;4060;71;295;826;3530;897;3825
160025;201703;1468;4409;1449;4388;36;88;1391;4239;1427;4327
160027;201703;8162;24304;7598;23678;1115;3325;5771;18717;6886;22042
160030;201703;50425;170564;44518;161308;10646;38312;23161;90774;33807;129086
160040;201703;4291;16735;4193;16602;172;991;3809;14892;3981;15883
160050;201703;3283;12118;2906;11581;1449;5487;909;4243;2358;9730
160053;201703;2966;11074;2895;10971;736;2730;1837;7251;2573;9981
160055;201703;562;2238;557;2231;31;160;500;1981;531;2141
160060;201703;15571;53257;14786;52350;1630;5718;11648;42175;13278;47893
160070;201703;2749;10718;2581;10444;196;938;2150;8710;2346;9648
160080;201703;2583;9629;2522;9553;58;302;2365;8935;2423;9237
170025;201703;524;1684;460;1593;136;485;225;795;361;1280
170030;201703;1170;3819;1006;3524;196;714;488;1749;684;2463
170035;201703;1334;3788;1101;3372;135;444;606;1880;741;2324
170040;201703;1863;5768;1641;5481;174;620;891;3262;1065;3882
170070;201703;1581;4218;1194;3707;215;711;676;2126;891;2837
170100;201703;2289;6874;2011;6464;189;584;1505;4909;1694;5493
170105;201703;744;2319;587;1987;145;524;244;805;389;1329
170110;201703;890;2951;774;2721;170;646;339;1218;509;1864
170130;201703;1359;4294;1069;3720;254;931;468;1716;722;2647
170190;201703;1552;4575;1161;3933;382;1220;261;1094;643;2314
170200;201703;1580;4334;1009;3244;284;997;202;611;486;1608
170210;201703;30738;86635;24527;76791;8101;27523;4896;16458;12997;43981
170215;201703;1219;3728;1039;3458;100;389;734;2429;834;2818
170220;201703;5438;18443;4983;17533;1131;4104;2669;9664;3800;13768
170230;201703;1350;4276;1087;3753;223;842;462;1585;685;2427
170240;201703;2739;8066;2216;7237;227;895;1495;4841;1722;5736
170255;201703;3419;10760;2773;9590;796;2811;1127;4047;1923;6858
170270;201703;998;2451;673;2012;41;127;462;1357;503;1484
170290;201703;2759;7984;2426;7605;250;521;1929;6582;2179;7103
170300;201703;1822;5524;1491;4979;147;509;966;3284;1113;3793
170305;201703;713;2111;586;1870;95;340;285;914;380;1254
170307;201703;969;3454;827;3177;184;759;405;1600;589;2359
170310;201703;1493;4171;1141;3563;266;905;538;1664;804;2569
170320;201703;1118;3181;809;2667;140;482;414;1418;554;1900
170330;201703;788;2568;721;2457;47;191;540;1821;587;2012
170360;201703;448;1401;364;1254;68;274;187;613;255;887
170370;201703;1308;3665;1002;3171;150;521;500;1581;650;2102
170380;201703;1745;5661;1423;5126;200;815;773;2860;973;3675
170382;201703;568;1779;472;1614;46;201;320;1087;366;1288
170384;201703;1571;6252;1432;5997;390;1739;687;2917;1077;4656
170386;201703;847;2462;670;2125;163;619;210;595;373;1214
170388;201703;586;1751;453;1517;96;355;184;593;280;948
170389;201703;887;2996;796;2842;59;245;599;2119;658;2364
170390;201703;1303;3653;1069;3364;92;307;808;2599;900;2906
170410;201703;538;1707;436;1518;26;113;280;968;306;1081
170460;201703;472;1272;327;1025;49;179;142;448;191;627
170510;201703;763;2494;592;2167;98;420;286;1009;384;1429
170550;201703;6539;18480;4834;15537;1566;5584;697;2297;2263;7881
170555;201703;1308;3736;1045;3338;174;604;551;1819;725;2423
170560;201703;1125;3459;868;3111;156;620;461;1781;617;2401
170600;201703;1242;3679;1085;3459;293;904;621;2079;914;2983
170610;201703;1591;4816;1281;4268;151;572;813;2689;964;3261
170625;201703;394;1189;293;973;37;128;106;338;143;466
170650;201703;1213;3850;986;3439;259;953;343;1285;602;2238
170700;201703;3932;12196;3181;10923;615;2305;1475;5259;2090;7564
170710;201703;1745;5103;1380;4433;248;866;682;2148;930;3014
170720;201703;1814;4824;1563;4448;129;312;1252;3702;1381;4014
170730;201703;935;2802;755;2498;209;737;299;1014;508;1751
170740;201703;2133;7586;1851;7059;273;1072;1178;4578;1451;5650
170755;201703;809;2481;610;2066;91;341;285;960;376;1301
170765;201703;1219;3333;900;2828;246;797;342;1154;588;1951
170770;201703;1688;5620;1523;5350;298;1040;891;3218;1189;4258
170820;201703;3844;13601;3484;12990;606;2212;2008;8046;2614;10258
170825;201703;952;2456;786;2206;106;283;456;1310;562;1593
170830;201703;1418;4084;1184;3724;63;147;963;3108;1026;3255
170900;201703;2501;8877;2347;8638;200;819;1889;7027;2089;7846
170930;201703;3699;10837;3190;10074;696;2405;1608;5236;2304;7641
170950;201703;13556;39316;10112;33340;3001;11223;1484;4971;4485;16194
170980;201703;481;1394;364;1205;65;227;161;514;226;741
171050;201703;1514;5008;1356;4703;87;397;1048;3599;1135;3996
171070;201703;1401;4332;1271;4146;273;875;788;2701;1061;3576
171090;201703;1100;2893;904;2632;61;185;665;1924;726;2109
171110;201703;580;1708;431;1444;122;475;180;534;302;1009
171150;201703;1021;2769;672;2148;75;265;408;1321;483;1586
171180;201703;683;2045;458;1586;94;324;183;683;277;1007
171190;201703;1469;5536;1308;5212;263;1074;661;2775;924;3849
171195;201703;830;2877;717;2679;84;384;464;1741;548;2125
171200;201703;622;1935;493;1696;152;551;158;535;310;1086
171215;201703;450;1328;344;1116;62;240;169;554;231;794
171240;201703;689;2512;637;2415;65;322;398;1542;463;1864
171245;201703;575;1933;474;1690;114;454;173;592;287;1046
171250;201703;1031;2977;818;2629;182;621;399;1290;581;1911
171270;201703;379;1535;354;1485;121;486;139;644;260;1130
171280;201703;868;2711;722;2458;162;571;328;1201;490;1772
171320;201703;3697;11087;3089;10033;850;2783;1287;4399;2137;7182
171330;201703;2713;7899;2200;7068;536;1843;1074;3503;1610;5346
171360;201703;1418;4497;1266;4278;100;376;1008;3434;1108;3810
171370;201703;656;1858;556;1722;93;327;350;1092;443;1419
171380;201703;1254;4001;1043;3633;391;1376;284;1122;675;2498
171395;201703;899;2658;680;2233;119;469;327;1025;446;1494
171420;201703;1884;5877;1454;5027;339;1269;566;1985;905;3254
171430;201703;1015;3116;838;2807;133;453;499;1663;632;2116
171488;201703;2481;7536;2079;6943;433;1454;1115;3904;1548;5358
171500;201703;861;2477;687;2197;69;231;464;1499;533;1730
171510;201703;832;2898;742;2734;64;271;534;1993;598;2264
171515;201703;482;1383;371;1192;42;137;210;671;252;808
171525;201703;601;1932;518;1786;49;211;344;1145;393;1356
171550;201703;339;1085;257;941;65;270;93;339;158;609
171570;201703;1250;3886;1087;3576;197;602;706;2420;903;3022
171575;201703;1895;5201;1359;4276;241;814;633;1987;874;2801
171610;201703;5086;15982;4232;14495;1098;4139;1301;4597;2399;8736
171620;201703;2700;7720;2307;7201;122;468;1882;5917;2004;6385
171630;201703;857;2608;722;2410;176;621;399;1344;575;1965
171650;201703;2155;6623;1626;5532;389;1375;544;1876;933;3251
171660;201703;2352;6543;1762;5489;265;874;948;2939;1213;3813
171665;201703;1468;4244;1148;3759;219;764;558;1924;777;2688
171670;201703;1812;5058;1486;4536;385;1304;610;1817;995;3121
171700;201703;1075;3382;886;3021;147;523;472;1636;619;2159
171720;201703;759;2223;647;2035;134;434;364;1167;498;1601
171750;201703;1123;3483;856;2961;244;839;246;907;490;1746
171780;201703;1184;3166;867;2718;79;279;529;1663;608;1942
171790;201703;1426;5049;1204;4542;267;997;606;2457;873;3454
171800;201703;718;2170;583;1967;65;223;371;1297;436;1520
171820;201703;9692;29208;8017;26509;1632;5788;3680;12482;5312;18270
171830;201703;1312;4869;1175;4567;324;1225;485;2023;809;3248
171840;201703;704;1984;600;1835;41;146;452;1358;493;1504
171845;201703;663;1817;522;1585;77;266;275;844;352;1110
171850;201703;880;3152;782;2949;83;357;520;1969;603;2326
171855;201703;1132;3589;1033;3412;71;254;764;2520;835;2774
171865;201703;423;1436;373;1352;73;273;179;654;252;927
171870;201703;698;2099;561;1849;128;432;238;866;366;1298
171875;201703;1208;3842;1022;3537;83;359;715;2449;798;2808
171880;201703;856;3088;823;3044;84;280;669;2565;753;2845
171884;201703;897;2453;667;2115;143;517;186;687;329;1204
171886;201703;1338;4232;1027;3616;314;1216;210;757;524;1973
171888;201703;722;2165;538;1793;67;244;297;983;364;1227
171889;201703;484;1485;425;1387;70;234;224;789;294;1023
171890;201703;1200;3537;978;3214;170;565;556;1855;726;2420
171900;201703;492;1752;399;1525;102;403;150;594;252;997
172000;201703;584;1869;499;1699;70;271;267;890;337;1161
172010;201703;1167;4033;1072;3861;115;497;756;2704;871;3201
172015;201703;333;1298;272;1175;51;218;138;618;189;836
172020;201703;2313;7636;2151;7392;256;944;1507;5236;1763;6180
172025;201703;698;2032;513;1725;76;286;265;918;341;1204
172030;201703;1160;3665;1030;3454;57;243;801;2677;858;2920
172049;201703;1295;3296;931;2682;390;1230;369;1010;759;2240
172065;201703;1328;3453;1077;3168;67;202;963;2866;1030;3068
172080;201703;2371;7366;2001;6721;188;754;1333;4447;1521;5201
172085;201703;475;1334;341;1061;58;171;121;376;179;547
172090;201703;3842;10411;3138;9420;101;314;2666;8086;2767;8400
172093;201703;549;1665;422;1438;87;338;202;675;289;1013
172097;201703;654;1904;508;1663;106;357;182;625;288;982
172100;201703;36348;102836;27122;87395;7258;26109;7248;24184;14506;50293
172110;201703;1629;6150;1436;5839;181;814;1021;4273;1202;5087
172120;201703;4954;15400;4061;14085;777;2690;2298;8339;3075;11029
172125;201703;248;790;207;714;44;181;94;319;138;500
172130;201703;522;1463;399;1251;38;146;247;761;285;907
172208;201703;2117;6116;1856;5735;232;733;1145;3601;1377;4334
172210;201703;2525;7440;2181;6964;370;1303;1369;4381;1739;5684
210005;201703;21181;65224;17873;60141;5744;20550;6538;22709;12282;43259
210010;201703;1744;6408;1593;6148;80;352;1323;5187;1403;5539
210015;201703;3394;10646;3011;10058;187;513;2541;8782;2728;9295
210020;201703;7023;16820;6617;16351;181;489;6109;15049;6290;15538
210030;201703;5240;17527;4931;17118;321;1557;4124;14130;4445;15687
210040;201703;2173;6763;2055;6630;52;146;1907;6252;1959;6398
210043;201703;6837;18725;5838;17523;741;2075;4127;13253;4868;15328
210047;201703;6372;23190;5841;22427;455;2081;4681;18013;5136;20094
210050;201703;2219;8211;1865;7511;528;2179;814;3552;1342;5731
210055;201703;1709;5942;1568;5719;101;424;1227;4498;1328;4922
210060;201703;6940;27231;6450;26311;964;4112;4381;18377;5345;22489
210070;201703;7214;20959;6701;20345;106;386;6198;18984;6304;19370
210080;201703;3665;12724;3579;12621;30;132;3444;12213;3474;12345
210083;201703;4599;15806;4116;15279;107;517;3839;14319;3946;14836
210087;201703;3014;8789;2741;8433;273;837;2168;6795;2441;7632
210090;201703;10126;32153;9619;31368;369;1377;8570;27986;8939;29363
210095;201703;5851;20735;5581;20379;327;1321;4790;17678;5117;18999
210100;201703;7093;21354;6523;20610;304;1248;5488;17204;5792;18452
210110;201703;2748;9523;2636;9375;103;473;2358;8364;2461;8837
210120;201703;26142;72860;22865;69048;2838;7293;16439;53108;19277;60401
210125;201703;3612;11255;3476;11114;127;279;3184;10438;3311;10717
210130;201703;4132;12155;3797;11699;256;880;3131;9619;3387;10499
210135;201703;1610;4780;1402;4477;72;214;1145;3714;1217;3928
210140;201703;16690;52678;14242;49342;2752;10221;8244;29301;10996;39522
210150;201703;4607;11318;4102;10696;64;220;3758;9727;3822;9947
210160;201703;17170;53808;16179;52337;1300;3922;13019;43359;14319;47281
210170;201703;13606;47942;13153;47371;652;2577;11715;42528;12367;45105
210173;201703;2228;8476;2107;8296;59;321;1930;7655;1989;7976
210177;201703;3072;9325;2901;9120;88;248;2689;8574;2777;8822
210180;201703;1485;4455;1408;4344;44;179;1210;3708;1254;3887
210190;201703;4756;14978;4398;14341;175;836;3486;11125;3661;11961
210193;201703;1317;4140;1193;3944;63;232;983;3263;1046;3495
210197;201703;2042;6846;1876;6647;227;780;1429;5275;1656;6055
210200;201703;8141;27062;7545;26234;790;2620;5974;21446;6764;24066
210203;201703;6753;20952;6352;20431;312;920;5655;18541;5967;19461
210207;201703;3363;11553;3189;11247;250;770;2544;9313;2794;10083
210210;201703;8274;28081;7874;27543;116;457;7235;25744;7351;26201
210215;201703;1098;4614;1056;4548;91;462;828;3623;919;4085
210220;201703;6017;23289;5743;22847;288;1438;4927;19649;5215;21087
210230;201703;5162;16519;4824;16017;226;789;4264;14245;4490;15034
210232;201703;12719;40478;10673;37901;1565;5711;6911;26600;8476;32311
210235;201703;3756;11485;3323;10949;171;692;2844;9429;3015;10121
210237;201703;2258;8653;2194;8566;26;121;2096;8250;2122;8371
210240;201703;2940;9188;2732;8881;130;476;2324;7549;2454;8025
210250;201703;5250;16817;4939;16419;139;693;4492;14814;4631;15507
210255;201703;2585;8244;2353;7821;212;767;1808;6026;2020;6793
210260;201703;5149;16655;4791;16118;402;1358;3795;13016;4197;14374
210270;201703;5187;14796;4605;13991;125;612;4002;12004;4127;12616
210275;201703;3462;8519;3288;8330;127;234;3072;7929;3199;8163
210280;201703;5603;16780;4774;15626;273;1295;3559;11393;3832;12688
210290;201703;5721;18642;5291;18140;225;848;4615;15994;4840;16842
210300;201703;36839;101604;30499;93811;2207;7228;22808;73121;25015;80349
210310;201703;2878;8035;2634;7720;77;183;2313;6871;2390;7054
210312;201703;2290;7045;2149;6861;82;402;1898;6013;1980;6415
210315;201703;2819;8693;2480;8283;110;398;2150;7327;2260;7725
210317;201703;4017;12580;3850;12385;136;519;3555;11457;3691;11976
210320;201703;19294;62528;17817;60740;842;3294;15471;53586;16313;56880
210325;201703;3723;11264;3317;10662;179;642;2702;8798;2881;9440
210330;201703;32889;84639;26945;78030;5068;13461;16099;53192;21167;66653
210340;201703;11492;34309;10435;32924;1105;3032;7721;26049;8826;29081
210350;201703;9766;29565;8743;28163;464;1663;7204;23431;7668;25094
210355;201703;3925;14244;3559;13677;163;779;2991;11670;3154;12449
210360;201703;14961;45555;13615;43698;941;3640;10872;34762;11813;38402
210370;201703;9333;22337;7798;20699;298;571;6874;19005;7172;19576
210375;201703;3130;9350;2585;8646;753;2612;1226;4279;1979;6891
210380;201703;5800;15986;5233;15258;365;1013;4365;12969;4730;13982
210390;201703;2965;10492;2709;10093;150;730;2243;8356;2393;9086
210400;201703;4890;15344;4619;15016;105;271;4364;14364;4469;14635
210405;201703;7580;21153;6115;19045;1686;5324;2687;9000;4373;14324
210407;201703;1960;7026;1690;6549;193;782;1218;4749;1411;5531
210408;201703;2431;9382;2280;9191;158;783;1859;7682;2017;8465
210409;201703;3662;13288;3482;13022;209;997;2913;10888;3122;11885
210410;201703;3713;11890;3526;11607;301;822;2810;9682;3111;10504
210420;201703;4064;13340;3699;12716;225;818;3024;10497;3249;11315
210430;201703;2086;6469;2015;6390;89;304;1784;5676;1873;5980
210440;201703;3931;12026;3778;11838;118;370;3489;11009;3607;11379
210450;201703;2693;8451;2381;7990;127;486;1905;6363;2032;6849
210455;201703;3665;10669;3346;10284;572;1721;2359;7603;2931;9324
210460;201703;3491;11350;3211;10937;164;695;2647;9006;2811;9701
210462;201703;1329;4839;1225;4651;82;408;982;3704;1064;4112
210465;201703;2565;8327;2369;8053;128;377;2065;7190;2193;7567
210467;201703;6029;20083;5669;19679;351;1261;4927;17361;5278;18622
210470;201703;2062;5576;1517;4776;91;281;1146;3682;1237;3963
210480;201703;14518;46120;12754;43935;1759;5908;9142;33709;10901;39617
210490;201703;3707;10030;3173;9292;81;304;2749;8039;2830;8343
210500;201703;6114;25555;5905;25168;547;2501;4707;20318;5254;22819
210510;201703;6455;21849;6075;21399;332;1027;5223;18954;5555;19981
210515;201703;3619;11431;3458;11254;113;275;3224;10724;3337;10999
210520;201703;2592;7839;2367;7528;142;490;2006;6434;2148;6924
210530;201703;50064;135754;42733;124956;6852;26061;13050;45942;19902;72003
210535;201703;3217;11014;3049;10791;122;438;2697;9709;2819;10147
210540;201703;12797;42346;11413;40427;1796;6350;7521;28153;9317;34503
210542;201703;5728;16289;5193;15708;286;692;4551;14165;4837;14857
210545;201703;2319;7393;2213;7236;49;264;1970;6360;2019;6624
210547;201703;3680;13155;3426;12720;362;1323;2514;9608;2876;10931
210550;201703;6031;17625;5422;16978;254;730;4887;15629;5141;16359
210560;201703;3910;12244;3519;11595;144;576;2989;9807;3133;10383
210565;201703;1438;5192;1237;4874;73;362;953;3838;1026;4200
210570;201703;11934;33690;10974;32616;603;1494;9680;29428;10283;30922
210580;201703;3147;9157;2847;8793;296;611;2281;7476;2577;8087
210590;201703;3888;12471;3603;12105;216;905;3124;10428;3340;11333
210592;201703;2533;7878;2421;7697;52;252;2130;6736;2182;6988
210594;201703;2641;7538;2106;6727;109;312;1545;5157;1654;5469
210596;201703;2570;9550;2449;9326;240;1007;1846;7128;2086;8135
210598;201703;1764;5522;1646;5378;92;394;1453;4705;1545;5099
210600;201703;3161;9010;2691;8383;127;462;2137;6634;2264;7096
210610;201703;2503;8090;2332;7874;136;602;2025;6735;2161;7337
210620;201703;2032;6516;1862;6312;47;111;1698;5899;1745;6010
210630;201703;3311;11802;3048;11382;265;1241;2319;8540;2584;9781
210632;201703;4517;15532;4158;15007;458;1821;3191;11569;3649;13390
210635;201703;1867;6562;1771;6412;67;248;1559;5740;1626;5988
210637;201703;2620;8992;2403;8689;144;597;1944;7097;2088;7694
210640;201703;4627;18668;4550;18587;14;60;4440;18278;4454;18338
210650;201703;6915;20814;6694;20533;147;462;6372;19610;6519;20072
210660;201703;8388;24480;7611;23366;239;907;6775;20661;7014;21568
210663;201703;2670;8180;2552;8035;120;395;2218;7093;2338;7488
210667;201703;1887;6418;1778;6250;80;355;1537;5451;1617;5806
210670;201703;4540;16406;4312;16043;221;1044;3640;13569;3861;14613
210675;201703;5056;14008;4616;13469;425;1079;3738;11276;4163;12355
210680;201703;3935;10626;3441;10038;149;400;3007;8883;3156;9283
210690;201703;7522;25266;7208;24933;307;1051;6313;22624;6620;23675
210700;201703;2632;7778;2416;7539;354;861;1720;6052;2074;6913
210710;201703;4789;15808;4518;15407;205;939;3825;12982;4030;13921
210720;201703;2650;9369;2492;9155;107;532;2232;8139;2339;8671
210725;201703;1067;4088;968;3885;49;206;730;3023;779;3229
210730;201703;1194;3542;1031;3315;76;250;811;2620;887;2870
210735;201703;4090;13842;3719;13233;402;1525;2834;10278;3236;11803
210740;201703;5052;14861;4737;14536;193;903;4234;12730;4427;13633
210745;201703;4150;12001;3903;11708;219;609;3339;10103;3558;10712
210750;201703;19375;52639;17073;49998;1984;5851;12518;37700;14502;43551
210760;201703;5867;16810;5381;16302;36;102;5210;15892;5246;15994
210770;201703;5876;15996;5069;15065;93;402;4574;13595;4667;13997
210780;201703;7733;25909;7128;24890;815;2838;5108;18387;5923;21225
210790;201703;4802;15033;4422;14580;198;524;3600;12510;3798;13034
210800;201703;4771;13284;4281;12699;117;434;3849;11444;3966;11878
210805;201703;3831;15430;3703;15232;192;973;3184;13174;3376;14147
210810;201703;5346;16072;4959;15584;284;588;4345;14216;4629;14804
210820;201703;7590;21935;6788;20709;811;2398;4751;14882;5562;17280
210825;201703;5752;19760;5498;19424;540;1840;4448;16208;4988;18048
210830;201703;8283;23861;7819;23301;774;1933;6346;19693;7120;21626
210840;201703;3543;9698;3192;9213;94;331;2719;7785;2813;8116
210845;201703;5989;17568;5783;17347;63;141;5620;17013;5683;17154
210850;201703;6269;21749;5611;20719;536;2342;4147;15301;4683;17643
210860;201703;17837;52054;15877;49300;1091;3477;12673;40007;13764;43484
210870;201703;5729;18986;5239;18361;513;1808;4170;14920;4683;16728
210880;201703;4319;13898;4107;13632;268;1060;3433;11377;3701;12437
210890;201703;4826;14503;4453;14074;314;806;3756;12464;4070;13270
210900;201703;4817;14371;3945;12947;1588;5507;977;3522;2565;9029
210905;201703;1803;5667;1595;5365;101;304;1276;4407;1377;4711
210910;201703;8200;26032;7247;24419;885;3256;4986;16849;5871;20105
210920;201703;2758;10226;2625;10006;147;770;2177;8262;2324;9032
210923;201703;1490;4985;1376;4812;141;551;945;3401;1086;3952
210927;201703;4752;15251;4489;14971;90;295;4227;14251;4317;14546
210930;201703;2500;9020;2346;8808;118;642;1970;7290;2088;7932
210940;201703;3093;11110;2989;10931;162;776;2564;9253;2726;10029
210945;201703;5676;17439;5477;17223;209;473;5005;15934;5214;16407
210950;201703;5221;15913;4410;14664;455;1511;3178;10898;3633;12409
210955;201703;1832;5886;1631;5585;138;489;1169;4098;1307;4587
210960;201703;9049;28655;8292;27643;1754;5573;5010;17994;6764;23567
210970;201703;1338;4620;1177;4353;130;556;847;3082;977;3638
210975;201703;1751;5848;1664;5689;117;442;1296;4435;1413;4877
210980;201703;10080;23477;9660;23050;435;832;8801;21449;9236;22281
210990;201703;16004;49567;13199;45538;3172;11409;6328;23069;9500;34478
211000;201703;15478;48448;13717;46444;789;3379;11457;39371;12246;42750
211003;201703;4655;17079;4250;16559;300;1450;3280;13060;3580;14510
211010;201703;6574;24174;6218;23744;63;317;5870;22646;5933;22963
211020;201703;7445;23996;7154;23571;482;1877;5982;19620;6464;21497
211023;201703;2166;7335;2086;7211;166;686;1711;5883;1877;6569
211027;201703;2778;10492;2720;10393;255;1113;2228;8503;2483;9616
211030;201703;3782;11520;3538;11264;459;1026;2826;9675;3285;10701
211040;201703;4444;16537;4252;16255;172;973;3691;14109;3863;15082
211050;201703;10040;25525;9526;24977;170;465;9052;23740;9222;24205
211060;201703;6085;21266;5888;21002;389;1516;5087;18263;5476;19779
211065;201703;2023;6295;1812;6001;52;171;1629;5456;1681;5627
211070;201703;7859;26810;7229;25789;370;1462;6017;21716;6387;23178
211080;201703;1307;3922;1143;3674;80;393;896;2736;976;3129
211085;201703;2002;6588;1830;6306;206;722;1360;4771;1566;5493
211090;201703;3443;9777;3198;9448;95;440;2798;8140;2893;8580
211100;201703;6456;17129;6309;16971;29;100;6163;16595;6192;16695
211102;201703;2850;10957;2699;10744;215;927;2275;9206;2490;10133
211105;201703;2476;8204;2153;7694;211;870;1577;5581;1788;6451
211107;201703;4517;14384;4084;13828;248;853;3319;11563;3567;12416
211110;201703;6196;18271;4976;16451;747;2407;3300;11356;4047;13763
211120;201703;35361;100062;32468;96729;4597;13141;23904;73822;28501;86963
211125;201703;2046;6438;1803;6053;125;473;1473;4975;1598;5448
211130;201703;168011;445538;157017;432021;23728;68736;77396;232925;101124;301661
211140;201703;5092;16327;4733;15791;203;867;4021;13357;4224;14224
211150;201703;9625;27502;8592;26244;371;1392;7320;22386;7691;23778
211153;201703;2709;8441;2463;8120;530;1815;1607;5519;2137;7334
211157;201703;1149;3672;991;3423;80;372;684;2399;764;2771
211160;201703;4135;13302;3490;12234;278;1343;2405;8180;2683;9523
211163;201703;1663;5451;1563;5318;40;122;1414;4909;1454;5031
211167;201703;1508;4976;1442;4881;32;147;1369;4620;1401;4767
211170;201703;6013;15996;5790;15724;91;315;5419;14635;5510;14950
211172;201703;2454;7148;2228;6846;96;420;1919;5815;2015;6235
211174;201703;2691;7980;2474;7705;58;319;2273;6989;2331;7308
211176;201703;4180;13113;3579;12317;301;1264;2750;9524;3051;10788
211178;201703;4233;10535;3883;10144;43;141;3684;9572;3727;9713
211180;201703;4219;14473;3972;14116;272;1056;3372;12061;3644;13117
211190;201703;2848;9292;2633;8975;84;407;2255;7647;2339;8054
211195;201703;1465;4351;1239;4063;70;210;1023;3470;1093;3680
211200;201703;2147;7021;1894;6677;328;1148;1180;4397;1508;5545
211210;201703;6652;20483;6292;20011;378;1273;5388;17243;5766;18516
211220;201703;33459;95384;29430;90260;4450;14168;19723;62358;24173;76526
211223;201703;5001;15554;4574;14887;427;1397;3495;11575;3922;12972
211227;201703;1642;5782;1506;5577;81;359;1268;4731;1349;5090
211230;201703;7878;25407;7130;24191;701;2531;5436;18656;6137;21187
211240;201703;7857;27131;7459;26622;256;1305;6730;23747;6986;25052
211245;201703;5632;16641;5601;16610;55;97;5516;16454;5571;16551
211250;201703;13417;42226;12612;41285;959;2876;10587;35692;11546;38568
211260;201703;8338;25943;7880;25347;350;1347;7083;22791;7433;24138
211270;201703;10180;34703;9166;33451;523;2426;7324;27260;7847;29686
211280;201703;13141;39019;11993;37559;890;2342;9686;31500;10576;33842
211285;201703;1743;6381;1533;5945;243;1040;783;3135;1026;4175
211290;201703;7053;22979;6740;22576;342;1175;5869;19920;6211;21095
211300;201703;8078;24132;7553;23424;137;425;7017;21865;7154;22290
211400;201703;11768;36528;10082;34068;2419;8279;5292;19590;7711;27869
220005;201703;1835;5214;1660;4959;68;272;1300;3769;1368;4041
220010;201703;1411;4120;1248;3871;31;136;1002;3049;1033;3185
220020;201703;3273;10309;3069;9974;553;1830;1930;6347;2483;8177
220025;201703;2268;5504;2035;5181;36;112;1691;4228;1727;4340
220027;201703;1348;3592;1199;3398;60;182;956;2707;1016;2889
220030;201703;3217;8602;3135;8480;125;427;2753;7319;2878;7746
220040;201703;7585;23294;6945;22154;1217;3950;4500;14442;5717;18392
220045;201703;1399;4579;1262;4309;50;244;980;3275;1030;3519
220050;201703;4432;13355;3828;12363;192;819;3048;9758;3240;10577
220060;201703;2130;5153;1889;4874;36;95;1706;4395;1742;4490
220070;201703;2393;6889;2161;6522;122;358;1728;5217;1850;5575
220080;201703;682;2067;633;1992;41;167;533;1614;574;1781
220090;201703;1792;4502;1470;4070;49;190;1273;3470;1322;3660
220095;201703;719;1915;672;1851;10;43;626;1702;636;1745
220100;201703;1300;3906;1074;3493;63;279;852;2712;915;2991
220105;201703;2216;6971;1975;6505;122;415;1494;4964;1616;5379
220110;201703;3316;9603;3186;9398;96;389;2797;8127;2893;8516
220115;201703;2599;8551;2491;8374;136;558;2179;7248;2315;7806
220117;201703;1250;3320;1024;2973;36;101;857;2478;893;2579
220120;201703;11848;34654;11030;33662;135;623;10318;31397;10453;32020
220130;201703;895;2933;797;2784;33;187;684;2345;717;2532
220140;201703;1678;4446;1456;4179;136;311;1181;3491;1317;3802
220150;201703;6941;20914;6575;20430;199;867;5722;17595;5921;18462
220155;201703;1084;3294;861;2870;38;155;596;1952;634;2107
220157;201703;1075;2705;925;2462;22;84;767;1986;789;2070
220160;201703;2536;7680;2283;7221;81;381;1842;5705;1923;6086
220170;201703;1363;4036;1167;3724;45;206;960;3023;1005;3229
220173;201703;2002;6043;1694;5461;52;271;1338;4218;1390;4489
220177;201703;1795;5358;1761;5314;34;140;1681;5049;1715;5189
220180;201703;1155;3081;942;2698;17;69;687;1876;704;1945
220190;201703;4585;14693;4216;14213;452;1605;3236;10954;3688;12559
220191;201703;1382;4599;1305;4459;117;493;992;3315;1109;3808
220192;201703;1814;5122;1460;4502;57;205;1122;3434;1179;3639
220194;201703;1790;5309;1591;5018;95;362;1251;3863;1346;4225
220196;201703;2006;5770;1840;5483;100;387;1503;4409;1603;4796
220198;201703;1344;3794;1025;3374;10;34;948;3169;958;3203
220200;201703;4428;14480;4100;14057;269;1020;3430;11795;3699;12815
220202;201703;2157;6371;1883;5895;30;168;1608;4934;1638;5102
220205;201703;2727;7222;2438;6836;52;201;2135;5903;2187;6104
220207;201703;862;2648;741;2435;65;264;506;1632;571;1896
220208;201703;1794;5683;1535;5239;225;877;932;3171;1157;4048
220209;201703;1581;4684;1375;4330;34;146;1107;3483;1141;3629
220210;201703;1635;4366;1427;4032;42;181;1151;3155;1193;3336
220211;201703;1548;4369;1481;4285;40;180;1292;3692;1332;3872
220213;201703;1657;4709;1523;4446;27;116;1235;3515;1262;3631
220217;201703;2011;6343;1930;6248;35;142;1787;5841;1822;5983
220220;201703;10324;28442;9230;26808;652;1799;6844;20318;7496;22117
220225;201703;1099;3144;905;2883;29;118;729;2296;758;2414
220230;201703;5433;14516;4926;13817;187;539;4293;12073;4480;12612
220240;201703;2819;8716;2604;8316;92;380;2148;6821;2240;7201
220245;201703;1505;3992;1264;3666;23;74;1104;3272;1127;3346
220250;201703;3005;8815;2716;8389;75;314;2342;7245;2417;7559
220253;201703;1571;4617;1322;4179;141;500;967;3013;1108;3513
220255;201703;1740;4781;1493;4371;45;217;1200;3341;1245;3558
220260;201703;4473;14405;3989;13523;272;1000;2991;10198;3263;11198
220265;201703;1304;4478;1200;4309;100;414;819;2948;919;3362
220270;201703;6790;21887;6485;21334;407;1765;5265;16858;5672;18623
220271;201703;1470;4101;1305;3843;56;167;1082;3227;1138;3394
220272;201703;1782;5314;1610;5016;50;208;1243;3815;1293;4023
220273;201703;1198;3472;1057;3221;70;259;788;2390;858;2649
220275;201703;2139;5351;1715;4846;43;172;1470;4122;1513;4294
220277;201703;2215;6029;1934;5597;60;214;1556;4413;1616;4627
220280;201703;1481;4063;1301;3743;72;262;1032;2876;1104;3138
220285;201703;1664;4319;1366;3923;21;86;1240;3568;1261;3654
220290;201703;6063;19856;5153;18534;558;2228;3524;12720;4082;14948
220300;201703;1786;5964;1599;5672;77;431;1270;4380;1347;4811
220310;201703;2396;8000;2178;7746;83;418;1823;6492;1906;6910
220320;201703;2835;8751;2448;8041;230;917;1782;5811;2012;6728
220323;201703;1486;5168;1298;4890;127;537;1019;3826;1146;4363
220325;201703;1184;3715;1007;3366;71;298;753;2491;824;2789
220327;201703;1324;4203;1212;4005;53;262;997;3211;1050;3473
220330;201703;3667;9767;3257;9249;114;320;2863;8204;2977;8524
220335;201703;1792;5458;1610;5245;27;84;1508;4954;1535;5038
220340;201703;1863;5058;1551;4567;79;280;1150;3298;1229;3578
220342;201703;1129;3660;1072;3567;63;277;863;2869;926;3146
220345;201703;2862;7128;2532;6668;31;62;2328;6136;2359;6198
220350;201703;3740;9918;3134;8955;165;585;2378;6670;2543;7255
220360;201703;1243;3404;1065;3147;71;231;835;2423;906;2654
220370;201703;9237;26267;8389;25180;265;1060;7439;22199;7704;23259
220375;201703;1468;4564;1367;4436;12;35;1323;4333;1335;4368
220380;201703;1355;3615;1146;3318;33;141;965;2722;998;2863
220385;201703;857;2175;683;1889;14;56;553;1494;567;1550
220390;201703;8859;27012;7851;25279;1979;6567;3264;10840;5243;17407
220400;201703;1503;3767;1171;3236;34;129;915;2436;949;2565
220410;201703;1159;3372;987;3106;61;204;769;2396;830;2600
220415;201703;828;2276;725;2122;34;126;530;1510;564;1636
220420;201703;2134;6130;1774;5437;95;283;1301;3973;1396;4256
220430;201703;2465;6853;2404;6776;93;313;2170;6060;2263;6373
220435;201703;1640;4823;1501;4599;49;195;1177;3572;1226;3767
220440;201703;2362;7773;2220;7573;169;624;1772;5957;1941;6581
220450;201703;1894;5888;1598;5458;349;1311;943;3230;1292;4541
220455;201703;1296;4086;1226;3982;43;167;1087;3516;1130;3683
220460;201703;888;2441;806;2342;40;127;686;1962;726;2089
220465;201703;2332;7644;2133;7339;236;860;1576;5461;1812;6321
220470;201703;3635;10718;3328;10240;135;475;2675;8112;2810;8587
220480;201703;2435;6877;2128;6396;148;400;1573;4738;1721;5138
220490;201703;2236;6267;2054;6047;56;206;1806;5288;1862;5494
220500;201703;3117;8372;2702;7687;86;369;2074;5686;2160;6055
220510;201703;2821;8285;2301;7377;99;365;1726;5569;1825;5934
220515;201703;1805;4402;1610;4144;99;247;1381;3565;1480;3812
220520;201703;5057;13725;4649;13191;113;344;4158;11829;4271;12173
220525;201703;1223;3453;1161;3363;39;156;985;2819;1024;2975
220527;201703;1366;4119;1215;3836;115;379;875;2817;990;3196
220530;201703;1273;3569;1116;3343;53;220;968;2828;1021;3048
220535;201703;849;2540;807;2481;68;244;619;1874;687;2118
220540;201703;3491;11058;3335;10824;119;546;2914;9366;3033;9912
220545;201703;1388;4574;1320;4451;110;440;1042;3476;1152;3916
220550;201703;9161;28853;8399;27587;655;2387;6321;20620;6976;23007
220551;201703;1460;4528;1306;4281;70;301;1031;3292;1101;3593
220552;201703;1582;4861;1380;4490;82;404;1064;3323;1146;3727
220553;201703;1629;4654;1368;4258;52;204;1059;3368;1111;3572
220554;201703;776;2242;688;2112;42;111;547;1688;589;1799
220555;201703;2098;6743;1949;6531;50;265;1668;5503;1718;5768
220556;201703;1365;4193;1221;3910;53;244;917;2814;970;3058
220557;201703;1555;4959;1399;4659;111;430;1019;3360;1130;3790
220558;201703;1101;3311;976;3120;46;216;782;2432;828;2648
220559;201703;1574;4405;1398;4113;25;87;1192;3503;1217;3590
220560;201703;1589;3951;1303;3562;38;118;1112;2985;1150;3103
220570;201703;7106;22919;6697;22199;832;2927;4762;15992;5594;18919
220580;201703;6612;20091;6432;19812;222;778;5811;17758;6033;18536
220585;201703;2038;6845;1864;6529;112;484;1470;5091;1582;5575
220590;201703;1289;3781;1133;3555;103;342;828;2641;931;2983
220595;201703;2372;6856;2216;6650;35;170;2035;6028;2070;6198
220600;201703;1309;3153;1072;2850;76;119;865;2382;941;2501
220605;201703;1845;5467;1595;5043;61;252;1255;3888;1316;4140
220610;201703;2755;8148;2615;7954;52;223;2367;7164;2419;7387
220620;201703;7469;24806;7185;24419;262;1258;6376;21443;6638;22701
220630;201703;396;1213;327;1088;51;188;169;572;220;760
220635;201703;1671;5600;1488;5206;77;334;1118;3852;1195;4186
220640;201703;2644;7625;2345;7197;95;359;1953;5939;2048;6298
220650;201703;2113;6191;1882;5780;91;318;1393;4263;1484;4581
220660;201703;2847;8430;2570;8091;119;570;2231;6829;2350;7399
220665;201703;1186;3953;1086;3788;32;162;915;3164;947;3326
220667;201703;1672;5511;1533;5271;82;303;1252;4313;1334;4616
220669;201703;1803;5786;1722;5642;154;671;1314;4205;1468;4876
220670;201703;1938;5696;1701;5394;95;282;1444;4634;1539;4916
220672;201703;2414;6993;2235;6775;137;450;1929;5879;2066;6329
220675;201703;1244;3560;1164;3416;66;177;912;2692;978;2869
220680;201703;2375;7353;2258;7208;112;376;1964;6276;2076;6652
220690;201703;1701;4672;1472;4302;111;305;1114;3332;1225;3637
220695;201703;957;2710;865;2537;27;94;696;2023;723;2117
220700;201703;8185;23216;7096;21543;501;1754;5340;16040;5841;17794
220710;201703;816;2418;656;2108;39;107;468;1501;507;1608
220720;201703;2057;5267;1928;5083;62;193;1673;4377;1735;4570
220730;201703;1371;3915;1164;3594;33;143;968;2941;1001;3084
220735;201703;1017;2529;806;2180;24;70;650;1725;674;1795
220740;201703;1395;4253;1191;3979;54;190;1005;3415;1059;3605
220750;201703;3964;10967;3610;10438;231;656;2981;8647;3212;9303
220755;201703;1181;3281;1052;3075;45;172;825;2350;870;2522
220760;201703;2864;9180;2585;8810;125;560;2211;7484;2336;8044
220770;201703;21232;70253;19080;66150;6321;23014;6189;22529;12510;45543
220775;201703;1226;3272;1173;3216;13;50;1143;3130;1156;3180
220777;201703;1548;4198;1303;3818;59;159;996;2926;1055;3085
220779;201703;1362;3501;1264;3370;40;148;1106;2902;1146;3050
220780;201703;5568;15162;4955;14206;343;1142;3936;11148;4279;12290
220785;201703;1371;3331;1284;3200;40;80;1183;2946;1223;3026
220790;201703;10240;30451;9392;29177;510;1988;7674;23539;8184;25527
220793;201703;811;2289;727;2164;38;136;597;1773;635;1909
220795;201703;1474;4053;1377;3930;47;161;1231;3523;1278;3684
220800;201703;15948;42992;14084;40138;1036;3376;10000;27777;11036;31153
220810;201703;3198;9182;2790;8480;92;360;2255;6737;2347;7097
220820;201703;5411;14562;4820;13718;319;876;3916;11110;4235;11986
220830;201703;7270;20501;6751;19696;468;1478;5422;15796;5890;17274
220840;201703;13446;42170;11924;39152;2305;7664;6375;21290;8680;28954
220850;201703;2950;9696;2771;9477;83;383;2547;8706;2630;9089
220855;201703;595;1798;516;1657;30;131;395;1236;425;1367
220860;201703;929;2488;821;2322;36;131;690;1914;726;2045
220865;201703;2627;7120;2090;6217;64;297;1687;4856;1751;5153
220870;201703;2201;7322;1962;7004;51;260;1750;6210;1801;6470
220880;201703;4627;12426;4294;12038;50;167;4045;11359;4095;11526
220885;201703;1270;4492;1119;4221;82;395;853;3200;935;3595
220887;201703;1357;3342;1194;3115;14;56;1104;2856;1118;2912
220890;201703;1619;5499;1408;5080;116;436;1026;3767;1142;4203
220900;201703;1879;5070;1667;4765;37;115;1453;4122;1490;4237
220910;201703;1489;4489;1302;4202;40;119;1144;3756;1184;3875
220915;201703;993;2806;854;2538;33;146;657;1887;690;2033
220920;201703;1322;4767;1194;4576;87;449;898;3371;985;3820
220930;201703;1447;4570;1316;4373;39;198;1110;3650;1149;3848
220935;201703;1083;3216;928;2899;39;162;617;1855;656;2017
220937;201703;1472;3987;1245;3619;41;159;977;2785;1018;2944
220940;201703;1269;4014;1187;3857;64;286;860;2719;924;3005
220945;201703;410;1517;367;1424;33;159;253;972;286;1131
220950;201703;1298;3200;931;2593;18;80;706;1905;724;1985
220955;201703;1456;4134;1281;3828;62;177;1006;3024;1068;3201
220960;201703;905;2313;714;2004;21;72;557;1550;578;1622
220965;201703;1643;4816;1530;4644;39;220;1330;3909;1369;4129
220970;201703;1921;5203;1524;4555;77;274;1175;3493;1252;3767
220975;201703;721;2274;656;2193;30;174;579;1863;609;2037
220980;201703;1230;3636;1090;3407;48;178;854;2655;902;2833
220985;201703;1170;3443;1103;3348;72;293;841;2463;913;2756
220987;201703;1447;4609;1304;4374;82;364;1035;3387;1117;3751
220990;201703;1772;5131;1530;4721;45;220;1182;3545;1227;3765
220995;201703;1244;3668;959;3217;84;306;664;2290;748;2596
220997;201703;2346;6984;2241;6840;36;153;2094;6357;2130;6510
221000;201703;4134;12440;3876;12009;259;1028;3093;9431;3352;10459
221005;201703;1417;4340;1301;4127;222;642;821;2645;1043;3287
221010;201703;1210;3054;1043;2849;22;72;911;2448;933;2520
221020;201703;1667;5216;1544;4982;55;253;1127;3563;1182;3816
221030;201703;1435;4256;1277;3994;60;252;1013;3094;1073;3346
221035;201703;1483;4025;1373;3884;55;129;1250;3609;1305;3738
221037;201703;597;1771;530;1656;14;67;371;1107;385;1174
221038;201703;586;1658;464;1454;36;121;293;928;329;1049
221039;201703;943;2579;833;2414;25;95;681;1917;706;2012
221040;201703;4463;13807;4143;13272;194;684;3266;10534;3460;11218
221050;201703;3539;10435;3270;10093;96;379;2900;8885;2996;9264
221060;201703;7937;23348;6859;21553;404;1467;5256;16451;5660;17918
221062;201703;1282;4422;1150;4162;67;312;879;3157;946;3469
221063;201703;1082;3458;972;3269;104;359;677;2299;781;2658
221065;201703;2793;7401;2467;6886;73;219;2083;5742;2156;5961
221070;201703;3660;11655;3177;10740;180;712;2386;8041;2566;8753
221080;201703;3518;8754;2862;7842;81;299;2339;6381;2420;6680
221090;201703;1367;3758;1191;3463;43;179;999;2838;1042;3017
221093;201703;1547;4569;1458;4395;178;580;927;2699;1105;3279
221095;201703;970;2598;845;2402;14;39;709;1992;723;2031
221097;201703;805;2224;650;1945;29;113;469;1358;498;1471
221100;201703;105064;306182;95855;290653;18387;58785;55136;164832;73523;223617
221110;201703;10376;32116;9618;31194;394;1819;8221;26324;8615;28143
221120;201703;4039;12823;3862;12522;536;1879;2780;8995;3316;10874
221130;201703;4485;12737;3679;11099;978;2879;1650;5087;2628;7966
221135;201703;1518;4502;1399;4336;68;253;1194;3672;1262;3925
221140;201703;1325;3257;1190;3065;25;67;1043;2648;1068;2715
221150;201703;1197;3018;965;2621;25;105;720;1889;745;1994
221160;201703;765;2004;713;1935;25;70;582;1570;607;1640
221170;201703;1145;3405;1042;3238;34;123;834;2566;868;2689
230010;201703;3357;9002;2706;7890;221;747;2015;5741;2236;6488
230015;201703;2900;9885;2716;9506;304;1211;1814;6287;2118;7498
230020;201703;13632;44019;13254;43443;613;2533;11310;36738;11923;39271
230030;201703;11948;33495;10616;31493;442;1696;8847;25958;9289;27654
230040;201703;4232;11791;3633;10746;280;1014;2658;7733;2938;8747
230050;201703;2687;8950;2007;7145;489;1725;580;2115;1069;3840
230060;201703;2305;6497;1946;5869;97;390;1504;4428;1601;4818
230070;201703;4177;12235;3647;11246;250;915;2527;7927;2777;8842
230075;201703;8990;30975;8391;29860;603;3070;6455;22322;7058;25392
230080;201703;2410;6165;1974;5510;66;255;1625;4469;1691;4724
230090;201703;4012;11156;3552;10395;307;1052;2558;7384;2865;8436
230100;201703;16588;48849;15469;46916;2428;7979;9260;28269;11688;36248
230110;201703;12372;39054;11316;36839;2092;7221;6102;19657;8194;26878
230120;201703;7826;21611;6788;20041;747;2169;4673;14347;5420;16516
230125;201703;2981;8552;2516;7725;158;584;1829;5563;1987;6147
230130;201703;5675;18443;4824;16607;491;1894;3162;10697;3653;12591
230140;201703;3486;10963;2975;10043;205;817;2060;6952;2265;7769
230150;201703;1643;5042;1435;4605;296;988;758;2449;1054;3437
230160;201703;6354;18146;5663;17150;308;1210;4565;13677;4873;14887
230170;201703;6140;19059;5374;17600;318;1263;3849;12422;4167;13685
230180;201703;1678;4881;1470;4473;63;281;1080;3126;1143;3407
230185;201703;3785;12317;3379;11562;499;1807;2191;7622;2690;9429
230190;201703;12325;38868;10871;35911;1841;6521;5545;18305;7386;24826
230195;201703;5304;16048;4692;14980;250;1007;3670;11479;3920;12486
230200;201703;5025;14306;4538;13398;289;977;3458;10000;3747;10977
230205;201703;4034;13184;3695;12554;290;1292;2590;8640;2880;9932
230210;201703;8728;24929;7710;23303;1048;3386;5015;15346;6063;18732
230220;201703;13110;36743;11850;34629;867;2958;8810;25338;9677;28296
230230;201703;7290;22991;6742;21988;627;2186;4810;15681;5437;17867
230240;201703;13384;36795;11784;34193;519;1730;9192;26465;9711;28195
230250;201703;9648;29409;9594;29309;593;2217;7406;22151;7999;24368
230260;201703;14291;46814;13112;44378;1906;6991;7531;25809;9437;32800
230270;201703;7532;21737;6270;19431;744;2504;3969;12380;4713;14884
230280;201703;19935;57869;17552;53740;1159;4293;13303;39997;14462;44290
230290;201703;4761;14276;4104;12942;496;1518;2778;8821;3274;10339
230300;201703;4310;12690;4110;12423;244;958;3370;10009;3614;10967
230310;201703;4865;14375;4213;13252;170;699;2994;9255;3164;9954
230320;201703;7241;21860;6532;20619;431;1746;4933;15290;5364;17036
230330;201703;4891;13991;4104;12471;317;1052;2869;8606;3186;9658
230340;201703;3450;11341;3117;10644;290;1157;2115;7082;2405;8239
230350;201703;18150;54084;16538;51274;1467;5462;10291;32301;11758;37763
230360;201703;3239;9086;2518;7779;186;676;1651;5055;1837;5731
230365;201703;2993;7852;2613;7211;93;368;2162;5884;2255;6252
230370;201703;54269;169735;48878;160616;12558;43343;21540;73851;34098;117194
230380;201703;6545;18888;5417;16768;231;873;3847;11772;4078;12645
230390;201703;3336;10564;3012;10003;212;954;2204;7171;2416;8125
230393;201703;3090;9967;2664;9145;176;872;1928;6339;2104;7211
230395;201703;5662;16206;5092;15247;677;2104;3142;9622;3819;11726
230400;201703;5512;16407;4965;15497;249;1061;3896;11907;4145;12968
230410;201703;14570;45566;12445;41144;1605;5642;7432;24595;9037;30237
230420;201703;23879;75112;21579;70625;4004;14110;10651;34815;14655;48925
230423;201703;4101;13347;3776;12690;242;1057;2927;9706;3169;10763
230425;201703;5471;17916;5013;16947;669;2357;3236;11002;3905;13359
230426;201703;2578;7191;2064;6206;69;301;1517;4465;1586;4766
230427;201703;1903;5576;1447;4568;121;405;863;2642;984;3047
230428;201703;8676;26484;8170;25526;1482;5062;4269;13121;5751;18183
230430;201703;4423;13775;3994;12959;277;1119;2904;9166;3181;10285
230435;201703;5176;15770;4600;14723;653;2310;2670;8545;3323;10855
230440;201703;366085;1045125;328949;982542;68196;214888;160487;483227;228683;698115
230445;201703;4413;12003;3793;10983;233;715;2701;7784;2934;8499
230450;201703;3649;11147;3209;10376;281;1178;2242;7111;2523;8289
230460;201703;1859;6065;1612;5609;161;673;1105;3812;1266;4485
230465;201703;3945;11660;3313;10492;208;834;2279;7024;2487;7858
230470;201703;10967;39184;10137;37519;1151;4991;7023;25741;8174;30732
230480;201703;1450;4473;1231;4042;133;536;846;2715;979;3251
230490;201703;2292;6886;2001;6334;278;957;1024;3148;1302;4105
230495;201703;5597;18187;5091;17189;576;2417;3053;10152;3629;12569
230500;201703;8687;30575;8283;29748;578;2611;6230;22247;6808;24858
230510;201703;1503;5229;1152;4325;279;1134;377;1429;656;2563
230520;201703;4266;13154;3999;12632;384;1365;2732;8517;3116;9882
230523;201703;14895;47247;12925;42803;3056;10805;3276;11322;6332;22127
230526;201703;4051;11908;3486;10915;204;870;2693;8252;2897;9122
230530;201703;5418;17184;4875;16440;682;2468;3345;11615;4027;14083
230533;201703;4102;11184;3568;10209;342;936;2557;7406;2899;8342
230535;201703;5484;15995;4768;14688;469;1514;3108;9798;3577;11312
230540;201703;17206;49721;15539;47139;532;2270;12964;38781;13496;41051
230550;201703;19343;56488;17009;52113;2765;9456;9150;27509;11915;36965
230560;201703;6857;19394;5902;17665;215;914;4507;13257;4722;14171
230565;201703;3465;9426;2811;8254;99;369;2071;6027;2170;6396
230570;201703;3580;9660;3156;9095;110;382;2575;7368;2685;7750
230580;201703;9950;29288;9121;28094;492;1915;7639;23229;8131;25144
230590;201703;9059;27406;7702;24858;552;2238;5357;16792;5909;19030
230600;201703;3777;10290;2878;8520;98;309;1872;5633;1970;5942
230610;201703;6234;19199;5690;18310;565;1876;4135;13371;4700;15247
230620;201703;2176;6123;1711;5131;191;606;956;2794;1147;3400
230625;201703;7786;24808;7006;23079;2105;7455;1969;6557;4074;14012
230630;201703;10598;33158;9721;31518;2520;7755;4495;15698;7015;23453
230640;201703;26412;83477;24099;80050;2281;8857;18330;60432;20611;69289
230650;201703;4776;14464;4306;13551;265;1066;3211;9834;3476;10900
230655;201703;9301;34216;8955;33555;688;3061;6976;26199;7664;29260
230660;201703;6196;19019;5272;17220;278;1358;4100;13043;4378;14401
230670;201703;6003;15772;4816;13722;173;605;3695;10250;3868;10855
230680;201703;2592;7604;2263;6954;298;947;1384;4258;1682;5205
230690;201703;6481;20526;6149;19802;663;2409;3767;11889;4430;14298
230700;201703;9582;26379;8474;24377;525;1890;6126;17003;6651;18893
230710;201703;7469;23893;6463;22022;743;2670;4470;15307;5213;17977
230720;201703;1831;5755;1571;5173;211;750;943;3083;1154;3833
230725;201703;3658;12294;3183;11143;745;2725;988;3448;1733;6173
230730;201703;53788;163157;46255;150212;13635;49370;9869;34354;23504;83724
230740;201703;6269;18293;5604;17187;245;988;4351;13199;4596;14187
230750;201703;8152;23365;7110;21624;354;1370;5386;16030;5740;17400
230760;201703;11152;32458;10227;30696;948;3369;7096;20578;8044;23947
230763;201703;4284;12828;3768;11837;219;913;2824;8570;3043;9483
230765;201703;38980;120154;34609;111778;9000;30933;10554;35357;19554;66290
230770;201703;25009;68322;22333;64413;2797;8590;14469;41787;17266;50377
230780;201703;5785;21909;5561;21404;1174;4600;2973;11900;4147;16500
230790;201703;2835;8799;2645;8492;206;757;2029;6521;2235;7278
230800;201703;7456;25838;6840;24504;1253;5006;3471;12191;4724;17197
230810;201703;11874;37942;11134;36661;761;3005;8445;27411;9206;30416
230820;201703;3280;11137;2881;10264;359;1489;1665;5807;2024;7296
230830;201703;7424;22228;6570;20652;356;1451;5044;15612;5400;17063
230835;201703;3843;10134;3189;9098;142;525;2490;7003;2632;7528
230837;201703;3132;10485;2734;9673;206;952;1954;6706;2160;7658
230840;201703;8889;28668;8237;27566;682;2640;6302;21135;6984;23775
230850;201703;9400;29034;8644;27692;901;3078;5970;19245;6871;22323
230860;201703;5078;14085;4495;13238;233;810;3646;10645;3879;11455
230870;201703;17959;46721;15680;43285;644;2101;12128;33215;12772;35316
230880;201703;1970;6534;1839;6279;119;582;1344;4458;1463;5040
230890;201703;4072;14437;3778;13826;376;1671;2561;9196;2937;10867
230900;201703;2741;9113;2318;8161;488;1642;1102;4003;1590;5645
230910;201703;3081;8932;2544;7986;156;701;1896;5793;2052;6494
230920;201703;4696;13306;4379;12912;163;591;3806;11297;3969;11888
230930;201703;6796;20322;6016;18829;519;1784;3998;12460;4517;14244
230940;201703;7526;21535;6790;20296;247;940;5476;16251;5723;17191
230945;201703;6223;18493;5482;17307;420;1507;3793;12140;4213;13647
230950;201703;6470;17050;5913;16353;183;473;5138;14527;5321;15000
230960;201703;13996;42945;12804;40615;2237;7426;6139;19790;8376;27216
230970;201703;13302;39594;11649;36655;2162;7506;5470;17133;7632;24639
230980;201703;2899;8861;2513;8179;544;1769;1352;4594;1896;6363
230990;201703;1800;5219;1495;4650;114;477;972;2908;1086;3385
231000;201703;2550;6999;2133;6184;106;380;1446;4090;1552;4470
231010;201703;3053;8360;2510;7442;253;820;1682;4916;1935;5736
231020;201703;7983;26387;7470;25234;1253;4223;4484;15513;5737;19736
231025;201703;7658;23270;7041;22153;1003;3338;4541;14479;5544;17817
231030;201703;7255;23195;6068;20715;1141;4115;3186;10915;4327;15030
231040;201703;3135;9705;2796;9049;141;646;2060;6460;2201;7106
231050;201703;11757;32854;10047;29874;662;2137;7383;21854;8045;23991
231060;201703;2414;7711;2246;7413;117;582;1684;5441;1801;6023
231070;201703;8411;26215;7528;24478;1337;4536;4052;13390;5389;17926
231080;201703;3999;12213;3648;11609;157;829;2794;8541;2951;9370
231085;201703;4895;14915;4674;14598;497;1561;3398;10948;3895;12509
231090;201703;4154;11515;3340;9925;158;567;2324;6739;2482;7306
231095;201703;2052;6591;1792;6029;186;710;1214;4058;1400;4768
231100;201703;3148;9664;2661;8762;186;717;1880;6136;2066;6853
231110;201703;3465;11276;3421;11198;306;1186;2415;7747;2721;8933
231120;201703;1911;6350;1802;6129;258;952;1133;3836;1391;4788
231123;201703;2023;5533;1777;5103;120;376;1300;3677;1420;4053
231126;201703;6114;17413;5048;15388;219;821;3567;10660;3786;11481
231130;201703;18947;56863;17166;54046;2510;8596;10761;34847;13271;43443
231135;201703;4048;11925;3478;10871;211;778;2499;7727;2710;8505
231140;201703;17149;52347;14804;47960;1145;4992;9918;31123;11063;36115
231150;201703;5557;15992;4851;14658;742;2353;2398;7396;3140;9749
231160;201703;5836;19112;5426;18301;864;3032;3221;10996;4085;14028
231170;201703;4238;13438;3748;12426;266;1138;2651;8542;2917;9680
231180;201703;14335;41961;12543;38319;2352;7427;6303;19041;8655;26468
231190;201703;4565;12759;3805;11598;226;941;2806;8255;3032;9196
231195;201703;4538;15099;3993;13979;369;1612;2724;9318;3093;10930
231200;201703;7816;26094;6862;24119;372;1925;4937;16833;5309;18758
231210;201703;4853;15308;4322;14446;248;1143;3209;10492;3457;11635
231220;201703;11616;32809;10151;30127;558;2153;7465;21585;8023;23738
231230;201703;8908;29297;8155;28164;726;2985;6223;21440;6949;24425
231240;201703;11566;35982;10581;33965;2012;6744;5636;18183;7648;24927
231250;201703;1880;5275;1290;3851;172;541;578;1663;750;2204
231260;201703;3280;9853;2986;9349;443;1394;1881;6008;2324;7402
231270;201703;7086;19135;6263;17881;258;1063;4817;13532;5075;14595
231280;201703;1738;5626;1621;5407;178;621;1072;3601;1250;4222
231290;201703;34454;112848;31125;105503;5912;21871;13639;45318;19551;67189
231300;201703;4265;12338;3526;10842;240;858;2368;7145;2608;8003
231310;201703;7330;20625;6057;17997;766;2340;3561;10464;4327;12804
231320;201703;6984;20913;5742;18401;241;1017;4185;13248;4426;14265
231325;201703;2721;7790;2358;7254;457;1423;1224;3828;1681;5251
231330;201703;11027;34905;9530;31849;1652;5641;5242;17725;6894;23366
231335;201703;5474;15237;4721;13890;151;620;3862;11152;4013;11772
231340;201703;17835;57602;16352;55210;1201;4340;12525;42903;13726;47243
231350;201703;14683;42296;13761;41058;508;1506;12225;36876;12733;38382
231355;201703;4590;14347;4138;13562;260;1041;3043;9903;3303;10944
231360;201703;7563;23889;6741;22468;1030;3565;4372;14870;5402;18435
231370;201703;2418;6689;1904;5832;59;211;1425;4331;1484;4542
231375;201703;4149;13919;3853;13356;220;1042;3017;10292;3237;11334
231380;201703;5482;16342;5228;16037;232;701;4393;13828;4625;14529
231390;201703;3424;10572;3131;10034;290;1081;2196;6939;2486;8020
231395;201703;3836;12460;3466;11758;576;2014;1993;6821;2569;8835
231400;201703;8950;27317;8239;25922;508;1977;6167;19094;6675;21071
231410;201703;14660;48384;13420;46530;1070;4068;10116;35263;11186;39331
240010;201703;2395;7037;1966;6164;257;916;1097;3353;1354;4269
240020;201703;10047;31281;9028;29346;1559;5440;4921;16088;6480;21528
240030;201703;2516;7012;2427;6876;120;423;2116;5915;2236;6338
240040;201703;860;2493;716;2205;28;136;499;1477;527;1613
240050;201703;3390;9115;2848;8165;94;315;2238;6310;2332;6625
240060;201703;1400;3970;1229;3654;57;216;961;2754;1018;2970
240070;201703;2423;7237;2258;6913;283;940;1551;4639;1834;5579
240080;201703;3025;8000;2586;7362;139;478;1925;5404;2064;5882
240090;201703;2264;5997;1865;5297;43;165;1473;4108;1516;4273
240100;201703;7704;22032;6841;20261;610;2051;4756;13650;5366;15701
240110;201703;4689;14479;4135;13358;563;2083;2302;7277;2865;9360
240120;201703;2657;9118;2524;8830;331;1345;1594;5492;1925;6837
240130;201703;2736;7148;2407;6640;76;277;2031;5517;2107;5794
240140;201703;2222;6596;1876;5942;241;879;1153;3589;1394;4468
240145;201703;5702;17652;5089;16595;1065;3630;2853;9547;3918;13177
240150;201703;954;2896;806;2587;64;275;576;1781;640;2056
240160;201703;1419;4443;1218;4093;110;448;806;2732;916;3180
240165;201703;878;2725;754;2447;147;445;407;1360;554;1805
240170;201703;2253;6763;1958;6217;347;1176;1060;3321;1407;4497
240180;201703;2690;8383;2361;7703;381;1304;1420;4715;1801;6019
240185;201703;1349;4492;1248;4322;82;341;1006;3469;1088;3810
240190;201703;968;3044;861;2861;35;153;669;2231;704;2384
240200;201703;12243;32907;10427;30064;2180;6572;4372;12952;6552;19524
240210;201703;2828;7847;2550;7395;102;395;2071;5837;2173;6232
240220;201703;7344;24389;6776;23567;671;2817;4814;16761;5485;19578
240230;201703;5761;15078;4929;13801;179;573;4088;11437;4267;12010
240240;201703;1782;5419;1136;3813;212;748;209;656;421;1404
240250;201703;2638;7675;2480;7474;115;339;2122;6429;2237;6768
240260;201703;11996;39750;11375;38749;1571;5969;7573;25829;9144;31798
240270;201703;2272;7093;2086;6782;141;503;1648;5393;1789;5896
240280;201703;1527;4281;1372;4069;60;212;1115;3284;1175;3496
240290;201703;1178;3713;1043;3450;65;326;706;2187;771;2513
240300;201703;2312;6250;1732;5079;160;516;903;2600;1063;3116
240310;201703;9313;26245;8329;24639;1028;3333;4668;13894;5696;17227
240320;201703;1962;5746;1565;4938;50;221;1140;3449;1190;3670
240325;201703;31995;89327;25981;79446;7469;24371;6714;21741;14183;46112
240330;201703;1477;4450;1252;3984;77;318;800;2449;877;2767
240340;201703;2038;5209;1679;4647;134;403;1241;3389;1375;3792
240350;201703;2039;5578;1878;5384;72;263;1675;4762;1747;5025
240360;201703;6538;20158;5911;19208;1518;4940;2887;9942;4405;14882
240370;201703;2030;5580;1613;4777;166;466;1031;3063;1197;3529
240375;201703;841;2241;746;2068;44;169;537;1401;581;1570
240380;201703;2396;7089;1812;5777;219;721;958;3033;1177;3754
240390;201703;920;2540;752;2209;24;76;508;1433;532;1509
240400;201703;1336;3568;1042;3009;61;204;723;2030;784;2234
240410;201703;450;1487;407;1399;60;258;240;799;300;1057
240420;201703;4678;17754;4342;16971;748;3441;2323;8958;3071;12399
240430;201703;3356;9319;3041;8760;138;574;2384;6612;2522;7186
240440;201703;2482;6313;2221;5936;347;1013;1386;3653;1733;4666
240450;201703;3965;11665;3375;10551;365;1377;1941;5851;2306;7228
240460;201703;2895;8751;2723;8528;214;866;2166;6614;2380;7480
240470;201703;3558;11130;2779;9435;682;2257;1267;4425;1949;6682
240480;201703;522;1422;397;1182;33;100;194;576;227;676
240485;201703;1952;6137;1702;5635;182;660;1127;3751;1309;4411
240490;201703;1750;4374;1425;3859;28;98;1228;3299;1256;3397
240500;201703;2178;6113;1956;5793;111;396;1578;4640;1689;5036
240510;201703;1653;4888;1584;4785;110;340;1323;3996;1433;4336
240520;201703;1209;3447;1078;3229;62;252;858;2478;920;2730
240530;201703;1940;6274;1801;6057;250;873;1274;4295;1524;5168
240540;201703;1839;5327;1718;5147;102;365;1453;4287;1555;4652
240550;201703;764;2179;654;1992;39;121;476;1448;515;1569
240560;201703;3277;9201;2983;8791;290;782;2338;7029;2628;7811
240570;201703;3003;8259;2210;6474;338;1093;955;2520;1293;3613
240580;201703;7768;23601;7195;22644;552;2050;5750;17879;6302;19929
240590;201703;743;2077;650;1909;19;74;493;1425;512;1499
240600;201703;1627;4712;1251;3915;125;464;739;2217;864;2681
240610;201703;4565;13062;3966;11915;351;1170;2623;7713;2974;8883
240615;201703;953;2810;781;2470;122;408;461;1411;583;1819
240620;201703;1813;5440;1606;5084;122;412;1266;3984;1388;4396
240630;201703;2054;6184;1874;5884;164;488;1290;4134;1454;4622
240640;201703;936;2606;786;2367;43;183;576;1666;619;1849
240650;201703;3960;11570;3546;10927;176;645;2796;8543;2972;9188
240660;201703;2333;7385;2195;7186;158;605;1730;5596;1888;6201
240670;201703;2558;7592;2151;6748;235;825;1262;3829;1497;4654
240680;201703;1507;4367;1222;3859;82;298;810;2505;892;2803
240690;201703;910;2467;778;2244;35;137;621;1723;656;1860
240700;201703;2501;7344;2098;6624;74;324;1636;5043;1710;5367
240710;201703;17527;46960;15252;43224;2935;8220;8200;23890;11135;32110
240720;201703;5133;14529;4633;13640;1127;3419;2240;6478;3367;9897
240725;201703;1016;3064;817;2609;55;189;506;1571;561;1760
240730;201703;2046;6116;1786;5633;107;360;1344;4215;1451;4575
240740;201703;1919;5523;1697;5103;115;443;1194;3454;1309;3897
240750;201703;2143;7910;1983;7612;404;1716;1039;4022;1443;5738
240760;201703;1343;3606;1082;3232;83;234;793;2450;876;2684
240770;201703;3065;8668;2755;8239;135;565;2293;6708;2428;7273
240780;201703;5937;16321;4802;14519;608;1899;2892;8894;3500;10793
240790;201703;886;2654;731;2367;36;143;517;1685;553;1828
240800;201703;33897;96507;29908;89759;6406;20189;13006;39494;19412;59683
240810;201703;83072;237584;76330;225955;19664;58978;35177;106554;54841;165532
240820;201703;5512;17466;4950;16572;1141;3994;2292;8094;3433;12088
240830;201703;8755;26751;8161;25904;389;1643;6774;21219;7163;22862
240840;201703;1104;3048;943;2769;81;263;624;1774;705;2037
240850;201703;1287;3729;960;2995;103;344;503;1556;606;1900
240860;201703;1253;3567;1016;3124;39;162;768;2275;807;2437
240870;201703;1139;3072;922;2689;67;215;613;1703;680;1918
240880;201703;1198;3962;1130;3847;86;377;926;3076;1012;3453
240890;201703;4842;13654;4048;12117;810;2521;1752;5202;2562;7723
240895;201703;2612;8970;2416;8643;241;931;1775;6425;2016;7356
240910;201703;2971;8751;2624;8088;121;461;2089;6361;2210;6822
240920;201703;760;2448;666;2234;105;379;354;1175;459;1554
240930;201703;3444;8775;3020;8256;93;263;2465;6821;2558;7084
240933;201703;1523;4059;1339;3763;42;165;1102;3009;1144;3174
240940;201703;6351;16722;5148;14726;639;1831;3265;9267;3904;11098
240950;201703;935;3028;861;2883;55;243;631;2049;686;2292
240960;201703;790;2447;698;2262;52;185;502;1627;554;1812
240970;201703;1850;5095;1565;4613;75;274;1236;3529;1311;3803
240980;201703;2782;9238;2601;8899;403;1500;1672;5680;2075;7180
240990;201703;2599;7721;2469;7470;390;1288;1617;4828;2007;6116
241000;201703;1030;2840;874;2560;46;166;613;1767;659;1933
241010;201703;2756;9280;2597;8979;328;1369;1810;6010;2138;7379
241020;201703;2013;5534;1599;4705;195;548;943;2780;1138;3328
241025;201703;1691;5045;1482;4677;72;282;1043;3294;1115;3576
241030;201703;2390;7789;2105;7203;208;839;1428;4828;1636;5667
241040;201703;2174;7372;1997;7056;134;591;1487;5248;1621;5839
241050;201703;1266;3705;1074;3364;69;249;787;2422;856;2671
241060;201703;834;2409;747;2254;55;185;525;1548;580;1733
241070;201703;702;2015;630;1886;51;191;480;1357;531;1548
241080;201703;1136;3338;927;2929;31;146;674;2080;705;2226
241090;201703;2127;6301;1777;5706;95;405;1321;4190;1416;4595
241100;201703;1164;3415;1005;3063;62;228;695;2074;757;2302
241105;201703;1181;3555;1017;3269;253;825;450;1510;703;2335
241110;201703;814;2513;673;2196;40;157;451;1414;491;1571
241120;201703;7247;21978;6573;20790;1540;4709;3385;11386;4925;16095
241140;201703;3380;9081;2914;8178;227;665;2112;5780;2339;6445
241142;201703;736;2158;571;1820;83;290;295;910;378;1200
241150;201703;5449;15757;4863;14769;397;1401;3486;10470;3883;11871
241160;201703;944;2780;847;2613;150;484;489;1496;639;1980
241170;201703;1136;3276;1059;3143;99;302;822;2400;921;2702
241180;201703;953;2661;761;2291;74;231;409;1192;483;1423
241190;201703;1172;3211;935;2715;49;180;625;1751;674;1931
241200;201703;18704;53270;16490;49879;3972;12611;7224;22627;11196;35238
241210;201703;1434;4002;1142;3414;125;436;691;1987;816;2423
241220;201703;7901;25554;7288;24439;2100;7167;3255;11364;5355;18531
241230;201703;3010;8631;2781;8277;143;518;2277;6627;2420;7145
241240;201703;1255;3644;862;2760;93;342;377;1206;470;1548
241250;201703;6096;18504;5072;16550;264;1310;3779;11914;4043;13224
241255;201703;1691;6321;1528;5966;292;1303;802;3112;1094;4415
241260;201703;5089;13716;4056;12081;181;775;2932;8554;3113;9329
241270;201703;1846;5596;1616;5138;98;422;1168;3632;1266;4054
241280;201703;1790;5202;1640;4922;132;417;1206;3584;1338;4001
241290;201703;2902;8062;2473;7315;144;534;1835;5314;1979;5848
241300;201703;1473;4163;1260;3773;47;166;866;2565;913;2731
241310;201703;1681;4855;1533;4608;77;298;1243;3680;1320;3978
241320;201703;925;3171;840;2983;114;468;528;1863;642;2331
241330;201703;1400;4268;1323;4172;85;351;1130;3513;1215;3864
241335;201703;2807;8386;2577;7976;117;418;2114;6467;2231;6885
241340;201703;1812;5517;1526;4874;330;1143;674;2082;1004;3225
241350;201703;1913;5970;1728;5628;120;526;1304;4119;1424;4645
241355;201703;1425;3919;1146;3427;59;214;879;2599;938;2813
241360;201703;2102;5606;1713;4852;76;240;1244;3440;1320;3680
241370;201703;1370;4040;1133;3572;85;327;730;2233;815;2560
241380;201703;616;1748;518;1561;56;192;321;931;377;1123
241390;201703;2754;8818;2564;8521;233;910;1955;6451;2188;7361
241400;201703;3684;10504;3341;10014;331;1100;2516;7581;2847;8681
241410;201703;2434;7347;2163;6952;334;1146;1396;4492;1730;5638
241415;201703;1655;4927;1472;4629;150;517;1090;3354;1240;3871
241420;201703;2224;7652;1980;7231;620;2448;525;1953;1145;4401
241430;201703;571;1677;440;1389;43;155;252;752;295;907
241440;201703;6083;21762;5782;21275;671;2883;4286;15755;4957;18638
241445;201703;964;2777;918;2726;51;124;776;2422;827;2546
241450;201703;2942;7868;2573;7344;322;952;1757;4992;2079;5944
241460;201703;3353;9711;2976;8948;231;843;2145;6250;2376;7093
241470;201703;1399;3831;1142;3487;87;332;868;2635;955;2967
241475;201703;1245;3715;1025;3280;47;249;734;2244;781;2493
241480;201703;2661;8807;2443;8436;960;3392;652;2541;1612;5933
241490;201703;698;1830;579;1656;29;86;372;1029;401;1115
241500;201703;725;2271;617;2131;17;75;524;1806;541;1881
250010;201703;2766;8544;2323;7571;83;382;1760;5609;1843;5991
250020;201703;1571;4489;1207;3790;63;255;861;2627;924;2882
250030;201703;6842;19662;6333;18946;372;1266;5188;15323;5560;16589
250040;201703;3952;13276;3656;12635;474;1730;2419;8368;2893;10098
250050;201703;3247;10110;3009;9729;500;1711;1870;5920;2370;7631
250053;201703;1219;3652;1109;3485;118;376;780;2480;898;2856
250057;201703;627;2641;609;2622;3;3;579;2554;582;2557
250060;201703;5078;14904;4725;14395;401;1410;3707;11208;4108;12618
250070;201703;3833;11788;3568;11293;116;563;2728;8322;2844;8885
250073;201703;780;2274;682;2109;23;85;518;1552;541;1637
250077;201703;2116;6129;1723;5468;114;392;1204;3804;1318;4196
250080;201703;4099;11846;3899;11490;273;929;3098;8955;3371;9884
250090;201703;2575;7284;2399;6995;138;384;1938;5606;2076;5990
250100;201703;3831;12283;3600;11867;206;879;2892;9312;3098;10191
250110;201703;4806;14278;4523;13870;400;1455;3593;10815;3993;12270
250115;201703;473;1514;438;1451;23;121;319;1009;342;1130
250120;201703;1841;5721;1621;5299;89;367;1257;4108;1346;4475
250130;201703;5266;16341;4763;15407;188;845;3819;12217;4007;13062
250135;201703;1037;3139;977;3036;35;137;786;2410;821;2547
250140;201703;2072;6746;1996;6626;154;652;1557;5124;1711;5776
250150;201703;4987;16551;4561;15748;250;1159;3479;11779;3729;12938
250153;201703;1438;3862;1236;3563;38;170;1032;2912;1070;3082
250157;201703;1711;5505;1565;5213;244;781;1000;3405;1244;4186
250160;201703;3272;9515;3096;9240;82;290;2805;8360;2887;8650
250170;201703;1563;4598;1433;4404;95;348;1118;3407;1213;3755
250180;201703;15608;44785;14489;43128;1319;4621;10534;30581;11853;35202
250190;201703;4088;11744;3731;11176;472;1414;2458;7350;2930;8764
250200;201703;1937;5676;1617;5191;81;336;1303;4139;1384;4475
250205;201703;835;2865;781;2741;35;179;585;2027;620;2206
250210;201703;1467;4719;1375;4572;95;454;1057;3400;1152;3854
250215;201703;1386;4358;1281;4205;107;441;839;2703;946;3144
250220;201703;734;2202;614;2018;34;137;457;1500;491;1637
250230;201703;1528;3826;1240;3350;46;166;962;2486;1008;2652
250240;201703;2280;7432;2170;7237;108;415;1751;5803;1859;6218
250250;201703;4356;12904;3961;12368;161;581;3245;10118;3406;10699
250260;201703;1672;5000;1449;4633;62;229;1130;3617;1192;3846
250270;201703;1278;3942;1152;3783;87;289;861;2958;948;3247
250280;201703;3549;10373;3111;9679;234;760;2349;7307;2583;8067
250290;201703;1769;4794;1484;4405;18;65;1250;3701;1268;3766
250300;201703;5213;15407;4989;15129;368;1471;4295;12734;4663;14205
250310;201703;1103;3344;987;3144;57;238;758;2342;815;2580
250320;201703;8026;23245;7537;22534;854;2825;5540;16275;6394;19100
250330;201703;2395;7360;2051;6845;151;555;1549;5143;1700;5698
250340;201703;1074;3156;968;2977;29;111;816;2464;845;2575
250350;201703;4036;11221;3638;10735;121;446;3209;9428;3330;9874
250355;201703;1944;6049;1781;5834;43;233;1582;5107;1625;5340
250360;201703;1797;5260;1680;5071;48;166;1416;4264;1464;4430
250370;201703;11503;32701;10283;31324;607;1999;8806;26852;9413;28851
250375;201703;1061;3178;963;3041;41;147;810;2578;851;2725
250380;201703;1655;4671;1576;4569;71;288;1325;3716;1396;4004
250390;201703;1794;4897;1475;4356;217;610;926;2775;1143;3385
250400;201703;72473;191220;57294;167409;14421;44616;21179;63381;35600;107997
250403;201703;1554;5055;1440;4899;244;1006;922;3044;1166;4050
250407;201703;1198;3308;1034;3061;85;229;756;2229;841;2458
250410;201703;520;1673;484;1606;23;119;384;1232;407;1351
250415;201703;1898;5612;1703;5277;94;318;1293;3982;1387;4300
250420;201703;1239;3589;1117;3409;24;90;1004;3057;1028;3147
250430;201703;6135;16343;5546;15455;226;761;4541;12379;4767;13140
250435;201703;1326;4052;1190;3809;71;268;882;2799;953;3067
250440;201703;4467;12653;4043;12073;112;443;3422;10105;3534;10548
250450;201703;1893;5364;1644;5022;55;225;1374;4132;1429;4357
250460;201703;6484;19082;6081;18566;395;1302;5093;15710;5488;17012
250470;201703;1539;4135;1297;3794;94;341;949;2695;1043;3036
250480;201703;3733;11158;3455;10771;85;371;3025;9450;3110;9821
250485;201703;628;1535;508;1372;22;68;421;1111;443;1179
250490;201703;3892;11723;3748;11528;499;1597;2824;8720;3323;10317
250500;201703;1760;5285;1593;5008;109;345;1242;3941;1351;4286
250510;201703;4889;13592;4382;12876;123;400;3847;11310;3970;11710
250520;201703;1758;5274;1642;5118;237;852;1031;3146;1268;3998
250523;201703;1734;5100;1681;5031;102;404;1421;4163;1523;4567
250527;201703;1412;4152;1349;4075;60;188;1228;3691;1288;3879
250530;201703;591;1821;525;1741;25;105;459;1509;484;1614
250535;201703;1317;4075;1231;3908;51;237;981;3034;1032;3271
250540;201703;2444;6738;2272;6544;35;133;2045;5837;2080;5970
250550;201703;863;2897;795;2787;40;211;650;2215;690;2426
250560;201703;1635;5061;1543;4915;80;314;1256;3921;1336;4235
250570;201703;2612;8122;2292;7515;118;516;1799;5751;1917;6267
250580;201703;1085;2874;954;2680;55;207;804;2200;859;2407
250590;201703;820;2546;755;2447;37;165;629;1976;666;2141
250600;201703;6969;20501;6545;19857;608;1880;5110;15559;5718;17439
250610;201703;2996;8718;2789;8420;246;789;2167;6512;2413;7301
250620;201703;674;1966;609;1835;74;246;402;1172;476;1418
250625;201703;2418;7614;2337;7492;48;150;2175;6980;2223;7130
250630;201703;9505;29197;8628;27383;1749;5831;4741;14953;6490;20784
250640;201703;3378;10292;3199;10052;158;698;2691;8263;2849;8961
250650;201703;856;2330;745;2181;46;188;563;1555;609;1743
250660;201703;1758;4654;1634;4480;30;67;1519;4193;1549;4260
250670;201703;2315;7742;2210;7562;105;522;1866;6240;1971;6762
250680;201703;4799;13133;4539;12833;166;619;4063;11394;4229;12013
250690;201703;5967;15129;5688;14812;242;705;5201;13453;5443;14158
250700;201703;4486;13248;4110;12677;581;1909;2768;8440;3349;10349
250710;201703;4412;13545;3973;12951;403;1411;2779;9203;3182;10614
250720;201703;2698;7672;2489;7341;59;259;2201;6434;2260;6693
250730;201703;3460;10372;3189;9996;231;888;2543;7779;2774;8667
250740;201703;1882;5371;1631;4995;152;570;1231;3638;1383;4208
250750;201703;96504;268300;88108;256041;10669;34157;58599;167455;69268;201612
250760;201703;2273;6286;2011;5910;119;436;1603;4633;1722;5069
250770;201703;3886;12722;3649;12413;371;1485;2642;8921;3013;10406
250780;201703;1720;5004;1486;4555;184;654;964;2866;1148;3520
250790;201703;2325;7536;2213;7336;437;1446;1323;4515;1760;5961
250800;201703;2633;7283;2331;6794;93;272;1910;5495;2003;5767
250810;201703;1244;3615;1078;3358;53;223;837;2556;890;2779
250820;201703;1858;5764;1783;5674;92;398;1576;4948;1668;5346
250830;201703;5542;17737;5129;16896;458;1832;3623;11698;4081;13530
250840;201703;880;2875;759;2622;51;212;502;1749;553;1961
250850;201703;1973;5983;1794;5708;74;349;1421;4413;1495;4762
250855;201703;1075;3143;945;2935;43;193;701;2112;744;2305
250860;201703;3203;10274;2749;9441;623;2298;1118;3923;1741;6221
250870;201703;1074;3084;940;2822;29;105;740;2192;769;2297
250880;201703;1503;4017;1254;3670;101;321;956;2822;1057;3143
250890;201703;9262;27392;8828;26802;1020;3683;6484;19207;7504;22890
250900;201703;2702;8670;2395;8077;147;529;1839;6140;1986;6669
250905;201703;1996;6299;1924;6213;166;642;1570;5005;1736;5647
250910;201703;4885;13965;4589;13547;208;780;3862;11305;4070;12085
250915;201703;1431;4285;1397;4244;62;151;1268;3935;1330;4086
250920;201703;3151;8892;2969;8620;222;671;2272;6505;2494;7176
250930;201703;1918;5810;1817;5640;135;563;1410;4237;1545;4800
250933;201703;1111;3639;1020;3454;85;362;710;2360;795;2722
250937;201703;645;1988;579;1864;43;163;431;1369;474;1532
250939;201703;1566;4635;1450;4449;84;311;1130;3392;1214;3703
250940;201703;3751;10917;3509;10528;86;363;3047;9117;3133;9480
250950;201703;1330;3996;1168;3774;50;205;943;3062;993;3267
250960;201703;1036;3351;987;3270;43;178;801;2618;844;2796
250970;201703;8379;23066;7343;21421;515;1691;5429;15615;5944;17306
250980;201703;2522;7337;2284;6898;92;391;1740;5060;1832;5451
250990;201703;1926;6481;1720;6031;215;925;1134;3826;1349;4751
251000;201703;2058;6005;1803;5595;54;255;1512;4627;1566;4882
251010;201703;2699;7935;2436;7504;94;341;2104;6473;2198;6814
251020;201703;1655;4619;1511;4438;60;190;1371;4024;1431;4214
251030;201703;1005;2851;916;2675;49;173;654;1857;703;2030
251040;201703;1718;5380;1553;5094;83;420;1209;3823;1292;4243
251050;201703;1035;3016;861;2679;112;349;536;1641;648;1990
251060;201703;1032;2310;766;1970;21;81;606;1529;627;1610
251065;201703;470;1361;401;1264;24;96;274;813;298;909
251070;201703;625;1715;560;1620;17;71;465;1301;482;1372
251080;201703;18466;51403;16542;48401;4164;12667;7878;23756;12042;36423
251090;201703;2844;8690;2504;8031;137;547;1914;6012;2051;6559
251100;201703;929;2929;843;2782;49;244;602;1897;651;2141
251110;201703;1807;5279;1601;4865;104;337;1148;3447;1252;3784
251120;201703;6207;20497;5890;19938;510;2133;4470;14850;4980;16983
251130;201703;3774;9675;3501;9385;109;260;3322;8975;3431;9235
251140;201703;4198;12659;3940;12240;137;579;3279;10119;3416;10698
251150;201703;2564;8046;2371;7757;176;773;1811;5773;1987;6546
251160;201703;1800;5865;1754;5796;47;201;1613;5315;1660;5516
251170;201703;1426;4244;1357;4168;48;207;1214;3686;1262;3893
251180;201703;2434;7390;2224;7049;292;1014;1430;4495;1722;5509
251190;201703;4391;11998;4194;11758;111;364;3802;10535;3913;10899
251200;201703;3919;12601;3713;12349;96;401;3348;11169;3444;11570
251203;201703;982;3263;948;3196;42;190;716;2363;758;2553
251207;201703;1017;3159;878;2894;34;165;605;1930;639;2095
251210;201703;7753;21657;6653;20221;551;1700;5118;15848;5669;17548
251220;201703;1174;3076;969;2794;62;176;750;2185;812;2361
251230;201703;4502;13194;4128;12731;213;825;3644;11079;3857;11904
251240;201703;3237;9667;2956;9289;330;1075;2228;6989;2558;8064
251250;201703;10224;29717;9515;28712;753;2690;7262;21464;8015;24154
251260;201703;463;1459;426;1401;23;101;326;1050;349;1151
251270;201703;4206;13595;3847;13144;136;617;3297;11255;3433;11872
251272;201703;1343;3815;1285;3738;59;205;1167;3367;1226;3572
251274;201703;901;2750;802;2579;75;327;536;1644;611;1971
251275;201703;1221;3551;1140;3425;52;223;873;2509;925;2732
251276;201703;1175;3581;1122;3494;93;396;853;2591;946;2987
251278;201703;591;1806;521;1680;47;187;340;1094;387;1281
251280;201703;2307;6768;2129;6469;81;348;1683;4942;1764;5290
251290;201703;5521;14967;5187;14552;464;1673;4115;11191;4579;12864
251300;201703;742;2439;700;2373;21;94;577;1931;598;2025
251310;201703;2862;8576;2657;8292;141;642;2121;6414;2262;7056
251315;201703;1640;5497;1559;5359;131;501;1185;4040;1316;4541
251320;201703;1844;5034;1378;4274;67;258;948;2928;1015;3186
251330;201703;1751;4622;1477;4261;54;221;1299;3680;1353;3901
251335;201703;1022;3363;933;3218;73;324;677;2271;750;2595
251340;201703;3403;9753;3023;9219;157;610;2360;7077;2517;7687
251350;201703;1181;3758;1105;3622;51;221;878;2786;929;3007
251360;201703;1798;5571;1540;5214;51;214;1314;4490;1365;4704
251365;201703;697;2087;586;1837;17;75;435;1334;452;1409
251370;201703;22783;69109;21899;67912;1720;6599;17346;52589;19066;59188
251380;201703;1310;4029;1136;3740;42;216;955;3030;997;3246
251385;201703;735;1970;610;1774;37;122;424;1176;461;1298
251390;201703;5637;18933;5022;17726;1374;5014;2246;8002;3620;13016
251392;201703;1037;3053;907;2832;55;214;665;2034;720;2248
251394;201703;607;1990;525;1847;34;152;369;1279;403;1431
251396;201703;798;2264;691;2091;58;169;450;1357;508;1526
251398;201703;867;2533;774;2363;35;142;539;1578;574;1720
251400;201703;1131;3170;959;2916;70;260;703;2056;773;2316
251410;201703;1535;3914;1299;3540;33;138;1083;2845;1116;2983
251420;201703;1961;5567;1697;5252;147;539;1259;3838;1406;4377
251430;201703;1590;5320;1460;5111;59;308;1235;4241;1294;4549
251440;201703;1169;3482;972;3097;44;170;740;2354;784;2524
251445;201703;1495;4545;1422;4447;103;432;1118;3405;1221;3837
251450;201703;4564;14340;4218;13873;135;631;3468;11365;3603;11996
251455;201703;1056;3344;946;3129;84;352;671;2186;755;2538
251460;201703;814;2505;755;2404;45;166;617;1970;662;2136
251465;201703;434;1373;374;1239;16;85;281;897;297;982
251470;201703;1105;3212;932;2853;74;267;591;1775;665;2042
251480;201703;900;2538;795;2368;32;147;594;1703;626;1850
251490;201703;1758;5172;1572;4877;147;533;1095;3344;1242;3877
251500;201703;1724;5442;1652;5312;98;404;1354;4265;1452;4669
251510;201703;2512;8177;2278;7715;334;1245;1386;4677;1720;5922
251520;201703;919;2521;796;2291;83;256;544;1525;627;1781
251530;201703;12044;33066;11277;32015;302;1298;9717;26996;10019;28294
251540;201703;2806;8868;2603;8492;154;615;2039;6565;2193;7180
251550;201703;3350;8848;2825;8134;80;299;2317;6620;2397;6919
251560;201703;653;2033;591;1929;87;332;360;1127;447;1459
251570;201703;958;2826;784;2487;35;147;551;1693;586;1840
251580;201703;1827;5138;1665;4912;312;805;1087;3350;1399;4155
251590;201703;1485;4471;1405;4357;60;227;1131;3504;1191;3731
251593;201703;966;2950;892;2846;124;419;556;1736;680;2155
251597;201703;1913;5801;1851;5724;45;186;1662;5079;1707;5265
251600;201703;6404;18621;5947;17913;294;1029;4882;14560;5176;15589
251610;201703;3274;9659;2952;9081;325;981;2078;6474;2403;7455
251615;201703;1129;3182;922;2823;44;179;636;1886;680;2065
251620;201703;15535;40703;13949;38854;469;1308;11483;33747;11952;35055
251630;201703;4601;11785;3916;10805;257;787;2927;7932;3184;8719
251640;201703;2191;6600;1987;6210;78;340;1631;4991;1709;5331
251650;201703;3947;11232;3618;10794;199;688;3010;8924;3209;9612
251660;201703;3474;10991;3158;10418;111;550;2608;8398;2719;8948
251670;201703;4355;12765;3873;12172;27;101;3644;11592;3671;11693
251675;201703;677;2109;624;2035;95;355;413;1306;508;1661
251680;201703;2732;7743;2218;6963;90;357;1714;5340;1804;5697
251690;201703;3265;9689;2965;9117;120;432;2165;6505;2285;6937
251700;201703;1881;6049;1756;5883;93;452;1444;4707;1537;5159
251710;201703;875;2293;591;1725;67;241;293;795;360;1036
251720;201703;1407;4246;1203;3856;52;242;889;2747;941;2989
251740;201703;747;2106;598;1862;53;187;374;1145;427;1332
260005;201703;24512;59756;21188;54933;3903;9900;12208;31907;16111;41807
260010;201703;9744;26468;8226;24367;909;2819;5015;15331;5924;18150
260020;201703;6185;16761;5250;15411;188;756;4273;12517;4461;13273
260030;201703;6122;17402;5432;16302;349;1222;4190;12525;4539;13747
260040;201703;9507;23431;7903;21543;640;1729;5980;16919;6620;18648
260050;201703;11113;34160;10422;33331;453;1792;9014;29013;9467;30805
260060;201703;3812;10666;3378;9892;302;873;2461;7338;2763;8211
260070;201703;9748;27649;8896;26298;912;3136;6275;18143;7187;21279
260080;201703;6013;15380;5400;14561;481;1315;4072;10876;4553;12191
260090;201703;5181;13998;4803;13468;482;1355;3670;10390;4152;11745
260100;201703;3305;9075;2842;8438;164;627;2305;6797;2469;7424
260105;201703;5028;13852;4771;13445;152;642;4101;11298;4253;11940
260110;201703;21047;58190;19361;56211;755;2436;17179;49977;17934;52413
260120;201703;12948;37941;11536;35603;2195;6975;6393;20270;8588;27245
260130;201703;3126;8696;2924;8375;278;862;2202;6227;2480;7089
260140;201703;12518;30918;10898;28990;712;2237;8800;23469;9512;25706
260150;201703;3161;8606;2855;8206;184;661;2289;6514;2473;7175
260160;201703;5467;16974;4739;16004;239;1105;3849;13019;4088;14124
260170;201703;16270;44788;15424;43623;736;2449;13222;37035;13958;39484
260180;201703;3211;9661;2932;9261;153;550;2492;7851;2645;8401
260190;201703;16219;37056;14633;35132;324;971;12740;30101;13064;31072
260200;201703;10975;27591;10132;26543;356;1132;9000;23489;9356;24621
260210;201703;11650;34618;10421;32678;459;1795;8540;26696;8999;28491
260220;201703;9339;26151;8973;25684;350;1351;7961;22404;8311;23755
260230;201703;9643;26982;8860;25903;406;1511;7175;20848;7581;22359
260240;201703;2903;8507;2528;7974;237;818;1913;6075;2150;6893
260250;201703;2240;6164;1974;5784;102;352;1587;4570;1689;4922
260260;201703;12072;34003;10909;32302;836;2866;8440;24896;9276;27762
260270;201703;3605;10359;3309;9911;218;968;2493;7179;2711;8147
260280;201703;12716;40754;11684;39241;638;2394;9746;32934;10384;35328
260290;201703;32173;94801;30336;91647;4850;15683;19184;57382;24034;73065
260300;201703;8787;26415;7777;24909;347;1515;6055;19418;6402;20933
260310;201703;4447;12972;4050;12384;735;2099;2622;8337;3357;10436
260320;201703;7434;23166;6799;22085;385;1476;5463;17679;5848;19155
260330;201703;2552;8132;2369;7782;131;562;1874;6028;2005;6590
260340;201703;1870;5384;1728;5176;44;159;1541;4593;1585;4752
260345;201703;22026;67080;20496;64239;5055;17441;8293;24915;13348;42356
260350;201703;4842;12853;4480;12352;148;545;3894;10611;4042;11156
260360;201703;2399;6771;2177;6385;100;433;1509;4368;1609;4801
260370;201703;5562;17115;4897;15918;340;1419;3596;11544;3936;12963
260380;201703;4829;15570;4352;14808;277;1224;3232;10876;3509;12100
260390;201703;4231;13301;3662;12174;277;1013;2550;8402;2827;9415
260392;201703;3462;11041;3154;10646;205;948;2602;8621;2807;9569
260400;201703;13607;37767;12822;36524;1423;4562;9161;25611;10584;30173
260410;201703;59746;168517;51831;156043;13416;42985;20353;63059;33769;106044
260415;201703;3669;11351;3216;10439;198;918;2183;6773;2381;7691
260420;201703;12148;27463;10750;25941;192;672;9843;23536;10035;24208
260430;201703;2873;9184;2527;8521;223;824;1683;5668;1906;6492
260440;201703;3222;9607;2853;8881;301;1081;1937;5858;2238;6939
260450;201703;4939;14107;4746;13847;153;518;4283;12521;4436;13039
260460;201703;5458;17234;4973;16305;807;2992;2810;9011;3617;12003
260470;201703;4589;13361;4168;12866;135;394;3646;11583;3781;11977
260480;201703;4084;11546;3569;10801;433;1461;2337;7193;2770;8654
260490;201703;4930;12726;4307;11683;193;642;3594;9515;3787;10157
260500;201703;5738;16323;5106;15313;702;2159;3343;10099;4045;12258
260510;201703;8655;22815;8028;21967;324;1079;7072;19171;7396;20250
260515;201703;4700;13924;3597;11740;226;875;2278;7405;2504;8280
260520;201703;16392;41657;15506;40463;1430;3844;12150;31492;13580;35336
260530;201703;9425;28873;8318;27163;351;1491;6967;22666;7318;24157
260540;201703;5990;14781;5447;14193;667;1254;4287;11825;4954;13079
260545;201703;62;221;42;165;9;37;8;29;17;66
260550;201703;2696;8650;2275;7717;355;1333;1104;3721;1459;5054
260560;201703;6253;16356;5536;15376;154;654;4810;13161;4964;13815
260570;201703;6724;21698;6165;20812;562;2242;4606;15464;5168;17706
260580;201703;3682;10109;3403;9646;87;312;2966;8282;3053;8594
260590;201703;6139;15348;5731;14887;256;713;4995;12983;5251;13696
260600;201703;28698;81889;25385;76476;1766;6494;18655;55614;20421;62108
260610;201703;5967;18074;5665;17557;532;1903;4162;12611;4694;14514
260620;201703;15027;45154;14360;43985;2172;7680;9246;27472;11418;35152
260630;201703;2251;6475;1986;6088;90;386;1628;4910;1718;5296
260640;201703;17024;46218;15929;44754;1962;5964;11078;30997;13040;36961
260650;201703;5440;16629;4776;15494;249;1000;3852;12526;4101;13526
260660;201703;7622;20993;6846;20016;248;980;5761;16643;6009;17623
260670;201703;2284;6068;1889;5494;104;315;1360;3935;1464;4250
260680;201703;21380;60341;19475;56953;3362;10104;10153;29734;13515;39838
260690;201703;3707;9901;3082;8890;185;542;2366;6819;2551;7361
260700;201703;5774;17194;5625;17033;28;55;5507;16854;5535;16909
260710;201703;1349;3873;1278;3777;95;325;948;2880;1043;3205
260720;201703;17962;55534;16793;53334;3035;10063;9665;30590;12700;40653
260730;201703;6655;21807;6238;21126;605;2406;4778;15923;5383;18329
260740;201703;1233;3675;1102;3441;62;220;898;2800;960;3020
260750;201703;6959;20434;6114;19371;220;666;5417;17525;5637;18191
260760;201703;4720;12593;4441;12246;191;640;3750;10348;3941;10988
260765;201703;7525;25215;7132;24563;887;4037;4887;16159;5774;20196
260770;201703;3756;10036;3379;9437;125;412;2678;7415;2803;7827
260775;201703;4866;14273;4613;13889;379;1475;3344;9773;3723;11248
260780;201703;3592;11405;3349;10939;674;2402;1812;5730;2486;8132
260790;201703;108618;271970;100065;259172;18754;49829;58287;149941;77041;199770
260795;201703;3071;8904;2709;8352;201;744;1945;6027;2146;6771
260800;201703;5031;12987;4681;12512;135;524;4140;10708;4275;11232
260805;201703;3711;11016;3187;10157;300;1141;2200;6917;2500;8058
260810;201703;6597;18309;6328;17914;361;1107;5277;14882;5638;15989
260820;201703;3940;11044;3496;10349;554;1819;2005;5833;2559;7652
260825;201703;2860;9061;2546;8532;145;618;1925;6409;2070;7027
260830;201703;3686;11663;3279;10893;416;1411;2216;7439;2632;8850
260840;201703;4186;11916;3736;11257;224;736;3011;9022;3235;9758
260845;201703;3988;11532;3815;11208;387;1192;2910;8594;3297;9786
260850;201703;4776;15380;4256;14184;741;2708;2116;6984;2857;9692
260860;201703;3600;10802;3114;9824;165;608;2361;7379;2526;7987
260870;201703;4155;11043;3693;10450;219;707;2991;8379;3210;9086
260875;201703;6323;17725;5572;16479;757;2289;3669;10902;4426;13191
260880;201703;9752;28710;8802;27183;487;1656;7052;21862;7539;23518
260890;201703;12704;36211;11839;34879;656;2374;8993;26145;9649;28519
260900;201703;5584;17062;4841;15643;362;1522;3181;10058;3543;11580
260910;201703;3068;9048;2752;8545;130;481;2065;6399;2195;6880
260915;201703;4609;15103;4314;14691;93;478;3902;13244;3995;13722
260920;201703;3206;9641;2977;9327;166;550;2406;7688;2572;8238
260930;201703;3813;12346;3387;11622;314;1147;2401;8269;2715;9416
260940;201703;13748;36038;12617;34206;1350;4182;8673;23000;10023;27182
260950;201703;6202;18940;5488;17493;811;3039;2824;8520;3635;11559
260960;201703;54205;147732;49150;139623;8877;27102;26464;74259;35341;101361
260970;201703;4862;14462;4466;13947;221;855;3494;10929;3715;11784
260980;201703;3973;12765;3690;12413;109;474;3267;10983;3376;11457
260990;201703;17179;51970;15625;49845;923;3707;12550;39902;13473;43609
261000;201703;15473;41525;12784;37476;1803;5727;7193;21564;8996;27291
261010;201703;2483;6832;2268;6575;106;241;2014;5966;2120;6207
261020;201703;6449;18432;5655;17022;492;1663;4152;12193;4644;13856
261030;201703;3757;11401;3308;10664;178;694;2600;8255;2778;8949
261040;201703;5060;16092;4299;14488;333;1331;3050;10063;3383;11394
261050;201703;7770;22471;7255;21557;871;2695;4792;14298;5663;16993
261060;201703;12310;35279;11347;33589;977;3402;8452;24512;9429;27914
261070;201703;53096;127891;46855;119004;4769;12825;32760;82289;37529;95114
261080;201703;5579;15878;5300;15474;285;810;4604;13606;4889;14416
261090;201703;16442;44303;15078;42426;963;2935;12258;34510;13221;37445
261100;201703;8201;25332;7294;23780;1065;3735;4479;14818;5544;18553
261110;201703;59860;176659;53101;166398;13355;44470;23317;75053;36672;119523
261120;201703;3800;9888;3307;9312;85;311;2928;8235;3013;8546
261130;201703;7097;17972;6577;17399;149;502;5877;15466;6026;15968
261140;201703;3120;8659;2831;8211;356;1203;1812;5134;2168;6337
261150;201703;5372;14945;4907;14248;202;730;4213;12154;4415;12884
261153;201703;2047;6074;1743;5588;97;405;1240;3940;1337;4345
261160;201703;191681;500316;176487;477696;43644;124065;78658;215535;122302;339600
261170;201703;5636;15107;5156;14415;278;804;4165;11666;4443;12470
261180;201703;9534;26203;8842;25257;829;2726;6094;17139;6923;19865
261190;201703;4958;15233;4627;14839;460;1956;3324;10370;3784;12326
261200;201703;3587;8818;3196;8344;302;815;2480;6478;2782;7293
261210;201703;1848;4885;1707;4702;103;285;1482;4088;1585;4373
261220;201703;13426;40893;11398;36749;1462;5256;6444;20600;7906;25856
261230;201703;4569;14012;4143;13474;114;471;3521;11574;3635;12045
261240;201703;4804;13733;4404;13052;512;1476;3203;9583;3715;11059
261245;201703;3461;10563;2993;9736;145;673;2322;7334;2467;8007
261247;201703;3105;9486;2662;8675;156;635;1923;6294;2079;6929
261250;201703;18840;49727;17455;47858;3118;8137;11380;32504;14498;40641
261255;201703;3943;12213;3512;11454;209;960;2763;8750;2972;9710
261260;201703;12363;34454;10999;32798;492;1671;9178;27664;9670;29335
261270;201703;3659;10835;3302;10241;291;1038;2356;7131;2647;8169
261280;201703;2532;7573;2328;7246;90;371;1892;5802;1982;6173
261290;201703;2935;8286;2640;7900;152;582;2054;6132;2206;6714
261300;201703;10894;34078;9471;31505;1049;4178;6174;20148;7223;24326
261310;201703;6949;21191;6510;20418;1566;5018;3546;11147;5112;16165
261320;201703;5814;17612;5321;16754;184;771;4312;13355;4496;14126
261330;201703;5589;15381;5259;14956;282;1111;4466;12411;4748;13522
261340;201703;3863;12682;3615;12278;315;1351;2551;8561;2866;9912
261350;201703;8048;25839;7576;25038;251;1321;6184;19911;6435;21232
261360;201703;8167;21188;7215;19886;524;1505;5666;15433;6190;16938
261370;201703;18876;55443;17698;53529;3543;11314;9919;30018;13462;41332
261380;201703;4059;13664;3763;13042;513;2046;2414;8253;2927;10299
261390;201703;16106;48486;14520;45793;1925;6635;8837;27980;10762;34615
261400;201703;4652;15815;4135;14716;245;1092;2968;10405;3213;11497
261410;201703;8904;24155;7934;22661;555;1794;6319;17947;6874;19741
261420;201703;7285;24207;6954;23762;1374;5299;4299;14505;5673;19804
261430;201703;3383;10312;2924;9618;185;646;2299;7628;2484;8274
261440;201703;1543;4857;1381;4575;55;288;1060;3431;1115;3719
261450;201703;13949;39478;13404;38802;299;1224;11947;34315;12246;35539
261460;201703;7026;20413;6563;19774;320;1034;5700;17216;6020;18250
261470;201703;4041;10894;3718;10462;67;260;3180;9022;3247;9282
261480;201703;3822;13279;3494;12693;243;1059;2634;9375;2877;10434
261485;201703;4910;14902;4367;13986;587;2177;2712;8545;3299;10722
261500;201703;5415;15154;4853;14399;475;1366;3497;10683;3972;12049
261510;201703;1842;5854;1660;5532;118;463;1228;4111;1346;4574
261520;201703;2714;8640;2567;8378;118;445;1684;5802;1802;6247
261530;201703;10741;34610;9742;32593;1753;6686;4533;15026;6286;21712
261540;201703;6918;22209;6474;21433;1428;4805;3646;12371;5074;17176
261550;201703;3465;9579;3222;9233;227;820;2457;6873;2684;7693
261560;201703;7248;23346;6534;22377;721;2936;4788;16412;5509;19348
261570;201703;3385;9986;2940;9251;312;1110;1882;5863;2194;6973
261580;201703;6060;18019;5496;17144;247;1076;4641;14265;4888;15341
261590;201703;2437;6809;2076;6241;149;480;1543;4652;1692;5132
261600;201703;5217;14028;4485;12984;282;901;3409;9867;3691;10768
261610;201703;2432;6760;2117;6312;73;283;1743;5208;1816;5491
261618;201703;2441;6697;2213;6398;147;492;1727;4886;1874;5378
261620;201703;3917;12141;3677;11738;763;2353;2269;7493;3032;9846
261630;201703;7446;21527;6293;19374;662;2480;3747;11203;4409;13683
261640;201703;34649;84726;32485;82200;1940;4481;26476;69893;28416;74374
261650;201703;3788;11006;3511;10643;227;874;2627;8040;2854;8914
270010;201703;4293;15725;3950;15059;277;1396;2994;11267;3271;12663
270020;201703;3864;10674;3570;10260;301;1039;2865;8018;3166;9057
270030;201703;36495;107880;33729;103317;6803;21364;19413;60051;26216;81415
270040;201703;10565;31639;9723;30533;1326;4454;6763;21452;8089;25906
270050;201703;4409;11891;3990;11398;286;944;3340;9534;3626;10478
270060;201703;1904;5467;1754;5269;243;749;1218;3731;1461;4480
270070;201703;4367;13200;3986;12682;197;920;3351;10411;3548;11331
270080;201703;1270;3950;1098;3619;130;463;728;2346;858;2809
270090;201703;2123;6557;1916;6155;94;457;1517;4674;1611;5131
270100;201703;5643;16856;5287;16285;521;1919;3988;12068;4509;13987
270110;201703;2918;8175;2605;7823;291;940;1910;5936;2201;6876
270120;201703;3065;8463;2709;8016;83;344;2429;7142;2512;7486
270130;201703;5153;15290;4737;14831;534;1803;3668;11656;4202;13459
270135;201703;1799;4791;1608;4560;151;319;1349;3978;1500;4297
270140;201703;10508;24405;8872;22319;557;2181;7226;17185;7783;19366
270150;201703;2658;8473;2583;8386;46;157;2503;8141;2549;8298
270160;201703;4873;16102;4506;15642;162;803;3874;13305;4036;14108
270170;201703;3666;11644;3369;11233;457;1840;2211;7217;2668;9057
270180;201703;2274;7334;2097;7084;94;469;1750;5783;1844;6252
270190;201703;1709;5534;1618;5417;74;282;1366;4609;1440;4891
270200;201703;2523;8257;2348;8008;194;842;1748;5769;1942;6611
270210;201703;4713;13587;4414;13182;288;1043;3721;11015;4009;12058
270220;201703;1247;4056;1150;3882;227;861;651;2140;878;3001
270230;201703;10607;32666;9237;30506;1048;4272;5662;18098;6710;22370
270235;201703;6129;19684;5733;19062;317;1372;4705;15497;5022;16869
270240;201703;9408;28183;7971;26311;1753;6160;4305;14493;6058;20653
270250;201703;3129;8206;2831;7831;387;1052;2134;5979;2521;7031
270255;201703;4767;14409;3860;12744;265;1133;2729;8777;2994;9910
270260;201703;5801;18261;5596;17973;338;1493;4773;14921;5111;16414
270270;201703;1153;3219;1062;3096;185;556;650;1868;835;2424
270280;201703;3473;9635;3008;8982;373;973;2088;6373;2461;7346
270290;201703;7821;26656;7314;25779;496;2358;5834;20181;6330;22539
270300;201703;3684;11459;3311;11015;322;1226;2468;8178;2790;9404
270310;201703;7406;22034;6519;20742;252;1295;5368;16594;5620;17889
270320;201703;5773;17658;5410;17070;720;2506;3764;11728;4484;14234
270330;201703;4132;14030;3850;13653;370;1408;2994;10747;3364;12155
270340;201703;1624;4900;1436;4647;99;404;1144;3608;1243;4012
270350;201703;1885;4942;1686;4687;142;453;1240;3452;1382;3905
270360;201703;2066;6218;1970;6111;148;440;1690;5360;1838;5800
270370;201703;1443;4740;1316;4525;97;425;965;3293;1062;3718
270375;201703;2899;7794;2566;7366;69;233;2298;6594;2367;6827
270380;201703;5741;17393;5334;16849;413;1323;4186;13513;4599;14836
270390;201703;1250;3421;1081;3171;55;195;823;2359;878;2554
270400;201703;6335;18709;5658;17721;313;1285;4200;12783;4513;14068
270410;201703;4720;14690;4315;13951;371;1393;3086;9817;3457;11210
270420;201703;5915;18440;5640;18077;294;1317;4583;14355;4877;15672
270430;201703;134867;380763;117922;355960;34052;108739;41261;130046;75313;238785
270440;201703;4570;13595;4194;13090;167;718;3427;10633;3594;11351
270450;201703;6244;18863;5909;18416;310;1357;4885;14930;5195;16287
270460;201703;3371;8738;3061;8371;102;357;2686;7226;2788;7583
270470;201703;10149;31941;9337;30658;1052;3998;6345;20880;7397;24878
270480;201703;2808;8485;2466;7890;305;1149;1674;5175;1979;6324
270490;201703;976;3013;889;2896;50;201;692;2234;742;2435
270500;201703;4860;16071;4556;15696;257;1205;3798;12940;4055;14145
270510;201703;6022;17296;5389;16416;580;2309;4082;11980;4662;14289
270520;201703;3448;10887;3131;10338;1044;3712;1037;3629;2081;7341
270530;201703;1298;3998;1209;3863;108;353;859;2793;967;3146
270540;201703;2031;6608;1869;6381;101;515;1544;5113;1645;5628
270550;201703;6689;19667;6039;18859;709;2335;4402;14043;5111;16378
270560;201703;3122;9183;2885;8828;219;827;2189;6580;2408;7407
270570;201703;3704;11864;3369;11289;207;909;2658;8723;2865;9632
270580;201703;2059;6172;1941;6013;116;364;1641;5165;1757;5529
270590;201703;1387;4483;1338;4410;6;19;1315;4349;1321;4368
270600;201703;2851;9257;2594;8825;159;769;2124;7056;2283;7825
270610;201703;3277;9863;3032;9511;150;592;2573;7954;2723;8546
270620;201703;1372;4484;1278;4322;78;350;1037;3395;1115;3745
270630;201703;15879;46037;14452;43770;1703;5418;10184;31219;11887;36637
270640;201703;5699;17274;5110;16357;310;1307;4071;12773;4381;14080
270642;201703;2339;8091;2182;7869;201;989;1693;5937;1894;6926
270644;201703;2775;7989;2419;7496;247;801;1766;5594;2013;6395
270650;201703;3627;11202;3430;10931;436;2027;2486;7412;2922;9439
270660;201703;2133;5456;1673;4811;78;322;1220;3453;1298;3775
270670;201703;16596;41700;14378;39212;1572;4300;10751;30016;12323;34316
270680;201703;4332;12291;4118;12055;91;253;3869;11399;3960;11652
270690;201703;9210;24680;8173;23526;2163;5821;4790;14738;6953;20559
270700;201703;577;1830;515;1726;74;317;341;1086;415;1403
270710;201703;5952;18562;5613;18128;366;1526;4661;14806;5027;16332
270720;201703;3447;11254;3095;10633;128;738;2546;8511;2674;9249
270730;201703;6374;17946;5971;17509;422;1321;5077;15071;5499;16392
270740;201703;2317;6526;2167;6302;156;563;1787;5129;1943;5692
270750;201703;5242;15719;4818;15059;607;2127;3468;10791;4075;12918
270760;201703;3478;10172;3118;9600;132;523;2533;7701;2665;8224
270770;201703;18848;49200;15727;45440;3046;8678;9211;28180;12257;36858
270780;201703;1786;5634;1704;5506;183;672;1279;4101;1462;4773
270790;201703;1575;4921;1451;4739;309;1086;858;2787;1167;3873
270800;201703;11133;32423;10321;31338;559;2331;8754;26020;9313;28351
270810;201703;3187;9655;2549;8482;247;949;1685;5609;1932;6558
270820;201703;1754;5576;1554;5240;235;913;1001;3325;1236;4238
270830;201703;5533;14472;4962;13795;358;978;4036;11628;4394;12606
270840;201703;7822;24676;7209;23877;306;1622;6221;20060;6527;21682
270850;201703;7594;22624;7190;22097;720;2994;5412;15761;6132;18755
270860;201703;11065;30222;9301;28027;989;3563;6465;19085;7454;22648
270870;201703;2209;6545;1870;5864;201;670;1239;3856;1440;4526
270880;201703;8146;25604;7551;24726;427;1806;6148;19877;6575;21683
270890;201703;2416;7260;2246;6967;233;860;1645;4958;1878;5818
270895;201703;2910;10327;2803;10169;132;674;2425;8669;2557;9343
270900;201703;1802;4905;1505;4468;90;309;1145;3305;1235;3614
270910;201703;3575;11394;3273;10865;216;983;2485;8047;2701;9030
270915;201703;9356;30589;8391;28898;1183;4781;5164;17434;6347;22215
270920;201703;6210;19192;5911;18773;302;1472;5115;15777;5417;17249
270930;201703;16377;43578;13955;40670;2705;7663;8556;26031;11261;33694
270940;201703;5463;17767;5147;17433;432;2043;3813;12567;4245;14610
280010;201703;669;1900;579;1744;39;186;402;1099;441;1285
280020;201703;4804;13506;4200;12521;540;1762;2749;8103;3289;9865
280030;201703;72712;187393;61820;171432;17313;49893;23000;66683;40313;116576
280040;201703;3098;9225;2769;8735;267;964;1997;6192;2264;7156
280050;201703;3654;11511;3376;11030;896;3118;1631;5362;2527;8480
280060;201703;4985;15195;4271;13973;805;2855;2157;7230;2962;10085
280067;201703;6957;19427;6059;17995;867;2645;3723;11110;4590;13755
280070;201703;1907;6145;1832;6030;169;599;1456;4775;1625;5374
280100;201703;3747;11414;3377;10777;439;1559;2270;7247;2709;8806
280110;201703;1369;4052;1257;3882;53;203;1049;3186;1102;3389
280120;201703;7802;24043;7081;22840;1009;3121;4975;16548;5984;19669
280130;201703;7699;20554;7131;19736;850;2604;5125;14199;5975;16803
280140;201703;5780;15048;5308;14377;388;1084;4294;11675;4682;12759
280150;201703;3465;10103;3246;9761;210;803;2540;7494;2750;8297
280160;201703;1308;3822;1110;3484;166;560;687;2124;853;2684
280170;201703;4794;14000;4370;13367;370;1147;3376;10482;3746;11629
280190;201703;1196;3049;1024;2788;74;251;795;2084;869;2335
280200;201703;1190;3486;1072;3306;104;377;771;2321;875;2698
280210;201703;14213;40370;12673;38274;2191;7142;7257;22230;9448;29372
280220;201703;1657;4825;1530;4627;66;249;1279;3833;1345;4082
280230;201703;3210;9451;2923;8999;320;1069;2016;6232;2336;7301
280240;201703;3460;9685;3137;9186;144;528;2559;7378;2703;7906
280250;201703;836;2204;674;1944;105;327;351;995;456;1322
280260;201703;2116;5450;1979;5289;61;185;1825;4878;1886;5063
280270;201703;2107;6520;1930;6250;104;390;1586;5063;1690;5453
280280;201703;4110;13283;3717;12634;709;2059;2224;8178;2933;10237
280290;201703;17472;51555;15744;48896;1867;6598;10023;31208;11890;37806
280300;201703;9700;28625;9029;27820;653;2309;6908;22158;7561;24467
280310;201703;1381;3813;1181;3473;42;182;871;2485;913;2667
280320;201703;8588;26554;7883;25425;1250;4468;4544;14551;5794;19019
280330;201703;4431;12423;4025;11753;409;1420;3013;8479;3422;9899
280340;201703;3877;10403;3640;10080;282;836;2973;8379;3255;9215
280350;201703;22210;60636;19610;56846;2645;8201;12934;37674;15579;45875
280360;201703;5623;17368;5179;16607;902;3202;2970;9380;3872;12582
280370;201703;1826;5012;1566;4584;158;427;1096;3239;1254;3666
280380;201703;1043;3152;938;2979;110;422;641;1970;751;2392
280390;201703;3071;8898;2631;8070;217;766;1820;5558;2037;6324
280400;201703;4086;11367;3709;10817;921;2652;1901;5789;2822;8441
280410;201703;2118;6660;1818;6070;211;794;1072;3471;1283;4265
280420;201703;4184;11840;3825;11293;185;575;3272;9703;3457;10278
280430;201703;2227;5677;1992;5344;98;370;1531;4028;1629;4398
280440;201703;4613;13161;4200;12640;296;1004;3354;9971;3650;10975
280445;201703;2412;6535;2217;6200;62;231;1761;4809;1823;5040
280450;201703;9233;23809;8520;22887;521;1175;7188;19853;7709;21028
280460;201703;6808;17318;6222;16487;712;1930;4671;12499;5383;14429
280470;201703;1835;5412;1633;5061;101;329;1211;3750;1312;4079
280480;201703;32671;91142;30432;87926;4062;13448;20617;58352;24679;71800
280490;201703;3825;11344;3369;10600;214;852;2495;7701;2709;8553
280500;201703;918;2431;818;2303;40;134;667;1863;707;1997
280510;201703;2508;7336;2244;6966;149;585;1649;5083;1798;5668
280520;201703;1767;4677;1604;4473;108;305;1348;3776;1456;4081
280530;201703;2464;6494;2260;6236;130;413;1872;5174;2002;5587
280540;201703;9325;25342;8584;24289;235;1044;7500;20662;7735;21706
280550;201703;6872;17399;5690;15636;452;1262;4075;11172;4527;12434
280560;201703;7437;21675;7021;21085;309;1186;5981;17659;6290;18845
280570;201703;6311;16935;5427;15746;495;1669;3757;10795;4252;12464
280580;201703;5342;16396;4618;15091;687;2314;2856;9531;3543;11845
280590;201703;2653;7253;2328;6848;211;841;1550;4442;1761;5283
280600;201703;3454;10376;3202;10005;266;981;2442;7542;2708;8523
280610;201703;2418;6666;2202;6354;175;605;1640;4632;1815;5237
280620;201703;5360;15150;4706;14084;544;1548;3210;9997;3754;11545
280630;201703;3614;11581;3376;11225;292;982;2633;8958;2925;9940
280640;201703;2190;6575;2073;6447;68;204;1926;6032;1994;6236
280650;201703;1081;3314;980;3152;110;383;677;2166;787;2549
280660;201703;2684;7345;2544;7183;228;649;2116;6001;2344;6650
280670;201703;16820;42769;15329;40783;1708;4976;10961;28887;12669;33863
280680;201703;2849;7492;2464;6885;167;481;1867;5127;2034;5608
280690;201703;949;2640;851;2507;90;304;619;1802;709;2106
280700;201703;1012;3024;925;2861;62;211;670;2039;732;2250
280710;201703;12592;31428;11317;29947;593;1278;9783;26529;10376;27807
280720;201703;2373;6110;2161;5863;194;560;1501;4310;1695;4870
280730;201703;991;2750;914;2637;66;238;741;2093;807;2331
280740;201703;13270;35026;11407;32125;1244;3567;7496;21279;8740;24846
280750;201703;3436;10259;3157;9798;249;875;2281;7070;2530;7945
280760;201703;5696;16977;5214;16241;779;2625;3191;10163;3970;12788
290010;201703;2769;6297;2074;5224;55;227;1650;3958;1705;4185
290020;201703;4338;14139;4208;13971;338;1045;3532;11895;3870;12940
290030;201703;3239;9587;3035;9313;327;1051;2367;7282;2694;8333
290035;201703;4515;11336;3959;10580;204;648;3107;8458;3311;9106
290040;201703;4146;10775;3507;10065;202;821;2704;7724;2906;8545
290050;201703;2384;7741;2104;7245;144;617;1506;5129;1650;5746
290060;201703;1275;3223;1070;2970;133;450;768;2048;901;2498
290070;201703;33137;81484;28617;75741;4750;12920;15822;43456;20572;56376
290080;201703;5947;17480;5062;16257;654;2201;3400;11173;4054;13374
290090;201703;2104;4512;1734;4113;64;137;1559;3730;1623;3867
290100;201703;9030;25766;8069;24235;1069;3219;5185;16001;6254;19220
290110;201703;4866;14064;4618;13630;623;1999;3030;8836;3653;10835
290115;201703;4621;13717;4136;13076;194;589;3501;11313;3695;11902
290120;201703;6747;17331;5580;15958;251;932;4518;12724;4769;13656
290130;201703;4636;11942;3773;10870;156;620;3011;8444;3167;9064
290135;201703;4617;11201;3856;10026;275;825;2819;7062;3094;7887
290140;201703;4427;12963;3744;12077;201;757;3131;10144;3332;10901
290150;201703;2185;6460;2077;6306;223;721;1589;4728;1812;5449
290160;201703;3373;8390;3196;8168;250;579;2638;6744;2888;7323
290170;201703;2595;8350;2434;8139;147;653;2082;6848;2229;7501
290180;201703;2897;8290;2473;7633;136;533;1930;5912;2066;6445
290190;201703;3772;12319;3599;12065;220;984;2805;9286;3025;10270
290195;201703;2171;5814;1808;5243;67;314;1472;4179;1539;4493
290200;201703;3906;11835;3429;11118;201;728;2724;8779;2925;9507
290205;201703;3328;9272;2970;8703;173;657;2255;6445;2428;7102
290210;201703;14500;40905;13054;39040;1537;4058;9554;29986;11091;34044
290220;201703;2363;6818;2240;6634;200;685;1749;5112;1949;5797
290225;201703;2932;7037;2613;6680;86;232;2382;6084;2468;6316
290230;201703;2229;7052;2094;6892;105;457;1765;5782;1870;6239
290240;201703;3534;9617;3192;9108;198;637;2518;7078;2716;7715
290250;201703;3855;11800;3589;11450;113;311;3089;10334;3202;10645
290260;201703;5172;14266;4277;12932;293;1002;3275;9896;3568;10898
290265;201703;3448;10509;3010;9719;142;615;2308;7348;2450;7963
290270;201703;12007;42815;11483;41983;1053;4496;8679;31554;9732;36050
290280;201703;5532;17363;5100;16690;376;1353;3814;12492;4190;13845
290290;201703;9845;30072;8668;28112;972;3279;6044;19802;7016;23081
290300;201703;4560;12750;3325;10438;215;748;2295;7315;2510;8063
290310;201703;1465;4299;1261;3970;158;534;788;2479;946;3013
290320;201703;28199;78421;23892;73023;4918;16054;12664;39803;17582;55857
290323;201703;3727;10214;3365;9772;119;410;2835;8136;2954;8546
290327;201703;4483;13254;3842;12105;416;1332;2552;8075;2968;9407
290330;201703;1896;4480;1731;4307;89;224;1539;3888;1628;4112
290340;201703;5127;15273;4702;14763;1062;3458;2886;9188;3948;12646
290350;201703;4465;14149;3986;13385;314;1091;2938;10105;3252;11196
290360;201703;4664;13756;4036;12902;135;562;3364;10849;3499;11411
290370;201703;4721;12689;4014;11732;239;727;3215;9491;3454;10218
290380;201703;5504;15853;4833;14847;275;930;3823;11904;4098;12834
290390;201703;15028;44537;13374;42108;1680;5535;8719;28194;10399;33729
290395;201703;2605;8409;2325;7873;103;501;1780;5991;1883;6492
290400;201703;3692;10543;3071;9578;211;725;2211;6805;2422;7530
290405;201703;4778;14615;4042;13272;374;1321;2620;8706;2994;10027
290410;201703;5820;16965;4781;15294;310;1265;3447;10694;3757;11959
290420;201703;3219;9150;2664;8327;221;738;2023;6348;2244;7086
290430;201703;3147;9589;2760;8903;422;1406;1699;5582;2121;6988
290440;201703;2991;7734;2355;6829;128;411;1777;5212;1905;5623
290450;201703;3195;9171;2716;8461;163;653;2021;6161;2184;6814
290460;201703;12433;35622;11148;33416;3235;10023;4066;12198;7301;22221
290470;201703;4107;11550;3190;10101;650;2296;1472;4808;2122;7104
290475;201703;5731;17851;5077;16666;172;871;3971;12735;4143;13606
290480;201703;2357;6395;2218;6197;211;612;1546;4531;1757;5143
290485;201703;4698;14752;4100;13844;231;1151;3326;11022;3557;12173
290490;201703;8360;21366;7871;20749;530;1655;6540;16939;7070;18594
290500;201703;4002;12442;3275;10977;454;1663;1744;5797;2198;7460
290510;201703;3141;8899;2809;8448;118;461;2366;7070;2484;7531
290515;201703;3579;9856;2994;9097;129;374;2546;7884;2675;8258
290520;201703;11293;34433;9161;30207;567;2342;5765;18731;6332;21073
290530;201703;5092;14936;4485;13972;281;928;3603;11224;3884;12152
290540;201703;3665;10577;3429;10204;211;677;2780;8259;2991;8936
290550;201703;4518;11641;4041;11103;76;260;3729;10287;3805;10547
290560;201703;6364;17904;5587;16791;823;2683;3791;11333;4614;14016
290570;201703;42208;112908;38879;108528;3310;9658;28897;80529;32207;90187
290580;201703;6916;22996;6483;22307;585;2203;4930;17196;5515;19399
290590;201703;7159;22638;6238;21017;253;1097;5084;17125;5337;18222
290600;201703;17649;52020;16342;50184;1424;4504;12690;39775;14114;44279
290610;201703;2439;8110;2018;7288;114;533;1415;5002;1529;5535
290620;201703;6198;18574;5675;17724;308;1065;4689;14546;4997;15611
290630;201703;8258;20943;7162;19708;466;1337;6030;16696;6496;18033
290640;201703;2621;7436;2150;6693;109;432;1658;5071;1767;5503
290650;201703;10714;30790;10153;30018;2260;6611;6028;18406;8288;25017
290660;201703;3647;9842;3130;9087;123;383;2317;7008;2440;7391
290670;201703;6948;20766;6163;19470;584;1927;4377;13993;4961;15920
290680;201703;10089;29905;9049;28526;358;1652;7297;22589;7655;24241
290682;201703;4687;13008;4102;12175;189;712;3415;10014;3604;10726
290685;201703;3652;8596;2436;6896;242;721;1575;4559;1817;5280
290687;201703;7062;20353;5648;18009;1145;3718;2843;9473;3988;13191
290689;201703;3048;8750;2719;8266;229;785;1980;6202;2209;6987
290690;201703;5439;15172;4769;14288;674;2010;3116;9436;3790;11446
290700;201703;2427;7211;2273;6988;120;398;1856;5748;1976;6146
290710;201703;7631;23825;7086;23025;485;1593;5757;18878;6242;20471
290720;201703;18405;53232;17082;51597;1113;3359;14137;43538;15250;46897
290730;201703;7091;19096;6363;18137;466;1372;4790;13678;5256;15050
290740;201703;903;2631;717;2308;47;178;528;1688;575;1866
290750;201703;10515;28679;9094;26090;1284;4031;5399;15093;6683;19124
290755;201703;2292;6505;1822;5651;118;448;1274;3888;1392;4336
290760;201703;4116;12376;3330;10867;438;1306;1939;6619;2377;7925
290770;201703;2516;8645;2354;8429;111;541;1901;6818;2012;7359
290780;201703;8956;22277;7745;20546;599;1250;5983;16376;6582;17626
290790;201703;4450;12916;4087;12435;217;646;3500;10709;3717;11355
290800;201703;7061;14764;5546;13131;336;635;4432;10905;4768;11540
290810;201703;5396;16069;4496;14598;199;773;3353;10929;3552;11702
290820;201703;5334;14844;4812;14130;370;1250;3615;10667;3985;11917
290830;201703;4468;11324;4126;10861;177;602;3226;8362;3403;8964
290840;201703;17174;48512;15173;45478;1831;5232;10051;31438;11882;36670
290850;201703;6038;16989;5755;16638;675;1735;4293;12923;4968;14658
290860;201703;5209;17021;4841;16587;346;1287;3896;13662;4242;14949
290870;201703;4714;13574;3790;12020;207;844;2681;8453;2888;9297
290880;201703;1420;3763;1133;3322;87;232;788;2365;875;2597
290890;201703;7206;17842;6177;16702;344;887;5386;14712;5730;15599
290900;201703;2326;6576;1807;5650;154;542;1116;3464;1270;4006
290910;201703;4902;12987;4037;11715;77;318;3414;9801;3491;10119
290920;201703;4992;13123;4602;12621;188;556;4006;10931;4194;11487
290930;201703;8190;23950;7019;22133;271;1240;5581;17252;5852;18492
290940;201703;3607;11047;3177;10418;132;443;2436;8167;2568;8610
290950;201703;1570;4261;1368;3951;116;356;950;2762;1066;3118
290960;201703;5646;15707;5101;15026;165;553;4308;12727;4473;13280
290970;201703;3722;11196;3213;10373;221;767;2261;7334;2482;8101
290980;201703;10326;28965;8821;26169;2349;7271;2819;8426;5168;15697
290990;201703;8892;26101;7659;24048;594;2206;5768;17765;6362;19971
291000;201703;3100;8902;2778;8521;216;639;2320;7193;2536;7832
291005;201703;14553;36838;12872;34726;1109;3050;9697;26520;10806;29570
291010;201703;3238;9867;2560;8458;209;717;1666;5543;1875;6260
291020;201703;1212;3221;994;2842;83;250;591;1607;674;1857
291030;201703;2326;6184;1680;4912;117;388;1037;2923;1154;3311
291040;201703;5562;16244;4882;15231;281;1157;3817;11845;4098;13002
291050;201703;7680;24360;7011;23181;1354;5056;4064;13104;5418;18160
291060;201703;5934;21467;5569;20867;812;3506;3647;13459;4459;16965
291070;201703;15969;45150;13948;42139;691;2573;10966;32840;11657;35413
291072;201703;23379;67815;18839;58724;4442;14903;6509;20615;10951;35518
291075;201703;4932;13821;4391;12998;292;775;3328;9933;3620;10708
291077;201703;1448;4089;1197;3658;67;228;858;2615;925;2843
291080;201703;76105;234730;68311;220199;24080;79033;12169;40408;36249;119441
291085;201703;5638;14728;4844;13652;288;922;3987;11237;4275;12159
291090;201703;1702;3789;1490;3546;75;127;1292;3117;1367;3244
291100;201703;2627;6552;2090;5936;119;462;1619;4490;1738;4952
291110;201703;5276;17787;4726;16953;520;2127;3411;11958;3931;14085
291120;201703;7274;19319;6656;18405;640;1801;4895;13613;5535;15414
291125;201703;1875;3724;1469;3289;58;163;1218;2712;1276;2875
291130;201703;2801;8697;2352;7873;101;486;1761;5740;1862;6226
291140;201703;4185;12278;3538;11045;462;1352;2203;7001;2665;8353
291150;201703;2056;5066;1882;4868;65;215;1578;4008;1643;4223
291160;201703;4927;15572;4381;14622;626;2362;2643;8641;3269;11003
291165;201703;2477;6895;1938;5899;48;209;1392;4139;1440;4348
291170;201703;20915;54872;18018;50525;1418;4389;11412;32065;12830;36454
291180;201703;5978;15630;4967;14046;343;1040;3629;10305;3972;11345
291185;201703;3507;9564;3114;8939;142;442;2539;7208;2681;7650
291190;201703;7240;19192;6317;17903;381;1378;5169;14412;5550;15790
291200;201703;2918;8569;2282;7359;109;386;1481;4802;1590;5188
291210;201703;6645;16036;5679;14889;223;799;4382;11360;4605;12159
291220;201703;4250;12868;3880;12279;469;1748;2632;8149;3101;9897
291230;201703;3934;9784;3536;9346;73;149;3331;8894;3404;9043
291240;201703;4471;11908;3915;10937;119;406;3252;8928;3371;9334
291250;201703;3392;10363;2736;9131;212;711;1830;6204;2042;6915
291260;201703;1075;3012;966;2872;50;230;818;2339;868;2569
291270;201703;4684;14456;4137;13456;955;3198;2285;7543;3240;10741
291280;201703;2199;6286;1773;5555;312;1076;947;2908;1259;3984
291290;201703;5580;15429;4782;14347;691;2138;3023;9299;3714;11437
291300;201703;4100;11680;3158;10044;160;592;2264;7124;2424;7716
291310;201703;5362;15011;4683;13797;245;818;3631;10631;3876;11449
291320;201703;6006;18393;4841;16114;1235;4090;2127;7355;3362;11445
291330;201703;1593;4691;1403;4361;93;331;996;3049;1089;3380
291340;201703;3857;10563;3232;9653;102;388;2653;7834;2755;8222
291345;201703;3277;10317;3054;10042;180;626;2513;8421;2693;9047
291350;201703;5613;16355;4934;15200;291;945;3796;11900;4087;12845
291360;201703;33058;87516;28291;81087;5887;17160;14868;43986;20755;61146
291370;201703;8101;22883;7623;22269;506;1677;5911;17234;6417;18911
291380;201703;3627;10755;3164;10031;163;641;2423;7697;2586;8338
291390;201703;10406;27196;9636;26293;779;2301;7644;20857;8423;23158
291400;201703;14228;38371;12381;35622;1959;5234;7939;24056;9898;29290
291410;201703;3038;8117;2364;6987;106;472;1750;4973;1856;5445
291420;201703;2008;5308;1708;4931;62;236;1436;4104;1498;4340
291430;201703;3232;9104;2835;8539;139;649;2294;6662;2433;7311
291440;201703;6359;19098;5570;17737;505;1692;4208;13484;4713;15176
291450;201703;8426;23694;7280;22193;280;792;5904;18751;6184;19543
291460;201703;13127;39020;11818;37041;1237;4336;8017;25261;9254;29597
291465;201703;7893;22241;6904;21089;364;1575;5669;17020;6033;18595
291470;201703;15457;40686;13639;38552;766;2239;10412;30257;11178;32496
291480;201703;35344;86467;28878;77883;3761;11186;16352;44485;20113;55671
291490;201703;4185;13161;3904;12771;517;1723;2712;9022;3229;10745
291500;201703;4181;11816;3542;10856;177;701;2837;8619;3014;9320
291510;201703;3715;10834;3349;10317;76;323;2855;8863;2931;9186
291520;201703;3751;10072;3215;9348;251;849;2262;6569;2513;7418
291530;201703;2112;5611;1673;4968;359;1020;892;2909;1251;3929
291535;201703;3560;10851;3289;10413;216;716;2523;8075;2739;8791
291540;201703;2022;4866;1721;4550;96;198;1519;4078;1615;4276
291550;201703;5119;13208;4442;12275;674;1773;2754;7790;3428;9563
291560;201703;18328;42999;13155;36883;803;2354;9130;26868;9933;29222
291570;201703;2180;5583;1950;5308;149;304;1611;4554;1760;4858
291580;201703;5348;15851;4718;14949;445;1726;3380;10661;3825;12387
291590;201703;1719;5336;1554;5072;142;525;1174;3859;1316;4384
291600;201703;5193;14065;3971;12101;832;2704;1912;5703;2744;8407
291610;201703;4709;14636;4552;14462;120;430;4204;13442;4324;13872
291620;201703;3021;6978;2222;6123;116;381;1728;4838;1844;5219
291630;201703;3124;7497;2544;6788;173;456;2000;5403;2173;5859
291640;201703;16098;43667;12769;38527;3191;10044;3580;11664;6771;21708
291650;201703;8293;23707;7617;22881;524;1386;6359;19418;6883;20804
291660;201703;2218;5649;1692;4831;150;529;1057;2844;1207;3373
291670;201703;1857;5083;1677;4838;99;281;1340;3926;1439;4207
291680;201703;3800;10900;3312;10075;491;1645;2109;6384;2600;8029
291685;201703;4849;12051;4003;10949;509;1284;2696;7685;3205;8969
291690;201703;3688;9797;2943;8559;181;511;2082;5998;2263;6509
291700;201703;9003;27482;8040;25772;762;2460;6008;19481;6770;21941
291710;201703;5121;13157;4100;11798;280;885;2928;8371;3208;9256
291720;201703;4622;14588;3874;13051;278;1119;2751;9041;3029;10160
291730;201703;6167;17725;5590;16970;391;1356;4451;13603;4842;14959
291733;201703;2737;7637;2269;6985;159;538;1527;4845;1686;5383
291735;201703;2943;7991;2519;7388;109;395;2070;6016;2179;6411
291740;201703;3782;10443;3175;9625;169;569;2541;7692;2710;8261
291750;201703;21079;54036;16854;47534;2997;8776;8962;25930;11959;34706
291760;201703;10511;33160;9199;30879;3469;12848;2272;7834;5741;20682
291770;201703;7437;21279;6242;19144;716;2446;4070;12176;4786;14622
291780;201703;4438;13102;4129;12592;171;599;3514;10680;3685;11279
291790;201703;2657;7899;2530;7719;90;365;2134;6430;2224;6795
291800;201703;29855;79611;26072;74506;3484;10209;16827;49308;20311;59517
291810;201703;10667;28014;9033;26023;339;1202;7443;21305;7782;22507
291820;201703;3726;10782;3326;10183;186;639;2529;7776;2715;8415
291830;201703;4062;10709;3759;10269;276;768;2998;8298;3274;9066
291835;201703;6196;19322;5099;17263;1048;3667;2762;9635;3810;13302
291840;201703;47364;131905;41448;125010;5555;16761;28304;88452;33859;105213
291845;201703;2548;7360;2361;7108;122;331;2053;6290;2175;6621
291850;201703;4402;12694;3638;11453;335;980;2622;8564;2957;9544
291855;201703;1879;4373;1619;4055;108;329;1277;3127;1385;3456
291860;201703;2190;6029;1662;5008;52;200;1094;3165;1146;3365
291870;201703;1376;3662;972;2923;71;272;607;1742;678;2014
291875;201703;2823;8664;2510;8163;143;570;1789;5717;1932;6287
291880;201703;4923;15641;4525;14844;462;1562;3218;10568;3680;12130
291890;201703;1300;3214;1037;2886;208;467;651;1917;859;2384
291900;201703;1248;3292;974;2831;47;186;736;2095;783;2281
291905;201703;2690;7171;2039;5988;71;243;1494;4268;1565;4511
291910;201703;2749;7278;2337;6795;113;418;1959;5666;2072;6084
291915;201703;6916;21044;5821;19080;310;1192;4454;14685;4764;15877
291920;201703;24506;72442;22658;69838;2852;10020;14989;45677;17841;55697
291930;201703;2525;7411;2236;6932;177;682;1603;4820;1780;5502
291940;201703;3313;9236;2452;7750;258;854;1463;4524;1721;5378
291950;201703;8585;27957;7677;26216;1158;4046;4453;15653;5611;19699
291955;201703;11224;31372;10366;30308;2306;6616;5837;18101;8143;24717
291960;201703;3068;8887;2509;8028;182;601;1873;6217;2055;6818
291970;201703;3885;11711;3580;11189;323;1225;2465;7655;2788;8880
291980;201703;11485;32542;9041;29069;727;2479;6316;20603;7043;23082
291990;201703;2090;6234;1940;6050;77;287;1711;5377;1788;5664
291992;201703;2872;8584;2799;8469;355;1050;2152;6551;2507;7601
291995;201703;2096;5890;1766;5417;84;326;1419;4279;1503;4605
292000;201703;2337;6481;2114;6179;186;601;1477;4409;1663;5010
292010;201703;6011;15034;5001;13633;424;1141;3756;10392;4180;11533
292020;201703;4024;13342;3788;12955;407;1573;2837;9610;3244;11183
292030;201703;1784;5775;1667;5590;176;664;967;3143;1143;3807
292040;201703;4315;11445;3699;10778;173;384;3134;9569;3307;9953
292045;201703;3403;10279;3027;9766;120;359;2707;8808;2827;9167
292050;201703;6361;19019;5365;17039;472;1665;3378;10653;3850;12318
292060;201703;12543;30899;11541;29671;661;1755;9721;24728;10382;26483
292070;201703;4953;14655;4549;14184;372;1166;3733;11728;4105;12894
292080;201703;3393;8793;2769;7991;161;574;2349;6755;2510;7329
292090;201703;3997;10011;3347;9243;215;735;2708;7503;2923;8238
292100;201703;10466;28145;9131;26257;1872;5627;4620;13725;6492;19352
292105;201703;2987;9054;2696;8574;104;478;2184;6900;2288;7378
292110;201703;6302;16756;4896;14498;1276;3779;2193;6689;3469;10468
292120;201703;7064;19655;5859;17450;945;2793;3454;10468;4399;13261
292130;201703;2818;7791;2438;7254;351;989;1582;4903;1933;5892
292140;201703;4717;12441;3932;11262;455;1210;2813;8231;3268;9441
292145;201703;2250;6929;1987;6480;232;731;1363;4586;1595;5317
292150;201703;12676;37808;11808;36456;414;1697;9924;30399;10338;32096
292160;201703;2298;6733;2105;6482;80;338;1881;5732;1961;6070
292170;201703;8563;24172;7159;21756;760;2495;4685;14247;5445;16742
292180;201703;3026;8536;2340;7375;472;1445;1158;3755;1630;5200
292190;201703;3133;8940;2655;8164;499;1647;1351;4223;1850;5870
292200;201703;6708;19932;5690;18196;1486;4930;2315;7657;3801;12587
292205;201703;3767;11222;3392;10667;140;650;2819;8671;2959;9321
292210;201703;6373;16363;5402;15092;200;710;4671;12959;4871;13669
292220;201703;1785;4870;1605;4596;238;659;1004;2879;1242;3538
292225;201703;3185;9809;2891;9362;139;625;2373;7562;2512;8187
292230;201703;6819;18810;6421;18195;249;1056;5199;14266;5448;15322
292240;201703;4837;14548;4269;13382;352;1141;2897;9051;3249;10192
292250;201703;5073;15169;4747;14638;804;2564;2772;8663;3576;11227
292260;201703;3204;9154;2956;8827;164;482;2504;7561;2668;8043
292265;201703;3190;9454;2741;8702;106;494;2120;6549;2226;7043
292270;201703;3947;9979;3299;9220;161;528;2774;7794;2935;8322
292273;201703;2463;5816;2086;5348;129;250;1650;4387;1779;4637
292275;201703;1660;4999;1494;4761;116;303;1198;4010;1314;4313
292280;201703;2232;6075;1952;5745;112;295;1560;4809;1672;5104
292285;201703;2400;6431;2002;5855;118;378;1567;4581;1685;4959
292290;201703;6132;19197;5481;18192;348;1446;4236;14029;4584;15475
292300;201703;8342;24446;7208;23014;1738;5796;3919;12899;5657;18695
292303;201703;2849;8515;2572;8113;80;315;2211;6915;2291;7230
292305;201703;2807;7539;2644;7303;54;233;2384;6495;2438;6728
292310;201703;6026;17400;5564;16740;224;777;4561;13652;4785;14429
292320;201703;6796;18460;5688;16569;355;1120;4359;12574;4714;13694
292330;201703;2234;5753;2051;5510;114;378;1702;4488;1816;4866
292335;201703;5078;13200;4573;12524;303;768;3747;10419;4050;11187
292340;201703;6509;17629;5546;16095;307;924;4183;12093;4490;13017
292350;201703;2273;6583;1949;6127;102;408;1591;5004;1693;5412
292360;201703;5256;13497;4840;12812;274;745;3788;10231;4062;10976
292370;201703;8455;23224;7395;21827;474;1329;6031;17958;6505;19287
292380;201703;7165;20918;6548;19917;575;1659;4928;15158;5503;16817
292390;201703;3663;7971;2977;7230;129;260;2623;6459;2752;6719
292400;201703;20508;63177;18908;60552;2737;8920;12315;39836;15052;48756
292405;201703;4397;10903;3595;9840;199;511;2886;7954;3085;8465
292410;201703;2028;5291;1836;5067;110;309;1528;4236;1638;4545
292420;201703;3726;11855;3504;11513;226;999;2841;9217;3067;10216
292430;201703;5433;15792;4088;13877;368;1399;2637;9029;3005;10428
292440;201703;8380;27544;7796;26700;171;773;7108;24506;7279;25279
292450;201703;3929;11714;3228;10487;265;939;2297;7527;2562;8466
292460;201703;4497;13463;3947;12520;369;1305;2794;8857;3163;10162
292465;201703;2354;6905;1973;6299;159;555;1324;4293;1483;4848
292467;201703;1777;5631;1709;5527;242;813;1194;3936;1436;4749
292470;201703;2888;7538;2371;6695;103;327;1862;5245;1965;5572
292480;201703;6350;16126;5321;14815;131;452;4716;13022;4847;13474
292490;201703;2368;6323;1946;5719;137;449;1468;4332;1605;4781
292500;201703;6358;18681;5484;17125;668;2171;3579;11315;4247;13486
292510;201703;12591;35848;10721;33007;752;2849;7834;24156;8586;27005
292520;201703;5780;15764;5048;14695;936;2771;2964;8817;3900;11588
292525;201703;5225;13626;4485;12774;175;568;3840;11000;4015;11568
292530;201703;26854;76080;23716;71671;5485;17056;11683;36511;17168;53567
292540;201703;3028;7772;2676;7358;302;805;2076;5809;2378;6614
292550;201703;6661;20010;5666;18718;522;1958;4281;14380;4803;16338
292560;201703;4050;11217;3579;10483;185;770;2803;8079;2988;8849
292570;201703;4223;11543;3787;11031;78;230;3496;10309;3574;10539
292575;201703;6337;20462;6112;20141;313;1065;5236;17383;5549;18448
292580;201703;6633;19351;6145;18660;256;944;5271;15936;5527;16880
292590;201703;7520;21065;7014;20351;291;1029;6036;17176;6327;18205
292593;201703;2912;7501;2497;6838;258;687;1838;4995;2096;5682
292595;201703;5746;15640;5095;14801;275;935;4098;11832;4373;12767
292600;201703;10789;30289;9606;28708;699;1866;7443;22745;8142;24611
292610;201703;4662;12631;3819;11236;242;692;2470;7517;2712;8209
292620;201703;6222;18301;5478;17455;111;356;5087;16414;5198;16770
292630;201703;8917;22617;7416;20254;529;1539;5221;14352;5750;15891
292640;201703;7631;24429;7062;23509;355;1472;5350;17865;5705;19337
292650;201703;4415;11933;4106;11522;266;807;3498;9763;3764;10570
292660;201703;10866;31913;9865;30459;803;2692;7575;23505;8378;26197
292665;201703;2229;7031;2083;6848;22;85;1885;6273;1907;6358
292670;201703;3559;9954;2799;8583;177;642;1839;5617;2016;6259
292680;201703;3733;10696;3299;9927;280;876;2404;7150;2684;8026
292690;201703;2714;7372;1981;6195;154;487;1322;4260;1476;4747
292700;201703;9510;27478;8278;25742;947;2881;5464;17763;6411;20644
292710;201703;2151;7065;2013;6883;71;278;1778;6109;1849;6387
292720;201703;9350;23239;8096;21858;281;920;6877;18776;7158;19696
292730;201703;3669;10677;3518;10461;177;576;2913;8649;3090;9225
292740;201703;330111;871389;308650;838677;54523;157113;183617;493131;238140;650244
292750;201703;6456;17379;5570;16117;247;839;4364;12671;4611;13510
292760;201703;3898;11950;3532;11291;331;1176;2533;8072;2864;9248
292770;201703;5902;17000;5151;15894;847;2765;3140;10008;3987;12773
292780;201703;1826;4159;1419;3645;79;259;1078;2706;1157;2965
292790;201703;3460;8079;3273;7877;39;69;3182;7705;3221;7774
292800;201703;9403;26756;8628;25496;506;1654;6865;20197;7371;21851
292805;201703;3009;8292;2631;7752;218;649;1989;5922;2207;6571
292810;201703;9447;27329;7633;24686;733;2518;5271;17345;6004;19863
292820;201703;7464;20826;5565;18061;330;1457;4250;13611;4580;15068
292830;201703;1959;5368;1791;5138;54;238;1621;4560;1675;4798
292840;201703;8109;23907;7701;23361;258;1076;6820;20309;7078;21385
292850;201703;3072;8103;2470;7186;241;799;1581;4501;1822;5300
292860;201703;15177;38180;13886;36533;798;2178;11166;29362;11964;31540
292870;201703;18437;50028;16189;46539;1502;5114;9957;27976;11459;33090
292880;201703;11909;33618;10707;31945;631;2513;7958;22941;8589;25454
292890;201703;5324;17403;4786;16457;535;1990;3316;11434;3851;13424
292895;201703;2818;6685;2122;5616;154;412;1528;4056;1682;4468
292900;201703;2714;8141;2575;7914;141;640;2007;5903;2148;6543
292905;201703;4134;11898;3308;10597;293;952;2205;7178;2498;8130
292910;201703;4914;14302;4454;13484;523;1665;2737;8308;3260;9973
292920;201703;9483;27159;9052;26580;425;1655;7687;22081;8112;23736
292925;201703;5057;15068;4630;14437;272;900;3683;11506;3955;12406
292930;201703;6489;20348;6031;19494;426;1864;4192;13221;4618;15085
292935;201703;1955;5758;1639;5402;69;303;1394;4697;1463;5000
292937;201703;3019;7788;2623;7303;111;339;2194;6120;2305;6459
292940;201703;3061;8416;2559;7713;176;572;1866;5732;2042;6304
292950;201703;8355;23754;7718;22713;417;1565;5879;16941;6296;18506
292960;201703;5223;13087;4486;12126;225;719;3448;9210;3673;9929
292970;201703;4194;12298;3696;11643;178;766;2978;9337;3156;10103
292975;201703;3604;9220;3342;8900;287;660;2818;7607;3105;8267
292980;201703;3113;8182;2511;7268;164;549;1896;5378;2060;5927
292990;201703;11613;32654;10018;30248;368;1360;8086;24347;8454;25707
293000;201703;2838;7136;2580;6825;38;134;1952;5493;1990;5627
293010;201703;17390;47598;14785;43439;1973;6146;9063;26555;11036;32701
293015;201703;7316;24616;6276;22550;685;2851;4173;14954;4858;17805
293020;201703;8787;29022;8405;28470;271;1256;7400;24907;7671;26163
293030;201703;5550;15661;4419;13868;208;701;3023;9875;3231;10576
293040;201703;3706;11834;3527;11543;161;592;3071;10026;3232;10618
293050;201703;20636;55725;18249;52671;2912;8731;10181;30728;13093;39459
293060;201703;3538;9474;2939;8488;233;775;2123;6065;2356;6840
293070;201703;24021;63451;19640;57342;4247;12518;9023;28059;13270;40577
293075;201703;3200;10827;2975;10461;164;792;2362;8303;2526;9095
293076;201703;3677;9894;3259;9335;134;386;2636;7696;2770;8082
293077;201703;5085;15328;4422;14418;733;2471;2715;9155;3448;11626
293080;201703;4629;14262;4174;13546;162;763;3440;10968;3602;11731
293090;201703;3146;9903;2611;9043;207;773;1855;6533;2062;7306
293100;201703;5808;16648;4805;14871;447;1418;3485;10887;3932;12305
293105;201703;3905;12695;3440;11810;401;1441;2308;8014;2709;9455
293110;201703;2013;5558;1749;5187;79;255;1387;4113;1466;4368
293120;201703;3762;11903;3588;11638;225;717;2988;9779;3213;10496
293130;201703;3685;10732;3353;10342;109;417;2945;9105;3054;9522
293135;201703;31024;77484;23616;66955;5090;16408;8921;25544;14011;41952
293140;201703;1983;5380;1872;5228;96;344;1530;4136;1626;4480
293150;201703;5385;17482;4604;15965;587;2139;2938;10334;3525;12473
293160;201703;3746;9470;3358;9011;391;724;2610;7516;3001;8240
293170;201703;3380;9659;3090;9224;208;728;2237;6678;2445;7406
293180;201703;5072;14129;4145;12594;175;755;3251;9615;3426;10370
293190;201703;13715;40292;12405;38313;500;2239;10371;31484;10871;33723
293200;201703;7374;19813;6450;18628;213;881;4955;14433;5168;15314
293210;201703;5120;14348;4488;13307;257;872;3396;9998;3653;10870
293220;201703;4963;14460;4152;12966;1061;3294;1525;5022;2586;8316
293230;201703;3619;10809;3203;10135;420;1493;2134;6735;2554;8228
293240;201703;4265;11772;3459;10398;126;390;2583;7821;2709;8211
293245;201703;4230;11648;3780;11024;177;583;3124;9071;3301;9654
293250;201703;5519;14829;4954;13963;454;1344;3598;10073;4052;11417
293260;201703;4465;12968;3741;11874;212;774;2644;8321;2856;9095
293270;201703;5638;14630;5023;13945;357;936;4223;11957;4580;12893
293280;201703;5242;14248;4436;13164;209;625;3418;10235;3627;10860
293290;201703;13868;45525;12862;43672;3206;11096;5644;20134;8850;31230
293300;201703;6619;15620;5615;14411;370;906;4219;10991;4589;11897
293305;201703;4755;11695;4004;10705;124;415;3330;8859;3454;9274
293310;201703;2348;6141;1905;5377;181;529;1285;3608;1466;4137
293315;201703;4219;10502;3568;9535;220;557;2840;7620;3060;8177
293317;201703;2383;6664;2145;6240;157;438;1541;4503;1698;4941
293320;201703;7449;24041;7198;23727;1178;3804;5101;17280;6279;21084
293325;201703;1711;4843;1427;4387;228;762;911;2772;1139;3534
293330;201703;47505;153669;43107;145710;9831;35173;19650;67223;29481;102396
293340;201703;2497;7197;2011;6354;246;825;1190;3779;1436;4604
293345;201703;3219;9439;2836;8944;251;622;2158;7206;2409;7828
293350;201703;6375;18818;6048;18436;145;306;5563;17446;5708;17752
293360;201703;13203;38572;11970;37053;669;2399;10436;32267;11105;34666
310010;201703;768;2121;646;1935;84;320;308;865;392;1185
310020;201703;2507;7832;2099;7080;551;2079;270;856;821;2935
310030;201703;2135;6590;1787;6004;337;1306;1031;3386;1368;4692
310040;201703;977;2583;803;2334;67;254;611;1711;678;1965
310050;201703;1771;5978;1652;5733;337;1341;750;2494;1087;3835
310060;201703;3312;9884;2876;9315;208;846;2286;7372;2494;8218
310070;201703;357;967;266;800;11;45;170;478;181;523
310080;201703;722;2113;591;1885;103;398;209;631;312;1029
310090;201703;4663;13493;3983;12339;483;1651;2643;8170;3126;9821
310100;201703;3515;10380;2946;9479;144;556;2270;7294;2414;7850
310110;201703;4830;13417;4106;12184;643;2176;2192;6276;2835;8452
310120;201703;638;1865;473;1561;120;483;173;460;293;943
310130;201703;367;1110;320;1024;66;260;173;499;239;759
310140;201703;167;554;141;514;44;193;44;127;88;320
310150;201703;4549;13727;3865;12381;947;3297;1224;3817;2171;7114
310160;201703;6558;20740;5447;18588;1766;6486;741;2536;2507;9022
310163;201703;1067;3386;900;3050;314;1151;221;703;535;1854
310170;201703;8915;24558;7885;23094;873;2755;5600;16481;6473;19236
310180;201703;1725;4810;1449;4400;196;696;883;2593;1079;3289
310190;201703;2922;9434;2593;8859;692;2640;531;1820;1223;4460
310200;201703;1638;5313;1384;4760;280;1078;506;1708;786;2786
310205;201703;1125;3185;854;2777;121;379;472;1593;593;1972
310210;201703;2773;7680;2374;7110;145;493;1755;5210;1900;5703
310220;201703;1023;3009;883;2783;130;481;564;1706;694;2187
310230;201703;2431;7337;2037;6457;246;976;1201;3589;1447;4565
310240;201703;886;3192;810;3042;107;476;487;1800;594;2276
310250;201703;821;2638;773;2549;142;580;455;1394;597;1974
310260;201703;2961;9296;2201;7759;521;2093;344;1042;865;3135
310270;201703;2615;7128;2103;6405;147;578;1635;4896;1782;5474
310280;201703;2294;5852;1828;5148;150;601;1165;3122;1315;3723
310285;201703;1979;6970;1831;6726;197;839;1270;4781;1467;5620
310290;201703;1106;3278;1027;3144;237;840;550;1538;787;2378
310300;201703;1626;5399;1542;5243;352;1380;759;2443;1111;3823
310310;201703;313;845;223;681;37;107;119;371;156;478
310320;201703;405;1234;326;1090;34;153;168;533;202;686
310330;201703;521;1291;336;946;43;134;133;334;176;468
310340;201703;8080;23675;6641;21192;1423;4543;3024;10140;4447;14683
310350;201703;13476;34980;9462;28374;2482;8190;2240;6632;4722;14822
310360;201703;439;1224;396;1163;21;84;308;878;329;962
310370;201703;1340;4464;1191;4168;256;909;573;2037;829;2946
310375;201703;1217;3301;812;2587;120;423;282;901;402;1324
310380;201703;361;915;215;664;54;172;63;182;117;354
310390;201703;444;1516;385;1395;99;372;83;261;182;633
310400;201703;9715;26470;7326;22539;1736;5882;2238;6773;3974;12655
310410;201703;682;2226;492;1903;116;497;102;379;218;876
310420;201703;4393;12335;3075;9631;641;2222;473;1271;1114;3493
310430;201703;1245;3951;895;3226;230;887;136;466;366;1353
310440;201703;514;1502;392;1254;71;262;163;521;234;783
310445;201703;1226;3906;1007;3496;70;293;704;2397;774;2690
310450;201703;4395;12116;3521;10808;317;1035;2486;7729;2803;8764
310460;201703;1556;4499;1255;4021;325;1155;342;1136;667;2291
310470;201703;4069;9031;3450;8295;229;618;2980;7148;3209;7766
310480;201703;1235;3543;925;2928;195;649;410;1238;605;1887
310490;201703;2913;9218;2496;8404;538;2121;1013;3265;1551;5386
310500;201703;1290;4242;1115;3899;268;1019;444;1527;712;2546
310510;201703;1874;5880;1475;5005;387;1435;259;880;646;2315
310520;201703;1406;3573;1057;3035;67;191;733;2093;800;2284
310530;201703;915;2688;479;1619;76;292;54;152;130;444
310540;201703;3069;9536;2675;8874;675;2397;1142;3675;1817;6072
310550;201703;1135;3135;910;2774;143;544;547;1569;690;2113
310560;201703;14126;42511;11961;38407;3049;10887;3748;11283;6797;22170
310570;201703;1163;3402;984;3096;131;536;660;1979;791;2515
310590;201703;4211;12134;3536;10917;518;1759;1847;5620;2365;7379
310600;201703;1428;4553;1216;4088;224;846;530;1676;754;2522
310610;201703;396;1322;348;1219;95;410;126;378;221;788
310620;201703;141460;424392;120651;384651;28985;103808;41971;122010;70956;225818
310630;201703;4266;12567;3813;11784;283;990;2890;8853;3173;9843
310640;201703;1220;3724;997;3335;278;1048;271;869;549;1917
310650;201703;2663;8158;2068;7115;279;1029;1153;3983;1432;5012
310660;201703;1324;3934;1167;3730;97;331;880;2802;977;3133
310665;201703;1304;3797;1150;3582;69;238;938;2990;1007;3228
310670;201703;39810;120093;35346;110965;8322;27912;14244;43538;22566;71450
310680;201703;663;1829;586;1719;68;225;414;1200;482;1425
310690;201703;1282;4073;1064;3708;189;823;474;1557;663;2380
310700;201703;537;1309;420;1161;65;215;258;688;323;903
310710;201703;6061;19326;4603;17020;1085;4687;480;1622;1565;6309
310720;201703;805;2331;729;2222;57;206;537;1634;594;1840
310730;201703;9080;27657;8081;25968;1224;4377;4702;14953;5926;19330
310740;201703;4972;15529;3812;13126;844;3088;834;2823;1678;5911
310750;201703;1466;3639;1079;3115;221;687;430;1151;651;1838
310760;201703;554;1656;453;1480;70;247;186;622;256;869
310770;201703;967;2951;721;2555;109;445;353;1198;462;1643
310780;201703;3879;10332;3198;9210;357;1081;2135;6098;2492;7179
310790;201703;1923;6139;1760;5847;377;1268;821;2857;1198;4125
310800;201703;2571;8148;1979;6973;567;2315;139;462;706;2777
310810;201703;1098;3069;964;2824;139;481;546;1509;685;1990
310820;201703;1261;3595;892;2877;210;759;222;693;432;1452
310825;201703;2883;9952;2349;9034;127;724;1780;6788;1907;7512
310830;201703;1336;4260;1094;3812;289;1086;365;1254;654;2340
310840;201703;2147;6277;1550;5177;304;1069;401;1262;705;2331
310850;201703;1531;4411;1322;4152;116;466;981;3034;1097;3500
310855;201703;2871;8811;2482;8229;346;1269;1672;5521;2018;6790
310860;201703;7120;21655;5957;19476;631;2258;3657;12062;4288;14320
310870;201703;1079;2815;826;2407;165;494;460;1355;625;1849
310880;201703;992;3074;825;2747;120;464;460;1523;580;1987
310890;201703;2497;7383;1918;6421;489;1858;403;1203;892;3061
310900;201703;4114;12771;3240;11011;705;2682;1199;3824;1904;6506
310910;201703;1894;5305;1225;4019;186;694;145;397;331;1091
310920;201703;1837;5284;1445;4652;284;1030;694;2209;978;3239
310925;201703;955;3018;843;2821;240;883;411;1320;651;2203
310930;201703;5994;16604;4789;14811;627;2083;2884;9197;3511;11280
310940;201703;5976;16388;5011;14945;591;2004;3200;9383;3791;11387
310945;201703;1182;3586;1074;3415;103;389;716;2236;819;2625
310950;201703;2090;6407;1512;5191;328;1335;532;1725;860;3060
310960;201703;386;1223;317;1089;74;276;138;486;212;762
310970;201703;1186;3831;899;3219;225;873;182;590;407;1463
310980;201703;386;931;242;687;30;106;139;370;169;476
310990;201703;1145;3616;933;3143;202;745;324;1032;526;1777
311000;201703;3446;11412;3143;10842;962;3657;1078;3516;2040;7173
311010;201703;713;2363;655;2216;215;769;271;930;486;1699
311020;201703;935;2716;736;2361;110;426;369;1126;479;1552
311030;201703;1659;4455;1155;3557;306;1082;352;987;658;2069
311040;201703;436;1438;361;1258;91;323;75;240;166;563
311050;201703;2286;6848;1961;6326;450;1614;825;2674;1275;4288
311060;201703;2524;7311;1850;5885;315;1173;628;1811;943;2984
311070;201703;1360;4525;1171;4168;240;993;501;1730;741;2723
311080;201703;808;2459;682;2219;151;557;251;754;402;1311
311090;201703;1806;6335;1527;5841;430;1859;519;1898;949;3757
311100;201703;1922;6420;1512;5540;488;1955;192;694;680;2649
311110;201703;3322;7935;2411;6653;413;1218;1156;3230;1569;4448
311115;201703;1208;3503;1023;3220;95;378;720;2225;815;2603
311120;201703;7327;20421;5614;17368;1150;3971;1701;4864;2851;8835
311130;201703;2003;6070;1655;5524;280;1164;704;2217;984;3381
311140;201703;1319;3416;995;2968;74;251;632;1914;706;2165
311150;201703;1580;5533;1443;5285;237;936;862;3176;1099;4112
311160;201703;3782;12497;3077;11220;1100;4399;712;2589;1812;6988
311170;201703;786;2329;627;2041;64;236;328;1098;392;1334
311180;201703;1028;2997;809;2589;240;832;223;696;463;1528
311190;201703;1072;3037;833;2597;164;594;226;664;390;1258
311200;201703;1786;5381;1402;4596;405;1448;233;707;638;2155
311205;201703;973;3189;840;2921;106;465;421;1450;527;1915
311210;201703;995;3089;904;2971;118;375;662;2242;780;2617
311220;201703;803;2505;666;2210;144;534;252;798;396;1332
311230;201703;8205;25871;6391;22089;1278;4751;2086;7506;3364;12257
311240;201703;958;2891;764;2589;188;707;300;994;488;1701
311250;201703;764;2433;674;2278;189;700;239;743;428;1443
311260;201703;2126;5705;1668;4957;381;1241;579;1679;960;2920
311265;201703;1194;3308;947;2894;133;452;562;1706;695;2158
311270;201703;3307;10378;2922;9848;282;1318;2073;6700;2355;8018
311280;201703;1134;3190;703;2252;143;535;160;497;303;1032
311290;201703;1994;6488;1869;6193;266;882;1193;4001;1459;4883
311300;201703;4338;13952;3867;13119;315;1477;2894;9596;3209;11073
311310;201703;601;1934;516;1768;116;399;142;441;258;840
311320;201703;3423;11284;3109;10594;552;2177;1219;3871;1771;6048
311330;201703;4289;12772;3735;11792;819;2801;1724;5459;2543;8260
311340;201703;11389;35442;9814;32451;2992;10548;2570;8653;5562;19201
311350;201703;2256;6207;1734;5226;245;873;807;2203;1052;3076
311360;201703;903;2679;784;2518;389;1284;115;411;504;1695
311370;201703;3742;11022;3128;9937;571;2206;1358;3930;1929;6136
311380;201703;420;1389;350;1241;103;390;109;392;212;782
311390;201703;1750;6172;1560;5896;681;2944;418;1426;1099;4370
311400;201703;1441;4424;1137;3822;201;789;467;1430;668;2219
311410;201703;1696;5783;1553;5600;390;1593;773;2782;1163;4375
311420;201703;1817;5859;1261;4529;230;897;116;325;346;1222
311430;201703;3524;10474;2482;8240;515;1875;388;1269;903;3144
311440;201703;2374;7571;1770;6428;575;2386;315;1154;890;3540
311450;201703;1862;6408;1544;5717;424;1718;290;997;714;2715
311455;201703;960;2575;747;2212;203;634;272;744;475;1378
311460;201703;596;1905;440;1604;84;365;110;382;194;747
311470;201703;461;1531;372;1342;105;426;59;186;164;612
311480;201703;810;2094;740;1988;137;376;475;1279;612;1655
311490;201703;208;759;186;696;56;233;61;200;117;433
311500;201703;427;1241;344;1098;63;239;168;531;231;770
311510;201703;2753;8306;2117;7173;629;2506;470;1580;1099;4086
311520;201703;583;1864;545;1786;167;604;230;713;397;1317
311530;201703;10400;26606;7575;22113;1903;6547;1877;5215;3780;11762
311535;201703;763;2195;502;1696;110;449;92;284;202;733
311540;201703;593;2021;551;1951;133;485;281;980;414;1465
311545;201703;2138;6304;1894;6011;156;613;1401;4360;1557;4973
311547;201703;1467;4053;1247;3713;72;237;886;2617;958;2854
311550;201703;2879;8838;2366;7840;359;1426;928;2957;1287;4383
311560;201703;262;684;221;630;29;93;132;350;161;443
311570;201703;1961;5008;1521;4418;65;192;1206;3631;1271;3823
311580;201703;2428;4755;1759;3993;302;614;1078;2637;1380;3251
311590;201703;481;1455;405;1339;92;362;186;604;278;966
311600;201703;1256;3692;1051;3419;184;604;665;2218;849;2822
311610;201703;2729;9476;2446;8947;728;2596;993;3825;1721;6421
311615;201703;3151;9614;2615;8768;242;970;1857;6164;2099;7134
311620;201703;417;1237;366;1154;48;181;243;760;291;941
311630;201703;1328;3842;1102;3445;118;410;760;2319;878;2729
311640;201703;760;2417;619;2185;120;461;280;1005;400;1466
311650;201703;2205;6121;1882;5627;207;703;1164;3456;1371;4159
311660;201703;2693;8492;2094;7269;414;1534;346;1064;760;2598
311670;201703;1583;4438;1298;3993;348;1193;421;1275;769;2468
311680;201703;2034;6346;1706;5756;332;1180;955;3241;1287;4421
311690;201703;519;1291;440;1189;26;69;344;952;370;1021
311700;201703;2296;5847;1793;5192;94;324;1393;3972;1487;4296
311710;201703;1592;4881;1169;4039;365;1399;322;1130;687;2529
311720;201703;390;1291;352;1225;51;203;162;543;213;746
311730;201703;5869;14415;3363;10199;1031;3586;530;1294;1561;4880
311740;201703;790;2411;757;2365;104;312;599;1903;703;2215
311750;201703;4048;12820;3459;11837;556;2179;1904;6338;2460;8517
311760;201703;657;2163;573;1965;128;491;136;372;264;863
311770;201703;2128;6687;1750;5971;417;1569;538;1744;955;3313
311780;201703;1239;4177;1003;3650;246;1029;230;750;476;1779
311783;201703;2022;6357;1692;5721;61;295;1285;4276;1346;4571
311787;201703;599;2006;454;1611;84;333;140;430;224;763
311790;201703;1534;4479;1171;3815;263;994;384;1215;647;2209
311800;201703;4906;16275;4290;14788;822;3141;502;1614;1324;4755
311810;201703;1024;3326;895;3079;77;334;542;1841;619;2175
311820;201703;592;1802;499;1584;102;380;287;827;389;1207
311830;201703;8020;25891;6342;21977;1836;6985;653;2154;2489;9139
311840;201703;2757;8288;2520;7925;528;1881;1469;4553;1997;6434
311850;201703;291;887;256;826;41;136;144;463;185;599
311860;201703;49313;142260;42097;129906;7174;24282;22876;69178;30050;93460
311870;201703;2100;6109;1537;4995;285;1061;477;1402;762;2463
311880;201703;6643;18575;5836;17511;616;1835;4217;12980;4833;14815
311890;201703;1392;4080;1145;3621;252;860;521;1612;773;2472
311900;201703;683;2054;584;1883;83;310;341;1095;424;1405
311910;201703;4002;11612;3346;10657;716;2430;1554;4954;2270;7384
311920;201703;1889;6038;1633;5577;187;750;1002;3388;1189;4138
311930;201703;3330;9190;2759;8280;1103;3498;735;2117;1838;5615
311940;201703;12602;37154;10144;32227;2030;7097;3290;9938;5320;17035
311950;201703;2187;6370;1755;5673;143;582;1247;3970;1390;4552
311960;201703;377;1149;340;1074;65;256;161;432;226;688
311970;201703;378;1252;274;1013;55;247;64;211;119;458
311980;201703;541;1537;354;1180;60;225;116;391;176;616
311990;201703;454;1242;351;1092;110;381;135;408;245;789
311995;201703;1153;3494;687;2371;44;176;51;123;95;299
312000;201703;600;1790;538;1694;58;204;354;1131;412;1335
312010;201703;870;2833;717;2471;105;404;309;1022;414;1426
312015;201703;1336;4252;1211;4026;135;527;804;2618;939;3145
312020;201703;1076;3433;957;3225;191;697;456;1519;647;2216
312030;201703;1839;5108;1642;4868;58;262;1463;4260;1521;4522
312040;201703;736;2608;610;2288;136;581;155;550;291;1131
312050;201703;1160;4085;1008;3729;284;1183;188;617;472;1800
312060;201703;720;2218;646;2089;133;473;352;1111;485;1584
312070;201703;989;2991;661;2285;130;507;255;858;385;1365
312080;201703;2668;7131;2097;6271;256;952;1225;3414;1481;4366
312083;201703;923;2534;779;2327;69;221;598;1781;667;2002
312087;201703;2104;6224;1906;5941;148;478;1479;4706;1627;5184
312090;201703;8688;26030;7161;23429;1855;6423;2763;8982;4618;15405
312100;201703;1445;4590;1139;4104;186;793;494;1711;680;2504
312110;201703;981;3412;854;3135;269;1099;167;550;436;1649
312120;201703;657;2098;550;1893;130;533;208;633;338;1166
312125;201703;1126;3565;1013;3371;227;716;596;2100;823;2816
312130;201703;848;2370;668;2018;83;287;264;752;347;1039
312140;201703;787;2489;674;2227;176;625;199;594;375;1219
312150;201703;437;1289;401;1218;21;91;257;723;278;814
312160;201703;7311;23928;6384;21955;1421;5410;2544;8400;3965;13810
312170;201703;873;2501;725;2258;57;215;474;1441;531;1656
312180;201703;1351;4092;1175;3751;194;719;531;1598;725;2317
312190;201703;586;1860;445;1568;147;579;69;240;216;819
312200;201703;4772;13469;3993;12231;702;2192;2337;7223;3039;9415
312210;201703;1068;2781;806;2396;148;523;463;1295;611;1818
312220;201703;1964;6497;1821;6335;106;249;1621;5883;1727;6132
312230;201703;11118;33709;8529;28713;2808;10439;1054;3363;3862;13802
312235;201703;1563;4598;1383;4342;153;561;999;3097;1152;3658
312240;201703;873;2914;697;2535;168;671;181;649;349;1320
312245;201703;2232;6418;2000;6124;81;306;1652;5056;1733;5362
312247;201703;772;2244;600;1959;152;525;254;863;406;1388
312250;201703;1119;3052;821;2533;146;545;325;936;471;1481
312260;201703;896;2791;746;2540;120;460;444;1461;564;1921
312270;201703;643;1906;527;1667;46;197;269;778;315;975
312280;201703;402;1323;358;1227;135;488;47;156;182;644
312290;201703;764;2516;696;2401;151;589;229;790;380;1379
312300;201703;848;2771;673;2358;173;664;53;131;226;795
312310;201703;774;2848;728;2745;179;763;322;1179;501;1942
312320;201703;1915;5393;1500;4645;444;1514;314;903;758;2417
312330;201703;1008;2912;830;2660;126;473;590;1851;716;2324
312340;201703;296;797;237;705;36;130;126;341;162;471
312350;201703;279;689;245;652;22;81;200;507;222;588
312352;201703;1578;4888;1418;4655;217;748;959;3258;1176;4006
312360;201703;2907;9204;2438;8218;560;2042;726;2425;1286;4467
312370;201703;1708;5191;1506;4838;400;1433;619;1884;1019;3317
312380;201703;1957;5161;1753;4889;61;180;1494;4257;1555;4437
312385;201703;1293;3707;1107;3417;85;344;796;2380;881;2724
312390;201703;2064;6503;1638;5678;400;1473;370;1217;770;2690
312400;201703;2978;9409;2468;8395;945;3323;553;1957;1498;5280
312410;201703;9855;31497;8781;29469;1814;6531;3984;13222;5798;19753
312420;201703;3819;11570;3590;11220;528;1722;2350;7447;2878;9169
312430;201703;8055;23072;6852;20980;854;2789;4344;13320;5198;16109
312440;201703;794;2485;663;2251;227;847;221;772;448;1619
312450;201703;1178;3807;919;3288;271;1031;314;1165;585;2196
312460;201703;339;1000;295;943;55;202;168;534;223;736
312470;201703;599;1616;394;1233;80;292;119;344;199;636
312480;201703;1130;2891;836;2563;150;559;480;1398;630;1957
312490;201703;1901;4935;1495;4322;236;748;836;2333;1072;3081
312500;201703;677;1986;587;1842;101;369;252;772;353;1141
312510;201703;3658;10548;2969;9151;406;1432;1533;4483;1939;5915
312520;201703;227;716;182;644;65;239;64;230;129;469
312530;201703;560;1616;490;1519;48;188;341;1045;389;1233
312540;201703;1357;4255;1037;3609;202;766;474;1651;676;2417
312550;201703;707;2076;609;1869;103;343;304;874;407;1217
312560;201703;2101;5406;1729;4931;96;353;1395;3928;1491;4281
312570;201703;2235;6494;1861;5893;528;1755;684;2189;1212;3944
312580;201703;513;1643;428;1453;60;238;169;567;229;805
312590;201703;1624;5233;1406;4780;225;956;662;2102;887;3058
312595;201703;1810;6036;1675;5726;318;1113;940;3244;1258;4357
312600;201703;783;2440;587;2075;113;507;275;915;388;1422
312610;201703;6463;17895;4705;14702;1109;3748;924;2762;2033;6510
312620;201703;2178;6210;1682;5501;102;383;1260;4229;1362;4612
312630;201703;300;954;254;866;58;231;92;310;150;541
312640;201703;529;1682;430;1473;85;304;127;409;212;713
312650;201703;2099;5953;1537;4850;159;574;889;2724;1048;3298
312660;201703;1377;3586;1110;3195;113;390;764;2151;877;2541
312670;201703;5332;15546;4506;14426;1119;4094;1895;5898;3014;9992
312675;201703;1272;3952;1080;3558;101;408;762;2476;863;2884
312680;201703;1417;4246;1224;3979;151;608;815;2592;966;3200
312690;201703;2139;5582;1741;5026;222;718;1165;3266;1387;3984
312695;201703;831;2831;787;2762;127;432;539;1950;666;2382
312700;201703;1771;5337;1415;4616;177;619;771;2481;948;3100
312705;201703;1268;3565;1040;3163;64;240;728;2154;792;2394
312707;201703;1459;4640;1149;4023;136;591;630;2102;766;2693
312710;201703;6412;15923;4166;12428;1258;4183;785;2387;2043;6570
312720;201703;762;2539;656;2311;107;435;296;985;403;1420
312730;201703;1842;4424;1317;3781;125;434;847;2408;972;2842
312733;201703;1553;4155;1194;3510;60;186;736;2123;796;2309
312735;201703;791;2130;693;1987;122;437;433;1139;555;1576
312737;201703;806;2014;584;1692;140;420;234;672;374;1092
312738;201703;485;1491;350;1221;87;362;116;367;203;729
312740;201703;303;766;191;634;71;251;41;119;112;370
312750;201703;1214;4208;1128;4071;203;873;593;2069;796;2942
312760;201703;1827;5770;1399;4889;320;1174;395;1373;715;2547
312770;201703;40918;109563;30156;91425;7534;24642;8413;24864;15947;49506
312780;201703;2650;8908;2360;8411;367;1484;1356;4860;1723;6344
312790;201703;321;816;194;612;29;110;73;203;102;313
312800;201703;4866;15541;3910;13575;1197;4500;843;2962;2040;7462
312810;201703;1994;6048;1390;4819;358;1361;288;913;646;2274
312820;201703;1910;5368;1628;4885;85;314;1125;3272;1210;3586
312825;201703;1295;3436;1134;3227;74;231;886;2526;960;2757
312830;201703;2542;7727;1782;6228;451;1720;326;1131;777;2851
312840;201703;1217;3822;979;3364;153;619;329;1022;482;1641
312850;201703;707;2134;567;1866;111;421;192;617;303;1038
312860;201703;1358;3693;946;2993;229;799;282;834;511;1633
312870;201703;5604;16964;3972;13550;688;2564;922;3006;1610;5570
312880;201703;1301;3740;1158;3532;92;305;751;2369;843;2674
312890;201703;1833;5423;1156;3918;206;749;406;1386;612;2135
312900;201703;1199;3464;1028;3219;95;321;719;2296;814;2617
312910;201703;1646;3223;969;2347;162;445;459;1037;621;1482
312920;201703;840;2653;698;2378;156;629;299;945;455;1574
312930;201703;2102;5931;1791;5457;400;1243;825;2512;1225;3755
312940;201703;863;2756;751;2559;166;608;270;925;436;1533
312950;201703;2874;8028;2203;7021;791;2733;459;1494;1250;4227
312960;201703;1895;5350;1651;5010;109;313;1296;4012;1405;4325
312965;201703;1787;5565;1526;5076;141;552;952;3133;1093;3685
312970;201703;929;3056;752;2753;199;813;220;786;419;1599
312980;201703;17600;57199;16357;54647;4170;15227;6789;21745;10959;36972
312990;201703;456;1327;312;1070;84;339;104;347;188;686
313000;201703;473;1547;390;1385;85;404;143;442;228;846
313005;201703;2601;8079;2317;7577;330;1089;1484;4884;1814;5973
313010;201703;3624;11426;3082;10474;788;2932;1424;4706;2212;7638
313020;201703;918;3045;674;2444;130;535;82;255;212;790
313030;201703;1431;3734;1050;3189;177;644;511;1521;688;2165
313040;201703;751;2456;664;2254;84;347;325;1041;409;1388
313050;201703;1771;5430;1298;4673;318;1294;331;1097;649;2391
313055;201703;1579;4879;1457;4704;58;222;1237;3995;1295;4217
313060;201703;769;2427;614;2075;181;631;82;268;263;899
313065;201703;1881;6015;1615;5588;211;844;1132;3927;1343;4771
313070;201703;963;2778;794;2487;149;529;358;1099;507;1628
313080;201703;433;1284;325;1061;79;313;102;275;181;588
313090;201703;5136;14654;4437;13539;1194;3977;2096;6360;3290;10337
313100;201703;1114;3318;1009;3156;78;248;801;2529;879;2777
313110;201703;1664;4692;1234;3850;171;619;544;1585;715;2204
313115;201703;2283;7477;2141;7185;441;1673;1017;3196;1458;4869
313120;201703;3444;8987;2954;8361;536;1700;1793;5078;2329;6778
313130;201703;25246;74715;21556;67460;4126;14369;9318;27658;13444;42027
313140;201703;500;1308;389;1134;24;82;285;811;309;893
313150;201703;1302;4072;1077;3656;420;1520;236;810;656;2330
313160;201703;918;2743;782;2478;146;535;402;1212;548;1747
313170;201703;10007;33055;7590;27313;1578;6034;2183;7625;3761;13659
313180;201703;2246;6067;1777;5406;356;1205;788;2295;1144;3500
313190;201703;3826;12521;3033;10634;652;2497;806;2661;1458;5158
313200;201703;1119;3545;985;3291;88;363;720;2347;808;2710
313210;201703;3968;12123;3345;11149;646;2357;1664;5357;2310;7714
313220;201703;1556;4552;1118;3683;251;929;271;768;522;1697
313230;201703;2225;7686;2084;7499;251;1005;1503;5364;1754;6369
313240;201703;8173;24221;6287;20742;1182;4406;2541;8024;3723;12430
313250;201703;6319;19902;5400;18251;539;2062;3029;10206;3568;12268
313260;201703;633;1861;441;1440;82;315;116;369;198;684
313270;201703;5269;15622;4389;14068;750;2601;2376;7563;3126;10164
313280;201703;360;1172;262;966;57;224;66;235;123;459
313290;201703;761;2704;640;2496;236;1035;94;340;330;1375
313300;201703;1728;5600;1426;4927;417;1577;181;543;598;2120
313310;201703;939;3190;838;2980;187;768;160;484;347;1252
313320;201703;2283;6422;1667;5448;340;1223;683;2222;1023;3445
313330;201703;3980;11956;3318;10823;321;1371;2082;6544;2403;7915
313340;201703;1646;4055;1280;3512;211;593;737;2039;948;2632
313350;201703;2442;7570;1952;6488;425;1556;475;1473;900;3029
313360;201703;1287;3616;964;3085;195;771;507;1507;702;2278
313370;201703;1165;3860;1093;3676;159;618;580;1855;739;2473
313375;201703;2095;5566;1505;4681;269;1015;495;1462;764;2477
313380;201703;4642;14104;3944;12719;1023;3623;1359;4092;2382;7715
313390;201703;881;2974;824;2877;89;387;558;1908;647;2295
313400;201703;3625;9735;3139;9162;297;858;2561;7589;2858;8447
313410;201703;1170;3282;986;2995;184;630;623;1840;807;2470
313420;201703;16564;39745;10307;29356;2150;6892;1572;4511;3722;11403
313430;201703;956;2994;726;2513;135;552;258;814;393;1366
313440;201703;6182;13906;4238;11581;236;666;2726;7592;2962;8258
313450;201703;580;1722;455;1462;90;307;145;442;235;749
313460;201703;2042;6817;1776;6364;485;1987;676;2229;1161;4216
313470;201703;3048;8233;2684;7696;360;1047;1815;5195;2175;6242
313480;201703;806;2365;635;2054;96;357;229;687;325;1044
313490;201703;1505;4192;845;3149;276;1172;62;213;338;1385
313500;201703;412;1360;329;1140;58;221;104;345;162;566
313505;201703;8929;25698;8290;24980;206;454;7766;23768;7972;24222
313507;201703;1341;3648;1150;3370;100;339;785;2314;885;2653
313510;201703;14379;41583;12627;38626;1633;5460;6909;20843;8542;26303
313520;201703;13908;42401;11636;38383;1254;4753;7465;24425;8719;29178
313530;201703;557;1661;463;1494;47;179;163;483;210;662
313535;201703;2527;7287;2265;6822;187;603;1599;4777;1786;5380
313540;201703;953;2973;707;2329;192;681;187;586;379;1267
313545;201703;1230;4448;1101;4201;170;740;644;2348;814;3088
313550;201703;1785;5614;1569;5207;333;1167;806;2629;1139;3796
313560;201703;2182;4933;1770;4478;147;350;1381;3565;1528;3915
313570;201703;859;2939;743;2717;200;812;290;1032;490;1844
313580;201703;5587;15905;4401;14138;756;2668;2297;7539;3053;10207
313590;201703;923;2664;730;2389;311;1110;146;460;457;1570
313600;201703;3709;11042;3251;10300;300;1094;2384;7540;2684;8634
313610;201703;953;2738;816;2480;169;527;475;1445;644;1972
313620;201703;5192;15630;4509;14409;1134;3846;1747;5569;2881;9415
313630;201703;7843;21474;5896;18767;835;2982;3125;10469;3960;13451
313640;201703;758;2194;558;1882;172;620;168;576;340;1196
313650;201703;1774;5846;1587;5524;202;850;1028;3508;1230;4358
313652;201703;894;3076;822;2945;124;535;492;1676;616;2211
313655;201703;899;2829;759;2610;108;433;431;1474;539;1907
313657;201703;1340;3864;1089;3493;95;417;790;2368;885;2785
313660;201703;786;2533;673;2302;130;536;327;1052;457;1588
313665;201703;3820;12043;3269;10898;604;2234;1649;5335;2253;7569
313670;201703;43850;125973;32187;103468;7155;25271;10256;32051;17411;57322
313680;201703;1044;3039;921;2838;114;448;572;1708;686;2156
313690;201703;880;3082;742;2784;154;606;272;1034;426;1640
313695;201703;1333;4291;1156;3945;107;460;809;2752;916;3212
313700;201703;3432;11606;2987;11049;374;1438;2241;8466;2615;9904
313710;201703;1294;3470;991;2988;142;464;556;1683;698;2147
313720;201703;5409;16658;4212;14155;796;2993;1465;4536;2261;7529
313730;201703;1293;3328;981;2915;97;332;587;1736;684;2068
313740;201703;1817;6584;1549;5896;450;1888;103;359;553;2247
313750;201703;2047;6116;1679;5370;459;1608;479;1396;938;3004
313753;201703;1819;5105;1427;4422;226;799;708;2158;934;2957
313760;201703;4176;13140;3422;11643;936;3487;1048;3360;1984;6847
313770;201703;3293;10229;2818;9563;535;1941;1590;5420;2125;7361
313780;201703;4008;10959;3072;9481;453;1614;1004;3094;1457;4708
313790;201703;446;1507;422;1466;62;220;269;944;331;1164
313800;201703;1165;3083;1007;2839;84;276;728;2095;812;2371
313810;201703;1557;4378;1356;4092;132;428;963;2949;1095;3377
313820;201703;12197;32407;9754;28396;1678;5653;4060;11081;5738;16734
313830;201703;369;1191;326;1116;79;302;140;478;219;780
313835;201703;866;2843;794;2725;115;487;445;1441;560;1928
313840;201703;7187;20428;5643;17834;1393;4858;1274;4015;2667;8873
313850;201703;1072;2891;941;2658;161;562;506;1304;667;1866
313860;201703;2747;8159;2080;6744;415;1437;631;1933;1046;3370
313862;201703;1254;3187;897;2599;101;287;497;1509;598;1796
313865;201703;2269;6787;2033;6429;127;476;1548;4846;1675;5322
313867;201703;1106;3759;968;3470;308;1130;328;1202;636;2332
313868;201703;1692;5636;1447;5138;110;501;1037;3614;1147;4115
313870;201703;754;2346;668;2191;168;631;210;609;378;1240
313880;201703;1266;3888;1063;3527;246;906;369;1069;615;1975
313890;201703;1845;4882;1510;4441;243;730;859;2719;1102;3449
313900;201703;3801;13412;3384;12487;1043;4216;859;3181;1902;7397
313910;201703;679;2250;559;2010;186;716;83;305;269;1021
313920;201703;3198;10589;2772;9814;553;2031;1489;5471;2042;7502
313925;201703;1776;4804;1390;4070;195;552;817;2418;1012;2970
313930;201703;6360;22559;5376;20837;677;2491;3400;14155;4077;16646
313940;201703;8508;27312;6761;24419;1809;7306;1911;7416;3720;14722
313950;201703;3989;10990;3020;9433;892;3245;1060;3100;1952;6345
313960;201703;5367;13739;3797;11402;956;3195;1119;3220;2075;6415
313970;201703;1370;4053;1241;3886;124;444;734;2405;858;2849
313980;201703;1216;3750;936;3255;204;804;365;1229;569;2033
313990;201703;1627;6110;1428;5599;480;2015;341;1288;821;3303
314000;201703;8257;25407;7390;23670;986;3806;4464;13759;5450;17565
314010;201703;1193;3210;986;2931;73;271;697;2027;770;2298
314015;201703;1583;5015;1303;4535;252;1031;631;2110;883;3141
314020;201703;501;1493;330;1107;59;228;72;236;131;464
314030;201703;793;2554;632;2175;101;371;263;893;364;1264
314040;201703;734;2119;616;1894;149;487;234;711;383;1198
314050;201703;1575;4805;1253;4164;244;949;527;1626;771;2575
314053;201703;1567;4889;1375;4621;192;653;912;3244;1104;3897
314055;201703;2163;6363;1892;5961;74;304;1544;4883;1618;5187
314060;201703;1166;3526;929;3112;60;269;620;2029;680;2298
314070;201703;4121;12708;3321;11168;861;3078;926;2984;1787;6062
314080;201703;1747;5443;1267;4349;205;778;285;843;490;1621
314085;201703;1955;6459;1708;6098;471;1823;653;2341;1124;4164
314090;201703;3199;10806;2804;10044;478;1945;1333;4928;1811;6873
314100;201703;3275;8127;2883;7599;135;279;2445;6713;2580;6992
314110;201703;3822;12038;3379;11120;657;2402;1462;4463;2119;6865
314120;201703;1019;2417;484;1532;93;327;117;368;210;695
314130;201703;684;1955;355;1218;63;244;64;204;127;448
314140;201703;4802;14680;3903;12876;708;2520;1785;5873;2493;8393
314150;201703;1506;4147;1204;3633;161;535;674;2003;835;2538
314160;201703;2529;6564;1924;5637;242;796;1004;3041;1246;3837
314170;201703;1037;3047;856;2679;94;320;496;1481;590;1801
314180;201703;4952;15407;4373;14490;1212;4242;1855;6282;3067;10524
314190;201703;672;1862;500;1578;108;408;188;534;296;942
314200;201703;2842;8674;2507;8081;247;992;1751;5458;1998;6450
314210;201703;1993;5648;1780;5290;171;614;1124;3265;1295;3879
314220;201703;1440;4430;1071;3706;339;1289;222;690;561;1979
314225;201703;1320;3772;1186;3594;78;285;875;2668;953;2953
314230;201703;656;2077;610;1998;98;376;350;1135;448;1511
314240;201703;1086;3276;898;2971;175;623;443;1526;618;2149
314250;201703;529;1571;407;1310;87;303;120;342;207;645
314260;201703;975;3454;862;3180;187;796;260;891;447;1687
314270;201703;2746;8815;2267;7956;213;877;1525;5353;1738;6230
314280;201703;3006;8084;2058;6320;442;1578;743;2074;1185;3652
314290;201703;4654;12745;3988;11668;692;2077;2309;6742;3001;8819
314300;201703;1474;4819;1231;4250;350;1260;339;1145;689;2405
314310;201703;5572;15799;4564;14100;1120;3708;1688;5039;2808;8747
314315;201703;771;3003;704;2868;83;402;486;1962;569;2364
314320;201703;2943;8280;2095;7006;479;1706;987;3426;1466;5132
314330;201703;52749;156615;44136;142393;13071;45350;11917;38121;24988;83471
314340;201703;2783;7471;1588;5198;314;1168;130;320;444;1488
314345;201703;1213;4053;1098;3856;197;757;709;2443;906;3200
314350;201703;1144;3282;863;2800;243;841;143;423;386;1264
314360;201703;670;2144;440;1598;90;380;106;387;196;767
314370;201703;529;1704;488;1644;89;355;339;1099;428;1454
314380;201703;1249;3761;882;2994;241;873;127;450;368;1323
314390;201703;12377;35202;9104;29189;2223;7706;2071;6180;4294;13886
314400;201703;4376;12759;3653;11713;1134;3823;1254;4169;2388;7992
314410;201703;2607;7869;2018;6743;449;1675;647;2270;1096;3945
314420;201703;740;2042;575;1792;28;151;417;1246;445;1397
314430;201703;5980;17725;5125;16112;1290;4387;1730;5482;3020;9869
314435;201703;1362;4260;1204;4001;91;408;833;2737;924;3145
314437;201703;985;2630;814;2368;27;90;600;1761;627;1851
314440;201703;539;1632;445;1487;150;571;122;349;272;920
314450;201703;1489;4366;1266;4011;208;831;664;1922;872;2753
314460;201703;3691;12265;2959;10652;725;2849;530;1828;1255;4677
314465;201703;2237;6901;2065;6593;81;407;1643;5097;1724;5504
314467;201703;974;2739;835;2510;42;130;619;1884;661;2014
314470;201703;2084;6496;1805;5937;414;1542;682;2101;1096;3643
314480;201703;5627;18495;4114;14652;728;2855;583;1857;1311;4712
314490;201703;810;2426;628;2046;113;424;335;1025;448;1449
314500;201703;1796;5052;1327;4209;267;941;435;1334;702;2275
314505;201703;1848;5138;1669;4909;157;514;1162;3464;1319;3978
314510;201703;1898;5045;1266;4173;339;1224;354;1197;693;2421
314520;201703;2694;9460;2014;7837;418;1878;197;717;615;2595
314530;201703;5717;19761;5384;19152;885;3113;3377;12363;4262;15476
314535;201703;2721;7453;2267;6816;217;738;1608;4823;1825;5561
314537;201703;1103;3385;903;3025;111;446;562;1838;673;2284
314540;201703;354;1055;281;907;55;198;103;310;158;508
314545;201703;1413;4223;1263;4010;67;234;1017;3329;1084;3563
314550;201703;629;1682;464;1440;71;288;194;541;265;829
314560;201703;4169;14093;3502;12559;660;2678;1108;3727;1768;6405
314570;201703;306;895;237;759;36;141;120;364;156;505
314580;201703;502;1661;393;1422;97;389;39;139;136;528
314585;201703;848;2699;611;2176;147;619;183;603;330;1222
314587;201703;1957;5838;1653;5332;324;1017;847;2810;1171;3827
314590;201703;2876;9641;2188;7918;463;1875;475;1657;938;3532
314600;201703;1558;5011;1106;4040;252;1036;146;434;398;1470
314610;201703;6735;22502;6013;20831;1335;5267;2553;8300;3888;13567
314620;201703;1579;4617;1402;4371;103;363;1083;3330;1186;3693
314625;201703;1530;4923;1383;4676;180;841;949;3014;1129;3855
314630;201703;4715;13836;4100;12849;271;1118;3030;9383;3301;10501
314640;201703;569;1526;435;1296;111;364;137;359;248;723
314650;201703;1034;2822;743;2347;88;336;293;823;381;1159
314655;201703;1537;4544;1171;3848;267;898;469;1553;736;2451
314660;201703;300;798;208;616;20;55;103;298;123;353
314670;201703;1623;4274;1148;3439;139;451;661;1925;800;2376
314675;201703;1806;5274;1566;4857;127;483;1146;3503;1273;3986
314690;201703;2077;6707;1720;6038;538;2081;331;1118;869;3199
314700;201703;9072;29624;6414;23737;1748;7161;949;3507;2697;10668
314710;201703;8092;24043;5748;19084;1076;4045;862;2626;1938;6671
314720;201703;2297;7487;1837;6469;424;1646;475;1688;899;3334
314730;201703;2054;6145;1662;5495;435;1590;573;1765;1008;3355
314740;201703;2748;8561;2338;7763;329;1333;1215;3845;1544;5178
314750;201703;319;993;254;849;35;140;120;378;155;518
314760;201703;1681;5435;1262;4466;187;786;280;831;467;1617
314770;201703;1042;3216;623;2112;64;247;123;339;187;586
314780;201703;304;787;222;668;46;173;105;290;151;463
314790;201703;9500;28864;7437;25013;2972;11046;513;1460;3485;12506
314795;201703;1579;4543;1375;4216;90;364;1022;3004;1112;3368
314800;201703;11252;31764;7485;24160;1872;6589;738;2233;2610;8822
314810;201703;10230;29386;7875;25321;2369;8203;1662;5448;4031;13651
314820;201703;863;2427;643;2040;157;547;249;776;406;1323
314830;201703;1528;5012;1354;4705;328;1297;662;2297;990;3594
314840;201703;890;3132;735;2903;134;665;438;1644;572;2309
314850;201703;1922;5372;1524;4676;161;639;1075;3181;1236;3820
314860;201703;3240;10523;2840;9758;430;1752;1686;5648;2116;7400
314870;201703;5405;16480;4639;15418;427;1800;3394;11108;3821;12908
314875;201703;1734;5546;1640;5418;115;369;1391;4648;1506;5017
314880;201703;902;2325;736;2108;51;115;528;1610;579;1725
314890;201703;537;1657;400;1334;76;287;156;475;232;762
314900;201703;567;1643;468;1496;89;306;193;604;282;910
314910;201703;1590;5088;1287;4587;363;1458;471;1609;834;3067
314915;201703;2431;7645;2116;7088;167;719;1484;4849;1651;5568
314920;201703;520;1429;372;1208;27;102;198;615;225;717
314930;201703;4507;14961;3947;13763;1042;3928;1134;3731;2176;7659
314940;201703;396;1137;360;1077;48;157;222;626;270;783
314950;201703;342;986;245;840;45;169;83;279;128;448
314960;201703;747;2249;589;1917;118;431;229;689;347;1120
314970;201703;560;1902;473;1730;108;446;141;512;249;958
314980;201703;1360;4141;1124;3758;352;1301;76;232;428;1533
314990;201703;2431;7549;1859;6296;494;1935;363;1062;857;2997
314995;201703;1599;4838;1388;4511;141;586;909;2884;1050;3470
315000;201703;1071;3024;862;2682;85;319;553;1700;638;2019
315010;201703;415;1265;328;1088;70;291;117;338;187;629
315015;201703;2088;6301;1896;6077;230;768;1354;4550;1584;5318
315020;201703;805;2467;593;2015;85;305;243;791;328;1096
315030;201703;590;1784;459;1539;131;474;102;311;233;785
315040;201703;892;2674;830;2559;149;494;504;1523;653;2017
315050;201703;1266;3623;1003;3219;142;524;513;1631;655;2155
315053;201703;1056;3137;915;2854;146;575;459;1429;605;2004
315057;201703;1623;5522;1466;5226;264;962;804;2895;1068;3857
315060;201703;692;2219;482;1763;104;417;68;241;172;658
315070;201703;732;2142;586;1886;167;571;226;674;393;1245
315080;201703;2794;9087;2412;8269;602;2226;1079;3652;1681;5878
315090;201703;766;2626;618;2289;152;621;158;547;310;1168
315100;201703;1166;3885;829;3070;201;838;221;764;422;1602
315110;201703;1255;3734;1045;3346;220;778;423;1349;643;2127
315120;201703;13636;31927;9458;26515;1305;3776;4596;13808;5901;17584
315130;201703;1259;4122;1138;3884;292;1152;380;1216;672;2368
315140;201703;2766;8581;2275;7585;466;1764;911;2822;1377;4586
315150;201703;4362;11637;3272;9860;533;1776;1353;4059;1886;5835
315160;201703;1265;3674;1003;3180;223;751;400;1233;623;1984
315170;201703;1463;4603;1139;3933;262;962;220;788;482;1750
315180;201703;16966;47058;9574;31522;1681;6258;1622;4944;3303;11202
315190;201703;1943;5032;1625;4543;329;966;1027;2845;1356;3811
315200;201703;3588;11974;3008;10733;972;3786;579;2039;1551;5825
315210;201703;7790;22551;6184;19191;1053;3617;2347;6897;3400;10514
315213;201703;1117;3331;1012;3171;45;159;818;2544;863;2703
315217;201703;2413;8125;1970;7299;206;968;1248;4513;1454;5481
315220;201703;9523;27185;7995;24564;2493;7891;2501;7934;4994;15825
315230;201703;2842;7513;2524;7141;126;194;2229;6663;2355;6857
315240;201703;2975;8988;2519;8280;681;2388;1176;3815;1857;6203
315250;201703;10192;30506;7989;26335;1803;6547;2641;8657;4444;15204
315260;201703;938;2903;622;2192;140;525;77;243;217;768
315270;201703;654;2093;498;1784;99;421;121;396;220;817
315280;201703;2879;8082;1792;5757;384;1316;263;800;647;2116
315290;201703;1219;3344;825;2689;267;949;185;624;452;1573
315300;201703;505;1314;342;1107;111;367;140;475;251;842
315310;201703;1253;3902;1015;3467;127;495;610;2009;737;2504
315320;201703;727;2154;580;1948;90;372;268;869;358;1241
315330;201703;734;2635;457;1883;104;463;76;294;180;757
315340;201703;3442;9620;2707;8492;511;1716;1116;3441;1627;5157
315350;201703;1825;4954;1395;4327;124;438;923;2915;1047;3353
315360;201703;1629;5382;1324;4705;267;1056;426;1431;693;2487
315370;201703;453;1412;397;1304;74;252;174;574;248;826
315380;201703;183;609;140;504;32;137;40;116;72;253
315390;201703;1198;3890;915;3251;209;828;199;664;408;1492
315400;201703;4206;12524;3405;11000;595;2070;1630;5195;2225;7265
315410;201703;2132;5364;1750;4866;260;794;1054;2909;1314;3703
315415;201703;1052;3311;908;3100;351;1270;275;969;626;2239
315420;201703;1130;3594;869;3056;211;777;128;412;339;1189
315430;201703;3565;9597;2702;8190;793;2666;644;1863;1437;4529
315440;201703;961;2856;836;2647;173;663;382;1078;555;1741
315445;201703;2029;5522;1574;4811;211;715;999;3060;1210;3775
315450;201703;2397;7349;2129;6923;322;1042;1318;4394;1640;5436
315460;201703;30465;98480;27371;92203;9847;35244;5484;17982;15331;53226
315470;201703;458;1379;381;1235;36;145;196;616;232;761
315480;201703;1653;5000;1152;3877;269;964;226;792;495;1756
315490;201703;3090;8106;2288;7007;412;1455;772;2236;1184;3691
315500;201703;471;1373;306;994;38;153;130;360;168;513
315510;201703;1340;3779;1145;3463;88;310;875;2593;963;2903
315520;201703;1057;3075;846;2745;100;379;534;1690;634;2069
315530;201703;625;2069;495;1735;167;646;154;487;321;1133
315540;201703;1027;3204;854;2880;167;682;308;1030;475;1712
315550;201703;1738;4880;1331;4235;299;1085;433;1368;732;2453
315560;201703;6385;20884;5763;20004;602;2433;3871;13478;4473;15911
315570;201703;1830;5827;1675;5506;232;879;870;2761;1102;3640
315580;201703;2210;6280;1773;5526;466;1644;509;1534;975;3178
315590;201703;803;2373;705;2219;108;388;367;1135;475;1523
315600;201703;2355;8312;1891;7366;285;1195;1053;4228;1338;5423
315610;201703;970;2708;786;2348;141;543;323;818;464;1361
315620;201703;306;1082;289;1048;68;238;165;642;233;880
315630;201703;825;2579;660;2245;162;548;133;452;295;1000
315640;201703;437;1269;369;1159;61;242;156;446;217;688
315645;201703;789;2326;633;2015;225;761;173;520;398;1281
315650;201703;1803;4901;1425;4359;97;391;1022;3081;1119;3472
315660;201703;2547;6510;2054;5711;172;466;1417;3920;1589;4386
315670;201703;10653;34211;9468;31904;2395;8723;3759;12358;6154;21081
315680;201703;2956;9681;2296;8352;668;2586;697;2540;1365;5126
315690;201703;3219;8981;2205;7157;535;1908;438;1534;973;3442
315700;201703;7232;21972;6046;19627;1053;3757;2787;8754;3840;12511
315710;201703;1818;5067;1393;4402;109;487;867;2619;976;3106
315720;201703;3757;11743;3349;11000;273;1189;2060;6491;2333;7680
315725;201703;1503;4623;1336;4384;197;664;979;3270;1176;3934
315727;201703;588;1754;466;1520;96;366;180;530;276;896
315730;201703;731;2293;677;2168;95;353;354;1081;449;1434
315733;201703;1035;3016;906;2781;246;855;335;975;581;1830
315737;201703;1204;3627;960;3187;66;283;626;2069;692;2352
315740;201703;978;2947;817;2625;131;522;424;1245;555;1767
315750;201703;1141;3427;1023;3217;73;266;744;2351;817;2617
315760;201703;1078;2780;1035;2724;14;39;973;2553;987;2592
315765;201703;1578;4637;1387;4396;49;186;1197;3839;1246;4025
315770;201703;1360;4303;1176;3989;320;1183;317;1085;637;2268
315780;201703;21699;69522;19556;64975;4095;14870;7898;25484;11993;40354
315790;201703;3620;11824;3168;10941;310;1059;2116;7534;2426;8593
315800;201703;1251;4865;986;4084;226;1003;183;727;409;1730
315810;201703;1323;3506;1131;3214;145;450;773;2113;918;2563
315820;201703;2315;7729;2020;7197;517;1884;983;3605;1500;5489
315830;201703;1135;3635;936;3245;109;476;336;1071;445;1547
315840;201703;802;2089;522;1564;86;276;154;446;240;722
315850;201703;929;3259;899;3202;210;831;527;1786;737;2617
315860;201703;506;1672;368;1382;83;378;85;282;168;660
315870;201703;444;1282;367;1159;35;121;231;700;266;821
315880;201703;1182;3014;935;2698;180;620;380;1073;560;1693
315890;201703;1473;4980;1314;4675;478;1800;496;1734;974;3534
315895;201703;5361;16548;4551;14789;838;2975;1738;5358;2576;8333
315900;201703;768;2192;732;2134;52;229;601;1649;653;1878
315910;201703;484;1612;450;1557;95;356;290;980;385;1336
315920;201703;1609;4366;901;2901;192;692;167;449;359;1141
315930;201703;1047;2769;764;2282;197;618;212;623;409;1241
315935;201703;884;2923;783;2719;208;816;212;725;420;1541
315940;201703;611;1937;528;1774;100;378;251;834;351;1212
315950;201703;1173;3508;1034;3252;206;636;640;2046;846;2682
315960;201703;3687;11412;2480;9023;858;3644;107;243;965;3887
315970;201703;677;1941;526;1725;53;157;362;1235;415;1392
315980;201703;3752;9200;2425;7036;625;2023;620;1594;1245;3617
315990;201703;3932;10956;3174;9661;476;1655;1594;4775;2070;6430
316000;201703;571;1661;470;1519;115;455;177;545;292;1000
316010;201703;631;1998;506;1765;60;260;247;791;307;1051
316020;201703;967;3105;859;2913;92;426;586;1869;678;2295
316030;201703;3099;8983;2279;7493;169;662;1387;4637;1556;5299
316040;201703;2990;9430;2282;7974;401;1598;427;1292;828;2890
316045;201703;1981;6062;1836;5823;200;640;1329;4261;1529;4901
316050;201703;357;1122;281;988;47;203;145;479;192;682
316060;201703;699;2047;552;1812;70;322;329;1001;399;1323
316070;201703;6100;18647;5224;16767;1117;4010;2148;6579;3265;10589
316080;201703;714;2535;628;2324;148;614;72;274;220;888
316090;201703;517;1594;379;1300;61;248;126;409;187;657
316095;201703;1443;4514;1231;4141;139;478;767;2588;906;3066
316100;201703;2597;8421;1960;6939;461;1780;461;1522;922;3302
316105;201703;932;2627;704;2242;164;556;279;907;443;1463
316110;201703;11939;39581;10686;37470;1467;5435;6873;24653;8340;30088
316120;201703;1113;3518;865;2932;203;736;215;632;418;1368
316130;201703;1488;3394;896;2530;138;450;355;935;493;1385
316140;201703;950;2694;748;2407;99;328;466;1533;565;1861
316150;201703;1507;4019;1313;3678;181;582;772;2091;953;2673
316160;201703;1169;3390;919;2930;147;517;461;1397;608;1914
316165;201703;936;2452;764;2220;133;456;427;1238;560;1694
316170;201703;1273;3544;937;2987;146;506;405;1205;551;1711
316180;201703;1449;4456;1013;3511;236;917;166;501;402;1418
316190;201703;2847;8679;1539;5341;296;1005;298;944;594;1949
316200;201703;3732;11736;2865;10019;618;2522;735;2442;1353;4964
316210;201703;4519;14410;3777;12924;1297;4694;560;1958;1857;6652
316220;201703;793;2422;555;1941;118;469;52;191;170;660
316225;201703;1187;3223;986;2902;130;435;621;1767;751;2202
316230;201703;426;1211;350;1082;40;132;169;563;209;695
316240;201703;6442;19480;5707;18493;649;2168;4178;13669;4827;15837
316245;201703;3215;11016;2947;10591;255;1300;2216;7736;2471;9036
316250;201703;10186;29030;7827;24449;2104;7210;1705;5050;3809;12260
316255;201703;2538;7516;2215;7102;269;966;1550;5044;1819;6010
316257;201703;1272;3421;954;2859;143;497;369;1052;512;1549
316260;201703;1791;4908;1413;4356;83;310;780;2530;863;2840
316265;201703;1347;3733;988;3043;82;289;618;1869;700;2158
316270;201703;3539;11858;3261;11233;798;2995;1324;4410;2122;7405
316280;201703;3105;9917;2831;9372;465;1727;1506;4841;1971;6568
316290;201703;3322;10134;2755;9026;516;1946;1029;3336;1545;5282
316292;201703;3595;10936;3145;10214;436;1634;2055;6483;2491;8117
316294;201703;805;2525;600;2119;123;508;63;225;186;733
316295;201703;1801;5830;1685;5614;168;704;1203;3894;1371;4598
316300;201703;996;3118;846;2853;66;243;522;1803;588;2046
316310;201703;694;1991;468;1582;86;328;142;465;228;793
316320;201703;597;1875;492;1679;97;393;123;391;220;784
316330;201703;984;2954;767;2469;75;282;497;1547;572;1829
316340;201703;913;2873;737;2514;127;527;382;1232;509;1759
316350;201703;1256;3987;1137;3783;150;560;711;2359;861;2919
316360;201703;724;1919;583;1711;52;169;410;1196;462;1365
316370;201703;4447;13904;3732;12490;1110;4154;620;1929;1730;6083
316380;201703;1613;4156;1277;3700;65;224;936;2712;1001;2936
316390;201703;869;2442;723;2212;143;479;334;1037;477;1516
316400;201703;1264;3835;957;3273;196;732;376;1235;572;1967
316410;201703;999;3260;920;3143;130;463;665;2258;795;2721
316420;201703;1926;6021;1691;5711;165;661;1191;3948;1356;4609
316430;201703;928;2814;648;2211;152;569;143;452;295;1021
316440;201703;672;2181;554;2006;190;789;101;391;291;1180
316443;201703;630;1854;506;1623;119;439;185;562;304;1001
316447;201703;1596;4642;1443;4443;95;347;1210;3727;1305;4074
316450;201703;2134;7046;1799;6380;182;735;1246;4397;1428;5132
316460;201703;777;2379;706;2249;221;721;308;972;529;1693
316470;201703;7173;22494;5767;19650;1454;5672;1509;4897;2963;10569
316480;201703;180;598;154;539;36;131;39;128;75;259
316490;201703;320;964;258;832;52;165;94;273;146;438
316500;201703;1180;4060;800;2986;160;656;51;173;211;829
316510;201703;722;2641;642;2491;222;939;165;630;387;1569
316520;201703;1014;3011;839;2720;145;546;333;980;478;1526
316530;201703;845;2685;707;2430;149;647;284;833;433;1480
316540;201703;731;2326;650;2178;91;380;205;635;296;1015
316550;201703;1192;3902;1117;3773;177;662;703;2372;880;3034
316553;201703;2168;7354;1640;5994;482;1902;304;1078;786;2980
316555;201703;2827;9496;2497;9070;211;872;1878;6978;2089;7850
316556;201703;632;1578;479;1331;41;131;309;824;350;955
316557;201703;781;2780;725;2682;315;1234;196;677;511;1911
316560;201703;281;1011;241;927;65;293;61;218;126;511
316570;201703;1181;3764;1044;3488;209;713;423;1448;632;2161
316580;201703;311;835;210;639;56;180;55;168;111;348
316590;201703;1439;3869;1027;3176;186;667;536;1525;722;2192
316600;201703;1036;3358;932;3160;204;763;425;1427;629;2190
316610;201703;568;2039;498;1894;78;400;304;1092;382;1492
316620;201703;2174;6453;1853;5932;168;658;1222;3878;1390;4536
316630;201703;1428;4640;1222;4212;442;1523;397;1470;839;2993
316640;201703;163;509;142;469;32;134;60;166;92;300
316650;201703;917;3214;789;3026;95;387;543;2136;638;2523
316660;201703;190;489;91;282;8;32;13;35;21;67
316670;201703;1931;5287;1550;4632;523;1713;473;1344;996;3057
316680;201703;1948;5205;1540;4613;133;436;1112;3304;1245;3740
316690;201703;1150;3860;1019;3578;286;1142;294;1020;580;2162
316695;201703;1065;3291;937;3047;92;363;607;1944;699;2307
316700;201703;379;1078;334;1014;33;139;224;629;257;768
316710;201703;2696;9928;2303;9069;859;3515;582;2517;1441;6032
316720;201703;16028;50943;13263;44973;3254;11727;3869;12875;7123;24602
316730;201703;339;1047;304;969;77;281;119;346;196;627
316740;201703;679;2198;623;2104;71;315;428;1445;499;1760
316750;201703;398;1313;328;1165;57;234;109;370;166;604
316760;201703;3497;11354;2971;10612;1371;5144;1018;3727;2389;8871
316770;201703;1395;3744;1208;3481;58;232;1015;2902;1073;3134
316780;201703;575;1903;493;1733;148;573;59;180;207;753
316790;201703;750;2175;605;1924;168;575;186;592;354;1167
316800;201703;5158;16494;4428;15049;814;3030;2281;7407;3095;10437
316805;201703;804;2017;776;1978;30;48;679;1831;709;1879
316810;201703;599;1801;484;1570;131;489;193;557;324;1046
316820;201703;395;1014;224;716;39;149;30;91;69;240
316830;201703;555;1896;523;1828;134;530;261;878;395;1408
316840;201703;2694;8163;2375;7581;502;1830;1081;3316;1583;5146
316850;201703;2069;5829;1682;5204;231;838;969;2922;1200;3760
316860;201703;17590;54599;14994;49873;3338;12677;5874;18930;9212;31607
316870;201703;6155;19499;4970;16874;1425;5197;993;3290;2418;8487
316880;201703;866;2578;747;2374;200;721;239;749;439;1470
316890;201703;1290;2993;903;2475;202;672;511;1281;713;1953
316900;201703;2495;7254;1966;6180;465;1671;580;1598;1045;3269
316905;201703;455;1473;388;1324;119;430;143;485;262;915
316910;201703;888;2692;633;2191;162;638;90;291;252;929
316920;201703;1563;4178;1110;3531;247;884;435;1356;682;2240
316930;201703;7721;25830;6131;22460;1448;5791;949;3346;2397;9137
316935;201703;4340;13133;3187;10665;837;3021;722;2413;1559;5434
316940;201703;6669;21261;5319;18329;1213;4501;1243;4022;2456;8523
316950;201703;1583;4202;1302;3812;90;307;974;2805;1064;3112
316960;201703;4681;11832;3716;10475;606;1857;2123;5943;2729;7800
316970;201703;3168;9948;2982;9606;626;2349;1279;3827;1905;6176
316980;201703;917;2756;649;2251;205;784;95;331;300;1115
316990;201703;9674;29993;7912;26115;2347;8334;714;2284;3061;10618
317000;201703;2755;9218;2656;9107;218;671;2087;7918;2305;8589
317005;201703;2615;7940;2278;7381;474;1622;1180;3831;1654;5453
317010;201703;26857;66164;16435;50153;4035;13888;3135;10252;7170;24140
317020;201703;64602;172840;38596;121304;7675;26508;7241;21161;14916;47669
317030;201703;677;1986;574;1826;48;194;362;1139;410;1333
317040;201703;10041;28509;7868;24669;1959;6523;2960;9434;4919;15957
317043;201703;724;1903;600;1729;121;363;306;867;427;1230
317047;201703;1127;2957;848;2499;71;230;503;1482;574;1712
317050;201703;1444;4805;1101;3990;217;847;342;1126;559;1973
317052;201703;2201;7135;2038;6866;184;749;1468;4844;1652;5593
317057;201703;1593;4378;1208;3702;95;375;768;2262;863;2637
317060;201703;417;1162;257;829;58;215;59;169;117;384
317065;201703;1268;3791;1117;3540;65;268;854;2653;919;2921
317070;201703;8975;27562;6249;21558;1397;5407;774;2612;2171;8019
317075;201703;1046;3129;823;2666;190;655;195;607;385;1262
317080;201703;6164;16336;5121;14590;1596;4753;1520;4196;3116;8949
317090;201703;4705;15266;4378;14777;450;1601;3142;10703;3592;12304
317100;201703;2926;7806;2116;6456;688;2252;625;1868;1313;4120
317103;201703;1784;6156;1580;5758;217;1003;875;3041;1092;4044
317107;201703;1338;4012;1171;3699;121;489;753;2199;874;2688
317110;201703;728;1764;414;1257;69;247;146;470;215;717
317115;201703;1134;3456;968;3116;74;252;686;2210;760;2462
317120;201703;10293;33854;8478;29625;1809;6970;3507;11931;5316;18901
317130;201703;7224;20986;5838;18465;1313;4581;2138;6689;3451;11270
317140;201703;545;1720;492;1631;68;247;313;1026;381;1273
317150;201703;998;2716;859;2548;62;211;681;2003;743;2214
317160;201703;3422;8891;2535;7667;164;550;1776;5332;1940;5882
317170;201703;1953;5171;1462;4342;212;718;512;1331;724;2049
317180;201703;1762;5873;1433;5161;389;1490;351;1245;740;2735
317190;201703;1363;3789;1055;3337;68;238;698;2199;766;2437
317200;201703;4394;13493;3720;12124;966;3493;1028;3200;1994;6693
317210;201703;931;2761;807;2595;108;445;534;1671;642;2116
317220;201703;279;943;264;919;66;260;127;430;193;690
320010;201703;4803;14898;4086;13494;657;2327;2225;7227;2882;9554
320013;201703;1881;5661;1327;4455;234;803;537;1874;771;2677
320016;201703;2982;8262;2537;7623;216;617;1918;5809;2134;6426
320020;201703;3734;11452;3071;10156;867;3035;926;3145;1793;6180
320030;201703;1677;5270;1269;4387;377;1373;371;1236;748;2609
320035;201703;1769;5214;1527;4823;525;1828;579;1732;1104;3560
320040;201703;3108;9883;2608;8915;588;2146;962;3264;1550;5410
320050;201703;1604;4276;1406;3928;342;1014;643;1750;985;2764
320060;201703;10984;34500;8338;28564;2095;7821;1672;5498;3767;13319
320070;201703;1380;4314;1127;3775;250;914;311;1002;561;1916
320080;201703;5484;15585;4205;13060;954;3076;1321;4205;2275;7281
320090;201703;7681;22184;6112;19034;1584;5227;2161;6562;3745;11789
320100;201703;2536;7933;2068;6983;628;2166;624;2142;1252;4308
320110;201703;1195;3532;1022;3209;266;853;267;867;533;1720
320115;201703;1796;6311;1636;6030;824;3139;429;1657;1253;4796
320120;201703;15367;45523;11899;38993;2939;10616;3230;10563;6169;21179
320130;201703;35615;112547;32089;105714;6341;23604;15350;49012;21691;72616
320140;201703;3302;10320;2396;8330;647;2502;433;1497;1080;3999
320150;201703;14008;39718;10758;33280;3194;10590;1198;3498;4392;14088
320160;201703;4916;15195;4158;13675;1048;3805;1527;4823;2575;8628
320170;201703;1627;5177;1349;4559;307;1093;556;1858;863;2951
320180;201703;736;2485;637;2307;232;878;163;608;395;1486
320190;201703;3468;11828;2739;10048;719;2757;458;1652;1177;4409
320200;201703;958;2947;785;2647;243;903;217;759;460;1662
320210;201703;4511;12658;3777;11228;737;2437;1765;4940;2502;7377
320220;201703;2166;6652;1814;6026;482;1756;746;2510;1228;4266
320225;201703;1276;4276;999;3616;344;1314;153;568;497;1882
320230;201703;4118;13047;3461;11885;989;3643;1349;4726;2338;8369
320240;201703;12550;36397;10162;32232;2559;8776;3148;10131;5707;18907
320245;201703;3026;10241;2789;9687;950;3493;673;2287;1623;5780
320250;201703;1866;5641;1334;4411;365;1366;218;650;583;2016
320255;201703;1671;5661;1465;5301;553;2084;569;2160;1122;4244
320260;201703;1044;3135;803;2621;231;836;206;571;437;1407
320265;201703;2448;7769;2081;7116;746;2659;772;2664;1518;5323
320270;201703;2683;7771;1978;6438;397;1379;888;2980;1285;4359
320280;201703;6257;19178;5407;17491;1413;4985;1419;4317;2832;9302
320290;201703;1408;4528;1015;3574;312;1169;148;520;460;1689
320300;201703;4088;13554;3567;12374;1196;4415;721;2480;1917;6895
320305;201703;4397;13962;3751;12525;925;3318;1450;4773;2375;8091
320310;201703;1849;5547;1543;4893;379;1242;587;1857;966;3099
320313;201703;2113;5965;1442;4497;331;1195;277;797;608;1992
320316;201703;1646;4913;1310;4221;403;1345;394;1258;797;2603
320320;201703;19480;57844;15202;50055;4116;14766;4828;15762;8944;30528
320330;201703;2904;8506;2382;7596;642;2036;979;3320;1621;5356
320332;201703;5210;16539;4511;15225;1400;5011;1700;5695;3100;10706
320334;201703;2018;6249;1386;4882;339;1324;302;1030;641;2354
320335;201703;2212;6470;1385;4534;368;1322;169;496;537;1818
320340;201703;5470;14762;4700;13481;1031;3201;2112;6208;3143;9409
320350;201703;5006;13216;3770;10967;669;2044;1717;4936;2386;6980
320360;201703;1632;4349;1217;3550;202;614;499;1404;701;2018
320370;201703;2784;9178;2246;7920;639;2332;674;2358;1313;4690
320380;201703;2126;6267;1890;5851;383;1294;995;3004;1378;4298
320390;201703;6940;20684;5653;17957;1616;5517;1663;5075;3279;10592
320400;201703;3440;10491;3004;9698;649;2303;1372;4352;2021;6655
320405;201703;4226;12203;3668;11217;725;2390;2003;6005;2728;8395
320410;201703;5238;14302;3928;12374;891;3039;1747;5668;2638;8707
320420;201703;2385;7096;1914;6247;565;2054;462;1492;1027;3546
320425;201703;1989;5143;1583;4476;163;497;972;2704;1135;3201
320430;201703;2533;7004;2150;6222;409;1261;1153;3206;1562;4467
320435;201703;2676;8544;2191;7590;949;3420;551;2028;1500;5448
320440;201703;1016;3302;894;2994;205;764;313;997;518;1761
320450;201703;1902;5895;1555;5214;403;1486;639;2066;1042;3552
320455;201703;4072;13192;3042;10769;829;3125;683;2348;1512;5473
320460;201703;2597;8203;1905;6628;478;1812;387;1251;865;3063
320465;201703;1553;4718;1189;3929;175;638;561;1852;736;2490
320470;201703;4135;12212;2930;9620;838;2999;572;1837;1410;4836
320480;201703;1671;5215;1449;4760;322;1161;601;1930;923;3091
320490;201703;15255;46107;12886;41904;3512;12543;4045;13154;7557;25697
320495;201703;1325;3800;870;2873;269;938;121;427;390;1365
320500;201703;47189;139837;41049;128978;8882;30186;19809;60984;28691;91170
320501;201703;4677;14120;3669;12428;1139;4347;968;3175;2107;7522
320503;201703;1877;6281;1513;5496;546;2234;426;1389;972;3623
320506;201703;4066;12404;2877;9648;809;2893;101;275;910;3168
320510;201703;8227;25289;7155;23297;1462;5248;3522;11294;4984;16542
320515;201703;1833;5294;1498;4571;456;1445;332;1019;788;2464
320517;201703;2073;6611;1673;5825;523;1958;405;1395;928;3353
320520;201703;35555;105741;29297;94584;7162;25640;10183;32392;17345;58032
320530;201703;27562;82045;22965;73480;4183;15592;11365;34271;15548;49863
330010;201703;19679;59482;17702;55810;3956;13342;9106;28498;13062;41840
330015;201703;1476;4105;1274;3742;196;688;609;1743;805;2431
330020;201703;17526;50656;15945;48063;2845;9481;9574;28198;12419;37679
330022;201703;1870;5455;1564;4942;309;1077;858;2664;1167;3741
330023;201703;3114;9517;2702;8858;772;2734;814;2577;1586;5311
330025;201703;4553;12256;3463;10307;899;2850;1511;4532;2410;7382
330030;201703;8107;26555;7143;24674;1414;5414;3431;11351;4845;16765
330040;201703;11427;34139;10409;32161;2051;6880;5765;17293;7816;24173
330045;201703;73431;199022;63608;185240;7973;25231;42832;123081;50805;148312
330050;201703;2374;7131;1977;6401;548;1915;716;2184;1264;4099
330060;201703;5571;15838;4750;14587;1036;3613;2367;7030;3403;10643
330070;201703;19391;58383;17445;55188;3750;12875;8534;27040;12284;39915
330080;201703;7838;21913;7221;20949;690;2078;5071;14691;5761;16769
330090;201703;2571;6817;2290;6392;351;1111;1294;3502;1645;4613
330093;201703;1906;5677;1596;5131;298;990;741;2518;1039;3508
330095;201703;992;3337;854;3020;186;735;316;1072;502;1807
330100;201703;58513;179846;53225;171442;7779;28700;31713;101008;39492;129708
330110;201703;2210;6889;1948;6435;484;1729;668;2177;1152;3906
330115;201703;1731;4971;1501;4621;262;905;838;2508;1100;3413
330120;201703;2669;7211;2345;6727;361;1207;1479;4143;1840;5350
330130;201703;3248;10457;2903;9851;683;2532;1401;4665;2084;7197
330140;201703;3039;9312;2774;8913;546;2010;1540;4863;2086;6873
330150;201703;2026;6008;1631;5231;426;1464;423;1362;849;2826
330160;201703;1123;3499;984;3263;262;991;452;1420;714;2411
330170;201703;98273;292616;89463;278459;17515;58007;49069;151534;66584;209541
330180;201703;2028;5840;1704;5256;122;505;1112;3270;1234;3775
330185;201703;8135;24794;7053;22726;1358;4792;3828;12043;5186;16835
330187;201703;3755;10654;3215;9769;495;1653;2008;6009;2503;7662
330190;201703;25197;70712;23538;68204;3640;11051;16576;47885;20216;58936
330200;201703;13732;42627;12250;40160;3056;10362;6112;20370;9168;30732
330205;201703;2018;5545;1757;5099;211;693;1103;3117;1314;3810
330210;201703;2991;8326;2486;7350;611;1860;806;2374;1417;4234
330220;201703;9959;29995;8519;26984;2179;7477;2089;6152;4268;13629
330225;201703;3640;11256;3157;10352;404;1679;1810;5657;2214;7336
330227;201703;16400;47123;14774;44766;3060;9540;8654;26764;11714;36304
330230;201703;1215;3604;1101;3431;169;626;645;1924;814;2550
330240;201703;17344;52405;14801;47729;4587;15936;4608;14410;9195;30346
330245;201703;1217;3629;929;3117;245;895;175;550;420;1445
330250;201703;34426;100537;31270;95355;9058;27919;12438;39483;21496;67402
330260;201703;4059;12565;3514;11458;665;2355;1494;4677;2159;7032
330270;201703;19346;43718;12996;35242;3012;9156;4676;12777;7688;21933
330280;201703;2196;6467;1851;5805;310;1124;905;2664;1215;3788
330285;201703;17849;50659;16044;47953;2751;9029;9786;28776;12537;37805
330290;201703;3178;9189;2814;8624;474;1638;1563;4606;2037;6244
330300;201703;3173;10249;2849;9616;508;1965;1608;5181;2116;7146
330310;201703;2135;6014;1811;5455;227;724;1124;3379;1351;4103
330320;201703;12839;38425;12005;37124;1542;5293;8794;26859;10336;32152
330330;201703;27333;74411;23817;68980;4148;13467;14231;39842;18379;53309
330340;201703;14000;40217;11002;34816;2701;9200;3585;11126;6286;20326
330350;201703;85618;247241;76918;234780;10635;34803;51942;158195;62577;192998
330360;201703;5926;17245;5609;16780;540;1752;4291;12697;4831;14449
330370;201703;3455;12139;3111;11418;1061;4049;965;3541;2026;7590
330380;201703;4974;15936;4196;14350;1031;3910;1404;4626;2435;8536
330385;201703;3801;13051;3472;12389;1027;3867;1365;4954;2392;8821
330390;201703;21861;70764;19141;65271;4816;17728;7776;26008;12592;43736
330395;201703;3000;8695;2752;8288;247;905;1823;5424;2070;6329
330400;201703;2590;7996;2345;7550;286;1165;1505;4486;1791;5651
330410;201703;2798;8412;2215;7311;430;1590;1018;3180;1448;4770
330411;201703;2269;7012;1978;6408;245;917;1186;3663;1431;4580
330412;201703;1364;4557;1151;4123;221;886;533;1783;754;2669
330414;201703;23426;65453;20415;61214;3962;11859;11866;36046;15828;47905
330415;201703;3198;9888;2761;9108;690;2306;1057;3546;1747;5852
330420;201703;9552;26829;6530;21419;1396;4973;1402;4491;2798;9464
330430;201703;7036;20705;6228;19196;1349;4532;2807;8365;4156;12897
330440;201703;1529;5083;1369;4772;431;1684;372;1167;803;2851
330450;201703;1306;4283;1171;4049;247;1036;604;2007;851;3043
330452;201703;13435;39267;10805;34266;2667;9163;4309;13349;6976;22512
330455;201703;491584;1334598;399784;1186331;81023;257429;205328;602221;286351;859650
330460;201703;1151;3699;1001;3424;212;803;438;1467;650;2270
330470;201703;4254;12613;3779;11776;844;2860;1778;5424;2622;8284
330475;201703;7598;23294;6703;21810;2011;7151;2497;7892;4508;15043
330480;201703;5539;16059;4991;15262;826;2706;2940;8806;3766;11512
330490;201703;108201;281387;96012;263428;10496;30681;66325;180328;76821;211009
330500;201703;5119;15589;4909;15229;694;2375;3424;10507;4118;12882
330510;201703;36437;110407;32418;104002;10177;33026;13601;44714;23778;77740
330513;201703;1312;3946;1213;3772;380;1209;523;1655;903;2864
330515;201703;2949;9033;2559;8266;837;2785;706;2275;1543;5060
330520;201703;10779;32576;9622;30482;1981;6727;4360;13544;6341;20271
330530;201703;1420;4121;1225;3752;305;1032;534;1556;839;2588
330540;201703;2848;8318;2331;7365;614;2059;818;2492;1432;4551
330550;201703;7622;25372;6738;23661;2874;10474;1116;4072;3990;14546
330555;201703;9587;28331;8580;26849;1565;5067;5229;16668;6794;21735
330560;201703;4199;12557;3749;11698;604;2075;2017;6067;2621;8142
330570;201703;3076;9062;2608;8253;638;2123;1236;3905;1874;6028
330575;201703;5123;14441;4574;13460;626;2127;3052;8627;3678;10754
330580;201703;13016;40641;10945;36423;3003;10571;4162;13791;7165;24362
330590;201703;1509;4590;1415;4440;212;720;977;3073;1189;3793
330600;201703;11119;32274;8922;28362;1491;5318;4236;13272;5727;18590
330610;201703;8466;26396;7650;24929;1262;4696;4306;13673;5568;18369
330615;201703;1582;5547;1475;5366;582;2218;520;1942;1102;4160
330620;201703;3406;11739;3034;10956;1091;4203;638;2294;1729;6497
330630;201703;22857;65560;18674;58174;2773;10048;10583;31710;13356;41758
350010;201703;1723;5025;1153;3888;294;1045;132;400;426;1445
350020;201703;432;1170;299;913;42;139;158;455;200;594
350030;201703;4437;13723;3409;11649;1014;3711;842;2874;1856;6585
350040;201703;434;1453;319;1190;70;276;91;327;161;603
350050;201703;850;2576;686;2261;161;610;216;606;377;1216
350055;201703;636;1864;538;1700;87;303;331;1032;418;1335
350060;201703;113;351;92;318;23;89;45;157;68;246
350070;201703;3830;11150;2446;8310;486;1752;543;1690;1029;3442
350075;201703;538;1779;419;1530;163;602;75;268;238;870
350080;201703;646;1847;407;1304;63;230;159;486;222;716
350090;201703;604;1604;386;1161;92;259;131;399;223;658
350100;201703;1902;5842;1364;4754;262;1064;448;1457;710;2521
350110;201703;460;1397;342;1139;33;131;191;612;224;743
350115;201703;1219;3630;1074;3351;205;695;534;1527;739;2222
350120;201703;751;2144;437;1479;71;234;168;643;239;877
350130;201703;3266;9616;2850;8780;367;1286;1596;4669;1963;5955
350140;201703;569;1858;474;1677;61;265;258;898;319;1163
350150;201703;450;1460;392;1337;137;501;89;307;226;808
350160;201703;8444;23949;5708;18660;1118;4109;2396;7254;3514;11363
350170;201703;1473;4950;1234;4360;312;1168;276;943;588;2111
350180;201703;1070;2956;672;2073;105;355;314;941;419;1296
350190;201703;3083;9451;2457;8160;522;2010;1011;2902;1533;4912
350200;201703;375;1142;337;1071;25;84;234;734;259;818
350210;201703;4796;12577;3403;10207;852;2671;1410;4209;2262;6880
350220;201703;2389;7547;2069;6815;419;1663;942;2864;1361;4527
350230;201703;728;2297;649;2139;147;516;282;927;429;1443
350240;201703;520;1586;413;1335;46;172;221;680;267;852
350250;201703;1976;7083;1825;6789;658;2622;553;2054;1211;4676
350260;201703;972;2541;643;1928;114;354;266;769;380;1123
350270;201703;4883;14681;4060;12921;737;2559;1788;5386;2525;7945
350275;201703;1837;5955;1658;5666;483;1725;625;2122;1108;3847
350280;201703;21458;51786;13488;38448;2761;8381;3500;9848;6261;18229
350290;201703;2212;6945;1731;5932;362;1367;561;1849;923;3216
350300;201703;538;1530;400;1232;83;251;179;539;262;790
350310;201703;869;2869;752;2589;107;417;298;987;405;1404
350315;201703;495;1554;367;1263;67;271;91;288;158;559
350320;201703;10288;32006;9201;29978;2682;9241;1533;5275;4215;14516
350330;201703;14226;39034;9765;29115;1917;5523;3524;10050;5441;15573
350335;201703;381;1181;338;1095;20;61;255;834;275;895
350340;201703;1048;3067;738;2459;151;568;227;750;378;1318
350350;201703;701;2154;593;2000;119;449;202;666;321;1115
350360;201703;838;2807;713;2528;166;577;293;1067;459;1644
350370;201703;536;1577;398;1272;91;306;81;249;172;555
350380;201703;4224;12292;2984;9974;737;2703;819;2566;1556;5269
350390;201703;9259;27993;8006;25621;2286;7514;2916;9213;5202;16727
350395;201703;360;996;182;630;28;101;49;150;77;251
350400;201703;7840;22257;6205;19252;1519;5211;2152;6337;3671;11548
350410;201703;8253;26936;6524;23374;1791;7003;1294;4381;3085;11384
350420;201703;541;1684;408;1445;90;373;46;152;136;525
350430;201703;673;2087;575;1913;94;374;324;1041;418;1415
350440;201703;1266;3943;1064;3469;242;783;469;1523;711;2306
350450;201703;7327;22589;5958;19798;1409;5043;1552;4931;2961;9974
350460;201703;1379;3717;843;2650;162;583;285;822;447;1405
350470;201703;239;631;199;562;26;98;127;334;153;432
350480;201703;761;2239;542;1805;89;349;101;305;190;654
350490;201703;1819;5442;1526;4932;352;1234;512;1536;864;2770
350500;201703;555;1666;485;1536;76;289;255;777;331;1066
350510;201703;1070;3203;803;2633;115;438;345;1076;460;1514
350520;201703;1523;5531;1228;4788;261;1106;326;1228;587;2334
350530;201703;2253;6542;1832;5697;526;1714;496;1492;1022;3206
350535;201703;1237;3959;1153;3816;168;689;755;2381;923;3070
350540;201703;1741;4852;1314;4101;318;1044;479;1532;797;2576
350550;201703;10255;26997;7128;21889;1281;4499;2640;7632;3921;12131
350560;201703;3313;10761;2897;9776;383;1370;1582;5280;1965;6650
350570;201703;17831;57125;15802;53095;4470;16285;6112;19607;10582;35892
350580;201703;1692;5350;1122;3905;216;803;120;348;336;1151
350590;201703;3785;11622;2974;10012;765;2911;1136;3490;1901;6401
350600;201703;42200;103407;27857;78207;4490;13822;11839;30946;16329;44768
350610;201703;6654;19728;5341;17271;1111;3921;2223;7008;3334;10929
350620;201703;406;1141;299;974;48;193;129;384;177;577
350630;201703;1592;4521;1177;3731;178;680;494;1428;672;2108
350635;201703;6637;19132;5222;16696;1158;4081;2178;6806;3336;10887
350640;201703;789;2426;544;1821;94;341;127;392;221;733
350650;201703;7802;23220;4977;16573;1067;3929;1048;3253;2115;7182
350660;201703;4800;13775;3910;12208;714;2433;1910;5897;2624;8330
350670;201703;1494;4654;1375;4422;313;1066;691;2177;1004;3243
350680;201703;1020;3013;759;2519;174;646;309;1006;483;1652
350690;201703;818;2672;642;2286;141;561;220;727;361;1288
350700;201703;4175;12099;2923;9938;629;2400;1020;3180;1649;5580
350710;201703;2654;8172;2295;7474;355;1290;1291;4103;1646;5393
350715;201703;749;2256;671;2097;108;369;360;1057;468;1426
350720;201703;126;355;113;334;26;84;41;116;67;200
350730;201703;403;1449;376;1385;84;342;165;601;249;943
350740;201703;1738;5240;1222;4067;221;806;327;986;548;1792
350745;201703;517;1590;317;1074;48;183;146;445;194;628
350750;201703;8939;27167;7443;24213;1713;6212;2002;6013;3715;12225
350760;201703;12949;37383;10310;32701;2729;9474;2602;7468;5331;16942
350770;201703;638;1797;444;1419;45;150;246;772;291;922
350775;201703;602;1578;488;1389;49;173;243;668;292;841
350780;201703;1821;5519;1417;4736;390;1438;292;1020;682;2458
350790;201703;1837;5659;1352;4681;313;1155;242;742;555;1897
350800;201703;2925;9630;2736;9269;505;1948;1431;4663;1936;6611
350810;201703;1951;5469;1665;5064;416;1335;796;2519;1212;3854
350820;201703;586;1590;412;1257;65;225;157;452;222;677
350830;201703;836;2560;535;1866;73;277;143;450;216;727
350840;201703;2524;8639;2035;7599;650;2573;489;1780;1139;4353
350850;201703;5854;19301;4954;17356;1492;5474;1163;4056;2655;9530
350860;201703;3104;9401;2913;9101;150;640;2245;6899;2395;7539
350870;201703;2662;8360;2154;7480;447;1716;1166;4085;1613;5801
350880;201703;1266;4180;1019;3589;237;870;255;893;492;1763
350890;201703;647;1807;405;1283;55;188;103;273;158;461
350900;201703;5142;15699;3692;12540;1117;4152;458;1462;1575;5614
350910;201703;853;2468;738;2234;178;600;369;1068;547;1668
350920;201703;10924;30455;9673;28364;874;2960;6993;19717;7867;22677
350925;201703;4355;13471;3489;11767;819;2995;1185;3510;2004;6505
350930;201703;1487;4148;1063;3275;132;438;572;1688;704;2126
350940;201703;1757;5727;1607;5423;284;1106;901;2932;1185;4038
350945;201703;904;2798;756;2527;131;519;369;1143;500;1662
350950;201703;74526;220860;60680;190932;11942;41267;28241;84051;40183;125318
350960;201703;4724;15435;4046;14026;806;3200;2041;6718;2847;9918
350970;201703;4021;13685;3368;12095;1093;4258;556;1791;1649;6049
350980;201703;618;2008;536;1830;225;817;165;556;390;1373
350990;201703;1736;5722;1405;5106;380;1517;407;1414;787;2931
350995;201703;754;2524;710;2430;87;408;461;1474;548;1882
351000;201703;2769;8132;2234;7119;401;1416;886;2649;1287;4065
351010;201703;319;925;191;632;41;148;66;213;107;361
351015;201703;720;2451;615;2255;139;559;290;1049;429;1608
351020;201703;7843;24140;6791;22444;1681;5824;3243;10728;4924;16552
351030;201703;2049;6916;1750;6167;386;1509;655;2164;1041;3673
351040;201703;3509;10371;3180;9814;377;1326;2209;6617;2586;7943
351050;201703;15269;41910;10743;34209;2512;8694;3263;10366;5775;19060
351060;201703;38309;108534;31107;95866;5645;19177;15932;47821;21577;66998
351070;201703;1369;3809;880;2913;224;816;92;262;316;1078
351080;201703;2681;7591;2030;6781;475;1807;951;2983;1426;4790
351090;201703;342;1156;266;998;54;226;49;176;103;402
351100;201703;2360;7036;1608;5188;426;1471;450;1456;876;2927
351110;201703;6314;16163;3729;11947;808;2898;923;2852;1731;5750
351120;201703;671;1961;521;1659;79;276;225;620;304;896
351130;201703;1003;2819;511;1762;80;284;111;371;191;655
351140;201703;1645;5484;1356;4867;423;1645;290;969;713;2614
351150;201703;1398;4817;991;3762;215;859;100;313;315;1172
351160;201703;1162;4015;1018;3673;260;995;331;1059;591;2054
351170;201703;1335;4168;1136;3732;157;584;587;1808;744;2392
351190;201703;803;2542;633;2119;99;347;193;623;292;970
351200;201703;1822;5332;1536;4807;178;632;676;1994;854;2626
351210;201703;1206;3401;841;2663;119;427;324;940;443;1367
351220;201703;2899;9634;2653;9108;399;1541;1496;5014;1895;6555
351230;201703;1748;5378;1441;4790;283;1086;702;2200;985;3286
351240;201703;1097;3307;826;2733;201;678;298;924;499;1602
351250;201703;932;2739;578;1892;94;307;198;625;292;932
351260;201703;903;2632;765;2352;212;650;241;727;453;1377
351270;201703;309;1009;269;920;68;263;105;301;173;564
351280;201703;5071;14327;3850;11947;689;2357;1507;4500;2196;6857
351290;201703;934;2651;656;2094;142;462;270;837;412;1299
351300;201703;12502;39459;9414;33005;2187;8423;2983;10397;5170;18820
351310;201703;2882;8687;2330;7656;443;1638;1081;3324;1524;4962
351320;201703;832;2750;691;2388;128;504;241;758;369;1262
351330;201703;585;2113;531;2028;70;208;359;1498;429;1706
351340;201703;5504;18162;4653;16472;1265;4705;1718;6085;2983;10790
351350;201703;7131;22682;6186;20764;1614;5683;2353;7570;3967;13253
351360;201703;3855;11857;3519;11213;900;3172;1088;3174;1988;6346
351370;201703;2239;6870;1741;5765;367;1363;686;2067;1053;3430
351380;201703;38244;108838;33904;100904;6630;21029;15486;45047;22116;66076
351385;201703;254;743;182;585;24;89;62;171;86;260
351390;201703;1171;3669;980;3267;256;1026;417;1225;673;2251
351400;201703;912;2965;862;2851;239;871;426;1379;665;2250
351410;201703;2347;7084;2019;6448;295;951;1167;3677;1462;4628
351420;201703;291;793;189;599;39;121;49;158;88;279
351430;201703;757;2388;709;2305;91;335;533;1705;624;2040
351440;201703;3106;9254;2302;7473;473;1615;321;956;794;2571
351450;201703;1523;4300;1204;3745;299;988;389;1281;688;2269
351460;201703;646;1922;558;1756;270;854;152;479;422;1333
351470;201703;1007;2952;874;2693;137;488;444;1282;581;1770
351480;201703;2680;8577;2436;8164;379;1618;1357;4319;1736;5937
351490;201703;1711;5599;1522;5192;168;727;897;2889;1065;3616
351492;201703;290;924;246;811;14;52;140;447;154;499
351495;201703;200;646;151;517;25;105;64;207;89;312
351500;201703;30002;82289;22499;68798;5227;17184;9010;26520;14237;43704
351510;201703;9373;27849;7548;24195;1632;5625;3659;11516;5291;17141
351512;201703;492;1406;357;1108;55;162;163;499;218;661
351515;201703;2282;6862;1599;5369;376;1405;397;1209;773;2614
351518;201703;2139;6412;1471;5157;336;1324;545;1738;881;3062
351519;201703;763;2250;552;1785;97;355;131;324;228;679
351520;201703;731;1996;357;1251;62;234;101;332;163;566
351530;201703;365;1113;234;770;28;94;58;154;86;248
351535;201703;2293;5884;1746;5034;139;504;1133;3100;1272;3604
351540;201703;1743;5115;1351;4342;475;1650;191;562;666;2212
351550;201703;4970;14609;3529;11360;636;2265;1445;4398;2081;6663
351560;201703;413;1330;356;1196;83;310;58;197;141;507
351565;201703;163;553;145;507;30;101;58;194;88;295
351570;201703;13546;39720;11204;35031;2088;7136;6326;19045;8414;26181
351580;201703;312;854;195;614;39;112;52;171;91;283
351590;201703;453;1149;281;820;24;81;141;383;165;464
351600;201703;1752;4815;1413;4196;169;589;846;2386;1015;2975
351610;201703;674;1789;492;1474;49;177;236;624;285;801
351620;201703;18091;56682;14316;49060;2883;11205;4191;12983;7074;24188
351630;201703;21945;65944;19448;61784;3896;13256;11308;35184;15204;48440
351640;201703;13730;40416;11339;36219;1789;6289;6719;21084;8508;27373
351650;201703;434;1298;210;719;30;116;42;128;72;244
351660;201703;756;2375;541;1822;125;460;99;282;224;742
351670;201703;3880;12162;3127;10375;549;2041;1384;4279;1933;6320
351680;201703;557;1717;333;1150;71;240;63;217;134;457
351685;201703;417;1336;358;1214;86;268;159;546;245;814
351690;201703;1048;3084;761;2464;132;463;302;884;434;1347
351700;201703;1073;3145;925;2851;214;631;343;1059;557;1690
351710;201703;534;1764;448;1554;66;257;181;591;247;848
351720;201703;1520;4528;1062;3479;201;717;330;1027;531;1744
351730;201703;1051;2925;831;2591;157;593;373;1121;530;1714
351740;201703;3948;10707;3143;9125;612;1917;1248;3424;1860;5341
351750;201703;1131;3572;724;2619;131;515;211;759;342;1274
351760;201703;3277;10111;2560;8533;681;2481;734;2250;1415;4731
351770;201703;2107;6614;1765;5953;503;1755;680;2219;1183;3974
351780;201703;1434;3993;796;2552;140;502;170;510;310;1012
351790;201703;1097;3073;920;2785;186;527;511;1578;697;2105
351800;201703;503;1099;273;709;47;134;85;220;132;354
351810;201703;1018;2882;850;2580;92;271;569;1690;661;1961
351820;201703;2516;7911;1829;6408;362;1386;186;639;548;2025
351830;201703;4241;12871;3280;10841;524;2001;1607;5093;2131;7094
351840;201703;6572;22090;5767;20432;1406;5418;2101;7174;3507;12592
351850;201703;2054;5420;1455;4424;194;748;723;2025;917;2773
351860;201703;3074;9745;2646;8846;600;2130;1188;3906;1788;6036
351870;201703;26539;77934;21898;69512;6751;22496;8147;25732;14898;48228
351880;201703;115214;350943;96455;313953;27847;97494;26400;81812;54247;179306
351885;201703;612;2074;558;1957;149;544;229;759;378;1303
351890;201703;616;1894;501;1672;120;424;82;250;202;674
351900;201703;1164;3537;944;3159;251;884;282;941;533;1825
351905;201703;452;1392;359;1209;43;162;181;561;224;723
351907;201703;18759;54254;15588;48335;1234;4695;10645;32043;11879;36738
351910;201703;1032;3130;817;2640;180;632;329;1010;509;1642
351920;201703;951;2554;767;2270;111;380;398;1148;509;1528
351925;201703;1005;2980;821;2615;145;522;360;1043;505;1565
351930;201703;2646;8336;2537;8132;356;1482;1922;5867;2278;7349
351940;201703;957;2849;787;2532;119;412;385;1234;504;1646
351950;201703;1504;4049;1067;3242;115;392;540;1619;655;2011
351960;201703;4472;12789;3351;10684;721;2517;1426;4499;2147;7016
351970;201703;5455;19151;4858;17961;1294;5199;1916;6795;3210;11994
351980;201703;880;2566;636;2036;121;417;233;663;354;1080
351990;201703;1467;4044;1143;3450;213;769;281;738;494;1507
352000;201703;2208;7175;2002;6724;349;1321;1006;3174;1355;4495
352010;201703;1572;5224;1378;4805;344;1271;232;827;576;2098
352020;201703;1408;4333;1201;3937;289;1028;488;1519;777;2547
352030;201703;4781;13860;3964;12660;807;2833;2099;6661;2906;9494
352040;201703;1944;6182;1489;5190;300;1154;237;766;537;1920
352042;201703;3503;9498;2130;6598;403;1333;922;2793;1325;4126
352044;201703;1784;5356;1138;4005;180;691;227;747;407;1438
352050;201703;11130;33476;7641;25729;1826;6939;1355;4116;3181;11055
352060;201703;692;2077;551;1789;106;396;215;631;321;1027
352070;201703;774;1934;618;1672;129;388;215;580;344;968
352080;201703;428;1226;281;896;49;164;91;273;140;437
352090;201703;1294;4352;1038;3725;169;679;281;924;450;1603
352100;201703;2935;8833;2344;7735;577;2056;952;2989;1529;5045
352110;201703;528;1824;443;1646;118;455;153;530;271;985
352115;201703;472;1472;405;1343;58;195;240;798;298;993
352120;201703;873;2736;720;2441;108;443;358;1115;466;1558
352130;201703;1823;5440;1203;3949;282;980;271;856;553;1836
352140;201703;1701;4815;1039;3421;164;582;358;1128;522;1710
352150;201703;764;2261;605;1957;149;508;292;936;441;1444
352160;201703;965;2636;740;2233;167;553;243;658;410;1211
352170;201703;2678;8020;2342;7265;468;1566;1148;3358;1616;4924
352180;201703;2989;8495;2521;7575;668;2112;847;2434;1515;4546
352190;201703;1129;3353;917;2934;138;550;310;817;448;1367
352200;201703;377;1295;288;1096;38;161;100;362;138;523
352210;201703;16198;43472;13277;39159;2140;6835;8169;24271;10309;31106
352215;201703;529;1594;481;1524;55;205;294;907;349;1112
352220;201703;12078;37566;9684;32754;3156;11390;2255;7608;5411;18998
352230;201703;12139;40510;10338;36953;2869;11250;3374;11539;6243;22789
352240;201703;11820;33661;9171;29022;2412;8624;2857;8186;5269;16810
352250;201703;22033;69361;19093;63506;5686;20039;6503;21589;12189;41628
352260;201703;5318;15243;3572;11537;706;2533;1346;4076;2052;6609
352265;201703;857;2665;734;2453;64;282;490;1570;554;1852
352270;201703;1558;5316;1280;4703;318;1238;348;1249;666;2487
352280;201703;2190;6451;1793;5744;303;1166;826;2474;1129;3640
352290;201703;1109;3498;947;3119;171;673;415;1256;586;1929
352300;201703;965;2754;725;2268;136;497;322;909;458;1406
352310;201703;44707;129365;35469;113214;9280;30715;15820;50791;25100;81506
352320;201703;5429;16459;4612;14761;1110;3807;1597;4627;2707;8434
352330;201703;1978;6237;1667;5787;502;1858;524;1776;1026;3634
352340;201703;4955;15459;3806;13289;1052;3958;849;2812;1901;6770
352350;201703;1591;5284;1415;4882;265;1051;529;1703;794;2754
352360;201703;1028;3079;907;2864;147;549;616;1853;763;2402
352370;201703;823;2769;738;2556;92;395;425;1402;517;1797
352380;201703;891;2802;755;2543;216;805;183;578;399;1383
352390;201703;19149;49976;12688;38132;2104;7234;5890;16561;7994;23795
352400;201703;3429;9780;2376;7759;718;2474;582;1768;1300;4242
352410;201703;2758;8209;2336;7520;471;1640;1044;3235;1515;4875
352420;201703;841;2294;678;1976;130;404;265;759;395;1163
352430;201703;6064;18031;5112;16466;1613;5572;1669;5399;3282;10971
352440;201703;15843;48132;12971;42471;2922;10260;5190;16746;8112;27006
352450;201703;617;1883;401;1392;84;325;117;407;201;732
352460;201703;2405;7554;1972;6702;525;1958;581;1844;1106;3802
352470;201703;3761;10432;2771;8604;355;1262;1274;3686;1629;4948
352480;201703;3965;10570;2942;8730;579;1938;1161;3101;1740;5039
352490;201703;652;2260;516;1926;101;412;143;538;244;950
352500;201703;8368;23262;6858;20783;3463;11162;1293;3237;4756;14399
352510;201703;2780;8625;2221;7577;638;2333;617;2084;1255;4417
352520;201703;1908;6655;1676;6095;448;1703;638;2311;1086;4014
352530;201703;8389;26347;6248;21343;1552;5706;857;2417;2409;8123
352540;201703;525;1635;375;1289;65;239;107;360;172;599
352550;201703;839;2728;617;2219;143;579;121;407;264;986
352560;201703;614;1819;426;1380;70;224;101;291;171;515
352570;201703;1795;5733;1310;4699;337;1349;205;629;542;1978
352580;201703;824;2469;646;2103;100;363;221;652;321;1015
352585;201703;261;823;212;712;38;142;73;239;111;381
352590;201703;11886;36090;9663;31792;3229;11261;3446;10500;6675;21761
352600;201703;1746;5312;1407;4542;298;1043;580;1774;878;2817
352610;201703;3214;9806;2555;8603;643;2409;761;2402;1404;4811
352620;201703;5140;15413;4560;14453;1128;3673;2054;6471;3182;10144
352630;201703;601;1861;550;1741;134;504;223;635;357;1139
352640;201703;2494;7437;2109;6736;202;720;1394;4407;1596;5127
352650;201703;744;2244;558;1798;96;340;146;435;242;775
352660;201703;922;3267;779;2949;177;729;211;799;388;1528
352670;201703;10731;31763;6559;22533;1553;5934;466;1536;2019;7470
352680;201703;2847;9322;2197;7881;452;1847;790;2618;1242;4465
352690;201703;30694;83701;22214;66901;2865;9668;11592;33333;14457;43001
352700;201703;576;1728;491;1596;153;546;184;568;337;1114
352710;201703;5370;15366;3992;12627;984;3506;1346;4014;2330;7520
352720;201703;7615;24177;6747;22223;2378;8020;1759;5617;4137;13637
352725;201703;426;1175;222;729;28;108;95;285;123;393
352730;201703;2128;6921;1915;6344;418;1530;830;2468;1248;3998
352740;201703;2115;5565;1638;4818;199;692;943;2675;1142;3367
352750;201703;457;1302;242;821;31;121;49;148;80;269
352760;201703;1215;4066;985;3475;279;1047;292;978;571;2025
352770;201703;753;2321;620;2040;144;515;241;768;385;1283
352780;201703;647;2141;512;1810;102;395;164;568;266;963
352790;201703;637;1815;455;1479;74;246;128;417;202;663
352800;201703;1067;3762;792;3016;170;699;216;751;386;1450
352810;201703;1022;2651;642;1908;124;374;211;606;335;980
352820;201703;615;1637;435;1354;93;318;97;288;190;606
352830;201703;498;1426;298;939;47;155;44;117;91;272
352840;201703;3841;12652;3433;11806;926;3361;1418;4753;2344;8114
352850;201703;9799;27550;7304;23524;1898;6581;2529;7987;4427;14568
352860;201703;800;2713;730;2551;146;570;287;952;433;1522
352870;201703;890;2243;588;1599;70;240;302;733;372;973
352880;201703;2184;5878;1568;4700;247;775;658;1800;905;2575
352885;201703;255;807;220;739;28;87;142;473;170;560
352890;201703;663;1715;458;1293;64;217;197;485;261;702
352900;201703;18945;54551;13754;44059;2771;9790;5023;15218;7794;25008
352910;201703;370;1058;211;703;24;86;48;142;72;228
352920;201703;2372;6967;1796;5757;313;1138;810;2421;1123;3559
352930;201703;5515;17025;4445;14692;909;3221;1493;4724;2402;7945
352940;201703;21132;66874;17522;58816;5820;21330;1921;5785;7741;27115
352950;201703;356;1017;225;772;59;221;27;84;86;305
352960;201703;591;1748;353;1188;61;234;104;293;165;527
352965;201703;370;1059;228;735;56;191;36;102;92;293
352970;201703;3154;7816;2533;6888;207;617;1797;4878;2004;5495
352980;201703;1068;3368;913;3120;178;613;512;1817;690;2430
352990;201703;4028;12399;3534;11535;884;3247;1557;4795;2441;8042
353000;201703;441;1246;228;760;38;136;46;151;84;287
353010;201703;2889;7886;2095;6344;503;1724;585;1602;1088;3326
353020;201703;3998;10795;2334;7214;332;1089;763;2154;1095;3243
353030;201703;3475;10152;2740;8745;782;2648;511;1579;1293;4227
353040;201703;471;1330;389;1171;76;249;121;340;197;589
353050;201703;4666;15301;3788;13461;1023;3872;1329;4509;2352;8381
353060;201703;41180;118420;35680;109317;3813;14067;24636;72496;28449;86563
353070;201703;9929;30318;7231;24584;1661;6083;1921;6510;3582;12593
353080;201703;4728;14631;3344;11671;784;3007;859;2779;1643;5786
353090;201703;526;1776;478;1663;47;191;294;962;341;1153
353100;201703;291;816;129;437;21;76;23;62;44;138
353110;201703;7075;21581;6178;20145;1092;3899;3816;12482;4908;16381
353120;201703;647;1919;425;1408;81;306;112;328;193;634
353130;201703;2369;6680;1772;5721;555;1941;548;1721;1103;3662
353140;201703;2138;5873;1709;5036;324;1055;821;2273;1145;3328
353150;201703;1550;4618;1235;4050;331;1086;341;1121;672;2207
353160;201703;657;1795;425;1343;77;263;128;342;205;605
353170;201703;425;1288;371;1222;82;359;191;575;273;934
353180;201703;8701;24177;7024;21359;1067;3532;4148;12513;5215;16045
353190;201703;3542;10538;2861;9044;443;1567;1488;4404;1931;5971
353200;201703;1075;3549;807;2806;209;794;195;648;404;1442
353205;201703;346;1154;313;1073;72;262;146;497;218;759
353210;201703;1020;2545;663;1880;39;148;411;1126;450;1274
353215;201703;419;1282;344;1110;61;233;110;308;171;541
353220;201703;610;1862;485;1608;120;414;105;333;225;747
353230;201703;685;2227;617;2108;158;593;179;574;337;1167
353240;201703;2053;6441;1765;5880;297;1138;967;3110;1264;4248
353250;201703;1055;2823;787;2319;119;368;344;974;463;1342
353260;201703;844;2354;597;1885;116;407;184;544;300;951
353270;201703;606;1785;521;1616;90;278;227;682;317;960
353280;201703;580;1878;449;1547;117;437;96;315;213;752
353282;201703;1768;5520;1620;5227;219;787;960;3005;1179;3792
353284;201703;359;956;205;638;39;127;48;136;87;263
353286;201703;127;385;91;309;25;87;15;47;40;134
353290;201703;846;2586;690;2280;89;362;388;1177;477;1539
353300;201703;1410;4367;1168;3833;251;952;412;1214;663;2166
353310;201703;216;614;177;563;44;155;67;206;111;361
353320;201703;581;1663;483;1472;60;185;268;803;328;988
353325;201703;618;2009;491;1720;74;264;148;517;222;781
353330;201703;589;1645;417;1260;52;182;212;602;264;784
353340;201703;2747;7976;1895;6356;562;1997;469;1616;1031;3613
353350;201703;3176;9516;2376;7773;673;2367;555;1674;1228;4041
353360;201703;441;1435;401;1347;48;178;250;832;298;1010
353370;201703;587;1916;508;1740;57;237;280;909;337;1146
353380;201703;307;1015;248;885;49;197;72;244;121;441
353390;201703;5690;15537;4121;12649;848;2711;1405;4197;2253;6908
353400;201703;453;1388;381;1244;76;280;82;210;158;490
353410;201703;599;1753;501;1566;101;364;241;712;342;1076
353420;201703;570;1610;362;1129;94;288;74;222;168;510
353430;201703;2085;6910;1569;5670;411;1585;276;948;687;2533
353440;201703;54416;169971;42744;144256;11260;39589;15237;50254;26497;89843
353450;201703;399;1164;301;944;58;218;106;303;164;521
353460;201703;3156;9021;2478;7709;293;1082;1116;3475;1409;4557
353470;201703;7217;21474;5386;17869;1220;4510;1356;4218;2576;8728
353475;201703;1418;4028;1057;3220;167;556;356;987;523;1543
353480;201703;1338;4084;1191;3788;124;407;847;2660;971;3067
353490;201703;897;2628;679;2159;156;495;249;774;405;1269
353500;201703;977;2590;801;2304;207;593;410;1179;617;1772
353510;201703;892;2853;669;2282;179;637;110;339;289;976
353520;201703;1077;3030;800;2554;119;422;363;1119;482;1541
353530;201703;2426;7002;2082;6371;285;1003;1112;3273;1397;4276
353540;201703;1898;5761;1614;5264;381;1310;728;2338;1109;3648
353550;201703;6016;16790;4892;14838;648;2282;2790;8011;3438;10293
353560;201703;2019;6615;1672;5982;518;2019;412;1386;930;3405
353570;201703;496;1464;374;1217;91;289;156;491;247;780
353580;201703;2311;6687;1991;6133;301;1028;1241;3766;1542;4794
353590;201703;650;1916;452;1466;95;340;161;508;256;848
353600;201703;1745;4803;1519;4366;187;602;805;2223;992;2825
353610;201703;597;2021;448;1686;89;362;85;300;174;662
353620;201703;2221;6950;1822;6146;452;1607;497;1571;949;3178
353625;201703;420;1178;269;873;36;141;118;366;154;507
353630;201703;1366;4738;1076;3993;207;846;144;448;351;1294
353640;201703;1331;3873;1002;3176;138;487;494;1540;632;2027
353650;201703;8462;24583;6370;20222;1113;3725;2554;7836;3667;11561
353657;201703;293;906;247;817;40;152;83;241;123;393
353660;201703;993;2615;718;2089;240;761;92;187;332;948
353670;201703;3397;10803;2863;9701;853;3218;1028;3217;1881;6435
353680;201703;663;2072;540;1855;155;593;204;670;359;1263
353690;201703;490;1317;257;852;37;127;43;109;80;236
353700;201703;1966;5912;1688;5362;240;849;922;2791;1162;3640
353710;201703;3274;7821;1642;5142;389;1187;340;1060;729;2247
353715;201703;529;1499;379;1199;29;110;108;320;137;430
353720;201703;1902;5785;1602;5323;315;1203;813;2573;1128;3776
353730;201703;4161;12497;3257;10537;629;2249;1173;3454;1802;5703
353740;201703;1655;4900;1237;4062;334;1193;321;1013;655;2206
353750;201703;834;2794;629;2333;140;567;135;502;275;1069
353760;201703;10081;26937;8213;24370;1135;3871;5248;15247;6383;19118
353770;201703;656;2029;352;1260;66;271;26;59;92;330
353780;201703;3950;13519;3437;12412;1044;4033;862;3067;1906;7100
353790;201703;2126;7148;1739;6319;467;1976;450;1520;917;3496
353800;201703;15867;47885;12697;42137;3037;10940;5006;16287;8043;27227
353810;201703;974;3131;759;2650;141;564;246;827;387;1391
353820;201703;1381;4560;1208;4146;231;909;574;1876;805;2785
353830;201703;615;1646;486;1436;70;213;263;748;333;961
353850;201703;1638;5044;1404;4548;372;1255;512;1635;884;2890
353860;201703;2471;7990;2028;7000;549;1993;542;1879;1091;3872
353870;201703;27518;79238;19515;63071;3509;12626;7084;20841;10593;33467
353880;201703;2664;8366;2255;7609;302;1177;1234;4109;1536;5286
353890;201703;2321;5702;1629;4566;252;789;845;2255;1097;3044
353900;201703;789;2437;594;2047;128;474;163;554;291;1028
353910;201703;1532;5310;1411;5096;227;836;916;3400;1143;4236
353920;201703;2264;6601;1577;5210;339;1239;286;835;625;2074
353930;201703;4375;13088;3126;10761;803;3066;507;1671;1310;4737
353940;201703;1091;3505;833;2892;155;572;239;783;394;1355
353950;201703;3061;9542;2598;8588;525;1889;1235;3824;1760;5713
353960;201703;538;1677;385;1330;84;304;84;258;168;562
353970;201703;575;1626;464;1441;53;190;284;869;337;1059
353980;201703;13420;39299;11270;35257;2226;7343;5652;17260;7878;24603
353990;201703;404;1236;361;1144;44;163;202;612;246;775
354000;201703;2254;6101;1387;4395;262;902;164;509;426;1411
354010;201703;357;1077;298;968;58;197;172;562;230;759
354020;201703;4005;12476;3425;11230;878;3126;1037;3127;1915;6253
354025;201703;830;2317;590;1870;110;364;205;654;315;1018
354030;201703;464;1238;295;908;42;154;123;352;165;506
354040;201703;753;2019;504;1529;38;126;302;857;340;983
354050;201703;893;2806;695;2398;178;670;136;438;314;1108
354060;201703;4654;14319;3235;11079;853;3066;808;2592;1661;5658
354070;201703;2676;8853;2243;7841;582;2182;441;1429;1023;3611
354075;201703;1875;6771;1682;6317;357;1511;817;2966;1174;4477
354080;201703;1321;4031;942;3183;157;572;317;992;474;1564
354085;201703;318;778;293;744;10;41;234;575;244;616
354090;201703;1320;3884;1249;3746;134;467;837;2484;971;2951
354100;201703;13885;46188;11493;41524;2926;11329;4713;16698;7639;28027
354105;201703;922;2643;804;2468;117;387;524;1599;641;1986
354110;201703;695;1891;536;1663;182;630;115;320;297;950
354120;201703;1882;5195;1333;4075;225;757;541;1529;766;2286
354130;201703;6094;17337;4429;14105;1588;5359;316;861;1904;6220
354140;201703;25623;64409;16265;47663;3420;10753;4640;12724;8060;23477
354150;201703;3695;9899;2815;8326;513;1647;1246;3572;1759;5219
354160;201703;3237;10352;2537;8762;636;2299;835;2850;1471;5149
354165;201703;508;1659;430;1497;106;418;177;610;283;1028
354170;201703;1333;4172;1061;3533;165;594;467;1499;632;2093
354180;201703;455;1404;388;1252;61;232;158;435;219;667
354190;201703;1439;4490;1178;3935;256;937;376;1219;632;2156
354200;201703;941;2621;732;2237;92;309;344;972;436;1281
354210;201703;621;1945;515;1747;73;302;276;863;349;1165
354220;201703;2909;8343;2403;7381;455;1506;1171;3490;1626;4996
354230;201703;592;1915;528;1778;87;349;248;782;335;1131
354240;201703;1182;3842;877;3129;166;652;190;635;356;1287
354250;201703;656;1820;428;1432;129;454;111;398;240;852
354260;201703;7277;21494;5920;19105;1581;5377;1836;6137;3417;11514
354270;201703;1108;3642;910;3209;179;690;308;1067;487;1757
354280;201703;691;2016;618;1886;114;434;359;1003;473;1437
354290;201703;898;3163;802;2922;177;674;319;1160;496;1834
354300;201703;3695;11903;3430;11400;941;3249;1580;5154;2521;8403
354310;201703;800;2424;647;2120;139;469;316;1025;455;1494
354320;201703;712;2119;569;1832;130;495;208;597;338;1092
354323;201703;460;1254;335;1012;59;184;121;328;180;512
354325;201703;1197;3873;908;3213;159;603;326;1066;485;1669
354330;201703;6248;18355;4924;15749;965;3538;2307;6808;3272;10346
354340;201703;23081;69631;18690;61878;5112;18403;6905;22111;12017;40514
354350;201703;1056;3098;939;2860;190;663;521;1478;711;2141
354360;201703;441;1387;274;1001;46;156;15;56;61;212
354370;201703;1089;3617;932;3290;106;459;507;1726;613;2185
354380;201703;784;2353;594;1961;168;637;108;309;276;946
354390;201703;12964;36895;8852;29036;1804;6372;1705;5526;3509;11898
354400;201703;1510;5221;1232;4528;289;1138;362;1315;651;2453
354410;201703;5204;15841;4276;14024;1074;3793;1651;5268;2725;9061
354420;201703;1181;3511;865;2789;179;609;363;1144;542;1753
354425;201703;2073;5929;1763;5328;519;1645;476;1460;995;3105
354430;201703;1305;4194;1161;3908;238;920;497;1599;735;2519
354440;201703;517;1531;365;1207;43;155;144;442;187;597
354450;201703;394;1137;234;780;32;118;39;122;71;240
354460;201703;971;2686;676;2100;122;419;291;910;413;1329
354470;201703;590;1559;462;1308;38;139;231;590;269;729
354480;201703;712;1938;568;1695;65;203;333;953;398;1156
354490;201703;714;2368;584;2053;76;296;262;885;338;1181
354500;201703;2036;6517;1814;6156;663;2512;397;1314;1060;3826
354510;201703;812;2238;741;2106;98;252;446;1259;544;1511
354515;201703;248;812;196;695;39;155;66;232;105;387
354520;201703;7848;25226;4522;15550;811;3214;1910;6069;2721;9283
354530;201703;3128;10544;2763;9748;709;2725;1121;3870;1830;6595
354540;201703;1156;3478;937;3065;310;1084;190;617;500;1701
354550;201703;467;1361;373;1186;78;272;187;573;265;845
354560;201703;1721;4725;1020;3155;149;480;432;1258;581;1738
354570;201703;1055;2940;498;1601;81;295;71;200;152;495
354580;201703;10395;28901;7203;23025;1283;4487;2729;8222;4012;12709
354600;201703;1578;5030;1341;4580;243;971;692;2281;935;3252
354610;201703;354;1022;204;669;24;84;65;200;89;284
354620;201703;384;1209;302;1059;59;257;134;432;193;689
354625;201703;285;881;184;646;27;106;46;128;73;234
354630;201703;2105;6905;1834;6343;747;2737;248;815;995;3552
354640;201703;3096;10121;2400;8467;504;2016;488;1506;992;3522
354650;201703;841;2461;716;2200;73;250;474;1463;547;1713
354660;201703;2336;6398;1689;5287;145;536;1074;3311;1219;3847
354670;201703;1086;3344;832;2730;198;715;200;602;398;1317
354680;201703;4274;13698;3882;12915;1025;3586;1811;5949;2836;9535
354690;201703;743;2398;507;1826;94;359;121;418;215;777
354700;201703;1075;3006;748;2298;154;561;308;839;462;1400
354710;201703;516;1516;378;1218;31;127;179;513;210;640
354720;201703;260;703;143;454;41;132;19;58;60;190
354730;201703;8669;26703;6499;22504;1261;4806;2941;9853;4202;14659
354740;201703;265;798;134;486;14;60;21;78;35;138
354750;201703;2242;6993;1759;5949;409;1569;638;2014;1047;3583
354760;201703;1794;5641;1430;4875;477;1740;213;733;690;2473
354765;201703;300;847;144;489;18;64;24;77;42;141
354770;201703;2231;6129;1680;5165;535;1758;517;1533;1052;3291
354780;201703;54727;150002;45512;131100;6960;22583;24457;66382;31417;88965
354790;201703;796;2602;706;2416;120;428;349;1174;469;1602
354800;201703;2298;6572;1934;6031;415;1434;964;2908;1379;4342
354805;201703;982;2886;717;2323;86;323;211;594;297;917
354810;201703;548;1757;343;1273;61;262;59;204;120;466
354820;201703;929;3127;773;2792;160;655;171;557;331;1212
354830;201703;447;1185;325;965;96;296;118;325;214;621
354840;201703;696;1992;513;1604;91;287;245;750;336;1037
354850;201703;16778;50357;12385;41642;2395;9111;5698;17816;8093;26927
354860;201703;1292;4022;1098;3691;259;996;405;1242;664;2238
354870;201703;45414;129829;39443;117993;7859;25575;18607;53962;26466;79537
354880;201703;4277;11748;2336;7447;339;1264;745;1996;1084;3260
354890;201703;14971;43039;12580;38765;2597;8662;5707;17027;8304;25689
354900;201703;423;1303;312;1053;55;204;74;235;129;439
354910;201703;6053;17912;3632;12785;655;2614;184;589;839;3203
354920;201703;379;1112;231;797;40;166;47;146;87;312
354925;201703;217;686;121;444;24;93;20;62;44;155
354930;201703;302;767;168;537;24;74;69;221;93;295
354940;201703;1630;5843;1345;5088;463;1874;133;475;596;2349
354950;201703;1436;4476;1197;4060;159;686;671;2160;830;2846
354960;201703;731;2240;642;2093;119;439;297;928;416;1367
354970;201703;3828;12340;3322;11289;566;2216;1774;5784;2340;8000
354980;201703;27052;70810;18359;55650;3039;10567;7526;21104;10565;31671
354990;201703;55023;156772;42860;133285;6841;23148;21331;64258;28172;87406
354995;201703;1806;5373;1478;4830;348;1208;749;2398;1097;3606
355000;201703;1304;4174;1160;3916;299;1178;230;656;529;1834
355010;201703;3307;10196;2485;8211;789;2805;484;1618;1273;4423
355020;201703;2843;9210;2182;7858;746;2967;557;1926;1303;4893
355030;201703;1157234;3078893;946737;2674536;197417;607957;421720;1132731;619137;1740688
355040;201703;2537;7661;2255;7169;382;1312;1399;4374;1781;5686
355050;201703;1066;3199;827;2723;250;837;144;470;394;1307
355060;201703;4263;13766;3443;12059;695;2797;1180;3766;1875;6563
355070;201703;6576;19978;5724;18535;1104;4056;2943;8979;4047;13035
355080;201703;844;2839;591;2248;101;445;36;121;137;566
355090;201703;1044;3529;880;3174;170;649;308;1105;478;1754
355100;201703;15609;47691;12951;43142;3059;11171;6624;21538;9683;32709
355110;201703;1080;3494;908;3178;285;1097;167;542;452;1639
355120;201703;605;1858;477;1607;90;354;186;604;276;958
355130;201703;633;1591;291;858;42;135;88;234;130;369
355140;201703;1127;3639;1037;3485;197;755;605;2068;802;2823
355150;201703;3427;9876;2797;8799;567;1926;1316;4115;1883;6041
355160;201703;1695;5262;1402;4760;402;1468;342;1132;744;2600
355170;201703;7926;22526;6243;19753;2043;6795;1909;6210;3952;13005
355180;201703;2694;8320;2165;7330;531;2171;687;2082;1218;4253
355190;201703;1365;4193;1151;3796;366;1328;352;1254;718;2582
355200;201703;743;2595;672;2436;277;1069;158;534;435;1603
355210;201703;2735;8407;2424;7733;296;1137;1529;4659;1825;5796
355220;201703;36388;108075;29751;94878;9363;31752;8056;23851;17419;55603
355230;201703;1425;3819;836;2587;157;479;189;536;346;1015
355240;201703;23682;67178;16506;52490;3581;12056;5514;17243;9095;29299
355250;201703;28751;87688;23649;77921;6483;22961;8016;25819;14499;48780
355255;201703;871;2378;528;1677;100;337;144;453;244;790
355260;201703;1165;3446;975;3116;199;733;437;1276;636;2009
355270;201703;1558;4812;1322;4278;237;810;614;1850;851;2660
355280;201703;26799;76305;21398;65692;3977;13366;9043;26694;13020;40060
355290;201703;870;2734;686;2278;151;501;201;630;352;1131
355300;201703;1288;4078;1059;3588;233;848;308;1024;541;1872
355310;201703;1013;2968;801;2601;119;427;432;1416;551;1843
355320;201703;566;1727;493;1574;98;367;195;547;293;914
355330;201703;1851;5578;1373;4621;251;926;641;2069;892;2995
355340;201703;2699;6772;2383;6290;357;946;1490;3898;1847;4844
355350;201703;1286;4247;1017;3651;245;959;287;1002;532;1961
355360;201703;1147;3575;1019;3285;168;571;635;2094;803;2665
355365;201703;329;967;203;714;47;168;36;117;83;285
355370;201703;6725;17241;5242;15288;1316;4103;2207;6799;3523;10902
355380;201703;3093;9095;2439;7707;542;1844;601;1671;1143;3515
355385;201703;1016;3238;913;3028;251;897;313;985;564;1882
355390;201703;814;2367;615;1953;126;447;222;603;348;1050
355395;201703;1865;5639;1385;4510;198;650;586;1826;784;2476
355400;201703;8938;29035;7654;26380;2343;8731;2048;6770;4391;15501
355410;201703;18157;56757;14183;48813;4070;15351;2718;9491;6788;24842
355420;201703;687;2436;616;2292;175;761;170;624;345;1385
355430;201703;3596;9737;2891;8538;539;1730;1413;4075;1952;5805
355440;201703;869;2633;618;2064;124;418;163;505;287;923
355450;201703;3721;10569;2196;7212;439;1534;626;1914;1065;3448
355460;201703;553;1477;362;1126;66;253;128;335;194;588
355465;201703;336;1076;265;921;55;204;64;211;119;415
355470;201703;812;2391;583;1932;161;552;206;664;367;1216
355475;201703;171;525;165;513;33;125;110;323;143;448
355480;201703;2987;10156;2708;9602;587;2275;1364;4759;1951;7034
355490;201703;978;2785;612;2004;88;290;192;609;280;899
355495;201703;762;2514;651;2285;143;556;167;558;310;1114
355500;201703;6848;20013;4558;14856;852;3005;856;2622;1708;5627
355510;201703;1851;4916;1003;3208;152;561;271;782;423;1343
355520;201703;422;991;212;588;26;80;101;256;127;336
355530;201703;429;1029;175;546;24;87;43;120;67;207
355535;201703;614;1844;491;1617;147;547;134;378;281;925
355540;201703;7843;24317;7372;23545;1714;5815;4029;12587;5743;18402
355550;201703;735;2255;602;1988;106;391;237;772;343;1163
355560;201703;1142;3425;694;2393;144;555;41;115;185;670
355570;201703;195;622;116;420;19;72;13;46;32;118
355580;201703;1189;3281;806;2545;126;453;320;988;446;1441
355590;201703;211;563;163;478;19;66;93;262;112;328
355600;201703;1231;3586;959;3018;290;996;295;892;585;1888
355610;201703;1617;4439;1187;3633;203;671;533;1576;736;2247
355620;201703;4248;13103;3409;11175;556;2121;1583;4759;2139;6880
355630;201703;2668;7764;1819;6093;396;1361;531;1826;927;3187
355635;201703;909;2890;777;2673;84;323;539;1882;623;2205
355640;201703;2672;8469;1927;6957;418;1621;334;1214;752;2835
355645;201703;3737;12005;3205;11155;463;1907;1911;6549;2374;8456
355650;201703;7193;21282;6234;19488;1206;4343;3641;10579;4847;14922
355660;201703;1282;3914;1017;3330;151;624;507;1495;658;2119
355670;201703;2832;8752;2071;6895;379;1432;895;2657;1274;4089
355680;201703;1550;5101;1118;4015;283;1083;156;540;439;1623
355690;201703;485;1518;344;1228;124;461;19;50;143;511
355695;201703;243;788;145;516;11;42;14;44;25;86
355700;201703;5316;17093;4494;15231;1142;3954;1741;5817;2883;9771
355710;201703;9307;22982;5566;16171;1136;3524;1479;4064;2615;7588
355715;201703;325;950;214;703;57;205;46;143;103;348
355720;201703;1434;4717;1189;4175;260;1000;417;1305;677;2305
355730;201703;840;2720;706;2394;223;763;187;599;410;1362
410010;201703;1325;4091;1124;3637;261;942;196;628;457;1570
410020;201703;1154;3692;972;3280;268;916;354;1194;622;2110
410030;201703;1092;3680;903;3227;248;920;167;620;415;1540
410040;201703;9531;30662;8198;28160;1906;7246;2604;8901;4510;16147
410045;201703;1010;2815;717;2260;154;542;184;520;338;1062
410050;201703;2648;7155;1689;5336;447;1512;184;498;631;2010
410060;201703;2147;6555;1847;5928;378;1227;760;2481;1138;3708
410070;201703;1672;4677;1268;3877;348;1153;346;1044;694;2197
410080;201703;1400;3932;1085;3344;195;692;440;1271;635;1963
410090;201703;976;2974;915;2853;183;623;398;1277;581;1900
410100;201703;2619;8000;1963;6412;368;1403;258;784;626;2187
410105;201703;352;1085;226;778;40;170;37;104;77;274
410110;201703;2854;8205;2255;7025;350;1206;724;2215;1074;3421
410115;201703;524;1408;398;1174;74;235;136;367;210;602
410120;201703;2408;8295;2234;7935;851;3205;588;2109;1439;5314
410130;201703;1092;3362;1023;3209;379;1301;262;725;641;2026
410140;201703;17322;44557;11275;33741;2276;7471;2523;7089;4799;14560
410150;201703;15089;38733;8167;24464;1584;5075;1273;3601;2857;8676
410160;201703;2882;8816;2580;8249;595;2126;960;3130;1555;5256
410165;201703;699;2031;561;1712;93;299;265;751;358;1050
410170;201703;2222;6325;1659;5073;440;1473;243;718;683;2191
410180;201703;11320;35407;9705;31741;1965;6926;4332;13324;6297;20250
410185;201703;522;1444;389;1183;90;282;79;213;169;495
410190;201703;2004;5858;1607;5007;351;1201;274;802;625;2003
410200;201703;3721;10211;2644;8121;563;1987;391;1162;954;3149
410210;201703;2598;7600;1855;5942;318;1179;398;1043;716;2222
410220;201703;650;1754;482;1446;76;265;139;418;215;683
410230;201703;1458;4500;1252;4075;249;930;524;1640;773;2570
410240;201703;4220;12657;3785;11756;1215;4312;549;1625;1764;5937
410250;201703;2675;7276;1876;5679;414;1362;369;1112;783;2474
410260;201703;1569;4453;1231;3874;256;886;517;1632;773;2518
410270;201703;565;1553;445;1312;53;175;205;587;258;762
410275;201703;782;2373;532;1772;79;283;228;762;307;1045
410280;201703;2101;6071;1520;4863;349;1259;395;1159;744;2418
410290;201703;3334;9939;2743;8810;585;1941;1074;3461;1659;5402
410300;201703;702;1954;578;1693;104;349;243;629;347;978
410302;201703;430;1178;254;825;28;96;131;429;159;525
410304;201703;1189;3749;1080;3511;276;949;431;1436;707;2385
410305;201703;1819;4916;1455;4292;333;1034;696;2042;1029;3076
410310;201703;2253;7101;1982;6617;436;1626;682;2277;1118;3903
410315;201703;677;1892;424;1410;63;232;131;412;194;644
410320;201703;1193;3620;797;2691;118;456;100;319;218;775
410322;201703;557;1625;333;1113;49;160;83;274;132;434
410330;201703;1324;3661;1065;3144;250;784;253;742;503;1526
410335;201703;913;2673;779;2408;130;459;322;901;452;1360
410337;201703;787;2060;560;1631;84;279;193;514;277;793
410340;201703;547;1539;372;1093;51;177;152;375;203;552
410345;201703;1842;5299;1270;4056;298;982;315;976;613;1958
410347;201703;726;1943;524;1565;58;207;162;457;220;664
410350;201703;1064;3154;799;2633;151;560;187;560;338;1120
410360;201703;3892;10307;3029;8772;348;1172;1582;4439;1930;5611
410370;201703;11699;34045;8468;26325;1495;5159;2471;6767;3966;11926
410380;201703;1320;3775;1188;3490;145;532;530;1511;675;2043
410390;201703;2344;7000;1843;5907;579;1959;368;1091;947;3050
410395;201703;871;2856;767;2635;202;756;339;1169;541;1925
410400;201703;4301;13179;3478;11384;692;2447;1259;3963;1951;6410
410405;201703;815;2318;669;2054;166;571;233;684;399;1255
410410;201703;1202;3696;1165;3646;279;1088;611;1815;890;2903
410420;201703;6568;21129;5367;18433;1350;5100;747;2248;2097;7348
410425;201703;2706;8498;2046;7059;391;1464;313;998;704;2462
410430;201703;13709;36750;10030;29973;1871;6147;2845;8135;4716;14282
410440;201703;2690;8873;2399;8311;542;2005;1077;3821;1619;5826
410442;201703;2577;8484;2268;7797;668;2411;668;2271;1336;4682
410445;201703;2304;7389;1962;6742;501;1912;632;2241;1133;4153
410450;201703;1903;5392;1464;4510;346;1166;183;427;529;1593
410460;201703;1623;4737;1273;4077;368;1243;258;772;626;2015
410465;201703;2236;7186;1883;6429;428;1513;647;2106;1075;3619
410470;201703;1753;5564;1383;4726;296;1147;271;924;567;2071
410480;201703;30796;85617;18687;60441;3035;10597;1498;4326;4533;14923
410490;201703;11213;33775;8424;27862;1850;6757;2250;6917;4100;13674
410500;201703;1514;4740;1195;3991;391;1446;167;479;558;1925
410510;201703;2421;6339;1628;4751;310;919;514;1406;824;2325
410520;201703;2996;10263;2812;9876;798;2923;1276;4536;2074;7459
410530;201703;1487;4093;955;2885;167;548;168;425;335;973
410540;201703;2895;8522;2069;6762;398;1408;690;2216;1088;3624
410550;201703;6137;17606;4353;13781;886;3092;608;1735;1494;4827
410560;201703;1243;3651;970;3118;254;906;303;876;557;1782
410570;201703;2587;8049;2279;7529;622;2257;637;2315;1259;4572
410580;201703;21879;64516;17813;56463;4055;14351;5797;17197;9852;31548
410590;201703;1373;4224;903;2975;157;559;188;532;345;1091
410600;201703;1813;5227;1442;4506;351;1097;467;1494;818;2591
410610;201703;733;2040;571;1737;64;205;212;622;276;827
410620;201703;1715;5681;1257;4547;315;1240;126;413;441;1653
410630;201703;2404;7149;1661;5447;359;1312;160;418;519;1730
410640;201703;4579;12435;3340;10100;853;2963;502;1406;1355;4369
410645;201703;1122;3804;1039;3662;458;1682;246;929;704;2611
410650;201703;2073;6406;1672;5531;540;1893;269;832;809;2725
410655;201703;1312;4736;1081;4277;76;285;680;2997;756;3282
410657;201703;770;2120;543;1650;119;399;175;463;294;862
410660;201703;2975;8328;1657;5380;333;1120;171;571;504;1691
410670;201703;905;2482;618;1866;123;385;219;633;342;1018
410680;201703;2831;9112;2240;7661;696;2340;498;1842;1194;4182
410685;201703;627;1782;532;1610;87;313;292;846;379;1159
410690;201703;114044;323974;80541;254042;15838;55377;20228;56407;36066;111784
410700;201703;2091;6176;1907;5805;461;1480;839;2440;1300;3920
410710;201703;905;2608;601;1947;147;494;145;408;292;902
410712;201703;784;2361;685;2170;240;823;221;706;461;1529
410715;201703;885;2817;641;2213;137;497;158;533;295;1030
410720;201703;3044;9076;2368;7671;426;1509;402;1165;828;2674
410725;201703;1086;3025;747;2361;130;421;114;336;244;757
410730;201703;478;1378;376;1199;102;349;77;253;179;602
410740;201703;895;2636;644;2129;108;417;264;854;372;1271
410750;201703;1806;5250;1489;4604;308;1029;472;1384;780;2413
410752;201703;303;810;150;476;30;97;35;93;65;190
410753;201703;357;1053;222;742;30;105;44;133;74;238
410754;201703;1167;3311;1002;3047;69;205;620;2061;689;2266
410755;201703;809;1993;597;1651;68;229;331;856;399;1085
410760;201703;2551;7503;2160;6814;574;1991;626;1952;1200;3943
410765;201703;14505;43515;11286;37255;2011;7513;1001;3154;3012;10667
410770;201703;885;2435;620;1913;133;435;117;363;250;798
410773;201703;1325;3707;1179;3498;182;622;834;2412;1016;3034
410775;201703;1398;3967;1266;3769;315;1030;409;1214;724;2244
410780;201703;545;1482;370;1113;89;273;103;343;192;616
410785;201703;777;2394;656;2136;175;627;183;575;358;1202
410790;201703;457;1490;394;1324;117;412;38;104;155;516
410800;201703;2802;6929;2202;5934;295;924;830;2123;1125;3047
410810;201703;338;1022;273;893;42;159;113;364;155;523
410820;201703;782;2330;564;1818;128;431;77;253;205;684
410830;201703;29277;82060;23241;71404;6370;21601;7319;21639;13689;43240
410832;201703;984;2812;837;2520;99;378;471;1331;570;1709
410840;201703;6658;19142;4405;14403;1015;3631;389;1028;1404;4659
410845;201703;1187;3506;1001;3130;211;721;386;1173;597;1894
410850;201703;2612;7798;2312;7275;537;1888;856;2716;1393;4604
410855;201703;579;1597;428;1285;73;246;161;447;234;693
410860;201703;3777;10670;3039;9187;568;1876;919;2641;1487;4517
410865;201703;1434;4719;1366;4593;364;1316;715;2461;1079;3777
410870;201703;1237;3653;1129;3491;116;403;776;2425;892;2828
410880;201703;3670;11540;3043;10229;609;2240;441;1541;1050;3781
410890;201703;904;2922;698;2461;177;684;99;339;276;1023
410895;201703;1044;3584;934;3333;363;1403;190;635;553;2038
410900;201703;912;2490;610;1893;85;294;182;514;267;808
410910;201703;385;984;269;769;23;78;141;380;164;458
410920;201703;815;2265;660;2005;169;581;215;645;384;1226
410930;201703;1547;4594;1275;4030;358;1292;319;969;677;2261
410940;201703;20763;65235;17324;58651;5358;19608;3221;11162;8579;30770
410950;201703;1786;5705;1656;5487;123;455;1278;4209;1401;4664
410960;201703;7504;20503;4695;15197;1332;4730;1031;3217;2363;7947
410965;201703;1057;3094;823;2612;213;699;276;831;489;1530
410970;201703;4098;12047;3184;10239;847;3134;497;1505;1344;4639
410975;201703;1563;4350;1212;3669;221;768;410;1208;631;1976
410980;201703;6261;17475;4143;13328;682;2458;1236;3836;1918;6294
410990;201703;956;2775;608;2021;187;693;83;225;270;918
411000;201703;493;1465;352;1158;62;233;66;171;128;404
411005;201703;471;1386;298;978;53;198;48;142;101;340
411007;201703;2294;7136;2012;6559;527;1835;587;1903;1114;3738
411010;201703;3987;13377;3608;12534;1063;3951;426;1440;1489;5391
411020;201703;2407;7352;2091;6793;639;2234;625;1970;1264;4204
411030;201703;658;1765;450;1314;71;236;132;334;203;570
411040;201703;747;2131;337;1094;62;213;64;200;126;413
411050;201703;1912;6546;1702;6098;528;2041;248;795;776;2836
411060;201703;1553;4623;1149;3744;241;937;148;454;389;1391
411065;201703;327;967;263;845;53;177;101;326;154;503
411070;201703;6039;17698;4860;15352;1131;3940;1332;3922;2463;7862
411080;201703;2087;6147;1850;5711;454;1564;546;1679;1000;3243
411090;201703;799;2043;553;1621;69;232;88;242;157;474
411095;201703;1382;3849;1004;3061;157;527;228;626;385;1153
411100;201703;1156;3377;831;2660;121;474;197;617;318;1091
411110;201703;555;1625;286;982;31;128;19;51;50;179
411120;201703;1572;4723;1189;3857;332;1251;265;749;597;2000
411125;201703;4096;13201;3839;12689;958;3337;1481;4963;2439;8300
411130;201703;654;1925;483;1564;107;348;138;481;245;829
411140;201703;2166;7265;1858;6511;445;1632;747;2675;1192;4307
411150;201703;3876;10864;2915;8933;642;2171;299;778;941;2949
411155;201703;947;2591;672;2082;87;290;272;798;359;1088
411160;201703;266;761;209;645;38;123;53;164;91;287
411170;201703;731;2270;587;1935;135;474;194;627;329;1101
411180;201703;5514;16139;4473;14146;920;3182;1493;4724;2413;7906
411190;201703;1377;3939;1122;3416;283;930;233;625;516;1555
411200;201703;4338;12678;3440;11105;909;3200;997;3132;1906;6332
411210;201703;1900;5367;1521;4680;388;1356;175;475;563;1831
411220;201703;919;2621;778;2342;178;619;306;850;484;1469
411230;201703;1234;3406;813;2596;173;577;213;673;386;1250
411240;201703;1568;3722;871;2519;129;395;360;973;489;1368
411250;201703;1924;5684;1590;5076;427;1492;448;1430;875;2922
411260;201703;330;853;213;646;27;87;89;250;116;337
411270;201703;1737;5370;1521;4927;246;918;704;2169;950;3087
411275;201703;1301;3759;1027;3155;233;749;234;658;467;1407
411280;201703;1496;4286;996;3195;187;662;195;586;382;1248
411290;201703;710;2071;531;1713;123;416;166;529;289;945
411295;201703;914;2505;820;2327;117;376;334;952;451;1328
411300;201703;1169;2958;768;2182;74;234;275;712;349;946
411310;201703;812;2218;644;1924;45;154;204;606;249;760
411320;201703;5028;14514;3674;11941;956;3251;674;2058;1630;5309
411325;201703;1489;4681;1324;4330;270;926;639;2130;909;3056
411330;201703;2957;9120;2426;8044;731;2679;570;1930;1301;4609
411340;201703;744;2269;525;1744;40;166;203;639;243;805
411342;201703;687;1914;566;1679;150;478;179;488;329;966
411345;201703;887;2719;803;2558;193;668;366;1164;559;1832
411350;201703;2760;8143;2034;6641;562;2016;199;648;761;2664
411360;201703;583;1455;404;1157;42;150;147;389;189;539
411370;201703;44988;125096;35593;107725;4899;17155;16382;46217;21281;63372
411373;201703;1411;4255;1224;3923;257;971;331;1061;588;2032
411375;201703;1117;3046;824;2482;159;535;239;662;398;1197
411380;201703;1056;2918;672;2024;125;395;198;539;323;934
411390;201703;1739;5089;1360;4223;271;912;366;1040;637;1952
411400;201703;2100;5823;1660;4937;327;1062;511;1453;838;2515
411410;201703;2018;6095;1543;4999;353;1271;325;924;678;2195
411420;201703;3922;10933;2651;8334;413;1468;407;1037;820;2505
411430;201703;3258;9566;2711;8668;597;2100;1278;4014;1875;6114
411435;201703;468;1450;369;1226;77;267;138;425;215;692
411440;201703;2719;8598;2391;7888;673;2293;526;1850;1199;4143
411450;201703;2319;7003;2097;6580;448;1428;972;3195;1420;4623
411460;201703;3463;9982;1882;6394;303;1196;118;376;421;1572
411470;201703;783;2315;542;1762;88;323;101;286;189;609
411480;201703;4425;13242;3290;10982;774;2865;526;1644;1300;4509
411490;201703;1397;4171;1142;3688;234;836;278;839;512;1675
411500;201703;1826;4822;1289;3869;250;856;383;1137;633;1993
411510;201703;1978;5847;1627;5124;431;1511;273;833;704;2344
411520;201703;25359;68686;15606;48331;2616;8799;3471;9781;6087;18580
411530;201703;942;2627;676;2140;131;473;195;592;326;1065
411535;201703;487;1459;229;813;26;121;14;33;40;154
411540;201703;2984;7996;2178;6356;508;1636;581;1530;1089;3166
411545;201703;984;3163;877;2949;119;439;552;1910;671;2349
411550;201703;745;2013;605;1787;166;534;97;278;263;812
411560;201703;2194;6432;1489;4832;221;796;116;308;337;1104
411570;201703;7050;18376;5105;15244;1158;3932;1093;3356;2251;7288
411573;201703;808;2351;757;2269;86;272;492;1484;578;1756
411575;201703;1603;4924;1360;4430;325;1113;442;1452;767;2565
411580;201703;3873;10869;2556;8244;321;1243;318;862;639;2105
411585;201703;798;2524;404;1418;75;270;56;175;131;445
411590;201703;356;1061;302;961;40;140;143;423;183;563
411600;201703;312;866;215;711;48;179;81;274;129;453
411605;201703;1633;4454;1077;3279;165;580;393;1149;558;1729
411610;201703;2172;6080;1689;5113;376;1221;628;1854;1004;3075
411620;201703;2780;8492;2501;8040;529;1867;1298;4167;1827;6034
411630;201703;511;1362;347;1117;76;292;49;122;125;414
411640;201703;456;1409;348;1148;40;133;122;382;162;515
411650;201703;209;651;154;537;32;119;21;70;53;189
411660;201703;933;2470;670;1999;76;245;326;943;402;1188
411670;201703;1060;2993;842;2506;159;497;272;804;431;1301
411680;201703;1503;4396;1290;4001;241;830;631;1966;872;2796
411690;201703;3288;9592;2598;8280;592;1955;668;2230;1260;4185
411695;201703;692;2231;530;1844;99;371;173;626;272;997
411700;201703;1624;4647;1134;3675;233;839;154;461;387;1300
411705;201703;1801;6218;1594;5803;389;1415;785;3028;1174;4443
411710;201703;1648;4791;1322;4134;331;1113;236;758;567;1871
411720;201703;894;2484;706;2101;114;383;192;521;306;904
411721;201703;755;2204;603;1875;151;495;82;251;233;746
411722;201703;646;1958;416;1421;83;324;95;280;178;604
411725;201703;1365;4349;860;3091;181;680;160;592;341;1272
411727;201703;1682;4945;1216;3918;336;1123;213;643;549;1766
411729;201703;619;1596;426;1232;104;313;98;236;202;549
411730;201703;5321;15215;4463;13571;1471;4618;1132;3433;2603;8051
411740;201703;629;1761;373;1206;68;237;61;174;129;411
411745;201703;894;2574;709;2177;127;405;193;565;320;970
411750;201703;5007;14746;3863;12195;634;2176;1433;4350;2067;6526
411760;201703;7593;22013;6437;19998;2116;7004;1376;4439;3492;11443
411770;201703;3351;10810;2745;9397;781;2832;426;1416;1207;4248
411780;201703;2859;8662;2621;8251;625;2125;1301;4236;1926;6361
411790;201703;3347;9346;2216;6976;547;1883;428;1297;975;3180
411800;201703;1117;3234;764;2431;111;398;101;282;212;680
411810;201703;1682;4729;1353;4088;271;924;564;1593;835;2517
411820;201703;12708;41049;10750;36847;3724;13221;2578;9061;6302;22282
411830;201703;541;1379;414;1160;111;362;25;84;136;446
411840;201703;10220;28866;7507;23458;1653;5673;1501;4661;3154;10334
411845;201703;492;1508;304;1006;53;202;26;75;79;277
411850;201703;7377;21633;6032;18921;1604;5502;1487;4544;3091;10046
411860;201703;862;2625;693;2247;129;449;216;661;345;1110
411870;201703;824;2654;562;1934;106;416;110;346;216;762
411880;201703;2167;6241;1709;5428;455;1643;316;942;771;2585
411885;201703;972;2704;819;2432;149;551;280;767;429;1318
411890;201703;1106;3387;767;2581;118;461;46;128;164;589
411900;201703;925;2872;613;2096;137;460;68;231;205;691
411910;201703;1154;3670;876;3024;236;865;207;657;443;1522
411915;201703;17250;46171;10865;33715;2029;6861;2371;6729;4400;13590
411920;201703;866;2892;757;2626;218;867;93;266;311;1133
411925;201703;601;1692;412;1341;98;337;101;309;199;646
411930;201703;5677;18724;5010;17375;2325;8670;508;1831;2833;10501
411940;201703;3120;10312;2694;9376;753;2780;541;1761;1294;4541
411950;201703;12575;38944;10739;35406;2330;8274;4735;15362;7065;23636
411960;201703;5312;15513;4885;14736;972;3248;1978;5753;2950;9001
411965;201703;532;1480;377;1213;73;273;95;313;168;586
411970;201703;789;2123;674;1952;147;416;339;1079;486;1495
411980;201703;1609;4689;1383;4248;340;1097;413;1260;753;2357
411990;201703;32417;99126;24853;83286;5991;22255;6871;22140;12862;44395
411995;201703;2471;7326;2077;6626;609;2199;531;1607;1140;3806
412000;201703;2296;5582;1737;4649;231;774;902;2165;1133;2939
412010;201703;687;2293;546;1954;80;324;134;430;214;754
412015;201703;634;1872;525;1659;86;277;246;782;332;1059
412020;201703;347;1061;233;771;44;142;51;151;95;293
412030;201703;743;2239;533;1798;83;321;161;512;244;833
412033;201703;869;2476;601;1873;88;291;155;477;243;768
412035;201703;950;2598;601;1952;115;396;192;601;307;997
412040;201703;593;1777;440;1453;69;244;76;241;145;485
412050;201703;1762;4975;1329;4143;227;804;298;927;525;1731
412060;201703;7011;23441;6309;22050;1898;7218;1781;6190;3679;13408
412065;201703;785;2359;605;1970;130;462;177;548;307;1010
412070;201703;1308;3480;966;2776;133;416;396;1111;529;1527
412080;201703;1488;4556;937;3308;119;471;29;83;148;554
412085;201703;437;1265;152;529;18;67;14;39;32;106
412090;201703;4652;13737;4289;13082;909;2820;2254;7102;3163;9922
412100;201703;1844;5593;1470;4870;427;1527;312;1044;739;2571
412110;201703;1068;2985;732;2267;154;517;145;473;299;990
412120;201703;1644;5561;1399;4990;337;1309;400;1271;737;2580
412125;201703;640;2095;573;1942;136;504;186;603;322;1107
412130;201703;568;1711;441;1411;105;356;81;261;186;617
412135;201703;518;1434;301;939;55;172;101;289;156;461
412140;201703;1522;4464;1198;3771;263;905;213;619;476;1524
412150;201703;2983;8442;2554;7567;313;1046;1517;4358;1830;5404
412160;201703;1215;3873;753;2648;187;729;77;256;264;985
412170;201703;4534;13648;3735;12111;932;3340;1410;4324;2342;7664
412175;201703;1452;4686;1262;4289;258;947;603;2058;861;3005
412180;201703;1687;5037;1275;4238;259;1011;455;1379;714;2390
412190;201703;3337;9218;2496;7665;440;1476;856;2756;1296;4232
412200;201703;2065;6468;1516;5100;293;1043;426;1464;719;2507
412210;201703;642;1731;379;1189;72;273;52;124;124;397
412215;201703;3514;10606;3128;9865;769;2421;1610;5300;2379;7721
412217;201703;1089;3063;959;2817;81;302;674;1871;755;2173
412220;201703;5671;17916;5249;17150;1466;4785;2153;7355;3619;12140
412230;201703;2864;9285;2449;8421;478;1851;656;2104;1134;3955
412240;201703;8753;22418;5248;15921;958;3304;1057;3005;2015;6309
412250;201703;1860;5387;1561;4785;363;1184;201;526;564;1710
412260;201703;1308;3607;870;2652;120;410;302;828;422;1238
412265;201703;948;2870;829;2660;215;751;312;996;527;1747
412270;201703;847;2631;568;1942;96;372;200;640;296;1012
412280;201703;625;1917;474;1602;166;608;36;94;202;702
412290;201703;1006;2826;750;2357;143;495;233;690;376;1185
412300;201703;1629;4957;1424;4553;385;1338;312;944;697;2282
412310;201703;952;2795;799;2526;113;476;363;1141;476;1617
412320;201703;834;2222;609;1803;92;352;196;566;288;918
412330;201703;1457;4159;1054;3309;144;491;426;1344;570;1835
412340;201703;916;2850;623;2090;84;308;115;352;199;660
412350;201703;2360;7109;1671;5574;332;1199;58;136;390;1335
412360;201703;294;852;179;574;19;73;58;168;77;241
412370;201703;871;2573;645;2164;139;507;100;345;239;852
412380;201703;1548;4806;1245;4068;302;1033;259;852;561;1885
412382;201703;657;1819;459;1412;67;224;111;312;178;536
412385;201703;2269;6931;2006;6331;723;2371;493;1629;1216;4000
412390;201703;2106;5923;1892;5569;444;1396;803;2432;1247;3828
412395;201703;764;2178;586;1838;75;269;293;886;368;1155
412400;201703;858;2649;699;2289;174;593;171;589;345;1182
412402;201703;1780;5174;1425;4455;304;1071;296;860;600;1931
412405;201703;3404;9858;2113;6921;324;1217;96;276;420;1493
412410;201703;4941;14616;3987;12795;1015;3759;830;2578;1845;6337
412420;201703;385;1140;251;813;44;153;80;220;124;373
412430;201703;542;1511;387;1215;63;226;112;331;175;557
412440;201703;2998;9099;2300;7729;572;2103;514;1740;1086;3843
412450;201703;268;891;211;739;29;99;20;56;49;155
412460;201703;723;2269;609;2010;151;514;132;434;283;948
412470;201703;1840;6168;1535;5394;484;1792;308;1148;792;2940
412480;201703;1118;3335;766;2446;119;420;102;255;221;675
412490;201703;882;2588;740;2293;142;451;266;782;408;1233
412500;201703;1858;5309;1539;4659;280;951;363;981;643;1932
412510;201703;2169;7025;1736;5961;510;1887;317;1006;827;2893
412520;201703;1402;3987;1051;3247;297;961;131;379;428;1340
412530;201703;545;1605;424;1323;80;271;73;226;153;497
412535;201703;975;3074;736;2517;90;298;323;1200;413;1498
412540;201703;1201;3389;906;2785;137;491;259;806;396;1297
412545;201703;706;2029;531;1633;87;283;156;431;243;714
412550;201703;30502;90620;21425;70453;4662;16396;4779;14830;9441;31226
412555;201703;250;741;176;573;28;91;38;106;66;197
412560;201703;5290;16113;4060;13331;787;2978;998;3144;1785;6122
412570;201703;4165;12002;2754;8991;598;2176;382;1246;980;3422
412575;201703;853;2606;672;2154;134;468;200;608;334;1076
412580;201703;1263;3482;907;2772;162;556;345;977;507;1533
412590;201703;446;1294;281;939;56;192;55;175;111;367
412600;201703;1417;4282;1059;3470;217;792;288;892;505;1684
412610;201703;732;2188;467;1516;102;342;139;428;241;770
412620;201703;1195;3726;941;3218;268;1059;168;491;436;1550
412625;201703;8309;24054;6140;19669;1217;4248;571;1705;1788;5953
412627;201703;960;2949;691;2316;201;744;146;484;347;1228
412630;201703;3128;9786;2410;8150;491;1676;669;2150;1160;3826
412635;201703;455;1317;315;1005;68;228;33;80;101;308
412640;201703;907;2695;584;1938;92;342;72;229;164;571
412650;201703;1581;4745;1328;4242;276;1026;407;1190;683;2216
412660;201703;2526;7141;1984;6094;414;1437;432;1190;846;2627
412665;201703;634;1635;359;1099;96;307;81;230;177;537
412667;201703;1678;4721;1317;4005;267;893;431;1266;698;2159
412670;201703;515;1590;417;1402;118;442;81;256;199;698
412680;201703;1356;3988;835;2849;134;502;193;581;327;1083
412690;201703;755;2247;592;1905;127;432;133;446;260;878
412700;201703;1838;5455;1536;4993;453;1676;428;1337;881;3013
412710;201703;6252;19741;5307;17791;1177;4358;1314;4071;2491;8429
412720;201703;1367;4215;997;3308;161;574;171;485;332;1059
412730;201703;2085;6241;1225;4206;255;934;139;454;394;1388
412740;201703;1481;4692;1089;3779;239;926;132;498;371;1424
412750;201703;4070;12162;3607;11362;500;1843;2159;6659;2659;8502
412760;201703;2390;7449;2235;7170;284;1052;1433;4487;1717;5539
412770;201703;10475;28801;5991;19268;834;2899;989;2814;1823;5713
412780;201703;1262;3791;1071;3422;225;795;436;1328;661;2123
412785;201703;2166;6001;1645;4978;400;1211;713;2248;1113;3459
412788;201703;1427;4474;1214;4028;335;1243;341;1016;676;2259
412790;201703;1060;3181;738;2448;170;605;138;379;308;984
412795;201703;997;2746;700;2123;130;418;255;758;385;1176
412796;201703;2622;7967;2385;7507;512;1753;985;2945;1497;4698
412800;201703;3124;8754;2354;7104;364;1253;824;2300;1188;3553
412810;201703;11265;30519;6743;20932;897;3191;1593;4179;2490;7370
412820;201703;7279;21118;5355;17228;1193;4070;1341;4373;2534;8443
412830;201703;361;1102;268;903;45;167;58;194;103;361
412840;201703;1820;5122;1452;4365;248;810;350;1026;598;1836
412850;201703;2760;8015;2192;7000;437;1580;657;1957;1094;3537
412853;201703;1749;4973;1541;4564;158;520;795;2202;953;2722
412855;201703;1377;4010;1027;3187;209;715;207;517;416;1232
412860;201703;1147;3270;914;2822;244;820;300;872;544;1692
412862;201703;736;1887;479;1423;75;246;128;396;203;642
412863;201703;1151;3839;1119;3783;132;497;819;2729;951;3226
412865;201703;704;2087;530;1743;113;373;155;538;268;911
412870;201703;905;2584;716;2251;288;1008;82;250;370;1258
412880;201703;785;2334;605;1938;153;554;44;111;197;665
420005;201703;526;1563;314;1074;56;218;106;343;162;561
420010;201703;3206;8831;2536;7876;313;1033;1721;5407;2034;6440
420020;201703;641;2039;381;1384;50;223;40;124;90;347
420030;201703;442;1147;225;756;51;207;23;80;74;287
420040;201703;674;2150;408;1535;86;355;30;97;116;452
420050;201703;702;2011;468;1520;101;352;185;589;286;941
420055;201703;186;566;104;364;19;73;17;55;36;128
420060;201703;224;721;153;548;21;93;28;81;49;174
420070;201703;1256;4007;948;3249;176;655;354;1236;530;1891
420075;201703;162;433;85;262;17;57;11;21;28;78
420080;201703;575;1801;470;1594;140;492;129;450;269;942
420090;201703;398;1354;286;1075;75;290;52;208;127;498
420100;201703;1158;3632;1060;3488;216;759;631;2068;847;2827
420110;201703;289;982;270;938;77;284;80;266;157;550
420120;201703;264;906;214;791;62;259;55;180;117;439
420125;201703;301;1096;274;1040;80;330;123;449;203;779
420127;201703;453;1296;167;603;42;174;15;42;57;216
420130;201703;1817;6077;1448;5306;389;1595;301;1008;690;2603
420140;201703;4123;12250;3029;10089;710;2679;460;1361;1170;4040
420150;201703;540;1521;369;1225;47;174;174;551;221;725
420160;201703;261;709;152;505;31;104;42;139;73;243
420165;201703;217;675;128;446;27;106;30;97;57;203
420170;201703;204;625;131;474;38;168;13;41;51;209
420180;201703;364;1084;202;709;28;102;45;148;73;250
420190;201703;360;1108;189;691;33;126;18;59;51;185
420195;201703;1309;3859;1063;3411;277;977;219;665;496;1642
420200;201703;2489;7608;1518;5438;327;1348;259;860;586;2208
420205;201703;1097;3462;880;3048;177;673;472;1638;649;2311
420207;201703;1463;4269;1018;3364;288;1075;209;658;497;1733
420208;201703;580;1544;322;1104;71;272;111;400;182;672
420209;201703;276;849;174;604;30;119;75;252;105;371
420210;201703;1904;5565;1234;4456;298;1277;453;1539;751;2816
420213;201703;767;2688;715;2572;173;682;368;1326;541;2008
420215;201703;305;983;203;734;53;199;17;69;70;268
420220;201703;168;578;138;517;36;152;45;157;81;309
420230;201703;4093;12018;3118;10284;607;2382;1116;3510;1723;5892
420240;201703;10764;29839;6995;22769;1103;4243;3017;8897;4120;13140
420243;201703;587;1742;463;1502;93;322;155;498;248;820
420245;201703;1262;3685;860;2874;131;515;320;961;451;1476
420250;201703;501;1603;448;1504;98;383;203;653;301;1036
420253;201703;512;1319;379;1134;39;115;226;702;265;817
420257;201703;287;784;179;586;39;133;74;241;113;374
420260;201703;1137;3625;922;3228;188;735;389;1355;577;2090
420270;201703;664;1956;253;858;40;152;62;179;102;331
420280;201703;2060;5591;1261;4170;279;1020;386;1216;665;2236
420285;201703;149;431;71;264;11;47;5;11;16;58
420287;201703;497;1443;407;1303;135;466;124;403;259;869
420290;201703;5762;17271;3971;13161;793;2822;1160;3523;1953;6345
420300;201703;6607;19540;4175;14255;894;3431;773;2418;1667;5849
420310;201703;805;2114;627;1772;76;255;448;1207;524;1462
420315;201703;934;2931;718;2499;217;809;221;760;438;1569
420320;201703;4485;13780;3692;12350;1131;4230;1129;3672;2260;7902
420325;201703;200;669;173;607;32;117;64;217;96;334
420330;201703;935;3167;687;2552;136;561;199;696;335;1257
420340;201703;1396;4269;1040;3467;202;743;82;244;284;987
420350;201703;1469;4290;1067;3483;242;882;449;1415;691;2297
420360;201703;2863;8690;1761;6262;367;1473;157;527;524;2000
420370;201703;1727;4944;1367;4316;168;590;922;2859;1090;3449
420380;201703;5242;15482;3487;11664;799;2917;896;2900;1695;5817
420390;201703;1213;3407;708;2352;135;518;141;365;276;883
420395;201703;1268;3892;859;2958;127;503;95;281;222;784
420400;201703;1175;3495;825;2790;189;727;164;508;353;1235
420410;201703;693;1861;483;1495;80;289;285;852;365;1141
420415;201703;462;1417;338;1132;93;322;90;304;183;626
420417;201703;704;2230;566;1885;106;383;242;790;348;1173
420419;201703;304;994;214;788;74;300;12;47;86;347
420420;201703;10282;31079;8253;27114;2896;10328;1744;5375;4640;15703
420425;201703;1178;3123;798;2420;87;335;339;965;426;1300
420430;201703;3337;10091;2179;7352;471;1752;659;2134;1130;3886
420435;201703;264;778;164;559;36;146;74;239;110;385
420440;201703;787;2427;452;1531;157;575;99;299;256;874
420445;201703;381;1094;253;810;49;170;83;256;132;426
420450;201703;752;2308;532;1813;103;387;131;417;234;804
420455;201703;1913;5571;1601;5020;251;983;744;2184;995;3167
420460;201703;8587;24976;6593;21467;1456;5451;2486;7688;3942;13139
420470;201703;1028;2695;587;1864;113;401;173;515;286;916
420475;201703;98;284;50;177;19;67;5;15;24;82
420480;201703;4821;13844;3478;11288;816;2856;688;2215;1504;5071
420490;201703;645;1690;359;1210;92;343;70;255;162;598
420500;201703;1427;4499;1080;3812;350;1375;318;1115;668;2490
420510;201703;122;450;94;375;23;105;47;185;70;290
420515;201703;77;240;63;218;14;57;18;63;32;120
420517;201703;842;2546;743;2369;105;366;467;1475;572;1841
420519;201703;461;1198;297;904;52;172;75;213;127;385
420520;201703;645;1660;329;1080;54;175;61;159;115;334
420530;201703;1171;3697;842;2976;190;762;212;652;402;1414
420535;201703;259;738;128;439;30;101;13;56;43;157
420540;201703;22009;61566;15365;47796;3345;11472;4085;11028;7430;22500
420543;201703;354;918;280;800;46;105;182;543;228;648
420545;201703;1588;4926;1267;4227;305;1114;371;1187;676;2301
420550;201703;3944;12254;2875;10137;781;3247;520;1758;1301;5005
420555;201703;349;1049;267;883;47;170;96;300;143;470
420560;201703;465;1338;348;1125;62;208;175;550;237;758
420570;201703;2137;6696;1640;5593;395;1522;534;1688;929;3210
420580;201703;1539;4598;1210;4046;287;1105;495;1629;782;2734
420590;201703;3254;9607;2099;6950;433;1584;338;949;771;2533
420600;201703;907;2915;824;2744;154;541;470;1604;624;2145
420610;201703;495;1500;282;1010;70;276;56;194;126;470
420620;201703;544;1670;479;1543;127;436;137;444;264;880
420630;201703;980;2991;719;2366;171;615;269;813;440;1428
420640;201703;768;2283;385;1396;100;404;30;108;130;512
420650;201703;2448;7105;1586;5382;277;995;383;1194;660;2189
420660;201703;463;1364;325;1074;60;220;93;304;153;524
420665;201703;683;1906;462;1503;68;258;152;443;220;701
420670;201703;1660;4872;1169;3853;233;931;282;825;515;1756
420675;201703;178;587;134;475;26;111;28;92;54;203
420680;201703;437;1032;244;745;43;146;88;261;131;407
420690;201703;839;2911;616;2274;107;432;97;307;204;739
420700;201703;3054;8976;2370;7605;458;1622;800;2449;1258;4071
420710;201703;630;2068;478;1731;128;534;151;515;279;1049
420720;201703;1646;4687;1278;4166;377;1294;537;1751;914;3045
420730;201703;3073;9138;2514;8176;538;1931;1089;3444;1627;5375
420740;201703;793;2449;624;2100;185;674;187;597;372;1271
420750;201703;2062;6602;1545;5413;248;965;494;1571;742;2536
420757;201703;92;205;34;117;6;23;14;48;20;71
420760;201703;377;1179;194;664;43;154;25;74;68;228
420765;201703;537;1696;283;1049;65;258;58;210;123;468
420768;201703;1195;4014;962;3539;363;1323;365;1430;728;2753
420770;201703;520;1544;305;1113;70;293;60;223;130;516
420775;201703;632;1895;366;1255;77;281;50;165;127;446
420780;201703;1407;4229;844;2887;156;567;125;395;281;962
420785;201703;262;789;199;641;30;102;50;141;80;243
420790;201703;1215;4115;953;3537;253;1035;352;1245;605;2280
420800;201703;881;2448;441;1437;81;290;140;443;221;733
420810;201703;1958;6583;1581;5784;516;2131;329;1124;845;3255
420820;201703;8440;24974;5934;20696;1459;5704;1557;5316;3016;11020
420830;201703;2766;8519;2253;7565;632;2346;739;2451;1371;4797
420840;201703;997;2905;478;1697;89;355;85;284;174;639
420845;201703;1441;4215;961;3334;250;1022;206;672;456;1694
420850;201703;1471;4649;907;3382;200;838;69;243;269;1081
420860;201703;382;1073;223;770;64;248;40;136;104;384
420870;201703;1060;2987;836;2626;302;1088;210;589;512;1677
420880;201703;971;3280;760;2730;171;687;127;399;298;1086
420890;201703;9034;24278;4760;15659;814;2980;1093;3180;1907;6160
420895;201703;205;593;117;382;34;110;18;55;52;165
420900;201703;1759;4923;1144;3765;234;888;298;891;532;1779
420910;201703;24341;71132;16847;56641;3070;11644;5244;16377;8314;28021
420915;201703;539;2108;389;1659;80;361;171;675;251;1036
420917;201703;475;1442;220;718;35;133;85;247;120;380
420920;201703;169;494;77;274;11;49;9;26;20;75
420930;201703;18112;51269;13791;43794;2881;10148;5428;16526;8309;26674
420940;201703;2817;8297;2088;6876;548;2002;160;476;708;2478
420945;201703;199;594;132;445;29;116;34;100;63;216
420950;201703;568;1561;291;1015;39;174;65;218;104;392
420960;201703;920;2602;725;2260;143;505;278;815;421;1320
420970;201703;2412;7593;1974;6770;633;2351;415;1450;1048;3801
420980;201703;441;1302;342;1153;124;448;121;452;245;900
420985;201703;474;1342;219;783;46;194;54;182;100;376
420990;201703;776;2188;437;1509;83;314;61;178;144;492
421000;201703;547;1854;357;1373;72;295;60;191;132;486
421003;201703;671;1793;249;839;29;101;20;52;49;153
421005;201703;136;413;103;357;25;91;49;184;74;275
421010;201703;4979;14083;3517;11507;812;2949;730;2200;1542;5149
421020;201703;434;1333;320;1130;34;145;188;654;222;799
421030;201703;736;2612;641;2368;208;858;101;354;309;1212
421040;201703;896;2257;577;1770;92;328;282;837;374;1165
421050;201703;1566;4523;920;3131;191;704;198;637;389;1341
421055;201703;199;562;109;350;24;76;20;44;44;120
421060;201703;541;1775;366;1327;90;355;117;419;207;774
421070;201703;657;2081;425;1503;89;344;58;198;147;542
421080;201703;751;3129;674;3015;86;278;525;2538;611;2816
421085;201703;503;1400;255;888;53;203;62;200;115;403
421090;201703;396;1104;185;616;29;109;46;145;75;254
421100;201703;959;2541;499;1574;115;389;56;162;171;551
421105;201703;1477;4411;1187;3929;253;889;393;1375;646;2264
421110;201703;939;3314;859;3131;331;1262;186;617;517;1879
421120;201703;1272;4086;854;3079;123;520;205;647;328;1167
421125;201703;403;1107;300;938;85;292;89;248;174;540
421130;201703;3191;10483;2742;9587;899;3388;916;3277;1815;6665
421140;201703;313;895;232;730;43;141;89;253;132;394
421145;201703;553;1709;343;1150;52;180;101;331;153;511
421150;201703;614;1751;445;1482;94;366;173;543;267;909
421160;201703;1148;3162;574;1870;112;413;189;578;301;991
421165;201703;226;760;191;680;26;88;91;341;117;429
421170;201703;1279;3623;1018;3219;168;571;585;1854;753;2425
421175;201703;1184;3348;822;2681;166;654;295;859;461;1513
421180;201703;532;1461;269;901;60;225;48;159;108;384
421185;201703;402;1100;286;883;66;201;116;380;182;581
421187;201703;331;993;229;755;36;120;84;259;120;379
421189;201703;401;1238;318;1060;62;227;90;289;152;516
421190;201703;11330;31999;6963;23522;1494;5654;1074;3411;2568;9065
421200;201703;900;2919;753;2615;163;608;254;835;417;1443
421205;201703;207;629;150;509;38;153;40;120;78;273
421210;201703;1376;4141;1006;3308;263;886;252;838;515;1724
421220;201703;1697;5769;1497;5309;473;1862;227;691;700;2553
421223;201703;514;1600;371;1314;79;306;136;498;215;804
421225;201703;1078;3427;916;3088;205;745;363;1250;568;1995
421227;201703;838;2561;682;2274;133;517;375;1215;508;1732
421230;201703;455;1447;383;1321;91;333;162;548;253;881
421240;201703;395;1249;216;795;26;126;31;98;57;224
421250;201703;1596;4544;1025;3545;289;1089;197;672;486;1761
421260;201703;352;995;86;310;18;62;15;54;33;116
421265;201703;786;2346;694;2202;110;403;424;1313;534;1716
421270;201703;731;2001;382;1264;78;256;82;294;160;550
421280;201703;1536;4840;1214;4260;301;1221;501;1709;802;2930
421290;201703;1026;2879;602;1929;99;351;104;293;203;644
421300;201703;288;863;217;715;53;222;88;256;141;478
421310;201703;209;639;163;525;29;101;56;181;85;282
421315;201703;325;978;193;683;36;136;30;102;66;238
421320;201703;613;1868;379;1310;74;263;55;141;129;404
421330;201703;575;1846;440;1585;134;523;95;357;229;880
421335;201703;466;1568;392;1417;86;355;80;305;166;660
421340;201703;1741;4882;1374;4292;187;727;755;2306;942;3033
421350;201703;1061;3405;895;3074;151;625;486;1599;637;2224
421360;201703;2779;7950;1759;5968;365;1442;494;1554;859;2996
421370;201703;542;1833;405;1507;123;502;116;423;239;925
421380;201703;909;2614;772;2359;130;444;383;1111;513;1555
421390;201703;181;508;79;267;18;67;25;79;43;146
421400;201703;284;951;205;800;58;256;69;247;127;503
421410;201703;303;860;185;626;25;95;73;244;98;339
421415;201703;369;1177;161;578;36;142;26;83;62;225
421420;201703;760;2266;578;1876;94;347;232;686;326;1033
421430;201703;197;634;152;544;33;126;37;138;70;264
421440;201703;834;2354;562;1894;112;424;237;800;349;1224
421450;201703;424;1300;258;930;37;150;28;115;65;265
421460;201703;583;1622;309;1108;59;230;72;270;131;500
421470;201703;381;1249;297;1070;78;322;83;280;161;602
421480;201703;3047;8529;2002;6711;679;2681;270;702;949;3383
421490;201703;270;806;126;475;25;109;21;74;46;183
421500;201703;2045;6931;1675;6155;537;2188;208;753;745;2941
421505;201703;354;1142;309;1041;71;249;142;475;213;724
421507;201703;533;1598;353;1226;82;308;89;311;171;619
421510;201703;192;620;152;535;30;129;72;205;102;334
421520;201703;711;1952;475;1432;72;261;196;520;268;781
421530;201703;316;983;186;685;34;155;32;100;66;255
421535;201703;659;1910;369;1307;43;171;160;526;203;697
421540;201703;328;879;244;736;55;181;89;243;144;424
421545;201703;792;2467;574;2057;143;582;162;556;305;1138
421550;201703;2045;6353;1722;5804;501;1926;573;1830;1074;3756
421555;201703;321;932;113;396;18;71;16;46;34;117
421560;201703;169;535;77;278;15;60;14;53;29;113
421565;201703;754;2204;670;2103;202;707;320;1029;522;1736
421567;201703;583;2108;507;1929;256;1007;121;463;377;1470
421568;201703;505;1536;345;1172;68;249;100;338;168;587
421569;201703;230;687;101;369;20;73;15;58;35;131
421570;201703;1349;4047;786;2718;182;666;123;406;305;1072
421575;201703;345;1179;303;1054;48;179;156;534;204;713
421580;201703;2943;9290;2232;7724;525;2105;608;1874;1133;3979
421590;201703;213;647;168;560;25;90;86;279;111;369
421600;201703;483;1496;369;1232;83;314;83;245;166;559
421605;201703;611;1875;446;1566;88;352;130;444;218;796
421610;201703;1370;3724;965;2970;160;541;359;1058;519;1599
421620;201703;4394;13190;2902;10099;798;2979;755;2634;1553;5613
421625;201703;374;1031;155;525;36;121;16;49;52;170
421630;201703;2959;8728;1683;5711;324;1238;264;816;588;2054
421635;201703;225;668;120;393;17;68;32;75;49;143
421640;201703;1062;3079;751;2490;156;549;266;871;422;1420
421650;201703;2153;6772;1591;5521;418;1670;200;567;618;2237
421660;201703;7489;24235;6268;21785;1363;5305;2060;6670;3423;11975
421670;201703;1041;3096;724;2401;179;676;210;659;389;1335
421680;201703;1128;3595;922;3156;306;1127;216;709;522;1836
421690;201703;1437;4639;1070;3794;237;950;137;421;374;1371
421700;201703;471;1535;260;990;47;200;71;249;118;449
421710;201703;210;695;94;345;14;54;25;81;39;135
421715;201703;219;578;115;371;26;81;40;122;66;203
421720;201703;1908;5614;1184;4141;304;1188;171;526;475;1714
421725;201703;137;408;100;330;31;113;28;81;59;194
421730;201703;578;1644;276;916;38;131;73;220;111;351
421740;201703;689;2220;473;1678;104;423;94;313;198;736
421750;201703;995;2602;602;1848;105;346;214;595;319;941
421755;201703;302;867;171;551;35;130;53;157;88;287
421760;201703;909;2746;458;1634;72;268;82;281;154;549
421770;201703;2857;8488;2154;7122;521;1789;702;2439;1223;4228
421775;201703;465;1349;324;1084;58;213;112;361;170;574
421780;201703;1016;3437;772;2855;191;822;215;720;406;1542
421790;201703;794;2089;462;1586;191;712;112;338;303;1050
421795;201703;350;1020;219;699;40;136;60;183;100;319
421800;201703;2646;7895;1980;6630;439;1604;758;2431;1197;4035
421810;201703;592;1791;426;1446;105;404;89;271;194;675
421820;201703;980;2837;592;2004;97;362;75;208;172;570
421825;201703;1436;4477;1347;4314;169;610;955;2977;1124;3587
421830;201703;2482;8336;2189;7751;534;2085;779;2624;1313;4709
421835;201703;160;474;119;415;17;76;77;262;94;338
421840;201703;286;891;201;705;44;184;68;209;112;393
421850;201703;434;1373;256;914;44;185;58;191;102;376
421860;201703;295;896;191;678;34;131;45;132;79;263
421870;201703;3675;10389;2571;8166;732;2556;575;1773;1307;4329
421875;201703;397;1162;185;660;35;134;22;64;57;198
421880;201703;811;2470;608;2033;145;533;121;380;266;913
421885;201703;292;915;239;829;75;276;66;216;141;492
421890;201703;823;2785;698;2540;240;1013;211;697;451;1710
421895;201703;381;1190;338;1118;66;243;201;664;267;907
421900;201703;950;2638;595;1905;154;516;157;482;311;998
421910;201703;480;1495;337;1177;68;290;67;197;135;487
421915;201703;480;1447;303;1031;61;211;55;187;116;398
421917;201703;594;1677;416;1411;133;510;115;375;248;885
421920;201703;676;1926;437;1591;218;810;116;453;334;1263
421930;201703;2992;7782;1596;5327;392;1432;234;718;626;2150
421935;201703;634;2050;478;1703;99;408;167;558;266;966
421940;201703;230;778;140;519;25;112;29;90;54;202
421950;201703;3440;9255;1627;5433;371;1360;204;674;575;2034
421960;201703;181;532;135;454;26;101;28;96;54;197
421970;201703;2323;6308;1355;4313;356;1184;345;1025;701;2209
421985;201703;448;1157;244;751;35;131;67;213;102;344
422000;201703;1312;3914;1081;3462;280;1007;410;1302;690;2309
430003;201703;594;1894;499;1721;136;532;156;522;292;1054
430005;201703;329;966;232;777;47;173;96;305;143;478
430010;201703;2016;5516;1573;4742;363;1192;702;2125;1065;3317
430020;201703;673;1646;561;1491;82;258;351;893;433;1151
430030;201703;1055;2702;741;2140;224;674;163;467;387;1141
430040;201703;10602;28114;7590;22475;2020;6694;782;2171;2802;8865
430045;201703;689;1858;517;1512;79;243;215;616;294;859
430047;201703;293;684;134;396;17;51;43;128;60;179
430050;201703;1033;2821;597;1891;127;411;130;398;257;809
430055;201703;301;790;157;476;11;38;70;205;81;243
430057;201703;69;168;37;104;4;9;6;9;10;18
430060;201703;16745;52514;14366;48473;3958;14431;5553;18948;9511;33379
430063;201703;962;2811;757;2368;176;559;370;1167;546;1726
430064;201703;1203;3591;963;3144;250;853;306;1000;556;1853
430066;201703;169;391;115;305;8;25;63;163;71;188
430070;201703;646;1731;171;571;23;88;16;40;39;128
430080;201703;733;2039;440;1451;104;381;135;397;239;778
430085;201703;943;2404;583;1755;117;391;157;495;274;886
430087;201703;782;2460;692;2282;136;507;329;1009;465;1516
430090;201703;651;1708;242;787;30;114;60;193;90;307
430100;201703;854;2243;440;1388;107;360;118;324;225;684
430105;201703;1014;2903;668;2264;159;608;232;778;391;1386
430107;201703;219;712;163;565;27;101;40;124;67;225
430110;201703;1912;5384;1557;4837;342;1111;723;2161;1065;3272
430120;201703;1592;4805;1152;3863;265;917;463;1592;728;2509
430130;201703;3834;10374;3239;9433;910;2629;1182;3748;2092;6377
430140;201703;1157;3540;767;2640;204;736;233;791;437;1527
430150;201703;725;1924;464;1414;100;336;122;386;222;722
430155;201703;317;878;186;603;28;101;47;143;75;244
430160;201703;16663;47430;14383;43608;3408;11167;5647;17456;9055;28623
430163;201703;1939;5577;1545;4901;239;827;842;2674;1081;3501
430165;201703;465;1131;117;387;14;46;13;30;27;76
430170;201703;934;2659;370;1333;58;234;48;144;106;378
430175;201703;867;2725;730;2405;179;572;316;1087;495;1659
430180;201703;783;2174;661;1963;130;451;349;979;479;1430
430185;201703;506;1349;306;962;58;197;101;266;159;463
430187;201703;653;1925;518;1639;108;388;185;556;293;944
430190;201703;1580;4706;1368;4278;276;934;692;2120;968;3054
430192;201703;181;551;85;270;10;36;11;28;21;64
430195;201703;386;1168;95;315;9;34;2;7;11;41
430200;201703;1327;4230;1140;3836;344;1203;306;1028;650;2231
430205;201703;544;1540;413;1281;40;151;282;858;322;1009
430210;201703;5975;15746;3794;11224;551;1836;1193;2873;1744;4709
430215;201703;341;935;237;721;47;154;90;257;137;411
430220;201703;660;1683;231;772;38;149;41;128;79;277
430222;201703;259;805;208;689;38;138;93;294;131;432
430223;201703;361;1008;294;889;59;176;139;431;198;607
430225;201703;34;83;15;41;4;11;6;15;10;26
430230;201703;1609;4796;1539;4707;279;762;1174;3734;1453;4496
430235;201703;267;862;217;744;47;189;71;225;118;414
430237;201703;548;1380;395;1130;47;155;226;602;273;757
430240;201703;1019;2582;702;2078;96;354;348;970;444;1324
430245;201703;810;2522;632;2150;174;590;263;947;437;1537
430250;201703;1060;3079;948;2898;306;1007;103;290;409;1297
430258;201703;163;461;121;388;12;42;50;168;62;210
430260;201703;672;1918;507;1588;94;310;243;793;337;1103
430265;201703;269;826;212;719;51;174;35;119;86;293
430270;201703;2811;7764;2424;7124;357;1224;1445;4101;1802;5325
430280;201703;4710;12471;3772;10856;824;2455;1651;4808;2475;7263
430290;201703;2419;6288;2226;6002;115;356;1909;5117;2024;5473
430300;201703;8953;25992;7433;23115;1620;5441;3326;10462;4946;15903
430310;201703;6710;19833;5183;16916;1121;4062;2051;6349;3172;10411
430320;201703;825;2412;522;1753;95;287;238;838;333;1125
430330;201703;664;1756;520;1483;131;381;217;568;348;949
430340;201703;714;1744;371;1161;73;230;170;532;243;762
430350;201703;5894;17746;5031;15924;1785;5864;1523;4682;3308;10546
430355;201703;400;1001;154;479;27;95;19;56;46;151
430360;201703;989;2639;780;2246;169;530;282;760;451;1290
430367;201703;233;636;150;469;36;134;52;150;88;284
430370;201703;534;1466;333;1064;74;250;67;197;141;447
430380;201703;721;1887;408;1307;130;452;99;312;229;764
430390;201703;3815;10538;2395;7657;427;1533;282;850;709;2383
430400;201703;1329;3189;989;2636;254;671;426;1106;680;1777
430410;201703;593;1562;420;1259;63;211;221;646;284;857
430420;201703;3470;10015;2742;8374;739;2344;910;2731;1649;5075
430430;201703;662;1814;425;1365;108;376;97;314;205;690
430435;201703;2033;5451;1481;4461;377;1174;442;1373;819;2547
430440;201703;4046;12590;3149;10533;658;2319;1299;4452;1957;6771
430450;201703;6919;19259;5709;16954;1657;5186;1694;5117;3351;10303
430460;201703;27803;82238;21554;71165;5778;21081;6306;20517;12084;41598
430461;201703;510;1346;167;530;23;72;42;132;65;204
430462;201703;289;814;193;649;34;128;35;130;69;258
430463;201703;3966;12597;3413;11543;761;2784;1614;5505;2375;8289
430465;201703;588;1629;502;1477;120;371;275;793;395;1164
430466;201703;3589;9573;3098;8807;683;2119;1606;4388;2289;6507
430467;201703;457;1346;383;1196;75;256;147;426;222;682
430468;201703;1378;3836;1160;3478;257;819;513;1510;770;2329
430469;201703;485;1314;60;197;9;25;8;19;17;44
430470;201703;7657;20373;5403;16633;1581;5186;1015;3192;2596;8378
430471;201703;499;1651;450;1540;130;449;129;460;259;909
430480;201703;1001;2652;525;1678;80;278;94;267;174;545
430485;201703;150;430;78;254;13;50;15;38;28;88
430490;201703;289;836;193;629;41;144;80;274;121;418
430495;201703;374;1118;246;856;48;178;80;262;128;440
430500;201703;1131;3115;939;2812;211;699;434;1256;645;1955
430510;201703;22093;63132;17320;53911;4972;16923;5135;15011;10107;31934
430511;201703;378;1175;170;598;31;110;15;37;46;147
430512;201703;1040;2676;892;2423;240;702;253;718;493;1420
430513;201703;799;2060;453;1315;107;337;169;460;276;797
430515;201703;467;1330;331;1055;55;164;149;494;204;658
430517;201703;1152;3608;947;3189;176;616;461;1576;637;2192
430520;201703;1485;4097;927;2899;175;632;211;596;386;1228
430530;201703;1132;2990;497;1573;79;274;118;344;197;618
430535;201703;2463;7272;1864;6111;385;1377;700;2240;1085;3617
430537;201703;461;1499;388;1333;38;150;263;890;301;1040
430540;201703;703;1558;466;1234;85;240;276;720;361;960
430543;201703;477;1192;419;1130;72;197;290;802;362;999
430544;201703;651;2077;541;1823;120;451;260;838;380;1289
430545;201703;1295;4145;1139;3958;369;1389;496;1735;865;3124
430550;201703;610;1721;356;1165;81;278;66;194;147;472
430558;201703;81;241;51;162;11;40;14;35;25;75
430560;201703;391;938;185;562;12;42;60;177;72;219
430570;201703;1077;2760;700;2029;136;458;284;702;420;1160
430580;201703;1215;3026;770;2303;109;351;375;1144;484;1495
430583;201703;171;455;43;134;4;13;6;20;10;33
430585;201703;305;768;180;518;30;106;77;192;107;298
430587;201703;161;507;127;417;28;101;45;154;73;255
430590;201703;1209;3277;1105;3103;99;325;856;2351;955;2676
430593;201703;23;85;21;78;5;20;8;28;13;48
430595;201703;292;837;84;290;9;40;10;27;19;67
430597;201703;343;1001;237;745;30;105;67;174;97;279
430600;201703;1922;5174;1021;3117;185;612;292;830;477;1442
430605;201703;1255;3730;972;3159;164;623;405;1308;569;1931
430607;201703;764;1804;563;1506;53;156;349;964;402;1120
430610;201703;7350;19686;5647;17025;1667;5488;1163;3538;2830;9026
430613;201703;275;673;110;342;8;28;27;68;35;96
430620;201703;681;1903;565;1676;150;481;231;663;381;1144
430630;201703;419;1286;169;564;24;85;25;72;49;157
430632;201703;642;1803;322;1019;46;166;110;304;156;470
430635;201703;581;1659;451;1391;90;311;229;683;319;994
430637;201703;483;1365;429;1259;69;227;240;665;309;892
430640;201703;1583;4218;761;2452;109;367;90;256;199;623
430642;201703;461;1198;303;917;53;158;122;381;175;539
430645;201703;280;642;110;312;20;54;29;87;49;141
430650;201703;1759;5674;1501;5143;312;1109;805;2805;1117;3914
430655;201703;160;412;138;369;35;115;66;147;101;262
430660;201703;5378;14976;4331;13125;995;3241;1830;5507;2825;8748
430670;201703;443;1285;413;1228;38;118;308;941;346;1059
430673;201703;721;1677;320;955;70;215;84;247;154;462
430675;201703;249;734;78;272;11;49;19;56;30;105
430676;201703;3588;10508;2906;9253;708;2420;928;2994;1636;5414
430680;201703;1066;3018;643;2132;125;427;125;373;250;800
430690;201703;3944;11300;3194;9834;1031;3361;693;2107;1724;5468
430692;201703;257;850;197;739;17;79;132;485;149;564
430693;201703;1201;3248;718;2260;158;543;127;365;285;908
430695;201703;564;1523;369;1109;61;204;151;435;212;639
430697;201703;448;1247;323;1022;70;231;123;406;193;637
430700;201703;9363;23959;4853;15571;888;3265;356;1096;1244;4361
430705;201703;266;807;211;678;57;193;60;178;117;371
430710;201703;1691;4270;1270;3544;259;799;524;1462;783;2261
430720;201703;771;1932;506;1519;119;378;168;514;287;892
430730;201703;1589;4116;1025;3166;188;614;430;1366;618;1980
430740;201703;614;1709;355;1163;70;245;65;228;135;473
430745;201703;489;1396;243;783;31;96;39;127;70;223
430750;201703;1459;4017;1138;3460;219;730;575;1715;794;2445
430755;201703;477;1270;305;913;25;91;146;400;171;491
430760;201703;2772;6816;1860;5504;443;1480;699;2141;1142;3621
430770;201703;6252;17955;4992;15633;852;2930;2679;8208;3531;11138
430780;201703;2453;6482;1524;4784;292;983;449;1405;741;2388
430781;201703;424;1236;307;995;71;235;85;282;156;517
430783;201703;542;1311;333;959;46;142;152;417;198;559
430786;201703;74;252;50;198;8;30;10;38;18;68
430790;201703;4479;12261;3107;9531;663;2237;1172;3389;1835;5626
430800;201703;885;2462;596;1828;117;394;218;641;335;1035
430805;201703;550;1530;328;1039;31;96;152;473;183;569
430807;201703;452;1264;305;953;58;205;85;253;143;458
430810;201703;713;1941;251;872;50;186;42;142;92;328
430820;201703;1379;3958;793;2681;171;610;147;472;318;1082
430825;201703;308;835;127;388;25;66;22;47;47;113
430830;201703;1684;5172;1546;4981;231;831;1062;3399;1293;4230
430840;201703;983;2935;857;2708;217;677;389;1257;606;1934
430843;201703;88;222;37;114;5;15;13;37;18;52
430845;201703;262;761;215;666;92;319;28;63;120;382
430850;201703;2360;6932;1992;6229;517;1757;781;2409;1298;4166
430860;201703;1030;2647;497;1543;100;367;176;502;276;869
430865;201703;597;1574;538;1482;171;494;248;664;419;1158
430870;201703;743;2047;385;1269;84;286;75;220;159;506
430880;201703;1170;3230;818;2534;227;739;229;730;456;1469
430885;201703;249;581;140;418;14;51;99;299;113;350
430890;201703;1657;4450;1106;3363;91;353;187;492;278;845
430900;201703;2671;6975;2085;5981;400;1316;925;2522;1325;3838
430905;201703;1073;3045;693;2242;159;538;153;466;312;1004
430910;201703;1622;4713;1085;3533;225;805;378;1107;603;1912
430912;201703;463;1292;345;1078;50;176;205;631;255;807
430915;201703;581;1802;418;1498;140;545;104;405;244;950
430920;201703;17340;51494;15203;47570;2760;9585;8599;26184;11359;35769
430925;201703;136;306;58;167;11;32;17;54;28;86
430930;201703;9594;26481;6457;20790;1765;6082;1353;4645;3118;10727
430940;201703;1215;3692;691;2378;190;708;83;237;273;945
430950;201703;891;2402;595;1805;137;446;223;614;360;1060
430955;201703;169;488;71;233;14;56;12;30;26;86
430957;201703;233;774;194;694;38;130;90;329;128;459
430960;201703;1431;3714;1090;3115;240;775;505;1437;745;2212
430965;201703;1575;4273;1336;3875;90;324;997;2813;1087;3137
430970;201703;404;1099;236;746;41;133;91;275;132;408
430975;201703;556;1818;436;1531;96;359;158;569;254;928
430980;201703;360;921;233;722;55;173;78;238;133;411
430990;201703;567;1780;371;1264;67;256;109;357;176;613
430995;201703;637;1797;463;1454;124;388;171;512;295;900
431000;201703;1548;3885;739;2250;120;386;45;119;165;505
431010;201703;2609;7213;1552;5201;259;980;170;496;429;1476
431020;201703;10147;24671;6706;18857;1679;5008;1708;4625;3387;9633
431030;201703;330;932;155;539;35;130;15;52;50;182
431033;201703;2608;8029;2284;7521;599;1969;1021;3651;1620;5620
431036;201703;219;567;92;297;14;47;18;45;32;92
431040;201703;956;2648;726;2243;133;505;357;1027;490;1532
431041;201703;494;1282;429;1192;114;336;185;524;299;860
431043;201703;471;1270;257;864;100;364;54;158;154;522
431046;201703;105;297;72;221;8;30;20;57;28;87
431050;201703;1636;4125;1187;3385;274;812;531;1524;805;2336
431053;201703;585;1840;463;1572;141;511;108;367;249;878
431055;201703;670;1765;615;1681;53;166;463;1245;516;1411
431057;201703;359;1033;220;727;42;155;55;162;97;317
431060;201703;5330;15918;4692;14831;1571;5236;1259;4132;2830;9368
431065;201703;536;1509;374;1188;65;229;115;334;180;563
431070;201703;609;1777;354;1165;84;288;58;149;142;437
431075;201703;246;766;184;629;35;136;56;194;91;330
431080;201703;676;2044;479;1588;99;343;127;411;226;754
431085;201703;755;2086;596;1736;104;294;329;960;433;1254
431087;201703;527;1513;471;1400;42;122;326;982;368;1104
431090;201703;473;1174;199;612;47;164;37;106;84;270
431100;201703;3272;8969;2644;7924;693;2286;883;2569;1576;4855
431110;201703;1461;3825;1096;3101;254;747;374;998;628;1745
431112;201703;555;1783;506;1682;119;402;247;797;366;1199
431113;201703;454;1339;365;1158;114;378;102;339;216;717
431115;201703;1353;3857;1162;3533;202;646;642;1943;844;2589
431120;201703;2648;8003;1993;6645;602;2327;600;1829;1202;4156
431123;201703;434;1242;284;938;65;210;132;449;197;659
431125;201703;1317;3939;932;3102;283;957;207;776;490;1733
431127;201703;253;684;59;197;9;25;10;26;19;51
431130;201703;3367;9686;2337;7635;524;1821;687;2273;1211;4094
431140;201703;5003;12211;2797;8385;378;1270;827;2275;1205;3545
431142;201703;469;1352;399;1223;62;202;240;743;302;945
431150;201703;1011;3016;776;2505;169;598;269;871;438;1469
431160;201703;820;2343;672;2071;135;388;289;989;424;1377
431162;201703;526;1300;231;740;28;101;26;61;54;162
431164;201703;176;479;52;178;11;40;3;10;14;50
431170;201703;660;1806;465;1446;133;452;135;398;268;850
431171;201703;746;2173;647;1977;153;501;279;823;432;1324
431173;201703;445;1280;349;1117;130;451;83;265;213;716
431175;201703;998;2752;800;2392;226;712;214;619;440;1331
431177;201703;756;2414;564;2029;161;635;200;700;361;1335
431179;201703;368;799;99;286;17;50;16;39;33;89
431180;201703;2197;6110;1478;4716;352;1227;262;784;614;2011
431190;201703;580;1601;322;1040;43;145;54;150;97;295
431198;201703;340;1117;304;1047;109;395;85;317;194;712
431200;201703;405;1134;120;410;16;45;0;0;16;45
431205;201703;251;739;109;391;27;91;33;126;60;217
431210;201703;702;1851;592;1693;148;413;309;927;457;1340
431213;201703;242;734;194;647;27;104;95;312;122;416
431215;201703;255;793;162;569;36;132;31;104;67;236
431217;201703;162;489;111;379;27;92;43;145;70;237
431220;201703;832;2268;471;1501;39;142;192;560;231;702
431225;201703;1286;3576;988;3023;241;758;319;1014;560;1772
431230;201703;784;2318;588;1882;100;369;251;773;351;1142
431235;201703;117;325;34;106;7;22;3;5;10;27
431237;201703;470;1387;378;1238;64;256;202;635;266;891
431238;201703;29;101;23;84;8;35;6;20;14;55
431240;201703;3439;10075;2945;9220;734;2507;1200;3688;1934;6195
431242;201703;377;1116;314;1000;86;271;107;361;193;632
431244;201703;354;832;194;555;29;96;75;187;104;283
431245;201703;1211;3134;804;2354;121;375;358;1037;479;1412
431247;201703;203;572;131;418;30;100;31;90;61;190
431250;201703;1343;4410;1190;4183;328;1225;446;1608;774;2833
431260;201703;341;955;167;573;21;92;38;111;59;203
431261;201703;252;829;212;735;40;160;93;306;133;466
431262;201703;417;1136;189;612;17;55;95;318;112;373
431265;201703;1400;3495;675;2057;113;370;193;480;306;850
431267;201703;283;806;173;525;19;72;107;298;126;370
431270;201703;2790;6837;1661;4957;411;1316;491;1496;902;2812
431275;201703;226;679;125;455;35;134;15;50;50;184
431280;201703;314;850;108;351;11;40;16;36;27;76
431290;201703;313;962;229;773;39;152;34;82;73;234
431295;201703;75;210;30;96;2;6;5;10;7;16
431300;201703;389;973;63;239;3;11;2;9;5;20
431301;201703;272;846;95;328;9;31;11;26;20;57
431303;201703;736;1953;446;1344;52;173;143;413;195;586
431306;201703;2174;5635;1324;4077;157;569;358;956;515;1525
431308;201703;36;124;33;112;17;61;10;33;27;94
431310;201703;720;2128;425;1436;88;313;129;450;217;763
431320;201703;743;2061;376;1255;74;270;63;187;137;457
431330;201703;2695;6717;1395;4352;333;1161;118;321;451;1482
431333;201703;410;1097;153;464;26;74;29;76;55;150
431335;201703;40;119;27;93;8;27;3;7;11;34
431337;201703;2438;7305;1765;5991;427;1568;258;895;685;2463
431339;201703;528;1440;370;1118;71;229;192;568;263;797
431340;201703;22912;60667;16674;49788;3904;12798;3905;11397;7809;24195
431342;201703;536;1307;400;1089;98;309;234;593;332;902
431344;201703;357;986;259;806;4;8;191;600;195;608
431346;201703;301;759;114;354;21;70;15;46;36;116
431349;201703;734;2027;432;1313;71;224;152;415;223;639
431350;201703;3984;11559;3154;9997;747;2625;1017;3055;1764;5680
431360;201703;625;1597;394;1194;107;320;101;313;208;633
431365;201703;1416;4122;1202;3765;193;644;683;2194;876;2838
431370;201703;4780;13294;3717;11455;948;3109;1357;4338;2305;7447
431380;201703;875;2719;811;2596;113;410;459;1451;572;1861
431390;201703;2954;7761;1760;5505;338;1212;450;1241;788;2453
431395;201703;1216;3616;991;3215;230;795;429;1401;659;2196
431400;201703;383;1176;192;637;33;110;39;128;72;238
431402;201703;1084;2635;689;1926;129;386;357;945;486;1331
431403;201703;189;560;159;509;46;170;59;169;105;339
431405;201703;4003;11110;3252;10006;579;1988;1700;5171;2279;7159
431406;201703;620;1904;484;1639;93;331;275;931;368;1262
431407;201703;516;1469;350;1139;80;267;121;373;201;640
431410;201703;14104;40168;9535;31195;2652;9699;1629;5176;4281;14875
431413;201703;208;513;77;253;8;32;13;38;21;70
431415;201703;699;1986;499;1614;120;434;144;421;264;855
431417;201703;523;1326;439;1202;62;184;277;738;339;922
431420;201703;1270;3446;1107;3194;219;675;483;1481;702;2156
431430;201703;570;1491;345;1057;63;218;112;300;175;518
431440;201703;21898;59793;17355;52535;4995;16121;4962;16118;9957;32239
431442;201703;126;379;77;261;15;50;4;12;19;62
431445;201703;518;1472;199;651;30;98;48;152;78;250
431446;201703;386;1167;283;921;73;250;76;234;149;484
431447;201703;560;1590;427;1332;71;218;200;622;271;840
431449;201703;756;2060;587;1744;53;159;300;907;353;1066
431450;201703;2098;5035;1842;4664;198;593;1362;3314;1560;3907
431454;201703;62;215;54;194;12;43;21;83;33;126
431455;201703;693;1752;361;1023;68;198;116;298;184;496
431460;201703;3060;8420;2577;7490;667;1983;857;2606;1524;4589
431470;201703;1741;5036;1280;4063;269;853;450;1489;719;2342
431475;201703;201;593;36;144;5;25;2;6;7;31
431477;201703;705;1831;458;1321;58;169;209;561;267;730
431478;201703;259;660;84;248;12;37;9;19;21;56
431480;201703;3125;8469;2427;7295;466;1556;1103;3239;1569;4795
431490;201703;107433;289230;92073;266054;11191;37963;62817;177117;74008;215080
431500;201703;561;1540;446;1311;72;205;257;762;329;967
431505;201703;486;1172;324;931;29;81;196;563;225;644
431507;201703;368;891;200;562;34;94;95;259;129;353
431510;201703;1800;5087;1391;4258;319;1048;450;1320;769;2368
431513;201703;311;826;153;471;21;61;76;231;97;292
431514;201703;95;268;45;154;3;14;9;28;12;42
431515;201703;570;1580;386;1195;93;324;146;412;239;736
431517;201703;73;247;55;196;9;31;12;39;21;70
431520;201703;518;1289;233;745;46;170;35;104;81;274
431530;201703;4065;9570;2857;7957;839;2456;603;1759;1442;4215
431531;201703;229;663;171;543;19;64;58;164;77;228
431532;201703;508;1393;405;1168;89;266;146;416;235;682
431535;201703;296;759;133;406;30;107;42;105;72;212
431540;201703;2006;6612;1800;6291;140;580;1200;4302;1340;4882
431545;201703;341;950;54;190;4;15;14;54;18;69
431550;201703;2136;6246;1853;5727;408;1392;773;2280;1181;3672
431555;201703;670;1645;469;1311;52;141;281;798;333;939
431560;201703;20347;58870;14334;47605;3146;11775;3214;11337;6360;23112
431570;201703;5803;14587;4549;12929;1166;3509;2032;5840;3198;9349
431575;201703;376;995;280;832;53;178;51;128;104;306
431580;201703;574;1619;324;1077;71;253;85;272;156;525
431590;201703;923;2445;574;1771;133;422;160;499;293;921
431595;201703;408;1162;302;927;38;116;160;475;198;591
431600;201703;1927;5262;1430;4415;312;1119;330;1003;642;2122
431610;201703;1395;3920;1019;3193;144;444;437;1405;581;1849
431620;201703;452;1282;220;683;44;133;95;270;139;403
431630;201703;1335;3603;788;2445;218;703;199;584;417;1287
431640;201703;6249;17142;5628;16277;964;2963;3514;10271;4478;13234
431642;201703;513;1351;375;1106;43;137;159;447;202;584
431643;201703;331;845;148;421;22;65;43;100;65;165
431645;201703;1640;4630;1379;4165;211;733;835;2496;1046;3229
431647;201703;136;407;90;300;10;37;17;49;27;86
431650;201703;311;947;222;742;38;152;69;208;107;360
431660;201703;973;2772;609;2010;115;429;124;357;239;786
431670;201703;1223;3175;915;2643;173;579;412;1109;585;1688
431673;201703;238;641;107;350;26;86;12;33;38;119
431675;201703;716;1829;148;505;16;55;46;147;62;202
431680;201703;8954;24616;6916;20752;1936;6148;1840;5615;3776;11763
431690;201703;22069;61344;17356;53376;4692;15274;5515;17486;10207;32760
431695;201703;143;422;102;331;23;80;27;63;50;143
431697;201703;458;1269;398;1171;99;305;187;563;286;868
431700;201703;1479;4176;1280;3808;196;607;703;2056;899;2663
431710;201703;11793;33993;9901;31043;3190;10618;2675;9277;5865;19895
431720;201703;6773;18676;4988;15096;1070;3449;1289;3785;2359;7234
431725;201703;30;85;18;60;3;11;4;12;7;23
431730;201703;3610;10444;2889;9188;762;2630;796;2723;1558;5353
431740;201703;4952;13490;3853;11548;1241;4111;639;1716;1880;5827
431750;201703;8314;23532;7162;21654;1719;5621;3043;9265;4762;14886
431755;201703;330;896;73;249;13;39;13;42;26;81
431760;201703;4135;11328;3301;9864;523;1771;1742;4962;2265;6733
431770;201703;1905;5085;1607;4652;265;793;965;2765;1230;3558
431775;201703;189;519;113;360;25;87;9;21;34;108
431780;201703;2132;5795;1567;4683;386;1213;400;1123;786;2336
431790;201703;1121;3305;865;2748;157;551;297;908;454;1459
431795;201703;377;1005;229;689;40;127;60;172;100;299
431800;201703;8188;23795;6541;20749;2167;7467;832;2597;2999;10064
431805;201703;327;804;98;330;12;44;19;70;31;114
431810;201703;3101;8356;2376;6946;462;1469;1002;2823;1464;4292
431820;201703;2477;7582;2137;6932;459;1630;936;2978;1395;4608
431830;201703;10752;25777;8336;22261;2048;5954;3389;9116;5437;15070
431840;201703;2476;7421;2138;6806;462;1586;1063;3437;1525;5023
431842;201703;767;1939;288;890;40;132;59;153;99;285
431843;201703;350;1006;285;883;38;144;132;392;170;536
431844;201703;283;775;78;259;21;75;11;30;32;105
431845;201703;490;1422;356;1127;23;74;216;692;239;766
431846;201703;308;918;261;845;27;105;192;614;219;719
431848;201703;229;609;122;390;9;38;19;48;28;86
431849;201703;474;1150;93;267;13;35;13;26;26;61
431850;201703;4516;13195;3815;11729;841;2751;1283;3899;2124;6650
431860;201703;756;1989;535;1572;80;270;259;715;339;985
431861;201703;101;296;53;188;8;30;13;32;21;62
431862;201703;478;1557;390;1398;76;304;168;593;244;897
431870;201703;17676;51357;14422;45348;3281;11287;5301;16623;8582;27910
431880;201703;4043;11843;3256;10267;759;2655;1173;3544;1932;6199
431890;201703;4825;13066;3386;10413;1007;3331;645;2098;1652;5429
431900;201703;1117;3045;713;2214;174;614;278;806;452;1420
431910;201703;933;2248;455;1307;65;187;123;330;188;517
431912;201703;455;1340;377;1189;91;287;177;565;268;852
431915;201703;1202;3249;924;2768;218;702;361;1070;579;1772
431920;201703;1223;3382;1066;3120;114;360;751;2181;865;2541
431930;201703;1094;3055;791;2527;178;550;387;1271;565;1821
431935;201703;62;203;52;184;9;34;13;43;22;77
431936;201703;334;995;229;743;52;186;76;240;128;426
431937;201703;277;736;162;490;37;124;26;66;63;190
431940;201703;2440;6574;1563;4802;350;1167;420;1236;770;2403
431950;201703;1541;4620;1366;4313;254;893;704;2169;958;3062
431960;201703;2699;7639;2300;6852;633;1982;691;2030;1324;4012
431970;201703;410;1150;198;662;49;158;45;134;94;292
431971;201703;86;266;55;199;8;30;7;25;15;55
431973;201703;444;1541;392;1432;42;154;261;969;303;1123
431975;201703;106;244;23;83;2;8;4;13;6;21
431980;201703;1306;3819;1044;3289;259;860;333;1015;592;1875
431990;201703;6760;18451;4836;15376;937;3357;1403;4414;2340;7771
432000;201703;9843;27238;7935;23977;2366;7356;2770;8503;5136;15859
432010;201703;2108;5840;1700;5118;268;902;826;2427;1094;3329
432020;201703;2243;5331;1629;4466;343;1046;906;2395;1249;3441
432023;201703;506;1362;303;932;48;170;128;327;176;497
432026;201703;1119;3415;846;2832;120;392;450;1496;570;1888
432030;201703;366;1036;271;828;60;192;118;338;178;530
432032;201703;532;1404;374;1103;50;167;161;431;211;598
432035;201703;802;2379;712;2220;241;833;198;618;439;1451
432040;201703;974;2301;464;1443;74;272;158;481;232;753
432045;201703;250;685;133;450;26;93;39;138;65;231
432050;201703;583;1608;499;1463;78;270;270;796;348;1066
432055;201703;907;2500;624;1964;146;502;252;772;398;1274
432057;201703;395;970;277;761;44;108;140;368;184;476
432060;201703;467;1232;181;609;34;141;43;122;77;263
432065;201703;233;670;179;574;49;159;60;191;109;350
432067;201703;880;2663;675;2223;123;393;304;1010;427;1403
432070;201703;2354;6431;1510;4748;290;1001;303;923;593;1924
432080;201703;3782;10508;3176;9449;880;2919;1169;3434;2049;6353
432085;201703;321;889;212;712;55;186;93;310;148;496
432090;201703;1437;4046;1137;3484;319;1043;442;1316;761;2359
432100;201703;1319;3767;611;2098;102;378;33;90;135;468
432110;201703;2446;7365;1803;6028;438;1692;157;480;595;2172
432120;201703;4187;12324;3471;11048;1212;4110;880;2809;2092;6919
432130;201703;2724;7404;2202;6738;646;2123;897;2812;1543;4935
432132;201703;302;858;152;522;26;93;40;128;66;221
432135;201703;727;2109;603;1865;101;334;368;1121;469;1455
432140;201703;1772;5663;1385;4913;304;1105;565;2126;869;3231
432143;201703;1325;3854;1100;3479;206;715;529;1699;735;2414
432145;201703;1338;4034;841;2877;141;541;130;412;271;953
432146;201703;174;546;119;417;31;118;24;76;55;194
432147;201703;597;1934;467;1645;143;543;91;324;234;867
432149;201703;362;984;236;699;36;104;97;280;133;384
432150;201703;3561;9962;2689;8358;588;2037;787;2384;1375;4421
432160;201703;4237;13333;3722;12398;1117;3913;1218;4134;2335;8047
432162;201703;376;909;59;186;12;43;8;24;20;67
432163;201703;282;783;65;209;6;20;1;2;7;22
432166;201703;613;1819;487;1550;83;320;188;529;271;849
432170;201703;1184;3599;821;2823;192;690;181;612;373;1302
432180;201703;2451;6683;1513;4701;363;1190;266;714;629;1904
432183;201703;379;1196;302;1029;102;380;52;170;154;550
432185;201703;888;2315;605;1801;78;243;322;924;400;1167
432190;201703;2960;7967;1901;5721;417;1329;549;1554;966;2883
432195;201703;1054;2805;742;2277;174;521;274;847;448;1368
432200;201703;2814;8496;2320;7626;570;2073;989;3181;1559;5254
432210;201703;393;1094;284;904;54;203;109;320;163;523
432215;201703;798;2450;694;2283;134;427;393;1352;527;1779
432218;201703;270;680;161;455;25;67;57;141;82;208
432220;201703;4120;10665;3253;9278;457;1485;1833;5041;2290;6526
432225;201703;105;319;83;273;24;84;26;88;50;172
432230;201703;998;2665;588;1777;109;357;150;382;259;739
432232;201703;465;1341;394;1197;66;235;175;507;241;742
432234;201703;362;971;224;687;40;128;45;125;85;253
432235;201703;110;317;38;133;6;23;2;4;8;27
432237;201703;441;1181;388;1091;17;64;272;738;289;802
432240;201703;13521;41664;11465;38841;1441;5948;7020;24453;8461;30401
432250;201703;4614;15594;4162;14677;1255;4720;1369;4967;2624;9687
432252;201703;447;1153;303;930;52;166;164;513;216;679
432253;201703;1270;3994;728;2551;158;609;41;132;199;741
432254;201703;888;2397;246;808;48;177;18;48;66;225
432255;201703;202;512;107;345;17;65;35;98;52;163
432260;201703;7401;18252;5266;14836;1121;3217;2176;6497;3297;9714
432270;201703;2488;7367;2112;6668;627;2101;498;1590;1125;3691
432280;201703;1390;3719;754;2368;103;329;204;592;307;921
432285;201703;195;610;26;90;3;8;2;2;5;10
432290;201703;472;1402;301;1011;74;238;76;250;150;488
432300;201703;23371;68521;20292;63228;3530;12073;11484;35279;15014;47352
432310;201703;782;2277;614;1992;146;485;287;934;433;1419
432320;201703;203;517;88;283;18;57;10;30;28;87
432330;201703;318;843;127;423;11;34;20;66;31;100
432335;201703;158;460;69;247;10;40;12;32;22;72
432340;201703;346;837;173;526;33;115;49;136;82;251
432345;201703;645;1736;595;1660;73;278;388;998;461;1276
432350;201703;379;1021;199;640;31;90;56;177;87;267
432360;201703;196;604;39;142;5;20;8;24;13;44
432370;201703;406;1112;296;889;31;100;172;524;203;624
432375;201703;706;1789;530;1497;71;211;302;834;373;1045
432377;201703;238;803;39;152;7;29;10;32;17;61
432380;201703;1062;3309;767;2663;201;760;306;1027;507;1787
500020;201703;2269;6478;1745;5608;359;1342;745;2320;1104;3662
500025;201703;1426;3308;856;2339;82;234;481;1299;563;1533
500060;201703;6893;20498;5433;17937;750;2511;3317;11441;4067;13952
500070;201703;4280;12127;3354;10493;734;2576;1285;4099;2019;6675
500080;201703;1394;4032;1025;3361;253;924;371;1190;624;2114
500085;201703;2145;5379;1466;4395;119;384;918;2708;1037;3092
500090;201703;2293;6489;1614;5241;328;1123;637;2201;965;3324
500100;201703;2997;8290;2417;7301;437;1510;971;2806;1408;4316
500110;201703;7894;23219;6202;20566;1160;4124;2674;9557;3834;13681
500124;201703;2069;6573;1790;6102;407;1318;923;3513;1330;4831
500150;201703;1330;3370;874;2592;160;554;315;816;475;1370
500190;201703;5015;12632;3830;11062;771;2384;1993;5927;2764;8311
500200;201703;2487;6160;1828;5017;401;1173;726;1853;1127;3026
500210;201703;4653;13750;3820;12416;891;3056;1678;5565;2569;8621
500215;201703;1413;4293;1071;3620;179;676;405;1376;584;2052
500220;201703;3047;9240;2452;8215;446;1609;1125;3845;1571;5454
500230;201703;2933;7456;2069;6090;344;1062;1011;3071;1355;4133
500240;201703;4381;13621;3143;11083;570;2272;846;3185;1416;5457
500260;201703;2790;6821;1874;5439;267;823;953;2712;1220;3535
500270;201703;120175;309727;76127;231572;17154;56647;17323;52380;34477;109027
500280;201703;1354;3432;1066;3043;80;239;787;2287;867;2526
500290;201703;4411;9774;2482;7063;437;1370;871;2479;1308;3849
500295;201703;2552;7225;1497;4878;232;835;376;1033;608;1868
500310;201703;776;2051;627;1837;124;421;317;877;441;1298
500315;201703;3183;9820;2615;8876;377;1321;1593;5634;1970;6955
500320;201703;17367;54838;13491;47614;3910;15048;3448;13056;7358;28104
500325;201703;4436;10904;3062;8845;487;1517;1665;4900;2152;6417
500330;201703;6890;17621;4689;13665;610;2009;2182;6360;2792;8369
500345;201703;2097;5360;1602;4665;390;1207;694;2036;1084;3243
500348;201703;2191;6359;1895;5902;172;686;1265;3867;1437;4553
500350;201703;1291;3759;719;2429;65;218;228;795;293;1013
500370;201703;21824;65098;16423;55389;3578;13594;4993;17218;8571;30812
500375;201703;2852;7822;2085;6356;385;1297;609;1848;994;3145
500380;201703;3472;9302;2607;7830;560;1778;1043;3188;1603;4966
500390;201703;550;1242;318;879;49;159;157;416;206;575
500400;201703;1283;3858;953;3082;226;775;222;684;448;1459
500410;201703;2178;6167;1772;5575;326;1077;979;3184;1305;4261
500430;201703;2707;7341;1971;6275;367;1326;765;2587;1132;3913
500440;201703;1428;3737;936;2863;159;510;385;1200;544;1710
500450;201703;1309;3824;859;2915;185;699;127;359;312;1058
500460;201703;3984;11440;2740;9012;672;2454;533;1765;1205;4219
500470;201703;2919;8390;2028;6536;562;1963;328;1006;890;2969
500480;201703;2250;6715;2075;6500;164;493;1636;5485;1800;5978
500490;201703;944;2530;690;2111;185;645;137;450;322;1095
500500;201703;3846;11397;2963;10084;1004;3939;841;2939;1845;6878
500510;201703;823;2112;519;1565;54;185;238;669;292;854
500515;201703;1963;5074;1580;4539;203;576;941;2903;1144;3479
500520;201703;3255;11094;2816;10221;405;1743;1649;5901;2054;7644
500525;201703;1183;3675;956;3274;165;648;437;1554;602;2202
500540;201703;6314;16853;3668;11952;881;3391;401;1168;1282;4559
500560;201703;4888;15526;4389;14748;426;1550;3175;10837;3601;12387
500568;201703;4203;10192;2763;8035;644;2307;735;1900;1379;4207
500570;201703;7422;19263;4605;14057;1205;3969;730;2218;1935;6187
500580;201703;3670;10169;2947;9015;299;945;2009;6256;2308;7201
500600;201703;3939;10278;2531;7738;579;1961;664;2008;1243;3969
500620;201703;7834;22086;5715;18003;962;3223;2433;7841;3395;11064
500625;201703;713;2035;394;1304;67;245;140;446;207;691
500627;201703;708;1880;474;1455;93;295;104;318;197;613
500630;201703;5691;15208;3870;12056;952;3154;1105;3441;2057;6595
500635;201703;2667;9736;2195;9016;265;1116;1536;6788;1801;7904
500640;201703;1650;3926;1241;3353;72;234;891;2347;963;2581
500660;201703;19312;54794;14847;47644;4541;16178;4092;13271;8633;29449
500690;201703;2424;7174;1925;6397;903;3121;379;1403;1282;4524
500710;201703;3353;9779;2727;8687;658;2349;971;3090;1629;5439
500720;201703;6124;16013;3813;12098;950;3356;697;2143;1647;5499
500730;201703;993;2712;673;2107;150;502;203;620;353;1122
500740;201703;4504;11957;3377;9912;363;1283;1683;5004;2046;6287
500750;201703;989;2678;802;2357;139;470;384;1057;523;1527
500755;201703;1160;3335;780;2577;152;530;142;369;294;899
500769;201703;5478;14340;3032;9363;497;1723;583;1532;1080;3255
500770;201703;1670;4800;1132;3746;219;819;315;1042;534;1861
500780;201703;1152;3260;883;2753;235;762;206;648;441;1410
500790;201703;9572;25600;7904;22929;1466;4739;4150;11886;5616;16625
500793;201703;2176;6124;1598;5097;474;1568;260;742;734;2310
500795;201703;2362;6866;2001;6351;245;665;1401;4810;1646;5475
500797;201703;810;2177;547;1694;96;337;193;583;289;920
500800;201703;3009;7818;2201;6635;753;2574;457;1455;1210;4029
500830;201703;19884;51884;13802;40789;2610;8512;4881;13846;7491;22358
500840;201703;1343;3645;858;2673;97;331;317;932;414;1263
510010;201703;1275;3658;1024;3260;238;764;525;1719;763;2483
510020;201703;3462;9544;2060;6727;454;1572;381;1141;835;2713
510025;201703;7193;20516;5072;16367;1139;4028;1284;3883;2423;7911
510030;201703;1638;4351;1331;3905;245;766;684;1963;929;2729
510035;201703;945;2656;647;2208;123;416;354;1271;477;1687
510040;201703;1791;4701;1384;4097;170;540;790;2329;960;2869
510050;201703;1829;5270;1346;4363;338;1208;401;1254;739;2462
510060;201703;1530;4269;1155;3567;190;650;495;1469;685;2119
510080;201703;1038;3293;841;2883;257;1011;138;393;395;1404
510100;201703;688;1783;481;1384;49;168;224;582;273;750
510120;201703;312;650;203;514;10;28;136;349;146;377
510125;201703;2986;7710;2242;6428;361;1240;861;2281;1222;3521
510130;201703;1668;4640;1365;4118;355;1161;392;1163;747;2324
510140;201703;2833;8812;2201;7904;932;3781;475;1492;1407;5273
510160;201703;1230;4151;1108;3951;200;768;682;2442;882;3210
510170;201703;5041;15037;4058;13348;797;2843;1794;5833;2591;8676
510180;201703;12418;31922;8449;25558;2370;7692;2209;7655;4579;15347
510185;201703;1500;4202;1166;3744;221;674;644;2406;865;3080
510190;201703;2473;6682;1723;5582;317;1093;830;2797;1147;3890
510250;201703;14019;41124;12046;38265;3238;11033;5319;17477;8557;28510
510260;201703;2173;8891;1769;8074;310;1333;938;5007;1248;6340
510263;201703;3863;10469;2720;8542;648;2195;514;1566;1162;3761
510267;201703;5490;16029;3797;12392;883;3085;787;2554;1670;5639
510268;201703;1035;2853;826;2528;139;469;471;1424;610;1893
510269;201703;1016;3075;716;2450;248;916;154;493;402;1409
510270;201703;2781;8920;2269;7891;528;1859;785;2700;1313;4559
510279;201703;1723;5231;1369;4489;336;1176;441;1332;777;2508
510285;201703;1164;3358;873;2864;248;877;256;824;504;1701
510300;201703;3481;9775;2822;8849;216;738;2054;6577;2270;7315
510305;201703;1437;4457;1094;3801;244;881;352;1297;596;2178
510310;201703;763;2234;617;1986;207;710;193;609;400;1319
510320;201703;3781;10615;2873;8995;508;1836;971;2957;1479;4793
510325;201703;4943;15324;4144;14264;936;3310;2500;9077;3436;12387
510330;201703;2688;8695;2122;7677;527;2005;779;3059;1306;5064
510335;201703;4947;14787;3959;13494;478;1672;2613;9481;3091;11153
510336;201703;571;1730;422;1443;78;279;195;674;273;953
510337;201703;1904;6144;1485;5363;568;2160;284;1098;852;3258
510340;201703;76309;200322;52205;162193;16666;58169;9296;29980;25962;88149
510343;201703;1095;3134;814;2591;131;446;369;1144;500;1590
510345;201703;1564;4618;1216;3991;290;1006;416;1348;706;2354
510350;201703;3106;8294;2319;7190;574;1889;953;3083;1527;4972
510360;201703;1790;4253;1124;3451;96;394;782;2386;878;2780
510370;201703;1439;4600;1154;4127;235;913;609;2282;844;3195
510380;201703;516;1480;292;1015;85;317;24;87;109;404
510385;201703;959;3630;695;3027;88;423;329;1579;417;2002
510390;201703;1040;3312;910;3069;232;747;436;1577;668;2324
510395;201703;764;1845;552;1528;59;186;247;758;306;944
510410;201703;3879;12306;3297;11214;841;2921;1527;5472;2368;8393
510420;201703;2431;5964;1768;4929;188;618;930;2540;1118;3158
510450;201703;707;1835;473;1452;112;389;104;311;216;700
510452;201703;652;2071;486;1698;79;286;250;874;329;1160
510454;201703;874;2701;722;2408;124;444;416;1417;540;1861
510455;201703;957;2920;718;2388;136;524;246;755;382;1279
510460;201703;2321;5981;1715;5112;177;625;969;2799;1146;3424
510480;201703;4324;11089;3091;8915;543;1678;1159;3158;1702;4836
510490;201703;1549;4802;1306;4427;304;1135;656;2171;960;3306
510500;201703;1455;4274;1007;3393;190;769;447;1461;637;2230
510510;201703;2771;9353;2327;8522;687;2751;549;2149;1236;4900
510515;201703;6297;17957;4254;13850;908;3237;939;2755;1847;5992
510517;201703;1525;4502;1231;3961;339;1129;253;809;592;1938
510520;201703;2177;4797;1468;3922;26;64;966;2824;992;2888
510523;201703;953;2732;843;2545;104;301;586;1832;690;2133
510525;201703;5359;16123;4311;14025;902;3122;1541;4805;2443;7927
510530;201703;494;1406;414;1286;32;146;288;841;320;987
510550;201703;2804;9002;2170;7781;572;2166;704;2611;1276;4777
510558;201703;1870;5343;1613;4992;147;502;1006;3297;1153;3799
510560;201703;1608;4805;1029;3819;274;1123;225;887;499;2010
510562;201703;5361;15277;3941;12493;1087;3736;1005;3378;2092;7114
510590;201703;3218;8133;2489;7226;459;1283;1518;4675;1977;5958
510600;201703;1600;4012;1063;3125;224;702;349;1015;573;1717
510610;201703;2898;8128;2307;7238;244;876;1451;4514;1695;5390
510615;201703;1978;5964;1669;5464;515;1764;699;2357;1214;4121
510617;201703;641;1886;538;1718;30;93;420;1402;450;1495
510618;201703;1431;4101;1040;3350;202;774;497;1510;699;2284
510619;201703;741;2056;436;1467;81;308;45;129;126;437
510620;201703;1384;3427;761;2441;197;710;113;349;310;1059
510621;201703;842;2807;753;2636;194;779;213;706;407;1485
510622;201703;4044;12025;2921;9668;832;3010;525;1624;1357;4634
510623;201703;3405;9229;2587;7893;595;2066;855;2486;1450;4552
510624;201703;1745;4799;882;3002;168;650;140;426;308;1076
510625;201703;1985;5528;1501;4726;429;1527;236;767;665;2294
510626;201703;1637;4385;1059;3558;297;1097;233;864;530;1961
510627;201703;694;1976;469;1505;136;469;108;362;244;831
510628;201703;1534;3749;1041;3060;181;530;604;1813;785;2343
510629;201703;1698;5473;1378;4759;372;1385;431;1531;803;2916
510630;201703;2508;8236;1707;6543;401;1673;288;1175;689;2848
510631;201703;394;1093;326;973;10;27;268;801;278;828
510637;201703;2893;8120;2376;7272;804;2666;710;2169;1514;4835
510642;201703;4801;15624;4074;14553;1190;4636;1692;6348;2882;10984
510645;201703;966;2146;601;1666;179;499;181;533;360;1032
510650;201703;6351;20062;5674;19271;1295;4651;3543;12526;4838;17177
510665;201703;1764;4581;1107;3373;197;626;415;1311;612;1937
510670;201703;374;828;209;597;20;67;113;332;133;399
510675;201703;6264;19211;4941;16656;1421;5233;1039;3530;2460;8763
510677;201703;1919;5120;1521;4608;199;618;1045;3351;1244;3969
510680;201703;705;2120;520;1749;118;416;75;236;193;652
510682;201703;2015;6350;1534;5449;459;1820;299;1021;758;2841
510685;201703;924;2477;716;2140;91;316;389;1112;480;1428
510700;201703;4176;10742;2802;8813;649;2087;1250;4110;1899;6197
510704;201703;10074;26138;7305;21350;1405;4602;2832;7824;4237;12426
510706;201703;1899;5621;1291;4740;252;980;666;2601;918;3581
510710;201703;3131;8569;2187;6674;501;1583;611;1726;1112;3309
510715;201703;704;1692;488;1339;69;186;186;541;255;727
510718;201703;2374;5748;1506;4725;648;2117;295;1139;943;3256
510719;201703;386;877;239;682;18;65;123;347;141;412
510720;201703;1101;2710;777;2265;193;648;260;675;453;1323
510724;201703;731;2153;529;1769;113;421;196;616;309;1037
510726;201703;729;1681;469;1298;73;213;269;718;342;931
510729;201703;720;1794;386;1169;79;262;119;356;198;618
510730;201703;2860;7953;2044;6501;579;1981;513;1612;1092;3593
510735;201703;1002;3187;785;2878;136;556;409;1540;545;2096
510740;201703;1186;3016;819;2460;129;371;432;1416;561;1787
510757;201703;732;2382;605;2140;263;978;184;629;447;1607
510760;201703;32483;80838;21266;62928;5928;19457;4202;11751;10130;31208
510770;201703;4461;10791;3591;9772;346;880;2321;7030;2667;7910
510774;201703;349;969;284;828;54;159;127;408;181;567
510775;201703;648;1952;533;1741;147;554;121;360;268;914
510776;201703;545;1511;420;1251;91;279;167;508;258;787
510777;201703;1548;4452;1144;3910;105;381;919;3184;1024;3565
510779;201703;607;1803;477;1570;69;220;245;840;314;1060
510780;201703;3722;10762;2989;9658;711;2393;1210;4308;1921;6701
510785;201703;1729;4912;1194;3974;344;1207;191;684;535;1891
510787;201703;2350;6999;1821;6052;821;2855;258;824;1079;3679
510788;201703;592;1486;415;1219;106;311;147;523;253;834
510790;201703;15077;43323;10222;34145;2201;8466;1062;3646;3263;12112
510792;201703;8639;24446;5756;19100;1213;4442;979;3184;2192;7626
510794;201703;1171;3625;919;3146;264;996;254;842;518;1838
510795;201703;8050;23680;5910;19730;1628;6021;1089;3950;2717;9971
510800;201703;1554;4315;1194;3771;268;910;489;1463;757;2373
510805;201703;2013;5521;1466;4590;298;1045;611;1796;909;2841
510810;201703;675;1618;507;1389;131;353;250;676;381;1029
510820;201703;717;1629;461;1268;72;248;178;432;250;680
510830;201703;707;2015;564;1809;122;393;281;972;403;1365
510835;201703;634;1821;474;1540;87;310;211;652;298;962
510840;201703;44341;111510;35427;99860;8086;23811;16679;49007;24765;72818
510850;201703;1572;4239;991;3196;284;1058;182;546;466;1604
510860;201703;2680;8101;1900;6660;659;2586;161;553;820;3139
510880;201703;576;1914;493;1765;127;480;211;784;338;1264
510885;201703;636;1759;504;1569;99;352;208;635;307;987
510890;201703;804;2461;656;2253;123;453;376;1327;499;1780
510895;201703;1166;3436;934;3014;202;747;344;1034;546;1781
520005;201703;1617;4998;1408;4712;412;1361;638;2300;1050;3661
520010;201703;1850;6051;1445;5186;528;2172;238;741;766;2913
520013;201703;3114;8720;2298;7146;521;1664;690;2241;1211;3905
520015;201703;485;1383;392;1255;91;311;133;455;224;766
520017;201703;1080;3127;892;2825;203;700;374;1144;577;1844
520020;201703;423;1088;335;961;74;220;147;413;221;633
520025;201703;30658;89661;27725;86215;3303;11126;20743;64721;24046;75847
520030;201703;4754;14369;3917;12979;651;2389;2014;6723;2665;9112
520050;201703;448;1123;279;808;23;62;163;493;186;555
520055;201703;796;2381;674;2143;135;422;335;1083;470;1505
520060;201703;1360;4185;1142;3778;282;1087;351;1100;633;2187
520080;201703;1872;5268;1525;4815;283;848;813;2778;1096;3626
520082;201703;1063;2809;940;2617;112;259;630;1826;742;2085
520085;201703;732;2175;626;1998;158;496;214;675;372;1171
520090;201703;953;2167;678;1819;138;316;355;1053;493;1369
520110;201703;40642;116144;31501;102271;11790;43644;3373;10416;15163;54060
520120;201703;189;487;117;367;17;59;35;113;52;172
520130;201703;3466;9560;3125;9069;717;2287;1622;4826;2339;7113
520140;201703;33688;108658;28987;99851;10746;40285;3857;13358;14603;53643
520145;201703;367;1036;272;863;52;191;83;259;135;450
520150;201703;463;1232;379;1141;56;194;232;675;288;869
520160;201703;890;2330;723;2093;186;547;244;720;430;1267
520170;201703;4591;10222;3489;8970;241;691;2848;7382;3089;8073
520180;201703;2203;6345;1846;5821;360;1287;850;2657;1210;3944
520215;201703;1954;4963;1596;4403;195;565;988;2778;1183;3343
520235;201703;668;1693;481;1411;86;291;190;530;276;821
520250;201703;1565;4301;1105;3565;293;1035;196;645;489;1680
520260;201703;812;2037;525;1522;80;238;195;556;275;794
520280;201703;569;1649;480;1483;146;454;196;662;342;1116
520310;201703;1243;2939;869;2351;218;643;272;828;490;1471
520320;201703;1990;6029;1642;5400;154;530;1013;3424;1167;3954
520330;201703;2558;7871;1974;6885;568;2194;363;1268;931;3462
520340;201703;1913;4753;1428;4065;202;501;918;2802;1120;3303
520350;201703;3294;8765;2508;7352;659;2084;872;2473;1531;4557
520355;201703;1187;3717;1036;3479;264;979;493;1628;757;2607
520357;201703;825;2182;668;1941;60;182;452;1327;512;1509
520360;201703;742;2096;619;1897;183;586;217;688;400;1274
520380;201703;1321;3523;868;2631;118;392;380;1109;498;1501
520390;201703;969;2350;583;1820;197;715;152;420;349;1135
520393;201703;551;1308;422;1128;50;146;229;587;279;733
520396;201703;676;2128;566;1919;107;388;310;1038;417;1426
520400;201703;1619;4608;1379;4259;272;899;809;2480;1081;3379
520410;201703;1523;3547;1083;2937;179;546;630;1684;809;2230
520420;201703;324;910;232;711;34;106;106;309;140;415
520425;201703;1259;3440;978;2905;267;802;399;1238;666;2040
520430;201703;1841;4824;1125;3496;250;792;147;439;397;1231
520440;201703;3642;9297;2412;7106;672;2181;470;1363;1142;3544
520450;201703;10867;29261;7482;23339;1937;6689;413;1311;2350;8000
520455;201703;705;2064;561;1831;198;695;171;579;369;1274
520460;201703;901;2492;744;2252;120;412;427;1263;547;1675
520465;201703;819;2168;721;2028;57;199;534;1446;591;1645
520470;201703;1714;5506;1542;5247;302;1066;992;3510;1294;4576
520480;201703;881;2569;600;2044;111;399;118;356;229;755
520485;201703;1386;4221;1205;3947;204;722;783;2585;987;3307
520490;201703;3980;12123;3125;10770;613;2169;1687;5996;2300;8165
520495;201703;1443;3639;1195;3320;93;271;880;2549;973;2820
520500;201703;1303;3623;1073;3290;264;902;423;1272;687;2174
520505;201703;710;1975;590;1784;124;363;299;914;423;1277
520510;201703;8638;23497;6132;19610;1398;5025;1766;5719;3164;10744
520520;201703;1074;2954;863;2647;261;846;282;899;543;1745
520530;201703;2006;6482;1619;5817;564;2065;418;1665;982;3730
520540;201703;2815;7781;2000;6258;530;1725;332;1083;862;2808
520545;201703;1010;2989;823;2668;155;555;267;832;422;1387
520547;201703;628;1951;539;1807;174;590;178;591;352;1181
520549;201703;9941;29089;8260;26697;2043;6958;3978;13158;6021;20116
520551;201703;3774;11320;3411;10789;696;2471;2141;6693;2837;9164
520552;201703;771;2264;695;2169;99;324;498;1583;597;1907
520570;201703;595;1614;430;1350;117;393;153;469;270;862
520580;201703;3078;7338;2162;6099;383;1181;1175;3353;1558;4534
520590;201703;1450;4105;1111;3506;258;857;220;702;478;1559
520620;201703;8029;23029;6813;21488;1644;5320;3584;11564;5228;16884
520630;201703;1000;2561;711;2097;94;301;318;923;412;1224
520640;201703;2784;7472;2277;6618;542;1616;899;2681;1441;4297
520650;201703;888;2283;635;1828;86;269;336;954;422;1223
520660;201703;371;951;248;769;88;294;80;268;168;562
520670;201703;969;2814;850;2644;56;201;660;2022;716;2223
520680;201703;790;2048;596;1738;142;424;241;720;383;1144
520690;201703;299;767;211;628;52;140;100;308;152;448
520710;201703;556;1439;352;1041;8;23;207;602;215;625
520725;201703;1597;4043;1175;3337;164;518;739;2083;903;2601
520735;201703;832;2217;580;1749;104;346;213;642;317;988
520740;201703;1748;4530;1402;4086;217;681;823;2392;1040;3073
520750;201703;614;1648;496;1468;104;286;226;734;330;1020
520753;201703;1522;3972;1362;3760;158;415;922;2727;1080;3142
520760;201703;790;2069;675;1916;58;153;495;1491;553;1644
520780;201703;1857;4517;1402;3866;140;397;825;2232;965;2629
520790;201703;3055;7584;2262;6408;159;423;1626;4825;1785;5248
520800;201703;16668;45359;14092;42320;2700;7735;8757;28159;11457;35894
520810;201703;1099;2640;845;2352;57;165;658;1940;715;2105
520815;201703;597;1859;438;1522;173;681;24;80;197;761
520830;201703;1644;4089;1292;3691;52;133;1075;3072;1127;3205
520840;201703;1589;5111;1366;4752;543;2010;332;1234;875;3244
520850;201703;602;1784;435;1511;111;453;113;386;224;839
520860;201703;6489;19097;5007;16660;1252;4458;1703;5874;2955;10332
520870;201703;90868;244437;67552;207569;20621;69707;14713;44187;35334;113894
520880;201703;6394;18228;4909;16099;2033;7427;530;1715;2563;9142
520890;201703;3771;10371;2983;9058;592;2034;1419;4276;2011;6310
520910;201703;3621;10259;2574;8281;900;3125;491;1506;1391;4631
520915;201703;647;1884;505;1602;103;353;227;719;330;1072
520920;201703;3496;9197;2529;7744;457;1523;1047;3354;1504;4877
520929;201703;631;1652;495;1431;94;235;252;807;346;1042
520940;201703;1137;3161;907;2823;90;306;657;2053;747;2359
520945;201703;646;1520;507;1295;96;228;270;663;366;891
520960;201703;988;2865;776;2470;70;225;370;1208;440;1433
520970;201703;2614;8025;2264;7389;632;2255;533;1723;1165;3978
520980;201703;776;2171;652;1983;163;532;347;1062;510;1594
520990;201703;3006;9416;2819;9174;310;1045;1978;6785;2288;7830
520993;201703;957;2432;754;2119;41;118;545;1556;586;1674
520995;201703;2257;6077;1954;5675;372;1065;1194;3537;1566;4602
521000;201703;7030;21134;5678;18515;2065;7261;1035;3295;3100;10556
521010;201703;4046;11468;3161;9884;664;2081;1367;4317;2031;6398
521015;201703;699;1864;589;1687;109;308;371;1067;480;1375
521020;201703;2858;8150;1968;6303;548;1897;224;690;772;2587
521030;201703;644;1617;481;1350;84;229;197;583;281;812
521040;201703;6318;16786;5180;14997;1585;4802;1673;5062;3258;9864
521056;201703;847;2491;677;2203;215;760;190;655;405;1415
521060;201703;1056;2718;833;2378;95;280;472;1398;567;1678
521080;201703;1092;2643;630;1900;55;195;262;716;317;911
521090;201703;3024;7948;2334;6997;737;2329;715;2242;1452;4571
521100;201703;1918;4485;1413;3791;199;520;877;2415;1076;2935
521120;201703;4697;11894;3604;10537;726;2206;1578;5021;2304;7227
521130;201703;1007;2644;716;2093;66;242;390;1135;456;1377
521140;201703;986;2944;792;2576;168;579;277;921;445;1500
521150;201703;11734;29342;7670;22423;2527;7839;2012;6106;4539;13945
521160;201703;891;2056;567;1531;94;274;257;676;351;950
521170;201703;1135;2774;837;2319;123;362;503;1369;626;1731
521180;201703;6169;19491;5514;18371;1434;5109;1918;6551;3352;11660
521190;201703;8897;25235;5936;19790;1506;5514;1194;3999;2700;9513
521200;201703;749;2029;598;1774;67;232;333;978;400;1210
521205;201703;623;1722;494;1501;49;164;308;930;357;1094
521210;201703;901;2473;564;1774;134;477;95;259;229;736
521220;201703;4349;10692;3171;9133;657;2072;1435;4243;2092;6315
521225;201703;379;933;313;860;30;71;228;661;258;732
521230;201703;1304;3918;1180;3686;405;1272;544;1723;949;2995
521250;201703;30669;92267;25776;85013;10860;37498;6653;23477;17513;60975
521260;201703;694;1656;565;1481;96;286;326;845;422;1131
521270;201703;1787;5083;1618;4852;124;312;1236;3862;1360;4174
521280;201703;1873;5648;1538;5002;463;1602;474;1535;937;3137
521290;201703;446;1218;332;1055;83;312;162;487;245;799
521295;201703;1201;2820;984;2529;116;289;709;1901;825;2190
521300;201703;1835;5152;1562;4730;169;555;1031;3119;1200;3674
521305;201703;715;2019;582;1807;109;343;306;983;415;1326
521308;201703;4308;12712;3419;11001;748;2465;1517;4944;2265;7409
521310;201703;8281;23723;5829;19025;1512;5390;1313;4104;2825;9494
521340;201703;334;855;315;833;15;38;279;734;294;772
521350;201703;1941;5271;1554;4666;222;661;980;3008;1202;3669
521370;201703;925;2649;650;2140;212;755;99;339;311;1094
521375;201703;1360;3810;1073;3391;248;846;488;1537;736;2383
521377;201703;1088;2692;972;2562;53;109;837;2236;890;2345
521380;201703;5731;16037;4013;12838;559;1894;1074;3593;1633;5487
521385;201703;563;1440;468;1325;139;408;208;638;347;1046
521390;201703;755;2091;607;1894;187;667;197;602;384;1269
521400;201703;2002;5555;1788;5294;278;913;1260;3745;1538;4658
521405;201703;1392;3862;1089;3332;297;965;448;1399;745;2364
521410;201703;720;2138;671;2068;177;495;328;1098;505;1593
521440;201703;1393;4000;1120;3445;267;903;307;824;574;1727
521450;201703;3654;11796;2959;10395;902;3377;605;2105;1507;5482
521460;201703;6869;19305;5525;16946;1543;5107;2103;6337;3646;11444
521470;201703;679;1950;483;1538;107;341;88;271;195;612
521480;201703;353;1054;234;786;49;181;72;231;121;412
521483;201703;2777;7172;2054;5923;519;1537;547;1563;1066;3100
521486;201703;1665;4155;1340;3707;96;253;1002;2782;1098;3035
521487;201703;490;1314;367;1118;99;333;86;257;185;590
521490;201703;805;2271;620;1943;39;167;422;1282;461;1449
521500;201703;1337;4115;987;3386;192;764;226;699;418;1463
521520;201703;877;2033;657;1740;140;386;313;894;453;1280
521523;201703;13014;45748;11643;42839;4215;16364;2172;8937;6387;25301
521525;201703;1088;2749;889;2464;103;330;545;1454;648;1784
521530;201703;1717;4819;1098;3586;244;852;173;550;417;1402
521540;201703;904;2409;608;1908;107;403;248;765;355;1168
521550;201703;1596;4043;1030;2917;182;550;465;1295;647;1845
521560;201703;3675;11936;2991;10987;902;3571;1332;5146;2234;8717
521565;201703;610;1555;513;1431;80;224;331;912;411;1136
521570;201703;4704;12869;3021;9562;643;2199;417;1354;1060;3553
521580;201703;535;1246;318;931;69;206;50;148;119;354
521590;201703;598;1649;476;1449;137;470;174;501;311;971
521600;201703;430;1241;304;977;82;268;63;197;145;465
521630;201703;1304;3190;903;2626;210;730;217;563;427;1293
521640;201703;2130;5292;1629;4604;391;1096;716;2121;1107;3217
521645;201703;554;1652;411;1350;104;365;119;358;223;723
521680;201703;1283;4086;1070;3669;400;1450;121;425;521;1875
521690;201703;553;1588;488;1481;114;402;241;699;355;1101
521710;201703;2742;7941;2178;6955;481;1607;532;1709;1013;3316
521720;201703;1918;5371;1465;4525;251;802;741;2232;992;3034
521730;201703;3693;11821;3142;10729;1145;4313;554;1645;1699;5958
521740;201703;3669;10085;2905;8974;554;1898;1336;4326;1890;6224
521760;201703;14558;44901;12309;41265;3362;12351;4425;15221;7787;27572
521770;201703;2616;7409;2062;6362;708;2375;538;1585;1246;3960
521800;201703;6735;20116;5730;18410;1717;5813;2016;6859;3733;12672
521805;201703;929;2067;668;1703;167;390;308;865;475;1255
521810;201703;763;1889;561;1607;100;305;247;753;347;1058
521830;201703;5141;15918;4523;14998;626;2294;2976;9823;3602;12117
521839;201703;685;1860;502;1521;104;346;203;585;307;931
521850;201703;6430;17176;4713;14274;1239;4048;920;2683;2159;6731
521860;201703;1917;5043;1449;4331;318;1104;456;1346;774;2450
521870;201703;480;1568;398;1399;105;384;133;448;238;832
521878;201703;771;2171;547;1722;92;331;197;575;289;906
521880;201703;21639;55674;14943;45084;3832;12310;4535;14308;8367;26618
521890;201703;3236;9479;2390;7780;628;2215;401;1286;1029;3501
521900;201703;1445;3731;970;3003;240;817;334;991;574;1808
521910;201703;944;2513;829;2365;119;365;472;1429;591;1794
521920;201703;296;938;241;830;82;304;51;177;133;481
521925;201703;700;2080;560;1818;113;381;149;460;262;841
521930;201703;3468;10959;2999;10103;1060;3740;616;2170;1676;5910
521935;201703;618;1716;523;1541;114;320;242;696;356;1016
521940;201703;945;2555;785;2326;144;480;454;1329;598;1809
521945;201703;655;1983;551;1800;93;308;267;942;360;1250
521950;201703;674;1690;538;1501;52;165;384;1072;436;1237
521960;201703;647;1920;507;1645;98;354;228;717;326;1071
521970;201703;2726;7077;2238;6499;134;342;1861;5638;1995;5980
521971;201703;970;2596;679;2070;126;410;169;499;295;909
521973;201703;953;2900;800;2633;146;510;389;1295;535;1805
521975;201703;12718;34652;11351;32958;1905;5888;7525;21753;9430;27641
521980;201703;2176;5821;1836;5395;238;607;1383;4236;1621;4843
521990;201703;1152;3228;926;2878;101;340;615;1969;716;2309
522000;201703;2312;6225;1683;5426;213;749;883;3024;1096;3773
522005;201703;378;910;265;748;81;216;93;272;174;488
522010;201703;3328;9315;2741;8365;966;3018;637;1982;1603;5000
522015;201703;911;2639;743;2363;163;515;343;1115;506;1630
522020;201703;5229;13310;3867;11166;918;2756;1757;5090;2675;7846
522026;201703;688;1886;516;1678;67;224;294;1024;361;1248
522028;201703;568;1583;438;1296;52;158;228;650;280;808
522040;201703;2322;5598;1834;5007;327;891;1243;3466;1570;4357
522045;201703;14987;48100;12297;42712;3377;12843;2149;7400;5526;20243
522050;201703;1111;3157;779;2495;167;565;205;581;372;1146
522060;201703;2349;7000;1968;6431;426;1470;1005;3351;1431;4821
522068;201703;1676;5074;1482;4840;165;499;1076;3700;1241;4199
522070;201703;677;1991;602;1866;76;298;404;1205;480;1503
522100;201703;471;1390;400;1276;119;419;164;512;283;931
522108;201703;832;2576;690;2338;67;294;503;1650;570;1944
522119;201703;1435;4177;1184;3805;239;803;569;1886;808;2689
522130;201703;341;937;276;856;71;233;149;470;220;703
522140;201703;16267;46771;13224;41189;3982;13392;2575;7709;6557;21101
522145;201703;808;2153;667;1941;171;461;342;1093;513;1554
522150;201703;960;2496;770;2201;182;516;312;920;494;1436
522155;201703;857;2415;743;2239;165;458;402;1283;567;1741
522157;201703;658;1779;550;1621;33;124;406;1183;439;1307
522160;201703;6189;17182;4409;13986;1278;4445;439;1479;1717;5924
522170;201703;2293;6655;1760;5645;583;1988;348;1126;931;3114
522180;201703;356;992;249;807;69;236;56;199;125;435
522185;201703;16153;44328;12826;40072;3770;12556;5569;18148;9339;30704
522190;201703;880;2149;677;1867;122;340;316;912;438;1252
522200;201703;1683;5401;1320;4577;317;1153;261;877;578;2030
522205;201703;1313;3598;1041;3179;153;509;586;1770;739;2279
522220;201703;1417;3589;1122;3218;176;516;657;2009;833;2525
522230;201703;1248;3403;1055;3110;129;469;654;1920;783;2389
530010;201703;187252;576122;164664;538268;42380;154497;68426;217704;110806;372201
110001;201702;3187;10552;2833;9975;659;2423;1416;5063;2075;7486
110002;201702;12646;36107;9699;31038;3003;10397;2926;9188;5929;19585
110003;201702;694;2176;584;1977;192;696;114;364;306;1060
110004;201702;9041;28180;7367;24881;2330;8434;1314;4778;3644;13212
110005;201702;1691;5304;1448;4847;435;1537;578;1932;1013;3469
110006;201702;1666;5084;1150;4024;348;1291;125;411;473;1702
110007;201702;1341;3975;1132;3577;327;1093;451;1626;778;2719
110008;201702;2331;7833;2164;7602;318;1055;1613;5919;1931;6974
110009;201702;4484;13528;3419;11790;1023;3767;982;3496;2005;7263
110010;201702;6919;21951;6045;20627;1754;6049;2673;10102;4427;16151
110011;201702;6757;20815;5748;18849;2010;6967;1717;5643;3727;12610
110012;201702;14648;41630;11378;36074;3094;10408;2792;9084;5886;19492
110013;201702;5298;16626;4459;15019;1795;6225;1041;3831;2836;10056
110014;201702;3962;11371;3290;10272;906;2951;1577;4906;2483;7857
110015;201702;4776;14129;3247;11077;859;3134;466;1620;1325;4754
110018;201702;3829;10618;2747;8889;711;2593;892;2774;1603;5367
110020;201702;65938;176193;47986;151927;10635;35977;19830;65996;30465;101973
110025;201702;4128;11658;3291;10196;480;1628;2025;6151;2505;7779
110026;201702;609;1847;549;1757;143;458;282;947;425;1405
110028;201702;5960;18163;4721;15679;1452;5243;557;1873;2009;7116
110029;201702;1284;3595;981;3131;259;853;419;1360;678;2213
110030;201702;9795;26710;7435;23399;1967;6883;2478;7878;4445;14761
110032;201702;3589;11121;2973;9874;987;3356;799;2667;1786;6023
110033;201702;4855;15592;4249;14506;1490;5169;1353;4964;2843;10133
110034;201702;3335;8955;2637;7961;796;2544;1307;3939;2103;6483
110037;201702;1811;6219;1580;5715;404;1537;702;2548;1106;4085
110040;201702;3193;9902;2617;8828;812;2929;853;2816;1665;5745
110045;201702;4790;15378;4150;14531;1348;5094;1765;6213;3113;11307
110050;201702;1608;5122;1352;4632;473;1674;475;1662;948;3336
110060;201702;787;2580;621;2223;218;835;101;376;319;1211
110070;201702;1931;6407;1696;5864;560;2051;596;2005;1156;4056
110080;201702;4664;12346;3889;11475;594;1657;2722;8496;3316;10153
110090;201702;689;1984;499;1637;124;448;226;718;350;1166
110092;201702;1261;4138;1125;3938;190;722;677;2440;867;3162
110094;201702;3396;9969;2842;9159;966;3309;1026;3375;1992;6684
110100;201702;2068;6474;1841;6078;444;1577;974;3228;1418;4805
110110;201702;1582;4967;1339;4601;532;1902;325;1191;857;3093
110120;201702;1682;5264;1304;4457;376;1350;275;944;651;2294
110130;201702;2323;6587;1649;5447;487;1728;409;1400;896;3128
110140;201702;2306;7457;1826;6494;531;2016;429;1437;960;3453
110143;201702;1226;3727;911;3173;324;1199;312;1094;636;2293
110145;201702;1069;3014;748;2401;188;659;290;916;478;1575
110146;201702;384;1199;329;1109;65;210;167;576;232;786
110147;201702;650;1931;492;1623;131;452;163;507;294;959
110148;201702;1101;3380;728;2503;140;517;80;273;220;790
110149;201702;3203;9492;2500;8380;860;2868;954;3435;1814;6303
110150;201702;2340;6698;1902;6076;584;2045;678;2227;1262;4272
110155;201702;807;2505;699;2264;161;565;305;950;466;1515
110160;201702;1788;5768;1487;5183;552;1953;441;1607;993;3560
110170;201702;2688;7570;1947;6221;423;1439;900;2864;1323;4303
110175;201702;1591;4857;1270;4405;204;745;697;2541;901;3286
110180;201702;1184;3485;978;3166;279;895;492;1634;771;2529
120001;201702;2753;9257;2504;8871;503;1848;1503;5530;2006;7378
120005;201702;1535;6430;1447;6252;178;829;1035;4646;1213;5475
120010;201702;4750;15932;4556;15660;521;1764;3561;12539;4082;14303
120013;201702;2015;8024;1923;7893;449;1813;1171;5128;1620;6941
120017;201702;1923;6929;1785;6676;499;1879;801;3355;1300;5234
120020;201702;14088;62287;13628;61417;1903;8993;9768;45424;11671;54417
120025;201702;2321;8111;2232;7980;404;1501;1428;5223;1832;6724
120030;201702;6555;25085;6364;24865;232;1187;5725;22412;5957;23599
120032;201702;1508;7316;1450;7171;164;977;1085;5369;1249;6346
120033;201702;3553;14250;3460;14087;236;1075;3035;12416;3271;13491
120034;201702;1979;8549;1889;8355;153;949;1492;6502;1645;7451
120035;201702;3182;14096;3096;13944;212;1121;2637;11977;2849;13098
120038;201702;2541;9097;2409;8854;571;2143;1339;5089;1910;7232
120039;201702;1781;8446;1734;8357;183;1081;1322;6413;1505;7494
120040;201702;43272;154220;39823;148129;9098;36624;20827;79087;29925;115711
120042;201702;3043;12502;2885;12154;221;1165;2188;9276;2409;10441
120043;201702;964;4410;934;4361;66;311;782;3768;848;4079
120045;201702;4416;14763;4273;14602;339;1328;3756;12818;4095;14146
120050;201702;7945;32376;7564;31561;985;4493;5335;22899;6320;27392
120060;201702;7802;34270;7614;33939;745;3896;6015;27087;6760;30983
120070;201702;2673;9861;2584;9679;418;1593;1712;6617;2130;8210
120080;201702;3547;13372;3401;13121;609;2480;2366;9314;2975;11794
130002;201702;3193;12943;2983;12629;167;853;2609;11114;2776;11967
130006;201702;2129;8773;1846;8269;189;1016;1376;6174;1565;7190
130008;201702;2267;8761;2093;8432;137;657;1693;6844;1830;7501
130010;201702;3159;10281;2943;10038;141;515;2659;9122;2800;9637
130014;201702;3194;10345;2750;9618;499;1897;1718;6085;2217;7982
130020;201702;2787;10406;2655;10171;122;683;2261;8535;2383;9218
130030;201702;7992;29694;7648;29299;225;709;7139;27868;7364;28577
130040;201702;3794;11616;3341;11034;291;1072;2675;8933;2966;10005
130050;201702;6146;25008;5798;24551;323;1397;4990;21750;5313;23147
130060;201702;5834;26944;5573;26527;545;3133;4390;20909;4935;24042
130063;201702;3933;17213;3756;16997;252;1267;3323;15187;3575;16454
130068;201702;3191;13240;2876;12587;254;1289;2078;9189;2332;10478
130070;201702;7385;24106;6560;23152;472;1610;5475;19900;5947;21510
130080;201702;5604;24220;5238;23699;629;3376;3864;17594;4493;20970
130083;201702;2269;8762;2127;8538;262;1221;1582;6346;1844;7567
130090;201702;2829;9808;2694;9607;86;382;2375;8576;2461;8958
130100;201702;5889;21321;5722;21127;139;571;5431;20152;5570;20723
130110;201702;6658;21371;6306;20965;568;1738;5279;18040;5847;19778
130115;201702;4712;16304;4476;15945;159;657;3871;13857;4030;14514
130120;201702;14868;55873;13852;54564;1407;5837;11108;44764;12515;50601
130130;201702;4093;16332;4024;16219;204;1020;3535;14260;3739;15280
130140;201702;6249;24486;6139;24367;261;1104;5704;22721;5965;23825
130150;201702;3440;13653;3371;13567;143;760;3043;12212;3186;12972
130160;201702;4297;17673;4111;17436;440;2258;3334;14122;3774;16380
130165;201702;2909;11873;2767;11626;163;876;2324;9811;2487;10687
130170;201702;9748;33382;8427;31816;903;3636;6602;25552;7505;29188
130180;201702;3570;11701;3505;11615;73;248;3336;11116;3409;11364
130185;201702;12160;37587;10771;36057;698;1898;9093;32071;9791;33969
130190;201702;16885;57988;14826;55271;2299;8760;10199;39468;12498;48228
130195;201702;1973;8343;1918;8274;112;446;1694;7491;1806;7937
130200;201702;2045;6950;1864;6677;313;1128;1262;4688;1575;5816
130210;201702;1335;5167;1218;5028;125;673;950;3880;1075;4553
130220;201702;1988;8155;1846;7884;204;1032;1287;5520;1491;6552
130230;201702;3722;16993;3493;16628;406;2122;2679;13063;3085;15185
130240;201702;9059;32992;8105;31610;366;1954;6995;27347;7361;29301
130250;201702;19826;68496;18616;67016;2614;9143;13729;51844;16343;60987
130255;201702;4271;14757;3995;14331;198;811;3459;12478;3657;13289
130260;201702;247728;803627;222225;761239;64269;236323;95460;329759;159729;566082
130270;201702;7454;30666;6952;29905;831;3809;5257;23223;6088;27032
130280;201702;3340;13892;3223;13753;114;508;2981;12900;3095;13408
130290;201702;11198;39833;10596;39149;174;464;10103;38054;10277;38518
130300;201702;4556;17247;4310;16882;263;1263;3679;14486;3942;15749
130310;201702;5013;19141;4621;18625;360;1674;3780;15453;4140;17127
130320;201702;2992;10843;2743;10492;383;1551;1893;7452;2276;9003
130330;201702;3764;13533;3403;13087;169;854;2921;11240;3090;12094
130340;201702;18649;69862;17146;68048;1833;7419;13872;56699;15705;64118
130350;201702;3422;13933;3315;13779;255;1432;2788;11450;3043;12882
130353;201702;6131;18645;5360;17671;970;3124;3534;12472;4504;15596
130356;201702;4744;16930;4412;16404;515;1941;3221;12364;3736;14305
130360;201702;3314;9522;2925;9113;81;204;2740;8695;2821;8899
130370;201702;5450;21389;4968;20764;194;1048;4293;18104;4487;19152
130380;201702;7999;33076;7695;32635;500;2568;6563;27890;7063;30458
130390;201702;5261;23178;4976;22643;563;3027;3681;16718;4244;19745
130395;201702;2245;7775;2017;7352;211;812;1451;5343;1662;6155
130400;201702;2139;8099;2008;7909;113;553;1761;6948;1874;7501
130406;201702;10766;40728;9850;39484;1828;7716;6620;27043;8448;34759
130410;201702;3884;14664;3467;13933;1053;4481;1602;6664;2655;11145
130420;201702;10870;45151;10381;44449;1532;6815;7788;34245;9320;41060
130423;201702;3547;13192;3286;12838;244;1199;2766;10710;3010;11909
130426;201702;2397;10117;2319;9995;127;604;2034;8901;2161;9505
130430;201702;3551;12325;3401;12110;261;975;2846;10301;3107;11276
130440;201702;3615;12982;3386;12716;173;738;3012;11393;3185;12131
140002;201702;1725;5626;1568;5417;123;501;1210;4173;1333;4674
140005;201702;3632;9799;3500;9658;62;154;3380;9374;3442;9528
140010;201702;54357;155540;44487;141241;10681;35955;18548;62541;29229;98496
140015;201702;2987;9464;2766;9203;141;415;2449;8335;2590;8750
140017;201702;3232;10287;2906;9868;287;1003;2188;7733;2475;8736
140020;201702;4558;15140;4061;14455;543;2171;2852;10202;3395;12373
140023;201702;2200;7281;1904;6838;221;866;1325;4863;1546;5729
140028;201702;2082;5758;1897;5510;199;698;1420;3990;1619;4688
140030;201702;3623;11339;3354;10983;580;1649;2313;8017;2893;9666
140040;201702;1791;8205;1737;8130;118;734;1533;7088;1651;7822
140045;201702;2559;9392;2315;9056;440;1689;1513;6311;1953;8000
140047;201702;5620;17105;4924;16016;1189;3934;2373;8327;3562;12261
140050;201702;1413;4430;1253;4209;210;732;797;2756;1007;3488
140060;201702;1458;4387;1295;4133;217;739;881;2838;1098;3577
140070;201702;1656;8983;1602;8830;155;1028;1242;6864;1397;7892
150010;201702;36496;106476;34295;103528;2183;7386;28146;84942;30329;92328
150013;201702;1726;4986;1537;4772;164;492;1165;3727;1329;4219
150020;201702;12519;41652;12086;41062;1404;4325;9720;34108;11124;38433
150030;201702;7546;31491;7297;31137;529;2235;6234;27184;6763;29419
150034;201702;4153;11455;3799;10948;160;506;3302;9548;3462;10054
150040;201702;12576;39895;11193;38283;1202;3378;8922;32457;10124;35835
150050;201702;5579;22038;5307;21577;255;1337;4587;18622;4842;19959
150060;201702;17960;55535;16176;52696;3610;11695;9215;31300;12825;42995
150070;201702;6096;24532;5469;23863;199;1068;5037;22144;5236;23212
150080;201702;79345;201731;67759;186636;14475;40733;31865;94953;46340;135686
150085;201702;5635;18901;5393;18605;333;961;4753;16881;5086;17842
150090;201702;10390;39383;9815;38552;839;3557;7766;30984;8605;34541
150095;201702;5365;17285;4893;16633;328;1100;3930;13765;4258;14865
150100;201702;3222;11861;2997;11464;201;921;2366;8953;2567;9874
150110;201702;3660;17167;3640;17126;208;1058;3257;15455;3465;16513
150120;201702;6677;23971;6513;23730;455;1476;5486;20755;5941;22231
150125;201702;713;2015;621;1908;91;308;431;1325;522;1633
150130;201702;22339;67380;20510;64831;2328;7126;15144;49237;17472;56363
150140;201702;168010;460810;155459;444422;20472;58094;112579;328019;133051;386113
150145;201702;4499;14104;4085;13559;461;1521;3238;10970;3699;12491
150150;201702;12184;36347;11235;34993;1578;5202;7752;24486;9330;29688
150157;201702;3052;9050;2648;8498;317;1151;1822;5958;2139;7109
150160;201702;3056;9684;2878;9424;757;2524;1603;5444;2360;7968
150170;201702;21628;79060;20480;77205;2813;10991;14724;56650;17537;67641
150172;201702;3022;10212;2664;9627;299;1129;1970;7281;2269;8410
150175;201702;1845;5640;1727;5499;128;443;1414;4639;1542;5082
150178;201702;9752;29982;8441;28444;906;3312;6231;21675;7137;24987
150180;201702;18784;74352;18053;73392;1143;5298;15505;63548;16648;68846
150190;201702;7020;24039;6760;23698;193;844;6190;21803;6383;22647
150195;201702;5306;17202;4999;16728;137;495;4531;15267;4668;15762
150200;201702;5293;16655;5031;16353;96;364;4744;15509;4840;15873
150210;201702;24950;92680;24184;91651;1717;6726;20370;79209;22087;85935
150215;201702;7407;23187;6534;21831;2030;6999;2691;9320;4721;16319
150220;201702;11413;35351;10292;33652;2213;7447;5505;18565;7718;26012
150230;201702;11742;36345;10285;34322;1403;4898;6807;23360;8210;28258
150240;201702;34295;101659;29633;93395;9998;32546;7964;26454;17962;59000
150250;201702;4010;16748;3867;16544;814;3484;2562;11482;3376;14966
150260;201702;2024;7889;1923;7720;332;1342;1219;5048;1551;6390
150270;201702;8094;24810;6348;22559;1604;5858;3337;12420;4941;18278
150275;201702;5937;21373;5604;20862;619;2269;4225;16128;4844;18397
150276;201702;2125;6337;1892;6040;273;917;1419;4602;1692;5519
150277;201702;4724;14462;4056;13643;607;2196;2884;9966;3491;12162
150280;201702;5788;26023;5624;25681;712;3305;4263;19892;4975;23197
150285;201702;3039;11550;2820;11194;279;1243;2040;8244;2319;9487
150290;201702;10059;28304;9592;27789;566;1442;8432;25122;8998;26564
150293;201702;9128;24453;6800;21284;1959;6415;2453;8478;4412;14893
150295;201702;7549;21853;6251;20352;1414;4599;3536;12837;4950;17436
150300;201702;2036;6609;1903;6431;88;417;1585;5326;1673;5743
150304;201702;4111;13077;3590;12247;632;2156;2271;8052;2903;10208
150307;201702;6449;21433;6091;20930;340;1243;5207;17970;5547;19213
150309;201702;6042;20540;5390;19560;1278;4587;2922;11278;4200;15865
150310;201702;6500;27515;6214;27116;486;2388;5141;22608;5627;24996
150320;201702;9458;24285;8656;23378;522;1394;7217;19680;7739;21074
150330;201702;13991;46981;13117;45741;1785;6284;9658;34606;11443;40890
150340;201702;2559;7968;2361;7662;211;731;1807;5881;2018;6612
150345;201702;6730;21917;6298;21335;543;1886;5068;17544;5611;19430
150350;201702;8097;24244;7529;23558;1113;2960;5657;18554;6770;21514
150360;201702;20628;63684;18032;60450;2857;9497;12156;42563;15013;52060
150370;201702;9868;35170;9025;34022;957;3646;6851;26745;7808;30391
150375;201702;2888;12770;2785;12626;236;1121;2356;10808;2592;11929
150380;201702;9620;27564;8470;25963;483;1521;7097;22071;7580;23592
150390;201702;7650;33178;7159;32301;1170;5148;4801;22628;5971;27776
150400;201702;5890;22745;5669;22329;463;1817;4524;18162;4987;19979
150405;201702;8102;24306;7217;23215;764;1954;5406;18664;6170;20618
150410;201702;1590;5977;1467;5731;230;1034;908;3561;1138;4595
150420;201702;35187;116410;29330;107020;9775;38282;8541;34322;18316;72604
150430;201702;7435;24705;7054;24137;808;2748;5354;18756;6162;21504
150440;201702;5403;18384;5191;18108;455;1567;4246;15114;4701;16681
150442;201702;21558;61349;18932;57424;3216;9829;11391;35951;14607;45780
150445;201702;5450;18478;5024;17806;482;1745;3880;14014;4362;15759
150450;201702;4159;20210;4019;19966;485;2430;3153;16056;3638;18486
150460;201702;7134;26110;6604;25462;400;1774;5454;21906;5854;23680
150470;201702;17606;53832;16865;52938;1074;2887;14885;47678;15959;50565
150475;201702;3684;12674;3397;12280;274;1032;2737;10081;3011;11113
150480;201702;13983;47470;12814;45656;1308;4895;9856;35842;11164;40737
150490;201702;7230;27480;7036;27188;269;1248;6243;24277;6512;25525
150495;201702;4921;18042;4770;17851;152;643;4407;16580;4559;17223
150497;201702;2540;9322;2280;8816;719;2905;1018;4054;1737;6959
150500;201702;3140;8584;2899;8242;273;764;2309;6570;2582;7334
150503;201702;3283;10145;2741;9408;867;3024;1448;5225;2315;8249
150506;201702;10603;36549;9661;35220;2084;7109;6117;23955;8201;31064
150510;201702;9769;37728;8868;35898;1399;5601;5793;24568;7192;30169
150520;201702;6707;26471;6596;26331;234;969;6172;24861;6406;25830
150530;201702;12266;42165;11106;40359;1018;3573;8601;31930;9619;35503
150540;201702;4596;13831;4059;13084;245;883;3352;10817;3597;11700
150543;201702;5708;17393;5024;16434;1000;3335;3056;10426;4056;13761
150548;201702;9097;29226;8475;28451;343;1033;7747;26370;8090;27403
150549;201702;2033;6579;1869;6397;58;239;1711;5895;1769;6134
150550;201702;19950;63191;17437;58924;5159;17870;6597;23597;11756;41467
150553;201702;22398;76334;18640;68897;6628;25900;4812;18930;11440;44830
150555;201702;1757;5161;1452;4671;79;290;1057;3424;1136;3714
150560;201702;1857;6077;1721;5800;283;956;1024;3529;1307;4485
150563;201702;2517;8423;2337;8105;547;2042;1248;4347;1795;6389
150565;201702;3911;13436;3573;12896;145;713;2984;10838;3129;11551
150570;201702;5871;21141;5693;20843;449;1909;4511;16502;4960;18411
150580;201702;9786;40604;9499;40257;584;2626;8271;35688;8855;38314
150590;201702;5746;22816;5563;22583;178;866;5194;21100;5372;21966
150600;201702;8074;30817;7707;30303;271;1286;6929;27447;7200;28733
150610;201702;2380;7995;2198;7629;207;802;1636;5608;1843;6410
150611;201702;2722;9169;2561;8894;145;536;2133;7455;2278;7991
150613;201702;11778;34632;9550;31257;2686;9259;4025;13579;6711;22838
150616;201702;3089;9348;2352;8105;597;2287;715;2365;1312;4652
150618;201702;6349;21284;5675;20095;1295;4623;3144;11557;4439;16180
150619;201702;5037;17200;4631;16559;466;1921;3409;12116;3875;14037
150620;201702;6201;22109;5598;21347;627;2528;4337;16722;4964;19250
150630;201702;5842;17261;5525;16892;453;1445;4650;14438;5103;15883
150635;201702;3840;12445;3464;11715;911;3170;1450;5101;2361;8271
150640;201702;1988;5821;1881;5700;90;260;1702;5303;1792;5563
150650;201702;11385;34705;10280;32736;2794;8987;4493;15005;7287;23992
150655;201702;5017;16340;4715;15804;534;1929;3591;12127;4125;14056
150658;201702;4452;13247;3838;12440;718;2549;2413;8105;3131;10654
150660;201702;5602;17340;5111;16626;1028;3369;2953;9863;3981;13232
150670;201702;7511;19472;6146;17815;583;1763;4830;14343;5413;16106
150680;201702;58989;199081;50320;185129;14445;54125;21092;85905;35537;140030
150690;201702;1975;6067;1791;5791;194;648;1305;4265;1499;4913
150700;201702;6089;19032;5596;18386;843;2772;3832;12991;4675;15763
150710;201702;4273;14317;3840;13639;371;1458;2763;9940;3134;11398
150715;201702;4843;15108;4247;14207;398;1521;3182;10689;3580;12210
150720;201702;6386;25540;6058;24957;655;3043;4623;19323;5278;22366
150730;201702;10146;34213;9351;32896;1124;4134;7017;25287;8141;29421
150740;201702;3562;11337;3204;10710;614;2175;1813;6065;2427;8240
150745;201702;4760;15221;4297;14572;1061;3770;2546;8727;3607;12497
150746;201702;1341;4387;1278;4267;108;369;993;3371;1101;3740
150747;201702;5283;16340;4690;15599;480;1464;3418;12161;3898;13625
150750;201702;3454;11039;3125;10583;196;791;2512;8590;2708;9381
150760;201702;11298;35631;10491;34606;1366;4635;7633;25693;8999;30328
150770;201702;5885;22312;5670;21979;235;803;5040;20435;5275;21238
150775;201702;1037;3141;886;2891;167;658;497;1586;664;2244
150780;201702;3592;11506;3467;11365;131;533;3144;10308;3275;10841
150790;201702;5021;16162;4585;15661;284;960;3734;13669;4018;14629
150795;201702;14920;47971;13482;45739;2959;9854;7862;28098;10821;37952
150796;201702;3119;9034;2806;8666;260;859;2207;6960;2467;7819
150797;201702;3683;12603;3386;12062;125;520;2818;10056;2943;10576
150800;201702;13593;44139;12495;42792;2336;7282;8567;31359;10903;38641
150803;201702;6650;23773;6251;23125;708;2844;4663;17383;5371;20227
150805;201702;2666;9514;2455;9157;342;1276;1726;6587;2068;7863
150808;201702;5479;18066;4447;16067;1749;6916;536;2015;2285;8931
150810;201702;18660;56780;15490;52871;2471;8297;9934;36021;12405;44318
150812;201702;5248;16375;4814;15634;605;2218;3375;10709;3980;12927
150815;201702;8298;27463;7471;26442;731;2564;5877;21405;6608;23969
150820;201702;11306;32706;10139;31408;775;2173;8174;26148;8949;28321
150830;201702;12460;47322;11840;46560;614;3091;9961;40221;10575;43312
150835;201702;2135;7461;1992;7189;439;1584;1097;4133;1536;5717
150840;201702;7266;22075;6009;19936;1235;4508;3011;10030;4246;14538
160005;201702;799;2710;764;2648;60;249;623;2138;683;2387
160010;201702;1371;4641;1368;4638;17;28;1341;4587;1358;4615
160015;201702;1735;6434;1692;6370;78;257;1551;5952;1629;6209
160020;201702;1846;6791;1723;6599;206;882;1290;4984;1496;5866
160021;201702;1038;4429;1002;4369;113;631;747;3243;860;3874
160023;201702;976;4087;966;4067;71;295;828;3537;899;3832
160025;201702;1471;4419;1452;4398;36;88;1394;4249;1430;4337
160027;201702;8176;24365;7612;23739;1127;3356;5770;18739;6897;22095
160030;201702;50145;169835;44288;160651;10554;38035;23048;90455;33602;128490
160040;201702;4297;16760;4199;16627;174;996;3813;14911;3987;15907
160050;201702;3249;12034;2883;11514;1429;5419;907;4244;2336;9663
160053;201702;2974;11121;2904;11020;738;2736;1844;7292;2582;10028
160055;201702;564;2248;559;2241;31;160;502;1991;533;2151
160060;201702;15429;52891;14650;51990;1621;5703;11528;41835;13149;47538
160070;201702;2710;10609;2548;10347;189;920;2126;8628;2315;9548
160080;201702;2585;9645;2525;9571;56;294;2375;8972;2431;9266
170025;201702;508;1654;453;1574;132;478;228;797;360;1275
170030;201702;1158;3809;1000;3525;206;756;472;1705;678;2461
170035;201702;1314;3769;1091;3370;140;473;584;1822;724;2295
170040;201702;1864;5774;1650;5499;178;636;909;3323;1087;3959
170070;201702;1577;4221;1199;3728;211;704;676;2127;887;2831
170100;201702;2268;6845;1999;6445;186;586;1496;4889;1682;5475
170105;201702;738;2307;586;1988;139;514;256;841;395;1355
170110;201702;883;2928;770;2709;169;650;336;1202;505;1852
170130;201702;1349;4276;1070;3722;264;962;457;1680;721;2642
170190;201702;1545;4576;1162;3949;379;1220;259;1092;638;2312
170200;201702;1574;4323;1010;3246;285;1006;200;601;485;1607
170210;201702;30569;86359;24435;76620;8023;27309;4969;16717;12992;44026
170215;201702;1213;3722;1034;3453;103;396;723;2406;826;2802
170220;201702;5345;18269;4912;17408;1147;4178;2593;9457;3740;13635
170230;201702;1346;4274;1082;3746;225;852;468;1603;693;2455
170240;201702;2716;8052;2206;7250;230;919;1484;4835;1714;5754
170255;201702;3384;10656;2755;9531;799;2833;1130;4054;1929;6887
170270;201702;998;2453;674;2015;40;124;464;1363;504;1487
170290;201702;2718;7880;2390;7507;261;548;1885;6459;2146;7007
170300;201702;1828;5549;1494;4995;148;524;962;3262;1110;3786
170305;201702;705;2095;581;1859;91;328;283;908;374;1236
170307;201702;970;3458;829;3182;185;760;406;1603;591;2363
170310;201702;1483;4160;1132;3555;267;900;527;1649;794;2549
170320;201702;1111;3169;801;2650;149;519;391;1336;540;1855
170330;201702;793;2580;727;2471;50;200;546;1839;596;2039
170360;201702;451;1418;368;1274;72;291;184;605;256;896
170370;201702;1314;3730;1009;3240;147;532;527;1691;674;2223
170380;201702;1739;5673;1425;5148;206;842;774;2885;980;3727
170382;201702;562;1814;467;1651;43;194;316;1119;359;1313
170384;201702;1572;6259;1435;6007;389;1730;690;2930;1079;4660
170386;201702;846;2473;699;2216;204;782;234;674;438;1456
170388;201702;577;1752;462;1555;100;378;178;579;278;957
170389;201702;885;2991;794;2837;57;235;598;2119;655;2354
170390;201702;1290;3641;1062;3358;88;291;804;2602;892;2893
170410;201702;537;1705;435;1516;29;125;277;955;306;1080
170460;201702;466;1270;321;1020;53;197;124;391;177;588
170510;201702;764;2494;593;2166;94;402;290;1020;384;1422
170550;201702;6525;18503;4847;15599;1574;5618;693;2285;2267;7903
170555;201702;1298;3718;1047;3335;178;621;552;1816;730;2437
170560;201702;1104;3417;858;3086;164;642;446;1731;610;2373
170600;201702;1242;3686;1085;3466;291;901;625;2092;916;2993
170610;201702;1585;4810;1275;4261;157;587;801;2664;958;3251
170625;201702;395;1192;295;980;35;124;108;342;143;466
170650;201702;1203;3834;981;3433;259;958;345;1297;604;2255
170700;201702;3912;12173;3178;10923;618;2318;1474;5261;2092;7579
170710;201702;1741;5090;1377;4420;250;864;682;2147;932;3011
170720;201702;1806;4843;1557;4471;126;314;1247;3717;1373;4031
170730;201702;929;2781;749;2477;215;756;284;969;499;1725
170740;201702;2133;7595;1853;7072;274;1076;1179;4589;1453;5665
170755;201702;784;2424;598;2026;92;347;273;919;365;1266
170765;201702;1208;3302;897;2809;243;788;341;1136;584;1924
170770;201702;1662;5572;1515;5323;308;1076;878;3171;1186;4247
170820;201702;3840;13640;3483;13036;609;2240;2016;8105;2625;10345
170825;201702;914;2413;762;2178;108;299;436;1266;544;1565
170830;201702;1411;4062;1188;3725;64;146;986;3178;1050;3324
170900;201702;2494;8858;2343;8623;198;815;1888;7023;2086;7838
170930;201702;3705;10873;3198;10116;692;2385;1626;5319;2318;7704
170950;201702;13498;39193;10069;33243;3007;11245;1473;4939;4480;16184
170980;201702;484;1409;366;1219;65;224;160;519;225;743
171050;201702;1506;4982;1350;4680;88;401;1040;3563;1128;3964
171070;201702;1411;4361;1280;4174;272;873;794;2721;1066;3594
171090;201702;1088;2883;896;2628;59;183;657;1913;716;2096
171110;201702;577;1697;433;1445;122;475;178;521;300;996
171150;201702;1017;2776;670;2157;74;262;412;1344;486;1606
171180;201702;674;2024;451;1570;93;327;179;669;272;996
171190;201702;1455;5505;1303;5192;259;1060;660;2767;919;3827
171195;201702;832;2881;718;2682;84;384;465;1744;549;2128
171200;201702;623;1942;495;1706;156;571;153;514;309;1085
171215;201702;442;1297;339;1091;54;207;166;536;220;743
171240;201702;689;2513;637;2416;65;322;398;1542;463;1864
171245;201702;574;1932;474;1693;112;447;172;595;284;1042
171250;201702;1010;2952;806;2616;194;665;377;1229;571;1894
171270;201702;378;1535;351;1478;122;486;134;634;256;1120
171280;201702;858;2692;714;2442;161;574;322;1185;483;1759
171320;201702;3684;11091;3077;10037;849;2796;1286;4398;2135;7194
171330;201702;2705;7881;2201;7068;553;1907;1058;3444;1611;5351
171360;201702;1422;4513;1270;4289;99;370;1013;3448;1112;3818
171370;201702;644;1833;547;1700;98;344;337;1056;435;1400
171380;201702;1242;3965;1034;3602;388;1370;266;1053;654;2423
171395;201702;895;2654;678;2230;116;474;330;1035;446;1509
171420;201702;1875;5834;1447;4993;342;1275;554;1944;896;3219
171430;201702;1018;3129;841;2820;133;453;502;1676;635;2129
171488;201702;2472;7550;2087;6991;431;1445;1116;3934;1547;5379
171500;201702;853;2471;688;2205;78;260;456;1482;534;1742
171510;201702;837;2914;746;2748;67;289;537;1998;604;2287
171515;201702;482;1387;372;1197;44;141;206;661;250;802
171525;201702;597;1925;519;1792;54;234;345;1148;399;1382
171550;201702;336;1085;255;941;66;273;91;342;157;615
171570;201702;1243;3888;1083;3583;204;626;698;2415;902;3041
171575;201702;1880;5181;1357;4271;251;863;636;1995;887;2858
171610;201702;5051;15874;4199;14390;1093;4125;1304;4609;2397;8734
171620;201702;2703;7744;2310;7225;126;490;1881;5925;2007;6415
171630;201702;842;2567;712;2374;175;611;387;1312;562;1923
171650;201702;2133;6570;1612;5497;395;1404;527;1812;922;3216
171660;201702;2355;6557;1774;5523;269;886;948;2946;1217;3832
171665;201702;1464;4234;1146;3749;210;727;566;1956;776;2683
171670;201702;1810;5077;1484;4554;384;1315;593;1778;977;3093
171700;201702;1079;3403;891;3042;152;536;472;1643;624;2179
171720;201702;753;2202;641;2012;143;466;347;1111;490;1577
171750;201702;1116;3472;853;2954;239;824;245;904;484;1728
171780;201702;1168;3134;855;2693;78;277;516;1630;594;1907
171790;201702;1416;5021;1203;4532;267;995;614;2500;881;3495
171800;201702;713;2153;578;1949;68;230;364;1276;432;1506
171820;201702;9641;29105;7994;26466;1623;5763;3721;12639;5344;18402
171830;201702;1314;4898;1178;4597;325;1218;483;2029;808;3247
171840;201702;702;1979;600;1832;42;150;449;1342;491;1492
171845;201702;659;1816;519;1590;74;251;271;840;345;1091
171850;201702;877;3149;779;2945;84;366;517;1962;601;2328
171855;201702;1119;3560;1024;3392;64;229;763;2521;827;2750
171865;201702;422;1431;374;1352;73;272;181;658;254;930
171870;201702;688;2081;557;1840;131;443;227;831;358;1274
171875;201702;1201;3838;1019;3545;84;366;702;2416;786;2782
171880;201702;839;3058;810;3018;82;282;660;2540;742;2822
171884;201702;884;2420;665;2097;151;540;175;643;326;1183
171886;201702;1337;4242;1029;3631;315;1220;214;770;529;1990
171888;201702;723;2168;539;1796;67;244;298;986;365;1230
171889;201702;481;1487;425;1393;73;242;221;787;294;1029
171890;201702;1198;3540;977;3218;170;565;554;1853;724;2418
171900;201702;493;1758;400;1533;104;407;148;592;252;999
172000;201702;587;1877;503;1711;73;286;266;879;339;1165
172010;201702;1170;4048;1075;3876;115;497;759;2719;874;3216
172015;201702;333;1298;272;1175;51;218;138;618;189;836
172020;201702;2295;7596;2135;7356;257;953;1490;5191;1747;6144
172025;201702;700;2039;515;1732;77;290;266;921;343;1211
172030;201702;1149;3628;1020;3420;57;243;792;2640;849;2883
172049;201702;1292;3292;931;2682;409;1287;344;936;753;2223
172065;201702;1334;3474;1083;3189;67;202;969;2887;1036;3089
172080;201702;2336;7321;1986;6703;195;797;1317;4415;1512;5212
172085;201702;475;1337;342;1065;59;173;119;373;178;546
172090;201702;3813;10372;3121;9396;94;305;2668;8104;2762;8409
172093;201702;552;1670;425;1443;87;338;205;680;292;1018
172097;201702;638;1879;498;1644;104;356;182;624;286;980
172100;201702;35980;102109;26912;86905;7195;25953;7143;23856;14338;49809
172110;201702;1613;6112;1421;5802;181;821;996;4193;1177;5014
172120;201702;4915;15342;4037;14047;746;2617;2317;8426;3063;11043
172125;201702;243;765;203;691;44;176;90;301;134;477
172130;201702;518;1445;397;1236;38;148;244;739;282;887
172208;201702;2119;6144;1858;5761;233;740;1153;3633;1386;4373
172210;201702;2525;7446;2185;6976;371;1315;1375;4396;1746;5711
210005;201702;21080;65031;17807;60004;5789;20741;6410;22300;12199;43041
210010;201702;1723;6379;1573;6120;80;341;1307;5175;1387;5516
210015;201702;3385;10622;3005;10038;193;524;2526;8744;2719;9268
210020;201702;6907;16663;6520;16218;185;511;6011;14888;6196;15399
210030;201702;5245;17545;4937;17138;322;1562;4133;14159;4455;15721
210040;201702;2177;6872;2060;6740;52;145;1914;6367;1966;6512
210043;201702;6801;18694;5813;17503;735;2067;4091;13196;4826;15263
210047;201702;6314;23125;5788;22370;472;2163;4590;17798;5062;19961
210050;201702;2206;8196;1866;7519;535;2212;796;3490;1331;5702
210055;201702;1713;5959;1572;5736;103;432;1229;4505;1332;4937
210060;201702;6928;27166;6442;26251;968;4134;4350;18226;5318;22360
210070;201702;7165;20865;6652;20252;107;391;6150;18885;6257;19276
210080;201702;3629;12675;3544;12572;30;131;3407;12161;3437;12292
210083;201702;4552;15726;4078;15209;105;515;3806;14257;3911;14772
210087;201702;2990;8735;2719;8383;277;847;2142;6735;2419;7582
210090;201702;10069;32055;9561;31268;366;1380;8519;27891;8885;29271
210095;201702;5857;20759;5590;20407;316;1295;4808;17723;5124;19018
210100;201702;7056;21281;6489;20542;305;1258;5450;17118;5755;18376
210110;201702;2747;9526;2636;9379;104;478;2356;8358;2460;8836
210120;201702;25846;72207;22593;68424;2784;7219;16265;52633;19049;59852
210125;201702;3615;11263;3479;11122;128;281;3187;10444;3315;10725
210130;201702;4130;12148;3796;11693;260;892;3125;9602;3385;10494
210135;201702;1603;4754;1396;4452;72;214;1139;3687;1211;3901
210140;201702;16566;52450;14173;49186;2707;10088;8256;29380;10963;39468
210150;201702;4566;11244;4069;10633;65;222;3728;9676;3793;9898
210160;201702;17132;53756;16153;52306;1308;3979;13003;43339;14311;47318
210170;201702;13591;47909;13139;47341;632;2552;11715;42498;12347;45050
210173;201702;2131;8146;2014;7970;63;348;1832;7295;1895;7643
210177;201702;3058;9311;2893;9116;90;259;2679;8560;2769;8819
210180;201702;1458;4417;1384;4312;47;197;1185;3659;1232;3856
210190;201702;4740;14967;4389;14340;176;839;3472;11110;3648;11949
210193;201702;1316;4143;1194;3950;64;236;986;3277;1050;3513
210197;201702;2039;6854;1873;6655;227;785;1427;5283;1654;6068
210200;201702;8126;27045;7533;26222;793;2631;5962;21436;6755;24067
210203;201702;6730;20884;6333;20369;317;944;5626;18432;5943;19376
210207;201702;3350;11897;3183;11602;252;785;2530;9636;2782;10421
210210;201702;8187;28156;7785;27605;117;467;7126;25724;7243;26191
210215;201702;1094;4608;1053;4544;91;467;825;3618;916;4085
210220;201702;5989;23238;5720;22804;288;1458;4908;19596;5196;21054
210230;201702;5130;16441;4799;15950;227;812;4243;14171;4470;14983
210232;201702;12684;40427;10655;37872;1539;5622;6916;26636;8455;32258
210235;201702;3727;11435;3297;10903;175;701;2811;9354;2986;10055
210237;201702;2254;8661;2190;8574;27;128;2092;8254;2119;8382
210240;201702;2946;9203;2738;8896;133;487;2327;7556;2460;8043
210250;201702;5239;16820;4928;16422;142;706;4478;14803;4620;15509
210255;201702;2561;8195;2334;7779;217;797;1784;5951;2001;6748
210260;201702;5092;16554;4742;16027;409;1392;3733;12876;4142;14268
210270;201702;5171;14755;4591;13951;127;623;3986;11951;4113;12574
210275;201702;3445;8451;3272;8263;128;240;3056;7865;3184;8105
210280;201702;5569;16724;4748;15583;282;1321;3522;11312;3804;12633
210290;201702;5536;18338;5119;17855;231;896;4438;15652;4669;16548
210300;201702;36626;101276;30342;93544;2210;7267;22671;72832;24881;80099
210310;201702;2881;8041;2637;7726;76;184;2319;6887;2395;7071
210312;201702;2290;7054;2149;6870;80;393;1899;6027;1979;6420
210315;201702;2795;8665;2470;8274;113;406;2140;7317;2253;7723
210317;201702;4020;12600;3855;12407;136;523;3564;11490;3700;12013
210320;201702;19255;62622;17779;60834;861;3368;15405;53572;16266;56940
210325;201702;3679;11170;3279;10574;181;661;2661;8676;2842;9337
210330;201702;32848;84355;26920;77775;4992;13209;16193;53337;21185;66546
210340;201702;11499;34368;10454;33012;1085;2971;7771;26238;8856;29209
210350;201702;9674;29448;8663;28058;472;1707;7107;23238;7579;24945
210355;201702;3891;14196;3536;13640;162;778;2970;11627;3132;12405
210360;201702;14935;45533;13589;43674;950;3680;10848;34722;11798;38402
210370;201702;9250;22165;7727;20537;286;553;6819;18866;7105;19419
210375;201702;3095;9295;2572;8622;747;2599;1222;4268;1969;6867
210380;201702;5768;15904;5209;15187;377;1040;4323;12842;4700;13882
210390;201702;2934;10435;2681;10040;152;769;2218;8284;2370;9053
210400;201702;4851;15236;4616;14970;112;287;4385;14395;4497;14682
210405;201702;7523;21034;6070;18948;1708;5435;2607;8734;4315;14169
210407;201702;1959;7026;1688;6546;192;788;1214;4733;1406;5521
210408;201702;2426;9378;2276;9188;159;786;1855;7676;2014;8462
210409;201702;3625;13192;3447;12930;212;1022;2872;10757;3084;11779
210410;201702;3696;11864;3517;11591;308;840;2803;9680;3111;10520
210420;201702;4035;13291;3675;12679;225;817;2999;10452;3224;11269
210430;201702;2074;6436;2005;6361;91;320;1774;5629;1865;5949
210440;201702;3870;11954;3719;11769;127;411;3425;10906;3552;11317
210450;201702;2684;8434;2375;7978;124;484;1901;6351;2025;6835
210455;201702;3578;10516;3284;10158;520;1599;2395;7725;2915;9324
210460;201702;3486;11342;3207;10926;164;695;2642;8995;2806;9690
210462;201702;1330;4843;1226;4655;81;406;984;3709;1065;4115
210465;201702;2551;8288;2357;8015;130;379;2052;7154;2182;7533
210467;201702;6027;20069;5666;19664;355;1271;4915;17326;5270;18597
210470;201702;2049;5550;1508;4755;94;293;1135;3649;1229;3942
210480;201702;14526;46216;12769;44043;1765;5921;9169;33859;10934;39780
210490;201702;3673;9954;3152;9236;81;304;2726;7968;2807;8272
210500;201702;6068;25455;5866;25079;553;2551;4669;20201;5222;22752
210510;201702;6429;21788;6055;21342;338;1047;5201;18876;5539;19923
210515;201702;3585;11320;3433;11153;77;188;3244;10733;3321;10921
210520;201702;2576;7801;2351;7488;138;476;1993;6408;2131;6884
210530;201702;49484;134790;42262;124141;6862;26134;13045;45955;19907;72089
210535;201702;3213;11029;3046;10803;126;452;2689;9705;2815;10157
210540;201702;12733;42151;11351;40237;1842;6507;7400;27780;9242;34287
210542;201702;5678;16223;5146;15646;253;643;4535;14139;4788;14782
210545;201702;2311;7376;2207;7223;48;261;1965;6352;2013;6613
210547;201702;3663;13100;3415;12675;357;1304;2507;9576;2864;10880
210550;201702;5985;17586;5396;16967;232;642;4892;15722;5124;16364
210560;201702;3920;12290;3531;11646;145;577;2999;9852;3144;10429
210565;201702;1440;5208;1238;4889;83;410;945;3810;1028;4220
210570;201702;11946;33748;10985;32672;603;1494;9690;29482;10293;30976
210580;201702;3126;9125;2827;8762;296;622;2264;7441;2560;8063
210590;201702;3884;12464;3600;12100;215;904;3124;10428;3339;11332
210592;201702;2527;7867;2417;7691;54;257;2123;6721;2177;6978
210594;201702;2637;7535;2104;6728;109;311;1543;5156;1652;5467
210596;201702;2553;9522;2431;9295;244;1030;1829;7085;2073;8115
210598;201702;1767;5533;1649;5389;92;394;1455;4714;1547;5108
210600;201702;3156;9003;2687;8377;128;465;2142;6657;2270;7122
210610;201702;2483;8045;2320;7837;135;601;2016;6703;2151;7304
210620;201702;2016;6487;1849;6286;51;124;1682;5860;1733;5984
210630;201702;3304;11775;3042;11357;270;1255;2306;8489;2576;9744
210632;201702;4495;15489;4139;14969;459;1827;3172;11525;3631;13352
210635;201702;1866;6553;1770;6403;67;247;1557;5729;1624;5976
210637;201702;2616;8967;2400;8665;145;593;1941;7078;2086;7671
210640;201702;4502;17261;4426;17181;9;34;4322;16905;4331;16939
210650;201702;6859;20712;6639;20432;151;476;6313;19501;6464;19977
210660;201702;8329;24373;7569;23286;230;917;6751;20589;6981;21506
210663;201702;2633;8058;2517;7917;124;417;2180;6951;2304;7368
210667;201702;1885;6411;1776;6243;79;352;1534;5437;1613;5789
210670;201702;4521;16379;4294;16016;226;1069;3623;13532;3849;14601
210675;201702;5068;14032;4628;13494;433;1100;3744;11275;4177;12375
210680;201702;3908;10578;3419;9996;157;419;2974;8813;3131;9232
210690;201702;7508;25203;7195;24869;298;1026;6300;22556;6598;23582
210700;201702;2630;7778;2417;7542;364;880;1708;6025;2072;6905
210710;201702;4748;15745;4482;15347;211;963;3782;12891;3993;13854
210720;201702;2629;9350;2475;9142;110;546;2214;8121;2324;8667
210725;201702;1051;4047;953;3842;49;209;714;2964;763;3173
210730;201702;1189;3539;1029;3315;79;256;807;2614;886;2870
210735;201702;4082;13872;3712;13266;391;1502;2827;10303;3218;11805
210740;201702;4994;14807;4691;14495;198;928;4182;12651;4380;13579
210745;201702;4110;11974;3864;11682;220;627;3306;10099;3526;10726
210750;201702;19306;52529;17025;49915;1969;5825;12510;37709;14479;43534
210760;201702;5857;16795;5376;16293;37;107;5203;15877;5240;15984
210770;201702;5870;15990;5064;15060;93;401;4571;13596;4664;13997
210780;201702;7711;25937;7121;24949;805;2842;5129;18490;5934;21332
210790;201702;4681;14593;4311;14156;201;543;3483;12059;3684;12602
210800;201702;4755;13255;4267;12672;117;443;3835;11404;3952;11847
210805;201702;3800;15368;3674;15172;193;997;3154;13084;3347;14081
210810;201702;5319;16052;4933;15564;275;588;4337;14213;4612;14801
210820;201702;7560;21859;6767;20653;815;2401;4735;14828;5550;17229
210825;201702;5716;19693;5464;19360;548;1871;4413;16120;4961;17991
210830;201702;8282;23858;7817;23297;798;1988;6305;19590;7103;21578
210840;201702;3539;9678;3189;9193;95;335;2714;7757;2809;8092
210845;201702;5980;17552;5774;17331;62;142;5613;16998;5675;17140
210850;201702;6279;21797;5621;20767;537;2343;4157;15355;4694;17698
210860;201702;17824;51940;15875;49202;1124;3572;12630;39782;13754;43354
210870;201702;5636;18775;5152;18156;517;1831;4081;14692;4598;16523
210880;201702;4300;13864;4091;13601;279;1101;3404;11295;3683;12396
210890;201702;4824;14516;4452;14088;307;792;3765;12497;4072;13289
210900;201702;4787;14258;3921;12861;1607;5564;952;3442;2559;9006
210905;201702;1789;5641;1583;5338;103;318;1262;4366;1365;4684
210910;201702;8183;25974;7248;24397;890;3255;4984;16824;5874;20079
210920;201702;2743;10186;2611;9963;155;807;2142;8133;2297;8940
210923;201702;1488;4982;1374;4809;139;546;944;3398;1083;3944
210927;201702;4752;15252;4491;14974;90;295;4229;14254;4319;14549
210930;201702;2502;9032;2349;8821;121;651;1970;7295;2091;7946
210940;201702;3062;11141;2961;10965;166;792;2534;9270;2700;10062
210945;201702;5665;17426;5474;17223;199;434;5011;15954;5210;16388
210950;201702;5198;15889;4410;14679;446;1520;3183;10892;3629;12412
210955;201702;1823;5885;1622;5584;140;498;1166;4124;1306;4622
210960;201702;9026;28625;8269;27613;1763;5610;4979;17915;6742;23525
210970;201702;1326;4603;1170;4346;137;580;841;3069;978;3649
210975;201702;1729;5800;1645;5645;111;434;1284;4398;1395;4832
210980;201702;10063;23428;9647;23005;442;843;8778;21387;9220;22230
210990;201702;15933;49520;13169;45532;3194;11505;6235;22833;9429;34338
211000;201702;15484;48543;13739;46557;787;3402;11478;39455;12265;42857
211003;201702;4654;17098;4248;16577;305;1482;3268;13022;3573;14504
211010;201702;6542;24062;6193;23639;69;330;5842;22537;5911;22867
211020;201702;7405;23950;7122;23534;493;1921;5929;19506;6422;21427
211023;201702;2169;7339;2090;7216;167;687;1714;5890;1881;6577
211027;201702;2737;10444;2679;10345;254;1126;2189;8445;2443;9571
211030;201702;3754;11511;3515;11260;505;1135;2755;9551;3260;10686
211040;201702;4442;16524;4251;16246;171;964;3691;14108;3862;15072
211050;201702;10038;25500;9526;24955;160;450;9067;23751;9227;24201
211060;201702;6093;21305;5902;21050;389;1516;5110;18344;5499;19860
211065;201702;2006;6259;1802;5979;52;168;1616;5428;1668;5596
211070;201702;7840;26839;7220;25833;357;1427;6030;21820;6387;23247
211080;201702;1297;3906;1137;3663;82;406;887;2706;969;3112
211085;201702;1985;6578;1814;6297;210;733;1338;4737;1548;5470
211090;201702;3432;9765;3189;9439;98;452;2786;8113;2884;8565
211100;201702;6456;17114;6315;16965;31;105;6168;16592;6199;16697
211102;201702;2846;11021;2696;10810;224;978;2269;9240;2493;10218
211105;201702;2464;8173;2146;7668;211;873;1572;5559;1783;6432
211107;201702;4519;14400;4088;13852;256;879;3309;11542;3565;12421
211110;201702;6186;18238;4967;16419;760;2476;3274;11242;4034;13718
211120;201702;35047;99196;32185;95903;4638;13301;23611;72914;28249;86215
211125;201702;2049;6453;1803;6064;123;488;1480;4990;1603;5478
211130;201702;166644;442160;155750;428767;23692;68743;76716;230525;100408;299268
211140;201702;5085;16328;4733;15803;190;844;4035;13385;4225;14229
211150;201702;9619;27535;8596;26288;367;1386;7321;22400;7688;23786
211153;201702;2703;8420;2461;8104;542;1861;1593;5445;2135;7306
211157;201702;1144;3669;992;3433;84;386;684;2408;768;2794
211160;201702;4130;13308;3484;12236;273;1318;2402;8188;2675;9506
211163;201702;1660;5453;1561;5321;41;124;1410;4906;1451;5030
211167;201702;1483;4917;1419;4825;31;147;1346;4563;1377;4710
211170;201702;5981;15944;5758;15672;93;325;5388;14584;5481;14909
211172;201702;2454;7155;2231;6857;96;423;1924;5832;2020;6255
211174;201702;2679;7967;2463;7693;61;335;2262;6971;2323;7306
211176;201702;4143;13033;3559;12258;313;1310;2716;9419;3029;10729
211178;201702;4182;10527;3835;10138;44;146;3632;9552;3676;9698
211180;201702;4208;14510;3962;14155;270;1062;3365;12096;3635;13158
211190;201702;2828;9293;2616;8980;86;417;2236;7636;2322;8053
211195;201702;1445;4338;1223;4062;65;204;1013;3467;1078;3671
211200;201702;2146;7016;1894;6675;330;1146;1177;4391;1507;5537
211210;201702;6660;20502;6306;20039;381;1287;5398;17251;5779;18538
211220;201702;33238;95037;29235;89944;4451;14219;19585;62078;24036;76297
211223;201702;4940;15107;4522;14450;425;1390;3438;11123;3863;12513
211227;201702;1614;5659;1478;5453;82;364;1235;4590;1317;4954
211230;201702;7864;25407;7120;24198;702;2547;5429;18657;6131;21204
211240;201702;7848;27117;7457;26619;260;1333;6721;23704;6981;25037
211245;201702;5558;16468;5528;16438;52;94;5446;16285;5498;16379
211250;201702;13288;42055;12497;41128;980;2928;10450;35516;11430;38444
211260;201702;8340;25963;7887;25374;358;1383;7081;22771;7439;24154
211270;201702;10154;34641;9146;33403;542;2524;7282;27112;7824;29636
211280;201702;13014;38738;11866;37273;884;2377;9539;31077;10423;33454
211285;201702;1745;6397;1535;5959;245;1046;785;3150;1030;4196
211290;201702;7025;22934;6713;22534;354;1213;5834;19860;6188;21073
211300;201702;8006;23999;7492;23303;141;454;6950;21701;7091;22155
211400;201702;11712;36447;10043;34015;2432;8377;5247;19459;7679;27836
220005;201702;1827;5203;1654;4952;68;273;1294;3759;1362;4032
220010;201702;1402;4104;1245;3866;30;134;1003;3054;1033;3188
220020;201702;3261;10297;3061;9965;550;1816;1922;6345;2472;8161
220025;201702;2260;5493;2028;5171;36;113;1685;4219;1721;4332
220027;201702;1340;3584;1193;3393;59;180;949;2700;1008;2880
220030;201702;3179;8565;3101;8448;125;438;2734;7313;2859;7751
220040;201702;7558;23265;6926;22143;1201;3913;4508;14483;5709;18396
220045;201702;1391;4558;1254;4287;50;245;973;3257;1023;3502
220050;201702;4399;13308;3807;12330;200;859;3014;9669;3214;10528
220060;201702;2109;5129;1877;4859;37;98;1690;4370;1727;4468
220070;201702;2383;6886;2156;6524;126;374;1721;5207;1847;5581
220080;201702;673;2048;625;1975;39;160;528;1609;567;1769
220090;201702;1786;4489;1469;4063;48;188;1274;3467;1322;3655
220095;201702;717;1909;670;1845;10;43;623;1693;633;1736
220100;201702;1283;3881;1066;3486;64;284;841;2696;905;2980
220105;201702;2201;6950;1971;6506;120;415;1495;4971;1615;5386
220110;201702;3312;9603;3185;9401;95;384;2795;8130;2890;8514
220115;201702;2579;8523;2478;8363;139;566;2174;7270;2313;7836
220117;201702;1229;3271;1009;2931;38;107;839;2426;877;2533
220120;201702;11813;34591;11006;33611;133;618;10295;31350;10428;31968
220130;201702;881;2915;785;2767;34;192;671;2322;705;2514
220140;201702;1661;4427;1439;4160;129;299;1172;3484;1301;3783
220150;201702;6875;20790;6515;20317;193;876;5669;17460;5862;18336
220155;201702;1076;3281;863;2876;37;152;599;1960;636;2112
220157;201702;1073;2695;926;2457;23;89;767;1977;790;2066
220160;201702;2470;7542;2232;7111;84;396;1805;5635;1889;6031
220170;201702;1359;4035;1165;3727;46;209;955;3015;1001;3224
220173;201702;1995;6035;1690;5459;52;271;1334;4209;1386;4480
220177;201702;1774;5305;1741;5263;34;140;1660;4995;1694;5135
220180;201702;1124;3044;941;2708;18;72;679;1862;697;1934
220190;201702;4522;14446;4154;13970;459;1631;3163;10659;3622;12290
220191;201702;1375;4579;1301;4447;117;489;994;3331;1111;3820
220192;201702;1786;5071;1442;4464;59;218;1102;3389;1161;3607
220194;201702;1775;5274;1577;4982;98;365;1232;3816;1330;4181
220196;201702;1977;5714;1817;5438;104;404;1482;4372;1586;4776
220198;201702;1335;3770;1017;3351;11;35;939;3148;950;3183
220200;201702;4410;14418;4085;14001;268;1002;3426;11789;3694;12791
220202;201702;2142;6358;1875;5897;31;169;1596;4922;1627;5091
220205;201702;2725;7213;2437;6829;53;203;2131;5887;2184;6090
220207;201702;861;2648;741;2438;63;257;505;1628;568;1885
220208;201702;1791;5676;1534;5238;211;820;961;3279;1172;4099
220209;201702;1574;4677;1374;4333;36;154;1108;3481;1144;3635
220210;201702;1622;4336;1416;4005;41;178;1138;3121;1179;3299
220211;201702;1535;4345;1471;4265;42;197;1284;3663;1326;3860
220213;201702;1657;4708;1523;4445;28;121;1233;3509;1261;3630
220217;201702;1996;6316;1917;6224;35;142;1776;5819;1811;5961
220220;201702;10257;28361;9184;26753;648;1799;6815;20288;7463;22087
220225;201702;1101;3148;906;2886;29;118;729;2296;758;2414
220230;201702;5387;14460;4892;13773;187;546;4254;11999;4441;12545
220240;201702;2817;8701;2602;8301;91;376;2143;6792;2234;7168
220245;201702;1501;3994;1260;3669;24;80;1099;3269;1123;3349
220250;201702;3008;8828;2721;8408;80;333;2344;7257;2424;7590
220253;201702;1551;4620;1306;4185;146;518;938;2975;1084;3493
220255;201702;1728;4782;1486;4377;47;223;1185;3312;1232;3535
220260;201702;4455;14366;3979;13502;270;1000;2978;10148;3248;11148
220265;201702;1293;4462;1192;4304;105;428;806;2930;911;3358
220270;201702;6777;21871;6473;21320;407;1766;5257;16848;5664;18614
220271;201702;1462;4092;1298;3835;56;167;1074;3217;1130;3384
220272;201702;1777;5307;1603;5002;54;232;1232;3776;1286;4008
220273;201702;1193;3454;1058;3216;70;257;786;2377;856;2634
220275;201702;2115;5308;1705;4824;41;170;1469;4106;1510;4276
220277;201702;2206;6026;1927;5596;63;229;1548;4405;1611;4634
220280;201702;1474;4045;1294;3725;69;259;1028;2860;1097;3119
220285;201702;1660;4309;1362;3912;21;86;1236;3559;1257;3645
220290;201702;6038;19816;5137;18511;556;2228;3518;12726;4074;14954
220300;201702;1786;5968;1600;5678;77;431;1270;4382;1347;4813
220310;201702;2387;7986;2169;7732;83;419;1815;6478;1898;6897
220320;201702;2805;8692;2423;7994;235;935;1750;5738;1985;6673
220323;201702;1475;5153;1291;4882;129;546;1013;3818;1142;4364
220325;201702;1170;3689;992;3338;76;321;732;2438;808;2759
220327;201702;1317;4192;1205;3993;52;261;989;3189;1041;3450
220330;201702;3631;9682;3229;9175;112;314;2849;8166;2961;8480
220335;201702;1784;5460;1607;5255;27;83;1506;4971;1533;5054
220340;201702;1824;4985;1535;4533;86;300;1136;3268;1222;3568
220342;201702;1117;3654;1064;3572;66;302;866;2888;932;3190
220345;201702;2859;7132;2529;6672;31;62;2325;6140;2356;6202
220350;201702;3737;9912;3140;8963;168;593;2382;6674;2550;7267
220360;201702;1238;3409;1063;3155;74;243;833;2433;907;2676
220370;201702;9167;26150;8334;25083;273;1083;7370;22054;7643;23137
220375;201702;1456;4554;1358;4429;12;35;1314;4326;1326;4361
220380;201702;1347;3616;1139;3321;38;156;947;2688;985;2844
220385;201702;856;2175;683;1890;14;56;553;1495;567;1551
220390;201702;8861;27043;7854;25312;1982;6569;3262;10839;5244;17408
220400;201702;1499;3759;1169;3231;36;133;910;2421;946;2554
220410;201702;1154;3359;982;3090;62;207;761;2371;823;2578
220415;201702;825;2274;724;2127;35;131;529;1510;564;1641
220420;201702;2123;6103;1763;5412;95;283;1297;3971;1392;4254
220430;201702;2444;6810;2385;6736;92;319;2156;6026;2248;6345
220435;201702;1628;4800;1492;4579;47;196;1170;3552;1217;3748
220440;201702;2349;7754;2208;7556;171;628;1757;5930;1928;6558
220450;201702;1895;5891;1599;5461;349;1312;944;3232;1293;4544
220455;201702;1299;4102;1229;3998;44;166;1083;3507;1127;3673
220460;201702;874;2409;794;2312;45;134;668;1925;713;2059
220465;201702;2318;7626;2121;7323;241;893;1557;5402;1798;6295
220470;201702;3633;10720;3327;10247;134;472;2677;8126;2811;8598
220480;201702;2421;6850;2125;6387;142;390;1575;4737;1717;5127
220490;201702;2222;6248;2045;6033;48;191;1806;5284;1854;5475
220500;201702;3088;8333;2682;7659;86;370;2059;5670;2145;6040
220510;201702;2809;8263;2294;7364;98;367;1716;5534;1814;5901
220515;201702;1799;4391;1604;4133;98;244;1379;3566;1477;3810
220520;201702;5003;13665;4608;13148;104;345;4128;11791;4232;12136
220525;201702;1221;3455;1159;3365;39;156;983;2820;1022;2976
220527;201702;1357;4113;1212;3841;123;406;856;2770;979;3176
220530;201702;1270;3561;1113;3335;54;224;964;2816;1018;3040
220535;201702;848;2540;805;2480;67;243;618;1874;685;2117
220540;201702;3484;11052;3330;10823;119;553;2921;9393;3040;9946
220545;201702;1380;4537;1311;4411;115;452;1025;3414;1140;3866
220550;201702;9104;28706;8345;27445;649;2371;6269;20473;6918;22844
220551;201702;1443;4491;1292;4248;69;302;1014;3246;1083;3548
220552;201702;1578;4856;1379;4488;82;405;1063;3321;1145;3726
220553;201702;1615;4625;1356;4232;48;194;1048;3341;1096;3535
220554;201702;775;2238;686;2105;41;112;545;1678;586;1790
220555;201702;2095;6737;1946;6524;49;259;1665;5495;1714;5754
220556;201702;1362;4182;1220;3902;54;245;916;2808;970;3053
220557;201702;1553;4963;1397;4663;117;447;1011;3346;1128;3793
220558;201702;1075;3266;957;3084;47;225;761;2384;808;2609
220559;201702;1572;4403;1398;4113;27;99;1187;3485;1214;3584
220560;201702;1570;3931;1290;3548;38;119;1093;2951;1131;3070
220570;201702;7088;22875;6682;22160;842;2963;4737;15924;5579;18887
220580;201702;6562;20044;6390;19778;214;757;5778;17741;5992;18498
220585;201702;2036;6836;1862;6520;115;493;1464;5064;1579;5557
220590;201702;1280;3768;1130;3548;106;352;823;2625;929;2977
220595;201702;2321;6782;2166;6577;36;177;1985;5948;2021;6125
220600;201702;1290;3133;1060;2842;86;140;839;2340;925;2480
220605;201702;1845;5474;1597;5052;61;250;1255;3896;1316;4146
220610;201702;2731;8121;2594;7930;54;229;2339;7116;2393;7345
220620;201702;7476;24835;7192;24448;263;1263;6382;21467;6645;22730
220630;201702;397;1217;327;1088;53;192;167;566;220;758
220635;201702;1660;5586;1478;5193;76;339;1109;3831;1185;4170
220640;201702;2626;7598;2328;7172;99;376;1935;5905;2034;6281
220650;201702;2103;6173;1872;5764;92;321;1380;4235;1472;4556
220660;201702;2837;8415;2560;8076;122;582;2218;6803;2340;7385
220665;201702;1189;3968;1088;3802;33;169;917;3176;950;3345
220667;201702;1659;5461;1520;5222;78;296;1246;4282;1324;4578
220669;201702;1802;5792;1721;5648;159;693;1310;4194;1469;4887
220670;201702;1902;5655;1673;5359;104;309;1399;4543;1503;4852
220672;201702;2393;6987;2224;6779;132;448;1923;5878;2055;6326
220675;201702;1245;3558;1165;3414;66;177;914;2694;980;2871
220680;201702;2371;7335;2255;7191;114;385;1959;6250;2073;6635
220690;201702;1702;4675;1473;4306;113;309;1116;3336;1229;3645
220695;201702;954;2701;863;2530;29;102;690;2001;719;2103
220700;201702;8155;23191;7087;21546;506;1781;5328;16015;5834;17796
220710;201702;817;2420;661;2121;34;88;476;1528;510;1616
220720;201702;2039;5241;1914;5066;61;191;1658;4355;1719;4546
220730;201702;1361;3894;1156;3576;37;157;960;2925;997;3082
220735;201702;1014;2521;805;2175;25;75;649;1719;674;1794
220740;201702;1383;4231;1184;3964;56;197;993;3380;1049;3577
220750;201702;3939;10947;3592;10431;230;668;2975;8660;3205;9328
220755;201702;1177;3285;1049;3081;45;172;820;2349;865;2521
220760;201702;2827;9128;2556;8768;127;588;2181;7407;2308;7995
220770;201702;21185;70221;19038;66122;6294;22968;6176;22535;12470;45503
220775;201702;1227;3270;1174;3214;12;49;1145;3129;1157;3178
220777;201702;1548;4214;1303;3834;58;166;1000;2948;1058;3114
220779;201702;1351;3490;1253;3359;40;147;1093;2884;1133;3031
220780;201702;5519;15100;4918;14165;343;1154;3904;11104;4247;12258
220785;201702;1332;3292;1249;3165;43;102;1146;2889;1189;2991
220790;201702;10239;30542;9396;29275;529;2037;7650;23562;8179;25599
220793;201702;800;2268;718;2147;41;147;588;1749;629;1896
220795;201702;1476;4066;1379;3942;47;163;1234;3533;1281;3696
220800;201702;15860;42880;14006;40021;1028;3360;9916;27586;10944;30946
220810;201702;3169;9146;2765;8450;93;369;2230;6705;2323;7074
220820;201702;5392;14530;4807;13693;307;854;3920;11116;4227;11970
220830;201702;7245;20465;6726;19661;479;1520;5387;15720;5866;17240
220840;201702;13405;42111;11890;39103;2302;7687;6345;21209;8647;28896
220850;201702;2931;9692;2755;9476;83;382;2535;8717;2618;9099
220855;201702;590;1789;512;1651;31;135;390;1225;421;1360
220860;201702;925;2480;819;2318;37;138;684;1898;721;2036
220865;201702;2620;7117;2092;6224;69;314;1680;4842;1749;5156
220870;201702;2201;7325;1964;7010;51;261;1751;6212;1802;6473
220880;201702;4612;12390;4281;12004;47;155;4033;11333;4080;11488
220885;201702;1258;4472;1111;4206;82;398;845;3172;927;3570
220887;201702;1344;3328;1181;3101;14;56;1091;2842;1105;2898
220890;201702;1611;5485;1401;5065;115;434;1025;3763;1140;4197
220900;201702;1868;5051;1668;4759;37;115;1453;4114;1490;4229
220910;201702;1489;4491;1305;4209;43;129;1142;3749;1185;3878
220915;201702;988;2797;851;2533;34;149;652;1877;686;2026
220920;201702;1321;4768;1193;4577;87;451;895;3361;982;3812
220930;201702;1448;4576;1317;4379;40;203;1109;3647;1149;3850
220935;201702;1078;3206;926;2898;39;162;613;1843;652;2005
220937;201702;1462;3983;1237;3617;45;176;963;2764;1008;2940
220940;201702;1257;3991;1181;3845;62;283;853;2698;915;2981
220945;201702;407;1509;364;1416;34;163;249;960;283;1123
220950;201702;1294;3184;937;2603;19;83;705;1897;724;1980
220955;201702;1444;4119;1269;3812;65;188;992;2997;1057;3185
220960;201702;896;2307;706;2000;23;77;542;1526;565;1603
220965;201702;1634;4808;1525;4642;40;226;1326;3911;1366;4137
220970;201702;1915;5204;1519;4555;83;296;1157;3443;1240;3739
220975;201702;721;2276;656;2195;30;174;579;1863;609;2037
220980;201702;1227;3633;1087;3404;47;177;852;2653;899;2830
220985;201702;1166;3443;1099;3348;73;300;837;2458;910;2758
220987;201702;1443;4608;1302;4374;83;367;1031;3380;1114;3747
220990;201702;1759;5096;1523;4695;46;226;1175;3519;1221;3745
220995;201702;1242;3656;957;3204;84;306;662;2279;746;2585
220997;201702;2330;6965;2229;6824;37;159;2078;6326;2115;6485
221000;201702;4117;12420;3859;11989;264;1043;3076;9402;3340;10445
221005;201702;1398;4321;1284;4112;263;765;764;2510;1027;3275
221010;201702;1203;3044;1037;2840;22;72;906;2442;928;2514
221020;201702;1662;5203;1539;4969;54;253;1123;3551;1177;3804
221030;201702;1422;4230;1268;3973;59;246;1001;3059;1060;3305
221035;201702;1469;3972;1361;3834;54;129;1241;3565;1295;3694
221037;201702;596;1768;529;1653;14;67;368;1096;382;1163
221038;201702;581;1648;463;1450;35;119;291;920;326;1039
221039;201702;938;2561;830;2402;26;102;677;1898;703;2000
221040;201702;4454;13799;4136;13269;197;696;3254;10505;3451;11201
221050;201702;3488;10391;3234;10065;104;425;2856;8809;2960;9234
221060;201702;7927;23337;6850;21544;404;1467;5245;16435;5649;17902
221062;201702;1282;4428;1150;4168;68;319;879;3161;947;3480
221063;201702;1070;3442;964;3258;104;362;670;2284;774;2646
221065;201702;2786;7385;2461;6873;74;223;2075;5721;2149;5944
221070;201702;3654;11641;3178;10741;181;719;2382;8026;2563;8745
221080;201702;3462;8668;2816;7767;81;294;2297;6317;2378;6611
221090;201702;1363;3741;1188;3447;43;179;996;2823;1039;3002
221093;201702;1543;4568;1457;4399;179;589;919;2676;1098;3265
221095;201702;962;2583;841;2391;12;37;708;1987;720;2024
221097;201702;800;2213;647;1939;30;118;467;1351;497;1469
221100;201702;104743;305446;95605;290053;18388;58859;54949;164337;73337;223196
221110;201702;10292;31969;9535;31050;393;1824;8139;26150;8532;27974
221120;201702;4037;12836;3861;12536;539;1892;2775;8993;3314;10885
221130;201702;4455;12687;3658;11067;980;2890;1626;5035;2606;7925
221135;201702;1501;4478;1385;4318;69;256;1178;3645;1247;3901
221140;201702;1319;3248;1186;3058;27;73;1035;2632;1062;2705
221150;201702;1195;3020;968;2638;26;110;726;1908;752;2018
221160;201702;752;1975;703;1910;26;73;571;1544;597;1617
221170;201702;1141;3402;1039;3236;33;122;831;2562;864;2684
230010;201702;3350;9025;2709;7932;226;766;2008;5749;2234;6515
230015;201702;2897;9870;2715;9495;304;1211;1809;6264;2113;7475
230020;201702;13546;43847;13175;43278;618;2542;11232;36584;11850;39126
230030;201702;11826;33358;10523;31399;446;1738;8737;25756;9183;27494
230040;201702;4235;11800;3637;10756;282;1020;2661;7740;2943;8760
230050;201702;2665;8906;1996;7132;482;1710;584;2137;1066;3847
230060;201702;2290;6461;1939;5849;98;398;1495;4401;1593;4799
230070;201702;4156;12238;3634;11265;242;894;2533;7992;2775;8886
230075;201702;8933;30902;8344;29799;617;3143;6390;22184;7007;25327
230080;201702;2397;6151;1966;5506;67;258;1616;4463;1683;4721
230090;201702;3976;11101;3533;10367;316;1081;2533;7350;2849;8431
230100;201702;16568;48876;15454;46952;2384;7871;9291;28400;11675;36271
230110;201702;12385;39118;11330;36909;2090;7228;6106;19668;8196;26896
230120;201702;7808;21588;6772;20018;774;2236;4621;14246;5395;16482
230125;201702;2964;8522;2500;7697;158;589;1811;5521;1969;6110
230130;201702;5681;18467;4830;16632;490;1894;3158;10693;3648;12587
230140;201702;3475;10947;2966;10031;216;848;2037;6899;2253;7747
230150;201702;1640;5053;1440;4632;300;1011;758;2451;1058;3462
230160;201702;6313;18096;5625;17105;309;1216;4531;13625;4840;14841
230170;201702;6131;19048;5372;17600;323;1287;3845;12412;4168;13699
230180;201702;1664;4864;1464;4467;67;299;1073;3111;1140;3410
230185;201702;3742;12237;3344;11496;492;1811;2155;7534;2647;9345
230190;201702;12251;38725;10804;35777;1833;6538;5500;18187;7333;24725
230195;201702;5305;16056;4693;14990;249;1018;3670;11475;3919;12493
230200;201702;4959;14163;4491;13291;310;1051;3414;9893;3724;10944
230205;201702;4028;13170;3694;12554;292;1304;2589;8645;2881;9949
230210;201702;8728;24923;7712;23300;1051;3393;5011;15331;6062;18724
230220;201702;13114;36791;11855;34679;868;2962;8804;25348;9672;28310
230230;201702;7264;22883;6719;21887;638;2223;4788;15589;5426;17812
230240;201702;13338;36718;11752;34149;504;1724;9175;26403;9679;28127
230250;201702;9633;29395;9581;29299;594;2225;7396;22150;7990;24375
230260;201702;14289;46851;13113;44422;1906;6999;7531;25833;9437;32832
230270;201702;7523;21756;6290;19496;745;2507;3973;12410;4718;14917
230280;201702;19821;57700;17488;53661;1183;4380;13225;39884;14408;44264
230290;201702;4745;14242;4096;12923;493;1526;2775;8797;3268;10323
230300;201702;4281;12695;4083;12429;248;985;3338;9983;3586;10968
230310;201702;4862;14380;4212;13254;174;708;2991;9257;3165;9965
230320;201702;7209;21803;6507;20572;431;1770;4917;15241;5348;17011
230330;201702;4880;13996;4099;12485;330;1105;2853;8573;3183;9678
230340;201702;3402;11236;3076;10556;298;1179;2074;6987;2372;8166
230350;201702;18067;54016;16473;51231;1480;5532;10219;32170;11699;37702
230360;201702;3208;8964;2486;7652;186;678;1617;4912;1803;5590
230365;201702;2991;7855;2612;7215;94;371;2161;5887;2255;6258
230370;201702;54217;169777;48859;160719;12587;43529;21535;73856;34122;117385
230380;201702;6517;18845;5398;16741;232;876;3843;11796;4075;12672
230390;201702;3323;10550;2998;9985;215;975;2183;7116;2398;8091
230393;201702;3080;9959;2657;9140;176;872;1919;6331;2095;7203
230395;201702;5671;16235;5100;15273;683;2128;3141;9607;3824;11735
230400;201702;5453;16293;4915;15400;241;1073;3857;11819;4098;12892
230410;201702;14509;45388;12412;41019;1614;5689;7420;24543;9034;30232
230420;201702;23811;75027;21526;70575;4017;14188;10629;34807;14646;48995
230423;201702;4108;13374;3782;12716;243;1060;2932;9727;3175;10787
230425;201702;5447;17856;4989;16886;670;2367;3217;10947;3887;13314
230426;201702;2567;7167;2060;6204;71;309;1513;4459;1584;4768
230427;201702;1898;5567;1441;4558;128;425;853;2618;981;3043
230428;201702;8629;26370;8132;25431;1486;5079;4219;12995;5705;18074
230430;201702;4421;13788;3998;12985;273;1107;2917;9224;3190;10331
230435;201702;5145;15727;4575;14697;653;2350;2645;8462;3298;10812
230440;201702;363987;1041276;327278;979390;68339;215844;158959;479692;227298;695536
230445;201702;4381;11925;3774;10929;235;730;2684;7733;2919;8463
230450;201702;3624;11087;3189;10326;287;1207;2219;7042;2506;8249
230460;201702;1853;6070;1608;5618;166;698;1086;3757;1252;4455
230465;201702;3924;11641;3290;10463;207;849;2248;6946;2455;7795
230470;201702;10971;39215;10144;37553;1164;5040;7015;25728;8179;30768
230480;201702;1438;4454;1221;4032;132;538;841;2706;973;3244
230490;201702;2264;6824;1974;6275;275;942;996;3083;1271;4025
230495;201702;5571;18173;5063;17167;589;2484;3002;10007;3591;12491
230500;201702;8663;30507;8266;29697;592;2687;6210;22148;6802;24835
230510;201702;1505;5239;1154;4335;278;1132;380;1441;658;2573
230520;201702;4253;13123;3992;12617;385;1383;2729;8504;3114;9887
230523;201702;14819;47102;12870;42703;3055;10843;3268;11302;6323;22145
230526;201702;4034;11896;3475;10916;208;901;2682;8241;2890;9142
230530;201702;5381;17088;4843;16361;682;2488;3317;11516;3999;14004
230533;201702;4098;11178;3565;10205;344;942;2554;7408;2898;8350
230535;201702;5471;15957;4764;14666;488;1563;3084;9729;3572;11292
230540;201702;17205;49726;15540;47152;534;2275;12959;38770;13493;41045
230550;201702;19339;56538;17018;52191;2809;9631;9127;27426;11936;37057
230560;201702;6769;19256;5824;17544;224;951;4406;13059;4630;14010
230565;201702;3452;9419;2804;8254;103;393;2062;6011;2165;6404
230570;201702;3554;9634;3141;9081;113;394;2560;7351;2673;7745
230580;201702;9884;29236;9073;28068;493;1924;7608;23236;8101;25160
230590;201702;9008;27310;7671;24805;543;2229;5337;16750;5880;18979
230600;201702;3797;10328;2880;8524;101;311;1862;5614;1963;5925
230610;201702;6194;19168;5658;18290;579;1925;4093;13317;4672;15242
230620;201702;2161;6089;1709;5125;195;624;947;2761;1142;3385
230625;201702;7738;24688;6981;23015;2095;7427;1967;6556;4062;13983
230630;201702;10596;33169;9733;31564;2510;7755;4532;15798;7042;23553
230640;201702;26317;83299;24024;79913;2277;8896;18303;60378;20580;69274
230650;201702;4761;14450;4292;13531;279;1130;3172;9717;3451;10847
230655;201702;9299;34204;8963;33572;696;3062;7007;26329;7703;29391
230660;201702;6136;18909;5231;17142;285;1382;4055;12964;4340;14346
230670;201702;5983;15766;4813;13739;164;593;3691;10243;3855;10836
230680;201702;2576;7583;2249;6938;296;945;1375;4240;1671;5185
230690;201702;6443;20480;6120;19770;668;2428;3741;11856;4409;14284
230700;201702;9548;26332;8446;24333;538;1915;6080;16915;6618;18830
230710;201702;7456;23892;6458;22038;751;2702;4458;15288;5209;17990
230720;201702;1804;5689;1550;5120;209;750;926;3036;1135;3786
230725;201702;3646;12313;3186;11206;739;2716;1018;3566;1757;6282
230730;201702;53360;162520;45955;149796;13562;49476;9609;33563;23171;83039
230740;201702;6233;18209;5576;17120;249;1009;4326;13110;4575;14119
230750;201702;8116;23278;7077;21548;355;1378;5366;15986;5721;17364
230760;201702;11114;32397;10196;30646;967;3444;7050;20462;8017;23906
230763;201702;4273;12811;3760;11826;215;902;2817;8546;3032;9448
230765;201702;38669;119556;34380;111312;8981;30960;10420;35042;19401;66002
230770;201702;24891;68044;22234;64150;2768;8521;14432;41665;17200;50186
230780;201702;5743;21891;5520;21387;1194;4707;2907;11735;4101;16442
230790;201702;2784;8718;2598;8418;203;768;1984;6434;2187;7202
230800;201702;7443;25838;6829;24509;1280;5100;3426;12060;4706;17160
230810;201702;11886;38011;11156;36764;753;2991;8513;27683;9266;30674
230820;201702;3270;11145;2876;10279;362;1514;1659;5803;2021;7317
230830;201702;7382;22135;6539;20583;360;1470;5000;15504;5360;16974
230835;201702;3822;10106;3180;9094;147;547;2470;6964;2617;7511
230837;201702;3104;10424;2712;9622;212;974;1927;6632;2139;7606
230840;201702;8855;28672;8210;27586;670;2602;6310;21230;6980;23832
230850;201702;9378;29043;8630;27723;912;3119;5957;19266;6869;22385
230860;201702;5034;14002;4462;13174;236;825;3614;10578;3850;11403
230870;201702;17897;46654;15627;43230;633;2096;12089;33174;12722;35270
230880;201702;1939;6492;1848;6304;120;584;1345;4466;1465;5050
230890;201702;4012;14296;3723;13694;359;1665;2511;9016;2870;10681
230900;201702;2728;9126;2309;8183;500;1696;1059;3881;1559;5577
230910;201702;3074;8913;2544;7986;159;712;1894;5783;2053;6495
230920;201702;4653;13217;4350;12840;166;599;3780;11240;3946;11839
230930;201702;6762;20278;6003;18826;511;1757;4012;12538;4523;14295
230940;201702;7524;21519;6791;20281;253;953;5472;16225;5725;17178
230945;201702;6182;18396;5449;17227;420;1535;3770;12069;4190;13604
230950;201702;6428;16996;5883;16310;185;482;5112;14482;5297;14964
230960;201702;13995;42942;12794;40594;2279;7567;6062;19556;8341;27123
230970;201702;13275;39572;11628;36642;2159;7521;5455;17094;7614;24615
230980;201702;2886;8845;2502;8166;542;1758;1347;4587;1889;6345
230990;201702;1793;5213;1494;4655;118;489;968;2896;1086;3385
231000;201702;2532;6964;2119;6153;115;413;1416;4007;1531;4420
231010;201702;3049;8354;2509;7440;258;841;1677;4895;1935;5736
231020;201702;7935;26266;7434;25137;1242;4212;4456;15421;5698;19633
231025;201702;7665;23308;7055;22208;1008;3351;4547;14511;5555;17862
231030;201702;7226;23130;6049;20679;1139;4126;3181;10902;4320;15028
231040;201702;3139;9726;2800;9070;140;646;2066;6484;2206;7130
231050;201702;11703;32774;10032;29875;666;2154;7366;21847;8032;24001
231060;201702;2397;7694;2236;7410;122;612;1682;5459;1804;6071
231070;201702;8377;26200;7507;24477;1347;4586;4025;13340;5372;17926
231080;201702;3972;12175;3624;11576;159;837;2769;8498;2928;9335
231085;201702;4845;14810;4638;14509;520;1643;3345;10799;3865;12442
231090;201702;4150;11502;3344;9923;162;576;2320;6729;2482;7305
231095;201702;2028;6554;1785;6032;186;715;1203;4047;1389;4762
231100;201702;3148;9668;2661;8766;187;720;1880;6137;2067;6857
231110;201702;3450;11249;3413;11181;303;1179;2414;7757;2717;8936
231120;201702;1904;6352;1795;6131;255;956;1134;3849;1389;4805
231123;201702;2020;5530;1778;5107;121;380;1300;3679;1421;4059
231126;201702;6106;17404;5054;15415;223;852;3576;10690;3799;11542
231130;201702;18852;56764;17104;53994;2603;8899;10609;34488;13212;43387
231135;201702;4027;11896;3463;10860;212;781;2483;7711;2695;8492
231140;201702;17121;52349;14800;48000;1145;5038;9923;31170;11068;36208
231150;201702;5554;16025;4856;14712;739;2368;2401;7418;3140;9786
231160;201702;5842;19130;5433;18321;858;3013;3226;11008;4084;14021
231170;201702;4209;13390;3727;12394;267;1149;2641;8542;2908;9691
231180;201702;14283;41857;12518;38272;2337;7410;6333;19142;8670;26552
231190;201702;4535;12711;3789;11566;227;945;2790;8225;3017;9170
231195;201702;4462;14884;3943;13831;377;1662;2681;9194;3058;10856
231200;201702;7803;26091;6854;24123;376;1939;4911;16765;5287;18704
231210;201702;4820;15273;4315;14465;249;1171;3215;10536;3464;11707
231220;201702;11601;32844;10148;30190;566;2180;7451;21602;8017;23782
231230;201702;8929;29364;8153;28193;728;3021;6201;21375;6929;24396
231240;201702;11529;35883;10541;33857;2028;6815;5568;17960;7596;24775
231250;201702;1883;5295;1293;3874;190;594;558;1611;748;2205
231260;201702;3258;9843;2970;9347;450;1449;1852;5944;2302;7393
231270;201702;7068;19106;6251;17868;261;1076;4802;13502;5063;14578
231280;201702;1732;5618;1618;5408;177;620;1068;3598;1245;4218
231290;201702;34386;112978;31061;105640;5990;22267;13503;45044;19493;67311
231300;201702;4233;12276;3519;10836;239;863;2370;7153;2609;8016
231310;201702;7306;20573;6039;17954;785;2414;3541;10407;4326;12821
231320;201702;6976;20916;5734;18399;243;1026;4171;13235;4414;14261
231325;201702;2714;7791;2360;7270;469;1474;1227;3846;1696;5320
231330;201702;11020;34890;9533;31862;1640;5587;5251;17760;6891;23347
231335;201702;5417;15192;4684;13869;152;632;3823;11115;3975;11747
231340;201702;17754;57486;16286;55120;1211;4386;12457;42775;13668;47161
231350;201702;14614;42141;13695;40906;509;1524;12168;36729;12677;38253
231355;201702;4559;14302;4114;13529;273;1099;2999;9768;3272;10867
231360;201702;7532;23847;6712;22424;1030;3581;4356;14852;5386;18433
231370;201702;2409;6674;1894;5814;62;217;1413;4302;1475;4519
231375;201702;4138;13913;3851;13368;221;1043;3005;10275;3226;11318
231380;201702;5434;16278;5188;15982;235;742;4353;13729;4588;14471
231390;201702;3419;10557;3130;10029;296;1102;2188;6908;2484;8010
231395;201702;3805;12404;3444;11718;563;1996;2000;6840;2563;8836
231400;201702;8914;27248;8206;25855;506;1970;6142;19043;6648;21013
231410;201702;14641;48402;13406;46556;1068;4098;10108;35262;11176;39360
240010;201702;2382;7003;1956;6141;259;921;1100;3359;1359;4280
240020;201702;10052;31326;9031;29384;1548;5416;4919;16090;6467;21506
240030;201702;2508;6999;2420;6865;114;413;2114;5908;2228;6321
240040;201702;849;2473;706;2187;29;142;489;1451;518;1593
240050;201702;3372;9093;2833;8150;97;327;2235;6323;2332;6650
240060;201702;1400;3973;1232;3663;57;219;963;2757;1020;2976
240070;201702;2411;7206;2249;6895;271;911;1551;4638;1822;5549
240080;201702;3019;7992;2580;7358;143;489;1928;5418;2071;5907
240090;201702;2264;6006;1865;5307;46;180;1469;4100;1515;4280
240100;201702;7705;22050;6843;20279;608;2052;4759;13667;5367;15719
240110;201702;4665;14455;4127;13369;574;2129;2281;7225;2855;9354
240120;201702;2650;9121;2520;8839;339;1392;1573;5427;1912;6819
240130;201702;2686;7078;2365;6583;68;260;1991;5454;2059;5714
240140;201702;2203;6557;1863;5921;247;922;1135;3509;1382;4431
240145;201702;5612;17480;5035;16477;1085;3707;2794;9396;3879;13103
240150;201702;944;2872;797;2565;63;276;568;1760;631;2036
240160;201702;1412;4436;1215;4095;113;465;800;2715;913;3180
240165;201702;878;2730;752;2448;146;447;402;1347;548;1794
240170;201702;2234;6731;1941;6188;357;1220;1049;3304;1406;4524
240180;201702;2680;8370;2352;7693;380;1301;1412;4704;1792;6005
240185;201702;1344;4478;1243;4308;82;345;1001;3451;1083;3796
240190;201702;962;3038;857;2859;40;182;662;2213;702;2395
240200;201702;12202;32846;10393;30018;2216;6689;4336;12863;6552;19552
240210;201702;2841;7888;2565;7440;105;407;2084;5873;2189;6280
240220;201702;7301;24309;6737;23492;652;2774;4789;16687;5441;19461
240230;201702;5732;15043;4923;13811;154;519;4115;11518;4269;12037
240240;201702;1782;5413;1141;3822;216;763;203;636;419;1399
240250;201702;2625;7641;2468;7441;108;336;2129;6435;2237;6771
240260;201702;11899;39622;11330;38684;1577;6006;7523;25735;9100;31741
240270;201702;2258;7090;2072;6778;153;558;1613;5301;1766;5859
240280;201702;1529;4286;1374;4074;61;215;1116;3286;1177;3501
240290;201702;1178;3717;1042;3453;66;332;703;2181;769;2513
240300;201702;2294;6237;1719;5073;177;580;867;2506;1044;3086
240310;201702;9294;26219;8320;24630;1007;3271;4690;13985;5697;17256
240320;201702;1952;5732;1557;4925;52;224;1129;3432;1181;3656
240325;201702;31911;89121;25949;79371;7503;24467;6690;21672;14193;46139
240330;201702;1468;4441;1246;3978;79;328;794;2441;873;2769
240340;201702;2008;5162;1653;4609;132;405;1219;3352;1351;3757
240350;201702;2036;5565;1876;5373;72;264;1669;4738;1741;5002
240360;201702;6517;20142;5893;19193;1509;4933;2882;9927;4391;14860
240370;201702;2021;5572;1606;4772;168;481;1022;3046;1190;3527
240375;201702;828;2224;732;2048;46;186;522;1366;568;1552
240380;201702;2389;7083;1810;5779;219;723;956;3033;1175;3756
240390;201702;907;2509;746;2191;25;80;511;1434;536;1514
240400;201702;1336;3570;1049;3026;64;213;723;2027;787;2240
240410;201702;447;1465;406;1384;64;274;239;784;303;1058
240420;201702;4670;17753;4339;16983;745;3443;2329;8986;3074;12429
240430;201702;3328;9281;3025;8742;136;580;2384;6623;2520;7203
240440;201702;2457;6280;2201;5913;355;1048;1363;3603;1718;4651
240450;201702;3929;11561;3344;10454;375;1411;1906;5732;2281;7143
240460;201702;2886;8752;2713;8528;209;873;2166;6615;2375;7488
240470;201702;3559;11139;2781;9445;705;2343;1255;4383;1960;6726
240480;201702;518;1407;394;1169;34;106;192;566;226;672
240485;201702;1914;6079;1686;5609;194;717;1102;3677;1296;4394
240490;201702;1734;4347;1410;3838;28;100;1217;3285;1245;3385
240500;201702;2151;6096;1936;5783;115;411;1563;4627;1678;5038
240510;201702;1658;4907;1590;4805;106;337;1334;4021;1440;4358
240520;201702;1201;3444;1074;3230;62;253;850;2464;912;2717
240530;201702;1924;6246;1783;6024;254;887;1255;4250;1509;5137
240540;201702;1797;5269;1700;5118;103;377;1431;4244;1534;4621
240550;201702;760;2171;650;1984;38;120;472;1436;510;1556
240560;201702;3261;9192;2983;8800;290;784;2342;7045;2632;7829
240570;201702;2982;8219;2204;6474;354;1148;931;2454;1285;3602
240580;201702;7699;23481;7131;22533;550;2059;5693;17759;6243;19818
240590;201702;741;2071;649;1906;21;79;492;1422;513;1501
240600;201702;1616;4689;1242;3897;133;491;721;2161;854;2652
240610;201702;4538;12984;3944;11846;347;1152;2611;7675;2958;8827
240615;201702;951;2802;779;2462;123;409;453;1387;576;1796
240620;201702;1805;5428;1601;5078;126;425;1255;3958;1381;4383
240630;201702;2051;6164;1871;5864;164;489;1282;4108;1446;4597
240640;201702;918;2580;775;2355;43;193;567;1657;610;1850
240650;201702;3941;11553;3524;10906;174;648;2770;8499;2944;9147
240660;201702;2329;7383;2191;7184;162;623;1721;5579;1883;6202
240670;201702;2546;7584;2141;6747;234;819;1244;3799;1478;4618
240680;201702;1495;4345;1211;3838;77;287;804;2492;881;2779
240690;201702;909;2470;777;2246;35;137;622;1733;657;1870
240700;201702;2480;7330;2084;6617;77;336;1622;5036;1699;5372
240710;201702;17466;46845;15221;43162;2925;8215;8177;23825;11102;32040
240720;201702;5131;14525;4637;13644;1135;3436;2234;6456;3369;9892
240725;201702;1005;3037;810;2591;59;200;496;1542;555;1742
240730;201702;2023;6092;1772;5622;95;337;1340;4220;1435;4557
240740;201702;1897;5485;1683;5080;123;473;1174;3409;1297;3882
240750;201702;2130;7864;1972;7571;396;1691;1037;4019;1433;5710
240760;201702;1336;3593;1089;3247;90;255;789;2445;879;2700
240770;201702;3027;8609;2720;8183;126;551;2258;6641;2384;7192
240780;201702;5917;16284;4787;14493;613;1922;2866;8832;3479;10754
240790;201702;889;2676;735;2393;37;147;518;1694;555;1841
240800;201702;33529;95619;29647;89086;6479;20432;12803;38945;19282;59377
240810;201702;82709;236703;76076;225297;19719;59125;34975;106031;54694;165156
240820;201702;5675;17861;5066;16895;1158;4077;2310;8095;3468;12172
240830;201702;8686;26613;8099;25773;374;1617;6727;21110;7101;22727
240840;201702;1098;3037;937;2759;79;260;621;1770;700;2030
240850;201702;1278;3716;952;2983;105;357;495;1540;600;1897
240860;201702;1253;3567;1016;3124;39;162;770;2280;809;2442
240870;201702;1135;3060;920;2682;68;219;609;1692;677;1911
240880;201702;1167;3865;1101;3753;81;366;908;3013;989;3379
240890;201702;4832;13627;4045;12108;818;2545;1750;5202;2568;7747
240895;201702;2604;8953;2411;8635;235;909;1769;6415;2004;7324
240910;201702;2950;8698;2604;8037;125;481;2067;6304;2192;6785
240920;201702;754;2435;659;2219;104;380;350;1163;454;1543
240930;201702;3421;8739;3001;8224;93;269;2450;6795;2543;7064
240933;201702;1500;4014;1318;3720;42;166;1079;2958;1121;3124
240940;201702;6314;16671;5127;14702;641;1840;3239;9227;3880;11067
240950;201702;931;3014;857;2869;56;249;624;2025;680;2274
240960;201702;787;2443;696;2259;53;188;496;1614;549;1802
240970;201702;1832;5064;1552;4587;77;296;1220;3480;1297;3776
240980;201702;2742;9133;2567;8805;418;1562;1607;5474;2025;7036
240990;201702;2593;7719;2463;7468;394;1303;1607;4806;2001;6109
241000;201702;1029;2840;872;2556;48;177;608;1748;656;1925
241010;201702;2740;9268;2581;8969;327;1393;1795;5985;2122;7378
241020;201702;2003;5526;1601;4719;181;514;959;2822;1140;3336
241025;201702;1677;5029;1468;4661;68;282;1033;3274;1101;3556
241030;201702;2370;7729;2093;7163;210;854;1419;4808;1629;5662
241040;201702;2160;7348;1989;7045;138;601;1472;5211;1610;5812
241050;201702;1261;3705;1072;3368;67;244;787;2431;854;2675
241060;201702;828;2395;741;2240;55;190;521;1535;576;1725
241070;201702;700;2011;629;1884;51;191;478;1352;529;1543
241080;201702;1133;3340;925;2932;33;152;668;2069;701;2221
241090;201702;2121;6304;1772;5708;100;421;1306;4156;1406;4577
241100;201702;1155;3396;999;3051;65;236;688;2065;753;2301
241105;201702;1174;3529;1013;3248;247;796;455;1528;702;2324
241110;201702;808;2506;667;2190;41;164;449;1407;490;1571
241120;201702;7196;21873;6536;20702;1534;4705;3362;11320;4896;16025
241140;201702;3375;9075;2913;8179;229;671;2108;5774;2337;6445
241142;201702;729;2146;565;1813;96;337;277;859;373;1196
241150;201702;5417;15703;4836;14723;410;1439;3439;10360;3849;11799
241160;201702;940;2775;844;2611;150;491;488;1490;638;1981
241170;201702;1128;3264;1053;3136;102;318;811;2376;913;2694
241180;201702;950;2658;761;2291;77;242;407;1188;484;1430
241190;201702;1162;3191;929;2702;48;180;622;1749;670;1929
241200;201702;18637;53161;16438;49795;3968;12639;7192;22551;11160;35190
241210;201702;1421;3971;1136;3396;124;434;690;1979;814;2413
241220;201702;7846;25417;7243;24319;2082;7117;3238;11298;5320;18415
241230;201702;2983;8600;2757;8248;144;530;2251;6583;2395;7113
241240;201702;1249;3638;855;2750;95;349;372;1204;467;1553
241250;201702;6102;18513;5084;16572;271;1349;3798;11957;4069;13306
241255;201702;1680;6298;1528;5967;294;1313;796;3083;1090;4396
241260;201702;5092;13716;4072;12109;189;817;2958;8602;3147;9419
241270;201702;1825;5568;1601;5125;102;448;1145;3581;1247;4029
241280;201702;1791;5209;1639;4924;128;404;1199;3567;1327;3971
241290;201702;2896;8064;2484;7357;152;566;1832;5296;1984;5862
241300;201702;1463;4150;1254;3768;45;162;859;2548;904;2710
241310;201702;1660;4817;1512;4569;80;310;1214;3612;1294;3922
241320;201702;918;3146;833;2958;108;451;526;1850;634;2301
241330;201702;1387;4270;1314;4179;84;349;1127;3535;1211;3884
241335;201702;2794;8371;2568;7970;124;452;2096;6420;2220;6872
241340;201702;1808;5508;1523;4868;330;1143;671;2076;1001;3219
241350;201702;1877;5924;1694;5581;123;564;1269;4031;1392;4595
241355;201702;1421;3917;1143;3427;61;220;874;2595;935;2815
241360;201702;2091;5597;1714;4866;77;240;1244;3445;1321;3685
241370;201702;1363;4029;1123;3556;87;331;722;2227;809;2558
241380;201702;613;1741;515;1554;58;199;317;921;375;1120
241390;201702;2735;8800;2556;8516;225;902;1955;6450;2180;7352
241400;201702;3680;10497;3337;10008;342;1130;2495;7533;2837;8663
241410;201702;2429;7336;2158;6943;337;1159;1396;4491;1733;5650
241415;201702;1648;4908;1476;4628;150;515;1097;3371;1247;3886
241420;201702;2210;7620;1967;7201;611;2425;520;1930;1131;4355
241430;201702;569;1677;441;1401;44;160;250;747;294;907
241440;201702;6068;21761;5784;21302;703;2995;4269;15720;4972;18715
241445;201702;962;2778;917;2728;53;128;773;2420;826;2548
241450;201702;2925;7852;2561;7334;321;960;1742;4959;2063;5919
241460;201702;3342;9684;2967;8923;223;820;2148;6253;2371;7073
241470;201702;1372;3790;1126;3462;94;351;839;2577;933;2928
241475;201702;1237;3696;1019;3259;48;255;728;2219;776;2474
241480;201702;2645;8778;2430;8411;958;3391;651;2543;1609;5934
241490;201702;700;1834;581;1660;29;86;374;1033;403;1119
241500;201702;720;2259;610;2114;16;70;518;1793;534;1863
250010;201702;2750;8503;2315;7551;86;389;1750;5579;1836;5968
250020;201702;1562;4478;1201;3786;63;263;859;2624;922;2887
250030;201702;6808;19596;6310;18898;375;1278;5161;15245;5536;16523
250040;201702;3936;13271;3643;12633;482;1767;2403;8352;2885;10119
250050;201702;3251;10137;3021;9771;467;1580;1895;5996;2362;7576
250053;201702;1217;3650;1106;3480;117;376;776;2470;893;2846
250057;201702;622;2623;604;2604;3;3;573;2533;576;2536
250060;201702;5056;14885;4701;14372;397;1397;3673;11127;4070;12524
250070;201702;3821;11765;3556;11270;118;570;2716;8299;2834;8869
250073;201702;768;2257;671;2093;21;83;509;1537;530;1620
250077;201702;2102;6103;1715;5457;109;379;1197;3791;1306;4170
250080;201702;4075;11859;3880;11513;279;965;3069;8937;3348;9902
250090;201702;2543;7235;2369;6948;132;368;1910;5553;2042;5921
250100;201702;3801;12236;3575;11827;213;897;2857;9223;3070;10120
250110;201702;4804;14285;4524;13878;382;1398;3610;10872;3992;12270
250115;201702;474;1517;439;1454;23;122;320;1011;343;1133
250120;201702;1839;5723;1621;5303;90;374;1251;4080;1341;4454
250130;201702;5251;16346;4756;15429;190;832;3821;12287;4011;13119
250135;201702;1027;3119;969;3020;35;137;778;2395;813;2532
250140;201702;2052;6711;1976;6591;160;681;1526;5044;1686;5725
250150;201702;4970;16524;4545;15724;247;1148;3469;11771;3716;12919
250153;201702;1424;3835;1228;3547;37;166;1024;2905;1061;3071
250157;201702;1702;5491;1559;5206;242;781;992;3382;1234;4163
250160;201702;3262;9516;3088;9244;82;295;2798;8364;2880;8659
250170;201702;1557;4586;1426;4391;97;355;1105;3378;1202;3733
250180;201702;15537;44661;14433;43026;1327;4667;10483;30470;11810;35137
250190;201702;4075;11708;3720;11142;467;1400;2455;7338;2922;8738
250200;201702;1934;5672;1618;5197;79;325;1303;4144;1382;4469
250205;201702;831;2855;778;2734;35;179;578;2014;613;2193
250210;201702;1456;4721;1369;4583;96;457;1050;3403;1146;3860
250215;201702;1340;4287;1266;4176;103;429;835;2699;938;3128
250220;201702;732;2216;619;2039;32;129;467;1537;499;1666
250230;201702;1511;3807;1236;3356;47;171;950;2460;997;2631
250240;201702;2269;7405;2164;7221;110;424;1751;5801;1861;6225
250250;201702;4338;12878;3946;12345;161;584;3230;10084;3391;10668
250260;201702;1666;4993;1445;4628;61;228;1130;3625;1191;3853
250270;201702;1268;3918;1142;3760;85;289;856;2946;941;3235
250280;201702;3546;10377;3111;9689;237;768;2339;7287;2576;8055
250290;201702;1762;4782;1477;4393;19;70;1243;3687;1262;3757
250300;201702;5174;15369;4954;15095;364;1476;4266;12700;4630;14176
250310;201702;1094;3339;985;3155;61;253;755;2344;816;2597
250320;201702;7967;23165;7488;22467;853;2829;5495;16203;6348;19032
250330;201702;2356;7298;2032;6810;163;597;1519;5071;1682;5668
250340;201702;1067;3155;960;2973;31;120;806;2451;837;2571
250350;201702;3957;11078;3565;10604;119;469;3142;9270;3261;9739
250355;201702;1930;6016;1770;5804;46;247;1567;5056;1613;5303
250360;201702;1782;5246;1674;5068;50;174;1411;4266;1461;4440
250370;201702;11381;32458;10185;31112;587;1939;8758;26785;9345;28724
250375;201702;1050;3167;955;3033;41;145;801;2566;842;2711
250380;201702;1644;4658;1565;4553;74;298;1309;3688;1383;3986
250390;201702;1774;4863;1457;4324;212;594;917;2756;1129;3350
250400;201702;72319;190965;57222;167307;14393;44514;21186;63530;35579;108044
250403;201702;1552;5046;1439;4891;241;991;929;3065;1170;4056
250407;201702;1187;3299;1023;3052;81;227;751;2219;832;2446
250410;201702;518;1674;482;1607;23;116;381;1231;404;1347
250415;201702;1880;5597;1696;5284;97;330;1282;3966;1379;4296
250420;201702;1232;3569;1110;3389;25;94;994;3028;1019;3122
250430;201702;6096;16279;5521;15412;230;786;4521;12337;4751;13123
250435;201702;1312;4010;1177;3768;75;286;866;2739;941;3025
250440;201702;4441;12608;4027;12041;113;446;3407;10076;3520;10522
250450;201702;1882;5357;1638;5021;54;224;1370;4132;1424;4356
250460;201702;6416;18980;6015;18467;403;1320;5010;15559;5413;16879
250470;201702;1536;4132;1300;3800;101;368;940;2660;1041;3028
250480;201702;3703;11097;3422;10699;89;389;2978;9321;3067;9710
250485;201702;603;1509;511;1385;27;83;422;1116;449;1199
250490;201702;3853;11679;3719;11496;511;1645;2779;8613;3290;10258
250500;201702;1745;5261;1578;4985;111;349;1221;3901;1332;4250
250510;201702;4864;13564;4366;12856;122;392;3830;11284;3952;11676
250520;201702;1746;5238;1630;5081;237;849;1022;3122;1259;3971
250523;201702;1710;5073;1663;5012;104;417;1401;4139;1505;4556
250527;201702;1397;4131;1335;4057;49;173;1225;3687;1274;3860
250530;201702;584;1806;519;1727;27;111;452;1493;479;1604
250535;201702;1307;4048;1222;3884;54;251;971;3005;1025;3256
250540;201702;2403;6671;2242;6488;31;136;2021;5785;2052;5921
250550;201702;858;2881;792;2775;43;228;648;2204;691;2432
250560;201702;1626;5045;1538;4910;80;319;1252;3909;1332;4228
250570;201702;2596;8101;2283;7505;120;522;1785;5728;1905;6250
250580;201702;1077;2866;947;2672;57;219;793;2170;850;2389
250590;201702;816;2534;752;2437;36;156;628;1980;664;2136
250600;201702;6966;20454;6549;19820;607;1861;5095;15472;5702;17333
250610;201702;2979;8668;2775;8374;238;759;2151;6462;2389;7221
250620;201702;668;1967;604;1837;77;257;393;1157;470;1414
250625;201702;2401;7591;2326;7477;41;122;2180;7018;2221;7140
250630;201702;9458;29061;8594;27280;1763;5872;4690;14791;6453;20663
250640;201702;3359;10283;3184;10046;163;721;2666;8214;2829;8935
250650;201702;846;2327;736;2179;47;194;545;1514;592;1708
250660;201702;1738;4649;1613;4474;30;67;1500;4191;1530;4258
250670;201702;2314;7743;2209;7563;106;529;1867;6244;1973;6773
250680;201702;4756;13106;4500;12811;167;641;4015;11320;4182;11961
250690;201702;5953;15172;5677;14859;251;732;5181;13474;5432;14206
250700;201702;4458;13184;4084;12615;591;1943;2735;8362;3326;10305
250710;201702;4385;13497;3954;12913;404;1431;2767;9167;3171;10598
250720;201702;2668;7626;2463;7303;60;266;2174;6385;2234;6651
250730;201702;3399;10283;3143;9923;234;910;2492;7672;2726;8582
250740;201702;1872;5358;1629;4993;155;583;1222;3612;1377;4195
250750;201702;95882;267260;87649;255254;10638;34170;58286;166925;68924;201095
250760;201702;2257;6271;2011;5919;119;451;1609;4643;1728;5094
250770;201702;3873;12708;3640;12406;371;1498;2634;8894;3005;10392
250780;201702;1714;5013;1485;4572;180;651;964;2882;1144;3533
250790;201702;2319;7527;2208;7329;446;1464;1314;4510;1760;5974
250800;201702;2619;7292;2320;6806;101;299;1892;5484;1993;5783
250810;201702;1234;3596;1074;3345;54;228;835;2550;889;2778
250820;201702;1851;5746;1776;5656;92;397;1570;4936;1662;5333
250830;201702;5529;17728;5119;16898;463;1857;3610;11677;4073;13534
250840;201702;882;2881;761;2628;51;212;502;1746;553;1958
250850;201702;1952;5941;1776;5667;77;365;1401;4359;1478;4724
250855;201702;1074;3136;945;2931;42;189;702;2112;744;2301
250860;201702;3205;10296;2757;9473;635;2355;1110;3902;1745;6257
250870;201702;1068;3075;932;2808;26;96;734;2184;760;2280
250880;201702;1502;4013;1257;3674;100;314;961;2838;1061;3152
250890;201702;9188;27255;8758;26670;1039;3764;6374;18927;7413;22691
250900;201702;2685;8665;2379;8073;151;546;1817;6115;1968;6661
250905;201702;1983;6264;1911;6178;171;651;1551;4959;1722;5610
250910;201702;4838;13894;4546;13479;204;775;3816;11217;4020;11992
250915;201702;1406;4238;1379;4204;59;146;1253;3898;1312;4044
250920;201702;3123;8852;2943;8583;212;677;2248;6449;2460;7126
250930;201702;1918;5818;1817;5648;131;551;1414;4254;1545;4805
250933;201702;1108;3643;1020;3463;87;372;706;2351;793;2723
250937;201702;631;1955;569;1842;47;180;418;1333;465;1513
250939;201702;1543;4597;1431;4419;105;365;1092;3321;1197;3686
250940;201702;3724;10880;3486;10497;87;368;3020;9069;3107;9437
250950;201702;1320;3963;1160;3745;47;195;939;3048;986;3243
250960;201702;1038;3360;990;3281;45;184;808;2645;853;2829
250970;201702;8334;23017;7302;21374;515;1707;5394;15555;5909;17262
250980;201702;2516;7318;2281;6883;92;391;1734;5034;1826;5425
250990;201702;1928;6484;1721;6031;219;943;1135;3824;1354;4767
251000;201702;2048;5990;1798;5586;55;258;1506;4616;1561;4874
251010;201702;2689;7912;2428;7484;93;339;2100;6459;2193;6798
251020;201702;1651;4628;1507;4447;61;199;1367;4025;1428;4224
251030;201702;1005;2860;916;2684;49;176;655;1869;704;2045
251040;201702;1717;5385;1552;5099;84;426;1205;3812;1289;4238
251050;201702;1032;3008;859;2673;115;353;523;1603;638;1956
251060;201702;1018;2291;759;1962;23;97;599;1509;622;1606
251065;201702;456;1345;397;1261;25;100;270;805;295;905
251070;201702;625;1711;560;1616;17;71;465;1296;482;1367
251080;201702;18350;51197;16469;48272;4365;13286;7510;22765;11875;36051
251090;201702;2821;8647;2487;7998;141;563;1888;5948;2029;6511
251100;201702;925;2918;840;2773;49;245;600;1889;649;2134
251110;201702;1797;5271;1590;4855;105;339;1136;3430;1241;3769
251120;201702;6160;20426;5852;19880;521;2181;4424;14749;4945;16930
251130;201702;3765;9708;3491;9417;129;318;3291;8953;3420;9271
251140;201702;4171;12616;3920;12212;137;580;3263;10102;3400;10682
251150;201702;2562;8047;2370;7765;178;781;1806;5765;1984;6546
251160;201702;1804;5881;1758;5812;47;201;1618;5338;1665;5539
251170;201702;1400;4206;1331;4129;52;222;1176;3603;1228;3825
251180;201702;2421;7373;2211;7030;293;1023;1421;4474;1714;5497
251190;201702;4376;11982;4180;11743;111;368;3783;10500;3894;10868
251200;201702;3894;12556;3689;12305;95;407;3326;11114;3421;11521
251203;201702;982;3263;949;3198;42;190;717;2366;759;2556
251207;201702;1012;3147;879;2897;37;180;610;1940;647;2120
251210;201702;7729;21671;6640;20260;584;1817;5102;15865;5686;17682
251220;201702;1161;3057;961;2780;62;176;741;2166;803;2342
251230;201702;4448;13125;4089;12679;214;839;3620;11073;3834;11912
251240;201702;3212;9617;2931;9239;327;1082;2210;6946;2537;8028
251250;201702;10172;29665;9475;28677;728;2639;7260;21516;7988;24155
251260;201702;461;1452;424;1395;23;100;324;1045;347;1145
251270;201702;4188;13544;3829;13092;136;626;3278;11190;3414;11816
251272;201702;1339;3812;1282;3736;63;218;1164;3360;1227;3578
251274;201702;896;2738;797;2567;75;328;531;1630;606;1958
251275;201702;1215;3531;1137;3409;53;230;873;2501;926;2731
251276;201702;1176;3590;1125;3506;93;392;854;2602;947;2994
251278;201702;590;1809;522;1687;46;186;343;1105;389;1291
251280;201702;2302;6758;2124;6458;82;349;1679;4934;1761;5283
251290;201702;5482;14888;5148;14476;470;1696;4058;11054;4528;12750
251300;201702;728;2403;687;2338;24;108;563;1894;587;2002
251310;201702;2845;8541;2642;8261;143;650;2108;6386;2251;7036
251315;201702;1627;5477;1547;5341;132;491;1170;4018;1302;4509
251320;201702;1839;5035;1378;4283;66;259;948;2932;1014;3191
251330;201702;1742;4611;1470;4253;56;231;1291;3666;1347;3897
251335;201702;1018;3356;931;3213;75;334;672;2256;747;2590
251340;201702;3344;9682;3004;9190;154;604;2343;7053;2497;7657
251350;201702;1183;3763;1108;3626;51;221;880;2786;931;3007
251360;201702;1797;5588;1539;5230;52;213;1313;4508;1365;4721
251365;201702;695;2084;586;1837;17;75;433;1326;450;1401
251370;201702;22667;68823;21807;67658;1714;6594;17304;52438;19018;59032
251380;201702;1307;4025;1138;3743;41;212;957;3034;998;3246
251385;201702;735;1972;614;1783;37;122;429;1191;466;1313
251390;201702;5555;18772;4951;17575;1381;5056;2162;7768;3543;12824
251392;201702;1023;3031;895;2814;57;224;658;2021;715;2245
251394;201702;604;1992;522;1848;36;158;367;1286;403;1444
251396;201702;795;2255;689;2083;62;185;450;1355;512;1540
251398;201702;864;2531;773;2364;36;146;537;1574;573;1720
251400;201702;1117;3161;954;2919;69;259;698;2052;767;2311
251410;201702;1515;3894;1284;3527;35;145;1065;2819;1100;2964
251420;201702;1937;5521;1683;5221;151;556;1241;3793;1392;4349
251430;201702;1577;5308;1448;5100;60;312;1220;4218;1280;4530
251440;201702;1165;3475;972;3101;41;163;745;2370;786;2533
251445;201702;1492;4528;1419;4429;106;443;1112;3374;1218;3817
251450;201702;4541;14305;4202;13848;135;632;3457;11357;3592;11989
251455;201702;1053;3350;944;3136;84;354;668;2185;752;2539
251460;201702;808;2500;751;2402;46;170;612;1962;658;2132
251465;201702;428;1364;368;1230;17;91;276;888;293;979
251470;201702;1091;3193;925;2844;74;271;584;1760;658;2031
251480;201702;894;2530;794;2369;32;148;595;1707;627;1855
251490;201702;1729;5127;1548;4843;140;522;1076;3312;1216;3834
251500;201702;1710;5419;1637;5285;99;408;1338;4233;1437;4641
251510;201702;2498;8152;2269;7702;339;1265;1378;4666;1717;5931
251520;201702;915;2507;796;2289;83;259;546;1529;629;1788
251530;201702;12024;33103;11264;32060;306;1324;9701;27001;10007;28325
251540;201702;2797;8853;2600;8490;148;600;2057;6637;2205;7237
251550;201702;3331;8808;2818;8110;79;307;2319;6615;2398;6922
251560;201702;650;2024;588;1920;82;321;362;1129;444;1450
251570;201702;954;2822;780;2482;37;154;543;1673;580;1827
251580;201702;1815;5133;1654;4909;319;817;1074;3337;1393;4154
251590;201702;1479;4473;1400;4358;59;225;1126;3504;1185;3729
251593;201702;962;2937;888;2832;124;419;552;1722;676;2141
251597;201702;1899;5776;1837;5699;49;198;1637;5016;1686;5214
251600;201702;6387;18617;5936;17920;300;1057;4871;14556;5171;15613
251610;201702;3266;9649;2952;9085;295;892;2117;6606;2412;7498
251615;201702;1124;3183;917;2824;44;182;628;1877;672;2059
251620;201702;15384;40492;13867;38724;472;1337;11427;33650;11899;34987
251630;201702;4574;11736;3897;10762;258;796;2907;7868;3165;8664
251640;201702;2175;6574;1977;6193;79;342;1618;4961;1697;5303
251650;201702;3915;11222;3597;10795;203;710;2985;8895;3188;9605
251660;201702;3445;10947;3145;10399;111;552;2593;8355;2704;8907
251670;201702;4353;12769;3872;12177;30;112;3638;11580;3668;11692
251675;201702;677;2105;626;2036;95;359;413;1296;508;1655
251680;201702;2716;7737;2210;6963;92;379;1703;5314;1795;5693
251690;201702;3253;9671;2962;9110;124;451;2155;6479;2279;6930
251700;201702;1880;6056;1755;5890;93;455;1435;4678;1528;5133
251710;201702;879;2290;597;1732;74;262;287;770;361;1032
251720;201702;1394;4229;1197;3857;53;251;879;2729;932;2980
251740;201702;745;2102;596;1858;55;194;372;1140;427;1334
260005;201702;24281;59419;21008;54655;3942;10032;12003;31498;15945;41530
260010;201702;9693;26389;8185;24307;945;2940;4957;15200;5902;18140
260020;201702;6129;16712;5194;15361;193;768;4214;12455;4407;13223
260030;201702;6117;17419;5435;16337;355;1238;4190;12549;4545;13787
260040;201702;9505;23395;7917;21533;628;1699;5992;16899;6620;18598
260050;201702;11112;34183;10423;33356;457;1812;9019;29044;9476;30856
260060;201702;3792;10644;3366;9883;300;887;2454;7318;2754;8205
260070;201702;9679;27559;8842;26236;923;3203;6221;18015;7144;21218
260080;201702;5942;15321;5342;14519;479;1326;4016;10811;4495;12137
260090;201702;5134;13942;4767;13425;471;1334;3636;10329;4107;11663
260100;201702;3298;9075;2837;8440;135;548;2334;6886;2469;7434
260105;201702;5028;13834;4774;13429;155;651;4106;11293;4261;11944
260110;201702;20866;57830;19199;55880;737;2389;17055;49749;17792;52138
260120;201702;12800;37668;11421;35369;2224;7075;6246;19904;8470;26979
260130;201702;3111;8673;2911;8353;273;852;2194;6201;2467;7053
260140;201702;12474;30846;10870;28946;721;2276;8758;23364;9479;25640
260150;201702;3159;8609;2853;8210;182;669;2292;6517;2474;7186
260160;201702;5447;16946;4725;15983;244;1128;3824;12950;4068;14078
260170;201702;16039;44455;15225;43330;732;2495;13024;36677;13756;39172
260180;201702;3184;9607;2906;9207;149;544;2478;7832;2627;8376
260190;201702;16130;36955;14568;35056;328;988;12664;30002;12992;30990
260200;201702;10813;27457;10000;26445;328;1129;8922;23436;9250;24565
260210;201702;11606;34536;10382;32608;455;1809;8521;26641;8976;28450
260220;201702;9248;26063;8891;25607;357;1385;7868;22275;8225;23660
260230;201702;9584;26918;8816;25857;402;1512;7136;20807;7538;22319
260240;201702;2870;8437;2497;7909;247;867;1871;5952;2118;6819
260250;201702;2230;6147;1965;5768;104;355;1576;4552;1680;4907
260260;201702;12029;33962;10887;32293;892;3067;8368;24718;9260;27785
260270;201702;3593;10333;3297;9883;217;975;2484;7146;2701;8121
260280;201702;12712;40797;11680;39281;646;2423;9727;32923;10373;35346
260290;201702;32087;94579;30275;91470;4859;15698;19131;57234;23990;72932
260300;201702;8718;26323;7728;24843;354;1544;5982;19264;6336;20808
260310;201702;4421;12922;4026;12340;757;2159;2580;8243;3337;10402
260320;201702;7388;23103;6759;22031;379;1469;5430;17619;5809;19088
260330;201702;2536;8109;2352;7757;131;583;1867;6006;1998;6589
260340;201702;1856;5360;1719;5156;43;154;1536;4589;1579;4743
260345;201702;21896;66828;20380;64000;5046;17462;8201;24684;13247;42146
260350;201702;4814;12796;4460;12304;149;545;3877;10573;4026;11118
260360;201702;2371;6738;2144;6344;109;472;1476;4301;1585;4773
260370;201702;5537;17090;4880;15910;340;1430;3574;11494;3914;12924
260380;201702;4814;15584;4343;14834;286;1266;3216;10862;3502;12128
260390;201702;4209;13255;3653;12158;274;1010;2545;8381;2819;9391
260392;201702;3455;11016;3147;10621;204;944;2594;8582;2798;9526
260400;201702;13568;37746;12791;36512;1431;4614;9113;25493;10544;30107
260410;201702;59436;168102;51640;155818;13416;43098;20228;62815;33644;105913
260415;201702;3650;11344;3196;10433;212;974;2154;6725;2366;7699
260420;201702;11995;27218;10612;25714;197;699;9692;23254;9889;23953
260430;201702;2844;9127;2503;8473;219;809;1659;5620;1878;6429
260440;201702;3208;9573;2842;8857;321;1143;1893;5732;2214;6875
260450;201702;4903;14083;4712;13825;147;510;4260;12523;4407;13033
260460;201702;5443;17215;4954;16277;819;3020;2772;8926;3591;11946
260470;201702;4533;13286;4119;12796;138;413;3596;11487;3734;11900
260480;201702;4071;11528;3560;10788;417;1427;2362;7232;2779;8659
260490;201702;4871;12644;4256;11612;197;669;3538;9412;3735;10081
260500;201702;5736;16358;5107;15353;710;2184;3329;10085;4039;12269
260510;201702;8647;22841;8037;22017;315;1064;7091;19235;7406;20299
260515;201702;4676;13906;3576;11721;228;877;2265;7420;2493;8297
260520;201702;16262;41445;15388;40262;1441;3879;12013;31223;13454;35102
260530;201702;9352;28741;8256;27048;355;1512;6911;22557;7266;24069
260540;201702;5955;14727;5418;14146;669;1255;4270;11807;4939;13062
260545;201702;62;221;42;165;9;37;8;29;17;66
260550;201702;2660;8565;2249;7657;374;1392;1042;3527;1416;4919
260560;201702;6174;16244;5474;15288;154;678;4750;13058;4904;13736
260570;201702;6725;21759;6168;20881;553;2226;4621;15564;5174;17790
260580;201702;3628;10016;3353;9557;92;335;2909;8160;3001;8495
260590;201702;6072;15220;5678;14769;257;735;4950;12868;5207;13603
260600;201702;28505;81578;25247;76243;1780;6564;18537;55395;20317;61959
260610;201702;5976;18131;5676;17616;523;1887;4175;12661;4698;14548
260620;201702;15021;45168;14362;44014;2186;7722;9228;27451;11414;35173
260630;201702;2226;6452;1974;6084;92;399;1612;4879;1704;5278
260640;201702;16952;46177;15866;44722;2026;6166;10945;30729;12971;36895
260650;201702;5430;16645;4771;15517;256;1038;3841;12510;4097;13548
260660;201702;7605;21028;6836;20059;251;996;5738;16631;5989;17627
260670;201702;2285;6088;1893;5521;107;333;1367;3971;1474;4304
260680;201702;21296;60223;19403;56848;3399;10226;10031;29451;13430;39677
260690;201702;3673;9844;3049;8835;194;571;2329;6749;2523;7320
260700;201702;5746;17070;5597;16909;28;51;5480;16736;5508;16787
260710;201702;1336;3841;1264;3744;94;327;939;2845;1033;3172
260720;201702;17657;54985;16534;52868;3009;10088;9452;30119;12461;40207
260730;201702;6596;21695;6184;21021;617;2459;4705;15744;5322;18203
260740;201702;1212;3625;1084;3396;62;223;875;2735;937;2958
260750;201702;6908;20357;6073;19305;232;723;5369;17408;5601;18131
260760;201702;4706;12564;4432;12222;189;632;3738;10317;3927;10949
260765;201702;7503;25146;7118;24506;897;4079;4878;16109;5775;20188
260770;201702;3748;10026;3375;9433;127;420;2670;7397;2797;7817
260775;201702;4840;14218;4589;13837;387;1503;3313;9695;3700;11198
260780;201702;3532;11318;3287;10851;668;2421;1728;5513;2396;7934
260790;201702;108084;270900;99607;258201;18743;49961;57903;148997;76646;198958
260795;201702;3058;8884;2699;8336;203;753;1931;5994;2134;6747
260800;201702;4947;12949;4609;12497;139;560;4085;10728;4224;11288
260805;201702;3706;11002;3191;10172;310;1187;2191;6887;2501;8074
260810;201702;6598;18296;6350;17956;351;1074;5325;15002;5676;16076
260820;201702;3934;11058;3489;10355;586;1892;1941;5688;2527;7580
260825;201702;2849;9041;2536;8516;145;617;1919;6412;2064;7029
260830;201702;3578;11493;3213;10781;423;1464;2151;7276;2574;8740
260840;201702;4180;11878;3734;11229;226;742;2998;8965;3224;9707
260845;201702;3948;11458;3782;11146;392;1213;2884;8545;3276;9758
260850;201702;4688;15214;4188;14064;749;2802;2025;6714;2774;9516
260860;201702;3606;10818;3118;9837;166;613;2366;7392;2532;8005
260870;201702;4104;11008;3650;10423;237;775;2925;8263;3162;9038
260875;201702;6270;17646;5532;16415;767;2324;3619;10796;4386;13120
260880;201702;9705;28665;8760;27147;504;1689;6985;21764;7489;23453
260890;201702;12648;36087;11787;34764;615;2282;9019;26234;9634;28516
260900;201702;5562;17021;4825;15610;370;1558;3152;9971;3522;11529
260910;201702;3056;9024;2740;8520;130;482;2053;6371;2183;6853
260915;201702;4565;15024;4270;14610;90;460;3860;13173;3950;13633
260920;201702;3137;9555;2913;9248;149;539;2367;7637;2516;8176
260930;201702;3822;12389;3396;11665;314;1148;2409;8304;2723;9452
260940;201702;13696;35957;12574;34138;1365;4224;8601;22846;9966;27070
260950;201702;6194;18930;5484;17488;811;3029;2815;8500;3626;11529
260960;201702;54068;147498;49055;139456;8882;27141;26414;74163;35296;101304
260970;201702;4839;14409;4445;13897;221;867;3476;10872;3697;11739
260980;201702;3918;12653;3651;12323;111;485;3227;10880;3338;11365
260990;201702;17138;51904;15600;49797;943;3791;12507;39790;13450;43581
261000;201702;15381;41417;12696;37365;1886;6024;7009;21115;8895;27139
261010;201702;2429;6735;2220;6488;101;234;1975;5895;2076;6129
261020;201702;6388;18333;5617;16957;488;1651;4123;12163;4611;13814
261030;201702;3722;11368;3282;10644;175;697;2578;8232;2753;8929
261040;201702;5041;16057;4289;14476;336;1355;3032;10005;3368;11360
261050;201702;7751;22469;7243;21571;859;2681;4804;14353;5663;17034
261060;201702;12263;35218;11311;33549;971;3419;8401;24391;9372;27810
261070;201702;52616;126891;46462;118126;4827;13005;32312;81284;37139;94289
261080;201702;5579;15880;5302;15481;286;815;4600;13590;4886;14405
261090;201702;16325;44150;14985;42298;979;2968;12141;34311;13120;37279
261100;201702;8151;25267;7250;23718;1061;3755;4439;14724;5500;18479
261110;201702;59665;176122;52944;165914;13285;44264;23226;74753;36511;119017
261120;201702;3790;9876;3301;9306;82;305;2925;8226;3007;8531
261130;201702;6979;17749;6472;17186;142;503;5770;15212;5912;15715
261140;201702;3120;8663;2833;8222;351;1187;1805;5114;2156;6301
261150;201702;5333;14913;4874;14223;212;776;4178;12097;4390;12873
261153;201702;2041;6059;1738;5575;95;398;1236;3924;1331;4322
261160;201702;190781;498397;175742;476034;43417;123535;78508;215213;121925;338748
261170;201702;5620;15099;5138;14398;291;839;4131;11598;4422;12437
261180;201702;9525;26200;8833;25255;860;2854;6012;16892;6872;19746
261190;201702;4968;15277;4637;14883;464;1980;3333;10399;3797;12379
261200;201702;3564;8784;3170;8308;304;824;2459;6450;2763;7274
261210;201702;1833;4879;1697;4702;105;299;1474;4083;1579;4382
261220;201702;13345;40763;11339;36640;1394;5053;6463;20691;7857;25744
261230;201702;4548;13986;4126;13452;121;511;3502;11527;3623;12038
261240;201702;4738;13656;4346;12991;505;1473;3158;9522;3663;10995
261245;201702;3450;10525;2987;9704;145;669;2317;7304;2462;7973
261247;201702;3091;9457;2646;8642;158;657;1905;6240;2063;6897
261250;201702;18747;49608;17389;47772;3109;8157;11355;32469;14464;40626
261255;201702;3934;12202;3506;11448;207;958;2763;8757;2970;9715
261260;201702;12292;34384;10950;32759;515;1782;9098;27489;9613;29271
261270;201702;3662;10851;3305;10257;291;1039;2359;7145;2650;8184
261280;201702;2523;7558;2324;7245;94;391;1884;5777;1978;6168
261290;201702;2904;8207;2617;7834;157;589;2031;6065;2188;6654
261300;201702;10815;33947;9399;31397;1067;4246;6079;19938;7146;24184
261310;201702;6917;21192;6485;20429;1556;5006;3551;11226;5107;16232
261320;201702;5791;17566;5303;16711;191;798;4268;13230;4459;14028
261330;201702;5556;15344;5234;14932;285;1126;4446;12391;4731;13517
261340;201702;3820;12622;3585;12235;315;1360;2527;8514;2842;9874
261350;201702;7990;25720;7526;24931;256;1344;6138;19807;6394;21151
261360;201702;8142;21183;7200;19889;537;1540;5636;15387;6173;16927
261370;201702;18834;55352;17663;53456;3558;11361;9857;29883;13415;41244
261380;201702;4046;13645;3750;13021;510;2038;2402;8230;2912;10268
261390;201702;16047;48352;14490;45721;1915;6609;8825;27967;10740;34576
261400;201702;4636;15793;4121;14697;252;1119;2951;10364;3203;11483
261410;201702;8861;24081;7903;22605;554;1801;6291;17896;6845;19697
261420;201702;7231;24077;6903;23638;1382;5338;4273;14427;5655;19765
261430;201702;3370;10296;2921;9621;188;658;2288;7602;2476;8260
261440;201702;1536;4840;1377;4563;55;290;1057;3417;1112;3707
261450;201702;13915;39380;13374;38711;292;1229;11939;34266;12231;35495
261460;201702;7020;20429;6567;19803;314;1025;5719;17276;6033;18301
261470;201702;4003;10856;3686;10434;65;236;3158;9036;3223;9272
261480;201702;3782;13213;3455;12629;247;1083;2582;9254;2829;10337
261485;201702;4866;14809;4335;13905;588;2200;2687;8470;3275;10670
261500;201702;5348;15007;4790;14257;490;1420;3422;10497;3912;11917
261510;201702;1837;5839;1657;5523;116;452;1229;4120;1345;4572
261520;201702;2699;8627;2550;8359;118;451;1672;5779;1790;6230
261530;201702;10728;34639;9762;32682;1801;6873;4520;14979;6321;21852
261540;201702;6842;22042;6408;21294;1424;4798;3587;12254;5011;17052
261550;201702;3450;9548;3212;9210;230;830;2447;6853;2677;7683
261560;201702;7186;23257;6486;22309;735;3013;4727;16261;5462;19274
261570;201702;3352;9949;2919;9232;318;1135;1855;5808;2173;6943
261580;201702;6010;17938;5455;17073;259;1113;4585;14143;4844;15256
261590;201702;2413;6771;2061;6214;155;490;1522;4609;1677;5099
261600;201702;5206;14023;4477;12983;286;911;3409;9894;3695;10805
261610;201702;2425;6769;2107;6316;79;319;1732;5190;1811;5509
261618;201702;2423;6674;2195;6375;149;507;1699;4820;1848;5327
261620;201702;3902;12115;3663;11713;721;2262;2303;7591;3024;9853
261630;201702;7415;21490;6268;19346;665;2504;3711;11127;4376;13631
261640;201702;34347;84218;32279;81823;1912;4449;26316;69609;28228;74058
261650;201702;3771;10982;3498;10626;238;920;2604;7983;2842;8903
270010;201702;4264;15674;3922;15007;279;1393;2963;11207;3242;12600
270020;201702;3826;10610;3540;10204;305;1051;2834;7959;3139;9010
270030;201702;36373;107812;33652;103316;6846;21557;19211;59595;26057;81152
270040;201702;10462;31481;9626;30385;1395;4712;6560;20920;7955;25632
270050;201702;4398;11912;3982;11423;295;977;3323;9521;3618;10498
270060;201702;1892;5457;1742;5259;249;770;1201;3698;1450;4468
270070;201702;4330;13162;3955;12654;195;912;3327;10395;3522;11307
270080;201702;1259;3922;1088;3592;128;461;718;2312;846;2773
270090;201702;2118;6558;1914;6159;89;442;1517;4683;1606;5125
270100;201702;5619;16856;5269;16294;538;2017;3951;11966;4489;13983
270110;201702;2919;8184;2605;7831;290;939;1911;5945;2201;6884
270120;201702;3044;8428;2693;7987;84;343;2407;7099;2491;7442
270130;201702;5116;15236;4703;14782;542;1843;3620;11557;4162;13400
270135;201702;1789;4761;1603;4536;156;329;1343;3959;1499;4288
270140;201702;10440;24358;8827;22298;565;2214;7162;17085;7727;19299
270150;201702;2633;8446;2558;8359;45;149;2476;8113;2521;8262
270160;201702;4881;16137;4516;15679;165;817;3880;13325;4045;14142
270170;201702;3657;11622;3368;11223;471;1884;2196;7166;2667;9050
270180;201702;2239;7276;2065;7030;89;465;1724;5724;1813;6189
270190;201702;1713;5555;1623;5439;74;287;1368;4618;1442;4905
270200;201702;2519;8261;2350;8022;197;862;1749;5779;1946;6641
270210;201702;4617;13490;4323;13087;269;1057;3653;10906;3922;11963
270220;201702;1239;4051;1142;3877;209;816;658;2160;867;2976
270230;201702;10588;32630;9229;30487;1044;4263;5659;18085;6703;22348
270235;201702;6115;19674;5727;19067;318;1379;4698;15490;5016;16869
270240;201702;9147;27687;7735;25843;1753;6232;4047;13800;5800;20032
270250;201702;3122;8216;2827;7844;375;1035;2146;6014;2521;7049
270255;201702;4747;14376;3840;12707;261;1127;2718;8755;2979;9882
270260;201702;5741;18203;5545;17933;350;1546;4726;14886;5076;16432
270270;201702;1145;3212;1056;3092;181;554;648;1864;829;2418
270280;201702;3454;9625;3000;8983;369;984;2079;6351;2448;7335
270290;201702;7725;26484;7238;25638;516;2453;5735;19926;6251;22379
270300;201702;3635;11373;3266;10935;330;1254;2415;8067;2745;9321
270310;201702;7397;22027;6521;20750;253;1304;5371;16601;5624;17905
270320;201702;5751;17635;5392;17054;723;2530;3740;11659;4463;14189
270330;201702;4120;14028;3851;13667;369;1415;2999;10764;3368;12179
270340;201702;1620;4898;1432;4645;97;398;1140;3607;1237;4005
270350;201702;1879;4953;1688;4710;137;444;1263;3520;1400;3964
270360;201702;2043;6177;1948;6071;145;441;1670;5314;1815;5755
270370;201702;1442;4736;1315;4521;95;422;963;3281;1058;3703
270375;201702;2876;7766;2551;7351;69;235;2278;6557;2347;6792
270380;201702;5721;17335;5317;16795;418;1353;4169;13444;4587;14797
270390;201702;1247;3425;1079;3179;55;197;819;2354;874;2551
270400;201702;6292;18630;5625;17656;309;1297;4178;12735;4487;14032
270410;201702;4710;14678;4312;13948;373;1403;3077;9793;3450;11196
270420;201702;5901;18421;5632;18065;298;1337;4574;14333;4872;15670
270430;201702;133963;379348;117320;354963;33980;108770;40903;129349;74883;238119
270440;201702;4547;13551;4175;13051;169;725;3404;10578;3573;11303
270450;201702;6236;18857;5901;18408;306;1353;4881;14920;5187;16273
270460;201702;3324;8701;3021;8342;103;380;2644;7169;2747;7549
270470;201702;10118;31897;9314;30622;1057;4026;6313;20778;7370;24804
270480;201702;2787;8442;2454;7865;301;1136;1667;5155;1968;6291
270490;201702;967;3007;885;2895;50;201;687;2230;737;2431
270500;201702;4831;16048;4529;15675;253;1195;3771;12906;4024;14101
270510;201702;5969;17232;5343;16363;581;2330;4040;11920;4621;14250
270520;201702;3443;10884;3139;10355;1046;3720;1033;3614;2079;7334
270530;201702;1287;3982;1201;3850;105;350;856;2789;961;3139
270540;201702;2019;6595;1858;6369;99;516;1538;5109;1637;5625
270550;201702;6662;19634;6015;18832;709;2362;4383;14006;5092;16368
270560;201702;3124;9191;2888;8837;226;851;2187;6567;2413;7418
270570;201702;3708;11889;3374;11315;209;914;2669;8765;2878;9679
270580;201702;2035;6129;1919;5980;125;397;1608;5089;1733;5486
270590;201702;1369;4440;1321;4368;7;23;1298;4306;1305;4329
270600;201702;2837;9230;2580;8796;162;786;2109;7018;2271;7804
270610;201702;3252;9852;3012;9503;147;571;2556;7965;2703;8536
270620;201702;1368;4485;1276;4328;81;366;1036;3394;1117;3760
270630;201702;15811;45919;14396;43674;1724;5497;10110;31047;11834;36544
270640;201702;5675;17237;5093;16333;309;1321;4048;12716;4357;14037
270642;201702;2328;8065;2172;7845;200;985;1682;5905;1882;6890
270644;201702;2760;7976;2408;7491;247;802;1757;5584;2004;6386
270650;201702;3627;11200;3429;10928;438;2048;2491;7408;2929;9456
270660;201702;2116;5420;1667;4787;79;324;1212;3422;1291;3746
270670;201702;16498;41560;14284;39080;1575;4308;10657;29880;12232;34188
270680;201702;4303;12281;4090;12046;93;265;3839;11378;3932;11643
270690;201702;9141;24633;8111;23481;2279;6165;4544;14173;6823;20338
270700;201702;576;1825;514;1721;74;317;340;1081;414;1398
270710;201702;5890;18484;5557;18056;359;1521;4611;14732;4970;16253
270720;201702;3380;11156;3079;10619;140;813;2551;8561;2691;9374
270730;201702;6323;17858;5943;17460;425;1334;5065;15093;5490;16427
270740;201702;2302;6502;2158;6285;163;587;1772;5087;1935;5674
270750;201702;5211;15683;4799;15034;627;2199;3427;10691;4054;12890
270760;201702;3451;10121;3096;9554;132;521;2510;7653;2642;8174
270770;201702;18636;48726;15552;45019;2987;8568;9152;28019;12139;36587
270780;201702;1777;5616;1697;5488;179;658;1272;4089;1451;4747
270790;201702;1554;4888;1435;4714;311;1111;841;2737;1152;3848
270800;201702;11089;32336;10284;31258;564;2346;8717;25930;9281;28276
270810;201702;3166;9618;2527;8437;254;968;1641;5496;1895;6464
270820;201702;1752;5569;1550;5228;233;903;993;3304;1226;4207
270830;201702;5534;14505;4974;13847;358;977;4074;11767;4432;12744
270840;201702;7776;24659;7178;23878;317;1669;6184;20030;6501;21699
270850;201702;7508;22530;7120;22029;732;3063;5325;15600;6057;18663
270860;201702;10792;29789;9098;27667;987;3626;6260;18634;7247;22260
270870;201702;2160;6475;1831;5804;198;679;1215;3808;1413;4487
270880;201702;8158;25666;7567;24795;429;1827;6172;19955;6601;21782
270890;201702;2408;7244;2240;6953;228;847;1646;4962;1874;5809
270895;201702;2885;10289;2778;10131;132;682;2402;8631;2534;9313
270900;201702;1789;4881;1515;4494;100;346;1150;3312;1250;3658
270910;201702;3539;11331;3244;10812;216;992;2464;8004;2680;8996
270915;201702;9330;30588;8369;28907;1193;4829;5138;17383;6331;22212
270920;201702;6170;19145;5901;18770;304;1488;5114;15793;5418;17281
270930;201702;16251;43426;13863;40561;2719;7744;8464;25835;11183;33579
270940;201702;5456;17781;5141;17448;434;2059;3793;12507;4227;14566
280010;201702;652;1866;565;1715;39;188;390;1072;429;1260
280020;201702;4785;13473;4188;12503;541;1799;2732;8035;3273;9834
280030;201702;72505;187082;61728;171317;17302;49935;22973;66628;40275;116563
280040;201702;3087;9219;2759;8728;254;940;2010;6238;2264;7178
280050;201702;3641;11480;3357;10992;924;3220;1575;5190;2499;8410
280060;201702;4961;15130;4254;13926;802;2849;2143;7188;2945;10037
280067;201702;6927;19339;6036;17917;890;2682;3670;10981;4560;13663
280070;201702;1908;6140;1833;6025;169;599;1448;4740;1617;5339
280100;201702;3723;11368;3354;10735;417;1506;2274;7273;2691;8779
280110;201702;1368;4062;1256;3892;53;203;1048;3195;1101;3398
280120;201702;7762;23980;7052;22797;1011;3144;4942;16478;5953;19622
280130;201702;7472;20318;6875;19468;835;2590;4907;13927;5742;16517
280140;201702;5714;14989;5261;14340;372;1087;4260;11625;4632;12712
280150;201702;3396;9970;3184;9644;208;807;2470;7338;2678;8145
280160;201702;1311;3835;1118;3510;154;532;715;2197;869;2729
280170;201702;4731;13893;4313;13266;391;1234;3302;10309;3693;11543
280190;201702;1187;3044;1019;2786;72;251;809;2131;881;2382
280200;201702;1170;3449;1050;3266;105;395;755;2275;860;2670
280210;201702;14080;40199;12569;38144;2179;7178;7165;22035;9344;29213
280220;201702;1638;4808;1513;4612;63;256;1265;3815;1328;4071
280230;201702;3124;9323;2852;8897;295;1029;1964;6137;2259;7166
280240;201702;3426;9671;3115;9188;149;529;2526;7357;2675;7886
280250;201702;828;2183;669;1928;98;304;355;1003;453;1307
280260;201702;2091;5414;1958;5257;59;186;1806;4846;1865;5032
280270;201702;2101;6510;1924;6240;102;386;1584;5058;1686;5444
280280;201702;4087;13248;3696;12601;709;2071;2209;8139;2918;10210
280290;201702;17381;51388;15678;48764;1855;6586;9978;31096;11833;37682
280300;201702;9671;28569;9011;27783;648;2320;6897;22108;7545;24428
280310;201702;1371;3791;1176;3459;44;189;868;2479;912;2668
280320;201702;8544;26479;7848;25367;1269;4553;4494;14410;5763;18963
280330;201702;4357;12366;3972;11715;409;1444;2944;8354;3353;9798
280340;201702;3793;10326;3560;10006;259;813;2927;8325;3186;9138
280350;201702;22109;60442;19536;56705;2619;8179;12921;37653;15540;45832
280360;201702;5572;17282;5134;16530;891;3186;2958;9349;3849;12535
280370;201702;1814;4999;1556;4576;148;404;1089;3228;1237;3632
280380;201702;1025;3119;920;2946;103;413;631;1942;734;2355
280390;201702;3066;8901;2627;8075;220;774;1810;5550;2030;6324
280400;201702;4063;11322;3690;10778;916;2639;1893;5772;2809;8411
280410;201702;2111;6657;1814;6074;213;801;1067;3462;1280;4263
280420;201702;4144;11796;3798;11267;181;577;3249;9659;3430;10236
280430;201702;2208;5653;1975;5325;94;371;1520;3993;1614;4364
280440;201702;4606;13143;4198;12630;295;1002;3355;9979;3650;10981
280445;201702;2413;6572;2220;6238;63;237;1768;4859;1831;5096
280450;201702;9184;23789;8479;22882;526;1201;7143;19806;7669;21007
280460;201702;6694;17200;6104;16363;698;1919;4566;12365;5264;14284
280470;201702;1828;5398;1627;5045;105;338;1199;3722;1304;4060
280480;201702;32488;90751;30287;87582;4032;13395;20599;58307;24631;71702
280490;201702;3815;11315;3364;10580;214;856;2485;7656;2699;8512
280500;201702;912;2429;816;2308;43;142;658;1847;701;1989
280510;201702;2504;7326;2243;6960;156;612;1642;5050;1798;5662
280520;201702;1750;4670;1603;4486;109;317;1347;3777;1456;4094
280530;201702;2462;6497;2258;6239;128;411;1874;5181;2002;5592
280540;201702;9304;25289;8570;24247;239;1067;7486;20621;7725;21688
280550;201702;6839;17399;5669;15656;464;1319;4040;11152;4504;12471
280560;201702;7409;21623;6998;21042;312;1197;5957;17614;6269;18811
280570;201702;6285;16895;5404;15711;510;1712;3718;10720;4228;12432
280580;201702;5332;16397;4608;15092;671;2285;2850;9510;3521;11795
280590;201702;2629;7225;2304;6815;215;848;1520;4396;1735;5244
280600;201702;3432;10358;3183;9993;268;986;2437;7566;2705;8552
280610;201702;2402;6648;2190;6340;186;637;1617;4581;1803;5218
280620;201702;5333;15092;4687;14035;547;1558;3184;9933;3731;11491
280630;201702;3603;11601;3365;11242;294;992;2620;8956;2914;9948
280640;201702;2154;6492;2046;6373;65;198;1906;5971;1971;6169
280650;201702;1073;3307;973;3143;104;373;678;2170;782;2543
280660;201702;2657;7298;2524;7150;233;662;2092;5952;2325;6614
280670;201702;16680;42555;15224;40615;1747;5098;10814;28564;12561;33662
280680;201702;2817;7455;2439;6855;163;475;1856;5120;2019;5595
280690;201702;925;2596;830;2469;98;334;586;1721;684;2055
280700;201702;999;2999;911;2834;67;223;653;2005;720;2228
280710;201702;12376;31202;11146;29779;584;1284;9625;26357;10209;27641
280720;201702;2321;6078;2116;5838;210;614;1484;4295;1694;4909
280730;201702;955;2724;885;2622;70;255;706;2050;776;2305
280740;201702;13227;34936;11371;32046;1239;3573;7471;21231;8710;24804
280750;201702;3426;10284;3154;9842;253;909;2274;7090;2527;7999
280760;201702;5678;16952;5200;16227;792;2663;3161;10094;3953;12757
290010;201702;2766;6277;2075;5216;54;220;1652;3961;1706;4181
290020;201702;4281;14092;4170;13948;352;1085;3482;11841;3834;12926
290030;201702;3207;9541;3006;9272;321;1048;2342;7226;2663;8274
290035;201702;4455;11267;3915;10525;210;667;3040;8349;3250;9016
290040;201702;4147;10796;3512;10093;203;829;2712;7752;2915;8581
290050;201702;2379;7721;2101;7229;144;620;1506;5117;1650;5737
290060;201702;1261;3209;1060;2962;120;420;774;2079;894;2499
290070;201702;32980;81247;28484;75558;4848;13221;15566;42916;20414;56137
290080;201702;5911;17448;5040;16251;645;2167;3395;11215;4040;13382
290090;201702;2073;4460;1704;4062;66;145;1528;3673;1594;3818
290100;201702;8981;25740;8038;24235;1070;3242;5136;15917;6206;19159
290110;201702;4774;13889;4535;13472;602;1978;2988;8720;3590;10698
290115;201702;4584;13688;4112;13075;200;617;3469;11263;3669;11880
290120;201702;6687;17301;5517;15928;257;985;4429;12579;4686;13564
290130;201702;4621;11930;3766;10866;161;635;3000;8425;3161;9060
290135;201702;4593;11169;3840;10005;274;823;2807;7045;3081;7868
290140;201702;4355;12870;3699;12020;203;768;3073;10039;3276;10807
290150;201702;2174;6436;2067;6283;226;744;1578;4695;1804;5439
290160;201702;3382;8413;3205;8191;251;578;2645;6766;2896;7344
290170;201702;2597;8357;2436;8146;148;658;2084;6853;2232;7511
290180;201702;2872;8259;2457;7619;139;555;1910;5871;2049;6426
290190;201702;3733;12246;3562;11994;215;968;2773;9225;2988;10193
290195;201702;2151;5757;1790;5192;64;291;1465;4173;1529;4464
290200;201702;3869;11769;3398;11064;207;753;2690;8701;2897;9454
290205;201702;3302;9241;2938;8659;174;671;2211;6353;2385;7024
290210;201702;14478;40882;13040;39033;1572;4171;9498;29851;11070;34022
290220;201702;2303;6702;2179;6515;148;587;1742;5081;1890;5668
290225;201702;2924;7071;2606;6715;103;276;2357;6058;2460;6334
290230;201702;2231;7082;2100;6927;108;473;1766;5793;1874;6266
290240;201702;3513;9593;3191;9110;201;649;2513;7058;2714;7707
290250;201702;3808;11727;3559;11395;113;321;3058;10270;3171;10591
290260;201702;5161;14251;4274;12927;293;1004;3272;9888;3565;10892
290265;201702;3437;10493;3003;9708;147;631;2301;7343;2448;7974
290270;201702;11949;42691;11431;41869;1077;4579;8605;31363;9682;35942
290280;201702;5431;17169;5011;16510;398;1433;3709;12227;4107;13660
290290;201702;9706;29852;8577;27978;1007;3431;5954;19623;6961;23054
290300;201702;4527;12697;3301;10397;213;743;2275;7282;2488;8025
290310;201702;1446;4267;1246;3944;162;554;770;2435;932;2989
290320;201702;28243;78586;23939;73192;4931;16085;12689;39913;17620;55998
290323;201702;3707;10193;3357;9771;117;412;2823;8120;2940;8532
290327;201702;4446;13197;3813;12064;439;1422;2504;7968;2943;9390
290330;201702;1869;4431;1714;4268;85;225;1531;3853;1616;4078
290340;201702;5105;15238;4684;14734;1062;3457;2877;9185;3939;12642
290350;201702;4262;13326;3786;12569;311;1085;2742;9294;3053;10379
290360;201702;4610;13661;3993;12826;137;580;3315;10732;3452;11312
290370;201702;4697;12674;4001;11735;236;737;3222;9516;3458;10253
290380;201702;5462;15783;4798;14790;292;990;3755;11748;4047;12738
290390;201702;14936;44365;13299;41966;1698;5627;8632;27966;10330;33593
290395;201702;2590;8368;2321;7862;105;511;1774;5972;1879;6483
290400;201702;3682;10514;3068;9559;214;739;2205;6776;2419;7515
290405;201702;4737;14607;4018;13299;410;1452;2569;8628;2979;10080
290410;201702;5810;16963;4773;15297;323;1312;3418;10628;3741;11940
290420;201702;3209;9132;2651;8306;222;742;2014;6327;2236;7069
290430;201702;3136;9591;2756;8914;430;1429;1686;5563;2116;6992
290440;201702;2985;7725;2353;6828;133;427;1775;5213;1908;5640
290450;201702;3170;9145;2693;8432;164;667;1991;6094;2155;6761
290460;201702;12371;35480;11110;33322;3223;9990;4060;12210;7283;22200
290470;201702;4101;11543;3203;10135;634;2254;1517;4938;2151;7192
290475;201702;5684;17750;5052;16601;174;881;3950;12679;4124;13560
290480;201702;2357;6394;2226;6220;207;612;1564;4587;1771;5199
290485;201702;4676;14729;4087;13843;237;1190;3317;11029;3554;12219
290490;201702;8305;21261;7819;20648;520;1645;6505;16861;7025;18506
290500;201702;3979;12390;3260;10941;453;1670;1748;5809;2201;7479
290510;201702;3132;8920;2801;8469;127;495;2332;6987;2459;7482
290515;201702;3517;9759;2936;8999;157;463;2457;7677;2614;8140
290520;201702;11237;34363;9132;30200;564;2331;5741;18704;6305;21035
290530;201702;5029;14835;4438;13893;283;949;3553;11123;3836;12072
290540;201702;3651;10551;3416;10173;214;688;2741;8137;2955;8825
290550;201702;4494;11575;4028;11051;76;255;3714;10224;3790;10479
290560;201702;6316;17843;5548;16744;842;2767;3722;11154;4564;13921
290570;201702;41961;112459;38646;108093;3365;9861;28610;79890;31975;89751
290580;201702;6884;22873;6456;22198;591;2230;4907;17085;5498;19315
290590;201702;7160;22633;6240;21009;263;1122;5070;17064;5333;18186
290600;201702;17562;51866;16269;50052;1502;4719;12559;39462;14061;44181
290610;201702;2420;8070;2003;7252;109;516;1403;4975;1512;5491
290620;201702;6137;18490;5627;17657;309;1074;4641;14472;4950;15546
290630;201702;8225;20884;7140;19671;463;1344;6021;16682;6484;18026
290640;201702;2614;7438;2147;6698;110;435;1654;5070;1764;5505
290650;201702;10655;30630;10089;29841;2183;6386;6054;18490;8237;24876
290660;201702;3616;9788;3105;9042;116;368;2305;6991;2421;7359
290670;201702;6892;20704;6111;19411;580;1937;4329;13908;4909;15845
290680;201702;10012;29822;8983;28460;376;1758;7237;22516;7613;24274
290682;201702;4676;13018;4097;12193;187;713;3412;10033;3599;10746
290685;201702;3634;8568;2427;6878;249;750;1559;4513;1808;5263
290687;201702;7034;20309;5632;17990;1160;3793;2821;9390;3981;13183
290689;201702;3038;8723;2726;8270;247;838;1988;6217;2235;7055
290690;201702;5413;15123;4745;14242;668;2017;3087;9372;3755;11389
290700;201702;2409;7179;2253;6952;136;467;1822;5643;1958;6110
290710;201702;7606;23795;7063;22989;482;1575;5735;18860;6217;20435
290720;201702;18281;53013;16965;51387;1110;3375;14044;43367;15154;46742
290730;201702;7048;19043;6332;18101;476;1411;4757;13610;5233;15021
290740;201702;899;2620;714;2301;48;186;526;1674;574;1860
290750;201702;10444;28523;9042;25995;1303;4096;5332;14960;6635;19056
290755;201702;2288;6506;1817;5647;117;454;1270;3878;1387;4332
290760;201702;4098;12344;3329;10873;450;1350;1929;6598;2379;7948
290770;201702;2514;8650;2354;8436;115;548;1895;6810;2010;7358
290780;201702;8915;22204;7723;20499;602;1266;5971;16364;6573;17630
290790;201702;4402;12850;4048;12382;202;618;3484;10681;3686;11299
290800;201702;6987;14685;5497;13078;323;615;4416;10901;4739;11516
290810;201702;5377;16048;4495;14608;189;743;3355;10938;3544;11681
290820;201702;5318;14849;4804;14145;380;1287;3605;10661;3985;11948
290830;201702;4425;11275;4081;10808;176;605;3172;8274;3348;8879
290840;201702;17091;48370;15118;45377;1822;5258;10021;31366;11843;36624
290850;201702;5976;16916;5696;16567;671;1727;4227;12816;4898;14543
290860;201702;5166;16962;4802;16532;352;1304;3848;13574;4200;14878
290870;201702;4690;13542;3778;12009;209;856;2666;8433;2875;9289
290880;201702;1412;3758;1130;3327;92;251;780;2352;872;2603
290890;201702;7107;17760;6080;16621;364;925;5263;14573;5627;15498
290900;201702;2308;6533;1796;5618;156;553;1102;3425;1258;3978
290910;201702;4828;12784;3975;11531;80;342;3356;9611;3436;9953
290920;201702;4962;13091;4576;12593;189;560;3968;10871;4157;11431
290930;201702;8113;23834;6954;22036;276;1270;5531;17201;5807;18471
290940;201702;3574;11009;3147;10383;124;429;2413;8138;2537;8567
290950;201702;1561;4247;1359;3935;122;372;937;2739;1059;3111
290960;201702;5616;15653;5080;14987;170;578;4294;12680;4464;13258
290970;201702;3673;11122;3176;10320;212;758;2231;7286;2443;8044
290980;201702;10286;28920;8786;26142;2385;7415;2737;8217;5122;15632
290990;201702;8823;26009;7602;23981;592;2228;5705;17630;6297;19858
291000;201702;3067;8833;2752;8472;163;548;2354;7254;2517;7802
291005;201702;14473;36729;12810;34646;1128;3122;9602;26332;10730;29454
291010;201702;3219;9819;2551;8431;210;720;1661;5533;1871;6253
291020;201702;1199;3193;986;2825;81;245;582;1584;663;1829
291030;201702;2310;6168;1677;4929;119;394;1034;2932;1153;3326
291040;201702;5542;16243;4872;15244;287;1184;3792;11807;4079;12991
291050;201702;7654;24340;6989;23169;1359;5090;4041;13064;5400;18154
291060;201702;5917;21440;5555;20846;821;3553;3630;13393;4451;16946
291070;201702;15865;44927;13861;41950;711;2660;10858;32564;11569;35224
291072;201702;23148;67278;18682;58370;4446;14998;6465;20536;10911;35534
291075;201702;4912;13777;4374;12965;292;769;3314;9911;3606;10680
291077;201702;1420;4016;1173;3591;62;210;842;2572;904;2782
291080;201702;75650;233970;68143;219851;24027;78922;12225;40548;36252;119470
291085;201702;5598;14649;4812;13588;295;933;3954;11172;4249;12105
291090;201702;1691;3769;1479;3524;36;97;1323;3139;1359;3236
291100;201702;2605;6541;2071;5927;119;467;1600;4471;1719;4938
291110;201702;5229;17690;4695;16881;530;2174;3381;11894;3911;14068
291120;201702;7180;19117;6583;18242;621;1798;4847;13461;5468;15259
291125;201702;1847;3695;1445;3263;61;174;1195;2683;1256;2857
291130;201702;2788;8697;2339;7869;105;496;1748;5741;1853;6237
291140;201702;4150;12200;3514;10992;442;1319;2199;6973;2641;8292
291150;201702;2009;4980;1838;4787;70;240;1529;3898;1599;4138
291160;201702;4898;15559;4361;14627;659;2470;2583;8497;3242;10967
291165;201702;2477;6896;1941;5911;49;212;1387;4128;1436;4340
291170;201702;20717;54577;17866;50322;1455;4531;11260;31802;12715;36333
291180;201702;5946;15573;4949;14013;344;1046;3615;10268;3959;11314
291185;201702;3500;9562;3119;8962;141;439;2546;7241;2687;7680
291190;201702;7208;19142;6293;17869;352;1318;5194;14493;5546;15811
291200;201702;2878;8482;2256;7299;115;408;1461;4757;1576;5165
291210;201702;6628;16030;5668;14895;224;807;4379;11393;4603;12200
291220;201702;4215;12798;3845;12207;471;1764;2606;8075;3077;9839
291230;201702;3911;9744;3518;9313;71;148;3318;8864;3389;9012
291240;201702;4421;11817;3884;10883;128;447;3221;8862;3349;9309
291250;201702;3373;10342;2727;9128;213;729;1823;6188;2036;6917
291260;201702;1056;2984;956;2858;50;230;806;2316;856;2546
291270;201702;4665;14463;4125;13475;979;3321;2250;7440;3229;10761
291280;201702;2162;6232;1759;5538;314;1098;931;2869;1245;3967
291290;201702;5546;15355;4764;14308;677;2099;3025;9319;3702;11418
291300;201702;4094;11681;3158;10057;159;591;2267;7144;2426;7735
291310;201702;5336;14979;4664;13779;249;836;3610;10605;3859;11441
291320;201702;5983;18382;4835;16149;1223;4047;2133;7420;3356;11467
291330;201702;1575;4669;1391;4350;88;326;987;3035;1075;3361
291340;201702;3827;10496;3205;9591;106;406;2626;7761;2732;8167
291345;201702;3274;10320;3051;10046;178;617;2513;8437;2691;9054
291350;201702;5599;16350;4921;15195;272;908;3796;11903;4068;12811
291360;201702;32769;87000;28134;80770;5943;17316;14736;43690;20679;61006
291370;201702;8116;22957;7641;22345;502;1681;5938;17318;6440;18999
291380;201702;3628;10761;3166;10038;166;651;2423;7698;2589;8349
291390;201702;10319;27097;9550;26194;788;2330;7555;20713;8343;23043
291400;201702;14172;38266;12370;35588;1970;5265;7922;24001;9892;29266
291410;201702;3023;8089;2355;6971;107;482;1742;4955;1849;5437
291420;201702;2004;5322;1709;4952;62;243;1435;4119;1497;4362
291430;201702;3225;9118;2830;8560;144;671;2287;6667;2431;7338
291440;201702;6291;18991;5511;17647;484;1653;4164;13405;4648;15058
291450;201702;8369;23642;7246;22165;288;825;5866;18699;6154;19524
291460;201702;13060;38878;11778;36933;1254;4407;7933;24996;9187;29403
291465;201702;7826;22134;6851;21001;380;1647;5599;16857;5979;18504
291470;201702;15347;40542;13556;38446;757;2221;10372;30218;11129;32439
291480;201702;34936;85932;28649;77582;3826;11436;16138;44046;19964;55482
291490;201702;4150;13125;3873;12741;554;1845;2619;8778;3173;10623
291500;201702;4190;11865;3552;10903;177;701;2846;8663;3023;9364
291510;201702;3693;10815;3343;10327;75;311;2855;8899;2930;9210
291520;201702;3724;10018;3197;9305;266;898;2213;6444;2479;7342
291530;201702;2105;5610;1670;4973;353;1025;899;2924;1252;3949
291535;201702;3544;10840;3280;10416;213;723;2535;8121;2748;8844
291540;201702;2008;4852;1713;4545;97;197;1512;4084;1609;4281
291550;201702;5079;13136;4401;12205;666;1770;2733;7747;3399;9517
291560;201702;18236;42840;13098;36760;799;2371;9108;26784;9907;29155
291570;201702;2175;5595;1946;5323;154;323;1611;4581;1765;4904
291580;201702;5295;15770;4680;14889;425;1686;3376;10667;3801;12353
291590;201702;1722;5347;1557;5083;143;529;1176;3866;1319;4395
291600;201702;5151;14013;3936;12056;836;2740;1881;5639;2717;8379
291610;201702;4692;14627;4535;14453;130;467;4178;13402;4308;13869
291620;201702;3012;6960;2215;6107;114;380;1730;4840;1844;5220
291630;201702;3062;7395;2520;6737;174;467;1980;5367;2154;5834
291640;201702;15977;43480;12675;38369;3159;10013;3491;11406;6650;21419
291650;201702;8238;23660;7580;22854;515;1379;6335;19396;6850;20775
291660;201702;2201;5647;1685;4842;148;535;1052;2842;1200;3377
291670;201702;1853;5082;1674;4838;99;284;1337;3921;1436;4205
291680;201702;3751;10788;3266;9972;499;1683;2060;6246;2559;7929
291685;201702;4832;12021;3992;10929;508;1299;2684;7649;3192;8948
291690;201702;3675;9847;2926;8595;191;561;2020;5848;2211;6409
291700;201702;8940;27411;7995;25732;776;2522;5961;19404;6737;21926
291710;201702;5091;13125;4087;11794;264;839;2942;8425;3206;9264
291720;201702;4597;14532;3856;13006;269;1095;2746;9039;3015;10134
291730;201702;6137;17682;5569;16939;389;1348;4434;13582;4823;14930
291733;201702;2715;7609;2253;6966;186;631;1466;4647;1652;5278
291735;201702;2924;7969;2506;7377;110;402;2058;6004;2168;6406
291740;201702;3742;10430;3158;9643;177;624;2524;7682;2701;8306
291750;201702;21006;53961;16806;47485;3056;8966;8829;25629;11885;34595
291760;201702;10472;33106;9178;30875;3464;12852;2274;7869;5738;20721
291770;201702;7398;21203;6217;19097;712;2449;4048;12128;4760;14577
291780;201702;4397;13057;4096;12566;166;592;3492;10686;3658;11278
291790;201702;2662;7921;2535;7740;91;371;2143;6457;2234;6828
291800;201702;29739;79386;26013;74372;3505;10294;16815;49315;20320;59609
291810;201702;10622;28004;8998;26020;344;1223;7409;21306;7753;22529
291820;201702;3701;10784;3309;10196;191;674;2512;7779;2703;8453
291830;201702;4055;10689;3751;10249;278;779;2994;8274;3272;9053
291835;201702;6177;19277;5080;17220;1076;3774;2717;9480;3793;13254
291840;201702;47113;131442;41241;124611;5567;16799;28110;88059;33677;104858
291845;201702;2537;7328;2361;7090;122;330;2063;6303;2185;6633
291850;201702;4387;12665;3628;11436;333;973;2615;8558;2948;9531
291855;201702;1853;4356;1600;4047;102;325;1269;3136;1371;3461
291860;201702;2168;5993;1656;4997;52;204;1085;3153;1137;3357
291870;201702;1372;3655;967;2913;71;276;606;1740;677;2016
291875;201702;2804;8637;2504;8157;141;556;1778;5699;1919;6255
291880;201702;4915;15644;4519;14849;463;1565;3201;10533;3664;12098
291890;201702;1290;3202;1034;2883;207;467;650;1920;857;2387
291900;201702;1242;3283;969;2822;47;184;733;2087;780;2271
291905;201702;2647;7107;1999;5925;66;227;1455;4199;1521;4426
291910;201702;2736;7266;2327;6786;114;429;1948;5646;2062;6075
291915;201702;6877;20972;5790;19013;301;1165;4436;14659;4737;15824
291920;201702;24369;72202;22538;69615;2846;10025;14882;45471;17728;55496
291930;201702;2515;7407;2225;6930;174;680;1592;4800;1766;5480
291940;201702;3297;9197;2441;7717;261;865;1449;4478;1710;5343
291950;201702;8526;27863;7657;26204;1152;4037;4452;15693;5604;19730
291955;201702;11076;31022;10204;29936;2343;6787;5542;17295;7885;24082
291960;201702;3051;8886;2507;8055;185;612;1870;6229;2055;6841
291970;201702;3854;11675;3554;11162;319;1223;2440;7613;2759;8836
291980;201702;11443;32477;9022;29033;745;2539;6306;20585;7051;23124
291990;201702;2073;6207;1928;6028;77;292;1698;5347;1775;5639
291992;201702;2861;8557;2789;8443;353;1036;2141;6527;2494;7563
291995;201702;2081;5853;1755;5386;86;335;1406;4239;1492;4574
292000;201702;2322;6473;2107;6182;174;577;1487;4450;1661;5027
292010;201702;5975;14968;4975;13580;436;1164;3705;10296;4141;11460
292020;201702;3985;13341;3753;12956;439;1708;2800;9567;3239;11275
292030;201702;1778;5763;1661;5577;178;673;963;3128;1141;3801
292040;201702;4312;11440;3700;10780;162;353;3153;9614;3315;9967
292045;201702;3386;10267;3016;9766;127;377;2692;8792;2819;9169
292050;201702;6347;19011;5361;17052;473;1686;3373;10655;3846;12341
292060;201702;12521;30874;11519;29647;659;1750;9702;24709;10361;26459
292070;201702;4894;14608;4507;14159;383;1215;3686;11675;4069;12890
292080;201702;3395;8791;2773;7991;162;575;2349;6742;2511;7317
292090;201702;3980;10013;3333;9251;205;716;2710;7536;2915;8252
292100;201702;10432;28103;9100;26212;1864;5632;4611;13704;6475;19336
292105;201702;2977;9046;2691;8574;105;487;2171;6875;2276;7362
292110;201702;6291;16743;4896;14509;1280;3788;2190;6686;3470;10474
292120;201702;7060;19676;5862;17485;963;2852;3440;10454;4403;13306
292130;201702;2740;7624;2368;7089;389;1095;1455;4583;1844;5678
292140;201702;4694;12392;3916;11224;485;1307;2754;8072;3239;9379
292145;201702;2253;6941;1994;6500;235;741;1375;4616;1610;5357
292150;201702;12585;37647;11762;36370;423;1741;9888;30337;10311;32078
292160;201702;2269;6692;2079;6442;76;327;1857;5684;1933;6011
292170;201702;8539;24127;7145;21737;764;2519;4672;14219;5436;16738
292180;201702;2990;8483;2325;7357;469;1433;1157;3790;1626;5223
292190;201702;3135;8954;2657;8178;501;1654;1350;4221;1851;5875
292200;201702;6665;19858;5653;18132;1506;5016;2260;7504;3766;12520
292205;201702;3747;11200;3379;10653;143;669;2793;8606;2936;9275
292210;201702;6309;16263;5349;15002;201;725;4615;12842;4816;13567
292220;201702;1777;4852;1600;4583;255;700;980;2814;1235;3514
292225;201702;3157;9758;2864;9314;146;654;2345;7506;2491;8160
292230;201702;6767;18736;6374;18129;255;1087;5142;14153;5397;15240
292240;201702;4812;14482;4251;13347;345;1130;2899;9077;3244;10207
292250;201702;5045;15143;4720;14613;802;2562;2750;8637;3552;11199
292260;201702;3185;9119;2941;8796;160;474;2491;7532;2651;8006
292265;201702;3180;9453;2734;8706;103;485;2111;6549;2214;7034
292270;201702;3945;9968;3299;9211;152;504;2789;7824;2941;8328
292273;201702;2417;5750;2052;5294;123;249;1639;4380;1762;4629
292275;201702;1644;4996;1480;4763;104;283;1202;4036;1306;4319
292280;201702;2208;5998;1929;5669;117;313;1530;4708;1647;5021
292285;201702;2364;6365;1970;5791;102;342;1547;4525;1649;4867
292290;201702;6058;19130;5426;18151;360;1523;4189;13971;4549;15494
292300;201702;8231;24220;7112;22813;1774;5968;3808;12593;5582;18561
292303;201702;2820;8461;2550;8074;81;320;2193;6877;2274;7197
292305;201702;2794;7525;2631;7289;53;234;2372;6479;2425;6713
292310;201702;5946;17261;5506;16633;197;759;4503;13463;4700;14222
292320;201702;6767;18429;5677;16581;362;1159;4341;12542;4703;13701
292330;201702;2201;5718;2020;5477;112;381;1673;4451;1785;4832
292335;201702;5040;13138;4542;12472;298;773;3735;10391;4033;11164
292340;201702;6446;17546;5505;16045;304;932;4137;12024;4441;12956
292350;201702;2267;6564;1942;6107;102;414;1585;4982;1687;5396
292360;201702;5257;13454;4849;12791;267;715;3817;10294;4084;11009
292370;201702;8457;23248;7389;21841;490;1367;5982;17840;6472;19207
292380;201702;7113;20862;6531;19929;598;1715;4932;15233;5530;16948
292390;201702;3623;7916;2946;7185;129;262;2596;6421;2725;6683
292400;201702;20343;62724;18790;60188;2752;8998;12195;39435;14947;48433
292405;201702;4386;10872;3581;9804;185;487;2893;7966;3078;8453
292410;201702;2018;5286;1831;5070;109;314;1522;4227;1631;4541
292420;201702;3696;11827;3480;11497;234;1036;2804;9135;3038;10171
292430;201702;5427;15769;4082;13858;367;1395;2625;8993;2992;10388
292440;201702;8364;27489;7789;26656;176;793;7094;24433;7270;25226
292450;201702;3903;11649;3218;10459;287;1016;2270;7434;2557;8450
292460;201702;4433;13351;3903;12442;374;1329;2763;8802;3137;10131
292465;201702;2324;6875;1947;6270;167;589;1290;4214;1457;4803
292467;201702;1785;5662;1711;5552;243;821;1193;3947;1436;4768
292470;201702;2863;7495;2361;6677;105;338;1848;5219;1953;5557
292480;201702;6322;16101;5308;14820;129;440;4700;13014;4829;13454
292490;201702;2357;6319;1937;5719;136;455;1460;4317;1596;4772
292500;201702;6337;18767;5491;17260;624;2093;3638;11530;4262;13623
292510;201702;12531;35763;10684;32966;751;2888;7823;24125;8574;27013
292520;201702;5515;15252;4817;14244;895;2719;2796;8449;3691;11168
292525;201702;5209;13574;4478;12734;173;559;3836;10976;4009;11535
292530;201702;26688;75730;23587;71395;5458;17003;11634;36426;17092;53429
292540;201702;2978;7721;2634;7318;279;803;2059;5773;2338;6576
292550;201702;6628;19971;5635;18676;530;1996;4252;14309;4782;16305
292560;201702;4006;11151;3547;10433;195;817;2759;7976;2954;8793
292570;201702;4196;11504;3773;11011;78;226;3489;10315;3567;10541
292575;201702;6303;20405;6079;20078;334;1131;5171;17228;5505;18359
292580;201702;6579;19307;6116;18654;255;950;5254;15949;5509;16899
292590;201702;7493;21053;7000;20359;294;1041;6015;17165;6309;18206
292593;201702;2903;7490;2487;6825;264;706;1824;4969;2088;5675
292595;201702;5720;15603;5080;14779;277;938;4075;11788;4352;12726
292600;201702;10756;30237;9585;28676;712;1911;7418;22685;8130;24596
292610;201702;4630;12603;3804;11249;240;696;2450;7505;2690;8201
292620;201702;6169;18229;5450;17409;106;345;5067;16386;5173;16731
292630;201702;8887;22562;7402;20233;526;1536;5229;14371;5755;15907
292640;201702;7569;24345;7025;23457;366;1536;5318;17797;5684;19333
292650;201702;4357;11844;4056;11446;271;831;3435;9636;3706;10467
292660;201702;10834;31901;9843;30465;800;2701;7571;23540;8371;26241
292665;201702;2217;6995;2076;6818;24;92;1882;6246;1906;6338
292670;201702;3542;9919;2789;8557;172;622;1833;5603;2005;6225
292680;201702;3718;10688;3292;9930;283;887;2403;7177;2686;8064
292690;201702;2707;7373;1979;6204;155;494;1325;4280;1480;4774
292700;201702;9438;27435;8219;25719;964;2967;5401;17682;6365;20649
292710;201702;2142;7034;2007;6856;71;278;1771;6079;1842;6357
292720;201702;9281;23189;8073;21860;281;929;6857;18784;7138;19713
292730;201702;3624;10640;3477;10433;177;589;2859;8547;3036;9136
292740;201702;328253;867542;307100;835372;54186;156369;183103;492458;237289;648827
292750;201702;6438;17323;5563;16080;243;832;4371;12672;4614;13504
292760;201702;3872;11919;3510;11263;336;1204;2502;8001;2838;9205
292770;201702;5853;16917;5119;15840;837;2747;3121;9976;3958;12723
292780;201702;1795;4104;1388;3590;75;255;1054;2660;1129;2915
292790;201702;3431;8059;3265;7883;42;73;3175;7719;3217;7792
292800;201702;9294;26635;8546;25409;497;1646;6791;20096;7288;21742
292805;201702;2968;8213;2595;7680;217;654;1962;5858;2179;6512
292810;201702;9346;27187;7553;24563;758;2596;5159;17112;5917;19708
292820;201702;7435;20804;5568;18091;333;1472;4253;13641;4586;15113
292830;201702;1684;4933;1552;4746;55;243;1361;4094;1416;4337
292840;201702;8063;23833;7690;23333;260;1084;6817;20305;7077;21389
292850;201702;3071;8123;2468;7203;243;811;1574;4486;1817;5297
292860;201702;15078;38062;13790;36420;763;2150;11112;29272;11875;31422
292870;201702;18410;50018;16169;46542;1517;5168;9899;27821;11416;32989
292880;201702;11852;33426;10667;31782;636;2539;7925;22791;8561;25330
292890;201702;5286;17343;4751;16394;548;2048;3255;11274;3803;13322
292895;201702;2761;6626;2105;5600;159;431;1507;4021;1666;4452
292900;201702;2703;8130;2566;7910;148;667;1990;5868;2138;6535
292905;201702;4084;11831;3266;10538;293;967;2155;7079;2448;8046
292910;201702;4881;14261;4419;13441;529;1687;2684;8205;3213;9892
292920;201702;9335;26848;8910;26272;427;1690;7536;21702;7963;23392
292925;201702;5016;14994;4597;14377;273;913;3671;11492;3944;12405
292930;201702;6455;20274;6002;19429;427;1886;4192;13224;4619;15110
292935;201702;1903;5694;1621;5377;68;297;1376;4671;1444;4968
292937;201702;2992;7727;2604;7250;113;348;2176;6068;2289;6416
292940;201702;3059;8421;2560;7721;177;573;1868;5742;2045;6315
292950;201702;8274;23589;7653;22578;406;1550;5843;16868;6249;18418
292960;201702;5153;12989;4441;12055;232;737;3394;9116;3626;9853
292970;201702;4177;12271;3685;11624;146;681;3011;9438;3157;10119
292975;201702;3602;9239;3340;8917;300;713;2808;7587;3108;8300
292980;201702;3079;8113;2479;7205;168;570;1866;5301;2034;5871
292990;201702;11542;32539;9963;30158;362;1358;8046;24237;8408;25595
293000;201702;2825;7122;2567;6810;38;136;1939;5463;1977;5599
293010;201702;17304;47470;14721;43350;1953;6141;9032;26492;10985;32633
293015;201702;7291;24612;6293;22626;684;2854;4168;14950;4852;17804
293020;201702;8706;28918;8347;28396;281;1316;7339;24793;7620;26109
293030;201702;5521;15624;4404;13853;206;707;3017;9862;3223;10569
293040;201702;3708;11863;3533;11585;171;621;3071;10047;3242;10668
293050;201702;20486;55633;18119;52606;2953;8958;9940;30238;12893;39196
293060;201702;3522;9456;2928;8476;231;777;2118;6060;2349;6837
293070;201702;23931;63280;19545;57162;4215;12484;8929;27804;13144;40288
293075;201702;3193;10798;2969;10435;161;788;2356;8274;2517;9062
293076;201702;3655;9872;3244;9321;137;390;2623;7685;2760;8075
293077;201702;5040;15263;4394;14371;733;2487;2709;9155;3442;11642
293080;201702;4581;14187;4132;13479;162;771;3401;10905;3563;11676
293090;201702;3116;9846;2596;9006;203;771;1850;6508;2053;7279
293100;201702;5769;16612;4763;14829;451;1435;3437;10811;3888;12246
293105;201702;3900;12693;3447;11836;416;1502;2314;8029;2730;9531
293110;201702;1990;5547;1726;5171;79;265;1360;4068;1439;4333
293120;201702;3721;11864;3545;11592;234;746;2926;9675;3160;10421
293130;201702;3663;10723;3338;10339;112;430;2933;9105;3045;9535
293135;201702;30862;77093;23491;66636;5116;16489;8753;25054;13869;41543
293140;201702;1968;5364;1864;5227;106;394;1525;4139;1631;4533
293150;201702;5345;17410;4574;15920;590;2162;2901;10243;3491;12405
293160;201702;3722;9440;3341;8990;383;720;2596;7492;2979;8212
293170;201702;3335;9585;3053;9157;212;740;2187;6568;2399;7308
293180;201702;5039;14106;4118;12582;181;777;3217;9572;3398;10349
293190;201702;13628;40171;12342;38218;515;2320;10306;31333;10821;33653
293200;201702;7308;19707;6402;18556;211;884;4907;14362;5118;15246
293210;201702;5096;14301;4476;13278;263;884;3372;9930;3635;10814
293220;201702;4950;14441;4147;12964;1063;3295;1511;4994;2574;8289
293230;201702;3606;10815;3191;10142;419;1503;2135;6759;2554;8262
293240;201702;4252;11755;3452;10380;125;390;2583;7812;2708;8202
293245;201702;4196;11617;3753;11006;172;567;3093;9019;3265;9586
293250;201702;5468;14760;4925;13932;463;1379;3562;10011;4025;11390
293260;201702;4429;12902;3746;11884;224;828;2662;8404;2886;9232
293270;201702;5551;14507;4949;13837;304;794;4230;12031;4534;12825
293280;201702;5233;14237;4432;13157;215;649;3414;10227;3629;10876
293290;201702;13840;45496;12839;43653;3191;11085;5636;20109;8827;31194
293300;201702;6616;15625;5622;14436;375;923;4202;10948;4577;11871
293305;201702;4760;11740;4009;10749;131;454;3323;8852;3454;9306
293310;201702;2338;6125;1898;5365;182;531;1278;3597;1460;4128
293315;201702;4184;10455;3542;9502;233;585;2802;7568;3035;8153
293317;201702;2366;6635;2133;6217;156;436;1532;4475;1688;4911
293320;201702;7412;24024;7163;23711;1172;3809;5082;17279;6254;21088
293325;201702;1701;4835;1418;4383;220;746;908;2773;1128;3519
293330;201702;47412;153553;43057;145695;9845;35270;19661;67361;29506;102631
293340;201702;2499;7207;2014;6367;246;825;1192;3785;1438;4610
293345;201702;3210;9426;2833;8944;249;617;2171;7242;2420;7859
293350;201702;6337;18788;6014;18410;143;310;5533;17413;5676;17723
293360;201702;13074;38479;11868;36997;652;2423;10356;32201;11008;34624
310010;201702;759;2098;640;1916;84;320;304;846;388;1166
310020;201702;2487;7789;2088;7053;550;2083;271;861;821;2944
310030;201702;2126;6575;1782;5997;344;1346;1028;3369;1372;4715
310040;201702;963;2552;793;2311;68;261;602;1687;670;1948
310050;201702;1751;5942;1634;5694;335;1327;741;2472;1076;3799
310060;201702;3277;9806;2847;9251;212;869;2254;7290;2466;8159
310070;201702;357;973;265;805;11;45;168;479;179;524
310080;201702;719;2107;589;1879;99;388;207;623;306;1011
310090;201702;4620;13431;3950;12298;478;1666;2606;8090;3084;9756
310100;201702;3502;10357;2943;9474;148;575;2270;7307;2418;7882
310110;201702;4748;13257;4035;12035;620;2137;2153;6179;2773;8316
310120;201702;630;1857;471;1561;128;521;170;445;298;966
310130;201702;367;1111;320;1025;66;260;173;500;239;760
310140;201702;169;562;143;522;44;192;46;136;90;328
310150;201702;4522;13666;3850;12345;943;3286;1219;3805;2162;7091
310160;201702;6506;20623;5408;18489;1747;6444;711;2433;2458;8877
310163;201702;1061;3368;894;3032;318;1161;212;678;530;1839
310170;201702;8864;24458;7864;23045;866;2741;5579;16433;6445;19174
310180;201702;1712;4796;1436;4385;206;730;860;2534;1066;3264
310190;201702;2904;9403;2579;8834;678;2603;534;1832;1212;4435
310200;201702;1632;5309;1381;4765;289;1114;502;1712;791;2826
310205;201702;1117;3161;846;2753;121;381;466;1572;587;1953
310210;201702;2763;7676;2368;7111;141;478;1755;5221;1896;5699
310220;201702;1012;2999;879;2783;132;492;558;1695;690;2187
310230;201702;2418;7310;2027;6437;239;956;1205;3607;1444;4563
310240;201702;879;3181;804;3031;106;478;479;1774;585;2252
310250;201702;807;2609;764;2533;135;562;462;1426;597;1988
310260;201702;2948;9273;2194;7748;518;2088;349;1064;867;3152
310270;201702;2602;7107;2096;6393;149;587;1625;4872;1774;5459
310280;201702;2273;5810;1813;5114;150;601;1148;3076;1298;3677
310285;201702;1978;7013;1834;6776;195;832;1276;4837;1471;5669
310290;201702;1096;3253;1019;3126;243;867;541;1517;784;2384
310300;201702;1623;5399;1540;5247;354;1389;753;2434;1107;3823
310310;201702;309;841;223;682;37;107;121;379;158;486
310320;201702;398;1210;320;1070;33;150;162;512;195;662
310330;201702;519;1285;335;943;40;127;134;335;174;462
310340;201702;8041;23635;6620;21187;1431;4566;2985;10051;4416;14617
310350;201702;13410;34819;9416;28255;2463;8135;2240;6629;4703;14764
310360;201702;441;1234;398;1173;22;89;309;883;331;972
310370;201702;1337;4450;1193;4177;262;924;575;2050;837;2974
310375;201702;1197;3259;800;2560;120;424;276;891;396;1315
310380;201702;361;919;217;673;56;181;63;178;119;359
310390;201702;441;1521;385;1406;98;371;85;270;183;641
310400;201702;9600;26202;7230;22305;1720;5850;2151;6543;3871;12393
310410;201702;678;2214;488;1890;111;474;99;367;210;841
310420;201702;4360;12272;3058;9584;633;2185;460;1244;1093;3429
310430;201702;1244;3940;894;3214;227;878;137;470;364;1348
310440;201702;512;1500;392;1256;70;260;165;527;235;787
310445;201702;1206;3880;996;3484;63;277;692;2378;755;2655
310450;201702;4349;12019;3482;10725;321;1057;2433;7581;2754;8638
310460;201702;1517;4392;1227;3943;329;1160;338;1141;667;2301
310470;201702;4038;8987;3423;8256;221;565;2972;7190;3193;7755
310480;201702;1232;3531;923;2917;196;654;402;1205;598;1859
310490;201702;2890;9184;2482;8386;546;2149;998;3253;1544;5402
310500;201702;1292;4255;1117;3912;271;1029;444;1532;715;2561
310510;201702;1864;5844;1463;4966;381;1412;253;858;634;2270
310520;201702;1405;3569;1058;3033;66;192;736;2098;802;2290
310530;201702;916;2691;480;1622;76;292;54;152;130;444
310540;201702;3046;9491;2661;8841;674;2405;1142;3684;1816;6089
310550;201702;1125;3125;903;2770;139;536;547;1585;686;2121
310560;201702;14074;42412;11926;38331;3058;10940;3723;11234;6781;22174
310570;201702;1158;3388;979;3082;133;546;653;1957;786;2503
310590;201702;4164;12032;3494;10827;515;1757;1792;5459;2307;7216
310600;201702;1402;4508;1205;4069;225;862;523;1660;748;2522
310610;201702;392;1309;344;1206;96;415;120;358;216;773
310620;201702;140130;421235;119629;382134;28713;102996;41763;121811;70476;224807
310630;201702;4236;12499;3787;11727;285;995;2870;8816;3155;9811
310640;201702;1218;3713;996;3325;279;1051;266;841;545;1892
310650;201702;2652;8140;2059;7099;283;1048;1143;3947;1426;4995
310660;201702;1302;3908;1153;3713;101;349;866;2775;967;3124
310665;201702;1279;3763;1145;3572;67;233;937;2995;1004;3228
310670;201702;39347;118886;34931;109836;8305;27847;13844;42424;22149;70271
310680;201702;663;1828;586;1718;68;226;414;1198;482;1424
310690;201702;1277;4068;1059;3701;194;846;466;1536;660;2382
310700;201702;524;1288;412;1145;65;218;252;675;317;893
310710;201702;6003;19220;4576;16951;1083;4690;462;1563;1545;6253
310720;201702;799;2319;721;2206;54;196;535;1633;589;1829
310730;201702;9003;27529;8018;25864;1246;4474;4629;14784;5875;19258
310740;201702;4886;15254;3746;12879;841;3089;794;2640;1635;5729
310750;201702;1463;3636;1078;3116;218;674;434;1166;652;1840
310760;201702;555;1661;454;1485;71;250;187;625;258;875
310770;201702;961;2947;723;2563;114;466;354;1200;468;1666
310780;201702;3816;10241;3175;9177;371;1118;2100;6025;2471;7143
310790;201702;1911;6099;1748;5808;379;1272;814;2836;1193;4108
310800;201702;2561;8114;1970;6942;572;2336;137;454;709;2790
310810;201702;1089;3053;956;2808;139;484;538;1489;677;1973
310820;201702;1265;3616;897;2903;215;778;221;693;436;1471
310825;201702;2959;10414;2428;9502;134;751;1846;7203;1980;7954
310830;201702;1335;4260;1092;3812;290;1090;364;1251;654;2341
310840;201702;2124;6244;1530;5146;303;1072;399;1264;702;2336
310850;201702;1517;4400;1307;4140;119;488;967;3013;1086;3501
310855;201702;2839;8758;2453;8182;345;1286;1651;5475;1996;6761
310860;201702;7076;21581;5922;19420;624;2246;3630;12010;4254;14256
310870;201702;1072;2812;823;2410;123;389;510;1494;633;1883
310880;201702;992;3084;825;2760;118;461;458;1522;576;1983
310890;201702;2492;7376;1916;6420;491;1862;408;1228;899;3090
310900;201702;4099;12730;3225;10971;729;2792;1157;3662;1886;6454
310910;201702;1893;5297;1225;4012;191;719;149;398;340;1117
310920;201702;1830;5283;1440;4654;288;1042;682;2187;970;3229
310925;201702;937;2984;826;2787;243;894;399;1295;642;2189
310930;201702;5982;16573;4785;14796;616;2029;2899;9248;3515;11277
310940;201702;5963;16399;5019;14996;613;2072;3184;9371;3797;11443
310945;201702;1152;3496;1046;3327;130;468;661;2077;791;2545
310950;201702;2078;6382;1504;5172;335;1364;523;1706;858;3070
310960;201702;383;1215;317;1088;76;284;136;479;212;763
310970;201702;1182;3828;898;3222;220;861;177;574;397;1435
310980;201702;377;911;237;680;32;115;131;344;163;459
310990;201702;1131;3584;923;3119;196;732;320;1014;516;1746
311000;201702;3415;11334;3115;10765;946;3596;1073;3525;2019;7121
311010;201702;708;2349;658;2222;215;771;276;949;491;1720
311020;201702;923;2698;736;2365;114;432;362;1102;476;1534
311030;201702;1642;4406;1144;3518;304;1078;353;982;657;2060
311040;201702;435;1441;362;1265;90;322;73;236;163;558
311050;201702;2260;6768;1941;6257;442;1588;834;2699;1276;4287
311060;201702;2457;7113;1820;5796;306;1139;621;1813;927;2952
311070;201702;1353;4532;1167;4179;237;982;497;1733;734;2715
311080;201702;797;2444;674;2209;152;570;246;744;398;1314
311090;201702;1793;6311;1514;5818;431;1886;521;1904;952;3790
311100;201702;1917;6408;1508;5531;492;1969;193;701;685;2670
311110;201702;3294;7894;2385;6624;396;1177;1156;3260;1552;4437
311115;201702;1200;3497;1014;3213;98;395;711;2210;809;2605
311120;201702;7282;20326;5587;17316;1153;3987;1681;4819;2834;8806
311130;201702;1998;6058;1653;5519;282;1170;700;2205;982;3375
311140;201702;1314;3403;991;2956;74;250;627;1895;701;2145
311150;201702;1566;5487;1430;5241;235;924;853;3151;1088;4075
311160;201702;3764;12456;3063;11183;1098;4382;705;2573;1803;6955
311170;201702;778;2315;623;2034;65;240;325;1093;390;1333
311180;201702;1000;2922;787;2526;237;820;216;678;453;1498
311190;201702;1069;3034;835;2601;164;592;222;654;386;1246
311200;201702;1775;5367;1400;4600;402;1445;229;691;631;2136
311205;201702;970;3185;839;2920;116;501;405;1400;521;1901
311210;201702;995;3097;904;2979;118;376;661;2246;779;2622
311220;201702;797;2490;660;2195;144;537;248;792;392;1329
311230;201702;8188;25851;6390;22098;1287;4780;2081;7488;3368;12268
311240;201702;952;2874;757;2570;189;711;295;980;484;1691
311250;201702;757;2411;667;2256;196;727;228;703;424;1430
311260;201702;2102;5663;1645;4913;358;1191;589;1724;947;2915
311265;201702;1187;3302;941;2889;151;518;538;1643;689;2161
311270;201702;3290;10348;2907;9820;278;1320;2072;6700;2350;8020
311280;201702;1122;3157;696;2231;143;536;162;505;305;1041
311290;201702;1977;6456;1850;6154;280;937;1162;3910;1442;4847
311300;201702;4295;13903;3827;13071;329;1525;2844;9496;3173;11021
311310;201702;590;1922;507;1760;106;366;136;427;242;793
311320;201702;3403;11244;3096;10565;549;2166;1207;3846;1756;6012
311330;201702;4247;12687;3698;11714;835;2870;1677;5322;2512;8192
311340;201702;11339;35327;9785;32382;2994;10580;2556;8576;5550;19156
311350;201702;2248;6200;1727;5218;250;901;797;2176;1047;3077
311360;201702;898;2665;781;2506;378;1242;116;421;494;1663
311370;201702;3688;10943;3085;9873;607;2368;1274;3683;1881;6051
311380;201702;416;1376;348;1235;103;391;108;385;211;776
311390;201702;1728;6120;1544;5852;682;2952;411;1405;1093;4357
311400;201702;1426;4376;1129;3791;199;779;462;1408;661;2187
311410;201702;1692;5777;1549;5594;393;1608;772;2781;1165;4389
311420;201702;1801;5806;1249;4482;231;902;115;314;346;1216
311430;201702;3509;10463;2486;8267;521;1902;390;1286;911;3188
311440;201702;2350;7518;1754;6387;573;2384;304;1119;877;3503
311450;201702;1839;6364;1534;5697;420;1717;290;996;710;2713
311455;201702;958;2574;745;2211;202;633;273;747;475;1380
311460;201702;592;1898;438;1598;84;364;107;373;191;737
311470;201702;456;1516;366;1326;108;440;59;187;167;627
311480;201702;804;2079;740;1983;141;378;472;1266;613;1644
311490;201702;208;759;186;696;56;233;61;200;117;433
311500;201702;426;1238;343;1095;68;258;162;511;230;769
311510;201702;2722;8252;2101;7147;640;2553;462;1577;1102;4130
311520;201702;584;1869;546;1791;168;608;231;717;399;1325
311530;201702;10350;26523;7550;22085;1906;6557;1849;5171;3755;11728
311535;201702;761;2192;501;1693;109;440;90;284;199;724
311540;201702;594;2027;552;1957;134;496;282;983;416;1479
311545;201702;2119;6279;1877;5990;159;627;1379;4319;1538;4946
311547;201702;1444;4006;1223;3663;71;230;857;2555;928;2785
311550;201702;2845;8777;2342;7796;357;1437;910;2909;1267;4346
311560;201702;263;684;222;630;30;98;131;343;161;441
311570;201702;1923;4944;1503;4381;64;190;1193;3605;1257;3795
311580;201702;2406;4717;1745;3964;313;643;1055;2581;1368;3224
311590;201702;481;1455;405;1339;92;362;186;604;278;966
311600;201702;1242;3652;1038;3380;179;590;655;2184;834;2774
311610;201702;2725;9472;2444;8949;723;2591;996;3830;1719;6421
311615;201702;3136;9606;2603;8767;242;971;1844;6148;2086;7119
311620;201702;413;1229;363;1147;48;181;237;741;285;922
311630;201702;1314;3805;1090;3413;123;425;743;2273;866;2698
311640;201702;761;2421;620;2189;120;461;281;1009;401;1470
311650;201702;2192;6092;1874;5606;210;712;1152;3424;1362;4136
311660;201702;2670;8427;2068;7193;410;1528;326;1003;736;2531
311670;201702;1554;4392;1270;3948;375;1290;378;1156;753;2446
311680;201702;2022;6327;1702;5749;332;1186;953;3234;1285;4420
311690;201702;515;1281;439;1184;27;71;341;941;368;1012
311700;201702;2284;5822;1786;5173;97;333;1381;3937;1478;4270
311710;201702;1576;4833;1157;3996;371;1423;307;1074;678;2497
311720;201702;390;1292;353;1227;50;201;163;545;213;746
311730;201702;5836;14395;3354;10213;1018;3554;529;1303;1547;4857
311740;201702;780;2384;749;2343;97;292;608;1930;705;2222
311750;201702;4019;12773;3436;11798;565;2221;1878;6277;2443;8498
311760;201702;653;2150;569;1952;127;488;141;386;268;874
311770;201702;2115;6658;1749;5978;425;1621;540;1760;965;3381
311780;201702;1217;4128;994;3628;252;1044;229;764;481;1808
311783;201702;2008;6335;1677;5696;64;310;1267;4232;1331;4542
311787;201702;596;2006;447;1595;83;336;133;410;216;746
311790;201702;1539;4492;1176;3828;265;1000;388;1229;653;2229
311800;201702;4864;16174;4255;14698;809;3107;486;1561;1295;4668
311810;201702;1021;3320;890;3067;79;346;537;1820;616;2166
311820;201702;579;1766;487;1553;101;380;277;799;378;1179
311830;201702;7967;25776;6324;21928;1838;7003;663;2183;2501;9186
311840;201702;2749;8273;2514;7914;537;1912;1454;4507;1991;6419
311850;201702;277;855;245;799;38;130;138;447;176;577
311860;201702;48599;139999;41457;127774;7116;24185;22370;67340;29486;91525
311870;201702;2098;6100;1538;4997;286;1065;473;1392;759;2457
311880;201702;6621;18555;5820;17500;620;1862;4200;12950;4820;14812
311890;201702;1391;4076;1143;3616;255;871;519;1604;774;2475
311900;201702;672;2029;574;1859;82;306;333;1069;415;1375
311910;201702;3969;11547;3317;10596;715;2443;1539;4910;2254;7353
311920;201702;1868;6005;1618;5550;183;740;994;3381;1177;4121
311930;201702;3293;9127;2728;8224;1093;3481;719;2083;1812;5564
311940;201702;12505;36865;10056;31960;2029;7081;3180;9594;5209;16675
311950;201702;2169;6326;1742;5642;144;580;1232;3918;1376;4498
311960;201702;374;1147;340;1075;65;256;163;438;228;694
311970;201702;373;1239;271;1005;56;245;65;220;121;465
311980;201702;539;1537;354;1184;60;224;117;401;177;625
311990;201702;446;1227;349;1085;113;392;133;397;246;789
311995;201702;1149;3486;687;2373;42;171;51;123;93;294
312000;201702;593;1763;532;1670;55;188;349;1117;404;1305
312010;201702;863;2793;711;2456;100;391;305;1008;405;1399
312015;201702;1331;4239;1204;4008;139;540;799;2606;938;3146
312020;201702;1070;3409;953;3205;192;697;451;1495;643;2192
312030;201702;1813;5081;1621;4847;67;298;1429;4187;1496;4485
312040;201702;725;2579;601;2261;135;579;146;520;281;1099
312050;201702;1152;4061;999;3701;283;1178;184;607;467;1785
312060;201702;720;2220;646;2091;132;467;350;1107;482;1574
312070;201702;979;2965;654;2266;132;511;244;824;376;1335
312080;201702;2649;7098;2081;6246;257;955;1215;3403;1472;4358
312083;201702;911;2500;771;2300;63;206;597;1773;660;1979
312087;201702;2097;6227;1902;5948;155;507;1467;4682;1622;5189
312090;201702;8518;25744;7098;23297;1853;6420;2749;8981;4602;15401
312100;201702;1427;4553;1128;4076;186;783;480;1673;666;2456
312110;201702;971;3380;846;3106;260;1068;169;556;429;1624
312120;201702;646;2075;541;1871;128;529;205;630;333;1159
312125;201702;1081;3437;969;3245;220;700;565;2002;785;2702
312130;201702;843;2361;664;2012;88;305;252;716;340;1021
312140;201702;791;2507;678;2243;176;625;199;597;375;1222
312150;201702;434;1284;398;1213;22;95;253;717;275;812
312160;201702;7272;23854;6416;22065;1457;5576;2538;8383;3995;13959
312170;201702;868;2487;720;2245;60;227;464;1410;524;1637
312180;201702;1347;4091;1172;3750;194;726;526;1583;720;2309
312190;201702;586;1858;444;1567;147;576;69;253;216;829
312200;201702;4725;13375;3964;12168;700;2179;2305;7151;3005;9330
312210;201702;1074;2800;813;2417;150;527;468;1312;618;1839
312220;201702;1941;6453;1800;6296;109;270;1593;5812;1702;6082
312230;201702;11018;33437;8457;28509;2776;10347;1048;3346;3824;13693
312235;201702;1546;4568;1368;4314;152;559;991;3088;1143;3647
312240;201702;866;2887;690;2509;169;678;178;642;347;1320
312245;201702;2188;6341;1972;6071;82;312;1622;4990;1704;5302
312247;201702;765;2231;592;1943;153;529;248;847;401;1376
312250;201702;1116;3052;820;2539;144;539;323;939;467;1478
312260;201702;883;2769;735;2524;118;459;437;1449;555;1908
312270;201702;642;1904;527;1667;48;203;268;775;316;978
312280;201702;396;1299;352;1203;135;482;46;153;181;635
312290;201702;758;2501;691;2387;155;612;225;771;380;1383
312300;201702;824;2698;655;2300;169;653;52;129;221;782
312310;201702;774;2849;728;2746;179;763;322;1180;501;1943
312320;201702;1899;5364;1497;4634;445;1528;307;878;752;2406
312330;201702;993;2875;815;2623;122;457;581;1840;703;2297
312340;201702;297;801;238;709;36;130;127;345;163;475
312350;201702;276;681;242;644;22;81;200;507;222;588
312352;201702;1573;4884;1413;4650;215;739;961;3266;1176;4005
312360;201702;2881;9136;2427;8197;556;2039;743;2488;1299;4527
312370;201702;1680;5145;1481;4800;400;1455;600;1846;1000;3301
312380;201702;1908;5097;1710;4831;62;185;1448;4190;1510;4375
312385;201702;1286;3687;1102;3402;82;335;795;2383;877;2718
312390;201702;2053;6472;1631;5659;402;1485;367;1206;769;2691
312400;201702;2958;9368;2453;8366;940;3312;552;1959;1492;5271
312410;201702;9803;31405;8735;29385;1819;6574;3945;13113;5764;19687
312420;201702;3800;11532;3580;11202;522;1695;2362;7502;2884;9197
312430;201702;7998;22972;6808;20903;863;2830;4305;13233;5168;16063
312440;201702;779;2444;652;2219;215;812;226;789;441;1601
312450;201702;1156;3740;906;3241;269;1019;308;1146;577;2165
312460;201702;335;995;293;942;53;196;166;530;219;726
312470;201702;593;1602;389;1220;76;280;120;348;196;628
312480;201702;1092;2821;822;2520;152;574;470;1361;622;1935
312490;201702;1896;4935;1492;4328;195;644;868;2432;1063;3076
312500;201702;665;1951;574;1803;104;380;229;698;333;1078
312510;201702;3611;10427;2931;9055;406;1435;1489;4374;1895;5809
312520;201702;227;716;182;644;66;243;63;226;129;469
312530;201702;560;1618;490;1521;48;188;341;1047;389;1235
312540;201702;1354;4252;1034;3606;204;773;470;1644;674;2417
312550;201702;694;2044;601;1851;104;348;300;863;404;1211
312560;201702;2089;5393;1717;4916;91;348;1392;3935;1483;4283
312570;201702;2194;6413;1830;5821;530;1757;668;2150;1198;3907
312580;201702;505;1626;424;1444;59;232;170;571;229;803
312590;201702;1621;5218;1408;4772;230;985;659;2081;889;3066
312595;201702;1795;6019;1661;5713;315;1115;936;3239;1251;4354
312600;201702;766;2413;578;2061;114;518;269;902;383;1420
312610;201702;6379;17715;4673;14614;1115;3765;911;2742;2026;6507
312620;201702;2157;6167;1665;5464;103;387;1241;4183;1344;4570
312630;201702;296;945;250;855;57;229;88;298;145;527
312640;201702;521;1655;426;1454;82;303;128;403;210;706
312650;201702;2096;5960;1536;4861;159;582;880;2695;1039;3277
312660;201702;1366;3567;1103;3184;106;370;762;2156;868;2526
312670;201702;5303;15558;4480;14440;1197;4366;1753;5531;2950;9897
312675;201702;1252;3929;1067;3544;98;397;745;2444;843;2841
312680;201702;1404;4232;1212;3967;156;636;801;2556;957;3192
312690;201702;2115;5525;1724;4979;237;770;1138;3187;1375;3957
312695;201702;819;2812;776;2743;121;420;534;1943;655;2363
312700;201702;1741;5264;1390;4553;172;608;758;2447;930;3055
312705;201702;1257;3534;1030;3134;64;244;715;2107;779;2351
312707;201702;1423;4575;1119;3966;142;628;591;2000;733;2628
312710;201702;6368;15839;4141;12369;1247;4135;783;2388;2030;6523
312720;201702;758;2527;652;2299;109;446;285;939;394;1385
312730;201702;1827;4396;1303;3755;129;455;832;2374;961;2829
312733;201702;1537;4110;1183;3483;60;193;723;2083;783;2276
312735;201702;785;2105;687;1962;124;440;424;1109;548;1549
312737;201702;798;2004;573;1677;141;420;224;661;365;1081
312738;201702;479;1482;344;1211;89;370;111;357;200;727
312740;201702;303;766;191;634;71;251;41;119;112;370
312750;201702;1206;4201;1122;4069;200;863;589;2075;789;2938
312760;201702;1797;5717;1385;4864;319;1183;385;1343;704;2526
312770;201702;40621;108894;29987;90969;7448;24393;8377;24785;15825;49178
312780;201702;2636;8890;2351;8397;373;1515;1346;4833;1719;6348
312790;201702;315;793;186;579;25;90;67;178;92;268
312800;201702;4819;15406;3877;13473;1172;4427;834;2936;2006;7363
312810;201702;1983;6028;1384;4807;360;1369;279;887;639;2256
312820;201702;1894;5313;1614;4836;83;311;1114;3234;1197;3545
312825;201702;1285;3431;1125;3223;77;244;875;2514;952;2758
312830;201702;2520;7659;1769;6179;451;1700;318;1100;769;2800
312840;201702;1200;3787;970;3341;148;600;326;1016;474;1616
312850;201702;687;2096;549;1828;107;419;171;554;278;973
312860;201702;1242;3534;914;2954;219;783;277;837;496;1620
312870;201702;5542;16899;3939;13548;698;2624;882;2945;1580;5569
312880;201702;1283;3704;1144;3501;92;311;740;2342;832;2653
312890;201702;1788;5326;1125;3840;199;728;403;1397;602;2125
312900;201702;1196;3450;1024;3204;95;320;718;2292;813;2612
312910;201702;1620;3173;952;2306;163;438;440;992;603;1430
312920;201702;828;2616;690;2348;156;629;296;931;452;1560
312930;201702;2090;5914;1781;5443;395;1235;820;2503;1215;3738
312940;201702;851;2729;746;2545;167;616;265;909;432;1525
312950;201702;2862;7999;2194;7002;781;2698;454;1490;1235;4188
312960;201702;1889;5327;1646;4988;110;317;1295;4002;1405;4319
312965;201702;1784;5557;1521;5065;136;536;953;3137;1089;3673
312970;201702;922;3045;746;2743;201;817;210;763;411;1580
312980;201702;17331;56510;16138;54046;4171;15234;6587;21165;10758;36399
312990;201702;452;1303;308;1048;83;329;102;340;185;669
313000;201702;472;1544;390;1384;85;405;143;441;228;846
313005;201702;2581;8067;2313;7582;337;1117;1476;4872;1813;5989
313010;201702;3599;11373;3059;10418;781;2922;1412;4668;2193;7590
313020;201702;908;3002;667;2411;131;536;84;259;215;795
313030;201702;1407;3707;1032;3170;180;658;492;1488;672;2146
313040;201702;739;2426;655;2232;80;333;322;1035;402;1368
313050;201702;1764;5421;1297;4674;319;1300;329;1095;648;2395
313055;201702;1562;4833;1442;4659;60;230;1223;3953;1283;4183
313060;201702;754;2387;599;2032;175;618;77;246;252;864
313065;201702;1864;5963;1599;5536;220;876;1108;3841;1328;4717
313070;201702;963;2779;795;2490;149;531;361;1106;510;1637
313080;201702;430;1286;322;1060;77;306;102;280;179;586
313090;201702;5100;14592;4412;13494;1192;3979;2093;6359;3285;10338
313100;201702;1090;3270;988;3111;75;233;783;2498;858;2731
313110;201702;1650;4672;1226;3839;168;617;539;1569;707;2186
313115;201702;2280;7490;2139;7200;440;1679;1017;3205;1457;4884
313120;201702;3425;8966;2939;8343;565;1799;1751;4964;2316;6763
313130;201702;25085;74340;21436;67159;4145;14423;9201;27353;13346;41776
313140;201702;498;1301;387;1127;24;82;283;800;307;882
313150;201702;1299;4061;1073;3643;424;1532;229;789;653;2321
313160;201702;893;2700;761;2440;148;552;376;1139;524;1691
313170;201702;9792;32259;7407;26576;1561;5998;2069;7117;3630;13115
313180;201702;2212;5990;1753;5341;358;1218;768;2238;1126;3456
313190;201702;3785;12426;3007;10574;649;2491;787;2620;1436;5111
313200;201702;1116;3541;982;3287;89;366;712;2326;801;2692
313210;201702;3963;12141;3341;11169;660;2418;1649;5323;2309;7741
313220;201702;1543;4522;1107;3655;248;920;259;727;507;1647
313230;201702;2231;7710;2090;7523;255;1016;1505;5371;1760;6387
313240;201702;8067;23941;6214;20524;1179;4414;2488;7855;3667;12269
313250;201702;6286;19827;5374;18192;538;2071;3006;10132;3544;12203
313260;201702;622;1821;435;1415;80;309;115;362;195;671
313270;201702;5247;15597;4376;14059;742;2583;2366;7547;3108;10130
313280;201702;361;1173;263;967;57;225;67;235;124;460
313290;201702;761;2706;641;2500;230;1010;101;364;331;1374
313300;201702;1723;5595;1423;4927;416;1577;182;552;598;2129
313310;201702;933;3179;832;2970;185;763;162;497;347;1260
313320;201702;2274;6414;1670;5461;339;1225;684;2224;1023;3449
313330;201702;3964;11939;3305;10809;336;1441;2055;6468;2391;7909
313340;201702;1642;4052;1279;3514;213;597;733;2036;946;2633
313350;201702;2431;7549;1940;6467;431;1579;457;1428;888;3007
313360;201702;1270;3581;954;3059;195;770;502;1495;697;2265
313370;201702;1145;3805;1073;3621;159;618;563;1812;722;2430
313375;201702;2085;5552;1497;4666;271;1026;494;1460;765;2486
313380;201702;4585;13966;3889;12584;1013;3599;1326;4010;2339;7609
313390;201702;870;2937;814;2843;78;338;562;1928;640;2266
313400;201702;3613;9708;3128;9136;300;856;2548;7565;2848;8421
313410;201702;1154;3252;970;2965;186;637;592;1760;778;2397
313420;201702;16443;39482;10249;29218;2139;6888;1559;4481;3698;11369
313430;201702;956;2994;728;2520;134;551;258;813;392;1364
313440;201702;6154;13850;4220;11539;234;662;2716;7566;2950;8228
313450;201702;578;1715;452;1455;88;306;151;457;239;763
313460;201702;2025;6769;1764;6319;489;2003;670;2200;1159;4203
313470;201702;3023;8183;2662;7651;361;1063;1790;5125;2151;6188
313480;201702;792;2318;623;2010;90;332;225;673;315;1005
313490;201702;1490;4168;834;3134;273;1165;64;227;337;1392
313500;201702;407;1336;326;1124;54;200;101;340;155;540
313505;201702;8859;25565;8237;24867;197;428;7736;23718;7933;24146
313507;201702;1342;3650;1151;3372;102;347;784;2310;886;2657
313510;201702;14333;41513;12597;38586;1679;5578;6836;20697;8515;26275
313520;201702;13850;42295;11595;38306;1276;4838;7412;24313;8688;29151
313530;201702;550;1645;457;1479;47;184;158;466;205;650
313535;201702;2499;7231;2245;6777;179;584;1600;4779;1779;5363
313540;201702;951;2965;709;2332;186;658;191;603;377;1261
313545;201702;1220;4426;1097;4194;168;738;644;2356;812;3094
313550;201702;1768;5586;1556;5184;331;1157;791;2605;1122;3762
313560;201702;2176;4915;1765;4462;151;359;1368;3531;1519;3890
313570;201702;851;2912;735;2690;201;812;284;1014;485;1826
313580;201702;5580;15907;4404;14156;766;2716;2292;7518;3058;10234
313590;201702;915;2639;724;2368;319;1135;145;455;464;1590
313600;201702;3694;10995;3249;10280;302;1102;2386;7523;2688;8625
313610;201702;950;2740;816;2487;177;564;468;1431;645;1995
313620;201702;5131;15439;4455;14236;1116;3790;1728;5510;2844;9300
313630;201702;7789;21368;5859;18689;830;2964;3115;10475;3945;13439
313640;201702;753;2189;555;1879;169;612;161;561;330;1173
313650;201702;1775;5858;1589;5539;212;886;1019;3484;1231;4370
313652;201702;892;3079;822;2952;127;544;492;1681;619;2225
313655;201702;898;2830;759;2612;107;421;433;1493;540;1914
313657;201702;1333;3852;1084;3483;98;426;779;2350;877;2776
313660;201702;805;2608;703;2395;137;568;345;1098;482;1666
313665;201702;3773;11907;3230;10778;601;2226;1618;5247;2219;7473
313670;201702;43502;125249;31982;103027;7140;25308;10137;31738;17277;57046
313680;201702;1040;3027;915;2824;115;453;566;1689;681;2142
313690;201702;861;3018;733;2751;151;593;278;1062;429;1655
313695;201702;1322;4259;1148;3914;111;473;801;2721;912;3194
313700;201702;3417;11586;2982;11040;388;1491;2224;8409;2612;9900
313710;201702;1275;3431;978;2957;148;485;541;1642;689;2127
313720;201702;5344;16484;4165;14028;799;3001;1440;4472;2239;7473
313730;201702;1282;3328;975;2919;102;348;579;1724;681;2072
313740;201702;1812;6564;1545;5882;451;1895;96;333;547;2228
313750;201702;1999;5993;1655;5299;461;1622;473;1367;934;2989
313753;201702;1802;5070;1414;4397;221;792;703;2149;924;2941
313760;201702;4125;13011;3389;11555;939;3498;1017;3275;1956;6773
313770;201702;3250;10147;2782;9493;623;2260;1472;5061;2095;7321
313780;201702;3980;10892;3058;9448;443;1571;1010;3113;1453;4684
313790;201702;442;1503;418;1462;64;228;267;944;331;1172
313800;201702;1151;3050;997;2813;86;283;720;2071;806;2354
313810;201702;1538;4356;1351;4085;136;444;968;2965;1104;3409
313820;201702;12046;32112;9660;28236;1664;5628;4016;11030;5680;16658
313830;201702;370;1197;327;1122;81;311;139;476;220;787
313835;201702;864;2834;792;2716;115;488;444;1441;559;1929
313840;201702;7154;20387;5626;17815;1382;4824;1276;4022;2658;8846
313850;201702;1069;2879;936;2643;164;572;499;1283;663;1855
313860;201702;2731;8129;2071;6732;420;1460;617;1904;1037;3364
313862;201702;1246;3155;897;2581;100;288;507;1528;607;1816
313865;201702;2246;6748;2014;6395;135;509;1526;4793;1661;5302
313867;201702;1101;3733;964;3445;303;1110;328;1197;631;2307
313868;201702;1651;5404;1406;4905;110;504;993;3366;1103;3870
313870;201702;744;2311;661;2167;167;628;208;599;375;1227
313880;201702;1264;3884;1062;3527;245;907;369;1069;614;1976
313890;201702;1829;4859;1498;4422;251;747;855;2709;1106;3456
313900;201702;3758;13317;3346;12393;1045;4241;847;3145;1892;7386
313910;201702;677;2242;557;1999;190;730;80;291;270;1021
313920;201702;3159;10465;2748;9712;545;2010;1476;5409;2021;7419
313925;201702;1766;4791;1382;4062;179;511;821;2439;1000;2950
313930;201702;6404;22825;5421;21101;696;2574;3419;14308;4115;16882
313940;201702;8461;27226;6743;24396;1795;7277;1926;7478;3721;14755
313950;201702;3971;11026;2999;9460;899;3307;1013;2987;1912;6294
313960;201702;5323;13644;3782;11369;944;3172;1128;3248;2072;6420
313970;201702;1354;4031;1228;3869;128;460;718;2370;846;2830
313980;201702;1205;3724;925;3227;202;803;362;1223;564;2026
313990;201702;1620;6100;1422;5593;483;2040;331;1249;814;3289
314000;201702;8176;25236;7326;23534;992;3842;4402;13594;5394;17436
314010;201702;1171;3173;968;2898;73;270;677;1983;750;2253
314015;201702;1552;4949;1279;4478;250;1028;606;2050;856;3078
314020;201702;498;1480;328;1100;56;217;74;244;130;461
314030;201702;775;2505;622;2149;96;351;258;881;354;1232
314040;201702;735;2122;617;1899;151;495;233;713;384;1208
314050;201702;1562;4763;1241;4125;241;941;521;1606;762;2547
314053;201702;1549;4817;1357;4550;191;658;876;3100;1067;3758
314055;201702;2140;6309;1871;5908;74;309;1527;4839;1601;5148
314060;201702;1163;3509;926;3095;59;264;617;2013;676;2277
314070;201702;4071;12569;3278;11040;866;3113;887;2850;1753;5963
314080;201702;1738;5412;1251;4305;201;755;276;836;477;1591
314085;201702;1935;6418;1690;6057;464;1805;630;2280;1094;4085
314090;201702;3114;10635;2738;9889;516;2091;1171;4408;1687;6499
314100;201702;3272;8132;2885;7614;134;276;2449;6734;2583;7010
314110;201702;3773;11883;3347;11000;652;2378;1440;4383;2092;6761
314120;201702;1007;2392;474;1511;90;321;116;370;206;691
314130;201702;685;1961;356;1224;64;248;64;204;128;452
314140;201702;4790;14666;3897;12878;714;2564;1795;5909;2509;8473
314150;201702;1502;4127;1202;3616;159;532;674;1991;833;2523
314160;201702;2518;6529;1919;5617;233;773;1008;3049;1241;3822
314170;201702;1021;3016;844;2655;90;309;492;1474;582;1783
314180;201702;4946;15405;4371;14495;1219;4273;1851;6278;3070;10551
314190;201702;667;1847;496;1565;109;413;186;528;295;941
314200;201702;2827;8650;2496;8060;252;1002;1737;5434;1989;6436
314210;201702;1978;5612;1771;5266;177;636;1118;3248;1295;3884
314220;201702;1440;4437;1072;3715;338;1284;223;700;561;1984
314225;201702;1321;3773;1191;3600;78;285;884;2684;962;2969
314230;201702;643;2036;600;1963;94;371;348;1122;442;1493
314240;201702;1078;3255;890;2950;174;620;439;1513;613;2133
314250;201702;527;1569;407;1312;83;293;121;347;204;640
314260;201702;965;3420;854;3152;181;781;264;905;445;1686
314270;201702;2734;8794;2258;7942;221;911;1510;5315;1731;6226
314280;201702;2986;8046;2043;6297;443;1586;725;2038;1168;3624
314290;201702;4632;12721;3969;11650;704;2119;2266;6652;2970;8771
314300;201702;1461;4783;1223;4230;347;1240;334;1139;681;2379
314310;201702;5529;15698;4540;14039;1090;3634;1732;5169;2822;8803
314315;201702;772;3009;705;2874;83;402;487;1968;570;2370
314320;201702;2903;8167;2075;6952;466;1672;995;3440;1461;5112
314330;201702;52534;156160;43980;142065;12965;44994;11963;38358;24928;83352
314340;201702;2772;7450;1585;5191;322;1203;127;310;449;1513
314345;201702;1194;4000;1084;3812;202;769;692;2394;894;3163
314350;201702;1133;3246;852;2767;242;847;132;382;374;1229
314360;201702;672;2147;440;1596;92;383;105;386;197;769
314370;201702;529;1705;488;1645;89;355;339;1100;428;1455
314380;201702;1240;3745;881;2997;242;891;128;459;370;1350
314390;201702;12312;35068;9067;29109;2209;7686;2067;6174;4276;13860
314400;201702;4342;12705;3636;11687;1137;3851;1234;4127;2371;7978
314410;201702;2579;7832;1999;6730;457;1714;644;2263;1101;3977
314420;201702;739;2046;575;1798;29;154;415;1245;444;1399
314430;201702;5955;17703;5097;16078;1318;4509;1698;5383;3016;9892
314435;201702;1339;4204;1185;3951;92;414;817;2697;909;3111
314437;201702;978;2601;807;2339;27;91;596;1740;623;1831
314440;201702;536;1633;445;1491;151;573;122;355;273;928
314450;201702;1484;4374;1261;4020;214;856;655;1910;869;2766
314460;201702;3657;12196;2942;10606;728;2849;520;1811;1248;4660
314465;201702;2225;6870;2055;6564;82;411;1630;5059;1712;5470
314467;201702;973;2743;835;2519;39;123;621;1897;660;2020
314470;201702;2074;6474;1796;5925;407;1528;682;2109;1089;3637
314480;201702;5591;18407;4089;14598;709;2792;559;1778;1268;4570
314490;201702;803;2405;624;2030;117;441;331;1009;448;1450
314500;201702;1777;5005;1307;4155;259;923;425;1309;684;2232
314505;201702;1800;5062;1643;4858;160;536;1136;3387;1296;3923
314510;201702;1888;5036;1263;4176;349;1258;344;1167;693;2425
314520;201702;2683;9420;2008;7827;420;1905;198;721;618;2626
314530;201702;5693;19725;5367;19129;886;3135;3349;12285;4235;15420
314535;201702;2703;7406;2250;6770;218;739;1596;4796;1814;5535
314537;201702;1091;3358;896;3007;110;447;554;1819;664;2266
314540;201702;352;1052;280;906;55;197;102;309;157;506
314545;201702;1400;4203;1250;3988;69;246;1007;3306;1076;3552
314550;201702;618;1653;456;1417;74;302;187;520;261;822
314560;201702;4162;14088;3505;12570;664;2696;1108;3724;1772;6420
314570;201702;301;879;233;747;36;141;115;349;151;490
314580;201702;497;1646;388;1407;100;408;36;127;136;535
314585;201702;838;2678;604;2165;147;622;170;566;317;1188
314587;201702;1948;5818;1649;5318;319;1002;849;2813;1168;3815
314590;201702;2825;9490;2151;7790;460;1887;435;1488;895;3375
314600;201702;1568;5034;1116;4076;255;1043;150;460;405;1503
314610;201702;6665;22296;5963;20678;1336;5259;2531;8216;3867;13475
314620;201702;1557;4583;1383;4336;103;360;1054;3268;1157;3628
314625;201702;1507;4889;1359;4637;178;830;921;2956;1099;3786
314630;201702;4670;13754;4060;12775;276;1139;2966;9208;3242;10347
314640;201702;563;1516;431;1291;113;369;134;352;247;721
314650;201702;1027;2814;738;2346;89;340;285;804;374;1144
314655;201702;1534;4536;1167;3839;267;900;465;1540;732;2440
314660;201702;300;804;209;624;20;53;101;298;121;351
314670;201702;1612;4250;1141;3418;141;457;654;1898;795;2355
314675;201702;1791;5274;1556;4864;133;507;1132;3491;1265;3998
314690;201702;2066;6682;1709;6016;536;2073;333;1127;869;3200
314700;201702;9020;29489;6369;23608;1740;7144;914;3391;2654;10535
314710;201702;8007;23884;5715;19019;1056;3980;839;2572;1895;6552
314720;201702;2280;7435;1821;6422;424;1654;470;1674;894;3328
314730;201702;2039;6124;1652;5487;430;1590;576;1789;1006;3379
314740;201702;2722;8484;2318;7700;331;1325;1206;3834;1537;5159
314750;201702;318;991;252;845;43;157;105;339;148;496
314760;201702;1675;5419;1260;4459;191;805;273;799;464;1604
314770;201702;1047;3248;632;2148;67;267;119;331;186;598
314780;201702;293;772;216;659;44;173;101;281;145;454
314790;201702;9454;28747;7406;24924;2940;10932;527;1495;3467;12427
314795;201702;1566;4536;1363;4211;87;364;1014;2996;1101;3360
314800;201702;11154;31538;7431;24016;1882;6604;719;2187;2601;8791
314810;201702;10144;29217;7827;25216;2368;8222;1645;5394;4013;13616
314820;201702;847;2383;628;1994;151;529;243;756;394;1285
314830;201702;1521;4995;1347;4686;328;1298;654;2269;982;3567
314840;201702;887;3129;735;2906;137;682;436;1634;573;2316
314850;201702;1908;5346;1511;4650;157;646;1069;3155;1226;3801
314860;201702;3201;10442;2816;9710;434;1777;1659;5573;2093;7350
314870;201702;5349;16425;4588;15372;421;1812;3339;11012;3760;12824
314875;201702;1727;5534;1633;5404;108;359;1407;4717;1515;5076
314880;201702;894;2312;735;2108;46;103;535;1634;581;1737
314890;201702;532;1639;396;1320;78;296;152;462;230;758
314900;201702;557;1618;460;1473;90;307;187;585;277;892
314910;201702;1576;5074;1279;4579;364;1476;461;1574;825;3050
314915;201702;2416;7621;2107;7077;172;736;1467;4810;1639;5546
314920;201702;521;1433;372;1211;27;102;198;618;225;720
314930;201702;4478;14892;3926;13710;1056;3978;1115;3686;2171;7664
314940;201702;392;1126;356;1066;43;142;224;633;267;775
314950;201702;329;946;236;811;49;192;77;257;126;449
314960;201702;735;2230;578;1900;124;456;206;627;330;1083
314970;201702;552;1881;465;1709;106;442;136;498;242;940
314980;201702;1340;4103;1110;3728;349;1300;77;233;426;1533
314990;201702;2420;7522;1849;6277;494;1934;362;1064;856;2998
314995;201702;1584;4781;1377;4462;136;562;908;2882;1044;3444
315000;201702;1059;2992;853;2652;82;298;545;1682;627;1980
315010;201702;412;1256;326;1081;67;278;118;343;185;621
315015;201702;2025;6199;1842;5987;210;701;1383;4718;1593;5419
315020;201702;808;2479;596;2027;86;307;246;802;332;1109
315030;201702;587;1781;458;1539;131;474;102;312;233;786
315040;201702;889;2667;827;2552;147;490;505;1526;652;2016
315050;201702;1257;3606;995;3203;142;524;508;1628;650;2152
315053;201702;1020;3046;898;2810;140;552;454;1424;594;1976
315057;201702;1610;5494;1456;5207;261;959;797;2879;1058;3838
315060;201702;688;2205;478;1750;105;421;67;237;172;658
315070;201702;729;2131;583;1879;164;560;226;676;390;1236
315080;201702;2784;9057;2404;8250;599;2217;1080;3646;1679;5863
315090;201702;757;2611;615;2281;149;616;158;547;307;1163
315100;201702;1156;3841;821;3029;200;837;216;737;416;1574
315110;201702;1234;3678;1029;3300;216;768;417;1328;633;2096
315120;201702;13640;31962;9460;26546;1312;3789;4590;13810;5902;17599
315130;201702;1260;4130;1140;3894;294;1165;381;1220;675;2385
315140;201702;2713;8399;2228;7415;467;1769;867;2644;1334;4413
315150;201702;4336;11588;3253;9827;535;1782;1329;3998;1864;5780
315160;201702;1236;3605;982;3121;215;725;381;1174;596;1899
315170;201702;1459;4577;1137;3916;261;961;222;790;483;1751
315180;201702;16852;46823;9505;31364;1666;6217;1588;4871;3254;11088
315190;201702;1932;5012;1616;4525;331;976;1011;2802;1342;3778
315200;201702;3572;11936;2988;10682;980;3831;573;2014;1553;5845
315210;201702;7718;22409;6153;19137;1077;3717;2306;6796;3383;10513
315213;201702;1094;3297;993;3143;46;162;798;2512;844;2674
315217;201702;2383;8097;1960;7304;210;993;1231;4480;1441;5473
315220;201702;9521;27197;8008;24606;2513;7933;2508;7975;5021;15908
315230;201702;2828;7521;2515;7159;130;198;2217;6679;2347;6877
315240;201702;2973;8990;2518;8282;697;2451;1156;3744;1853;6195
315250;201702;10126;30267;7937;26154;1805;6579;2605;8503;4410;15082
315260;201702;935;2896;621;2193;139;531;74;228;213;759
315270;201702;651;2090;494;1777;97;417;119;392;216;809
315280;201702;2835;7976;1766;5686;378;1303;264;805;642;2108
315290;201702;1216;3347;827;2699;262;936;185;626;447;1562
315300;201702;502;1305;339;1097;113;375;143;484;256;859
315310;201702;1247;3894;1013;3466;130;511;607;2003;737;2514
315320;201702;723;2151;578;1957;95;389;266;881;361;1270
315330;201702;734;2635;457;1883;104;463;76;294;180;757
315340;201702;3423;9601;2693;8478;520;1750;1079;3325;1599;5075
315350;201702;1815;4933;1387;4305;126;447;919;2901;1045;3348
315360;201702;1618;5354;1319;4686;261;1037;433;1452;694;2489
315370;201702;450;1403;396;1298;72;249;178;579;250;828
315380;201702;185;614;142;509;32;137;41;117;73;254
315390;201702;1190;3866;905;3222;207;822;196;651;403;1473
315400;201702;4196;12518;3400;11004;609;2124;1599;5100;2208;7224
315410;201702;2103;5322;1736;4835;242;733;1070;2970;1312;3703
315415;201702;1046;3308;908;3107;351;1272;279;983;630;2255
315420;201702;1114;3551;859;3030;212;792;127;401;339;1193
315430;201702;3539;9569;2687;8182;799;2695;630;1838;1429;4533
315440;201702;944;2815;820;2606;176;676;367;1041;543;1717
315445;201702;2024;5526;1571;4818;214;736;997;3058;1211;3794
315450;201702;2380;7329;2121;6917;334;1074;1299;4347;1633;5421
315460;201702;30252;98022;27203;91822;9811;35178;5397;17749;15208;52927
315470;201702;451;1354;375;1213;34;138;189;593;223;731
315480;201702;1654;5002;1151;3873;266;958;221;777;487;1735
315490;201702;3066;8083;2278;6998;417;1472;771;2248;1188;3720
315500;201702;468;1365;304;987;37;150;128;355;165;505
315510;201702;1341;3782;1145;3464;93;326;873;2587;966;2913
315520;201702;1047;3061;838;2733;102;389;526;1666;628;2055
315530;201702;617;2048;491;1721;165;637;150;476;315;1113
315540;201702;1023;3190;852;2870;174;718;310;1025;484;1743
315550;201702;1713;4825;1310;4191;297;1080;421;1340;718;2420
315560;201702;6322;20788;5719;19933;601;2468;3848;13443;4449;15911
315570;201702;1822;5812;1669;5496;236;901;861;2723;1097;3624
315580;201702;2142;6205;1746;5491;475;1688;511;1542;986;3230
315590;201702;800;2370;702;2214;108;394;364;1123;472;1517
315600;201702;2352;8308;1894;7381;284;1197;1056;4238;1340;5435
315610;201702;961;2693;781;2338;140;541;323;819;463;1360
315620;201702;303;1072;286;1038;69;241;163;633;232;874
315630;201702;821;2574;657;2242;162;550;129;438;291;988
315640;201702;435;1263;367;1153;61;242;154;439;215;681
315645;201702;786;2314;634;2016;235;784;177;544;412;1328
315650;201702;1776;4860;1403;4331;91;390;1008;3057;1099;3447
315660;201702;2548;6524;2060;5729;176;489;1421;3919;1597;4408
315670;201702;10506;33854;9353;31607;2360;8631;3704;12209;6064;20840
315680;201702;2950;9685;2293;8361;668;2603;695;2528;1363;5131
315690;201702;3224;8993;2211;7174;543;1940;435;1513;978;3453
315700;201702;7180;21835;5998;19513;1057;3785;2752;8672;3809;12457
315710;201702;1810;5072;1395;4416;118;523;886;2705;1004;3228
315720;201702;3730;11675;3321;10929;291;1261;2011;6328;2302;7589
315725;201702;1504;4626;1338;4388;199;673;979;3266;1178;3939
315727;201702;576;1728;456;1493;97;369;170;508;267;877
315730;201702;724;2276;669;2147;94;352;354;1082;448;1434
315733;201702;1022;2990;897;2761;246;853;333;971;579;1824
315737;201702;1188;3612;950;3184;67;289;615;2057;682;2346
315740;201702;978;2951;817;2629;129;519;428;1260;557;1779
315750;201702;1119;3378;1010;3188;74;283;736;2318;810;2601
315760;201702;1057;2729;1016;2679;13;38;955;2508;968;2546
315765;201702;1562;4619;1384;4394;46;181;1195;3837;1241;4018
315770;201702;1357;4298;1174;3987;317;1169;308;1060;625;2229
315780;201702;21382;68820;19317;64369;4116;14946;7647;24788;11763;39734
315790;201702;3588;11766;3148;10906;304;1039;2106;7525;2410;8564
315800;201702;1246;4848;987;4082;231;1032;178;697;409;1729
315810;201702;1301;3480;1112;3194;170;530;712;1962;882;2492
315820;201702;2284;7682;1991;7151;554;2008;905;3386;1459;5394
315830;201702;1120;3613;932;3245;114;499;314;990;428;1489
315840;201702;809;2091;523;1564;85;277;153;441;238;718
315850;201702;929;3261;899;3204;211;839;527;1789;738;2628
315860;201702;498;1654;364;1368;87;390;79;257;166;647
315870;201702;440;1266;363;1143;35;121;226;679;261;800
315880;201702;1176;3010;931;2696;177;610;377;1066;554;1676
315890;201702;1463;4956;1305;4653;471;1782;490;1714;961;3496
315895;201702;5269;16301;4483;14592;847;3009;1668;5149;2515;8158
315900;201702;758;2176;722;2118;52;229;591;1629;643;1858
315910;201702;479;1597;445;1542;81;303;302;1027;383;1330
315920;201702;1598;4335;899;2895;185;662;172;479;357;1141
315930;201702;1039;2767;758;2278;197;635;202;592;399;1227
315935;201702;886;2933;786;2732;214;837;210;715;424;1552
315940;201702;606;1921;523;1758;99;376;246;820;345;1196
315950;201702;1164;3493;1028;3242;203;629;633;2031;836;2660
315960;201702;3653;11341;2462;8988;854;3638;104;241;958;3879
315970;201702;672;1910;521;1694;46;139;360;1215;406;1354
315980;201702;3706;9103;2391;6967;640;2088;583;1501;1223;3589
315990;201702;3885;10894;3158;9653;480;1682;1570;4724;2050;6406
316000;201702;566;1646;465;1504;113;448;172;532;285;980
316010;201702;632;2010;509;1777;62;269;250;797;312;1066
316020;201702;938;3040;851;2889;94;426;584;1873;678;2299
316030;201702;3100;8999;2280;7510;171;674;1388;4638;1559;5312
316040;201702;2965;9369;2267;7939;401;1602;452;1404;853;3006
316045;201702;1956;6030;1812;5792;203;656;1306;4209;1509;4865
316050;201702;357;1122;281;988;46;199;146;483;192;682
316060;201702;692;2043;548;1811;67;316;326;992;393;1308
316070;201702;6071;18576;5203;16713;1095;3957;2165;6636;3260;10593
316080;201702;713;2549;626;2337;150;620;72;273;222;893
316090;201702;514;1585;375;1290;57;226;125;412;182;638
316095;201702;1432;4495;1221;4124;140;488;761;2576;901;3064
316100;201702;2575;8380;1944;6909;469;1823;452;1505;921;3328
316105;201702;932;2628;704;2243;165;559;273;887;438;1446
316110;201702;11853;39483;10612;37385;1461;5441;6817;24602;8278;30043
316120;201702;1108;3508;859;2916;208;748;210;615;418;1363
316130;201702;1482;3373;891;2506;137;441;350;915;487;1356
316140;201702;936;2677;744;2401;97;322;466;1536;563;1858
316150;201702;1485;3982;1301;3652;180;593;776;2108;956;2701
316160;201702;1164;3386;914;2926;153;538;443;1351;596;1889
316165;201702;924;2436;752;2203;121;418;423;1239;544;1657
316170;201702;1269;3530;934;2976;147;506;398;1181;545;1687
316180;201702;1434;4408;1005;3479;243;937;159;484;402;1421
316190;201702;2844;8671;1533;5326;288;985;290;913;578;1898
316200;201702;3694;11651;2838;9954;617;2512;695;2311;1312;4823
316210;201702;4482;14330;3743;12851;1288;4679;565;1994;1853;6673
316220;201702;781;2394;549;1924;116;464;50;183;166;647
316225;201702;1177;3227;984;2918;137;479;614;1744;751;2223
316230;201702;423;1198;347;1069;37;122;170;564;207;686
316240;201702;6402;19451;5687;18495;631;2122;4169;13684;4800;15806
316245;201702;3203;10994;2939;10576;257;1310;2198;7676;2455;8986
316250;201702;10158;28994;7812;24443;2077;7140;1730;5135;3807;12275
316255;201702;2519;7474;2200;7071;266;968;1537;5001;1803;5969
316257;201702;1259;3398;944;2839;139;483;367;1049;506;1532
316260;201702;1792;4913;1414;4361;82;306;782;2538;864;2844
316265;201702;1348;3737;991;3053;88;307;611;1852;699;2159
316270;201702;3533;11854;3255;11228;798;2988;1317;4400;2115;7388
316280;201702;3088;9897;2816;9354;461;1717;1497;4837;1958;6554
316290;201702;3289;10068;2728;8970;515;1959;1019;3310;1534;5269
316292;201702;3562;10871;3120;10161;439;1639;2035;6443;2474;8082
316294;201702;804;2525;600;2119;123;516;60;215;183;731
316295;201702;1807;5845;1691;5629;168;704;1208;3907;1376;4611
316300;201702;992;3102;847;2856;65;237;525;1815;590;2052
316310;201702;697;1998;470;1587;86;328;143;467;229;795
316320;201702;591;1857;486;1661;101;409;112;357;213;766
316330;201702;973;2915;763;2451;77;285;492;1528;569;1813
316340;201702;909;2861;735;2507;127;525;381;1232;508;1757
316350;201702;1256;3989;1138;3786;152;566;707;2346;859;2912
316360;201702;722;1923;583;1720;53;168;408;1198;461;1366
316370;201702;4415;13835;3709;12446;1104;4141;611;1922;1715;6063
316380;201702;1605;4141;1274;3690;65;230;935;2701;1000;2931
316390;201702;868;2455;724;2227;146;494;335;1043;481;1537
316400;201702;1257;3825;950;3263;202;761;357;1169;559;1930
316410;201702;994;3254;919;3140;133;470;661;2250;794;2720
316420;201702;1927;6043;1691;5731;168;676;1186;3950;1354;4626
316430;201702;927;2816;647;2213;153;573;143;453;296;1026
316440;201702;664;2168;550;2000;190;790;99;381;289;1171
316443;201702;629;1845;505;1614;116;429;189;570;305;999
316447;201702;1556;4535;1404;4338;101;367;1174;3624;1275;3991
316450;201702;2129;7044;1795;6381;185;756;1241;4385;1426;5141
316460;201702;755;2315;687;2193;207;677;304;964;511;1641
316470;201702;7127;22414;5730;19597;1458;5739;1498;4891;2956;10630
316480;201702;178;591;151;529;38;141;37;123;75;264
316490;201702;315;950;254;819;53;167;88;258;141;425
316500;201702;1177;4061;801;2994;164;671;52;174;216;845
316510;201702;720;2632;645;2496;229;958;164;626;393;1584
316520;201702;1009;2990;835;2703;145;545;329;966;474;1511
316530;201702;841;2680;704;2429;148;639;280;826;428;1465
316540;201702;731;2327;650;2180;91;384;206;635;297;1019
316550;201702;1189;3905;1116;3780;178;668;699;2369;877;3037
316553;201702;2050;6988;1572;5787;463;1844;302;1069;765;2913
316555;201702;2821;9504;2497;9086;209;864;1870;6964;2079;7828
316556;201702;632;1582;482;1339;43;137;311;831;354;968
316557;201702;779;2780;724;2684;299;1178;197;682;496;1860
316560;201702;279;1008;239;924;66;298;59;212;125;510
316570;201702;1169;3738;1040;3483;150;525;479;1630;629;2155
316580;201702;301;809;204;618;56;179;46;140;102;319
316590;201702;1431;3862;1020;3166;178;640;529;1507;707;2147
316600;201702;1030;3342;928;3147;208;779;420;1411;628;2190
316610;201702;564;2036;494;1891;80;409;296;1075;376;1484
316620;201702;2158;6422;1843;5905;170;663;1198;3814;1368;4477
316630;201702;1416;4619;1215;4196;447;1541;383;1419;830;2960
316640;201702;162;508;141;468;32;134;59;165;91;299
316650;201702;903;3185;780;3000;91;378;541;2123;632;2501
316660;201702;190;489;92;284;8;32;14;37;22;69
316670;201702;1930;5295;1555;4643;537;1756;472;1343;1009;3099
316680;201702;1905;5135;1505;4557;125;416;1083;3254;1208;3670
316690;201702;1136;3828;1006;3540;283;1130;289;1010;572;2140
316695;201702;1059;3282;931;3035;95;378;599;1922;694;2300
316700;201702;367;1063;329;1008;33;141;220;626;253;767
316710;201702;2686;9915;2297;9069;871;3604;570;2459;1441;6063
316720;201702;15875;50515;13145;44629;3264;11772;3746;12488;7010;24260
316730;201702;333;1031;299;956;77;279;120;351;197;630
316740;201702;676;2190;620;2096;72;321;425;1431;497;1752
316750;201702;396;1310;326;1162;58;238;107;360;165;598
316760;201702;3448;11276;2951;10566;1367;5144;1003;3679;2370;8823
316770;201702;1383;3717;1198;3458;60;239;1002;2870;1062;3109
316780;201702;575;1909;492;1736;152;593;61;185;213;778
316790;201702;744;2169;601;1919;171;585;180;580;351;1165
316800;201702;5139;16451;4413;15015;811;3028;2270;7379;3081;10407
316805;201702;792;1995;764;1956;29;46;673;1818;702;1864
316810;201702;593;1780;479;1550;130;479;191;556;321;1035
316820;201702;392;1011;223;720;36;143;32;96;68;239
316830;201702;550;1870;519;1804;132;520;256;858;388;1378
316840;201702;2681;8143;2365;7570;508;1861;1074;3306;1582;5167
316850;201702;2026;5755;1649;5140;240;877;938;2848;1178;3725
316860;201702;17449;54304;14896;49652;3346;12720;5819;18812;9165;31532
316870;201702;6066;19292;4894;16697;1421;5218;927;3081;2348;8299
316880;201702;854;2551;739;2360;203;730;229;730;432;1460
316890;201702;1257;2953;896;2460;207;684;501;1259;708;1943
316900;201702;2463;7188;1941;6131;457;1647;561;1566;1018;3213
316905;201702;449;1461;381;1309;119;433;136;468;255;901
316910;201702;846;2600;619;2158;163;636;89;284;252;920
316920;201702;1554;4176;1108;3537;249;893;433;1353;682;2246
316930;201702;7704;25803;6119;22445;1444;5782;945;3340;2389;9122
316935;201702;4320;13089;3175;10637;834;3018;717;2391;1551;5409
316940;201702;6603;21134;5284;18259;1209;4488;1217;3963;2426;8451
316950;201702;1555;4158;1278;3772;84;291;962;2797;1046;3088
316960;201702;4626;11686;3673;10355;617;1897;2087;5841;2704;7738
316970;201702;3136;9867;2951;9529;635;2397;1263;3765;1898;6162
316980;201702;915;2755;649;2253;203;772;97;338;300;1110
316990;201702;9612;29816;7876;26017;2351;8376;701;2249;3052;10625
317000;201702;2742;9208;2644;9098;219;676;2074;7902;2293;8578
317005;201702;2569;7842;2239;7298;436;1501;1203;3934;1639;5435
317010;201702;26725;65832;16371;49952;4033;13857;3146;10327;7179;24184
317020;201702;64139;172004;38365;120898;7602;26361;7174;21115;14776;47476
317030;201702;662;1965;559;1805;50;201;347;1116;397;1317
317040;201702;9964;28341;7819;24561;1936;6489;2956;9422;4892;15911
317043;201702;707;1852;590;1689;113;331;307;864;420;1195
317047;201702;1108;2918;830;2463;70;223;485;1443;555;1666
317050;201702;1438;4791;1095;3983;220;869;339;1119;559;1988
317052;201702;2193;7129;2029;6857;184;764;1461;4831;1645;5595
317057;201702;1587;4380;1204;3705;94;382;763;2252;857;2634
317060;201702;417;1164;256;825;58;219;59;165;117;384
317065;201702;1261;3794;1114;3549;68;279;838;2619;906;2898
317070;201702;8940;27465;6226;21489;1400;5419;765;2584;2165;8003
317075;201702;1033;3090;811;2624;186;640;191;594;377;1234
317080;201702;6128;16282;5097;14550;1583;4731;1516;4199;3099;8930
317090;201702;4688;15251;4366;14772;458;1617;3121;10674;3579;12291
317100;201702;2903;7755;2097;6410;679;2236;622;1858;1301;4094
317103;201702;1772;6139;1566;5737;218;1013;853;2985;1071;3998
317107;201702;1311;3969;1160;3676;124;509;746;2188;870;2697
317110;201702;709;1731;404;1238;61;229;149;490;210;719
317115;201702;1118;3430;953;3093;75;249;677;2217;752;2466
317120;201702;10102;33336;8318;29160;1785;6925;3411;11608;5196;18533
317130;201702;7121;20783;5792;18373;1293;4535;2140;6713;3433;11248
317140;201702;542;1714;490;1627;71;254;306;1011;377;1265
317150;201702;988;2701;855;2540;64;219;675;1986;739;2205
317160;201702;3403;8872;2537;7683;150;511;1788;5379;1938;5890
317170;201702;1939;5140;1459;4330;217;737;512;1332;729;2069
317180;201702;1753;5846;1431;5153;380;1463;369;1306;749;2769
317190;201702;1358;3781;1054;3335;71;251;695;2193;766;2444
317200;201702;4365;13436;3702;12094;956;3478;1052;3290;2008;6768
317210;201702;920;2747;802;2587;111;460;529;1655;640;2115
317220;201702;280;949;265;925;66;260;128;436;194;696
320010;201702;4776;14852;4069;13464;654;2323;2217;7220;2871;9543
320013;201702;1879;5663;1331;4476;237;815;532;1858;769;2673
320016;201702;2990;8285;2545;7645;217;619;1925;5829;2142;6448
320020;201702;3728;11444;3067;10151;867;3041;933;3164;1800;6205
320030;201702;1669;5249;1265;4377;378;1381;370;1232;748;2613
320035;201702;1758;5191;1521;4809;524;1822;570;1708;1094;3530
320040;201702;3075;9813;2578;8841;591;2162;931;3174;1522;5336
320050;201702;1585;4246;1391;3902;338;1011;616;1673;954;2684
320060;201702;10963;34434;8334;28530;2070;7724;1679;5531;3749;13255
320070;201702;1360;4270;1117;3746;244;906;303;972;547;1878
320080;201702;5437;15493;4170;12986;948;3079;1275;4072;2223;7151
320090;201702;7650;22134;6091;19001;1574;5207;2140;6513;3714;11720
320100;201702;2516;7897;2052;6951;622;2162;624;2143;1246;4305
320110;201702;1184;3518;1020;3209;266;849;274;897;540;1746
320115;201702;1777;6253;1618;5973;810;3096;424;1639;1234;4735
320120;201702;15271;45318;11835;38858;2923;10566;3210;10546;6133;21112
320130;201702;35391;111984;31933;105283;6351;23687;15244;48668;21595;72355
320140;201702;3294;10320;2391;8342;654;2539;417;1448;1071;3987
320150;201702;13949;39631;10722;33239;3160;10519;1207;3534;4367;14053
320160;201702;4900;15141;4138;13603;1047;3808;1484;4647;2531;8455
320170;201702;1610;5133;1332;4514;308;1113;537;1798;845;2911
320180;201702;735;2486;636;2308;237;896;155;581;392;1477
320190;201702;3462;11819;2743;10060;727;2780;472;1717;1199;4497
320200;201702;953;2930;784;2638;241;892;223;781;464;1673
320210;201702;4503;12669;3768;11231;749;2484;1737;4866;2486;7350
320220;201702;2109;6515;1767;5904;492;1812;690;2349;1182;4161
320225;201702;1270;4265;997;3614;345;1322;149;552;494;1874
320230;201702;4072;12924;3431;11795;983;3623;1334;4685;2317;8308
320240;201702;12394;35957;10027;31811;2553;8768;3039;9775;5592;18543
320245;201702;3014;10235;2784;9696;945;3476;657;2243;1602;5719
320250;201702;1851;5596;1321;4375;360;1352;221;663;581;2015
320255;201702;1658;5624;1456;5270;557;2098;556;2118;1113;4216
320260;201702;1024;3082;789;2581;218;793;207;581;425;1374
320265;201702;2431;7736;2072;7102;716;2559;800;2777;1516;5336
320270;201702;2673;7760;1979;6443;412;1431;876;2939;1288;4370
320280;201702;6231;19092;5388;17420;1404;4947;1406;4272;2810;9219
320290;201702;1395;4492;1007;3546;313;1171;146;519;459;1690
320300;201702;4073;13529;3564;12385;1198;4424;725;2497;1923;6921
320305;201702;4376;13933;3742;12520;928;3339;1447;4761;2375;8100
320310;201702;1835;5501;1532;4852;374;1217;573;1821;947;3038
320313;201702;2105;5952;1435;4488;330;1192;272;780;602;1972
320316;201702;1647;4920;1313;4235;403;1345;393;1261;796;2606
320320;201702;19388;57656;15141;49917;4087;14716;4822;15767;8909;30483
320330;201702;2889;8487;2370;7586;633;2016;977;3322;1610;5338
320332;201702;5167;16458;4485;15187;1404;5040;1676;5640;3080;10680
320334;201702;1990;6178;1370;4840;344;1353;291;991;635;2344
320335;201702;2208;6463;1378;4522;362;1306;160;466;522;1772
320340;201702;5444;14718;4686;13454;1037;3220;2082;6141;3119;9361
320350;201702;4954;13109;3743;10911;676;2066;1683;4853;2359;6919
320360;201702;1628;4341;1215;3549;203;625;493;1393;696;2018
320370;201702;2775;9156;2242;7910;635;2319;669;2341;1304;4660
320380;201702;2115;6248;1880;5832;378;1280;992;3000;1370;4280
320390;201702;6902;20626;5649;17965;1618;5528;1648;5063;3266;10591
320400;201702;3400;10417;2972;9640;651;2310;1342;4292;1993;6602
320405;201702;4186;12115;3640;11146;731;2411;1977;5962;2708;8373
320410;201702;5227;14269;3921;12352;894;3050;1735;5632;2629;8682
320420;201702;2353;7012;1888;6177;551;2002;471;1536;1022;3538
320425;201702;1966;5105;1561;4438;166;506;954;2677;1120;3183
320430;201702;2510;6963;2139;6210;402;1246;1150;3209;1552;4455
320435;201702;2680;8547;2196;7597;959;3449;548;2013;1507;5462
320440;201702;1015;3300;898;3008;206;762;316;1018;522;1780
320450;201702;1892;5886;1549;5209;409;1504;627;2041;1036;3545
320455;201702;4069;13176;3037;10753;831;3140;684;2338;1515;5478
320460;201702;2598;8218;1917;6666;477;1811;408;1316;885;3127
320465;201702;1551;4726;1187;3940;175;634;569;1890;744;2524
320470;201702;4114;12190;2915;9604;834;3003;560;1812;1394;4815
320480;201702;1666;5218;1445;4762;323;1171;593;1911;916;3082
320490;201702;15231;46090;12874;41913;3515;12571;4046;13168;7561;25739
320495;201702;1314;3760;855;2822;269;947;107;365;376;1312
320500;201702;46934;139236;40860;128528;8878;30223;19691;60697;28569;90920
320501;201702;4641;13971;3644;12315;1140;4337;943;3065;2083;7402
320503;201702;1864;6254;1501;5470;546;2237;418;1373;964;3610
320506;201702;4049;12364;2868;9627;817;2922;98;260;915;3182
320510;201702;8200;25235;7138;23267;1461;5253;3528;11326;4989;16579
320515;201702;1831;5294;1498;4578;456;1443;322;991;778;2434
320517;201702;2076;6632;1676;5845;524;1963;416;1438;940;3401
320520;201702;35548;105862;29311;94744;7217;25857;10172;32398;17389;58255
320530;201702;27208;81197;22684;72799;4200;15749;11143;33675;15343;49424
330010;201702;19669;59504;17706;55854;3958;13367;9128;28582;13086;41949
330015;201702;1476;4118;1274;3755;196;690;609;1753;805;2443
330020;201702;17227;50013;15711;47517;2830;9472;9369;27671;12199;37143
330022;201702;1850;5416;1553;4917;296;1044;855;2661;1151;3705
330023;201702;3082;9446;2675;8801;769;2737;797;2530;1566;5267
330025;201702;4495;12101;3447;10241;867;2752;1581;4721;2448;7473
330030;201702;8045;26422;7099;24573;1422;5460;3396;11268;4818;16728
330040;201702;11338;33892;10331;31943;2060;6900;5675;17033;7735;23933
330045;201702;73171;198572;63377;184825;7974;25281;42548;122454;50522;147735
330050;201702;2352;7079;1957;6355;550;1922;687;2101;1237;4023
330060;201702;5551;15776;4733;14535;1017;3553;2394;7127;3411;10680
330070;201702;19317;58223;17377;55042;3746;12880;8500;26969;12246;39849
330080;201702;7689;21603;7093;20676;682;2073;4958;14441;5640;16514
330090;201702;2560;6797;2280;6377;349;1101;1288;3492;1637;4593
330093;201702;1901;5664;1592;5121;294;977;740;2516;1034;3493
330095;201702;978;3304;842;2991;188;750;308;1044;496;1794
330100;201702;58009;178754;52784;170451;7847;29058;31216;99749;39063;128807
330110;201702;2197;6866;1937;6420;493;1768;657;2148;1150;3916
330115;201702;1718;4935;1488;4584;263;910;824;2457;1087;3367
330120;201702;2642;7167;2322;6687;374;1260;1446;4056;1820;5316
330130;201702;3250;10488;2906;9884;693;2566;1397;4659;2090;7225
330140;201702;3017;9262;2755;8866;552;2043;1519;4797;2071;6840
330150;201702;2010;5972;1615;5194;409;1414;421;1361;830;2775
330160;201702;1127;3510;988;3274;262;991;456;1431;718;2422
330170;201702;97804;291832;89140;277894;17449;57831;48869;151229;66318;209060
330180;201702;2005;5803;1682;5218;128;524;1080;3192;1208;3716
330185;201702;8109;24773;7036;22717;1373;4848;3796;11972;5169;16820
330187;201702;3733;10612;3197;9732;493;1651;1998;5998;2491;7649
330190;201702;24947;70209;23314;67749;3610;10998;16391;47510;20001;58508
330200;201702;13667;42542;12184;40068;3054;10388;6055;20236;9109;30624
330205;201702;2008;5525;1747;5079;209;694;1097;3095;1306;3789
330210;201702;3014;8390;2502;7405;630;1921;787;2322;1417;4243
330220;201702;9927;29938;8499;26945;2174;7458;2068;6092;4242;13550
330225;201702;3631;11221;3147;10318;402;1677;1799;5616;2201;7293
330227;201702;16385;47116;14760;44756;3106;9668;8598;26633;11704;36301
330230;201702;1208;3596;1096;3425;172;646;639;1911;811;2557
330240;201702;17202;52121;14681;47479;4581;15947;4492;14122;9073;30069
330245;201702;1206;3615;917;3102;242;890;169;530;411;1420
330250;201702;34262;100180;31116;95011;9067;28006;12319;39160;21386;67166
330260;201702;4048;12536;3506;11436;667;2362;1481;4642;2148;7004
330270;201702;19298;43646;12956;35186;3009;9161;4650;12732;7659;21893
330280;201702;2184;6440;1838;5773;300;1093;905;2671;1205;3764
330285;201702;17808;50585;16018;47909;2751;9021;9790;28839;12541;37860
330290;201702;3159;9151;2800;8591;468;1623;1558;4600;2026;6223
330300;201702;3171;10240;2847;9608;498;1931;1624;5236;2122;7167
330310;201702;2125;5993;1806;5446;231;734;1114;3345;1345;4079
330320;201702;12782;38295;11956;37012;1529;5265;8776;26823;10305;32088
330330;201702;27203;74175;23721;68794;4123;13431;14186;39770;18309;53201
330340;201702;13895;39960;10909;34584;2683;9145;3517;10954;6200;20099
330350;201702;85412;246744;76762;234362;10673;34895;51759;157711;62432;192606
330360;201702;5881;17148;5567;16686;515;1711;4271;12623;4786;14334
330370;201702;3438;12099;3095;11381;1053;4022;953;3502;2006;7524
330380;201702;4937;15865;4169;14299;1025;3890;1395;4614;2420;8504
330385;201702;3783;13021;3458;12368;1033;3897;1349;4910;2382;8807
330390;201702;21763;70553;19070;65135;4816;17761;7758;26031;12574;43792
330395;201702;2993;8706;2745;8296;257;939;1813;5419;2070;6358
330400;201702;2572;7955;2329;7516;287;1171;1480;4404;1767;5575
330410;201702;2782;8386;2210;7312;432;1598;1022;3223;1454;4821
330411;201702;2235;6918;1950;6331;246;924;1155;3579;1401;4503
330412;201702;1353;4521;1140;4085;216;863;526;1772;742;2635
330414;201702;23311;65239;20336;61051;3942;11800;11807;35936;15749;47736
330415;201702;3188;9849;2750;9065;702;2353;1028;3443;1730;5796
330420;201702;9501;26711;6491;21326;1398;4992;1381;4425;2779;9417
330430;201702;6998;20651;6191;19145;1350;4545;2754;8266;4104;12811
330440;201702;1521;5060;1361;4749;428;1672;363;1141;791;2813
330450;201702;1303;4292;1169;4060;255;1063;603;2027;858;3090
330452;201702;13369;38968;10759;33997;2666;9162;4267;13092;6933;22254
330455;201702;487222;1324884;396298;1178061;80697;256800;202760;596028;283457;852828
330460;201702;1140;3668;991;3395;211;802;433;1454;644;2256
330470;201702;4237;12589;3768;11765;842;2853;1781;5443;2623;8296
330475;201702;7573;23259;6691;21786;2002;7118;2505;7908;4507;15026
330480;201702;5501;15983;4960;15198;832;2748;2902;8686;3734;11434
330490;201702;107357;279635;95344;261994;10310;30193;66071;179994;76381;210187
330500;201702;5078;15493;4873;15143;688;2370;3405;10458;4093;12828
330510;201702;36160;109815;32215;103516;10131;32922;13519;44568;23650;77490
330513;201702;1312;3954;1212;3778;375;1195;527;1676;902;2871
330515;201702;2930;8989;2552;8243;842;2782;701;2259;1543;5041
330520;201702;10750;32485;9601;30410;1987;6756;4340;13472;6327;20228
330530;201702;1398;4095;1221;3751;304;1025;530;1551;834;2576
330540;201702;2851;8352;2334;7395;621;2087;810;2482;1431;4569
330550;201702;7603;25352;6721;23641;2893;10561;1091;3984;3984;14545
330555;201702;9603;28374;8594;26890;1565;5067;5243;16708;6808;21775
330560;201702;4180;12502;3739;11666;610;2094;1993;5992;2603;8086
330570;201702;3069;9049;2599;8235;639;2128;1231;3891;1870;6019
330575;201702;5087;14361;4548;13403;630;2149;3023;8546;3653;10695
330580;201702;12945;40467;10890;36293;2978;10497;4150;13773;7128;24270
330590;201702;1492;4566;1401;4418;217;731;961;3047;1178;3778
330600;201702;10751;31307;8778;27961;1485;5348;4202;13178;5687;18526
330610;201702;8463;26373;7646;24906;1245;4640;4327;13712;5572;18352
330615;201702;1562;5491;1458;5315;597;2278;484;1824;1081;4102
330620;201702;3390;11717;3025;10944;1050;4056;657;2369;1707;6425
330630;201702;22609;64982;18475;57695;2774;10080;10387;31166;13161;41246
350010;201702;1706;4978;1141;3854;295;1042;128;397;423;1439
350020;201702;433;1174;300;917;43;142;157;454;200;596
350030;201702;4410;13676;3391;11612;1013;3727;831;2839;1844;6566
350040;201702;434;1457;319;1194;70;276;90;328;160;604
350050;201702;840;2554;682;2254;159;611;220;616;379;1227
350055;201702;632;1853;535;1692;86;301;326;1018;412;1319
350060;201702;113;351;92;318;23;89;45;157;68;246
350070;201702;3777;11055;2429;8266;475;1736;524;1623;999;3359
350075;201702;532;1760;417;1517;164;600;75;269;239;869
350080;201702;632;1819;401;1287;64;230;150;461;214;691
350090;201702;601;1597;387;1165;94;257;131;401;225;658
350100;201702;1875;5785;1338;4698;262;1065;421;1393;683;2458
350110;201702;449;1359;333;1107;33;128;184;593;217;721
350115;201702;1212;3608;1068;3332;202;700;533;1510;735;2210
350120;201702;635;1661;332;1024;70;230;61;182;131;412
350130;201702;3232;9538;2819;8706;370;1299;1576;4632;1946;5931
350140;201702;568;1853;473;1672;64;275;253;878;317;1153
350150;201702;431;1411;378;1298;141;519;75;263;216;782
350160;201702;8184;23378;5575;18305;1110;4103;2314;7041;3424;11144
350170;201702;1465;4939;1225;4344;318;1193;274;934;592;2127
350180;201702;1042;2881;661;2027;103;354;309;910;412;1264
350190;201702;3069;9403;2451;8136;512;1975;1020;2921;1532;4896
350200;201702;370;1143;332;1072;27;94;227;725;254;819
350210;201702;4732;12460;3384;10173;851;2670;1406;4212;2257;6882
350220;201702;2362;7473;2051;6768;425;1691;928;2821;1353;4512
350230;201702;716;2266;639;2112;141;495;279;917;420;1412
350240;201702;515;1572;411;1329;46;178;227;700;273;878
350250;201702;1948;7022;1803;6741;645;2594;556;2080;1201;4674
350260;201702;969;2536;640;1922;111;344;266;769;377;1113
350270;201702;4866;14678;4067;12951;745;2610;1788;5404;2533;8014
350275;201702;1849;6003;1672;5716;485;1733;634;2153;1119;3886
350280;201702;21344;51570;13422;38328;2761;8421;3448;9735;6209;18156
350290;201702;2181;6858;1710;5865;357;1352;555;1824;912;3176
350300;201702;528;1499;396;1220;90;281;194;581;284;862
350310;201702;860;2845;746;2573;108;419;296;982;404;1401
350315;201702;482;1524;358;1237;63;267;83;256;146;523
350320;201702;10165;31650;9091;29652;2651;9159;1498;5154;4149;14313
350330;201702;14103;38851;9670;28959;1993;5779;3339;9587;5332;15366
350335;201702;367;1143;325;1061;24;73;236;780;260;853
350340;201702;1038;3051;732;2451;148;565;222;740;370;1305
350350;201702;690;2123;586;1976;116;438;202;666;318;1104
350360;201702;839;2817;714;2538;166;577;295;1076;461;1653
350370;201702;530;1563;394;1264;88;296;81;252;169;548
350380;201702;4093;11869;2888;9671;739;2709;752;2359;1491;5068
350390;201702;9164;27768;7942;25461;2257;7456;2913;9208;5170;16664
350395;201702;360;990;187;640;28;101;47;140;75;241
350400;201702;7791;22130;6181;19192;1502;5138;2180;6447;3682;11585
350410;201702;8137;26648;6424;23123;1762;6963;1266;4331;3028;11294
350420;201702;531;1650;400;1417;90;378;43;139;133;517
350430;201702;666;2070;569;1898;95;382;322;1038;417;1420
350440;201702;1238;3855;1049;3417;234;768;466;1507;700;2275
350450;201702;7275;22431;5912;19650;1397;5002;1526;4848;2923;9850
350460;201702;1356;3652;831;2607;153;547;289;835;442;1382
350470;201702;233;618;196;555;27;101;124;328;151;429
350480;201702;749;2213;535;1788;91;349;102;319;193;668
350490;201702;1808;5410;1517;4900;352;1242;509;1516;861;2758
350500;201702;543;1626;475;1503;75;287;254;769;329;1056
350510;201702;1049;3151;786;2584;113;434;337;1052;450;1486
350520;201702;1495;5458;1204;4721;261;1115;306;1168;567;2283
350530;201702;2248;6528;1834;5697;523;1696;504;1518;1027;3214
350535;201702;1220;3926;1135;3779;168;691;730;2319;898;3010
350540;201702;1715;4796;1306;4083;316;1036;478;1534;794;2570
350550;201702;10199;26867;7080;21780;1279;4499;2594;7530;3873;12029
350560;201702;3259;10620;2851;9649;377;1351;1554;5212;1931;6563
350570;201702;17471;56240;15502;52314;4463;16310;5879;18980;10342;35290
350580;201702;1643;5212;1094;3820;210;775;115;337;325;1112
350590;201702;3731;11468;2929;9875;738;2820;1124;3467;1862;6287
350600;201702;41797;102433;27586;77519;4450;13743;11672;30543;16122;44286
350610;201702;6576;19514;5289;17107;1112;3917;2170;6853;3282;10770
350620;201702;402;1133;295;966;48;193;127;379;175;572
350630;201702;1593;4527;1178;3737;179;682;494;1432;673;2114
350635;201702;6582;19023;5181;16609;1159;4115;2140;6692;3299;10807
350640;201702;784;2411;544;1820;95;346;121;373;216;719
350650;201702;7684;22893;4895;16333;1053;3883;1002;3118;2055;7001
350660;201702;4780;13729;3899;12176;714;2437;1905;5893;2619;8330
350670;201702;1467;4577;1352;4354;312;1051;671;2122;983;3173
350680;201702;999;2956;751;2489;175;645;304;993;479;1638
350690;201702;815;2660;643;2282;147;583;218;713;365;1296
350700;201702;4158;12081;2904;9919;626;2417;988;3091;1614;5508
350710;201702;2667;8220;2308;7523;359;1303;1297;4132;1656;5435
350715;201702;751;2266;672;2108;115;397;359;1060;474;1457
350720;201702;128;364;115;343;26;84;41;119;67;203
350730;201702;399;1434;372;1370;86;351;160;582;246;933
350740;201702;1720;5213;1211;4044;226;824;319;955;545;1779
350745;201702;514;1586;316;1074;45;172;150;462;195;634
350750;201702;8870;27009;7381;24072;1699;6174;1957;5912;3656;12086
350760;201702;12866;37156;10256;32539;2713;9416;2603;7474;5316;16890
350770;201702;638;1802;445;1425;46;156;246;772;292;928
350775;201702;593;1557;487;1384;48;169;243;667;291;836
350780;201702;1802;5468;1404;4694;405;1493;276;965;681;2458
350790;201702;1813;5594;1333;4625;311;1153;237;736;548;1889
350800;201702;2908;9584;2723;9229;505;1945;1420;4625;1925;6570
350810;201702;1939;5458;1654;5054;412;1321;794;2528;1206;3849
350820;201702;562;1531;403;1229;62;228;171;496;233;724
350830;201702;829;2535;530;1850;74;294;138;421;212;715
350840;201702;2423;8387;1984;7431;640;2532;462;1688;1102;4220
350850;201702;5830;19239;4934;17304;1491;5483;1155;4037;2646;9520
350860;201702;3085;9371;2899;9079;152;649;2232;6878;2384;7527
350870;201702;2630;8287;2131;7420;439;1685;1153;4057;1592;5742
350880;201702;1246;4105;1008;3546;239;882;255;888;494;1770
350890;201702;645;1805;405;1283;52;180;105;279;157;459
350900;201702;4970;15233;3580;12212;1054;3946;477;1526;1531;5472
350910;201702;836;2438;721;2201;182;619;350;1024;532;1643
350920;201702;10786;30165;9561;28099;883;2990;6869;19403;7752;22393
350925;201702;4348;13496;3507;11841;830;3027;1198;3556;2028;6583
350930;201702;1454;4053;1046;3217;129;435;559;1640;688;2075
350940;201702;1737;5685;1593;5397;289;1129;883;2885;1172;4014
350945;201702;902;2799;757;2533;131;518;369;1151;500;1669
350950;201702;73519;218372;59883;188912;11943;41349;27563;82243;39506;123592
350960;201702;4711;15407;4035;14003;806;3199;2038;6716;2844;9915
350970;201702;4000;13628;3356;12067;1086;4222;554;1793;1640;6015
350980;201702;609;1974;531;1811;221;796;163;549;384;1345
350990;201702;1727;5711;1397;5096;379;1515;404;1409;783;2924
350995;201702;750;2520;707;2428;85;401;461;1481;546;1882
351000;201702;2770;8154;2241;7155;396;1393;906;2711;1302;4104
351010;201702;315;914;190;628;41;148;66;213;107;361
351015;201702;716;2442;612;2247;138;556;292;1062;430;1618
351020;201702;7739;23908;6716;22258;1666;5778;3191;10600;4857;16378
351030;201702;1980;6722;1688;5985;385;1507;595;1978;980;3485
351040;201702;3445;10191;3127;9654;370;1299;2169;6505;2539;7804
351050;201702;15164;41732;10682;34101;2501;8686;3223;10270;5724;18956
351060;201702;37316;106046;30288;93692;5543;18935;15352;46292;20895;65227
351070;201702;1368;3809;878;2911;226;827;91;257;317;1084
351080;201702;2644;7532;2017;6755;471;1791;945;2985;1416;4776
351090;201702;336;1151;263;997;60;253;41;155;101;408
351100;201702;2337;6968;1595;5145;417;1433;436;1412;853;2845
351110;201702;6741;17295;3991;12799;859;3092;959;2964;1818;6056
351120;201702;656;1931;515;1643;81;285;225;620;306;905
351130;201702;980;2730;516;1752;88;315;112;354;200;669
351140;201702;1639;5478;1350;4861;422;1634;282;951;704;2585
351150;201702;1387;4782;988;3750;214;854;99;311;313;1165
351160;201702;1155;4002;1012;3661;261;995;325;1051;586;2046
351170;201702;1311;4117;1112;3682;161;597;561;1745;722;2342
351190;201702;799;2537;628;2112;97;342;192;623;289;965
351200;201702;1810;5313;1525;4789;179;637;664;1969;843;2606
351210;201702;1160;3282;819;2593;119;428;309;895;428;1323
351220;201702;2868;9567;2625;9046;407;1592;1470;4934;1877;6526
351230;201702;1735;5336;1436;4767;283;1082;699;2187;982;3269
351240;201702;1074;3265;806;2695;202;685;269;852;471;1537
351250;201702;937;2767;583;1920;95;314;201;642;296;956
351260;201702;897;2614;761;2339;213;661;245;731;458;1392
351270;201702;298;990;259;904;67;260;97;285;164;545
351280;201702;5036;14241;3815;11856;691;2365;1480;4440;2171;6805
351290;201702;939;2665;661;2109;143;465;274;851;417;1316
351300;201702;12262;38785;9227;32446;2146;8290;2902;10146;5048;18436
351310;201702;2856;8618;2312;7599;443;1639;1062;3256;1505;4895
351320;201702;821;2722;681;2366;128;502;234;750;362;1252
351330;201702;350;1153;296;1068;66;199;130;550;196;749
351340;201702;5462;18049;4621;16377;1261;4693;1700;6038;2961;10731
351350;201702;7097;22604;6161;20710;1611;5693;2316;7472;3927;13165
351360;201702;3834;11831;3508;11205;915;3222;1068;3116;1983;6338
351370;201702;2218;6813;1729;5729;361;1344;689;2078;1050;3422
351380;201702;37530;107052;33321;99357;6548;20826;15083;43987;21631;64813
351385;201702;255;745;183;587;23;85;67;186;90;271
351390;201702;1153;3612;970;3233;254;1020;410;1205;664;2225
351400;201702;905;2952;856;2839;240;879;417;1353;657;2232
351410;201702;2330;7046;2007;6420;300;960;1158;3661;1458;4621
351420;201702;287;782;188;593;38;118;48;150;86;268
351430;201702;742;2357;694;2274;98;363;507;1632;605;1995
351440;201702;3060;9152;2272;7401;467;1596;305;932;772;2528
351450;201702;1518;4277;1196;3728;298;974;386;1280;684;2254
351460;201702;643;1913;555;1747;272;857;147;468;419;1325
351470;201702;996;2932;864;2674;143;514;432;1255;575;1769
351480;201702;2668;8553;2427;8143;379;1624;1355;4323;1734;5947
351490;201702;1708;5603;1517;5187;169;733;892;2881;1061;3614
351492;201702;288;919;245;809;14;52;140;449;154;501
351495;201702;199;640;151;514;28;117;63;201;91;318
351500;201702;29313;80641;21996;67428;5094;16826;8740;25759;13834;42585
351510;201702;8987;26921;7273;23486;1593;5513;3483;11093;5076;16606
351512;201702;484;1394;356;1109;57;169;160;493;217;662
351515;201702;2265;6838;1595;5371;378;1417;392;1186;770;2603
351518;201702;2112;6346;1452;5106;338;1339;531;1700;869;3039
351519;201702;760;2236;551;1777;95;349;131;322;226;671
351520;201702;689;1885;343;1206;58;224;94;311;152;535
351530;201702;362;1104;233;764;27;89;54;140;81;229
351535;201702;2290;5895;1745;5050;140;512;1130;3104;1270;3616
351540;201702;1710;5041;1340;4323;464;1615;187;550;651;2165
351550;201702;4885;14350;3464;11160;616;2204;1418;4316;2034;6520
351560;201702;407;1308;351;1177;80;302;57;191;137;493
351565;201702;164;555;146;509;30;101;59;196;89;297
351570;201702;13288;39067;10991;34462;2053;7030;6176;18656;8229;25686
351580;201702;311;858;194;618;39;114;53;176;92;290
351590;201702;445;1135;272;802;22;79;136;370;158;449
351600;201702;1758;4833;1419;4214;170;593;851;2401;1021;2994
351610;201702;663;1773;486;1469;48;171;234;630;282;801
351620;201702;17942;56289;14196;48742;2866;11121;4110;12777;6976;23898
351630;201702;21663;65208;19226;61154;3888;13244;11081;34517;14969;47761
351640;201702;13410;39442;11052;35287;1757;6202;6487;20280;8244;26482
351650;201702;427;1281;207;712;31;121;39;119;70;240
351660;201702;760;2391;544;1834;126;463;100;285;226;748
351670;201702;3851;12079;3104;10307;550;2037;1368;4237;1918;6274
351680;201702;555;1715;332;1153;73;248;57;200;130;448
351685;201702;411;1313;354;1198;82;254;160;544;242;798
351690;201702;1041;3077;762;2470;128;451;304;895;432;1346
351700;201702;1062;3122;915;2830;213;632;340;1056;553;1688
351710;201702;522;1732;439;1529;64;235;170;570;234;805
351720;201702;1510;4511;1057;3471;199;704;325;1015;524;1719
351730;201702;1056;2942;836;2608;159;600;377;1138;536;1738
351740;201702;3934;10680;3132;9114;604;1885;1232;3408;1836;5293
351750;201702;1124;3545;714;2580;132;510;204;735;336;1245
351760;201702;3262;10067;2556;8514;688;2502;737;2267;1425;4769
351770;201702;2110;6625;1772;5974;489;1717;706;2297;1195;4014
351780;201702;1431;3992;795;2557;137;486;172;521;309;1007
351790;201702;1084;3041;907;2752;182;510;495;1538;677;2048
351800;201702;493;1085;265;695;40;106;86;232;126;338
351810;201702;1008;2853;842;2558;88;262;568;1687;656;1949
351820;201702;2490;7818;1808;6328;351;1347;176;597;527;1944
351830;201702;4174;12717;3228;10703;512;1957;1576;5008;2088;6965
351840;201702;6557;22054;5756;20402;1407;5433;2104;7184;3511;12617
351850;201702;2043;5400;1449;4414;192;739;717;2010;909;2749
351860;201702;3072;9718;2649;8829;601;2135;1181;3855;1782;5990
351870;201702;26442;77829;21841;69498;6682;22315;8202;25982;14884;48297
351880;201702;113608;347211;95440;311307;27493;96371;26265;81584;53758;177955
351885;201702;614;2090;560;1973;151;550;229;767;380;1317
351890;201702;602;1856;487;1633;114;407;84;256;198;663
351900;201702;1165;3542;946;3169;250;882;280;934;530;1816
351905;201702;454;1401;361;1218;43;162;184;573;227;735
351907;201702;18520;53621;15364;47740;1267;4814;10376;31270;11643;36084
351910;201702;1027;3123;814;2637;180;630;324;1001;504;1631
351920;201702;956;2574;771;2287;111;379;403;1171;514;1550
351925;201702;996;2964;811;2597;147;524;349;1024;496;1548
351930;201702;2619;8267;2510;8063;360;1494;1899;5801;2259;7295
351940;201702;944;2829;779;2520;121;419;372;1200;493;1619
351950;201702;1496;4037;1063;3238;116;395;539;1621;655;2016
351960;201702;4416;12668;3304;10579;707;2489;1401;4442;2108;6931
351970;201702;5424;19060;4839;17895;1306;5250;1883;6689;3189;11939
351980;201702;878;2558;633;2027;119;411;229;650;348;1061
351990;201702;1453;4014;1132;3426;222;806;266;688;488;1494
352000;201702;2193;7134;1987;6683;357;1342;974;3079;1331;4421
352010;201702;1560;5182;1370;4770;340;1261;232;824;572;2085
352020;201702;1373;4242;1170;3849;288;1027;467;1456;755;2483
352030;201702;4740;13772;3933;12584;804;2820;2082;6630;2886;9450
352040;201702;1934;6160;1484;5185;309;1189;228;747;537;1936
352042;201702;3502;9511;2133;6620;401;1333;922;2799;1323;4132
352044;201702;1760;5288;1127;3962;181;706;213;679;394;1385
352050;201702;10981;33029;7558;25440;1821;6922;1341;4071;3162;10993
352060;201702;685;2072;547;1787;108;408;210;617;318;1025
352070;201702;774;1944;616;1678;128;386;211;576;339;962
352080;201702;420;1209;276;892;50;172;85;256;135;428
352090;201702;1285;4331;1029;3704;169;669;269;898;438;1567
352100;201702;2897;8715;2307;7620;571;2020;926;2920;1497;4940
352110;201702;515;1783;433;1609;115;442;151;527;266;969
352115;201702;472;1475;406;1349;59;200;241;803;300;1003
352120;201702;878;2759;722;2463;105;439;355;1106;460;1545
352130;201702;1795;5354;1199;3940;282;992;260;822;542;1814
352140;201702;1693;4802;1032;3412;162;579;354;1112;516;1691
352150;201702;753;2228;594;1924;148;506;283;907;431;1413
352160;201702;961;2625;736;2223;165;544;242;656;407;1200
352170;201702;2659;7975;2330;7237;470;1569;1140;3352;1610;4921
352180;201702;2963;8436;2498;7519;654;2083;845;2435;1499;4518
352190;201702;1136;3369;927;2957;141;561;316;831;457;1392
352200;201702;371;1282;282;1083;39;168;96;351;135;519
352210;201702;16003;43038;13113;38784;2125;6818;7993;23843;10118;30661
352215;201702;523;1591;474;1518;53;206;293;911;346;1117
352220;201702;11949;37311;9610;32593;3141;11376;2229;7547;5370;18923
352230;201702;12028;40167;10279;36737;2833;11120;3383;11578;6216;22698
352240;201702;11845;33793;9202;29165;2460;8832;2840;8141;5300;16973
352250;201702;21737;68700;18884;62990;5665;20027;6331;21121;11996;41148
352260;201702;5183;14684;3440;10987;692;2494;1231;3584;1923;6078
352265;201702;852;2662;729;2450;66;292;488;1568;554;1860
352270;201702;1546;5285;1269;4681;317;1253;345;1236;662;2489
352280;201702;2184;6448;1789;5739;310;1191;814;2449;1124;3640
352290;201702;1090;3433;942;3096;172;675;420;1273;592;1948
352300;201702;958;2750;720;2267;141;511;311;890;452;1401
352310;201702;44245;128469;35254;112691;9238;30613;15828;50880;25066;81493
352320;201702;5355;16251;4556;14601;1113;3827;1561;4554;2674;8381
352330;201702;1963;6207;1656;5762;507;1893;516;1755;1023;3648
352340;201702;4907;15344;3776;13201;1055;3977;820;2730;1875;6707
352350;201702;1596;5323;1421;4924;267;1063;528;1711;795;2774
352360;201702;1012;3044;894;2831;146;548;605;1824;751;2372
352370;201702;811;2749;730;2543;101;431;411;1367;512;1798
352380;201702;877;2778;744;2523;215;809;175;559;390;1368
352390;201702;19039;49738;12617;37978;2090;7209;5844;16454;7934;23663
352400;201702;3386;9669;2331;7644;707;2451;535;1625;1242;4076
352410;201702;2658;8022;2299;7431;475;1659;1029;3208;1504;4867
352420;201702;824;2254;668;1950;130;405;264;757;394;1162
352430;201702;6009;17872;5072;16335;1608;5570;1645;5309;3253;10879
352440;201702;15670;47766;12843;42181;2897;10188;5129;16653;8026;26841
352450;201702;602;1829;392;1356;81;316;112;381;193;697
352460;201702;2375;7481;1950;6644;522;1953;568;1807;1090;3760
352470;201702;3689;10239;2709;8426;358;1262;1220;3551;1578;4813
352480;201702;3929;10487;2926;8686;575;1926;1157;3096;1732;5022
352490;201702;644;2235;511;1904;102;414;141;530;243;944
352500;201702;8169;22743;6716;20393;3401;10947;1296;3290;4697;14237
352510;201702;2721;8496;2192;7502;634;2316;605;2047;1239;4363
352520;201702;1893;6631;1664;6079;446;1727;628;2273;1074;4000
352530;201702;8321;26156;6205;21216;1549;5713;852;2415;2401;8128
352540;201702;519;1610;372;1270;61;221;107;360;168;581
352550;201702;836;2723;616;2218;145;590;124;417;269;1007
352560;201702;602;1789;417;1356;64;203;98;280;162;483
352570;201702;1795;5725;1309;4691;338;1367;201;611;539;1978
352580;201702;818;2447;639;2081;93;337;217;639;310;976
352585;201702;259;817;210;706;37;136;73;241;110;377
352590;201702;11863;36060;9660;31824;3182;11122;3494;10680;6676;21802
352600;201702;1724;5270;1396;4528;296;1042;581;1799;877;2841
352610;201702;3219;9826;2561;8626;640;2399;766;2425;1406;4824
352620;201702;5058;15258;4495;14334;1098;3607;2022;6405;3120;10012
352630;201702;594;1844;546;1732;133;499;222;633;355;1132
352640;201702;2476;7396;2089;6687;208;746;1368;4330;1576;5076
352650;201702;739;2244;552;1792;95;341;142;429;237;770
352660;201702;902;3190;762;2876;171;706;207;776;378;1482
352670;201702;10701;31662;6529;22429;1535;5865;465;1531;2000;7396
352680;201702;2818;9269;2192;7885;453;1850;782;2610;1235;4460
352690;201702;30405;82952;21970;66245;2880;9722;11373;32780;14253;42502
352700;201702;572;1714;486;1581;152;543;184;570;336;1113
352710;201702;5309;15232;3945;12506;970;3449;1317;3966;2287;7415
352720;201702;7563;24056;6714;22145;2323;7855;1812;5810;4135;13665
352725;201702;422;1159;219;716;27;104;95;284;122;388
352730;201702;2097;6845;1884;6265;410;1502;804;2407;1214;3909
352740;201702;2088;5498;1624;4777;189;668;940;2662;1129;3330
352750;201702;458;1306;242;822;32;124;48;148;80;272
352760;201702;1199;4021;969;3432;285;1072;271;912;556;1984
352770;201702;749;2310;618;2036;143;508;244;777;387;1285
352780;201702;638;2132;507;1810;97;385;162;561;259;946
352790;201702;629;1790;451;1463;76;256;121;382;197;638
352800;201702;1051;3720;779;2981;167;693;217;753;384;1446
352810;201702;1000;2584;629;1860;119;360;205;576;324;936
352820;201702;610;1622;432;1341;92;315;95;281;187;596
352830;201702;488;1405;292;932;46;152;43;120;89;272
352840;201702;3807;12603;3402;11763;943;3449;1391;4671;2334;8120
352850;201702;9563;27115;7149;23233;1871;6517;2470;7952;4341;14469
352860;201702;788;2671;719;2512;144;559;281;931;425;1490
352870;201702;886;2229;585;1589;71;245;294;711;365;956
352880;201702;2149;5810;1535;4628;250;785;621;1716;871;2501
352885;201702;243;777;212;719;26;80;135;458;161;538
352890;201702;651;1693;450;1280;62;213;187;467;249;680
352900;201702;18782;54142;13618;43722;2763;9758;4934;15014;7697;24772
352910;201702;369;1058;212;707;24;86;48;142;72;228
352920;201702;2349;6914;1781;5726;313;1143;791;2369;1104;3512
352930;201702;5433;16797;4381;14519;909;3232;1438;4552;2347;7784
352940;201702;21033;66677;17456;58676;5773;21174;1927;5809;7700;26983
352950;201702;353;1007;224;767;59;221;25;78;84;299
352960;201702;586;1748;352;1200;61;228;99;287;160;515
352965;201702;368;1054;228;733;55;187;36;102;91;289
352970;201702;3104;7684;2491;6784;211;639;1761;4778;1972;5417
352980;201702;1055;3329;901;3083;173;591;518;1846;691;2437
352990;201702;3998;12325;3508;11470;884;3248;1537;4754;2421;8002
353000;201702;429;1216;228;757;38;138;43;140;81;278
353010;201702;2904;7931;2103;6379;503;1719;582;1597;1085;3316
353020;201702;3968;10745;2328;7197;334;1110;745;2109;1079;3219
353030;201702;3414;9989;2695;8629;767;2612;497;1549;1264;4161
353040;201702;465;1313;383;1154;74;240;122;344;196;584
353050;201702;4583;15153;3771;13417;1011;3830;1323;4500;2334;8330
353060;201702;40435;116677;35112;107858;3768;13954;24171;71278;27939;85232
353070;201702;9852;30133;7173;24431;1646;6042;1882;6404;3528;12446
353080;201702;4685;14518;3311;11585;770;2959;852;2763;1622;5722
353090;201702;514;1743;468;1633;43;175;286;931;329;1106
353100;201702;285;795;126;421;20;68;20;51;40;119
353110;201702;7010;21420;6119;19999;1082;3889;3775;12361;4857;16250
353120;201702;643;1905;422;1396;80;301;110;318;190;619
353130;201702;2239;6448;1744;5639;540;1886;551;1726;1091;3612
353140;201702;2143;5869;1719;5049;329;1063;831;2299;1160;3362
353150;201702;1540;4590;1227;4027;330;1081;337;1114;667;2195
353160;201702;651;1786;421;1336;75;262;123;329;198;591
353170;201702;422;1288;370;1224;83;365;188;566;271;931
353180;201702;8594;23944;6938;21163;1067;3555;4053;12274;5120;15829
353190;201702;3493;10406;2826;8948;439;1556;1466;4350;1905;5906
353200;201702;1045;3463;787;2754;208;804;187;622;395;1426
353205;201702;341;1131;310;1058;72;263;144;485;216;748
353210;201702;1016;2522;659;1874;41;156;404;1111;445;1267
353215;201702;409;1260;337;1094;62;237;105;297;167;534
353220;201702;601;1844;481;1598;120;414;107;341;227;755
353230;201702;676;2200;612;2087;157;586;173;558;330;1144
353240;201702;2031;6402;1757;5864;297;1146;964;3107;1261;4253
353250;201702;1045;2793;779;2296;108;340;352;996;460;1336
353260;201702;829;2312;583;1847;110;389;184;550;294;939
353270;201702;600;1761;517;1599;93;286;220;658;313;944
353280;201702;574;1865;448;1545;121;457;94;302;215;759
353282;201702;1759;5505;1611;5213;227;827;954;2980;1181;3807
353284;201702;354;938;202;625;39;128;45;127;84;255
353286;201702;123;376;87;300;22;79;15;49;37;128
353290;201702;818;2495;669;2207;86;352;380;1151;466;1503
353300;201702;1378;4277;1144;3758;249;941;397;1166;646;2107
353310;201702;192;553;156;509;47;166;49;159;96;325
353320;201702;568;1614;472;1427;64;194;250;738;314;932
353325;201702;616;1999;491;1718;71;250;148;514;219;764
353330;201702;577;1608;407;1230;52;186;205;579;257;765
353340;201702;2725;7917;1877;6304;558;1981;465;1602;1023;3583
353350;201702;3153;9453;2372;7766;678;2388;556;1676;1234;4064
353360;201702;442;1446;404;1364;48;182;254;847;302;1029
353370;201702;577;1911;499;1736;59;250;274;912;333;1162
353380;201702;307;1021;250;892;46;187;73;251;119;438
353390;201702;5641;15448;4086;12587;845;2714;1378;4135;2223;6849
353400;201702;445;1353;373;1209;76;283;83;213;159;496
353410;201702;595;1746;499;1564;101;364;241;712;342;1076
353420;201702;567;1606;363;1132;95;288;80;242;175;530
353430;201702;2057;6827;1543;5588;400;1527;263;921;663;2448
353440;201702;53843;168548;42418;143278;11180;39337;15059;49732;26239;89069
353450;201702;395;1148;299;933;57;210;105;301;162;511
353460;201702;3116;8891;2457;7619;288;1051;1122;3510;1410;4561
353470;201702;7151;21307;5335;17739;1212;4495;1324;4115;2536;8610
353475;201702;1401;3985;1048;3195;162;545;353;985;515;1530
353480;201702;1325;4058;1182;3772;131;444;833;2612;964;3056
353490;201702;883;2593;667;2131;156;498;246;770;402;1268
353500;201702;972;2586;796;2300;206;592;405;1173;611;1765
353510;201702;885;2832;661;2252;169;604;117;356;286;960
353520;201702;1063;2998;799;2556;119;427;358;1109;477;1536
353530;201702;2412;6971;2073;6349;285;1007;1111;3271;1396;4278
353540;201702;1863;5681;1593;5213;388;1336;701;2251;1089;3587
353550;201702;5954;16596;4846;14679;619;2206;2800;8018;3419;10224
353560;201702;2007;6590;1661;5955;510;1982;410;1390;920;3372
353570;201702;492;1462;370;1215;96;311;144;455;240;766
353580;201702;2299;6665;1984;6120;290;988;1247;3797;1537;4785
353590;201702;651;1921;454;1476;97;349;161;506;258;855
353600;201702;1728;4758;1506;4332;193;624;790;2184;983;2808
353610;201702;593;1996;443;1658;88;357;83;289;171;646
353620;201702;2203;6900;1811;6107;446;1585;495;1561;941;3146
353625;201702;405;1137;260;846;35;135;109;347;144;482
353630;201702;1355;4709;1072;3982;204;836;140;434;344;1270
353640;201702;1311;3834;987;3147;134;475;479;1503;613;1978
353650;201702;8363;24288;6284;19960;1124;3762;2457;7537;3581;11299
353657;201702;291;906;245;817;46;178;81;238;127;416
353660;201702;995;2624;719;2092;243;767;88;176;331;943
353670;201702;3368;10737;2842;9658;862;3272;1010;3154;1872;6426
353680;201702;654;2050;536;1844;154;594;206;680;360;1274
353690;201702;492;1320;259;855;38;128;44;111;82;239
353700;201702;1941;5851;1667;5311;228;809;909;2762;1137;3571
353710;201702;3198;7635;1589;5023;376;1194;283;891;659;2085
353715;201702;521;1476;371;1176;32;120;99;296;131;416
353720;201702;1898;5791;1600;5333;311;1199;815;2588;1126;3787
353730;201702;4129;12421;3232;10482;623;2231;1145;3382;1768;5613
353740;201702;1622;4819;1217;4009;332;1198;312;992;644;2190
353750;201702;807;2710;607;2255;128;516;129;486;257;1002
353760;201702;10015;26798;8161;24252;1078;3698;5281;15385;6359;19083
353770;201702;649;2008;351;1253;62;252;26;58;88;310
353780;201702;3903;13374;3404;12304;1046;4046;857;3056;1903;7102
353790;201702;2094;7080;1714;6275;461;1952;430;1484;891;3436
353800;201702;15728;47507;12578;41808;3010;10855;4924;16051;7934;26906
353810;201702;959;3069;746;2594;140;547;241;814;381;1361
353820;201702;1365;4529;1198;4129;223;886;578;1897;801;2783
353830;201702;613;1642;484;1432;74;233;267;761;341;994
353850;201702;1636;5050;1406;4564;373;1254;515;1652;888;2906
353860;201702;2462;7979;2022;6997;552;2015;529;1827;1081;3842
353870;201702;27279;78671;19327;62604;3491;12573;6945;20511;10436;33084
353880;201702;2625;8292;2227;7554;302;1180;1203;4049;1505;5229
353890;201702;2317;5694;1630;4568;250;781;849;2271;1099;3052
353900;201702;791;2449;597;2060;128;479;165;558;293;1037
353910;201702;1331;4479;1220;4281;229;835;726;2582;955;3417
353920;201702;2269;6605;1580;5212;335;1218;281;820;616;2038
353930;201702;4345;13014;3104;10706;791;3021;515;1718;1306;4739
353940;201702;1086;3489;829;2886;156;582;237;780;393;1362
353950;201702;2998;9439;2568;8510;509;1837;1231;3823;1740;5660
353960;201702;536;1673;386;1334;83;302;91;281;174;583
353970;201702;570;1617;460;1434;50;171;279;867;329;1038
353980;201702;13235;38880;11130;34915;2237;7409;5534;16941;7771;24350
353990;201702;402;1231;359;1139;42;157;203;620;245;777
354000;201702;2155;5853;1356;4285;258;878;153;476;411;1354
354010;201702;355;1069;296;960;57;195;169;545;226;740
354020;201702;3987;12438;3416;11209;876;3134;1026;3093;1902;6227
354025;201702;820;2292;584;1854;112;372;199;635;311;1007
354030;201702;454;1222;293;911;44;161;121;354;165;515
354040;201702;746;2006;503;1526;38;121;300;856;338;977
354050;201702;890;2802;695;2399;179;676;139;452;318;1128
354060;201702;4635;14283;3219;11051;853;3069;796;2565;1649;5634
354070;201702;2637;8772;2225;7801;579;2173;434;1421;1013;3594
354075;201702;1847;6692;1667;6267;358;1513;799;2902;1157;4415
354080;201702;1306;3986;937;3172;154;561;310;969;464;1530
354085;201702;315;770;290;736;9;40;231;565;240;605
354090;201702;1294;3820;1222;3681;132;469;817;2435;949;2904
354100;201702;13778;45911;11400;41278;2911;11319;4660;16539;7571;27858
354105;201702;927;2664;809;2489;118;390;529;1618;647;2008
354110;201702;690;1877;532;1652;182;630;113;315;295;945
354120;201702;1866;5152;1323;4046;222;748;541;1538;763;2286
354130;201702;6021;17149;4387;13975;1594;5376;314;860;1908;6236
354140;201702;25529;64158;16198;47486;3407;10704;4613;12662;8020;23366
354150;201702;3671;9849;2797;8286;478;1546;1292;3713;1770;5259
354160;201702;3182;10230;2513;8698;623;2254;850;2917;1473;5171
354165;201702;494;1632;418;1476;109;428;162;570;271;998
354170;201702;1299;4057;1030;3427;166;605;444;1412;610;2017
354180;201702;449;1387;386;1247;63;240;154;425;217;665
354190;201702;1410;4394;1166;3884;254;923;375;1210;629;2133
354200;201702;927;2591;724;2220;89;301;339;960;428;1261
354210;201702;617;1937;511;1734;74;309;272;848;346;1157
354220;201702;2868;8249;2378;7313;455;1501;1147;3425;1602;4926
354230;201702;588;1909;522;1765;88;351;244;773;332;1124
354240;201702;1180;3830;874;3115;166;653;191;637;357;1290
354250;201702;657;1824;429;1437;128;449;112;402;240;851
354260;201702;7438;21953;6097;19606;1632;5552;1858;6175;3490;11727
354270;201702;1096;3615;905;3191;177;680;307;1072;484;1752
354280;201702;689;2013;617;1884;111;424;362;1015;473;1439
354290;201702;887;3109;791;2872;169;650;313;1133;482;1783
354300;201702;3647;11770;3395;11296;912;3157;1588;5187;2500;8344
354310;201702;801;2431;648;2127;139;469;317;1031;456;1500
354320;201702;704;2103;561;1816;130;494;200;584;330;1078
354323;201702;461;1261;335;1014;63;199;117;318;180;517
354325;201702;1197;3890;912;3229;164;625;326;1073;490;1698
354330;201702;6167;18179;4868;15613;953;3496;2271;6744;3224;10240
354340;201702;22868;69081;18516;61417;5046;18193;6879;22081;11925;40274
354350;201702;1047;3076;936;2851;193;668;513;1458;706;2126
354360;201702;434;1383;271;1003;46;166;15;60;61;226
354370;201702;1081;3601;924;3272;108;479;497;1689;605;2168
354380;201702;766;2313;583;1945;166;637;102;297;268;934
354390;201702;12876;36698;8805;28921;1800;6366;1657;5391;3457;11757
354400;201702;1483;5142;1206;4453;284;1117;350;1272;634;2389
354410;201702;5161;15747;4246;13948;1062;3761;1638;5239;2700;9000
354420;201702;1154;3423;843;2716;182;621;349;1102;531;1723
354425;201702;2072;5944;1762;5343;513;1638;476;1465;989;3103
354430;201702;1302;4185;1159;3901;242;934;494;1583;736;2517
354440;201702;504;1512;363;1205;45;165;137;417;182;582
354450;201702;393;1128;234;775;32;116;40;123;72;239
354460;201702;968;2691;680;2119;129;447;292;913;421;1360
354470;201702;583;1543;459;1303;38;139;231;597;269;736
354480;201702;715;1947;571;1704;65;203;336;962;401;1165
354490;201702;705;2350;575;2035;72;282;258;878;330;1160
354500;201702;2011;6468;1793;6114;659;2507;391;1308;1050;3815
354510;201702;790;2163;723;2044;93;237;451;1278;544;1515
354515;201702;246;812;194;695;39;158;64;230;103;388
354520;201702;7749;24929;4446;15321;814;3210;1834;5846;2648;9056
354530;201702;3083;10414;2736;9652;695;2681;1112;3845;1807;6526
354540;201702;1141;3437;928;3031;313;1098;183;590;496;1688
354550;201702;459;1343;371;1175;78;272;182;552;260;824
354560;201702;1706;4693;1016;3144;146;469;432;1260;578;1729
354570;201702;1034;2885;492;1574;78;272;69;204;147;476
354580;201702;10288;28603;7129;22798;1267;4427;2684;8096;3951;12523
354600;201702;1545;4946;1315;4511;243;977;674;2231;917;3208
354610;201702;352;1016;203;665;21;75;68;207;89;282
354620;201702;374;1179;293;1033;58;254;128;415;186;669
354625;201702;279;866;181;637;26;101;45;131;71;232
354630;201702;2076;6804;1812;6255;740;2698;251;826;991;3524
354640;201702;3091;10118;2393;8459;505;2028;480;1491;985;3519
354650;201702;826;2416;705;2160;69;238;472;1455;541;1693
354660;201702;2280;6273;1647;5187;154;571;1044;3245;1198;3816
354670;201702;1077;3315;823;2702;196;708;197;591;393;1299
354680;201702;4204;13540;3822;12783;1005;3517;1783;5913;2788;9430
354690;201702;734;2359;498;1785;89;334;121;419;210;753
354700;201702;1065;2994;740;2290;152;558;301;828;453;1386
354710;201702;506;1495;369;1197;33;134;169;490;202;624
354720;201702;248;669;138;439;42;136;17;50;59;186
354730;201702;8541;26410;6404;22277;1264;4824;2865;9664;4129;14488
354740;201702;246;732;130;468;13;56;20;76;33;132
354750;201702;2166;6806;1715;5837;406;1565;618;1969;1024;3534
354760;201702;1780;5600;1421;4845;477;1743;208;712;685;2455
354765;201702;296;837;141;480;18;65;22;70;40;135
354770;201702;2210;6074;1664;5122;540;1772;500;1496;1040;3268
354780;201702;53978;148406;44954;129861;6875;22354;24090;65654;30965;88008
354790;201702;775;2551;698;2385;117;415;351;1177;468;1592
354800;201702;2270;6498;1912;5968;408;1420;955;2877;1363;4297
354805;201702;975;2873;710;2309;84;313;208;588;292;901
354810;201702;548;1768;347;1290;63;270;59;203;122;473
354820;201702;924;3118;769;2784;163;668;162;535;325;1203
354830;201702;443;1176;324;965;95;294;119;327;214;621
354840;201702;678;1937;499;1557;90;289;242;741;332;1030
354850;201702;16673;50075;12293;41377;2392;9086;5603;17541;7995;26627
354860;201702;1286;4023;1097;3704;261;1010;397;1221;658;2231
354870;201702;45019;129035;39139;117339;7861;25637;18356;53377;26217;79014
354880;201702;4251;11697;2324;7428;338;1268;732;1969;1070;3237
354890;201702;14874;42827;12502;38584;2571;8595;5675;16978;8246;25573
354900;201702;417;1285;309;1041;56;208;70;220;126;428
354910;201702;6016;17813;3612;12722;643;2573;181;583;824;3156
354920;201702;366;1082;227;791;41;170;47;146;88;316
354925;201702;205;646;117;428;24;95;20;62;44;157
354930;201702;301;765;167;534;24;74;69;223;93;297
354940;201702;1618;5800;1337;5056;460;1861;132;473;592;2334
354950;201702;1420;4435;1187;4034;162;703;658;2116;820;2819
354960;201702;722;2218;633;2071;120;442;290;912;410;1354
354970;201702;3796;12277;3297;11238;561;2219;1755;5730;2316;7949
354980;201702;26875;70441;18232;55389;3070;10704;7349;20638;10419;31342
354990;201702;54506;155485;42455;132230;6826;23144;21017;63444;27843;86588
354995;201702;1772;5286;1452;4756;348;1214;726;2327;1074;3541
355000;201702;1292;4150;1151;3895;295;1168;226;643;521;1811
355010;201702;3307;10163;2499;8229;787;2787;529;1758;1316;4545
355020;201702;2784;9084;2157;7792;752;2980;544;1903;1296;4883
355030;201702;1135482;3031718;932230;2639963;195473;603127;413149;1113338;608622;1716465
355040;201702;2513;7604;2231;7113;374;1294;1383;4332;1757;5626
355050;201702;1063;3183;824;2707;249;830;140;457;389;1287
355060;201702;4221;13701;3422;12024;683;2743;1166;3758;1849;6501
355070;201702;6536;19889;5691;18462;1103;4053;2924;8947;4027;13000
355080;201702;829;2797;581;2219;97;433;37;125;134;558
355090;201702;1034;3512;874;3162;171;650;311;1120;482;1770
355100;201702;16109;49224;13394;44593;3251;11849;6732;21919;9983;33768
355110;201702;1076;3478;905;3163;284;1090;161;513;445;1603
355120;201702;599;1840;475;1599;88;353;182;583;270;936
355130;201702;622;1560;283;831;38;121;89;236;127;357
355140;201702;1107;3590;1018;3440;196;749;589;2034;785;2783
355150;201702;3423;9863;2794;8786;564;1912;1313;4109;1877;6021
355160;201702;1681;5233;1395;4746;404;1482;341;1135;745;2617
355170;201702;7844;22281;6168;19521;2015;6707;1878;6121;3893;12828
355180;201702;2677;8278;2157;7301;537;2183;685;2071;1222;4254
355190;201702;1329;4126;1129;3754;356;1307;337;1211;693;2518
355200;201702;741;2600;669;2439;272;1056;159;547;431;1603
355210;201702;2709;8359;2403;7697;289;1118;1519;4653;1808;5771
355220;201702;35899;106778;29341;93794;9259;31454;7849;23343;17108;54797
355230;201702;1392;3738;803;2502;151;450;180;521;331;971
355240;201702;23563;66897;16402;52236;3583;12086;5388;16867;8971;28953
355250;201702;28577;87276;23535;77658;6426;22798;7991;25773;14417;48571
355255;201702;854;2320;518;1639;100;341;135;412;235;753
355260;201702;1145;3393;959;3067;204;749;419;1226;623;1975
355270;201702;1545;4763;1314;4246;230;779;627;1898;857;2677
355280;201702;26436;75404;21144;65011;3935;13255;8908;26376;12843;39631
355290;201702;862;2722;676;2260;141;474;201;634;342;1108
355300;201702;1274;4052;1051;3573;237;860;310;1031;547;1891
355310;201702;998;2932;786;2564;119;428;422;1390;541;1818
355320;201702;558;1698;487;1551;95;361;194;539;289;900
355330;201702;1830;5540;1356;4590;256;940;618;2018;874;2958
355340;201702;2655;6695;2341;6214;365;974;1434;3776;1799;4750
355350;201702;1279;4234;1014;3643;244;950;284;999;528;1949
355360;201702;1140;3564;1014;3277;172;579;631;2089;803;2668
355365;201702;327;963;201;710;50;182;36;118;86;300
355370;201702;6638;17006;5165;15073;1350;4229;2120;6536;3470;10765
355380;201702;3058;9017;2404;7623;528;1813;583;1633;1111;3446
355385;201702;998;3176;896;2967;248;891;298;928;546;1819
355390;201702;812;2365;613;1953;126;444;220;607;346;1051
355395;201702;1842;5574;1362;4441;197;643;577;1794;774;2437
355400;201702;8752;28607;7565;26117;2317;8619;2030;6749;4347;15368
355410;201702;17825;55898;13957;48176;4057;15301;2657;9317;6714;24618
355420;201702;690;2442;618;2297;178;776;170;620;348;1396
355430;201702;3519;9553;2836;8395;529;1703;1385;3994;1914;5697
355440;201702;864;2615;618;2057;127;428;157;477;284;905
355450;201702;3681;10454;2164;7120;418;1462;619;1901;1037;3363
355460;201702;546;1457;358;1114;64;240;128;336;192;576
355465;201702;335;1074;267;923;55;200;67;218;122;418
355470;201702;742;2220;578;1928;156;536;210;677;366;1213
355475;201702;163;508;157;496;34;126;99;297;133;423
355480;201702;2947;10042;2676;9508;587;2275;1325;4633;1912;6908
355490;201702;958;2720;609;1994;89;292;186;586;275;878
355495;201702;744;2463;635;2237;142;559;160;536;302;1095
355500;201702;6768;19833;4515;14770;850;3027;821;2531;1671;5558
355510;201702;1842;4897;1002;3203;152;573;271;778;423;1351
355520;201702;418;987;209;584;25;79;99;252;124;331
355530;201702;427;1024;174;543;25;90;40;111;65;201
355535;201702;610;1823;489;1598;148;550;133;361;281;911
355540;201702;7774;24122;7315;23368;1690;5736;4007;12521;5697;18257
355550;201702;725;2216;591;1949;100;371;242;785;342;1156
355560;201702;1117;3371;679;2354;136;536;39;108;175;644
355570;201702;190;603;115;416;19;69;14;50;33;119
355580;201702;1189;3288;808;2555;126;453;316;977;442;1430
355590;201702;212;567;164;482;19;67;94;265;113;332
355600;201702;1174;3463;938;2964;285;984;288;872;573;1856
355610;201702;1577;4329;1157;3541;193;631;522;1550;715;2181
355620;201702;4180;12956;3363;11085;550;2101;1548;4695;2098;6796
355630;201702;2658;7728;1812;6067;401;1380;512;1769;913;3149
355635;201702;891;2830;762;2617;79;302;534;1867;613;2169
355640;201702;2643;8369;1920;6907;412;1611;327;1179;739;2790
355645;201702;3653;11782;3138;10959;458;1877;1876;6464;2334;8341
355650;201702;7187;21277;6234;19504;1187;4289;3668;10678;4855;14967
355660;201702;1261;3866;1003;3302;151;624;494;1461;645;2085
355670;201702;2769;8571;2025;6764;384;1469;861;2543;1245;4012
355680;201702;1526;5043;1106;3992;279;1084;156;548;435;1632
355690;201702;479;1493;346;1237;131;484;19;51;150;535
355695;201702;241;784;145;518;11;42;14;45;25;87
355700;201702;5276;16981;4466;15152;1127;3917;1725;5766;2852;9683
355710;201702;9232;22812;5514;16063;1135;3535;1451;4020;2586;7555
355715;201702;312;922;210;692;56;204;43;132;99;336
355720;201702;1424;4682;1169;4107;270;1031;389;1218;659;2249
355730;201702;821;2668;692;2360;217;748;181;591;398;1339
410010;201702;1314;4068;1119;3622;254;919;197;631;451;1550
410020;201702;1146;3674;970;3277;268;914;352;1194;620;2108
410030;201702;1097;3697;909;3245;251;930;168;624;419;1554
410040;201702;9460;30495;8148;28025;1907;7278;2569;8790;4476;16068
410045;201702;1005;2795;714;2254;164;573;178;501;342;1074
410050;201702;2604;7068;1668;5295;460;1552;164;442;624;1994
410060;201702;2131;6498;1838;5890;370;1212;767;2490;1137;3702
410070;201702;1659;4643;1257;3847;350;1168;341;1021;691;2189
410080;201702;1386;3879;1073;3297;194;678;438;1266;632;1944
410090;201702;964;2946;902;2824;169;587;394;1275;563;1862
410100;201702;2610;7996;1965;6444;383;1447;241;734;624;2181
410105;201702;349;1080;229;787;41;171;38;107;79;278
410110;201702;2822;8142;2248;7020;358;1236;716;2199;1074;3435
410115;201702;520;1395;395;1165;74;238;136;366;210;604
410120;201702;2384;8205;2215;7860;849;3193;588;2098;1437;5291
410130;201702;1083;3334;1016;3185;381;1296;263;732;644;2028
410140;201702;17199;44260;11186;33544;2258;7412;2521;7165;4779;14577
410150;201702;14945;38374;8109;24322;1574;5059;1244;3520;2818;8579
410160;201702;2861;8765;2566;8217;596;2132;951;3105;1547;5237
410165;201702;693;2011;557;1699;94;307;262;740;356;1047
410170;201702;2214;6310;1661;5082;447;1496;244;722;691;2218
410180;201702;11171;34918;9593;31366;1944;6848;4292;13203;6236;20051
410185;201702;518;1436;386;1178;86;269;78;213;164;482
410190;201702;1982;5813;1590;4972;343;1180;264;778;607;1958
410200;201702;3690;10153;2632;8113;567;2002;382;1145;949;3147
410210;201702;2572;7528;1838;5890;321;1192;385;1010;706;2202
410220;201702;646;1740;479;1435;78;271;140;420;218;691
410230;201702;1438;4442;1235;4022;243;907;519;1636;762;2543
410240;201702;4182;12575;3761;11705;1228;4369;538;1585;1766;5954
410250;201702;2661;7244;1862;5642;410;1350;364;1104;774;2454
410260;201702;1549;4406;1216;3832;254;880;509;1602;763;2482
410270;201702;554;1533;435;1292;50;167;206;594;256;761
410275;201702;776;2356;528;1757;78;275;226;757;304;1032
410280;201702;2092;6058;1518;4863;350;1256;394;1165;744;2421
410290;201702;3325;9917;2739;8794;589;1946;1075;3472;1664;5418
410300;201702;695;1935;576;1690;104;346;246;643;350;989
410302;201702;426;1175;254;829;31;111;128;421;159;532
410304;201702;1190;3757;1081;3519;276;950;431;1435;707;2385
410305;201702;1803;4895;1448;4284;319;1007;704;2067;1023;3074
410310;201702;2237;7064;1977;6601;433;1614;689;2311;1122;3925
410315;201702;668;1869;419;1392;60;221;130;407;190;628
410320;201702;1188;3616;794;2688;115;446;97;315;212;761
410322;201702;548;1601;332;1116;49;163;84;281;133;444
410330;201702;1305;3625;1058;3136;252;788;251;738;503;1526
410335;201702;903;2654;770;2390;125;449;321;898;446;1347
410337;201702;780;2052;560;1635;82;274;192;513;274;787
410340;201702;545;1537;372;1097;48;160;156;395;204;555
410345;201702;1784;5146;1253;4001;291;967;304;940;595;1907
410347;201702;715;1916;514;1541;61;223;154;431;215;654
410350;201702;1056;3141;793;2624;151;561;184;554;335;1115
410360;201702;3840;10220;2988;8693;342;1152;1547;4374;1889;5526
410370;201702;11600;33781;8454;26290;1496;5165;2436;6674;3932;11839
410380;201702;1290;3708;1177;3464;140;520;552;1601;692;2121
410390;201702;2304;6907;1819;5850;574;1937;365;1088;939;3025
410395;201702;853;2811;755;2600;198;736;333;1156;531;1892
410400;201702;4258;13075;3446;11295;702;2486;1221;3847;1923;6333
410405;201702;803;2290;656;2022;160;555;223;658;383;1213
410410;201702;1191;3674;1155;3625;291;1128;587;1749;878;2877
410420;201702;6519;20997;5334;18339;1341;5055;726;2180;2067;7235
410425;201702;2661;8346;2007;6922;382;1438;281;879;663;2317
410430;201702;13585;36449;9947;29768;1858;6109;2741;7900;4599;14009
410440;201702;2575;8302;2285;7739;536;1982;975;3288;1511;5270
410442;201702;2556;8429;2250;7753;661;2386;660;2265;1321;4651
410445;201702;2286;7364;1952;6737;512;1955;623;2219;1135;4174
410450;201702;1890;5368;1449;4476;343;1154;172;396;515;1550
410460;201702;1619;4722;1268;4060;368;1236;251;750;619;1986
410465;201702;2198;7085;1856;6348;424;1512;641;2097;1065;3609
410470;201702;1730;5492;1371;4680;289;1126;278;948;567;2074
410480;201702;30462;84804;18544;60027;3017;10556;1476;4277;4493;14833
410490;201702;11092;33530;8362;27751;1845;6791;2207;6794;4052;13585
410500;201702;1499;4698;1196;3991;412;1517;163;464;575;1981
410510;201702;2420;6340;1633;4759;313;926;510;1395;823;2321
410520;201702;2973;10200;2791;9815;796;2903;1261;4506;2057;7409
410530;201702;1466;4027;944;2849;171;559;175;458;346;1017
410540;201702;2876;8500;2058;6758;399;1418;681;2200;1080;3618
410550;201702;6024;17341;4296;13627;863;3018;587;1693;1450;4711
410560;201702;1232;3612;961;3082;243;862;295;852;538;1714
410570;201702;2561;7996;2280;7528;616;2232;645;2353;1261;4585
410580;201702;21596;63781;17583;55825;4020;14257;5628;16712;9648;30969
410590;201702;1367;4209;894;2951;154;556;191;551;345;1107
410600;201702;1799;5216;1433;4503;345;1082;473;1516;818;2598
410610;201702;735;2054;575;1753;64;205;214;631;278;836
410620;201702;1684;5605;1235;4502;308;1214;121;412;429;1626
410630;201702;2392;7116;1652;5425;366;1334;158;418;524;1752
410640;201702;4521;12312;3302;10018;838;2927;493;1388;1331;4315
410645;201702;1123;3825;1041;3682;468;1725;239;907;707;2632
410650;201702;2055;6372;1662;5510;544;1924;262;800;806;2724
410655;201702;1002;3222;772;2768;78;294;366;1469;444;1763
410657;201702;767;2114;540;1647;123;415;169;444;292;859
410660;201702;2929;8207;1640;5345;329;1117;167;556;496;1673
410670;201702;895;2466;608;1848;125;394;206;601;331;995
410680;201702;2830;9110;2246;7687;696;2343;506;1873;1202;4216
410685;201702;624;1782;531;1614;84;306;292;850;376;1156
410690;201702;112585;320505;79620;251705;15732;55109;19802;55396;35534;110505
410700;201702;2069;6141;1896;5785;457;1476;833;2427;1290;3903
410710;201702;904;2605;601;1947;146;490;142;400;288;890
410712;201702;782;2365;684;2176;244;842;210;675;454;1517
410715;201702;875;2793;637;2204;132;485;157;530;289;1015
410720;201702;3096;9217;2380;7727;448;1598;396;1161;844;2759
410725;201702;1069;2977;735;2324;128;410;111;332;239;742
410730;201702;476;1369;374;1190;100;342;80;267;180;609
410740;201702;887;2604;634;2093;106;411;262;842;368;1253
410750;201702;1790;5210;1475;4569;299;1001;465;1375;764;2376
410752;201702;306;823;153;489;30;97;36;101;66;198
410753;201702;355;1051;220;738;29;100;43;134;72;234
410754;201702;1148;3271;989;3017;69;208;612;2037;681;2245
410755;201702;810;1997;598;1655;68;225;334;870;402;1095
410760;201702;2510;7412;2144;6774;564;1968;620;1926;1184;3894
410765;201702;14379;43191;11184;36970;2000;7504;988;3123;2988;10627
410770;201702;885;2456;623;1936;132;438;117;365;249;803
410773;201702;1318;3702;1173;3494;173;596;840;2440;1013;3036
410775;201702;1385;3940;1253;3742;318;1050;394;1172;712;2222
410780;201702;535;1460;364;1099;87;269;98;331;185;600
410785;201702;770;2398;654;2151;177;641;184;592;361;1233
410790;201702;449;1465;388;1303;111;393;36;97;147;490
410800;201702;2770;6848;2171;5852;292;909;802;2050;1094;2959
410810;201702;322;986;266;870;43;161;105;340;148;501
410820;201702;773;2307;558;1808;128;432;77;255;205;687
410830;201702;29014;81481;23097;71070;6345;21550;7289;21598;13634;43148
410832;201702;982;2809;836;2520;101;384;468;1325;569;1709
410840;201702;6555;18905;4342;14258;987;3557;370;984;1357;4541
410845;201702;1176;3459;994;3092;209;707;396;1202;605;1909
410850;201702;2602;7774;2304;7257;535;1873;850;2710;1385;4583
410855;201702;571;1574;420;1260;72;243;152;418;224;661
410860;201702;3749;10657;3020;9176;573;1889;904;2625;1477;4514
410865;201702;1439;4740;1372;4616;364;1315;727;2512;1091;3827
410870;201702;1236;3655;1130;3494;118;411;775;2414;893;2825
410880;201702;3642;11467;3027;10174;599;2213;427;1487;1026;3700
410890;201702;889;2874;683;2411;181;699;84;283;265;982
410895;201702;1031;3549;925;3306;357;1387;190;639;547;2026
410900;201702;905;2478;603;1882;85;291;182;522;267;813
410910;201702;385;991;273;787;23;77;144;394;167;471
410920;201702;805;2236;652;1982;166;573;216;658;382;1231
410930;201702;1529;4541;1262;3989;353;1274;325;983;678;2257
410940;201702;20586;64842;17203;58388;5308;19514;3237;11242;8545;30756
410950;201702;1780;5682;1650;5462;124;461;1276;4200;1400;4661
410960;201702;7458;20403;4662;15115;1333;4757;1026;3210;2359;7967
410965;201702;1045;3066;816;2600;215;719;272;825;487;1544
410970;201702;4051;11953;3177;10216;855;3178;493;1489;1348;4667
410975;201702;1571;4376;1224;3706;224;774;422;1243;646;2017
410980;201702;6174;17261;4090;13193;672;2426;1192;3725;1864;6151
410990;201702;946;2746;597;1991;191;703;69;180;260;883
411000;201702;482;1438;343;1133;59;217;63;173;122;390
411005;201702;471;1387;298;979;54;201;47;140;101;341
411007;201702;2274;7075;1995;6506;527;1829;568;1843;1095;3672
411010;201702;3953;13287;3577;12448;1055;3933;424;1453;1479;5386
411020;201702;2403;7350;2085;6786;645;2270;623;1960;1268;4230
411030;201702;631;1702;436;1286;78;266;125;319;203;585
411040;201702;748;2142;342;1118;60;207;65;204;125;411
411050;201702;1901;6492;1697;6061;520;2008;251;798;771;2806
411060;201702;1537;4580;1137;3705;239;913;147;459;386;1372
411065;201702;325;964;264;850;53;177;101;326;154;503
411070;201702;5981;17575;4815;15255;1134;3969;1292;3823;2426;7792
411080;201702;2066;6116;1835;5687;446;1533;544;1690;990;3223
411090;201702;783;2001;542;1595;69;238;88;245;157;483
411095;201702;1355;3804;973;2996;125;436;223;602;348;1038
411100;201702;1151;3363;825;2645;123;474;191;595;314;1069
411110;201702;554;1616;287;981;30;124;19;51;49;175
411120;201702;1566;4697;1188;3845;321;1215;268;756;589;1971
411125;201702;4021;13003;3774;12503;937;3293;1424;4768;2361;8061
411130;201702;654;1938;484;1578;101;329;135;473;236;802
411140;201702;2150;7224;1845;6475;437;1594;743;2674;1180;4268
411150;201702;3839;10777;2883;8854;634;2148;301;787;935;2935
411155;201702;939;2571;667;2066;85;285;272;803;357;1088
411160;201702;262;746;207;634;37;123;55;164;92;287
411170;201702;727;2256;584;1923;133;472;192;616;325;1088
411180;201702;5474;16042;4430;14040;922;3201;1466;4643;2388;7844
411190;201702;1366;3917;1116;3408;288;946;226;616;514;1562
411200;201702;4314;12607;3421;11044;899;3168;984;3075;1883;6243
411210;201702;1864;5286;1494;4614;375;1305;167;456;542;1761
411220;201702;920;2627;780;2349;176;606;309;863;485;1469
411230;201702;1218;3376;804;2573;172;577;211;669;383;1246
411240;201702;1527;3617;848;2448;131;403;346;927;477;1330
411250;201702;1902;5613;1574;5019;425;1480;427;1364;852;2844
411260;201702;326;841;213;644;24;75;91;256;115;331
411270;201702;1728;5347;1514;4910;239;886;704;2176;943;3062
411275;201702;1299;3756;1027;3155;236;759;231;649;467;1408
411280;201702;1491;4267;998;3201;187;657;202;608;389;1265
411290;201702;695;2042;528;1706;118;397;162;517;280;914
411295;201702;918;2520;824;2342;119;383;336;960;455;1343
411300;201702;1159;2936;761;2169;72;227;274;716;346;943
411310;201702;801;2195;640;1912;43;148;204;607;247;755
411320;201702;5015;14455;3661;11881;963;3291;672;2029;1635;5320
411325;201702;1483;4667;1319;4320;270;936;634;2112;904;3048
411330;201702;2918;9019;2412;8007;729;2671;567;1927;1296;4598
411340;201702;742;2275;530;1771;41;174;205;645;246;819
411342;201702;685;1902;565;1670;149;468;181;498;330;966
411345;201702;840;2601;760;2446;171;624;356;1129;527;1753
411350;201702;2724;8050;2010;6576;558;1994;195;639;753;2633
411360;201702;577;1453;403;1166;47;168;152;399;199;567
411370;201702;44626;124255;35310;107058;4940;17317;16076;45440;21016;62757
411373;201702;1416;4279;1229;3947;259;982;335;1079;594;2061
411375;201702;1106;3011;817;2460;156;516;240;671;396;1187
411380;201702;1051;2902;663;1995;125;392;186;508;311;900
411390;201702;1726;5053;1346;4193;278;934;337;961;615;1895
411400;201702;2090;5824;1651;4943;320;1046;498;1434;818;2480
411410;201702;1985;6033;1531;4978;351;1257;323;922;674;2179
411420;201702;3904;10899;2651;8338;418;1486;407;1031;825;2517
411430;201702;3246;9540;2699;8641;589;2054;1285;4057;1874;6111
411435;201702;434;1397;365;1215;75;258;136;420;211;678
411440;201702;2689;8543;2368;7841;674;2323;525;1863;1199;4186
411450;201702;2319;7012;2099;6591;451;1438;970;3192;1421;4630
411460;201702;3394;9822;1857;6339;294;1164;105;342;399;1506
411470;201702;782;2326;540;1772;90;332;92;263;182;595
411480;201702;4354;13075;3242;10856;766;2831;488;1551;1254;4382
411490;201702;1374;4131;1131;3677;232;833;272;834;504;1667
411500;201702;1814;4792;1283;3850;241;828;391;1160;632;1988
411510;201702;1969;5818;1619;5099;420;1476;283;860;703;2336
411520;201702;25153;68206;15495;48054;2594;8756;3429;9684;6023;18440
411530;201702;931;2616;663;2120;143;512;178;549;321;1061
411535;201702;484;1445;228;800;28;127;15;34;43;161
411540;201702;2962;7954;2180;6367;519;1692;592;1573;1111;3265
411545;201702;983;3157;878;2947;122;446;550;1902;672;2348
411550;201702;729;1970;592;1748;165;534;96;275;261;809
411560;201702;2178;6367;1480;4793;224;804;118;314;342;1118
411570;201702;6965;18188;5058;15126;1147;3898;1073;3300;2220;7198
411573;201702;806;2358;757;2279;86;270;498;1513;584;1783
411575;201702;1572;4829;1336;4348;317;1084;436;1429;753;2513
411580;201702;3839;10805;2543;8212;323;1248;315;865;638;2113
411585;201702;790;2503;405;1425;76;275;55;178;131;453
411590;201702;354;1057;300;955;36;128;144;427;180;555
411600;201702;310;864;213;709;45;171;82;280;127;451
411605;201702;1635;4458;1080;3287;164;576;394;1152;558;1728
411610;201702;2149;6016;1683;5092;370;1216;635;1870;1005;3086
411620;201702;2766;8464;2492;8022;518;1824;1303;4208;1821;6032
411630;201702;506;1351;343;1107;75;287;49;122;124;409
411640;201702;449;1383;346;1132;42;139;115;351;157;490
411650;201702;207;650;154;542;31;121;21;70;52;191
411660;201702;919;2432;663;1975;78;254;319;922;397;1176
411670;201702;1050;2963;831;2476;156;486;272;799;428;1285
411680;201702;1492;4366;1281;3980;242;839;625;1947;867;2786
411690;201702;3282;9540;2581;8230;594;1967;656;2179;1250;4146
411695;201702;680;2203;529;1848;101;373;170;618;271;991
411700;201702;1618;4645;1133;3680;235;849;155;465;390;1314
411705;201702;1783;6166;1580;5760;382;1389;777;3001;1159;4390
411710;201702;1625;4728;1301;4077;329;1103;232;751;561;1854
411720;201702;865;2425;677;2036;111;380;175;480;286;860
411721;201702;748;2191;601;1871;146;477;82;248;228;725
411722;201702;637;1926;414;1410;79;305;94;278;173;583
411725;201702;1357;4317;858;3073;176;662;160;587;336;1249
411727;201702;1671;4915;1209;3896;328;1085;210;646;538;1731
411729;201702;622;1607;429;1243;107;320;98;238;205;558
411730;201702;5302;15162;4457;13550;1482;4651;1112;3372;2594;8023
411740;201702;622;1746;372;1206;67;234;64;187;131;421
411745;201702;893;2557;717;2181;131;416;206;607;337;1023
411750;201702;4937;14570;3803;12032;638;2200;1363;4134;2001;6334
411760;201702;7540;21926;6409;19946;2085;6911;1384;4474;3469;11385
411770;201702;3318;10741;2726;9352;773;2814;428;1434;1201;4248
411780;201702;2831;8604;2603;8216;624;2121;1314;4317;1938;6438
411790;201702;3321;9284;2211;6956;539;1865;436;1320;975;3185
411800;201702;1118;3236;766;2437;112;398;101;280;213;678
411810;201702;1668;4705;1345;4078;274;925;547;1562;821;2487
411820;201702;12572;40672;10651;36565;3727;13242;2536;8945;6263;22187
411830;201702;535;1369;404;1140;116;380;21;74;137;454
411840;201702;10129;28627;7451;23287;1660;5720;1467;4549;3127;10269
411845;201702;489;1499;301;998;53;203;24;67;77;270
411850;201702;7267;21400;5968;18792;1552;5336;1521;4671;3073;10007
411860;201702;861;2622;693;2247;136;477;221;674;357;1151
411870;201702;817;2633;560;1928;113;439;108;335;221;774
411880;201702;2148;6216;1695;5412;453;1647;311;939;764;2586
411885;201702;952;2640;804;2377;139;523;276;750;415;1273
411890;201702;1095;3357;760;2556;118;462;46;127;164;589
411900;201702;920;2868;612;2100;135;459;69;238;204;697
411910;201702;1154;3664;877;3021;233;854;210;661;443;1515
411915;201702;17110;45857;10781;33496;1994;6763;2350;6674;4344;13437
411920;201702;861;2875;755;2614;214;853;95;272;309;1125
411925;201702;589;1668;403;1322;98;343;94;289;192;632
411930;201702;5647;18642;4996;17335;2312;8614;541;1960;2853;10574
411940;201702;3098;10265;2681;9350;750;2780;537;1752;1287;4532
411950;201702;12544;38886;10721;35376;2323;8285;4715;15307;7038;23592
411960;201702;5276;15460;4861;14698;964;3229;1977;5776;2941;9005
411965;201702;530;1473;373;1203;73;274;92;302;165;576
411970;201702;761;2064;656;1911;150;434;318;1021;468;1455
411980;201702;1602;4679;1378;4241;333;1073;414;1274;747;2347
411990;201702;31789;97707;24582;82553;5943;22167;6794;21959;12737;44126
411995;201702;2437;7262;2058;6585;601;2186;524;1584;1125;3770
412000;201702;2262;5510;1715;4597;229;773;883;2116;1112;2889
412010;201702;674;2274;537;1946;79;325;129;424;208;749
412015;201702;628;1863;522;1657;91;292;241;770;332;1062
412020;201702;330;1007;226;752;40;132;55;165;95;297
412030;201702;734;2197;526;1759;90;359;147;438;237;797
412033;201702;860;2451;593;1849;82;273;154;470;236;743
412035;201702;951;2601;602;1955;114;395;193;603;307;998
412040;201702;584;1762;437;1451;68;239;76;246;144;485
412050;201702;1742;4937;1318;4115;219;776;296;920;515;1696
412060;201702;6977;23401;6282;22018;1888;7206;1788;6236;3676;13442
412065;201702;781;2353;602;1967;132;475;171;534;303;1009
412070;201702;1294;3431;952;2727;140;440;383;1062;523;1502
412080;201702;1461;4487;913;3246;116;464;28;81;144;545
412085;201702;431;1248;149;519;17;64;12;31;29;95
412090;201702;4594;13670;4246;13037;886;2768;2242;7124;3128;9892
412100;201702;1832;5565;1460;4846;433;1546;310;1037;743;2583
412110;201702;1063;2970;728;2261;151;510;141;462;292;972
412120;201702;1623;5520;1383;4956;334;1309;401;1291;735;2600
412125;201702;617;2011;561;1893;134;495;188;611;322;1106
412130;201702;557;1684;431;1384;107;362;75;236;182;598
412135;201702;502;1398;300;935;55;171;101;291;156;462
412140;201702;1487;4407;1187;3744;260;897;209;611;469;1508
412150;201702;2955;8414;2528;7535;324;1081;1489;4311;1813;5392
412160;201702;1202;3830;751;2642;187;728;75;248;262;976
412170;201702;4494;13549;3699;12022;921;3292;1401;4320;2322;7612
412175;201702;1449;4666;1261;4272;257;941;609;2068;866;3009
412180;201702;1663;4988;1254;4199;260;1019;437;1341;697;2360
412190;201702;3313;9194;2471;7641;437;1477;839;2739;1276;4216
412200;201702;2043;6418;1506;5084;289;1037;436;1493;725;2530
412210;201702;643;1737;380;1192;75;282;51;119;126;401
412215;201702;3499;10589;3127;9888;767;2406;1636;5411;2403;7817
412217;201702;1077;3039;948;2792;81;309;668;1859;749;2168
412220;201702;5604;17853;5214;17135;1460;4798;2117;7258;3577;12056
412230;201702;2846;9238;2436;8388;475;1846;669;2148;1144;3994
412240;201702;8655;22113;5193;15709;951;3278;1021;2860;1972;6138
412250;201702;1841;5356;1566;4797;364;1192;197;514;561;1706
412260;201702;1284;3542;856;2612;119;409;303;827;422;1236
412265;201702;937;2847;821;2640;213;747;307;987;520;1734
412270;201702;836;2592;562;1918;95;368;195;620;290;988
412280;201702;622;1909;471;1594;168;618;32;78;200;696
412290;201702;997;2795;747;2342;150;511;227;669;377;1180
412300;201702;1620;4923;1415;4517;387;1340;312;940;699;2280
412310;201702;949;2793;798;2531;117;489;360;1134;477;1623
412320;201702;840;2253;617;1841;101;378;197;573;298;951
412330;201702;1450;4158;1053;3321;140;483;437;1386;577;1869
412340;201702;893;2782;610;2048;83;306;107;328;190;634
412350;201702;2222;6813;1637;5487;336;1210;59;138;395;1348
412360;201702;294;854;177;567;19;74;58;166;77;240
412370;201702;859;2529;635;2125;137;497;100;338;237;835
412380;201702;1499;4640;1219;3974;294;1004;251;828;545;1832
412382;201702;658;1823;461;1417;68;224;113;319;181;543
412385;201702;2258;6947;2006;6367;710;2324;521;1710;1231;4034
412390;201702;2082;5874;1873;5528;436;1380;791;2396;1227;3776
412395;201702;751;2144;580;1827;76;279;284;858;360;1137
412400;201702;842;2612;697;2282;174;595;172;585;346;1180
412402;201702;1773;5157;1420;4443;308;1086;295;853;603;1939
412405;201702;3377;9803;2099;6896;325;1227;90;262;415;1489
412410;201702;4885;14467;3932;12646;1019;3787;807;2505;1826;6292
412420;201702;380;1125;249;805;43;150;78;211;121;361
412430;201702;542;1511;387;1215;64;228;111;326;175;554
412440;201702;2993;9086;2302;7734;567;2080;530;1800;1097;3880
412450;201702;262;868;204;711;28;94;20;55;48;149
412460;201702;687;2186;576;1933;154;535;99;340;253;875
412470;201702;1833;6167;1534;5408;493;1835;306;1157;799;2992
412480;201702;1111;3312;761;2427;117;403;107;271;224;674
412490;201702;867;2550;732;2272;141;452;259;757;400;1209
412500;201702;1848;5292;1536;4663;291;985;351;948;642;1933
412510;201702;2156;6994;1730;5950;509;1901;339;1079;848;2980
412520;201702;1389;3962;1042;3230;297;960;130;376;427;1336
412530;201702;546;1609;425;1327;80;271;73;226;153;497
412535;201702;832;2478;601;1933;91;302;189;618;280;920
412540;201702;1198;3392;904;2788;129;466;265;831;394;1297
412545;201702;697;2014;530;1641;85;282;164;454;249;736
412550;201702;30197;89799;21259;69951;4629;16245;4659;14482;9288;30727
412555;201702;243;715;169;546;26;86;35;96;61;182
412560;201702;5265;16041;4061;13345;787;3006;1021;3218;1808;6224
412570;201702;4112;11891;2735;8958;602;2200;380;1257;982;3457
412575;201702;840;2574;670;2150;132;460;203;616;335;1076
412580;201702;1248;3448;896;2745;166;568;330;930;496;1498
412590;201702;446;1300;281;943;58;201;56;178;114;379
412600;201702;1410;4263;1056;3459;218;794;281;866;499;1660
412610;201702;717;2136;458;1485;102;343;135;413;237;756
412620;201702;1182;3690;932;3191;260;1027;165;485;425;1512
412625;201702;8192;23735;6093;19481;1219;4248;569;1705;1788;5953
412627;201702;940;2890;675;2266;200;747;140;466;340;1213
412630;201702;3113;9761;2400;8140;488;1672;663;2146;1151;3818
412635;201702;456;1321;316;1009;68;229;32;74;100;303
412640;201702;884;2631;565;1882;88;326;66;213;154;539
412650;201702;1574;4732;1321;4228;278;1031;397;1166;675;2197
412660;201702;2508;7103;1971;6062;413;1434;424;1160;837;2594
412665;201702;632;1629;358;1094;93;294;82;237;175;531
412667;201702;1647;4649;1296;3945;264;878;410;1204;674;2082
412670;201702;510;1566;412;1380;115;431;68;211;183;642
412680;201702;1341;3974;834;2854;130;492;191;576;321;1068
412690;201702;745;2213;593;1902;134;464;128;422;262;886
412700;201702;1820;5428;1522;4971;465;1725;406;1265;871;2990
412710;201702;6204;19625;5268;17684;1171;4340;1301;4034;2472;8374
412720;201702;1350;4144;980;3240;159;565;172;481;331;1046
412730;201702;2055;6153;1211;4169;264;961;129;423;393;1384
412740;201702;1464;4638;1076;3739;240;932;128;485;368;1417
412750;201702;4032;12083;3578;11305;495;1821;2151;6678;2646;8499
412760;201702;2364;7402;2213;7131;274;1027;1429;4505;1703;5532
412770;201702;10371;28537;5965;19198;837;2929;984;2799;1821;5728
412780;201702;1250;3761;1064;3405;221;787;425;1295;646;2082
412785;201702;2145;5968;1633;4964;403;1235;713;2249;1116;3484
412788;201702;1420;4467;1208;4013;329;1231;330;983;659;2214
412790;201702;1055;3152;732;2423;172;612;136;371;308;983
412795;201702;978;2688;700;2118;129;410;258;766;387;1176
412796;201702;2603;7921;2368;7461;512;1756;955;2862;1467;4618
412800;201702;3057;8626;2307;7013;358;1244;803;2269;1161;3513
412810;201702;11133;30174;6676;20760;906;3239;1559;4087;2465;7326
412820;201702;7192;20934;5342;17215;1189;4065;1336;4363;2525;8428
412830;201702;358;1095;265;897;46;172;57;192;103;364
412840;201702;1804;5076;1445;4340;246;802;345;1023;591;1825
412850;201702;2737;7963;2190;6991;425;1556;652;1929;1077;3485
412853;201702;1726;4916;1524;4521;152;501;798;2223;950;2724
412855;201702;1357;3938;1012;3131;210;721;207;525;417;1246
412860;201702;1133;3234;901;2787;240;824;299;865;539;1689
412862;201702;739;1903;487;1449;82;266;128;395;210;661
412863;201702;1142;3811;1111;3756;134;507;812;2705;946;3212
412865;201702;698;2070;526;1728;109;365;157;540;266;905
412870;201702;894;2563;707;2232;282;988;82;253;364;1241
412880;201702;778;2319;600;1929;154;566;42;105;196;671
420005;201702;521;1553;311;1069;53;209;102;332;155;541
420010;201702;3176;8793;2528;7871;317;1042;1701;5366;2018;6408
420020;201702;663;2115;390;1425;51;223;43;136;94;359
420030;201702;442;1147;225;756;51;207;23;80;74;287
420040;201702;667;2127;401;1512;85;355;28;84;113;439
420050;201702;698;1991;464;1501;98;339;185;586;283;925
420055;201702;187;570;105;368;19;73;17;55;36;128
420060;201702;224;723;154;551;21;93;29;87;50;180
420070;201702;1251;3996;950;3266;182;687;352;1225;534;1912
420075;201702;162;432;84;260;17;57;10;19;27;76
420080;201702;575;1805;472;1602;138;488;132;459;270;947
420090;201702;396;1351;284;1072;74;288;52;208;126;496
420100;201702;1144;3605;1050;3469;220;777;620;2044;840;2821
420110;201702;285;967;266;923;71;253;86;294;157;547
420120;201702;266;912;216;797;62;259;57;186;119;445
420125;201702;298;1082;271;1026;75;300;123;460;198;760
420127;201702;449;1285;166;598;39;162;17;49;56;211
420130;201702;1796;6019;1428;5257;390;1593;271;913;661;2506
420140;201702;4094;12164;3010;10022;703;2661;449;1316;1152;3977
420150;201702;540;1523;370;1230;47;174;173;550;220;724
420160;201702;257;709;153;511;30;99;42;140;72;239
420165;201702;214;666;126;438;26;102;31;101;57;203
420170;201702;204;628;132;479;39;173;14;45;53;218
420180;201702;367;1089;205;718;31;113;46;153;77;266
420190;201702;356;1096;185;680;33;128;12;35;45;163
420195;201702;1306;3854;1061;3409;276;975;224;679;500;1654
420200;201702;2419;7409;1479;5305;321;1328;249;822;570;2150
420205;201702;1053;3347;856;2972;179;683;459;1602;638;2285
420207;201702;1448;4233;1010;3342;291;1090;201;635;492;1725
420208;201702;578;1536;320;1096;78;299;102;365;180;664
420209;201702;277;851;175;606;30;119;76;254;106;373
420210;201702;1847;5447;1203;4382;289;1256;431;1480;720;2736
420213;201702;759;2671;708;2557;172;685;368;1328;540;2013
420215;201702;304;973;202;724;53;198;16;66;69;264
420220;201702;167;578;138;518;36;152;46;161;82;313
420230;201702;4074;11974;3106;10255;603;2370;1119;3536;1722;5906
420240;201702;10583;29354;6891;22457;1079;4159;2949;8734;4028;12893
420243;201702;586;1743;463;1507;93;320;160;520;253;840
420245;201702;1241;3644;852;2853;128;507;315;949;443;1456
420250;201702;495;1591;443;1492;94;371;200;644;294;1015
420253;201702;482;1263;366;1104;36;107;222;697;258;804
420257;201702;283;776;176;580;39;132;71;236;110;368
420260;201702;1124;3581;910;3185;190;740;376;1309;566;2049
420270;201702;653;1927;246;843;38;142;58;172;96;314
420280;201702;2061;5586;1264;4169;273;1000;391;1221;664;2221
420285;201702;148;427;71;260;11;47;5;11;16;58
420287;201702;495;1443;406;1307;133;465;125;405;258;870
420290;201702;5735;17178;3951;13097;787;2800;1144;3481;1931;6281
420300;201702;6555;19469;4158;14264;898;3451;772;2441;1670;5892
420310;201702;792;2104;623;1773;78;262;445;1212;523;1474
420315;201702;921;2893;709;2471;221;822;214;738;435;1560
420320;201702;4432;13621;3653;12223;1122;4201;1123;3655;2245;7856
420325;201702;197;656;170;594;31;112;64;216;95;328
420330;201702;926;3150;686;2557;137;564;195;686;332;1250
420340;201702;1386;4235;1034;3441;205;756;82;245;287;1001
420350;201702;1445;4230;1049;3440;256;927;404;1270;660;2197
420360;201702;2850;8618;1756;6230;364;1464;154;510;518;1974
420370;201702;1725;4963;1364;4333;170;598;916;2860;1086;3458
420380;201702;5191;15382;3465;11608;796;2905;889;2878;1685;5783
420390;201702;1198;3370;703;2336;134;515;141;361;275;876
420395;201702;1273;3902;865;2969;128;500;94;276;222;776
420400;201702;1160;3433;811;2733;183;693;163;506;346;1199
420410;201702;688;1845;477;1480;79;287;275;821;354;1108
420415;201702;458;1404;333;1115;90;307;93;321;183;628
420417;201702;695;2200;563;1870;105;377;242;789;347;1166
420419;201702;303;992;213;786;76;306;13;53;89;359
420420;201702;10223;30932;8216;27011;2873;10248;1746;5400;4619;15648
420425;201702;1175;3130;797;2431;88;340;341;984;429;1324
420430;201702;3303;10025;2158;7311;462;1733;652;2136;1114;3869
420435;201702;265;781;165;562;36;146;74;238;110;384
420440;201702;783;2427;453;1545;164;609;95;288;259;897
420445;201702;376;1076;248;790;47;163;83;253;130;416
420450;201702;748;2290;530;1800;106;403;125;392;231;795
420455;201702;1886;5512;1584;4989;258;1020;730;2148;988;3168
420460;201702;8546;24866;6564;21378;1465;5476;2460;7612;3925;13088
420470;201702;1022;2678;579;1840;111;396;175;524;286;920
420475;201702;97;280;49;173;19;65;5;15;24;80
420480;201702;4792;13786;3453;11232;820;2881;662;2131;1482;5012
420490;201702;634;1660;353;1189;87;325;68;247;155;572
420500;201702;1423;4499;1080;3823;353;1390;322;1130;675;2520
420510;201702;118;441;90;366;22;101;44;180;66;281
420515;201702;75;233;60;209;13;53;17;61;30;114
420517;201702;834;2539;733;2358;112;391;441;1393;553;1784
420519;201702;462;1202;298;907;53;175;75;213;128;388
420520;201702;640;1645;332;1089;60;202;63;165;123;367
420530;201702;1154;3653;828;2940;185;754;207;636;392;1390
420535;201702;257;733;126;434;27;92;12;53;39;145
420540;201702;21922;61204;15287;47442;3356;11510;3983;10590;7339;22100
420543;201702;355;923;281;805;46;105;183;547;229;652
420545;201702;1555;4829;1240;4141;296;1084;369;1174;665;2258
420550;201702;3913;12174;2858;10080;766;3195;513;1722;1279;4917
420555;201702;349;1049;267;883;47;170;96;300;143;470
420560;201702;470;1368;354;1158;63;216;178;566;241;782
420570;201702;2117;6659;1621;5557;387;1506;519;1652;906;3158
420580;201702;1520;4556;1197;4011;284;1102;485;1601;769;2703
420590;201702;3199;9491;2081;6904;427;1573;335;935;762;2508
420600;201702;905;2916;822;2745;156;548;466;1598;622;2146
420610;201702;488;1482;276;997;66;266;60;209;126;475
420620;201702;533;1640;474;1525;126;434;133;428;259;862
420630;201702;965;2943;706;2323;166;602;260;782;426;1384
420640;201702;762;2268;381;1384;96;392;31;111;127;503
420650;201702;2405;6996;1560;5314;264;950;374;1167;638;2117
420660;201702;463;1368;327;1082;58;213;97;321;155;534
420665;201702;674;1879;457;1488;69;262;150;439;219;701
420670;201702;1637;4808;1154;3805;226;906;273;796;499;1702
420675;201702;180;595;136;483;26;111;30;100;56;211
420680;201702;442;1052;251;764;42;141;91;268;133;409
420690;201702;826;2864;619;2283;106;428;102;321;208;749
420700;201702;3040;8948;2356;7584;457;1619;785;2406;1242;4025
420710;201702;619;2036;471;1710;125;519;150;514;275;1033
420720;201702;1618;4646;1269;4148;376;1290;534;1756;910;3046
420730;201702;3049;9090;2502;8145;539;1937;1073;3401;1612;5338
420740;201702;795;2448;631;2119;192;696;192;614;384;1310
420750;201702;2048;6556;1539;5388;248;965;484;1542;732;2507
420757;201702;94;215;36;127;6;23;16;58;22;81
420760;201702;377;1183;196;670;44;157;25;74;69;231
420765;201702;539;1708;284;1057;67;268;55;203;122;471
420768;201702;1180;3994;950;3526;370;1349;341;1375;711;2724
420770;201702;519;1553;307;1126;71;299;58;212;129;511
420775;201702;623;1870;357;1230;76;283;48;157;124;440
420780;201702;1399;4211;841;2882;157;570;125;396;282;966
420785;201702;261;788;201;645;31;105;53;148;84;253
420790;201702;1208;4106;951;3539;259;1070;347;1223;606;2293
420800;201702;877;2436;445;1449;85;304;140;442;225;746
420810;201702;1945;6559;1573;5770;507;2106;328;1125;835;3231
420820;201702;8358;24784;5869;20524;1439;5636;1523;5228;2962;10864
420830;201702;2731;8442;2228;7500;631;2334;723;2411;1354;4745
420840;201702;989;2876;481;1701;89;355;87;293;176;648
420845;201702;1423;4173;951;3310;246;1004;206;686;452;1690
420850;201702;1473;4665;908;3394;205;859;66;232;271;1091
420860;201702;376;1057;218;755;62;238;38;132;100;370
420870;201702;1046;2940;824;2587;293;1055;209;586;502;1641
420880;201702;972;3283;761;2731;167;670;130;408;297;1078
420890;201702;9018;24236;4753;15659;813;2985;1077;3112;1890;6097
420895;201702;204;590;118;385;35;113;18;55;53;168
420900;201702;1752;4919;1135;3756;228;867;291;878;519;1745
420910;201702;24190;70769;16747;56394;3077;11676;5170;16178;8247;27854
420915;201702;531;2088;384;1648;78;357;165;652;243;1009
420917;201702;476;1445;221;721;36;136;83;242;119;378
420920;201702;169;491;77;271;11;46;10;31;21;77
420930;201702;17959;50956;13664;43529;2860;10109;5351;16380;8211;26489
420940;201702;2797;8240;2076;6842;548;2011;159;470;707;2481
420945;201702;197;595;131;447;29;116;34;106;63;222
420950;201702;563;1550;290;1016;42;188;64;216;106;404
420960;201702;915;2594;723;2257;138;483;285;844;423;1327
420970;201702;2390;7557;1971;6770;637;2368;427;1512;1064;3880
420980;201702;439;1290;338;1138;123;446;120;444;243;890
420985;201702;475;1344;220;785;47;195;54;186;101;381
420990;201702;776;2184;436;1504;81;305;63;185;144;490
421000;201702;541;1843;356;1372;73;306;58;186;131;492
421003;201702;669;1788;250;843;29;101;20;52;49;153
421005;201702;138;417;105;361;25;91;51;188;76;279
421010;201702;4940;13987;3495;11453;818;2994;729;2201;1547;5195
421020;201702;433;1326;319;1123;35;148;183;634;218;782
421030;201702;731;2606;640;2372;212;872;96;343;308;1215
421040;201702;884;2226;566;1740;92;327;273;813;365;1140
421050;201702;1542;4458;909;3093;188;692;190;613;378;1305
421055;201702;197;553;106;339;23;73;20;44;43;117
421060;201702;530;1735;360;1296;89;352;115;409;204;761
421070;201702;652;2062;425;1501;86;332;64;223;150;555
421080;201702;768;3292;691;3178;88;283;544;2709;632;2992
421085;201702;493;1373;251;875;51;199;62;199;113;398
421090;201702;392;1087;182;604;28;106;46;144;74;250
421100;201702;950;2529;500;1581;120;401;54;158;174;559
421105;201702;1452;4339;1169;3864;247;878;383;1323;630;2201
421110;201702;936;3306;856;3123;328;1252;184;611;512;1863
421120;201702;1258;4038;849;3052;124;524;199;619;323;1143
421125;201702;402;1107;300;939;84;289;89;249;173;538
421130;201702;3103;10231;2677;9385;880;3322;894;3211;1774;6533
421140;201702;313;900;232;735;43;141;90;260;133;401
421145;201702;543;1692;337;1141;52;180;94;315;146;495
421150;201702;617;1763;448;1494;96;374;174;545;270;919
421160;201702;1142;3147;568;1855;113;419;182;558;295;977
421165;201702;223;753;189;674;27;91;88;332;115;423
421170;201702;1279;3627;1018;3222;167;573;586;1851;753;2424
421175;201702;1174;3330;814;2665;161;648;292;848;453;1496
421180;201702;525;1449;268;903;54;208;48;156;102;364
421185;201702;399;1096;282;877;60;188;117;385;177;573
421187;201702;327;976;227;741;36;121;84;253;120;374
421189;201702;398;1227;315;1049;62;228;89;286;151;514
421190;201702;11310;31976;6961;23524;1498;5643;1070;3410;2568;9053
421200;201702;896;2918;750;2615;168;633;248;813;416;1446
421205;201702;205;621;148;501;38;153;38;112;76;265
421210;201702;1377;4148;1007;3315;265;894;251;837;516;1731
421220;201702;1699;5782;1500;5325;483;1904;228;691;711;2595
421223;201702;509;1591;369;1309;81;315;134;491;215;806
421225;201702;1082;3436;920;3097;206;748;366;1256;572;2004
421227;201702;785;2450;679;2267;136;527;380;1228;516;1755
421230;201702;444;1424;376;1305;87;320;162;549;249;869
421240;201702;394;1241;216;790;25;122;32;97;57;219
421250;201702;1570;4499;1019;3538;282;1057;198;687;480;1744
421260;201702;351;989;87;311;19;63;15;54;34;117
421265;201702;786;2346;694;2202;110;403;424;1313;534;1716
421270;201702;729;1997;382;1264;78;256;83;298;161;554
421280;201702;1544;4878;1222;4297;305;1235;504;1724;809;2959
421290;201702;1002;2808;591;1894;91;325;104;302;195;627
421300;201702;289;862;218;716;53;220;88;256;141;476
421310;201702;205;630;159;516;29;101;51;168;80;269
421315;201702;321;968;190;674;33;125;29;97;62;222
421320;201702;608;1850;377;1300;70;250;59;150;129;400
421330;201702;567;1826;433;1566;134;530;91;341;225;871
421335;201702;465;1576;392;1426;88;364;79;303;167;667
421340;201702;1725;4838;1357;4249;186;717;736;2263;922;2980
421350;201702;1047;3372;887;3052;149;618;486;1602;635;2220
421360;201702;2747;7877;1741;5919;353;1392;498;1584;851;2976
421370;201702;535;1809;403;1503;124;509;118;430;242;939
421380;201702;894;2578;762;2334;124;432;383;1112;507;1544
421390;201702;179;504;78;264;20;76;23;68;43;144
421400;201702;281;945;203;795;58;259;69;245;127;504
421410;201702;300;855;183;623;25;98;73;246;98;344
421415;201702;361;1168;159;587;34;136;25;88;59;224
421420;201702;758;2264;576;1874;94;347;226;668;320;1015
421430;201702;198;642;151;544;33;132;37;134;70;266
421440;201702;826;2336;557;1880;112;429;235;790;347;1219
421450;201702;422;1287;255;914;38;152;25;99;63;251
421460;201702;579;1615;308;1109;57;226;73;275;130;501
421470;201702;381;1253;296;1069;79;327;81;272;160;599
421480;201702;3021;8467;1987;6670;669;2654;269;699;938;3353
421490;201702;270;806;126;475;25;109;21;74;46;183
421500;201702;2029;6890;1666;6128;540;2220;216;785;756;3005
421505;201702;354;1142;309;1041;71;249;142;475;213;724
421507;201702;534;1595;353;1220;83;310;88;305;171;615
421510;201702;175;560;138;484;24;108;65;180;89;288
421520;201702;729;1997;492;1486;68;245;197;529;265;774
421530;201702;315;982;184;681;33;149;33;108;66;257
421535;201702;652;1890;360;1284;40;162;156;518;196;680
421540;201702;326;873;243;731;57;188;88;240;145;428
421545;201702;784;2455;572;2052;146;591;156;539;302;1130
421550;201702;2025;6301;1703;5753;501;1934;561;1786;1062;3720
421555;201702;316;912;111;386;18;72;15;42;33;114
421560;201702;169;533;77;276;16;63;13;47;29;110
421565;201702;752;2196;668;2095;202;708;321;1029;523;1737
421567;201702;581;2110;506;1932;256;1006;121;470;377;1476
421568;201702;507;1541;345;1172;70;254;99;334;169;588
421569;201702;230;689;102;372;21;76;15;58;36;134
421570;201702;1339;4006;779;2683;178;651;126;414;304;1065
421575;201702;344;1182;302;1057;49;183;156;536;205;719
421580;201702;2905;9165;2202;7619;525;2103;590;1798;1115;3901
421590;201702;213;647;168;560;25;90;86;279;111;369
421600;201702;475;1490;365;1228;82;305;83;249;165;554
421605;201702;598;1831;439;1534;86;340;130;441;216;781
421610;201702;1359;3696;957;2949;153;520;357;1053;510;1573
421620;201702;4356;13082;2886;10035;791;2945;763;2655;1554;5600
421625;201702;372;1024;154;520;34;111;16;51;50;162
421630;201702;2890;8522;1654;5632;329;1267;259;817;588;2084
421635;201702;221;661;117;388;15;67;32;76;47;143
421640;201702;1048;3050;743;2467;155;546;260;851;415;1397
421650;201702;2130;6731;1589;5519;418;1670;201;575;619;2245
421660;201702;7373;23872;6170;21458;1361;5303;2006;6495;3367;11798
421670;201702;1038;3083;723;2391;181;684;205;637;386;1321
421680;201702;1123;3581;919;3147;309;1135;210;691;519;1826
421690;201702;1436;4653;1072;3812;242;974;130;403;372;1377
421700;201702;464;1505;252;957;46;189;64;220;110;409
421710;201702;208;688;96;351;16;60;26;83;42;143
421715;201702;219;578;115;371;26;81;40;122;66;203
421720;201702;1900;5592;1183;4134;299;1170;175;534;474;1704
421725;201702;134;407;99;332;35;126;23;70;58;196
421730;201702;578;1645;278;928;40;140;71;214;111;354
421740;201702;674;2174;463;1646;107;435;84;278;191;713
421750;201702;975;2552;591;1811;104;346;212;591;316;937
421755;201702;303;874;171;555;37;136;50;152;87;288
421760;201702;903;2734;452;1623;71;263;84;292;155;555
421770;201702;2823;8417;2132;7072;506;1750;697;2432;1203;4182
421775;201702;463;1344;323;1083;56;210;112;359;168;569
421780;201702;997;3407;763;2841;192;829;212;719;404;1548
421790;201702;774;2055;455;1570;186;700;107;324;293;1024
421795;201702;344;1001;217;692;40;137;60;182;100;319
421800;201702;2624;7843;1961;6584;440;1613;744;2388;1184;4001
421810;201702;571;1743;407;1406;111;426;64;204;175;630
421820;201702;972;2817;587;1991;94;348;77;218;171;566
421825;201702;1433;4490;1345;4328;167;604;952;2990;1119;3594
421830;201702;2462;8289;2171;7704;539;2109;759;2558;1298;4667
421835;201702;160;474;119;415;17;76;77;262;94;338
421840;201702;285;895;201;710;44;187;68;211;112;398
421850;201702;425;1349;251;900;43;180;56;183;99;363
421860;201702;295;902;190;682;38;153;44;130;82;283
421870;201702;3657;10336;2554;8116;734;2557;557;1725;1291;4282
421875;201702;391;1153;181;661;33;135;19;59;52;194
421880;201702;808;2463;606;2026;143;530;121;374;264;904
421885;201702;289;905;236;819;74;272;66;216;140;488
421890;201702;819;2789;700;2550;246;1038;209;691;455;1729
421895;201702;381;1193;339;1122;67;247;200;660;267;907
421900;201702;939;2593;591;1883;155;513;151;462;306;975
421910;201702;484;1516;342;1202;71;304;68;206;139;510
421915;201702;480;1446;301;1026;61;208;55;189;116;397
421917;201702;587;1662;410;1397;133;517;113;371;246;888
421920;201702;678;1940;442;1612;222;828;116;452;338;1280
421930;201702;2969;7741;1587;5313;393;1436;231;699;624;2135
421935;201702;628;2028;474;1690;99;410;164;543;263;953
421940;201702;232;784;143;528;22;100;33;103;55;203
421950;201702;3433;9256;1632;5453;370;1350;206;681;576;2031
421960;201702;180;526;134;448;25;95;28;96;53;191
421970;201702;2313;6277;1351;4297;356;1181;353;1047;709;2228
421985;201702;450;1159;248;758;36;132;68;209;104;341
422000;201702;1275;3803;1060;3401;274;979;407;1304;681;2283
430003;201702;593;1888;499;1716;137;527;155;519;292;1046
430005;201702;326;961;231;775;49;183;95;301;144;484
430010;201702;2011;5506;1572;4740;372;1218;693;2106;1065;3324
430020;201702;659;1620;549;1471;85;273;339;870;424;1143
430030;201702;1036;2671;741;2138;224;674;162;460;386;1134
430040;201702;10599;28144;7630;22590;2029;6728;798;2222;2827;8950
430045;201702;686;1852;516;1510;79;244;218;627;297;871
430047;201702;286;669;131;388;16;51;43;128;59;179
430050;201702;1026;2803;591;1875;123;402;130;400;253;802
430055;201702;299;787;157;480;10;35;70;207;80;242
430057;201702;71;174;39;110;5;11;6;9;11;20
430060;201702;16625;52255;14302;48306;3944;14408;5535;18915;9479;33323
430063;201702;960;2819;756;2377;178;575;364;1154;542;1729
430064;201702;1201;3588;965;3149;255;871;308;1007;563;1878
430066;201702;169;391;115;305;8;25;63;163;71;188
430070;201702;636;1700;170;569;24;93;15;38;39;131
430080;201702;729;2032;441;1456;106;389;132;390;238;779
430085;201702;940;2404;582;1759;115;388;152;478;267;866
430087;201702;782;2464;693;2288;138;516;328;1006;466;1522
430090;201702;639;1681;242;787;31;118;59;189;90;307
430100;201702;846;2216;432;1361;105;352;118;326;223;678
430105;201702;1013;2898;667;2259;160;609;230;773;390;1382
430107;201702;217;708;162;563;28;103;40;127;68;230
430110;201702;1895;5345;1552;4817;340;1105;723;2163;1063;3268
430120;201702;1588;4801;1150;3867;265;919;460;1585;725;2504
430130;201702;3652;9601;3059;8662;895;2591;1018;3024;1913;5615
430140;201702;1158;3550;769;2652;207;751;231;783;438;1534
430150;201702;716;1908;459;1407;102;342;116;372;218;714
430155;201702;317;878;186;603;28;101;47;143;75;244
430160;201702;16486;47108;14266;43372;3346;11000;5617;17425;8963;28425
430163;201702;1909;5516;1527;4858;228;800;827;2635;1055;3435
430165;201702;462;1125;117;388;13;44;13;30;26;74
430170;201702;924;2633;369;1331;61;249;42;121;103;370
430175;201702;866;2715;731;2401;184;585;314;1079;498;1664
430180;201702;778;2164;658;1958;130;450;345;972;475;1422
430185;201702;504;1345;305;959;59;202;100;260;159;462
430187;201702;644;1908;513;1628;108;389;181;549;289;938
430190;201702;1579;4712;1367;4282;277;944;691;2118;968;3062
430192;201702;180;548;84;266;7;25;14;39;21;64
430195;201702;383;1163;95;320;9;34;2;7;11;41
430200;201702;1328;4237;1141;3843;347;1215;303;1019;650;2234
430205;201702;543;1543;412;1284;41;154;280;858;321;1012
430210;201702;5900;15595;3733;11102;544;1826;1159;2816;1703;4642
430215;201702;353;973;243;742;47;158;94;266;141;424
430220;201702;648;1660;229;773;36;142;38;120;74;262
430222;201702;259;811;208;695;39;147;92;293;131;440
430223;201702;356;1002;292;888;59;175;139;434;198;609
430225;201702;34;83;15;41;4;11;6;15;10;26
430230;201702;1610;4802;1540;4713;279;762;1175;3740;1454;4502
430235;201702;264;854;215;740;50;198;70;224;120;422
430237;201702;534;1346;384;1096;46;155;221;588;267;743
430240;201702;1010;2563;692;2056;92;345;345;964;437;1309
430245;201702;803;2509;625;2137;170;582;261;938;431;1520
430250;201702;1065;3098;955;2919;316;1048;107;301;423;1349
430258;201702;164;465;122;392;12;42;51;172;63;214
430260;201702;670;1920;512;1608;92;306;250;816;342;1122
430265;201702;270;828;213;721;51;174;36;121;87;295
430270;201702;2814;7782;2427;7142;354;1216;1447;4110;1801;5326
430280;201702;4686;12428;3755;10820;825;2452;1645;4801;2470;7253
430290;201702;2411;6274;2220;5990;113;349;1906;5114;2019;5463
430300;201702;8855;25796;7383;22987;1614;5445;3321;10451;4935;15896
430310;201702;6621;19602;5113;16730;1132;4117;1992;6190;3124;10307
430320;201702;823;2400;524;1749;99;304;235;822;334;1126
430330;201702;663;1761;518;1485;132;383;214;567;346;950
430340;201702;700;1723;360;1145;71;228;169;535;240;763
430350;201702;5874;17703;5017;15892;1783;5851;1509;4651;3292;10502
430355;201702;388;976;151;470;25;88;18;53;43;141
430360;201702;977;2594;780;2241;170;532;284;763;454;1295
430367;201702;231;636;152;478;37;141;50;145;87;286
430370;201702;525;1440;328;1046;73;248;70;205;143;453
430380;201702;711;1867;402;1295;127;456;98;306;225;762
430390;201702;3797;10499;2399;7671;428;1532;289;874;717;2406
430400;201702;1323;3191;989;2646;269;718;407;1056;676;1774
430410;201702;589;1563;421;1269;66;219;221;650;287;869
430420;201702;3429;9914;2738;8369;743;2370;919;2752;1662;5122
430430;201702;661;1811;426;1371;106;367;98;317;204;684
430435;201702;2017;5419;1473;4444;376;1171;446;1391;822;2562
430440;201702;4031;12538;3138;10496;647;2281;1298;4445;1945;6726
430450;201702;6911;19248;5707;16957;1689;5299;1657;5011;3346;10310
430460;201702;27696;81961;21484;70958;5783;21118;6269;20378;12052;41496
430461;201702;510;1346;167;530;23;72;43;133;66;205
430462;201702;288;810;192;645;32;119;36;135;68;254
430463;201702;3961;12594;3413;11545;757;2771;1616;5514;2373;8285
430465;201702;580;1609;498;1465;120;373;273;784;393;1157
430466;201702;3524;9432;3052;8697;673;2098;1589;4351;2262;6449
430467;201702;455;1337;381;1188;75;256;144;419;219;675
430468;201702;1350;3758;1134;3405;256;814;478;1401;734;2215
430469;201702;486;1319;64;214;10;28;8;19;18;47
430470;201702;7633;20318;5401;16625;1588;5187;997;3148;2585;8335
430471;201702;490;1622;442;1513;131;455;122;433;253;888
430480;201702;998;2652;527;1693;84;291;98;280;182;571
430485;201702;146;414;76;245;13;49;13;30;26;79
430490;201702;290;842;194;635;41;145;80;274;121;419
430495;201702;373;1112;247;856;51;190;73;237;124;427
430500;201702;1128;3117;936;2814;210;698;434;1263;644;1961
430510;201702;21819;62465;17151;53503;4947;16890;5078;14875;10025;31765
430511;201702;379;1176;169;592;33;121;14;32;47;153
430512;201702;1037;2665;890;2415;238;701;255;718;493;1419
430513;201702;798;2062;453;1321;106;337;168;460;274;797
430515;201702;460;1318;326;1047;53;165;145;484;198;649
430517;201702;1141;3584;939;3170;178;621;457;1569;635;2190
430520;201702;1478;4078;924;2890;182;658;211;598;393;1256
430530;201702;1098;2912;506;1606;75;264;123;361;198;625
430535;201702;2423;7162;1839;6034;388;1395;685;2190;1073;3585
430537;201702;460;1493;387;1327;36;142;264;892;300;1034
430540;201702;703;1558;466;1234;85;240;276;720;361;960
430543;201702;469;1182;411;1120;68;189;286;800;354;989
430544;201702;647;2054;537;1801;115;433;258;825;373;1258
430545;201702;1275;4106;1122;3922;367;1400;488;1701;855;3101
430550;201702;610;1722;356;1166;79;274;65;189;144;463
430558;201702;83;246;53;167;11;40;16;40;27;80
430560;201702;390;934;184;560;12;42;59;175;71;217
430570;201702;1070;2756;693;2020;134;452;282;708;416;1160
430580;201702;1198;2994;757;2277;106;346;372;1142;478;1488
430583;201702;171;454;43;135;5;14;5;18;10;32
430585;201702;306;772;183;525;30;106;79;195;109;301
430587;201702;157;494;122;401;27;88;31;110;58;198
430590;201702;1212;3290;1108;3116;99;325;858;2361;957;2686
430593;201702;23;85;21;78;5;20;8;28;13;48
430595;201702;293;841;85;293;9;40;10;27;19;67
430597;201702;341;994;234;737;30;106;64;166;94;272
430600;201702;1950;5225;1039;3159;194;642;292;825;486;1467
430605;201702;1248;3725;975;3171;169;634;401;1300;570;1934
430607;201702;762;1804;562;1508;52;153;348;963;400;1116
430610;201702;7312;19612;5644;17024;1686;5586;1230;3736;2916;9322
430613;201702;276;674;110;342;7;24;27;68;34;92
430620;201702;682;1911;567;1686;150;479;231;668;381;1147
430630;201702;399;1215;167;554;22;78;27;78;49;156
430632;201702;644;1809;324;1026;49;174;107;296;156;470
430635;201702;581;1660;451;1392;91;314;228;680;319;994
430637;201702;480;1359;426;1253;69;228;239;662;308;890
430640;201702;1574;4193;755;2437;104;349;82;230;186;579
430642;201702;458;1189;300;908;52;155;121;376;173;531
430645;201702;280;643;110;313;20;54;28;85;48;139
430650;201702;1756;5655;1501;5132;313;1112;805;2798;1118;3910
430655;201702;157;402;135;359;32;107;65;141;97;248
430660;201702;5348;14916;4318;13104;988;3216;1835;5540;2823;8756
430670;201702;441;1279;412;1223;38;117;307;936;345;1053
430673;201702;722;1687;322;967;70;217;86;254;156;471
430675;201702;249;734;78;272;11;49;18;53;29;102
430676;201702;3583;10506;2908;9259;707;2419;927;2998;1634;5417
430680;201702;1079;3061;657;2175;130;447;132;388;262;835
430690;201702;3941;11310;3196;9853;1034;3387;696;2117;1730;5504
430692;201702;252;831;193;723;18;85;126;455;144;540
430693;201702;1195;3236;728;2283;160;559;133;378;293;937
430695;201702;558;1508;363;1094;66;220;145;418;211;638
430697;201702;441;1239;320;1019;70;233;120;394;190;627
430700;201702;9300;23857;4830;15521;877;3245;342;1056;1219;4301
430705;201702;265;805;213;685;59;201;63;188;122;389
430710;201702;1684;4256;1265;3537;259;804;519;1448;778;2252
430720;201702;769;1924;505;1516;119;383;165;498;284;881
430730;201702;1582;4102;1024;3163;191;625;429;1364;620;1989
430740;201702;591;1637;348;1137;69;240;63;221;132;461
430745;201702;487;1391;242;781;30;93;39;131;69;224
430750;201702;1454;4013;1132;3453;220;727;568;1700;788;2427
430755;201702;470;1248;300;898;25;94;138;375;163;469
430760;201702;2771;6818;1863;5517;444;1482;696;2129;1140;3611
430770;201702;6197;17788;4951;15495;855;2928;2652;8128;3507;11056
430780;201702;2446;6471;1512;4758;292;987;440;1388;732;2375
430781;201702;423;1236;306;994;70;233;84;278;154;511
430783;201702;542;1308;333;955;45;139;153;420;198;559
430786;201702;74;249;49;193;8;30;10;36;18;66
430790;201702;4443;12162;3079;9444;674;2282;1144;3293;1818;5575
430800;201702;867;2412;578;1772;116;376;201;594;317;970
430805;201702;551;1536;330;1047;31;96;153;476;184;572
430807;201702;449;1267;304;958;58;208;84;254;142;462
430810;201702;705;1903;245;845;47;171;38;127;85;298
430820;201702;1367;3923;788;2665;173;608;143;472;316;1080
430825;201702;309;838;128;391;25;66;22;47;47;113
430830;201702;1648;5072;1514;4886;240;863;1002;3200;1242;4063
430840;201702;972;2911;849;2689;217;681;382;1237;599;1918
430843;201702;81;204;37;114;5;15;13;37;18;52
430845;201702;260;761;217;668;94;326;28;63;122;389
430850;201702;2357;6927;1990;6227;522;1776;772;2380;1294;4156
430860;201702;1024;2659;495;1557;99;368;178;523;277;891
430865;201702;595;1570;536;1478;173;496;244;662;417;1158
430870;201702;735;2022;381;1252;80;273;74;214;154;487
430880;201702;1148;3183;806;2502;225;733;221;712;446;1445
430885;201702;245;572;136;409;14;51;96;293;110;344
430890;201702;1651;4440;1099;3347;89;344;185;483;274;827
430900;201702;2671;6991;2087;6000;404;1335;918;2511;1322;3846
430905;201702;1064;3012;690;2231;166;562;149;458;315;1020
430910;201702;1603;4662;1070;3490;227;820;373;1099;600;1919
430912;201702;460;1300;345;1089;52;187;208;647;260;834
430915;201702;580;1800;417;1496;146;572;97;374;243;946
430920;201702;17261;51310;15153;47440;2760;9569;8570;26109;11330;35678
430925;201702;136;308;58;169;10;30;17;55;27;85
430930;201702;9539;26383;6416;20715;1750;6026;1335;4609;3085;10635
430940;201702;1217;3698;693;2384;191;714;84;239;275;953
430950;201702;884;2391;589;1797;139;457;214;593;353;1050
430955;201702;168;486;71;234;14;56;12;31;26;87
430957;201702;233;776;194;696;38;130;90;331;128;461
430960;201702;1409;3665;1086;3102;246;792;498;1417;744;2209
430965;201702;1557;4242;1316;3840;94;338;965;2728;1059;3066
430970;201702;403;1098;235;747;40;129;91;277;131;406
430975;201702;557;1821;438;1536;97;363;159;571;256;934
430980;201702;360;922;233;723;56;177;78;238;134;415
430990;201702;558;1752;363;1240;65;246;111;368;176;614
430995;201702;617;1742;452;1412;122;381;166;498;288;879
431000;201702;1522;3832;734;2241;115;371;46;120;161;491
431010;201702;2617;7234;1557;5217;258;983;169;490;427;1473
431020;201702;10075;24545;6682;18801;1680;5011;1691;4597;3371;9608
431030;201702;327;926;157;544;35;129;16;55;51;184
431033;201702;2597;8040;2274;7533;597;1980;1023;3679;1620;5659
431036;201702;218;564;93;298;15;49;18;44;33;93
431040;201702;946;2619;718;2217;133;499;348;998;481;1497
431041;201702;494;1289;429;1199;119;352;179;514;298;866
431043;201702;474;1290;261;888;101;367;56;174;157;541
431046;201702;104;295;74;230;8;30;21;62;29;92
431050;201702;1618;4102;1180;3377;277;822;520;1503;797;2325
431053;201702;583;1838;462;1573;141;512;106;363;247;875
431055;201702;667;1765;614;1684;54;167;461;1246;515;1413
431057;201702;360;1050;222;745;42;160;60;181;102;341
431060;201702;5312;15864;4688;14803;1569;5212;1273;4184;2842;9396
431065;201702;529;1502;370;1183;61;218;115;335;176;553
431070;201702;609;1779;352;1160;82;283;59;153;141;436
431075;201702;243;758;180;620;32;125;56;197;88;322
431080;201702;683;2063;486;1608;106;370;126;401;232;771
431085;201702;755;2085;595;1733;105;297;327;954;432;1251
431087;201702;526;1513;470;1400;43;126;324;978;367;1104
431090;201702;473;1174;200;613;49;167;38;109;87;276
431100;201702;3243;8921;2623;7885;684;2278;871;2531;1555;4809
431110;201702;1457;3819;1093;3096;254;747;361;970;615;1717
431112;201702;547;1762;499;1664;118;400;240;777;358;1177
431113;201702;452;1331;365;1155;112;368;103;343;215;711
431115;201702;1346;3841;1163;3530;203;644;648;1960;851;2604
431120;201702;2639;7985;1995;6659;605;2338;609;1860;1214;4198
431123;201702;431;1242;281;938;65;209;133;457;198;666
431125;201702;1314;3938;933;3114;287;966;202;762;489;1728
431127;201702;253;684;59;197;9;25;10;26;19;51
431130;201702;3356;9653;2329;7610;522;1815;682;2256;1204;4071
431140;201702;4948;12074;2772;8320;369;1249;815;2229;1184;3478
431142;201702;459;1321;391;1198;61;196;236;731;297;927
431150;201702;1010;3023;777;2516;171;605;267;873;438;1478
431160;201702;814;2334;671;2071;131;378;294;1005;425;1383
431162;201702;526;1300;231;740;28;101;26;61;54;162
431164;201702;176;484;52;183;11;40;3;15;14;55
431170;201702;656;1801;461;1441;131;441;133;402;264;843
431171;201702;737;2163;639;1968;153;499;269;806;422;1305
431173;201702;443;1274;349;1113;129;447;82;259;211;706
431175;201702;985;2737;799;2401;226;715;212;620;438;1335
431177;201702;757;2413;565;2028;159;625;202;709;361;1334
431179;201702;365;790;96;277;17;51;14;31;31;82
431180;201702;2181;6088;1467;4701;354;1244;255;760;609;2004
431190;201702;580;1605;322;1044;44;151;54;150;98;301
431198;201702;335;1107;299;1037;108;392;85;317;193;709
431200;201702;404;1133;120;411;15;43;0;0;15;43
431205;201702;252;742;109;392;28;96;32;122;60;218
431210;201702;701;1857;592;1700;150;424;310;929;460;1353
431213;201702;236;709;188;622;29;109;91;301;120;410
431215;201702;244;760;156;550;37;138;22;71;59;209
431217;201702;162;489;111;379;27;92;44;148;71;240
431220;201702;830;2271;470;1502;39;141;189;554;228;695
431225;201702;1280;3564;982;3006;239;750;314;1000;553;1750
431230;201702;783;2314;586;1873;100;362;247;762;347;1124
431235;201702;114;316;32;100;7;22;3;5;10;27
431237;201702;466;1377;374;1229;65;261;196;620;261;881
431238;201702;29;101;23;84;8;35;6;20;14;55
431240;201702;3415;10045;2931;9212;734;2522;1186;3670;1920;6192
431242;201702;377;1114;313;997;90;286;104;346;194;632
431244;201702;351;827;193;552;28;93;76;190;104;283
431245;201702;1212;3137;805;2357;121;375;359;1040;480;1415
431247;201702;200;560;131;418;30;102;30;86;60;188
431250;201702;1333;4376;1182;4154;325;1224;440;1572;765;2796
431260;201702;340;954;167;574;22;96;38;111;60;207
431261;201702;248;818;208;724;38;150;90;299;128;449
431262;201702;415;1131;187;607;19;63;92;310;111;373
431265;201702;1386;3461;673;2052;110;364;197;496;307;860
431267;201702;279;795;170;517;21;81;103;285;124;366
431270;201702;2775;6838;1663;4992;417;1348;491;1505;908;2853
431275;201702;224;673;123;449;34;129;14;49;48;178
431280;201702;317;864;111;365;11;40;16;36;27;76
431290;201702;313;964;229;775;39;152;33;81;72;233
431295;201702;77;218;32;104;2;6;7;18;9;24
431300;201702;389;973;63;239;3;11;2;9;5;20
431301;201702;272;842;99;340;12;45;12;29;24;74
431303;201702;733;1948;445;1344;52;175;146;422;198;597
431306;201702;2148;5589;1311;4054;154;560;336;890;490;1450
431308;201702;36;124;33;112;17;61;10;33;27;94
431310;201702;722;2140;428;1451;91;325;129;450;220;775
431320;201702;743;2070;379;1274;75;282;64;195;139;477
431330;201702;2683;6691;1388;4336;333;1166;117;318;450;1484
431333;201702;408;1094;150;457;26;74;27;70;53;144
431335;201702;40;119;27;93;8;27;3;7;11;34
431337;201702;2420;7256;1761;5968;426;1561;254;881;680;2442
431339;201702;523;1419;366;1101;76;239;187;554;263;793
431340;201702;22792;60476;16600;49683;3892;12805;3849;11261;7741;24066
431342;201702;535;1307;399;1089;100;316;231;586;331;902
431344;201702;354;983;257;803;4;10;191;600;195;610
431346;201702;299;755;112;347;21;70;14;43;35;113
431349;201702;727;2017;426;1305;71;228;149;415;220;643
431350;201702;3956;11491;3143;9973;750;2642;998;3001;1748;5643
431360;201702;618;1575;388;1175;100;303;99;301;199;604
431365;201702;1391;4056;1181;3703;191;642;671;2156;862;2798
431370;201702;4738;13236;3692;11428;975;3196;1287;4162;2262;7358
431380;201702;874;2717;811;2596;115;417;456;1440;571;1857
431390;201702;2910;7652;1743;5451;336;1207;444;1217;780;2424
431395;201702;1204;3588;985;3197;225;775;429;1407;654;2182
431400;201702;379;1170;187;625;32;111;38;123;70;234
431402;201702;1069;2616;679;1913;132;403;345;912;477;1315
431403;201702;188;560;159;510;46;170;58;167;104;337
431405;201702;4009;11132;3260;10030;581;1996;1704;5180;2285;7176
431406;201702;622;1911;486;1646;95;336;275;931;370;1267
431407;201702;510;1452;344;1122;79;265;117;359;196;624
431410;201702;13957;39804;9458;30977;2646;9710;1590;5051;4236;14761
431413;201702;207;510;76;250;7;29;13;38;20;67
431415;201702;697;1978;500;1613;116;420;143;413;259;833
431417;201702;514;1309;434;1195;58;178;282;756;340;934
431420;201702;1272;3459;1110;3208;221;681;484;1485;705;2166
431430;201702;563;1476;340;1044;63;216;110;299;173;515
431440;201702;21670;59265;17212;52169;4954;16000;4968;16162;9922;32162
431442;201702;122;364;75;251;14;46;3;8;17;54
431445;201702;517;1469;201;658;30;98;46;144;76;242
431446;201702;381;1166;284;935;71;240;80;249;151;489
431447;201702;551;1577;425;1331;68;218;201;621;269;839
431449;201702;750;2039;588;1744;55;164;305;922;360;1086
431450;201702;2074;5007;1821;4638;194;597;1348;3292;1542;3889
431454;201702;62;215;54;194;12;43;21;83;33;126
431455;201702;686;1738;359;1018;74;217;114;296;188;513
431460;201702;3040;8380;2568;7463;665;1967;851;2598;1516;4565
431470;201702;1736;5027;1282;4064;269;854;446;1464;715;2318
431475;201702;201;593;37;148;5;25;2;6;7;31
431477;201702;707;1844;461;1336;58;166;210;576;268;742
431478;201702;260;662;85;250;13;39;9;19;22;58
431480;201702;3091;8398;2393;7223;469;1570;1066;3137;1535;4707
431490;201702;107084;288281;91794;265244;11164;37861;62630;176603;73794;214464
431500;201702;554;1529;440;1301;64;187;256;762;320;949
431505;201702;486;1171;324;930;29;81;196;564;225;645
431507;201702;363;875;197;553;34;94;94;256;128;350
431510;201702;1786;5055;1380;4233;314;1029;430;1265;744;2294
431513;201702;309;821;152;467;21;61;75;227;96;288
431514;201702;95;268;45;154;3;14;9;28;12;42
431515;201702;568;1573;385;1191;93;326;146;410;239;736
431517;201702;73;245;55;194;9;31;13;44;22;75
431520;201702;516;1290;238;762;46;170;34;100;80;270
431530;201702;4049;9536;2855;7948;870;2564;640;1871;1510;4435
431531;201702;229;667;171;547;18;59;59;173;77;232
431532;201702;507;1387;405;1164;87;260;149;421;236;681
431535;201702;295;754;133;405;29;104;42;105;71;209
431540;201702;2004;6609;1798;6288;142;590;1198;4294;1340;4884
431545;201702;341;950;54;190;4;15;14;54;18;69
431550;201702;2136;6258;1852;5740;409;1403;777;2288;1186;3691
431555;201702;668;1643;470;1312;51;140;283;800;334;940
431560;201702;20210;58570;14250;47412;3140;11788;3176;11220;6316;23008
431570;201702;5746;14492;4501;12845;1175;3533;1974;5723;3149;9256
431575;201702;377;1003;281;840;55;187;51;130;106;317
431580;201702;560;1575;313;1039;66;237;79;247;145;484
431590;201702;918;2433;575;1777;133;422;159;496;292;918
431595;201702;407;1159;301;924;38;116;161;478;199;594
431600;201702;1916;5241;1421;4399;305;1097;333;1025;638;2122
431610;201702;1383;3908;1010;3186;146;450;427;1381;573;1831
431620;201702;453;1290;222;693;44;133;96;277;140;410
431630;201702;1317;3562;800;2471;220;699;199;588;419;1287
431640;201702;6214;17101;5602;16241;953;2937;3514;10287;4467;13224
431642;201702;513;1354;377;1112;44;141;159;447;203;588
431643;201702;330;843;149;424;21;61;43;100;64;161
431645;201702;1630;4607;1370;4142;213;742;829;2476;1042;3218
431647;201702;137;409;91;302;10;37;18;50;28;87
431650;201702;314;955;225;750;39;154;70;211;109;365
431660;201702;963;2740;603;1992;119;441;119;341;238;782
431670;201702;1215;3161;909;2633;170;566;407;1100;577;1666
431673;201702;231;629;104;341;25;83;11;29;36;112
431675;201702;710;1802;145;487;15;51;44;134;59;185
431680;201702;8921;24534;6897;20708;1920;6108;1841;5611;3761;11719
431690;201702;21929;61009;17276;53156;4671;15197;5496;17467;10167;32664
431695;201702;141;419;100;328;23;79;26;62;49;141
431697;201702;446;1236;391;1144;99;311;184;544;283;855
431700;201702;1468;4158;1274;3800;191;609;705;2060;896;2669
431710;201702;11692;33830;9815;30893;3182;10656;2622;9119;5804;19775
431720;201702;6720;18547;4975;15063;1079;3488;1315;3868;2394;7356
431725;201702;30;85;18;60;4;13;5;15;9;28
431730;201702;3580;10387;2871;9147;757;2624;790;2709;1547;5333
431740;201702;4896;13364;3830;11478;1237;4094;640;1732;1877;5826
431750;201702;8278;23460;7139;21603;1721;5629;3032;9241;4753;14870
431755;201702;331;898;74;251;13;39;14;44;27;83
431760;201702;4096;11256;3270;9804;528;1787;1698;4860;2226;6647
431770;201702;1887;5056;1598;4634;264;795;953;2730;1217;3525
431775;201702;187;514;114;360;28;94;8;20;36;114
431780;201702;2120;5770;1559;4672;391;1236;392;1090;783;2326
431790;201702;1111;3294;859;2744;157;556;292;899;449;1455
431795;201702;376;1006;229;691;39;124;60;175;99;299
431800;201702;8164;23801;6532;20788;2159;7482;835;2607;2994;10089
431805;201702;329;812;100;338;13;50;19;70;32;120
431810;201702;3077;8321;2362;6922;461;1461;986;2794;1447;4255
431820;201702;2465;7552;2127;6906;445;1589;935;2976;1380;4565
431830;201702;10647;25622;8285;22178;2040;5946;3367;9099;5407;15045
431840;201702;2475;7428;2138;6816;457;1571;1068;3461;1525;5032
431842;201702;763;1929;288;890;39;127;57;148;96;275
431843;201702;349;1003;285;882;39;147;133;393;172;540
431844;201702;282;779;77;260;22;80;10;29;32;109
431845;201702;490;1425;358;1133;23;74;217;696;240;770
431846;201702;303;915;255;839;27;105;187;610;214;715
431848;201702;229;613;124;397;10;43;19;48;29;91
431849;201702;473;1149;94;271;13;35;13;26;26;61
431850;201702;4503;13167;3812;11732;842;2772;1294;3926;2136;6698
431860;201702;746;1959;531;1551;79;270;259;709;338;979
431861;201702;99;299;51;189;7;26;11;31;18;57
431862;201702;476;1557;389;1400;75;300;167;596;242;896
431870;201702;17486;50882;14268;44957;3279;11278;5186;16326;8465;27604
431880;201702;4015;11789;3231;10216;759;2671;1157;3513;1916;6184
431890;201702;4798;13008;3374;10382;999;3315;662;2145;1661;5460
431900;201702;1106;3021;707;2200;169;599;277;801;446;1400
431910;201702;935;2258;458;1326;68;198;124;340;192;538
431912;201702;452;1337;375;1188;91;287;176;568;267;855
431915;201702;1198;3251;922;2774;220;710;357;1069;577;1779
431920;201702;1209;3398;1051;3135;116;361;729;2169;845;2530
431930;201702;1085;3041;784;2515;176;545;383;1265;559;1810
431935;201702;62;203;52;184;9;34;13;43;22;77
431936;201702;329;990;229;748;53;192;73;232;126;424
431937;201702;277;737;162;491;37;124;26;67;63;191
431940;201702;2409;6506;1563;4816;360;1211;413;1220;773;2431
431950;201702;1517;4564;1347;4264;254;901;681;2105;935;3006
431960;201702;2687;7613;2290;6828;639;2005;689;2034;1328;4039
431970;201702;406;1147;195;658;50;166;43;134;93;300
431971;201702;86;266;55;199;8;30;7;25;15;55
431973;201702;438;1529;388;1424;41;151;257;961;298;1112
431975;201702;106;244;23;83;2;8;4;13;6;21
431980;201702;1296;3800;1035;3271;256;838;319;986;575;1824
431990;201702;6730;18408;4829;15374;929;3334;1400;4423;2329;7757
432000;201702;9813;27160;7907;23904;2364;7370;2748;8419;5112;15789
432010;201702;2098;5805;1692;5088;275;925;816;2384;1091;3309
432020;201702;2241;5330;1627;4465;341;1054;904;2381;1245;3435
432023;201702;499;1352;302;932;47;164;128;331;175;495
432026;201702;1113;3393;841;2816;115;377;452;1502;567;1879
432030;201702;367;1041;273;837;58;183;121;352;179;535
432032;201702;531;1403;374;1104;53;176;160;430;213;606
432035;201702;795;2366;705;2209;230;800;198;618;428;1418
432040;201702;959;2256;460;1430;70;260;158;483;228;743
432045;201702;249;685;133;451;25;91;39;138;64;229
432050;201702;579;1604;497;1461;69;231;285;851;354;1082
432055;201702;907;2498;627;1973;145;497;258;790;403;1287
432057;201702;397;973;279;764;44;108;142;371;186;479
432060;201702;465;1228;183;617;32;133;45;128;77;261
432065;201702;234;672;180;576;49;159;61;193;110;352
432067;201702;878;2660;674;2224;125;400;306;1012;431;1412
432070;201702;2351;6439;1512;4762;296;1025;302;920;598;1945
432080;201702;3765;10492;3166;9447;884;2939;1161;3420;2045;6359
432085;201702;321;889;212;710;56;189;91;299;147;488
432090;201702;1431;4042;1137;3491;320;1044;443;1320;763;2364
432100;201702;1310;3752;610;2097;105;393;35;96;140;489
432110;201702;2438;7348;1799;6020;440;1699;153;475;593;2174
432120;201702;4191;12343;3479;11072;1220;4131;896;2860;2116;6991
432130;201702;2713;7382;2193;6719;636;2085;902;2836;1538;4921
432132;201702;304;867;154;531;26;93;41;133;67;226
432135;201702;714;2079;595;1842;98;322;364;1115;462;1437
432140;201702;1755;5623;1375;4887;304;1112;555;2099;859;3211
432143;201702;1318;3825;1094;3451;195;679;531;1697;726;2376
432145;201702;1321;3984;829;2845;139;537;127;406;266;943
432146;201702;176;555;122;428;31;118;24;77;55;195
432147;201702;599;1941;469;1652;145;549;92;326;237;875
432149;201702;362;990;237;707;39;111;95;279;134;390
432150;201702;3537;9907;2673;8321;586;2027;781;2365;1367;4392
432160;201702;4215;13263;3704;12333;1119;3921;1227;4166;2346;8087
432162;201702;376;909;59;186;12;43;8;24;20;67
432163;201702;280;772;65;209;6;20;1;2;7;22
432166;201702;610;1800;485;1535;82;310;186;521;268;831
432170;201702;1169;3543;805;2764;193;694;177;592;370;1286
432180;201702;2407;6576;1507;4682;359;1182;271;727;630;1909
432183;201702;378;1193;300;1022;100;372;52;171;152;543
432185;201702;879;2304;598;1790;77;242;323;936;400;1178
432190;201702;2956;7990;1905;5758;414;1338;547;1541;961;2879
432195;201702;1046;2787;736;2262;165;495;278;863;443;1358
432200;201702;2778;8419;2304;7586;568;2078;974;3142;1542;5220
432210;201702;390;1088;283;903;53;200;108;318;161;518
432215;201702;794;2437;690;2270;137;431;387;1337;524;1768
432218;201702;265;674;161;462;26;74;55;136;81;210
432220;201702;4078;10622;3244;9288;450;1466;1830;5069;2280;6535
432225;201702;105;320;83;275;24;84;25;87;49;171
432230;201702;989;2656;593;1798;110;361;149;380;259;741
432232;201702;464;1337;393;1193;67;237;173;501;240;738
432234;201702;362;971;224;687;40;128;45;125;85;253
432235;201702;110;317;38;133;6;23;2;4;8;27
432237;201702;438;1171;385;1081;16;61;270;731;286;792
432240;201702;13419;41513;11386;38719;1447;5986;6994;24382;8441;30368
432250;201702;4581;15507;4133;14593;1244;4689;1359;4931;2603;9620
432252;201702;445;1149;303;930;55;178;166;524;221;702
432253;201702;1268;3994;726;2550;159;619;45;146;204;765
432254;201702;878;2367;248;819;41;143;21;62;62;205
432255;201702;203;515;108;348;17;65;35;98;52;163
432260;201702;7416;18304;5285;14900;1120;3220;2193;6552;3313;9772
432270;201702;2475;7333;2106;6649;617;2080;512;1641;1129;3721
432280;201702;1366;3669;741;2341;102;330;184;533;286;863
432285;201702;195;612;25;88;4;11;2;2;6;13
432290;201702;472;1403;303;1019;75;239;76;254;151;493
432300;201702;23241;68216;20194;62979;3494;11979;11445;35205;14939;47184
432310;201702;780;2273;611;1985;148;499;289;932;437;1431
432320;201702;205;522;91;289;20;63;13;36;33;99
432330;201702;314;832;122;407;11;34;19;61;30;95
432335;201702;156;457;67;242;9;38;12;32;21;70
432340;201702;346;836;173;525;32;112;49;136;81;248
432345;201702;641;1736;593;1663;72;268;384;998;456;1266
432350;201702;378;1018;198;635;29;87;58;180;87;267
432360;201702;196;604;41;150;6;25;7;20;13;45
432370;201702;403;1101;292;876;32;102;170;518;202;620
432375;201702;702;1782;526;1489;64;190;302;838;366;1028
432377;201702;238;803;39;152;7;29;10;32;17;61
432380;201702;1045;3262;766;2651;204;768;301;1008;505;1776
500020;201702;2278;6514;1753;5643;360;1348;751;2343;1111;3691
500025;201702;1416;3280;847;2314;82;231;472;1272;554;1503
500060;201702;6853;20434;5421;17945;749;2538;3323;11488;4072;14026
500070;201702;4260;12101;3344;10488;734;2584;1272;4058;2006;6642
500080;201702;1351;3952;1007;3330;257;943;357;1164;614;2107
500085;201702;2121;5331;1452;4363;116;364;919;2730;1035;3094
500090;201702;2289;6486;1614;5245;333;1152;641;2204;974;3356
500100;201702;2966;8262;2401;7300;445;1541;981;2886;1426;4427
500110;201702;7857;23177;6180;20542;1138;4057;2697;9657;3835;13714
500124;201702;2059;6556;1783;6089;412;1338;909;3471;1321;4809
500150;201702;1327;3369;874;2597;162;561;315;816;477;1377
500190;201702;4976;12571;3810;11020;761;2354;1988;5939;2749;8293
500200;201702;2461;6089;1807;4955;399;1149;717;1849;1116;2998
500210;201702;4616;13697;3806;12402;882;3048;1680;5574;2562;8622
500215;201702;1413;4291;1068;3611;178;673;394;1340;572;2013
500220;201702;2974;9127;2416;8155;466;1699;1095;3769;1561;5468
500230;201702;2920;7431;2061;6074;348;1084;999;3039;1347;4123
500240;201702;4379;13632;3143;11099;572;2293;842;3169;1414;5462
500260;201702;2748;6762;1855;5413;272;845;938;2693;1210;3538
500270;201702;118955;306680;75538;229917;17013;56290;17111;51832;34124;108122
500280;201702;1357;3448;1071;3061;81;240;794;2312;875;2552
500290;201702;4375;9696;2462;7021;429;1341;869;2487;1298;3828
500295;201702;2527;7158;1482;4834;222;801;370;1020;592;1821
500310;201702;764;2020;618;1810;123;418;315;877;438;1295
500315;201702;3114;9657;2563;8743;371;1320;1563;5551;1934;6871
500320;201702;17285;54699;13443;47537;3883;14972;3449;13091;7332;28063
500325;201702;4395;10799;3038;8771;492;1535;1633;4804;2125;6339
500330;201702;6861;17577;4669;13646;642;2112;2136;6241;2778;8353
500345;201702;2088;5361;1605;4675;390;1209;694;2034;1084;3243
500348;201702;2177;6326;1883;5874;173;693;1257;3843;1430;4536
500350;201702;1280;3730;717;2416;71;241;227;789;298;1030
500370;201702;21670;64713;16325;55132;3552;13534;4938;17041;8490;30575
500375;201702;2819;7746;2076;6331;383;1288;617;1858;1000;3146
500380;201702;3414;9208;2580;7773;547;1729;1035;3171;1582;4900
500390;201702;547;1238;318;876;49;159;157;413;206;572
500400;201702;1285;3863;956;3088;226;775;224;688;450;1463
500410;201702;2155;6122;1755;5542;325;1087;954;3115;1279;4202
500430;201702;2679;7264;1949;6215;368;1334;756;2562;1124;3896
500440;201702;1420;3728;932;2862;164;529;383;1199;547;1728
500450;201702;1306;3832;864;2935;189;715;129;363;318;1078
500460;201702;3955;11395;2727;9005;690;2535;534;1761;1224;4296
500470;201702;2899;8340;2014;6497;549;1929;331;1016;880;2945
500480;201702;2226;6646;2055;6436;163;484;1616;5434;1779;5918
500490;201702;936;2526;687;2114;189;672;133;441;322;1113
500500;201702;3825;11423;2966;10163;975;3869;916;3258;1891;7127
500510;201702;822;2103;521;1557;61;206;226;632;287;838
500515;201702;1946;5053;1566;4524;207;586;930;2903;1137;3489
500520;201702;3223;11024;2800;10185;391;1696;1664;5964;2055;7660
500525;201702;1177;3658;949;3256;162;640;437;1556;599;2196
500540;201702;6280;16804;3674;11990;898;3450;405;1191;1303;4641
500560;201702;4841;15441;4356;14689;422;1552;3152;10788;3574;12340
500568;201702;4200;10213;2764;8060;647;2327;734;1902;1381;4229
500570;201702;7374;19185;4579;14007;1205;3975;733;2245;1938;6220
500580;201702;3652;10112;2938;8972;296;942;2014;6265;2310;7207
500600;201702;3938;10286;2537;7760;590;1998;637;1933;1227;3931
500620;201702;7716;21852;5680;17951;967;3266;2409;7759;3376;11025
500625;201702;715;2044;394;1310;71;265;137;436;208;701
500627;201702;696;1854;468;1441;94;299;98;304;192;603
500630;201702;5557;14951;3821;11947;952;3160;1123;3498;2075;6658
500635;201702;2662;9749;2191;9030;271;1149;1533;6776;1804;7925
500640;201702;1621;3878;1235;3335;73;235;900;2380;973;2615
500660;201702;19196;54481;14783;47422;4550;16220;4085;13192;8635;29412
500690;201702;2408;7117;1925;6386;909;3131;420;1551;1329;4682
500710;201702;3340;9746;2721;8668;649;2313;984;3146;1633;5459
500720;201702;6071;15922;3799;12057;941;3303;694;2150;1635;5453
500730;201702;983;2693;668;2099;163;559;207;634;370;1193
500740;201702;4472;11908;3358;9885;362;1292;1661;4951;2023;6243
500750;201702;975;2643;790;2325;140;470;376;1047;516;1517
500755;201702;1155;3332;778;2578;151;527;143;371;294;898
500769;201702;5440;14206;3034;9345;499;1712;572;1512;1071;3224
500770;201702;1654;4761;1119;3711;223;830;303;1007;526;1837
500780;201702;1147;3259;882;2764;230;760;206;641;436;1401
500790;201702;9501;25483;7854;22841;1467;4776;4115;11805;5582;16581
500793;201702;2160;6106;1591;5085;474;1570;266;779;740;2349
500795;201702;2340;6850;1982;6338;258;711;1360;4728;1618;5439
500797;201702;809;2191;550;1712;96;335;194;593;290;928
500800;201702;2936;7684;2177;6584;750;2574;469;1491;1219;4065
500830;201702;19551;51063;13617;40305;2588;8504;4743;13470;7331;21974
500840;201702;1339;3637;854;2668;95;324;321;947;416;1271
510010;201702;1220;3574;981;3185;221;710;522;1744;743;2454
510020;201702;3429;9485;2045;6704;457;1585;373;1122;830;2707
510025;201702;7134;20443;5067;16407;1142;4034;1260;3829;2402;7863
510030;201702;1596;4267;1301;3834;233;744;679;1959;912;2703
510035;201702;900;2470;616;2044;123;421;325;1109;448;1530
510040;201702;1772;4670;1366;4065;170;549;776;2302;946;2851
510050;201702;1813;5231;1339;4347;345;1242;387;1212;732;2454
510060;201702;1518;4264;1146;3567;188;649;487;1461;675;2110
510080;201702;1029;3275;833;2872;253;986;140;409;393;1395
510100;201702;679;1753;478;1373;52;178;222;586;274;764
510120;201702;309;646;199;508;9;27;137;348;146;375
510125;201702;2988;7721;2247;6448;371;1270;871;2319;1242;3589
510130;201702;1657;4622;1360;4107;351;1149;395;1178;746;2327
510140;201702;2801;8750;2185;7857;900;3631;494;1613;1394;5244
510160;201702;1230;4143;1108;3943;200;768;682;2434;882;3202
510170;201702;5006;14957;4032;13281;786;2820;1787;5813;2573;8633
510180;201702;12373;31860;8432;25555;2369;7695;2216;7694;4585;15389
510185;201702;1480;4265;1169;3846;205;634;671;2561;876;3195
510190;201702;2445;6579;1704;5503;289;985;870;2938;1159;3923
510250;201702;13895;40863;11936;38023;3286;11235;5151;16979;8437;28214
510260;201702;2166;8854;1764;8044;315;1348;927;4959;1242;6307
510263;201702;3840;10405;2701;8490;646;2199;516;1563;1162;3762
510267;201702;5411;15790;3759;12249;868;3041;771;2507;1639;5548
510268;201702;877;2492;738;2297;121;431;448;1377;569;1808
510269;201702;1006;3064;709;2441;241;887;155;519;396;1406
510270;201702;2742;8822;2233;7793;519;1827;782;2711;1301;4538
510279;201702;1693;5165;1345;4437;333;1168;423;1295;756;2463
510285;201702;1159;3348;870;2862;249;884;257;830;506;1714
510300;201702;3326;9539;2738;8711;197;711;2032;6565;2229;7276
510305;201702;1425;4440;1087;3799;248;919;346;1273;594;2192
510310;201702;752;2213;613;1975;212;721;188;596;400;1317
510320;201702;3729;10504;2832;8894;505;1858;948;2872;1453;4730
510325;201702;4939;15347;4146;14298;934;3307;2513;9142;3447;12449
510330;201702;2670;8643;2114;7647;521;1967;786;3091;1307;5058
510335;201702;4904;14692;3930;13429;479;1667;2603;9477;3082;11144
510336;201702;575;1744;425;1455;79;282;195;676;274;958
510337;201702;1890;6116;1478;5349;568;2163;279;1079;847;3242
510340;201702;75666;198975;51784;161252;16531;57796;9138;29618;25669;87414
510343;201702;1081;3092;810;2573;120;404;386;1208;506;1612
510345;201702;1552;4591;1209;3976;291;1018;412;1333;703;2351
510350;201702;3093;8279;2316;7187;565;1870;975;3155;1540;5025
510360;201702;1786;4258;1119;3455;98;403;772;2374;870;2777
510370;201702;1396;4451;1127;4033;231;907;592;2215;823;3122
510380;201702;514;1483;293;1023;85;318;26;94;111;412
510385;201702;950;3592;687;2994;89;427;324;1550;413;1977
510390;201702;1033;3298;905;3055;229;745;437;1571;666;2316
510395;201702;748;1816;545;1512;61;196;239;735;300;931
510410;201702;3827;12167;3259;11101;824;2865;1512;5421;2336;8286
510420;201702;2410;5934;1753;4907;183;609;927;2546;1110;3155
510450;201702;705;1840;471;1456;109;399;111;330;220;729
510452;201702;641;2035;477;1665;78;284;262;903;340;1187
510454;201702;870;2693;720;2403;120;433;421;1433;541;1866
510455;201702;915;2813;691;2324;127;497;239;750;366;1247
510460;201702;2319;5983;1718;5122;179;633;971;2804;1150;3437
510480;201702;4282;10998;3051;8831;545;1688;1107;3037;1652;4725
510490;201702;1551;4809;1310;4439;296;1115;678;2246;974;3361
510500;201702;1450;4259;1000;3373;192;777;445;1456;637;2233
510510;201702;2732;9265;2306;8464;686;2730;541;2117;1227;4847
510515;201702;6232;17806;4219;13761;904;3210;925;2727;1829;5937
510517;201702;1520;4507;1228;3968;336;1134;263;844;599;1978
510520;201702;2141;4731;1443;3871;25;64;948;2780;973;2844
510523;201702;954;2739;844;2553;106;313;585;1834;691;2147
510525;201702;5335;16080;4299;14017;892;3092;1557;4869;2449;7961
510530;201702;483;1384;405;1266;33;151;278;815;311;966
510550;201702;2787;8961;2164;7760;572;2178;703;2611;1275;4789
510558;201702;1866;5331;1610;4980;161;551;995;3254;1156;3805
510560;201702;1580;4734;1010;3771;266;1088;225;897;491;1985
510562;201702;5339;15256;3923;12476;1078;3701;993;3360;2071;7061
510590;201702;3174;8017;2453;7124;444;1253;1481;4551;1925;5804
510600;201702;1597;4007;1055;3107;214;668;352;1033;566;1701
510610;201702;2885;8106;2297;7222;241;879;1447;4502;1688;5381
510615;201702;1984;5990;1673;5486;519;1778;699;2362;1218;4140
510617;201702;644;1894;541;1726;30;93;423;1410;453;1503
510618;201702;1405;4041;1024;3305;206;790;485;1485;691;2275
510619;201702;726;2023;425;1437;70;271;43;124;113;395
510620;201702;1382;3437;767;2466;197;716;117;358;314;1074
510621;201702;832;2792;744;2622;194;781;209;697;403;1478
510622;201702;3943;11714;2854;9447;819;2950;486;1510;1305;4460
510623;201702;3386;9205;2579;7882;595;2067;841;2466;1436;4533
510624;201702;1735;4768;886;3011;167;645;143;439;310;1084
510625;201702;1972;5498;1503;4723;427;1522;245;781;672;2303
510626;201702;1627;4369;1058;3560;299;1114;236;879;535;1993
510627;201702;696;1981;473;1513;135;467;108;358;243;825
510628;201702;1532;3748;1039;3059;182;533;602;1811;784;2344
510629;201702;1707;5509;1386;4794;380;1426;434;1543;814;2969
510630;201702;2489;8180;1707;6531;401;1669;285;1163;686;2832
510631;201702;386;1066;320;950;10;26;263;785;273;811
510637;201702;2830;7998;2342;7201;816;2726;682;2101;1498;4827
510642;201702;4756;15539;4043;14488;1179;4645;1686;6320;2865;10965
510645;201702;964;2134;600;1657;179;497;183;532;362;1029
510650;201702;6311;20029;5632;19236;1309;4717;3480;12398;4789;17115
510665;201702;1739;4509;1093;3328;188;593;416;1316;604;1909
510670;201702;367;814;206;589;20;67;108;317;128;384
510675;201702;6240;19199;4921;16641;1428;5256;1024;3511;2452;8767
510677;201702;1899;5081;1507;4574;199;620;1043;3352;1242;3972
510680;201702;705;2116;522;1753;116;414;76;236;192;650
510682;201702;1985;6310;1521;5433;462;1849;288;991;750;2840
510685;201702;924;2471;718;2140;93;324;395;1128;488;1452
510700;201702;4157;10720;2790;8814;628;2031;1270;4182;1898;6213
510704;201702;9937;25857;7228;21170;1390;4553;2825;7852;4215;12405
510706;201702;1876;5563;1279;4697;253;983;666;2604;919;3587
510710;201702;3134;8579;2192;6687;502;1586;612;1729;1114;3315
510715;201702;705;1697;490;1345;70;189;187;546;257;735
510718;201702;2341;5706;1487;4699;647;2116;294;1148;941;3264
510719;201702;380;857;234;664;15;55;121;338;136;393
510720;201702;1096;2697;774;2255;191;640;256;665;447;1305
510724;201702;720;2126;524;1751;112;420;193;606;305;1026
510726;201702;718;1657;456;1267;74;215;253;679;327;894
510729;201702;718;1794;387;1173;82;273;118;352;200;625
510730;201702;2813;7884;2012;6453;567;1948;495;1565;1062;3513
510735;201702;995;3166;777;2854;140;567;399;1506;539;2073
510740;201702;1104;2656;749;2123;129;355;370;1119;499;1474
510757;201702;724;2361;600;2124;270;999;170;585;440;1584
510760;201702;32130;80088;21032;62342;5824;19173;4087;11458;9911;30631
510770;201702;4415;10729;3571;9739;335;849;2311;7029;2646;7878
510774;201702;345;966;284;833;52;153;129;415;181;568
510775;201702;643;1932;528;1720;147;553;120;355;267;908
510776;201702;538;1488;414;1230;94;298;163;490;257;788
510777;201702;1553;4464;1147;3920;105;378;923;3201;1028;3579
510779;201702;606;1801;474;1563;70;224;242;832;312;1056
510780;201702;3695;10713;2967;9615;708;2378;1207;4313;1915;6691
510785;201702;1721;4905;1197;3982;344;1204;195;697;539;1901
510787;201702;2320;6928;1800;5996;808;2826;269;870;1077;3696
510788;201702;578;1476;412;1224;103;303;149;537;252;840
510790;201702;14989;43110;10177;34062;2195;8443;1068;3701;3263;12144
510792;201702;8459;23965;5633;18724;1183;4364;909;2960;2092;7324
510794;201702;1152;3550;901;3068;252;949;254;835;506;1784
510795;201702;7975;23522;5861;19617;1620;6006;1074;3897;2694;9903
510800;201702;1536;4264;1182;3729;256;879;489;1448;745;2327
510805;201702;2003;5496;1462;4580;298;1042;618;1825;916;2867
510810;201702;667;1602;503;1376;125;337;250;675;375;1012
510820;201702;714;1635;461;1277;72;248;177;433;249;681
510830;201702;694;2003;558;1806;120;394;285;991;405;1385
510835;201702;629;1815;471;1536;90;318;207;646;297;964
510840;201702;44071;111007;35257;99498;8142;24018;16451;48425;24593;72443
510850;201702;1559;4224;980;3180;267;975;163;500;430;1475
510860;201702;2670;8087;1908;6683;662;2601;162;551;824;3152
510880;201702;572;1904;489;1755;128;483;210;784;338;1267
510885;201702;628;1745;501;1565;95;340;209;637;304;977
510890;201702;796;2456;648;2247;125;460;366;1310;491;1770
510895;201702;1146;3389;927;2990;196;715;343;1037;539;1752
520005;201702;1533;4765;1344;4504;387;1289;631;2258;1018;3547
520010;201702;1785;5867;1416;5085;520;2141;235;731;755;2872
520013;201702;3098;8692;2290;7139;523;1686;682;2214;1205;3900
520015;201702;479;1368;387;1239;95;326;128;433;223;759
520017;201702;1078;3135;889;2830;210;736;373;1134;583;1870
520020;201702;423;1090;336;963;72;210;147;419;219;629
520025;201702;30377;88877;27476;85469;3301;11147;20498;63959;23799;75106
520030;201702;4685;14234;3863;12870;656;2412;1961;6596;2617;9008
520050;201702;437;1086;272;787;22;57;161;488;183;545
520055;201702;784;2351;663;2113;137;432;327;1061;464;1493
520060;201702;1338;4117;1123;3716;286;1101;353;1107;639;2208
520080;201702;1871;5278;1523;4822;279;839;813;2784;1092;3623
520082;201702;1063;2815;941;2624;112;260;629;1828;741;2088
520085;201702;715;2136;618;1968;150;473;219;691;369;1164
520090;201702;941;2151;668;1804;131;302;349;1045;480;1347
520110;201702;40309;115464;31351;101916;11817;43741;3609;11322;15426;55063
520120;201702;184;475;112;356;17;59;34;110;51;169
520130;201702;3418;9470;3082;8987;715;2290;1587;4749;2302;7039
520140;201702;33132;107425;28638;98988;10628;39976;3849;13354;14477;53330
520145;201702;350;984;258;820;50;181;74;231;124;412
520150;201702;453;1207;375;1126;54;190;232;671;286;861
520160;201702;868;2285;701;2043;188;563;228;675;416;1238
520170;201702;4432;9999;3414;8829;223;663;2793;7272;3016;7935
520180;201702;2161;6237;1813;5735;343;1233;861;2696;1204;3929
520215;201702;1960;4987;1601;4426;195;562;996;2810;1191;3372
520235;201702;665;1686;480;1407;86;291;193;543;279;834
520250;201702;1550;4276;1096;3549;282;993;208;688;490;1681
520260;201702;807;2027;525;1519;78;231;197;558;275;789
520280;201702;566;1648;480;1486;148;462;192;653;340;1115
520310;201702;1230;2916;860;2337;215;634;268;828;483;1462
520320;201702;1977;6005;1631;5379;152;518;1006;3418;1158;3936
520330;201702;2486;7643;1912;6674;567;2187;307;1077;874;3264
520340;201702;1892;4710;1415;4038;202;497;909;2782;1111;3279
520350;201702;3264;8704;2492;7316;654;2064;872;2486;1526;4550
520355;201702;1061;3393;939;3207;241;910;457;1536;698;2446
520357;201702;826;2189;669;1947;61;190;450;1317;511;1507
520360;201702;734;2078;613;1881;172;556;220;696;392;1252
520380;201702;1310;3494;872;2631;120;407;383;1103;503;1510
520390;201702;963;2328;578;1799;190;690;155;425;345;1115
520393;201702;540;1280;415;1107;50;144;230;593;280;737
520396;201702;666;2131;552;1913;71;292;340;1153;411;1445
520400;201702;1618;4625;1380;4278;273;917;810;2488;1083;3405
520410;201702;1493;3485;1057;2878;191;581;598;1601;789;2182
520420;201702;314;895;221;694;33;105;98;290;131;395
520425;201702;1238;3404;963;2875;263;789;396;1229;659;2018
520430;201702;1820;4792;1111;3472;246;780;144;436;390;1216
520440;201702;3624;9257;2409;7092;677;2192;465;1358;1142;3550
520450;201702;10702;28967;7380;23125;1878;6515;399;1275;2277;7790
520455;201702;695;2045;554;1815;199;697;167;565;366;1262
520460;201702;894;2488;741;2251;120;412;426;1270;546;1682
520465;201702;820;2172;722;2032;56;197;537;1455;593;1652
520470;201702;1690;5463;1524;5209;295;1053;993;3509;1288;4562
520480;201702;882;2571;600;2044;111;399;118;356;229;755
520485;201702;1341;4122;1165;3854;205;756;752;2487;957;3243
520490;201702;3972;12126;3119;10779;605;2155;1688;6010;2293;8165
520495;201702;1421;3610;1176;3294;88;262;876;2557;964;2819
520500;201702;1273;3562;1047;3232;251;863;429;1296;680;2159
520505;201702;685;1934;575;1759;106;313;307;952;413;1265
520510;201702;8601;23418;6101;19540;1397;5034;1751;5690;3148;10724
520520;201702;1041;2871;838;2581;251;826;265;848;516;1674
520530;201702;1987;6447;1610;5801;559;2062;422;1694;981;3756
520540;201702;2792;7743;1988;6246;528;1737;330;1078;858;2815
520545;201702;980;2922;805;2616;149;540;257;805;406;1345
520547;201702;609;1897;524;1763;171;584;173;575;344;1159
520549;201702;9865;28920;8202;26558;2076;7071;3882;12887;5958;19958
520551;201702;3732;11230;3377;10711;708;2517;2104;6590;2812;9107
520552;201702;765;2242;689;2147;96;316;493;1566;589;1882
520570;201702;584;1592;421;1328;115;390;152;461;267;851
520580;201702;3045;7282;2129;6040;388;1212;1135;3244;1523;4456
520590;201702;1440;4081;1099;3476;265;877;204;653;469;1530
520620;201702;8006;22949;6802;21425;1612;5218;3707;11930;5319;17148
520630;201702;985;2528;709;2098;93;302;322;940;415;1242
520640;201702;2756;7400;2250;6545;537;1595;893;2680;1430;4275
520650;201702;871;2241;631;1806;88;278;356;1006;444;1284
520660;201702;324;877;246;775;93;315;83;281;176;596
520670;201702;973;2825;853;2653;57;202;662;2028;719;2230
520680;201702;784;2040;593;1733;148;438;236;710;384;1148
520690;201702;295;761;210;623;54;145;98;302;152;447
520710;201702;552;1432;349;1036;7;21;203;596;210;617
520725;201702;1577;4008;1160;3306;159;503;732;2073;891;2576
520735;201702;823;2204;573;1739;106;360;205;623;311;983
520740;201702;1723;4483;1378;4046;218;686;792;2324;1010;3010
520750;201702;599;1612;483;1434;98;270;221;719;319;989
520753;201702;1498;3937;1342;3730;152;409;912;2713;1064;3122
520760;201702;795;2083;680;1930;58;153;498;1502;556;1655
520780;201702;1848;4494;1395;3847;136;384;823;2234;959;2618
520790;201702;3019;7506;2244;6356;159;428;1616;4792;1775;5220
520800;201702;16663;45415;14092;42384;2690;7716;8771;28244;11461;35960
520810;201702;1105;2658;850;2369;57;165;663;1956;720;2121
520815;201702;598;1867;440;1532;173;682;25;85;198;767
520830;201702;1642;4088;1292;3692;50;132;1077;3077;1127;3209
520840;201702;1548;5003;1331;4653;549;2034;313;1174;862;3208
520850;201702;594;1778;437;1519;111;446;117;403;228;849
520860;201702;6366;18781;4899;16364;1222;4387;1643;5683;2865;10070
520870;201702;89330;241507;66586;205491;20366;69089;14548;44046;34914;113135
520880;201702;6387;18253;4901;16125;2042;7480;501;1647;2543;9127
520890;201702;3764;10373;2982;9071;589;2022;1421;4299;2010;6321
520910;201702;3580;10143;2544;8197;896;3124;486;1487;1382;4611
520915;201702;639;1866;500;1592;102;348;227;724;329;1072
520920;201702;3439;9071;2486;7639;448;1501;983;3182;1431;4683
520929;201702;619;1629;483;1406;94;245;240;772;334;1017
520940;201702;1129;3147;899;2809;90;306;647;2031;737;2337
520945;201702;647;1534;509;1310;89;208;281;702;370;910
520960;201702;992;2883;778;2484;67;219;370;1211;437;1430
520970;201702;2583;7932;2241;7309;629;2239;540;1742;1169;3981
520980;201702;763;2151;639;1963;167;549;335;1032;502;1581
520990;201702;2983;9378;2796;9136;316;1080;1961;6731;2277;7811
520993;201702;921;2318;735;2057;41;121;540;1542;581;1663
520995;201702;2240;6022;1938;5623;373;1065;1186;3514;1559;4579
521000;201702;6950;20952;5628;18382;2087;7363;985;3135;3072;10498
521010;201702;4036;11460;3156;9882;670;2115;1351;4261;2021;6376
521015;201702;694;1859;587;1687;110;315;368;1056;478;1371
521020;201702;2865;8185;1980;6355;559;1932;224;689;783;2621
521030;201702;645;1624;482;1357;84;229;198;590;282;819
521040;201702;6227;16590;5126;14866;1566;4732;1660;5061;3226;9793
521056;201702;835;2470;670;2188;208;745;191;665;399;1410
521060;201702;1044;2696;822;2357;95;280;459;1372;554;1652
521080;201702;1094;2626;632;1881;54;194;268;710;322;904
521090;201702;3001;7890;2317;6955;730;2298;717;2254;1447;4552
521100;201702;1915;4486;1414;3801;206;537;882;2437;1088;2974
521120;201702;4612;11775;3561;10467;726;2211;1557;5003;2283;7214
521130;201702;1003;2655;717;2109;70;258;398;1159;468;1417
521140;201702;981;2945;794;2591;170;595;280;935;450;1530
521150;201702;11589;28967;7562;22097;2531;7852;1898;5736;4429;13588
521160;201702;887;2050;564;1526;94;272;254;670;348;942
521170;201702;1122;2745;829;2302;130;376;489;1346;619;1722
521180;201702;6095;19330;5456;18243;1432;5113;1915;6545;3347;11658
521190;201702;8756;24915;5864;19607;1492;5518;1172;3954;2664;9472
521200;201702;739;2000;589;1745;70;242;324;955;394;1197
521205;201702;617;1709;487;1487;51;173;299;907;350;1080
521210;201702;888;2442;557;1758;136;488;93;249;229;737
521220;201702;4308;10619;3139;9069;642;2021;1441;4286;2083;6307
521225;201702;383;946;317;873;31;77;232;670;263;747
521230;201702;1264;3843;1139;3603;386;1245;516;1636;902;2881
521250;201702;30323;91533;25581;84507;10757;37196;6626;23376;17383;60572
521260;201702;679;1626;558;1468;99;302;319;824;418;1126
521270;201702;1785;5088;1615;4856;120;312;1232;3856;1352;4168
521280;201702;1867;5639;1535;4999;468;1623;468;1518;936;3141
521290;201702;439;1211;328;1051;84;313;157;477;241;790
521295;201702;1181;2785;970;2497;113;279;696;1870;809;2149
521300;201702;1828;5148;1555;4724;165;538;1031;3134;1196;3672
521305;201702;716;2028;583;1816;105;334;311;1003;416;1337
521308;201702;4262;12568;3382;10876;751;2466;1492;4867;2243;7333
521310;201702;8161;23456;5758;18846;1483;5289;1282;4033;2765;9322
521340;201702;332;846;312;823;13;31;279;733;292;764
521350;201702;1952;5300;1564;4694;224;668;987;3025;1211;3693
521370;201702;917;2644;647;2147;215;772;97;336;312;1108
521375;201702;1349;3782;1075;3389;257;865;495;1561;752;2426
521377;201702;1066;2679;954;2554;51;107;817;2216;868;2323
521380;201702;5694;15927;3990;12759;550;1868;1072;3580;1622;5448
521385;201702;534;1387;457;1294;133;396;207;630;340;1026
521390;201702;775;2139;621;1935;198;716;192;584;390;1300
521400;201702;1981;5521;1771;5263;281;930;1244;3707;1525;4637
521405;201702;1385;3843;1084;3315;307;994;429;1343;736;2337
521410;201702;725;2162;677;2093;180;506;330;1108;510;1614
521440;201702;1364;3929;1093;3376;244;826;305;811;549;1637
521450;201702;3618;11738;2926;10343;905;3411;585;2038;1490;5449
521460;201702;6767;19096;5470;16826;1491;4977;2135;6437;3626;11414
521470;201702;683;1969;489;1561;110;352;93;289;203;641
521480;201702;351;1051;233;784;50;185;71;228;121;413
521483;201702;2734;7082;2035;5880;502;1498;564;1609;1066;3107
521486;201702;1639;4117;1318;3674;91;235;977;2738;1068;2973
521487;201702;484;1306;364;1114;94;322;86;258;180;580
521490;201702;803;2270;618;1939;41;180;418;1263;459;1443
521500;201702;1305;4078;957;3333;194;790;177;542;371;1332
521520;201702;874;2021;660;1739;137;379;327;919;464;1298
521523;201702;13293;46578;11884;43636;4202;16328;2160;8948;6362;25276
521525;201702;1082;2745;886;2464;106;342;540;1448;646;1790
521530;201702;1658;4690;1068;3501;250;877;159;509;409;1386
521540;201702;878;2358;608;1906;107;403;250;772;357;1175
521550;201702;1590;4021;1021;2887;184;557;456;1264;640;1821
521560;201702;3639;11884;2968;10951;904;3596;1316;5110;2220;8706
521565;201702;603;1543;506;1419;82;227;324;903;406;1130
521570;201702;4682;12792;3004;9504;629;2156;423;1367;1052;3523
521580;201702;532;1235;316;922;70;212;48;140;118;352
521590;201702;586;1614;464;1412;135;461;162;465;297;926
521600;201702;432;1233;307;977;82;265;67;205;149;470
521630;201702;1278;3146;889;2593;210;736;215;561;425;1297
521640;201702;2108;5245;1612;4570;387;1089;716;2127;1103;3216
521645;201702;548;1631;409;1341;93;326;124;375;217;701
521680;201702;1269;4045;1058;3633;403;1454;117;413;520;1867
521690;201702;545;1570;480;1463;114;402;234;681;348;1083
521710;201702;2672;7771;2125;6822;474;1591;564;1832;1038;3423
521720;201702;1896;5333;1448;4492;251;806;726;2190;977;2996
521730;201702;3636;11724;3100;10656;1136;4303;551;1661;1687;5964
521740;201702;3605;9915;2859;8837;525;1811;1358;4413;1883;6224
521760;201702;14507;44744;12267;41118;3336;12256;4417;15209;7753;27465
521770;201702;2569;7315;2041;6324;709;2385;530;1562;1239;3947
521800;201702;6698;20069;5706;18386;1718;5833;2001;6837;3719;12670
521805;201702;930;2070;672;1709;168;394;313;873;481;1267
521810;201702;758;1873;558;1594;97;294;249;756;346;1050
521830;201702;5102;15857;4503;14965;616;2276;2966;9811;3582;12087
521839;201702;687;1868;504;1529;105;348;204;584;309;932
521850;201702;6378;17102;4680;14224;1224;4024;916;2671;2140;6695
521860;201702;1875;4927;1429;4264;316;1094;446;1326;762;2420
521870;201702;482;1578;400;1409;107;392;132;448;239;840
521878;201702;772;2173;549;1727;88;316;204;601;292;917
521880;201702;21492;55377;14839;44838;3837;12348;4474;14134;8311;26482
521890;201702;3199;9396;2361;7707;630;2223;407;1308;1037;3531
521900;201702;1424;3674;954;2956;239;816;327;962;566;1778
521910;201702;919;2460;810;2326;121;378;459;1402;580;1780
521920;201702;293;926;242;829;85;318;51;172;136;490
521925;201702;694;2074;556;1814;108;371;149;462;257;833
521930;201702;3428;10867;2962;10009;1056;3746;585;2061;1641;5807
521935;201702;613;1700;517;1524;112;317;241;694;353;1011
521940;201702;925;2508;765;2280;138;459;446;1316;584;1775
521945;201702;650;1976;548;1796;93;308;267;943;360;1251
521950;201702;670;1680;535;1492;52;165;382;1065;434;1230
521960;201702;646;1924;508;1651;100;363;227;715;327;1078
521970;201702;2704;7044;2213;6462;129;336;1839;5606;1968;5942
521971;201702;964;2586;676;2060;121;388;166;494;287;882
521973;201702;945;2882;794;2619;145;510;386;1285;531;1795
521975;201702;12600;34392;11263;32737;1909;5903;7467;21625;9376;27528
521980;201702;2149;5765;1808;5338;232;609;1367;4192;1599;4801
521990;201702;1144;3198;915;2841;101;340;603;1925;704;2265
522000;201702;2289;6171;1663;5374;215;754;879;3016;1094;3770
522005;201702;379;911;265;748;81;216;93;272;174;488
522010;201702;3303;9285;2725;8341;969;3039;637;1978;1606;5017
522015;201702;903;2639;741;2370;162;516;342;1119;504;1635
522020;201702;5179;13209;3838;11098;911;2740;1762;5099;2673;7839
522026;201702;664;1835;498;1630;91;314;228;808;319;1122
522028;201702;549;1525;433;1268;50;142;258;754;308;896
522040;201702;2304;5537;1820;4957;306;838;1250;3474;1556;4312
522045;201702;14800;47618;12168;42350;3371;12880;2115;7295;5486;20175
522050;201702;1107;3154;775;2493;169;566;198;575;367;1141
522060;201702;2320;6915;1943;6351;431;1487;982;3274;1413;4761
522068;201702;1678;5086;1484;4852;165;496;1077;3709;1242;4205
522070;201702;662;1959;590;1842;81;314;385;1158;466;1472
522100;201702;473;1392;403;1279;121;429;165;507;286;936
522108;201702;824;2565;681;2326;65;294;497;1636;562;1930
522119;201702;1414;4155;1174;3797;244;820;548;1826;792;2646
522130;201702;344;950;279;869;72;235;151;481;223;716
522140;201702;16101;46318;13115;40878;3970;13361;2572;7702;6542;21063
522145;201702;787;2125;656;1930;175;485;333;1073;508;1558
522150;201702;962;2500;772;2205;182;521;315;926;497;1447
522155;201702;838;2361;726;2189;156;433;397;1270;553;1703
522157;201702;651;1764;546;1610;36;132;404;1178;440;1310
522160;201702;6147;17124;4388;13966;1283;4473;443;1501;1726;5974
522170;201702;2259;6588;1749;5619;584;1996;349;1134;933;3130
522180;201702;331;933;241;782;69;234;58;207;127;441
522185;201702;16008;43998;12718;39795;3670;12221;5606;18312;9276;30533
522190;201702;872;2143;671;1862;117;337;310;897;427;1234
522200;201702;1659;5350;1319;4580;324;1191;263;882;587;2073
522205;201702;1288;3553;1028;3153;154;513;571;1729;725;2242
522220;201702;1402;3573;1115;3218;187;556;642;1980;829;2536
522230;201702;1233;3362;1039;3068;130;480;633;1857;763;2337
530010;201702;186319;574213;163982;536807;42410;154808;68002;216824;110412;371632
110001;201701;3162;10515;2828;9970;649;2388;1427;5103;2076;7491
110002;201701;12535;35929;9615;30908;2995;10417;2868;9079;5863;19496
110003;201701;692;2171;583;1976;196;711;111;355;307;1066
110004;201701;9029;28160;7361;24873;2326;8427;1309;4766;3635;13193
110005;201701;1694;5323;1452;4867;441;1560;579;1934;1020;3494
110006;201701;1634;5007;1135;3982;341;1265;125;411;466;1676
110007;201701;1344;3989;1141;3601;332;1104;454;1641;786;2745
110008;201701;2327;7828;2163;7602;320;1063;1612;5915;1932;6978
110009;201701;4461;13450;3397;11714;1019;3757;974;3467;1993;7224
110010;201701;6914;21847;6048;20548;1760;6042;2680;10103;4440;16145
110011;201701;6719;20734;5720;18792;1984;6891;1737;5727;3721;12618
110012;201701;14583;41522;11370;36096;3116;10483;2806;9158;5922;19641
110013;201701;5291;16619;4463;15037;1801;6236;1043;3843;2844;10079
110014;201701;3949;11359;3291;10287;903;2929;1595;4983;2498;7912
110015;201701;4716;13983;3216;10996;849;3103;472;1655;1321;4758
110018;201701;3793;10551;2720;8838;695;2550;894;2781;1589;5331
110020;201701;65421;175358;47632;151307;10537;35792;19714;65738;30251;101530
110025;201701;4099;11629;3279;10201;470;1613;2030;6193;2500;7806
110026;201701;606;1843;547;1754;140;444;289;976;429;1420
110028;201701;5884;17971;4687;15582;1459;5265;551;1884;2010;7149
110029;201701;1285;3595;985;3138;263;863;418;1346;681;2209
110030;201701;9717;26483;7365;23191;1962;6880;2421;7687;4383;14567
110032;201701;3567;11055;2963;9838;979;3333;804;2680;1783;6013
110033;201701;4855;15608;4255;14534;1490;5178;1359;4987;2849;10165
110034;201701;3308;8886;2618;7903;798;2559;1293;3878;2091;6437
110037;201701;1811;6225;1582;5727;401;1533;703;2551;1104;4084
110040;201701;3184;9897;2619;8842;796;2871;883;2927;1679;5798
110045;201701;4770;15328;4127;14478;1342;5068;1754;6189;3096;11257
110050;201701;1603;5124;1349;4638;464;1656;488;1710;952;3366
110060;201701;785;2577;619;2221;214;828;104;386;318;1214
110070;201701;1939;6437;1725;5951;570;2086;603;2018;1173;4104
110080;201701;4635;12281;3875;11428;573;1571;2752;8607;3325;10178
110090;201701;684;1976;496;1634;124;448;216;692;340;1140
110092;201701;1221;4043;1093;3856;177;683;677;2447;854;3130
110094;201701;3398;9976;2844;9167;966;3302;1029;3382;1995;6684
110100;201701;2070;6486;1848;6098;454;1610;972;3225;1426;4835
110110;201701;1573;4964;1337;4608;531;1894;327;1213;858;3107
110120;201701;1678;5253;1301;4452;381;1371;267;924;648;2295
110130;201701;2328;6611;1655;5472;490;1742;410;1404;900;3146
110140;201701;2295;7433;1822;6494;528;2010;422;1417;950;3427
110143;201701;1211;3691;901;3146;320;1198;313;1100;633;2298
110145;201701;1062;2991;742;2377;186;649;293;927;479;1576
110146;201701;386;1208;331;1118;65;210;169;585;234;795
110147;201701;652;1937;494;1629;132;456;164;509;296;965
110148;201701;1095;3367;726;2497;145;539;75;252;220;791
110149;201701;3199;9488;2501;8385;852;2842;979;3521;1831;6363
110150;201701;2334;6693;1904;6080;581;2025;688;2259;1269;4284
110155;201701;805;2497;697;2255;159;561;304;944;463;1505
110160;201701;1782;5747;1481;5163;554;1967;441;1599;995;3566
110170;201701;2687;7571;1948;6225;425;1448;900;2856;1325;4304
110175;201701;1587;4840;1268;4392;209;762;692;2518;901;3280
110180;201701;1184;3481;977;3161;280;901;490;1624;770;2525
120001;201701;2718;9187;2477;8811;502;1848;1500;5529;2002;7377
120005;201701;1536;6434;1448;6258;176;826;1035;4645;1211;5471
120010;201701;4703;15825;4510;15553;540;1821;3495;12376;4035;14197
120013;201701;1974;7905;1886;7781;447;1832;1133;4987;1580;6819
120017;201701;1916;6916;1779;6666;512;1914;781;3291;1293;5205
120020;201701;14033;62088;13578;61226;1960;9224;9651;44945;11611;54169
120025;201701;2323;8123;2234;7992;404;1501;1430;5234;1834;6735
120030;201701;6535;25088;6348;24874;233;1205;5700;22383;5933;23588
120032;201701;1509;7321;1451;7176;167;992;1084;5363;1251;6355
120033;201701;3548;14223;3455;14060;236;1074;3029;12383;3265;13457
120034;201701;1981;8578;1893;8386;156;968;1498;6533;1654;7501
120035;201701;3168;14065;3093;13928;222;1172;2626;11917;2848;13089
120038;201701;2518;9041;2387;8801;572;2152;1318;5034;1890;7186
120039;201701;1778;8432;1731;8343;184;1086;1318;6394;1502;7480
120040;201701;43049;153865;39625;147805;9160;36996;20625;78534;29785;115530
120042;201701;3026;12474;2869;12126;235;1207;2155;9185;2390;10392
120043;201701;957;4388;927;4339;67;317;776;3746;843;4063
120045;201701;4338;14622;4214;14479;348;1362;3685;12650;4033;14012
120050;201701;7887;32256;7508;31443;1011;4603;5262;22686;6273;27289
120060;201701;7767;34186;7579;33855;762;3962;5967;26939;6729;30901
120070;201701;2663;9850;2576;9670;419;1606;1703;6596;2122;8202
120080;201701;3520;13287;3378;13042;619;2509;2332;9192;2951;11701
130002;201701;3156;12875;2953;12569;174;904;2574;11007;2748;11911
130006;201701;2097;8682;1817;8182;204;1081;1334;6031;1538;7112
130008;201701;2244;8733;2073;8412;138;670;1673;6809;1811;7479
130010;201701;3121;10196;2906;9954;144;548;2620;9010;2764;9558
130014;201701;3178;10299;2739;9586;490;1864;1720;6102;2210;7966
130020;201701;2760;10316;2631;10085;121;677;2235;8444;2356;9121
130030;201701;7940;29492;7603;29104;228;718;7080;27628;7308;28346
130040;201701;3783;11614;3339;11041;298;1098;2668;8921;2966;10019
130050;201701;6126;24915;5779;24459;331;1447;4949;21560;5280;23007
130060;201701;5823;26895;5563;26479;551;3177;4360;20739;4911;23916
130063;201701;3887;17056;3712;16841;267;1370;3263;14926;3530;16296
130068;201701;3194;13260;2879;12608;254;1292;2080;9204;2334;10496
130070;201701;7365;23944;6547;22997;471;1615;5460;19735;5931;21350
130080;201701;5592;24192;5229;23673;629;3365;3844;17516;4473;20881
130083;201701;2250;8715;2111;8498;262;1221;1565;6292;1827;7513
130090;201701;2808;9759;2675;9561;87;390;2360;8528;2447;8918
130100;201701;5889;21324;5722;21130;139;571;5430;20152;5569;20723
130110;201701;6645;21382;6302;20984;559;1722;5303;18123;5862;19845
130115;201701;4663;16186;4438;15838;155;643;3840;13769;3995;14412
130120;201701;14829;55821;13823;54524;1390;5769;11106;44818;12496;50587
130130;201701;4082;16289;4012;16175;206;1034;3524;14210;3730;15244
130140;201701;6238;24448;6132;24333;260;1104;5690;22654;5950;23758
130150;201701;3429;13614;3361;13529;145;778;3032;12160;3177;12938
130160;201701;4249;17540;4069;17311;446;2303;3294;13977;3740;16280
130165;201701;2912;11873;2770;11626;170;913;2322;9774;2492;10687
130170;201701;9544;32947;8274;31435;909;3713;6451;25092;7360;28805
130180;201701;3514;11577;3449;11491;80;271;3271;10961;3351;11232
130185;201701;12083;37465;10715;35953;745;2073;8984;31759;9729;33832
130190;201701;16791;57801;14770;55144;2301;8791;10117;39220;12418;48011
130195;201701;1973;8333;1918;8264;115;451;1690;7472;1805;7923
130200;201701;2038;6949;1859;6679;327;1179;1243;4632;1570;5811
130210;201701;1321;5148;1207;5012;125;674;940;3861;1065;4535
130220;201701;1992;8166;1851;7898;209;1056;1281;5484;1490;6540
130230;201701;3717;16987;3489;16623;417;2147;2657;13005;3074;15152
130240;201701;8942;32793;8044;31524;391;2128;6908;27091;7299;29219
130250;201701;19835;68523;18626;67044;2639;9222;13708;51784;16347;61006
130255;201701;4249;14611;3979;14197;196;791;3446;12375;3642;13166
130260;201701;246169;800277;221068;758520;63878;235169;94974;328918;158852;564087
130270;201701;7407;30544;6921;29812;834;3806;5246;23213;6080;27019
130280;201701;3335;13875;3220;13740;115;519;2976;12871;3091;13390
130290;201701;11186;39809;10584;39125;172;459;10091;38029;10263;38488
130300;201701;4533;17209;4290;16848;264;1267;3659;14444;3923;15711
130310;201701;5016;19160;4624;18644;361;1677;3782;15466;4143;17143
130320;201701;2965;10757;2721;10410;381;1553;1871;7355;2252;8908
130330;201701;3702;13414;3355;12989;173;871;2863;11104;3036;11975
130340;201701;18596;69737;17100;67930;1839;7476;13812;56498;15651;63974
130350;201701;3395;13867;3293;13724;259;1482;2758;11334;3017;12816
130353;201701;6129;18681;5362;17711;1017;3322;3475;12276;4492;15598
130356;201701;4654;16720;4338;16223;510;1940;3163;12230;3673;14170
130360;201701;3303;9510;2920;9107;76;195;2739;8696;2815;8891
130370;201701;5443;21329;4967;20710;197;1056;4283;18017;4480;19073
130380;201701;7983;33040;7682;32607;496;2530;6563;27931;7059;30461
130390;201701;5241;23044;4961;22521;572;3078;3653;16552;4225;19630
130395;201701;2232;7749;2006;7327;208;821;1447;5316;1655;6137
130400;201701;2129;8089;1997;7897;113;559;1758;6958;1871;7517
130406;201701;10787;40804;9871;39560;1832;7727;6637;27109;8469;34836
130410;201701;3876;14652;3463;13926;1051;4499;1592;6604;2643;11103
130420;201701;10830;45049;10344;44350;1560;6925;7714;33994;9274;40919
130423;201701;3447;13105;3199;12767;244;1219;2685;10629;2929;11848
130426;201701;2400;10128;2322;10006;127;604;2037;8912;2164;9516
130430;201701;3541;12312;3391;12097;257;969;2837;10287;3094;11256
130440;201701;3556;12845;3335;12588;186;788;2942;11191;3128;11979
140002;201701;1708;5588;1554;5384;125;516;1191;4111;1316;4627
140005;201701;3610;9766;3480;9627;59;143;3363;9354;3422;9497
140010;201701;53816;154423;44185;140445;10617;35832;18486;62356;29103;98188
140015;201701;2950;9374;2743;9131;143;414;2426;8264;2569;8678
140017;201701;3209;10242;2887;9828;288;1009;2173;7698;2461;8707
140020;201701;4500;15051;4018;14384;555;2236;2791;10039;3346;12275
140023;201701;2191;7270;1895;6827;220;869;1321;4851;1541;5720
140028;201701;2074;5740;1888;5489;198;692;1414;3972;1612;4664
140030;201701;3632;11366;3365;11013;598;1700;2299;7983;2897;9683
140040;201701;1773;8166;1719;8091;119;742;1516;7045;1635;7787
140045;201701;2551;9355;2309;9020;436;1664;1519;6324;1955;7988
140047;201701;5578;17002;4895;15934;1204;3987;2334;8209;3538;12196
140050;201701;1412;4425;1249;4201;214;745;787;2718;1001;3463
140060;201701;1465;4412;1302;4158;217;739;887;2861;1104;3600
140070;201701;1652;8958;1599;8808;153;1010;1241;6860;1394;7870
150010;201701;36249;106179;34074;103271;2235;7578;27864;84450;30099;92028
150013;201701;1719;4968;1534;4759;163;483;1170;3734;1333;4217
150020;201701;12458;41527;12030;40945;1385;4302;9685;34012;11070;38314
150030;201701;7482;31365;7237;31016;546;2308;6160;26991;6706;29299
150034;201701;4114;11377;3802;10945;147;477;3332;9598;3479;10075
150040;201701;12494;39820;11131;38232;1215;3463;8843;32294;10058;35757
150050;201701;5560;22015;5289;21553;258;1357;4563;18574;4821;19931
150060;201701;17777;55120;16022;52316;3527;11484;9158;31150;12685;42634
150070;201701;6064;24470;5441;23806;205;1085;5004;22074;5209;23159
150080;201701;77313;198290;65756;183211;14177;40071;31565;94421;45742;134492
150085;201701;5570;18760;5333;18471;349;1024;4679;16687;5028;17711
150090;201701;10358;39313;9792;38500;849;3619;7736;30886;8585;34505
150095;201701;5335;17217;4866;16568;329;1109;3905;13700;4234;14809
150100;201701;3210;11866;2991;11478;202;916;2359;8960;2561;9876
150110;201701;3627;17081;3607;17039;217;1099;3212;15312;3429;16411
150120;201701;6638;23838;6477;23600;456;1492;5446;20590;5902;22082
150125;201701;670;1970;585;1871;86;307;405;1300;491;1607
150130;201701;22161;67007;20367;64510;2325;7174;15027;48936;17352;56110
150140;201701;166817;458768;154579;442782;19999;56851;112539;328494;132538;385345
150145;201701;4472;14077;4059;13533;462;1567;3206;10876;3668;12443
150150;201701;12071;36073;11141;34747;1606;5306;7645;24173;9251;29479
150157;201701;3029;9006;2628;8452;315;1160;1822;5952;2137;7112
150160;201701;3056;9688;2878;9428;754;2513;1606;5455;2360;7968
150170;201701;21472;78740;20352;76933;2757;10847;14718;56727;17475;67574
150172;201701;3016;10198;2659;9614;306;1153;1958;7240;2264;8393
150175;201701;1833;5628;1718;5492;135;462;1401;4621;1536;5083
150178;201701;9757;30049;8468;28548;891;3301;6275;21788;7166;25089
150180;201701;18616;73860;17897;72915;1163;5424;15323;62904;16486;68328
150190;201701;6950;23976;6695;23641;198;875;6124;21706;6322;22581
150195;201701;5281;17166;4976;16694;146;539;4491;15167;4637;15706
150200;201701;5292;16672;5032;16372;98;368;4742;15522;4840;15890
150210;201701;24951;92711;24187;91681;1718;6718;20379;79274;22097;85992
150215;201701;7391;23160;6518;21803;2025;6986;2689;9320;4714;16306
150220;201701;11419;35389;10301;33697;2220;7489;5513;18579;7733;26068
150230;201701;11700;36277;10254;34268;1366;4831;6814;23354;8180;28185
150240;201701;34190;101402;29557;93183;9962;32385;7994;26560;17956;58945
150250;201701;3999;16677;3858;16475;793;3399;2571;11486;3364;14885
150260;201701;2022;7894;1921;7725;339;1365;1215;5049;1554;6414
150270;201701;8061;24769;6340;22545;1595;5848;3365;12518;4960;18366
150275;201701;5918;21304;5585;20791;628;2311;4195;16009;4823;18320
150276;201701;2130;6356;1899;6062;280;946;1421;4601;1701;5547
150277;201701;4710;14457;4048;13644;619;2238;2853;9887;3472;12125
150280;201701;5780;26019;5618;25683;739;3404;4214;19731;4953;23135
150285;201701;3023;11514;2806;11157;288;1279;2016;8157;2304;9436
150290;201701;10070;28336;9603;27821;567;1443;8442;25152;9009;26595
150293;201701;9077;24349;6760;21195;1915;6314;2429;8408;4344;14722
150295;201701;7553;21903;6258;20405;1418;4609;3537;12874;4955;17483
150300;201701;2015;6548;1882;6370;95;457;1556;5221;1651;5678
150304;201701;4070;12985;3553;12160;624;2134;2238;7975;2862;10109
150307;201701;6427;21382;6070;20879;346;1281;5174;17854;5520;19135
150309;201701;5959;20382;5325;19432;1267;4609;2875;11135;4142;15744
150310;201701;6430;27298;6151;26904;509;2510;5053;22264;5562;24774
150320;201701;9467;24277;8666;23370;519;1382;7232;19690;7751;21072
150330;201701;13963;46950;13092;45714;1792;6310;9626;34551;11418;40861
150340;201701;2560;7978;2362;7671;216;752;1806;5884;2022;6636
150345;201701;6635;21737;6210;21167;551;1946;4980;17318;5531;19264
150350;201701;8101;24262;7532;23575;1114;2966;5658;18562;6772;21528
150360;201701;20386;63175;17849;60016;2854;9519;12023;42233;14877;51752
150370;201701;9828;35132;8997;34004;961;3661;6822;26706;7783;30367
150375;201701;2866;12695;2764;12552;241;1128;2332;10732;2573;11860
150380;201701;9620;27586;8491;26012;471;1493;7131;22140;7602;23633
150390;201701;7638;33150;7149;32275;1177;5183;4788;22585;5965;27768
150400;201701;5838;22634;5619;22221;482;1917;4459;17968;4941;19885
150405;201701;8038;24208;7159;23125;826;2096;5288;18424;6114;20520
150410;201701;1592;5986;1469;5740;230;1034;909;3566;1139;4600
150420;201701;35147;116400;29334;107086;9734;38148;8658;34744;18392;72892
150430;201701;7391;24574;7016;24011;819;2785;5302;18579;6121;21364
150440;201701;5409;18409;5197;18133;456;1571;4252;15136;4708;16707
150442;201701;21528;61300;18918;57400;3225;9847;11362;35894;14587;45741
150445;201701;5367;18275;4954;17623;506;1829;3784;13735;4290;15564
150450;201701;4165;20279;4026;20039;501;2500;3133;15998;3634;18498
150460;201701;7061;25967;6537;25329;390;1763;5414;21818;5804;23581
150470;201701;17531;53732;16814;52873;1010;2732;14966;47989;15976;50721
150475;201701;3655;12583;3370;12193;272;1030;2718;10016;2990;11046
150480;201701;13910;47259;12759;45473;1244;4702;9902;35944;11146;40646
150490;201701;7212;27435;7020;27145;277;1271;6225;24234;6502;25505
150495;201701;4926;18067;4775;17876;150;638;4415;16615;4565;17253
150497;201701;2546;9369;2286;8863;724;2931;1017;4061;1741;6992
150500;201701;3122;8554;2884;8216;256;721;2309;6580;2565;7301
150503;201701;3222;9983;2695;9266;843;2938;1445;5228;2288;8166
150506;201701;10617;36629;9688;35319;2092;7141;6136;24034;8228;31175
150510;201701;9705;37632;8822;35830;1386;5579;5751;24481;7137;30060
150520;201701;6643;26327;6534;26191;239;979;6109;24721;6348;25700
150530;201701;12244;42087;11102;40320;1026;3585;8589;31874;9615;35459
150540;201701;4586;13828;4053;13087;248;889;3340;10796;3588;11685
150543;201701;5722;17447;5039;16489;1007;3359;3055;10426;4062;13785
150548;201701;9036;29100;8419;28330;344;1045;7700;26260;8044;27305
150549;201701;2024;6554;1861;6375;58;239;1704;5875;1762;6114
150550;201701;19874;63017;17385;58810;5136;17848;6622;23693;11758;41541
150553;201701;22089;75312;18393;67999;6531;25558;4702;18479;11233;44037
150555;201701;1742;5144;1440;4656;83;301;1046;3410;1129;3711
150560;201701;1853;6084;1723;5821;293;992;1022;3529;1315;4521
150563;201701;2509;8402;2336;8109;558;2087;1237;4318;1795;6405
150565;201701;3872;13329;3535;12792;151;738;2935;10687;3086;11425
150570;201701;5855;21090;5675;20782;448;1910;4486;16411;4934;18321
150580;201701;9762;40581;9480;40242;586;2651;8262;35680;8848;38331
150590;201701;5617;22508;5444;22284;184;923;5054;20688;5238;21611
150600;201701;8018;30630;7658;30128;287;1356;6868;27217;7155;28573
150610;201701;2374;7983;2192;7616;203;792;1631;5593;1834;6385
150611;201701;2722;9189;2562;8919;153;559;2126;7453;2279;8012
150613;201701;11777;34701;9558;31345;2703;9328;4056;13733;6759;23061
150616;201701;3075;9340;2347;8113;598;2306;707;2334;1305;4640
150618;201701;6323;21231;5655;20052;1290;4618;3134;11537;4424;16155
150619;201701;5048;17243;4643;16603;471;1938;3419;12155;3890;14093
150620;201701;6177;22081;5588;21337;623;2515;4341;16746;4964;19261
150630;201701;5812;17230;5504;16871;475;1519;4610;14362;5085;15881
150635;201701;3839;12453;3463;11723;914;3185;1451;5106;2365;8291
150640;201701;1972;5787;1865;5666;114;322;1658;5201;1772;5523
150650;201701;11379;34703;10274;32738;2782;8952;4504;15052;7286;24004
150655;201701;5024;16366;4722;15830;535;1935;3596;12146;4131;14081
150658;201701;4401;13176;3816;12400;718;2551;2404;8092;3122;10643
150660;201701;5565;17256;5078;16546;1082;3557;2857;9560;3939;13117
150670;201701;7399;19300;6080;17691;533;1622;4820;14370;5353;15992
150680;201701;58273;197624;49888;184148;14465;54428;20835;85150;35300;139578
150690;201701;1979;6099;1796;5826;195;652;1301;4260;1496;4912
150700;201701;6060;18974;5567;18328;842;2768;3804;12927;4646;15695
150710;201701;4267;14305;3838;13631;375;1466;2751;9903;3126;11369
150715;201701;4827;15106;4241;14222;399;1534;3178;10694;3577;12228
150720;201701;6384;25579;6064;25010;667;3106;4614;19302;5281;22408
150730;201701;10062;33993;9280;32694;1113;4093;6974;25170;8087;29263
150740;201701;3565;11356;3210;10735;620;2196;1810;6054;2430;8250
150745;201701;4768;15250;4305;14601;1062;3775;2553;8752;3615;12527
150746;201701;1342;4393;1279;4273;108;369;994;3377;1102;3746
150747;201701;5237;16200;4648;15471;458;1387;3404;12151;3862;13538
150750;201701;3428;10954;3101;10501;197;808;2484;8476;2681;9284
150760;201701;11176;35397;10380;34390;1407;4810;7515;25389;8922;30199
150770;201701;5872;22284;5654;21940;248;866;5006;20316;5254;21182
150775;201701;1030;3124;882;2878;165;654;496;1586;661;2240
150780;201701;3595;11524;3468;11380;135;543;3137;10297;3272;10840
150790;201701;4961;16106;4582;15674;300;1018;3717;13622;4017;14640
150795;201701;14922;47927;13489;45717;2925;9729;7912;28225;10837;37954
150796;201701;3101;9001;2793;8640;267;885;2186;6904;2453;7789
150797;201701;3660;12560;3365;12025;124;520;2801;10027;2925;10547
150800;201701;13529;44040;12449;42714;2367;7386;8500;31192;10867;38578
150803;201701;6637;23759;6240;23115;714;2865;4642;17334;5356;20199
150805;201701;2630;9447;2427;9098;337;1283;1715;6556;2052;7839
150808;201701;5412;17935;4415;16003;1751;6914;542;2035;2293;8949
150810;201701;18515;56591;15448;52804;2445;8228;9961;36131;12406;44359
150812;201701;5206;16293;4778;15560;604;2235;3331;10593;3935;12828
150815;201701;8291;27478;7477;26476;733;2577;5887;21446;6620;24023
150820;201701;11278;32638;10114;31342;788;2191;8126;26018;8914;28209
150830;201701;12451;47304;11834;46548;620;3124;9946;40158;10566;43282
150835;201701;2137;7470;1994;7198;439;1584;1099;4142;1538;5726
150840;201701;7216;21970;5989;19876;1254;4568;2955;9838;4209;14406
160005;201701;800;2714;765;2652;60;249;624;2142;684;2391
160010;201701;1373;4652;1370;4649;17;28;1343;4598;1360;4626
160015;201701;1730;6440;1689;6378;78;252;1550;5970;1628;6222
160020;201701;1836;6763;1717;6577;206;879;1285;4963;1491;5842
160021;201701;1031;4427;995;4367;116;648;737;3227;853;3875
160023;201701;977;4091;968;4078;74;310;831;3553;905;3863
160025;201701;1457;4402;1439;4382;39;99;1377;4219;1416;4318
160027;201701;8173;24364;7611;23740;1225;3695;5665;18384;6890;22079
160030;201701;49866;169101;44056;159988;10432;37654;23063;90549;33495;128203
160040;201701;4301;16780;4203;16647;175;1002;3818;14931;3993;15933
160050;201701;3205;11960;2853;11455;1420;5404;899;4222;2319;9626
160053;201701;2983;11159;2913;11058;739;2740;1851;7322;2590;10062
160055;201701;564;2248;559;2241;31;160;502;1991;533;2151
160060;201701;15288;52556;14511;51656;1628;5732;11390;41474;13018;47206
160070;201701;2676;10515;2524;10268;189;910;2100;8555;2289;9465
160080;201701;2590;9665;2529;9588;56;294;2379;8989;2435;9283
170025;201701;496;1631;446;1559;125;451;236;830;361;1281
170030;201701;1153;3804;995;3521;214;781;456;1657;670;2438
170035;201701;1309;3771;1087;3373;145;498;570;1781;715;2279
170040;201701;1863;5774;1652;5506;189;690;894;3257;1083;3947
170070;201701;1565;4202;1201;3729;213;713;676;2120;889;2833
170100;201701;2267;6848;1997;6443;184;581;1494;4887;1678;5468
170105;201701;739;2322;588;2004;136;506;258;854;394;1360
170110;201701;882;2929;770;2712;169;661;334;1195;503;1856
170130;201701;1352;4287;1075;3738;267;972;456;1678;723;2650
170190;201701;1543;4576;1163;3952;383;1234;258;1086;641;2320
170200;201701;1565;4319;1004;3245;288;1029;199;600;487;1629
170210;201701;30410;86080;24351;76450;7938;27121;5023;16874;12961;43995
170215;201701;1200;3689;1022;3421;109;416;707;2363;816;2779
170220;201701;5356;18337;4925;17477;1149;4188;2603;9505;3752;13693
170230;201701;1330;4243;1078;3741;223;847;465;1588;688;2435
170240;201701;2681;7980;2180;7195;236;953;1454;4759;1690;5712
170255;201701;3330;10527;2726;9459;804;2855;1111;3993;1915;6848
170270;201701;992;2453;673;2020;41;126;461;1363;502;1489
170290;201701;2699;7790;2377;7424;273;589;1857;6332;2130;6921
170300;201701;1833;5566;1499;5012;148;524;966;3275;1114;3799
170305;201701;694;2081;574;1858;94;347;285;913;379;1260
170307;201701;973;3470;832;3194;184;758;411;1618;595;2376
170310;201701;1482;4163;1134;3564;281;940;514;1613;795;2553
170320;201701;1096;3146;792;2635;152;528;377;1304;529;1832
170330;201701;786;2564;721;2456;52;209;540;1822;592;2031
170360;201701;454;1428;371;1284;72;291;186;611;258;902
170370;201701;1309;3712;1004;3222;145;524;526;1691;671;2215
170380;201701;1658;5366;1354;4861;203;853;707;2581;910;3434
170382;201701;559;1745;462;1580;41;178;309;1059;350;1237
170384;201701;1575;6281;1438;6029;382;1695;698;2984;1080;4679
170386;201701;846;2524;726;2333;223;844;290;887;513;1731
170388;201701;575;1745;462;1556;100;377;176;573;276;950
170389;201701;882;2992;792;2839;58;237;593;2109;651;2346
170390;201701;1269;3605;1046;3327;89;294;785;2549;874;2843
170410;201701;532;1689;431;1500;27;120;272;930;299;1050
170460;201701;471;1288;324;1035;56;213;122;381;178;594
170510;201701;765;2501;594;2173;93;402;293;1028;386;1430
170550;201701;6535;18543;4857;15638;1581;5645;691;2283;2272;7928
170555;201701;1291;3720;1045;3344;187;652;544;1808;731;2460
170560;201701;1035;3359;809;3048;161;650;436;1715;597;2365
170600;201701;1239;3694;1083;3475;288;898;627;2102;915;3000
170610;201701;1576;4821;1270;4276;161;614;791;2651;952;3265
170625;201701;395;1193;295;981;36;129;108;342;144;471
170650;201701;1200;3830;978;3429;261;967;340;1281;601;2248
170700;201701;3901;12143;3174;10907;623;2335;1467;5243;2090;7578
170710;201701;1733;5083;1374;4425;260;902;692;2196;952;3098
170720;201701;1809;4853;1560;4481;127;316;1249;3725;1376;4041
170730;201701;921;2758;745;2462;210;733;284;973;494;1706
170740;201701;2142;7652;1861;7124;282;1114;1179;4596;1461;5710
170755;201701;767;2389;592;2010;95;363;262;885;357;1248
170765;201701;1207;3307;897;2815;241;784;342;1140;583;1924
170770;201701;1636;5529;1506;5298;328;1146;857;3113;1185;4259
170820;201701;3684;12864;3331;12269;608;2238;1866;7334;2474;9572
170825;201701;784;2198;661;1993;87;261;392;1170;479;1431
170830;201701;1410;4063;1189;3729;63;144;991;3200;1054;3344
170900;201701;2484;8840;2337;8612;196;802;1887;7034;2083;7836
170930;201701;3708;10893;3203;10139;690;2367;1629;5344;2319;7711
170950;201701;13484;39160;10074;33245;3004;11241;1485;4959;4489;16200
170980;201701;484;1412;366;1222;66;224;158;516;224;740
171050;201701;1501;4982;1345;4680;97;443;1033;3543;1130;3986
171070;201701;1416;4381;1286;4195;277;896;793;2709;1070;3605
171090;201701;1073;2858;889;2614;60;185;646;1890;706;2075
171110;201701;574;1695;433;1446;122;471;179;532;301;1003
171150;201701;1017;2785;672;2170;78;277;407;1332;485;1609
171180;201701;675;2030;452;1576;94;332;179;670;273;1002
171190;201701;1450;5490;1301;5186;264;1084;657;2746;921;3830
171195;201701;834;2891;720;2692;84;384;467;1754;551;2138
171200;201701;618;1928;490;1692;153;564;155;519;308;1083
171215;201701;440;1298;339;1098;50;191;163;534;213;725
171240;201701;691;2524;639;2426;65;322;400;1551;465;1873
171245;201701;567;1910;471;1681;109;434;172;598;281;1032
171250;201701;997;2914;798;2584;198;667;366;1192;564;1859
171270;201701;377;1536;350;1479;123;490;132;630;255;1120
171280;201701;855;2670;714;2431;160;572;321;1168;481;1740
171320;201701;3684;11100;3078;10047;844;2782;1291;4418;2135;7200
171330;201701;2694;7890;2197;7084;563;1950;1041;3396;1604;5346
171360;201701;1426;4531;1274;4307;99;370;1017;3466;1116;3836
171370;201701;639;1823;544;1694;103;363;328;1028;431;1391
171380;201701;1241;3971;1033;3608;395;1392;243;978;638;2370
171395;201701;887;2640;672;2219;119;485;319;1007;438;1492
171420;201701;1864;5809;1439;4974;350;1316;537;1887;887;3203
171430;201701;1018;3129;841;2820;133;453;502;1676;635;2129
171488;201701;2466;7527;2083;6974;431;1455;1118;3929;1549;5384
171500;201701;843;2448;684;2198;75;244;460;1509;535;1753
171510;201701;839;2920;748;2754;67;289;538;2001;605;2290
171515;201701;482;1389;372;1199;44;141;206;663;250;804
171525;201701;600;1938;522;1805;59;257;343;1138;402;1395
171550;201701;334;1094;256;952;68;282;89;339;157;621
171570;201701;1244;3898;1086;3598;211;641;696;2419;907;3060
171575;201701;1879;5188;1363;4290;252;868;651;2041;903;2909
171610;201701;5018;15790;4174;14322;1095;4134;1287;4538;2382;8672
171620;201701;2705;7754;2312;7235;127;495;1883;5932;2010;6427
171630;201701;841;2567;711;2374;174;608;387;1315;561;1923
171650;201701;2124;6560;1610;5497;393;1403;529;1821;922;3224
171660;201701;2343;6522;1766;5497;265;878;946;2932;1211;3810
171665;201701;1449;4200;1143;3737;203;712;570;1960;773;2672
171670;201701;1815;5099;1488;4574;386;1321;593;1785;979;3106
171700;201701;1077;3404;892;3051;153;540;474;1648;627;2188
171720;201701;738;2180;630;1995;146;484;332;1069;478;1553
171750;201701;1098;3442;843;2935;234;807;243;901;477;1708
171780;201701;1140;3094;842;2670;79;277;493;1567;572;1844
171790;201701;1398;4968;1190;4485;257;954;627;2537;884;3491
171800;201701;708;2149;577;1949;71;241;360;1268;431;1509
171820;201701;9606;29022;7972;26408;1619;5758;3733;12689;5352;18447
171830;201701;1315;4911;1179;4610;326;1213;477;2020;803;3233
171840;201701;697;1967;597;1823;44;154;441;1319;485;1473
171845;201701;661;1831;522;1606;73;248;272;847;345;1095
171850;201701;872;3130;775;2929;82;358;511;1938;593;2296
171855;201701;1109;3530;1014;3361;61;223;763;2519;824;2742
171865;201701;421;1425;373;1346;74;280;179;644;253;924
171870;201701;682;2073;555;1837;134;461;217;797;351;1258
171875;201701;1193;3834;1010;3537;86;376;690;2385;776;2761
171880;201701;809;2974;785;2940;84;299;633;2446;717;2745
171884;201701;883;2423;666;2103;151;540;176;646;327;1186
171886;201701;1315;4195;1021;3612;309;1206;217;791;526;1997
171888;201701;723;2173;539;1801;68;250;297;984;365;1234
171889;201701;483;1496;428;1404;73;243;224;797;297;1040
171890;201701;1196;3543;975;3221;176;591;542;1818;718;2409
171900;201701;490;1771;398;1551;109;453;143;566;252;1019
172000;201701;583;1870;499;1704;72;286;266;882;338;1168
172010;201701;1169;4043;1082;3891;119;519;771;2749;890;3268
172015;201701;330;1285;269;1161;52;218;135;608;187;826
172020;201701;2281;7564;2124;7326;254;955;1480;5154;1734;6109
172025;201701;701;2040;516;1733;77;290;267;922;344;1212
172030;201701;1110;3531;986;3329;57;252;765;2568;822;2820
172049;201701;1296;3309;935;2696;411;1291;346;946;757;2237
172065;201701;1335;3481;1084;3196;67;202;970;2894;1037;3096
172080;201701;2298;7245;1968;6669;190;787;1313;4414;1503;5201
172085;201701;471;1328;338;1056;57;171;111;348;168;519
172090;201701;3804;10344;3130;9396;98;332;2702;8195;2800;8527
172093;201701;554;1680;427;1453;87;339;207;689;294;1028
172097;201701;619;1833;484;1611;103;356;176;609;279;965
172100;201701;35431;100889;26573;86016;7142;25827;6993;23390;14135;49217
172110;201701;1608;6106;1419;5798;184;853;987;4131;1171;4984
172120;201701;4911;15354;4036;14065;739;2607;2323;8451;3062;11058
172125;201701;241;758;202;688;47;181;87;299;134;480
172130;201701;518;1450;396;1238;38;148;243;741;281;889
172208;201701;2115;6150;1858;5775;234;744;1155;3648;1389;4392
172210;201701;2500;7411;2164;6944;368;1307;1372;4414;1740;5721
210005;201701;20976;64854;17732;59865;5775;20706;6327;22041;12102;42747
210010;201701;1726;6481;1575;6218;83;353;1302;5245;1385;5598
210015;201701;3390;10638;3010;10054;193;524;2531;8760;2724;9284
210020;201701;6896;16636;6509;16190;188;522;6000;14858;6188;15380
210030;201701;5239;17526;4930;17119;323;1555;4127;14131;4450;15686
210040;201701;2083;6591;1968;6463;58;161;1817;6080;1875;6241
210043;201701;6794;18681;5808;17492;747;2092;4058;13127;4805;15219
210047;201701;6298;23185;5779;22442;504;2310;4517;17576;5021;19886
210050;201701;2201;8193;1863;7519;541;2238;781;3443;1322;5681
210055;201701;1711;5954;1570;5731;103;433;1223;4485;1326;4918
210060;201701;6932;27181;6446;26268;969;4146;4345;18200;5314;22346
210070;201701;7162;20863;6654;20257;110;400;6147;18869;6257;19269
210080;201701;3622;12657;3536;12553;29;131;3400;12142;3429;12273
210083;201701;4525;15679;4059;15172;106;516;3786;14216;3892;14732
210087;201701;2972;8691;2706;8347;270;835;2143;6724;2413;7559
210090;201701;10070;32057;9562;31270;367;1383;8519;27895;8886;29278
210095;201701;5864;20794;5597;20442;316;1300;4815;17751;5131;19051
210100;201701;7027;21222;6467;20496;303;1258;5422;17045;5725;18303
210110;201701;2750;9539;2639;9392;104;480;2359;8369;2463;8849
210120;201701;25651;71932;22417;68178;2726;7131;16197;52543;18923;59674
210125;201701;3607;11250;3476;11114;128;283;3187;10443;3315;10726
210130;201701;4131;12146;3797;11691;265;913;3127;9600;3392;10513
210135;201701;1599;4747;1395;4457;76;233;1134;3670;1210;3903
210140;201701;16560;52449;14172;49197;2710;10110;8264;29401;10974;39511
210150;201701;4544;11206;4053;10601;66;229;3712;9644;3778;9873
210160;201701;17071;53707;16109;52283;1311;3992;12987;43370;14298;47362
210170;201701;13590;47945;13140;47379;619;2527;11734;42569;12353;45096
210173;201701;2062;8063;1952;7895;68;390;1766;7176;1834;7566
210177;201701;3050;9287;2888;9097;92;265;2670;8531;2762;8796
210180;201701;1456;4417;1382;4312;47;197;1183;3659;1230;3856
210190;201701;4736;14987;4392;14373;178;853;3469;11119;3647;11972
210193;201701;1311;4136;1189;3943;64;241;982;3269;1046;3510
210197;201701;2032;6843;1871;6653;229;800;1425;5279;1654;6079
210200;201701;8105;26991;7513;26172;792;2651;5950;21386;6742;24037
210203;201701;6680;20765;6288;20262;335;982;5553;18240;5888;19222
210207;201701;3280;11744;3120;11460;272;872;2434;9355;2706;10227
210210;201701;8155;28025;7752;27469;117;465;7087;25566;7204;26031
210215;201701;1094;4610;1053;4546;91;467;825;3620;916;4087
210220;201701;5946;23181;5682;22760;297;1490;4861;19516;5158;21006
210230;201701;5111;16417;4783;15932;232;830;4222;14136;4454;14966
210232;201701;12624;40282;10605;37742;1509;5534;6897;26586;8406;32120
210235;201701;3708;11387;3282;10857;184;723;2784;9273;2968;9996
210237;201701;2258;8680;2194;8593;27;128;2096;8273;2123;8401
210240;201701;2949;9191;2742;8888;135;496;2333;7559;2468;8055
210250;201701;5236;16813;4926;16416;142;708;4479;14809;4621;15517
210255;201701;2544;8153;2323;7752;220;805;1771;5910;1991;6715
210260;201701;5028;16484;4687;15972;408;1410;3671;12760;4079;14170
210270;201701;5174;14765;4595;13961;129;633;3982;11936;4111;12569
210275;201701;3447;8458;3274;8270;128;240;3058;7872;3186;8112
210280;201701;5535;16651;4716;15514;290;1368;3486;11211;3776;12579
210290;201701;5502;18276;5096;17805;234;899;4406;15582;4640;16481
210300;201701;36387;100852;30192;93219;2223;7349;22525;72443;24748;79792
210310;201701;2874;8039;2630;7726;81;197;2308;6882;2389;7079
210312;201701;2288;7059;2147;6875;80;394;1898;6034;1978;6428
210315;201701;2758;8634;2441;8257;115;418;2116;7302;2231;7720
210317;201701;4026;12615;3861;12422;137;527;3571;11507;3708;12034
210320;201701;19091;62565;17629;60806;892;3491;15208;53352;16100;56843
210325;201701;3661;11113;3260;10515;185;678;2639;8597;2824;9275
210330;201701;32865;84378;26946;77818;4983;13142;16253;53518;21236;66660
210340;201701;11497;34423;10455;33071;1089;2958;7793;26392;8882;29350
210350;201701;9634;29404;8624;28010;476;1737;7056;23135;7532;24872
210355;201701;3846;14122;3499;13574;167;811;2930;11526;3097;12337
210360;201701;14956;45643;13607;43777;968;3754;10829;34674;11797;38428
210370;201701;9252;22178;7736;20558;287;556;6822;18872;7109;19428
210375;201701;3090;9294;2571;8626;752;2613;1219;4255;1971;6868
210380;201701;5759;15970;5210;15266;386;1068;4313;12886;4699;13954
210390;201701;2928;10473;2679;10084;156;796;2205;8279;2361;9075
210400;201701;4843;15194;4634;14963;97;255;4445;14496;4542;14751
210405;201701;7496;20989;6054;18926;1732;5515;2553;8599;4285;14114
210407;201701;1955;7023;1686;6548;194;805;1213;4730;1407;5535
210408;201701;2392;9292;2244;9103;158;794;1831;7605;1989;8399
210409;201701;3620;13165;3444;12907;215;1044;2867;10716;3082;11760
210410;201701;3675;11834;3507;11597;312;868;2808;9729;3120;10597
210420;201701;4004;13229;3651;12628;225;839;2976;10384;3201;11223
210430;201701;2078;6457;2009;6382;94;328;1772;5630;1866;5958
210440;201701;3861;12002;3715;11823;142;461;3407;10913;3549;11374
210450;201701;2681;8427;2373;7972;120;477;1906;6355;2026;6832
210455;201701;3537;10441;3255;10096;457;1411;2451;7910;2908;9321
210460;201701;3478;11330;3202;10918;169;718;2635;8975;2804;9693
210462;201701;1331;4852;1227;4664;81;407;985;3717;1066;4124
210465;201701;2544;8269;2353;7999;132;388;2045;7126;2177;7514
210467;201701;6028;20103;5667;19698;351;1250;4926;17393;5277;18643
210470;201701;2039;5532;1499;4738;95;298;1124;3627;1219;3925
210480;201701;14527;46248;12770;44076;1767;5929;9171;33886;10938;39815
210490;201701;3650;9920;3143;9220;79;305;2720;7962;2799;8267
210500;201701;6045;25400;5844;25026;561;2592;4649;20139;5210;22731
210510;201701;6428;21804;6056;21360;341;1065;5201;18884;5542;19949
210515;201701;3583;11322;3432;11156;54;137;3271;10797;3325;10934
210520;201701;2567;7788;2344;7477;138;476;1980;6377;2118;6853
210530;201701;48807;133237;41660;122720;6860;26155;13117;46204;19977;72359
210535;201701;3201;11001;3038;10783;123;448;2681;9671;2804;10119
210540;201701;12682;42063;11305;40154;1882;6670;7306;27499;9188;34169
210542;201701;5671;16218;5140;15642;251;635;4529;14137;4780;14772
210545;201701;2303;7354;2199;7199;53;284;1953;6315;2006;6599
210547;201701;3662;13120;3417;12701;357;1308;2506;9589;2863;10897
210550;201701;5923;17465;5359;16875;229;630;4865;15657;5094;16287
210560;201701;3916;12304;3530;11668;148;597;2997;9859;3145;10456
210565;201701;1445;5225;1243;4906;83;410;950;3827;1033;4237
210570;201701;11958;33803;10999;32729;606;1497;9702;29535;10308;31032
210580;201701;3120;9113;2826;8754;300;629;2258;7424;2558;8053
210590;201701;3892;12496;3609;12136;219;918;3132;10463;3351;11381
210592;201701;2519;7851;2411;7677;54;257;2116;6706;2170;6963
210594;201701;2617;7496;2086;6694;110;315;1532;5133;1642;5448
210596;201701;2548;9503;2425;9274;240;1018;1828;7077;2068;8095
210598;201701;1767;5535;1648;5387;93;396;1453;4710;1546;5106
210600;201701;3142;8987;2676;8368;129;477;2127;6620;2256;7097
210610;201701;2481;8074;2320;7869;138;613;2016;6734;2154;7347
210620;201701;2005;6461;1841;6263;51;126;1672;5833;1723;5959
210630;201701;3299;11769;3042;11363;273;1271;2299;8463;2572;9734
210632;201701;4453;15395;4108;14895;459;1845;3144;11442;3603;13287
210635;201701;1862;6524;1766;6373;66;243;1557;5715;1623;5958
210637;201701;2590;8916;2376;8618;148;614;1917;7011;2065;7625
210640;201701;4570;17486;4493;17405;13;63;4385;17105;4398;17168
210650;201701;6843;20668;6627;20394;155;484;6303;19479;6458;19963
210660;201701;8309;24354;7555;23268;236;952;6732;20542;6968;21494
210663;201701;2618;8031;2505;7897;127;432;2161;6891;2288;7323
210667;201701;1879;6412;1770;6244;79;354;1533;5442;1612;5796
210670;201701;4527;16460;4301;16098;229;1083;3629;13611;3858;14694
210675;201701;5065;14014;4632;13485;437;1116;3729;11207;4166;12323
210680;201701;3873;10530;3391;9958;162;437;2938;8746;3100;9183
210690;201701;7507;25203;7201;24877;300;1040;6304;22547;6604;23587
210700;201701;2624;7743;2412;7508;371;896;1698;5978;2069;6874
210710;201701;4707;15679;4447;15290;223;1013;3734;12780;3957;13793
210720;201701;2594;9279;2445;9079;114;564;2180;8044;2294;8608
210725;201701;1047;4036;946;3826;54;239;702;2903;756;3142
210730;201701;1180;3534;1023;3313;79;258;801;2605;880;2863
210735;201701;4084;13884;3714;13278;392;1506;2828;10308;3220;11814
210740;201701;4957;14723;4662;14419;205;959;4147;12540;4352;13499
210745;201701;4082;11948;3839;11663;219;635;3283;10073;3502;10708
210750;201701;19166;52320;16969;49799;1954;5796;12513;37735;14467;43531
210760;201701;5858;16824;5377;16322;38;111;5202;15898;5240;16009
210770;201701;5875;16033;5070;15105;92;397;4573;13624;4665;14021
210780;201701;7704;25963;7124;24990;817;2882;5132;18532;5949;21414
210790;201701;4595;14286;4232;13862;202;541;3416;11789;3618;12330
210800;201701;4756;13259;4270;12678;117;443;3838;11410;3955;11853
210805;201701;3752;15261;3626;15065;195;1011;3106;12959;3301;13970
210810;201701;5317;16077;4934;15594;283;607;4327;14219;4610;14826
210820;201701;7518;21793;6743;20617;811;2405;4727;14815;5538;17220
210825;201701;5671;19568;5419;19234;562;1931;4350;15909;4912;17840
210830;201701;8302;23947;7837;23386;799;1993;6320;19667;7119;21660
210840;201701;3540;9690;3190;9205;96;335;2710;7753;2806;8088
210845;201701;5942;17486;5738;17267;63;143;5576;16932;5639;17075
210850;201701;6285;21842;5627;20812;538;2350;4163;15395;4701;17745
210860;201701;17833;52000;15886;49264;1134;3597;12614;39771;13748;43368
210870;201701;5565;18673;5085;18059;543;1953;3970;14391;4513;16344
210880;201701;4287;13843;4080;13582;281;1105;3394;11279;3675;12384
210890;201701;4821;14508;4451;14083;310;817;3768;12484;4078;13301
210900;201701;4775;14221;3914;12844;1606;5564;944;3412;2550;8976
210905;201701;1787;5648;1581;5344;105;325;1259;4364;1364;4689
210910;201701;8176;25959;7248;24395;898;3277;4973;16792;5871;20069
210920;201701;2740;10193;2610;9971;159;819;2127;8093;2286;8912
210923;201701;1477;4960;1362;4786;142;561;931;3357;1073;3918
210927;201701;4747;15236;4489;14962;93;309;4226;14234;4319;14543
210930;201701;2488;9015;2335;8804;119;649;1959;7283;2078;7932
210940;201701;3042;11164;2944;10993;170;815;2512;9270;2682;10085
210945;201701;5673;17446;5482;17243;199;434;5019;15974;5218;16408
210950;201701;5183;15865;4411;14676;448;1545;3193;10889;3641;12434
210955;201701;1819;5890;1618;5589;144;508;1163;4139;1307;4647
210960;201701;9023;28640;8273;27647;1762;5606;4970;17894;6732;23500
210970;201701;1322;4594;1166;4336;146;602;831;3047;977;3649
210975;201701;1733;5814;1649;5659;109;432;1288;4408;1397;4840
210980;201701;10073;23458;9657;23035;442;838;8788;21422;9230;22260
210990;201701;15921;49532;13173;45561;3210;11583;6189;22662;9399;34245
211000;201701;15476;48621;13748;46653;789;3424;11490;39540;12279;42964
211003;201701;4706;17556;4301;17037;306;1487;3319;13471;3625;14958
211010;201701;6506;23972;6169;23563;77;391;5805;22385;5882;22776
211020;201701;7385;23922;7106;23511;522;2019;5869;19330;6391;21349
211023;201701;2161;7313;2083;7191;168;682;1714;5898;1882;6580
211027;201701;2738;10461;2680;10362;255;1134;2191;8458;2446;9592
211030;201701;3757;11528;3518;11277;508;1146;2756;9557;3264;10703
211040;201701;4435;16481;4246;16204;174;986;3685;14039;3859;15025
211050;201701;10041;25520;9531;24977;154;438;9080;23789;9234;24227
211060;201701;6101;21326;5910;21071;390;1519;5116;18361;5506;19880
211065;201701;1974;6222;1782;5953;54;179;1599;5395;1653;5574
211070;201701;7837;26867;7219;25867;346;1403;6045;21897;6391;23300
211080;201701;1265;3853;1114;3625;84;415;872;2695;956;3110
211085;201701;1949;6423;1785;6149;203;718;1314;4602;1517;5320
211090;201701;3406;9740;3179;9434;101;465;2786;8132;2887;8597
211100;201701;6459;17123;6318;16974;31;105;6171;16601;6202;16706
211102;201701;2843;10988;2693;10777;224;988;2270;9208;2494;10196
211105;201701;2459;8150;2140;7642;208;867;1571;5548;1779;6415
211107;201701;4469;14294;4046;13759;257;898;3279;11458;3536;12356
211110;201701;6178;18246;4966;16435;767;2508;3261;11205;4028;13713
211120;201701;34480;96883;31647;93624;4705;13499;23006;70439;27711;83938
211125;201701;2050;6474;1807;6089;115;479;1497;5034;1612;5513
211130;201701;163710;435885;152934;422593;23595;68636;76035;228192;99630;296828
211140;201701;5090;16490;4740;15967;180;819;4051;13568;4231;14387
211150;201701;9631;27585;8610;26341;374;1400;7328;22433;7702;23833
211153;201701;2694;8391;2457;8082;556;1927;1583;5366;2139;7293
211157;201701;1141;3668;993;3442;86;395;684;2412;770;2807
211160;201701;4110;13279;3473;12218;275;1333;2386;8149;2661;9482
211163;201701;1657;5454;1559;5321;37;113;1408;4904;1445;5017
211167;201701;1486;4937;1422;4845;34;160;1346;4570;1380;4730
211170;201701;5982;15968;5758;15696;91;315;5387;14612;5478;14927
211172;201701;2448;7127;2228;6835;97;430;1919;5793;2016;6223
211174;201701;2662;7906;2446;7631;61;337;2250;6922;2311;7259
211176;201701;4143;13041;3561;12270;318;1326;2715;9418;3033;10744
211178;201701;4100;10423;3765;10045;45;153;3553;9425;3598;9578
211180;201701;4187;14468;3943;14118;263;1043;3355;12078;3618;13121
211190;201701;2809;9275;2603;8973;87;421;2219;7616;2306;8037
211195;201701;1440;4327;1217;4050;64;201;1008;3455;1072;3656
211200;201701;2130;6990;1880;6649;343;1193;1156;4334;1499;5527
211210;201701;6645;20478;6294;20018;371;1261;5396;17252;5767;18513
211220;201701;32805;94393;28896;89417;4499;14433;19428;61796;23927;76229
211223;201701;4895;14965;4483;14317;428;1403;3397;10961;3825;12364
211227;201701;1599;5633;1463;5428;91;413;1199;4464;1290;4877
211230;201701;7822;25345;7086;24148;709;2568;5400;18601;6109;21169
211240;201701;7794;27027;7407;26536;258;1332;6676;23618;6934;24950
211245;201701;5512;16358;5483;16329;52;94;5400;16173;5452;16267
211250;201701;13135;41869;12396;41019;1020;3074;10333;35353;11353;38427
211260;201701;8324;25948;7877;25366;370;1431;7071;22746;7441;24177
211270;201701;10164;34686;9158;33450;544;2539;7287;27131;7831;29670
211280;201701;13027;38811;11880;37348;884;2383;9551;31139;10435;33522
211285;201701;1736;6375;1527;5938;250;1072;776;3118;1026;4190
211290;201701;7031;22963;6720;22564;357;1220;5840;19888;6197;21108
211300;201701;8006;24001;7495;23311;138;451;6954;21704;7092;22155
211400;201701;11717;36490;10106;34191;2460;8488;5270;19517;7730;28005
220005;201701;1822;5188;1649;4937;68;273;1288;3738;1356;4011
220010;201701;1395;4078;1242;3844;32;142;997;3022;1029;3164
220020;201701;3241;10252;3050;9935;507;1693;1966;6471;2473;8164
220025;201701;2263;5497;2033;5178;35;115;1689;4218;1724;4333
220027;201701;1341;3596;1194;3404;62;190;948;2701;1010;2891
220030;201701;3176;8555;3105;8448;126;439;2756;7370;2882;7809
220040;201701;7511;23138;6901;22067;1208;3953;4495;14440;5703;18393
220045;201701;1378;4532;1245;4269;51;251;950;3191;1001;3442
220050;201701;4393;13297;3804;12324;213;913;2988;9584;3201;10497
220060;201701;2081;5091;1855;4827;39;105;1666;4329;1705;4434
220070;201701;2363;6859;2147;6512;133;396;1702;5162;1835;5558
220080;201701;671;2042;623;1970;41;168;526;1605;567;1773
220090;201701;1786;4496;1469;4069;51;193;1267;3451;1318;3644
220095;201701;718;1916;671;1852;11;48;622;1690;633;1738
220100;201701;1284;3882;1067;3487;65;290;841;2692;906;2982
220105;201701;2199;6953;1970;6513;121;430;1494;4965;1615;5395
220110;201701;3312;9605;3185;9403;97;389;2796;8133;2893;8522
220115;201701;2569;8496;2471;8339;140;571;2168;7253;2308;7824
220117;201701;1216;3257;1008;2931;38;107;840;2432;878;2539
220120;201701;11807;34607;11003;33632;136;633;10296;31371;10432;32004
220130;201701;853;2872;758;2721;38;216;641;2253;679;2469
220140;201701;1658;4417;1436;4150;136;322;1163;3451;1299;3773
220150;201701;6882;20829;6523;20358;190;866;5681;17515;5871;18381
220155;201701;1073;3281;863;2880;38;155;596;1953;634;2108
220157;201701;1067;2678;923;2447;25;97;762;1963;787;2060
220160;201701;2454;7518;2222;7095;85;397;1792;5612;1877;6009
220170;201701;1359;4041;1166;3734;47;214;956;3022;1003;3236
220173;201701;1992;6035;1689;5464;53;276;1331;4206;1384;4482
220177;201701;1735;5231;1703;5190;34;140;1621;4919;1655;5059
220180;201701;1109;3018;930;2688;19;76;667;1838;686;1914
220190;201701;4508;14417;4142;13943;474;1683;3140;10590;3614;12273
220191;201701;1376;4585;1303;4458;120;494;995;3339;1115;3833
220192;201701;1769;5045;1443;4470;61;224;1097;3380;1158;3604
220194;201701;1755;5240;1558;4947;107;391;1196;3726;1303;4117
220196;201701;1964;5689;1804;5413;107;419;1464;4323;1571;4742
220198;201701;1335;3773;1017;3354;11;35;939;3151;950;3186
220200;201701;4412;14428;4087;14011;268;1002;3428;11799;3696;12801
220202;201701;2132;6364;1875;5922;32;176;1596;4939;1628;5115
220205;201701;2718;7193;2432;6810;54;206;2122;5850;2176;6056
220207;201701;858;2642;740;2435;68;276;501;1616;569;1892
220208;201701;1791;5676;1533;5237;211;820;960;3278;1171;4098
220209;201701;1565;4663;1371;4327;37;158;1106;3475;1143;3633
220210;201701;1622;4336;1416;4005;42;181;1138;3119;1180;3300
220211;201701;1523;4314;1461;4236;39;181;1277;3640;1316;3821
220213;201701;1656;4701;1522;4438;28;121;1233;3505;1261;3626
220217;201701;1986;6297;1908;6207;35;141;1767;5803;1802;5944
220220;201701;10197;28261;9142;26677;637;1785;6786;20230;7423;22015
220225;201701;1102;3151;907;2889;29;118;730;2299;759;2417
220230;201701;5352;14433;4867;13757;189;565;4222;11951;4411;12516
220240;201701;2803;8668;2590;8269;92;374;2134;6772;2226;7146
220245;201701;1502;3999;1259;3670;24;80;1095;3260;1119;3340
220250;201701;3012;8846;2725;8426;80;334;2348;7274;2428;7608
220253;201701;1543;4622;1298;4187;146;515;927;2967;1073;3482
220255;201701;1719;4769;1480;4366;47;221;1178;3297;1225;3518
220260;201701;4440;14342;3973;13492;271;997;2970;10136;3241;11133
220265;201701;1288;4458;1188;4301;109;444;795;2895;904;3339
220270;201701;6757;21844;6466;21324;407;1776;5265;16894;5672;18670
220271;201701;1452;4074;1293;3826;57;168;1067;3203;1124;3371
220272;201701;1760;5265;1603;4997;56;242;1253;3817;1309;4059
220273;201701;1184;3433;1055;3209;71;257;775;2344;846;2601
220275;201701;2081;5240;1693;4787;40;171;1474;4109;1514;4280
220277;201701;2194;6016;1920;5593;69;250;1539;4392;1608;4642
220280;201701;1471;4053;1290;3732;75;275;1020;2857;1095;3132
220285;201701;1647;4290;1353;3897;24;102;1226;3533;1250;3635
220290;201701;6013;19785;5126;18495;564;2249;3511;12719;4075;14968
220300;201701;1788;5981;1602;5691;81;449;1267;4370;1348;4819
220310;201701;2383;7974;2166;7721;84;421;1811;6462;1895;6883
220320;201701;2805;8693;2423;7994;238;945;1748;5731;1986;6676
220323;201701;1473;5155;1292;4887;131;550;1010;3812;1141;4362
220325;201701;1170;3694;990;3337;79;335;724;2414;803;2749
220327;201701;1299;4152;1188;3954;51;257;969;3138;1020;3395
220330;201701;3592;9595;3211;9118;110;312;2857;8167;2967;8479
220335;201701;1781;5472;1605;5268;24;69;1512;5016;1536;5085
220340;201701;1806;4953;1528;4518;90;313;1125;3239;1215;3552
220342;201701;1113;3657;1062;3577;67;309;862;2881;929;3190
220345;201701;2861;7137;2531;6677;31;62;2327;6145;2358;6207
220350;201701;3735;9912;3142;8970;169;596;2383;6676;2552;7272
220360;201701;1237;3413;1063;3160;77;257;836;2444;913;2701
220370;201701;9130;26075;8313;25030;281;1126;7337;21943;7618;23069
220375;201701;1457;4565;1359;4440;11;34;1316;4338;1327;4372
220380;201701;1345;3625;1136;3329;36;152;943;2688;979;2840
220385;201701;848;2165;676;1882;17;64;545;1486;562;1550
220390;201701;8858;27045;7853;25317;1986;6588;3262;10836;5248;17424
220400;201701;1503;3766;1173;3238;36;130;913;2426;949;2556
220410;201701;1153;3358;980;3088;63;212;758;2366;821;2578
220415;201701;816;2258;717;2113;33;124;523;1495;556;1619
220420;201701;2123;6097;1765;5412;96;293;1296;3962;1392;4255
220430;201701;2427;6802;2371;6733;89;315;2151;6043;2240;6358
220435;201701;1625;4804;1490;4584;44;189;1175;3577;1219;3766
220440;201701;2316;7704;2182;7514;172;631;1730;5880;1902;6511
220450;201701;1896;5894;1600;5464;349;1312;945;3235;1294;4547
220455;201701;1290;4097;1222;3995;46;177;1071;3484;1117;3661
220460;201701;875;2412;795;2315;45;134;669;1928;714;2062
220465;201701;2308;7617;2114;7320;245;916;1539;5353;1784;6269
220470;201701;3631;10706;3326;10234;134;474;2680;8124;2814;8598
220480;201701;2414;6835;2120;6379;143;396;1572;4730;1715;5126
220490;201701;2225;6257;2048;6042;48;191;1809;5293;1857;5484
220500;201701;3064;8295;2669;7643;88;389;2055;5670;2143;6059
220510;201701;2723;7884;2218;7002;95;359;1639;5166;1734;5525
220515;201701;1797;4379;1603;4122;103;257;1371;3537;1474;3794
220520;201701;5004;13640;4607;13121;106;355;4123;11746;4229;12101
220525;201701;1214;3445;1152;3355;40;158;973;2798;1013;2956
220527;201701;1358;4117;1213;3845;123;406;856;2770;979;3176
220530;201701;1269;3562;1112;3335;54;224;963;2816;1017;3040
220535;201701;849;2546;806;2486;67;243;620;1884;687;2127
220540;201701;3468;11022;3315;10794;127;584;2906;9356;3033;9940
220545;201701;1374;4527;1307;4403;118;460;1017;3396;1135;3856
220550;201701;9032;28551;8278;27298;656;2403;6184;20235;6840;22638
220551;201701;1441;4494;1290;4251;72;317;1009;3236;1081;3553
220552;201701;1580;4859;1382;4493;82;405;1065;3323;1147;3728
220553;201701;1613;4625;1353;4229;49;198;1045;3336;1094;3534
220554;201701;765;2232;678;2101;44;125;532;1657;576;1782
220555;201701;2094;6723;1945;6510;49;257;1666;5488;1715;5745
220556;201701;1365;4197;1223;3917;55;247;918;2819;973;3066
220557;201701;1549;4956;1394;4659;119;455;1007;3337;1126;3792
220558;201701;1078;3277;966;3103;48;226;766;2391;814;2617
220559;201701;1559;4375;1386;4086;29;105;1168;3436;1197;3541
220560;201701;1568;3935;1289;3552;39;123;1090;2948;1129;3071
220570;201701;7089;22886;6684;22171;842;2963;4741;15941;5583;18904
220580;201701;6485;20005;6329;19766;213;783;5717;17697;5930;18480
220585;201701;2034;6834;1863;6524;113;478;1465;5076;1578;5554
220590;201701;1276;3764;1130;3551;109;363;818;2610;927;2973
220595;201701;2320;6775;2162;6567;37;179;1977;5927;2014;6106
220600;201701;1271;3096;1044;2809;82;138;826;2306;908;2444
220605;201701;1846;5475;1605;5063;63;255;1267;3919;1330;4174
220610;201701;2721;8127;2585;7937;53;230;2327;7110;2380;7340
220620;201701;7481;24848;7197;24461;264;1265;6386;21478;6650;22743
220630;201701;398;1225;330;1099;57;212;165;557;222;769
220635;201701;1660;5597;1478;5202;74;333;1113;3854;1187;4187
220640;201701;2592;7544;2300;7126;98;381;1906;5844;2004;6225
220650;201701;2104;6175;1872;5765;92;321;1380;4236;1472;4557
220660;201701;2826;8386;2550;8048;120;571;2205;6771;2325;7342
220665;201701;1189;3969;1088;3803;33;169;917;3177;950;3346
220667;201701;1658;5457;1519;5218;84;316;1240;4265;1324;4581
220669;201701;1795;5789;1715;5647;167;725;1298;4170;1465;4895
220670;201701;1895;5631;1667;5336;104;309;1394;4523;1498;4832
220672;201701;2393;6993;2224;6785;132;449;1922;5880;2054;6329
220675;201701;1241;3550;1163;3410;63;173;914;2686;977;2859
220680;201701;2375;7339;2263;7201;121;408;1956;6227;2077;6635
220690;201701;1699;4665;1471;4297;114;312;1113;3327;1227;3639
220695;201701;948;2695;857;2524;30;104;682;1987;712;2091
220700;201701;8146;23192;7086;21558;513;1806;5319;16001;5832;17807
220710;201701;818;2426;662;2127;32;83;479;1542;511;1625
220720;201701;2019;5214;1896;5041;63;196;1638;4325;1701;4521
220730;201701;1350;3864;1146;3547;42;180;949;2886;991;3066
220735;201701;1014;2522;806;2177;26;77;649;1719;675;1796
220740;201701;1382;4249;1184;3985;54;199;997;3405;1051;3604
220750;201701;3938;10961;3590;10442;229;670;2972;8666;3201;9336
220755;201701;1178;3295;1050;3091;46;178;818;2342;864;2520
220760;201701;2773;9058;2514;8714;131;616;2136;7328;2267;7944
220770;201701;21177;70225;19036;66134;6292;22972;6171;22520;12463;45492
220775;201701;1221;3267;1169;3212;12;49;1140;3129;1152;3178
220777;201701;1538;4201;1298;3828;57;162;998;2946;1055;3108
220779;201701;1343;3483;1245;3352;40;147;1085;2874;1125;3021
220780;201701;5500;15104;4901;14170;342;1162;3891;11108;4233;12270
220785;201701;1298;3281;1225;3169;43;103;1120;2885;1163;2988
220790;201701;10147;30442;9314;29189;558;2135;7541;23371;8099;25506
220793;201701;798;2262;716;2141;42;151;585;1739;627;1890
220795;201701;1463;4059;1370;3940;51;181;1223;3514;1274;3695
220800;201701;15762;42735;13920;39869;1026;3383;9828;27370;10854;30753
220810;201701;3156;9101;2757;8416;100;396;2219;6661;2319;7057
220820;201701;5368;14487;4801;13686;313;872;3915;11100;4228;11972
220830;201701;7201;20382;6688;19586;489;1551;5341;15617;5830;17168
220840;201701;13340;41974;11841;39004;2295;7732;6332;21152;8627;28884
220850;201701;2881;9633;2711;9424;78;347;2505;8729;2583;9076
220855;201701;586;1782;510;1647;31;136;385;1210;416;1346
220860;201701;925;2487;819;2325;39;145;682;1899;721;2044
220865;201701;2606;7100;2083;6212;73;335;1665;4804;1738;5139
220870;201701;2204;7332;1967;7017;51;261;1754;6219;1805;6480
220880;201701;4614;12401;4283;12015;46;154;4037;11345;4083;11499
220885;201701;1254;4469;1108;4204;84;406;836;3143;920;3549
220887;201701;1347;3331;1184;3104;14;56;1094;2845;1108;2901
220890;201701;1607;5476;1398;5058;118;450;1016;3720;1134;4170
220900;201701;1852;5035;1663;4764;40;127;1462;4157;1502;4284
220910;201701;1483;4491;1300;4211;49;155;1132;3728;1181;3883
220915;201701;982;2785;844;2521;33;142;646;1874;679;2016
220920;201701;1316;4735;1188;4544;88;453;887;3317;975;3770
220930;201701;1448;4576;1317;4379;40;203;1109;3647;1149;3850
220935;201701;1073;3194;923;2890;39;162;611;1836;650;1998
220937;201701;1462;3982;1236;3613;45;176;961;2756;1006;2932
220940;201701;1256;3991;1181;3846;62;283;852;2696;914;2979
220945;201701;407;1511;364;1418;34;163;249;960;283;1123
220950;201701;1294;3178;938;2599;19;83;704;1889;723;1972
220955;201701;1434;4113;1261;3809;69;207;982;2982;1051;3189
220960;201701;896;2307;706;2000;23;77;537;1507;560;1584
220965;201701;1617;4768;1514;4613;43;237;1314;3879;1357;4116
220970;201701;1917;5221;1522;4574;85;305;1155;3441;1240;3746
220975;201701;714;2260;649;2179;30;174;572;1847;602;2021
220980;201701;1229;3646;1090;3418;49;183;851;2654;900;2837
220985;201701;1168;3451;1101;3356;74;304;838;2462;912;2766
220987;201701;1441;4598;1300;4364;83;369;1028;3361;1111;3730
220990;201701;1743;5072;1511;4677;46;226;1161;3495;1207;3721
220995;201701;1243;3658;958;3206;84;305;663;2282;747;2587
220997;201701;2295;6904;2195;6764;37;164;2045;6264;2082;6428
221000;201701;4111;12425;3854;11995;273;1080;3060;9358;3333;10438
221005;201701;1394;4342;1281;4137;297;863;725;2432;1022;3295
221010;201701;1193;3033;1029;2830;22;71;898;2432;920;2503
221020;201701;1664;5221;1541;4987;57;268;1121;3551;1178;3819
221030;201701;1432;4255;1279;3998;58;240;1009;3078;1067;3318
221035;201701;1471;3998;1361;3857;56;134;1241;3586;1297;3720
221037;201701;593;1762;526;1647;15;73;364;1083;379;1156
221038;201701;581;1647;464;1450;36;122;291;917;327;1039
221039;201701;929;2547;823;2390;29;114;670;1883;699;1997
221040;201701;4456;13818;4150;13304;202;711;3269;10539;3471;11250
221050;201701;3457;10359;3213;10042;108;440;2825;8750;2933;9190
221060;201701;7898;23303;6835;21527;410;1492;5214;16349;5624;17841
221062;201701;1278;4422;1147;4164;68;319;876;3155;944;3474
221063;201701;1066;3439;962;3256;109;381;658;2245;767;2626
221065;201701;2775;7361;2460;6869;74;224;2068;5696;2142;5920
221070;201701;3647;11648;3175;10757;176;710;2384;8051;2560;8761
221080;201701;3425;8622;2795;7741;84;303;2274;6276;2358;6579
221090;201701;1363;3739;1188;3445;43;182;997;2822;1040;3004
221093;201701;1540;4568;1454;4399;185;609;909;2651;1094;3260
221095;201701;960;2578;839;2385;11;36;707;1982;718;2018
221097;201701;800;2217;647;1943;29;117;467;1353;496;1470
221100;201701;104173;304209;95159;289070;18372;58903;54673;163772;73045;222675
221110;201701;10235;31884;9485;30975;404;1880;8071;25992;8475;27872
221120;201701;4014;12792;3838;12491;548;1926;2738;8901;3286;10827
221130;201701;4411;12612;3632;11016;1002;2970;1574;4874;2576;7844
221135;201701;1500;4485;1383;4322;70;258;1175;3646;1245;3904
221140;201701;1314;3241;1181;3051;27;73;1030;2624;1057;2697
221150;201701;1198;3034;974;2661;26;110;725;1903;751;2013
221160;201701;744;1960;697;1898;27;75;564;1530;591;1605
221170;201701;1140;3406;1038;3240;35;128;827;2555;862;2683
230010;201701;3336;9016;2694;7917;226;769;1988;5713;2214;6482
230015;201701;2897;9873;2715;9495;314;1250;1800;6227;2114;7477
230020;201701;13454;43620;13096;43074;623;2572;11165;36440;11788;39012
230030;201701;11796;33413;10512;31477;451;1794;8703;25711;9154;27505
230040;201701;4239;11820;3644;10782;282;1020;2666;7759;2948;8779
230050;201701;2660;8897;1999;7142;490;1738;577;2117;1067;3855
230060;201701;2273;6421;1926;5814;103;427;1478;4348;1581;4775
230070;201701;4162;12294;3645;11330;245;908;2525;7994;2770;8902
230075;201701;8903;30891;8323;29795;608;3136;6378;22186;6986;25322
230080;201701;2377;6125;1954;5497;68;261;1599;4435;1667;4696
230090;201701;3928;11055;3490;10326;332;1141;2494;7300;2826;8441
230100;201701;16576;48921;15465;47001;2392;7897;9295;28421;11687;36318
230110;201701;12395;39152;11342;36947;2088;7223;6115;19699;8203;26922
230120;201701;7790;21583;6756;20020;775;2244;4592;14198;5367;16442
230125;201701;2950;8492;2497;7692;162;597;1797;5488;1959;6085
230130;201701;5690;18492;4839;16658;494;1905;3158;10688;3652;12593
230140;201701;3474;10976;2968;10062;223;867;2029;6899;2252;7766
230150;201701;1624;5026;1427;4611;295;1002;752;2439;1047;3441
230160;201701;6294;18092;5616;17120;310;1223;4523;13644;4833;14867
230170;201701;6127;19061;5375;17628;331;1328;3844;12426;4175;13754
230180;201701;1651;4850;1451;4453;66;300;1067;3114;1133;3414
230185;201701;3740;12241;3342;11500;491;1810;2156;7541;2647;9351
230190;201701;12176;38574;10746;35657;1851;6630;5422;17940;7273;24570
230195;201701;5305;16061;4696;14999;246;1011;3669;11475;3915;12486
230200;201701;4932;14107;4471;13252;317;1069;3397;9860;3714;10929
230205;201701;4029;13176;3695;12560;292;1304;2590;8651;2882;9955
230210;201701;8726;24902;7710;23278;1075;3473;4990;15246;6065;18719
230220;201701;13142;36874;11883;34762;868;2966;8826;25406;9694;28372
230230;201701;7263;22879;6722;21891;641;2236;4792;15597;5433;17833
230240;201701;13310;36719;11739;34181;498;1752;9156;26358;9654;28110
230250;201701;9600;29368;9551;29278;595;2246;7380;22153;7975;24399
230260;201701;14297;46884;13123;44460;1909;7008;7538;25864;9447;32872
230270;201701;7502;21735;6279;19495;759;2556;3952;12368;4711;14924
230280;201701;19687;57428;17402;53492;1250;4620;13106;39616;14356;44236
230290;201701;4727;14206;4078;12884;491;1520;2757;8752;3248;10272
230300;201701;4283;12709;4087;12445;248;986;3343;9999;3591;10985
230310;201701;4837;14339;4191;13215;177;722;2979;9239;3156;9961
230320;201701;7175;21730;6483;20517;439;1803;4891;15172;5330;16975
230330;201701;4806;13880;4045;12413;339;1146;2793;8452;3132;9598
230340;201701;3362;11145;3048;10489;310;1231;2028;6862;2338;8093
230350;201701;17977;53878;16387;51081;1495;5632;10110;31866;11605;37498
230360;201701;3197;8948;2478;7639;183;666;1611;4899;1794;5565
230365;201701;2993;7864;2614;7224;95;378;2162;5889;2257;6267
230370;201701;54180;169757;48858;160770;12594;43542;21555;73989;34149;117531
230380;201701;6471;18789;5381;16726;232;878;3843;11819;4075;12697
230390;201701;3319;10589;2996;10026;216;982;2175;7120;2391;8102
230393;201701;3048;9924;2631;9116;182;893;1883;6266;2065;7159
230395;201701;5673;16262;5105;15302;693;2157;3122;9578;3815;11735
230400;201701;5437;16281;4905;15403;240;1090;3863;11865;4103;12955
230410;201701;14382;45156;12390;41030;1640;5844;7474;24764;9114;30608
230420;201701;23753;74960;21476;70519;4081;14461;10564;34621;14645;49082
230423;201701;4113;13392;3787;12734;244;1063;2936;9739;3180;10802
230425;201701;5386;17766;4936;16809;675;2416;3160;10809;3835;13225
230426;201701;2557;7149;2051;6187;76;335;1499;4412;1575;4747
230427;201701;1891;5551;1437;4548;129;432;843;2590;972;3022
230428;201701;8636;26394;8136;25450;1484;5073;4240;13056;5724;18129
230430;201701;4413;13785;4007;13017;268;1100;2940;9301;3208;10401
230435;201701;5109;15680;4547;14666;652;2366;2619;8395;3271;10761
230440;201701;361254;1035856;325159;974959;68478;216772;157103;475076;225581;691848
230445;201701;4374;11912;3768;10920;242;753;2681;7736;2923;8489
230450;201701;3590;11037;3159;10282;291;1221;2188;6983;2479;8204
230460;201701;1858;6089;1612;5636;166;698;1089;3774;1255;4472
230465;201701;3923;11649;3289;10471;205;849;2243;6932;2448;7781
230470;201701;10962;39198;10139;37542;1165;5043;7004;25693;8169;30736
230480;201701;1429;4425;1210;3993;132;540;832;2674;964;3214
230490;201701;2246;6788;1954;6233;278;958;974;3004;1252;3962
230495;201701;5546;18134;5040;17128;609;2546;2932;9803;3541;12349
230500;201701;8655;30542;8262;29737;610;2749;6176;22068;6786;24817
230510;201701;1504;5244;1152;4337;279;1142;375;1426;654;2568
230520;201701;4213;13050;3960;12562;387;1404;2709;8464;3096;9868
230523;201701;14725;46920;12801;42553;3063;10920;3241;11211;6304;22131
230526;201701;4030;11902;3473;10924;205;891;2680;8251;2885;9142
230530;201701;5326;16945;4794;16231;664;2452;3293;11463;3957;13915
230533;201701;4069;11157;3539;10186;346;963;2530;7366;2876;8329
230535;201701;5432;15914;4760;14690;534;1689;3018;9582;3552;11271
230540;201701;17203;49717;15541;47149;535;2280;12955;38748;13490;41028
230550;201701;19248;56347;16971;52090;2808;9690;9104;27344;11912;37034
230560;201701;6777;19279;5832;17567;224;951;4414;13082;4638;14033
230565;201701;3456;9431;2810;8270;103;395;2067;6027;2170;6422
230570;201701;3529;9596;3121;9052;114;410;2546;7329;2660;7739
230580;201701;9827;29195;9025;28039;493;1945;7574;23220;8067;25165
230590;201701;8946;27196;7627;24729;560;2287;5286;16637;5846;18924
230600;201701;3798;10336;2877;8520;103;311;1850;5575;1953;5886
230610;201701;6150;19101;5626;18232;592;1976;4040;13188;4632;15164
230620;201701;2149;6064;1706;5117;191;614;949;2765;1140;3379
230625;201701;7708;24644;6954;22968;2087;7397;1968;6590;4055;13987
230630;201701;10577;33162;9725;31578;2510;7773;4549;15862;7059;23635
230640;201701;26249;83194;23976;79837;2303;9001;18246;60248;20549;69249
230650;201701;4766;14471;4298;13557;281;1136;3178;9743;3459;10879
230655;201701;9280;34231;8944;33597;707;3131;6978;26268;7685;29399
230660;201701;6087;18803;5185;17048;289;1401;4006;12835;4295;14236
230670;201701;5959;15760;4807;13760;163;610;3691;10256;3854;10866
230680;201701;2566;7560;2242;6920;295;955;1364;4209;1659;5164
230690;201701;6448;20490;6130;19793;676;2458;3755;11882;4431;14340
230700;201701;9528;26290;8433;24300;554;1981;6057;16833;6611;18814
230710;201701;7403;23817;6413;21975;746;2717;4420;15204;5166;17921
230720;201701;1791;5665;1542;5107;206;744;923;3027;1129;3771
230725;201701;3648;12323;3188;11215;737;2711;1024;3584;1761;6295
230730;201701;53156;162271;45794;149595;13490;49344;9483;33215;22973;82559
230740;201701;6204;18164;5556;17090;247;996;4310;13081;4557;14077
230750;201701;8074;23220;7044;21506;353;1391;5332;15909;5685;17300
230760;201701;11037;32266;10133;30535;974;3482;6985;20312;7959;23794
230763;201701;4273;12829;3765;11850;213;904;2819;8543;3032;9447
230765;201701;38377;118986;34172;110914;8972;31032;10355;34914;19327;65946
230770;201701;24795;67906;22176;64071;2773;8605;14402;41589;17175;50194
230780;201701;5705;21861;5486;21370;1209;4814;2865;11626;4074;16440
230790;201701;2783;8719;2598;8422;202;775;1983;6425;2185;7200
230800;201701;7438;25850;6825;24524;1292;5144;3409;12023;4701;17167
230810;201701;11868;38004;11148;36780;767;3054;8507;27693;9274;30747
230820;201701;3214;11015;2829;10171;364;1533;1617;5685;1981;7218
230830;201701;7349;22060;6512;20521;367;1491;4949;15375;5316;16866
230835;201701;3795;10082;3165;9087;154;574;2443;6915;2597;7489
230837;201701;3101;10422;2712;9624;212;974;1926;6630;2138;7604
230840;201701;8851;28680;8210;27600;662;2587;6318;21259;6980;23846
230850;201701;9362;29017;8619;27708;934;3190;5940;19227;6874;22417
230860;201701;5020;13979;4451;13157;243;850;3594;10529;3837;11379
230870;201701;17850;46631;15588;43219;636;2127;12055;33140;12691;35267
230880;201701;1933;6467;1845;6286;123;597;1342;4445;1465;5042
230890;201701;3978;14223;3692;13628;369;1731;2466;8860;2835;10591
230900;201701;2730;9133;2311;8190;501;1700;1060;3884;1561;5584
230910;201701;3057;8888;2533;7968;165;748;1884;5756;2049;6504
230920;201701;4641;13196;4350;12833;171;616;3774;11216;3945;11832
230930;201701;6737;20236;5984;18799;517;1780;4009;12554;4526;14334
230940;201701;7510;21503;6776;20262;278;1035;5424;16120;5702;17155
230945;201701;6184;18434;5453;17269;421;1535;3768;12087;4189;13622
230950;201701;6380;16966;5842;16287;188;504;5073;14450;5261;14954
230960;201701;13992;42970;12787;40609;2334;7745;5999;19372;8333;27117
230970;201701;13253;39570;11620;36655;2149;7510;5454;17089;7603;24599
230980;201701;2876;8831;2488;8140;545;1781;1337;4558;1882;6339
230990;201701;1788;5206;1491;4651;122;506;963;2882;1085;3388
231000;201701;2529;6961;2116;6148;116;417;1415;4004;1531;4421
231010;201701;3041;8341;2507;7441;263;856;1667;4869;1930;5725
231020;201701;7823;26032;7330;24917;1237;4221;4372;15207;5609;19428
231025;201701;7662;23347;7058;22256;1004;3348;4561;14586;5565;17934
231030;201701;7203;23098;6036;20672;1145;4145;3183;10934;4328;15079
231040;201701;3145;9749;2808;9100;140;646;2071;6500;2211;7146
231050;201701;11675;32787;10037;29943;676;2198;7398;21980;8074;24178
231060;201701;2375;7668;2219;7395;131;661;1679;5472;1810;6133
231070;201701;8369;26201;7505;24488;1350;4607;4032;13372;5382;17979
231080;201701;3965;12161;3621;11570;162;851;2769;8495;2931;9346
231085;201701;4812;14767;4610;14470;532;1680;3302;10696;3834;12376
231090;201701;4131;11458;3341;9907;168;588;2313;6719;2481;7307
231095;201701;2004;6499;1774;6013;186;719;1195;4042;1381;4761
231100;201701;3150;9674;2666;8783;195;762;1876;6106;2071;6868
231110;201701;3431;11243;3399;11182;303;1181;2400;7749;2703;8930
231120;201701;1890;6326;1781;6105;257;971;1125;3836;1382;4807
231123;201701;2015;5517;1774;5098;121;378;1298;3676;1419;4054
231126;201701;6086;17364;5056;15424;214;834;3589;10725;3803;11559
231130;201701;18809;56765;17066;54004;2713;9269;10471;34190;13184;43459
231135;201701;4010;11889;3455;10871;217;809;2476;7713;2693;8522
231140;201701;17021;52205;14751;47952;1162;5144;9852;30976;11014;36120
231150;201701;5521;15978;4840;14709;736;2369;2387;7398;3123;9767
231160;201701;5807;18990;5398;18179;856;3020;3189;10851;4045;13871
231170;201701;4187;13361;3710;12373;273;1177;2628;8526;2901;9703
231180;201701;14276;41856;12527;38298;2332;7386;6356;19228;8688;26614
231190;201701;4518;12673;3779;11543;235;975;2781;8205;3016;9180
231195;201701;4459;14881;3943;13835;380;1674;2680;9195;3060;10869
231200;201701;7804;26099;6857;24136;374;1922;4910;16773;5284;18695
231210;201701;4800;15220;4308;14440;255;1218;3225;10560;3480;11778
231220;201701;11604;32883;10155;30234;568;2191;7460;21645;8028;23836
231230;201701;9193;30121;8340;28844;768;3205;6183;21359;6951;24564
231240;201701;11508;35825;10526;33804;2033;6828;5534;17847;7567;24675
231250;201701;1897;5325;1303;3895;205;623;541;1569;746;2192
231260;201701;3257;9852;2969;9354;472;1524;1829;5887;2301;7411
231270;201701;7075;19148;6260;17914;267;1101;4803;13518;5070;14619
231280;201701;1726;5600;1612;5390;177;622;1063;3579;1240;4201
231290;201701;34181;112731;30907;105503;6015;22496;13422;44962;19437;67458
231300;201701;4226;12263;3520;10847;237;864;2372;7154;2609;8018
231310;201701;7289;20539;6023;17917;789;2442;3522;10350;4311;12792
231320;201701;6977;20920;5741;18415;248;1041;4172;13236;4420;14277
231325;201701;2701;7784;2346;7262;465;1493;1223;3833;1688;5326
231330;201701;11008;34897;9536;31904;1631;5569;5263;17803;6894;23372
231335;201701;5391;15152;4665;13835;150;623;3799;11060;3949;11683
231340;201701;17628;57301;16174;54962;1235;4486;12311;42461;13546;46947
231350;201701;14480;41947;13578;40736;535;1607;12008;36426;12543;38033
231355;201701;4537;14272;4097;13511;280;1128;2974;9707;3254;10835
231360;201701;7504;23817;6689;22403;1038;3629;4325;14791;5363;18420
231370;201701;2388;6632;1879;5785;63;223;1397;4260;1460;4483
231375;201701;4123;13879;3845;13351;230;1085;2991;10211;3221;11296
231380;201701;5412;16272;5171;15982;248;798;4325;13666;4573;14464
231390;201701;3421;10566;3132;10038;297;1104;2188;6910;2485;8014
231395;201701;3781;12323;3426;11648;564;1989;1991;6809;2555;8798
231400;201701;8851;27115;8165;25768;515;2004;6107;18970;6622;20974
231410;201701;14635;48432;13410;46601;1092;4210;10113;35309;11205;39519
240010;201701;2372;6998;1955;6159;262;926;1092;3352;1354;4278
240020;201701;10070;31402;9049;29460;1554;5440;4932;16139;6486;21579
240030;201701;2510;7001;2424;6871;119;431;2112;5900;2231;6331
240040;201701;846;2463;704;2181;29;142;487;1446;516;1588
240050;201701;3358;9063;2828;8133;97;332;2241;6336;2338;6668
240060;201701;1389;3957;1228;3661;63;242;964;2768;1027;3010
240070;201701;2374;7109;2219;6811;263;893;1532;4577;1795;5470
240080;201701;2999;7958;2574;7349;139;477;1943;5480;2082;5957
240090;201701;2243;5984;1844;5282;49;200;1449;4068;1498;4268
240100;201701;7711;22108;6851;20339;612;2067;4761;13699;5373;15766
240110;201701;4657;14450;4126;13372;579;2141;2291;7264;2870;9405
240120;201701;2651;9113;2520;8828;340;1401;1567;5391;1907;6792
240130;201701;2685;7094;2364;6599;68;261;1990;5469;2058;5730
240140;201701;2154;6443;1828;5842;235;908;1114;3445;1349;4353
240145;201701;5529;17360;4990;16408;1105;3769;2748;9292;3853;13061
240150;201701;939;2868;792;2561;68;288;558;1738;626;2026
240160;201701;1410;4434;1218;4102;118;478;795;2694;913;3172
240165;201701;879;2734;754;2453;146;448;403;1349;549;1797
240170;201701;2223;6713;1931;6174;365;1250;1029;3247;1394;4497
240180;201701;2656;8299;2334;7630;372;1283;1399;4652;1771;5935
240185;201701;1331;4445;1233;4280;82;347;991;3424;1073;3771
240190;201701;954;3015;851;2838;43;196;646;2158;689;2354
240200;201701;12171;32830;10374;30034;2240;6781;4281;12738;6521;19519
240210;201701;2829;7865;2556;7420;109;422;2071;5842;2180;6264
240220;201701;7280;24238;6721;23429;651;2766;4769;16609;5420;19375
240230;201701;5695;14977;4901;13772;134;474;4116;11520;4250;11994
240240;201701;1770;5347;1135;3768;218;775;195;579;413;1354
240250;201701;2601;7601;2451;7409;102;333;2127;6434;2229;6767
240260;201701;11862;39572;11299;38646;1606;6127;7485;25645;9091;31772
240270;201701;2228;7056;2046;6751;177;654;1551;5143;1728;5797
240280;201701;1532;4298;1378;4088;63;225;1119;3296;1182;3521
240290;201701;1172;3709;1040;3457;66;336;694;2157;760;2493
240300;201701;2270;6190;1701;5033;197;642;821;2374;1018;3016
240310;201701;9284;26206;8322;24645;1001;3266;4700;14005;5701;17271
240320;201701;1947;5717;1553;4913;54;229;1121;3409;1175;3638
240325;201701;31807;88861;25893;79200;7513;24485;6698;21712;14211;46197
240330;201701;1464;4435;1243;3973;82;337;786;2421;868;2758
240340;201701;1996;5137;1648;4591;137;425;1215;3330;1352;3755
240350;201701;2015;5534;1856;5343;78;285;1632;4655;1710;4940
240360;201701;6489;20094;5863;19146;1505;4948;2859;9882;4364;14830
240370;201701;2019;5568;1611;4787;172;506;1018;3029;1190;3535
240375;201701;824;2221;728;2045;48;192;513;1342;561;1534
240380;201701;2377;7072;1809;5800;226;754;952;3020;1178;3774
240390;201701;905;2506;763;2225;27;95;534;1492;561;1587
240400;201701;1328;3556;1046;3019;64;217;727;2029;791;2246
240410;201701;444;1463;405;1385;63;273;241;792;304;1065
240420;201701;4662;17751;4335;16992;747;3449;2330;9011;3077;12460
240430;201701;3273;9194;2989;8687;133;570;2355;6583;2488;7153
240440;201701;2431;6235;2178;5871;369;1084;1330;3526;1699;4610
240450;201701;3917;11546;3338;10444;382;1454;1886;5655;2268;7109
240460;201701;2875;8726;2701;8501;210;884;2154;6581;2364;7465
240470;201701;3556;11121;2780;9431;706;2341;1251;4367;1957;6708
240480;201701;517;1393;395;1157;35;112;187;538;222;650
240485;201701;1876;6004;1657;5547;202;766;1064;3557;1266;4323
240490;201701;1726;4326;1408;3826;29;107;1211;3257;1240;3364
240500;201701;2134;6054;1924;5748;112;411;1554;4598;1666;5009
240510;201701;1664;4924;1596;4822;105;336;1342;4042;1447;4378
240520;201701;1193;3429;1070;3221;66;261;841;2446;907;2707
240530;201701;1906;6213;1768;5996;266;923;1233;4198;1499;5121
240540;201701;1749;5200;1656;5054;104;385;1386;4172;1490;4557
240550;201701;761;2173;651;1986;38;120;473;1438;511;1558
240560;201701;3202;9121;2957;8769;294;793;2316;7006;2610;7799
240570;201701;2964;8190;2193;6462;384;1230;882;2327;1266;3557
240580;201701;7641;23368;7083;22431;572;2150;5627;17569;6199;19719
240590;201701;742;2072;653;1912;21;81;495;1425;516;1506
240600;201701;1607;4692;1234;3903;128;480;701;2124;829;2604
240610;201701;4513;12947;3929;11826;366;1226;2563;7532;2929;8758
240615;201701;952;2809;781;2470;123;409;454;1391;577;1800
240620;201701;1791;5407;1588;5059;131;441;1237;3926;1368;4367
240630;201701;2052;6159;1874;5864;162;483;1284;4103;1446;4586
240640;201701;902;2556;764;2338;48;215;554;1630;602;1845
240650;201701;3919;11510;3505;10868;176;661;2750;8442;2926;9103
240660;201701;2315;7366;2182;7174;168;650;1702;5525;1870;6175
240670;201701;2538;7585;2134;6752;240;831;1233;3790;1473;4621
240680;201701;1480;4324;1197;3817;73;285;796;2472;869;2757
240690;201701;912;2480;781;2257;35;137;625;1742;660;1879
240700;201701;2474;7324;2084;6623;75;333;1627;5056;1702;5389
240710;201701;17398;46744;15184;43119;2911;8203;8169;23828;11080;32031
240720;201701;5121;14509;4648;13663;1167;3538;2234;6441;3401;9979
240725;201701;997;3026;812;2605;61;215;507;1571;568;1786
240730;201701;2011;6075;1765;5619;95;332;1332;4210;1427;4542
240740;201701;1884;5465;1675;5075;127;489;1165;3394;1292;3883
240750;201701;2125;7855;1971;7569;417;1766;1011;3924;1428;5690
240760;201701;1324;3574;1082;3241;88;258;789;2457;877;2715
240770;201701;3028;8617;2721;8191;126;552;2256;6637;2382;7189
240780;201701;5916;16281;4792;14508;617;1949;2865;8824;3482;10773
240790;201701;889;2676;737;2398;38;152;519;1693;557;1845
240800;201701;33283;95072;29501;88748;6577;20773;12713;38708;19290;59481
240810;201701;82323;235887;75792;224673;19738;59230;34783;105596;54521;164826
240820;201701;5640;17796;5039;16840;1158;4092;2262;7949;3420;12041
240830;201701;8589;26463;8014;25640;350;1620;6685;21007;7035;22627
240840;201701;1096;3030;936;2756;80;264;604;1714;684;1978
240850;201701;1271;3696;946;2968;107;372;491;1529;598;1901
240860;201701;1246;3547;1007;3102;41;171;766;2267;807;2438
240870;201701;1129;3050;914;2673;73;231;599;1672;672;1903
240880;201701;1161;3855;1094;3743;75;351;901;2994;976;3345
240890;201701;4797;13556;4027;12073;829;2594;1727;5126;2556;7720
240895;201701;2601;8933;2407;8612;243;939;1757;6363;2000;7302
240910;201701;2930;8670;2591;8025;133;504;2044;6257;2177;6761
240920;201701;751;2427;658;2216;110;397;343;1146;453;1543
240930;201701;3386;8677;2972;8171;95;276;2435;6766;2530;7042
240933;201701;1493;4012;1312;3719;41;161;1071;2956;1112;3117
240940;201701;6270;16629;5095;14679;651;1877;3195;9159;3846;11036
240950;201701;928;3010;855;2867;58;254;614;1994;672;2248
240960;201701;778;2430;687;2245;55;191;485;1589;540;1780
240970;201701;1797;5006;1520;4535;79;315;1190;3419;1269;3734
240980;201701;2732;9135;2558;8808;434;1632;1570;5372;2004;7004
240990;201701;2588;7704;2460;7457;395;1318;1607;4799;2002;6117
241000;201701;1024;2839;869;2558;47;177;604;1744;651;1921
241010;201701;2742;9278;2583;8979;329;1404;1792;5974;2121;7378
241020;201701;1991;5511;1591;4707;183;531;960;2830;1143;3361
241025;201701;1653;4960;1453;4605;72;309;1024;3229;1096;3538
241030;201701;2377;7813;2095;7221;200;841;1429;4864;1629;5705
241040;201701;2127;7288;1962;6995;133;561;1451;5189;1584;5750
241050;201701;1257;3707;1073;3380;74;280;786;2433;860;2713
241060;201701;827;2393;742;2245;60;211;529;1559;589;1770
241070;201701;701;2024;630;1897;53;201;475;1347;528;1548
241080;201701;1128;3319;920;2914;34;158;667;2060;701;2218
241090;201701;2117;6282;1770;5691;101;427;1297;4101;1398;4528
241100;201701;1150;3390;995;3046;68;251;686;2063;754;2314
241105;201701;1163;3500;1001;3219;245;773;450;1533;695;2306
241110;201701;793;2461;661;2171;42;173;444;1391;486;1564
241120;201701;7131;21741;6498;20613;1560;4780;3303;11154;4863;15934
241140;201701;3380;9090;2918;8194;231;673;2111;5787;2342;6460
241142;201701;719;2121;556;1789;103;364;260;807;363;1171
241150;201701;5334;15580;4765;14623;441;1526;3302;10048;3743;11574
241160;201701;939;2784;843;2620;149;481;489;1512;638;1993
241170;201701;1129;3266;1054;3138;101;316;815;2390;916;2706
241180;201701;942;2638;757;2276;78;247;405;1175;483;1422
241190;201701;1154;3178;920;2686;53;202;611;1719;664;1921
241200;201701;18586;53130;16403;49789;3964;12659;7174;22527;11138;35186
241210;201701;1401;3943;1128;3384;127;458;682;1961;809;2419
241220;201701;7839;25410;7237;24311;2075;7096;3242;11307;5317;18403
241230;201701;2985;8609;2759;8254;143;538;2249;6571;2392;7109
241240;201701;1245;3639;852;2751;96;359;366;1185;462;1544
241250;201701;6065;18445;5062;16542;276;1387;3774;11910;4050;13297
241255;201701;1673;6289;1523;5962;292;1306;794;3084;1086;4390
241260;201701;5067;13652;4056;12061;200;875;2943;8537;3143;9412
241270;201701;1827;5578;1604;5138;102;445;1144;3583;1246;4028
241280;201701;1791;5214;1638;4926;128;406;1195;3557;1323;3963
241290;201701;2891;8074;2487;7378;167;603;1814;5247;1981;5850
241300;201701;1461;4153;1252;3770;46;165;854;2537;900;2702
241310;201701;1635;4780;1494;4540;86;342;1187;3545;1273;3887
241320;201701;904;3116;822;2939;109;465;517;1821;626;2286
241330;201701;1377;4276;1306;4188;88;371;1120;3538;1208;3909
241335;201701;2750;8291;2526;7892;127;473;2043;6291;2170;6764
241340;201701;1765;5418;1500;4820;329;1144;668;2070;997;3214
241350;201701;1866;5904;1685;5563;134;593;1242;3961;1376;4554
241355;201701;1415;3916;1141;3433;63;227;873;2600;936;2827
241360;201701;2079;5583;1710;4864;77;246;1239;3434;1316;3680
241370;201701;1355;4019;1117;3550;87;337;713;2204;800;2541
241380;201701;614;1746;516;1561;60;205;314;915;374;1120
241390;201701;2727;8772;2549;8489;224;907;1951;6422;2175;7329
241400;201701;3676;10494;3333;10005;347;1147;2487;7509;2834;8656
241410;201701;2423;7335;2155;6947;354;1227;1382;4455;1736;5682
241415;201701;1643;4897;1472;4617;138;487;1105;3390;1243;3877
241420;201701;2199;7601;1957;7181;610;2447;513;1896;1123;4343
241430;201701;566;1672;438;1396;45;165;247;740;292;905
241440;201701;6058;21789;5783;21348;719;3062;4261;15727;4980;18789
241445;201701;962;2781;917;2731;53;128;773;2423;826;2551
241450;201701;2886;7781;2526;7269;313;956;1703;4853;2016;5809
241460;201701;3328;9637;2961;8896;222;818;2155;6267;2377;7085
241470;201701;1371;3787;1128;3462;95;352;841;2581;936;2933
241475;201701;1236;3693;1020;3261;49;263;727;2208;776;2471
241480;201701;2631;8752;2417;8386;952;3374;646;2528;1598;5902
241490;201701;697;1827;578;1652;31;90;367;1012;398;1102
241500;201701;720;2261;612;2120;16;71;518;1787;534;1858
250010;201701;2726;8458;2293;7507;88;406;1724;5515;1812;5921
250020;201701;1553;4454;1197;3770;68;289;845;2569;913;2858
250030;201701;6783;19574;6295;18888;377;1288;5144;15210;5521;16498
250040;201701;3921;13257;3636;12635;498;1824;2377;8282;2875;10106
250050;201701;3254;10162;3027;9803;493;1661;1860;5891;2353;7552
250053;201701;1215;3647;1103;3475;118;378;774;2466;892;2844
250057;201701;617;2620;600;2602;3;3;571;2537;574;2540
250060;201701;5036;14843;4679;14326;400;1406;3636;11013;4036;12419
250070;201701;3819;11753;3557;11262;122;595;2711;8260;2833;8855
250073;201701;767;2254;671;2093;22;86;511;1543;533;1629
250077;201701;2089;6081;1709;5444;111;386;1186;3761;1297;4147
250080;201701;4062;11859;3867;11512;282;981;3053;8923;3335;9904
250090;201701;2532;7226;2357;6936;124;342;1898;5531;2022;5873
250100;201701;3763;12194;3548;11803;230;954;2804;9098;3034;10052
250110;201701;4806;14303;4533;13906;357;1338;3646;10959;4003;12297
250115;201701;474;1517;439;1454;23;122;320;1011;343;1133
250120;201701;1824;5699;1608;5285;94;384;1236;4064;1330;4448
250130;201701;5233;16310;4747;15410;200;864;3801;12236;4001;13100
250135;201701;1012;3094;955;2998;36;147;763;2364;799;2511
250140;201701;2035;6690;1957;6566;167;739;1488;4913;1655;5652
250150;201701;4956;16486;4530;15684;253;1170;3454;11721;3707;12891
250153;201701;1409;3815;1214;3532;38;177;1013;2889;1051;3066
250157;201701;1695;5478;1552;5193;252;808;970;3323;1222;4131
250160;201701;3241;9484;3073;9219;78;288;2788;8349;2866;8637
250170;201701;1540;4561;1414;4372;104;375;1083;3328;1187;3703
250180;201701;15471;44535;14393;42934;1341;4723;10474;30473;11815;35196
250190;201701;4061;11680;3713;11128;466;1411;2444;7289;2910;8700
250200;201701;1923;5652;1612;5188;81;333;1296;4127;1377;4460
250205;201701;826;2833;774;2715;35;176;571;1988;606;2164
250210;201701;1438;4699;1352;4564;98;471;1028;3345;1126;3816
250215;201701;1329;4260;1257;4153;102;423;833;2699;935;3122
250220;201701;729;2216;618;2042;31;123;469;1556;500;1679
250230;201701;1490;3776;1226;3341;48;176;938;2434;986;2610
250240;201701;2252;7389;2153;7219;113;436;1744;5814;1857;6250
250250;201701;4300;12849;3915;12326;164;601;3192;10030;3356;10631
250260;201701;1657;4991;1438;4631;63;240;1124;3616;1187;3856
250270;201701;1264;3920;1140;3764;86;294;853;2939;939;3233
250280;201701;3530;10351;3104;9673;248;801;2326;7252;2574;8053
250290;201701;1762;4780;1477;4389;20;74;1254;3724;1274;3798
250300;201701;5120;15281;4904;15013;358;1494;4228;12604;4586;14098
250310;201701;1089;3336;985;3161;61;254;753;2340;814;2594
250320;201701;7925;23103;7453;22412;873;2911;5441;16081;6314;18992
250330;201701;2329;7272;2012;6794;167;616;1497;5044;1664;5660
250340;201701;1064;3137;957;2955;32;123;801;2427;833;2550
250350;201701;3952;11085;3564;10618;120;474;3133;9252;3253;9726
250355;201701;1909;5978;1755;5775;46;245;1545;5004;1591;5249
250360;201701;1754;5200;1650;5029;49;171;1383;4216;1432;4387
250370;201701;11275;32263;10103;30962;588;1933;8689;26654;9277;28587
250375;201701;1045;3163;951;3029;46;164;785;2517;831;2681
250380;201701;1624;4632;1545;4527;78;311;1286;3645;1364;3956
250390;201701;1756;4834;1448;4312;209;594;908;2725;1117;3319
250400;201701;72139;190509;57115;167036;14297;44295;21249;63694;35546;107989
250403;201701;1533;5000;1422;4848;229;965;929;3064;1158;4029
250407;201701;1179;3290;1016;3044;81;236;742;2189;823;2425
250410;201701;518;1674;482;1607;23;116;381;1231;404;1347
250415;201701;1865;5577;1687;5271;94;327;1275;3947;1369;4274
250420;201701;1236;3587;1115;3410;24;92;996;3037;1020;3129
250430;201701;6054;16201;5497;15359;220;773;4509;12307;4729;13080
250435;201701;1301;3993;1170;3758;75;288;853;2711;928;2999
250440;201701;4420;12545;4010;11983;117;468;3385;9983;3502;10451
250450;201701;1855;5307;1625;4989;57;236;1354;4087;1411;4323
250460;201701;6329;18893;5930;18382;420;1401;4887;15326;5307;16727
250470;201701;1519;4112;1289;3787;102;373;928;2642;1030;3015
250480;201701;3665;11050;3382;10645;104;464;2860;8971;2964;9435
250485;201701;596;1500;507;1379;26;82;419;1111;445;1193
250490;201701;3808;11668;3684;11497;549;1774;2705;8460;3254;10234
250500;201701;1739;5247;1573;4975;114;359;1211;3872;1325;4231
250510;201701;4804;13442;4326;12757;128;415;3788;11184;3916;11599
250520;201701;1741;5233;1625;5073;243;882;1012;3083;1255;3965
250523;201701;1672;5017;1625;4956;122;466;1353;4047;1475;4513
250527;201701;1373;4116;1311;4044;31;161;1219;3691;1250;3852
250530;201701;578;1796;514;1718;29;118;445;1477;474;1595
250535;201701;1297;4042;1215;3884;56;262;966;3003;1022;3265
250540;201701;2344;6594;2186;6415;44;203;1943;5610;1987;5813
250550;201701;857;2875;792;2771;46;236;648;2201;694;2437
250560;201701;1610;5040;1526;4912;79;317;1242;3911;1321;4228
250570;201701;2554;8039;2260;7471;119;532;1759;5662;1878;6194
250580;201701;1069;2869;939;2675;57;213;783;2170;840;2383
250590;201701;815;2526;750;2428;38;158;624;1964;662;2122
250600;201701;6977;20484;6559;19847;616;1883;5091;15458;5707;17341
250610;201701;2970;8631;2769;8340;228;745;2154;6436;2382;7181
250620;201701;660;1946;597;1819;78;262;386;1139;464;1401
250625;201701;2399;7580;2330;7475;36;99;2188;7037;2224;7136
250630;201701;9433;29000;8580;27241;1778;5911;4651;14678;6429;20589
250640;201701;3329;10263;3157;10033;173;760;2624;8147;2797;8907
250650;201701;846;2327;736;2179;47;194;545;1514;592;1708
250660;201701;1733;4641;1611;4472;31;73;1496;4177;1527;4250
250670;201701;2310;7758;2205;7578;107;533;1866;6264;1973;6797
250680;201701;4689;13089;4445;12806;168;666;3921;11133;4089;11799
250690;201701;5930;15139;5659;14832;267;782;5145;13386;5412;14168
250700;201701;4458;13185;4088;12623;589;1921;2746;8424;3335;10345
250710;201701;4367;13472;3940;12896;418;1487;2739;9093;3157;10580
250720;201701;2652;7623;2458;7318;71;303;2132;6262;2203;6565
250730;201701;3357;10206;3109;9853;225;884;2472;7636;2697;8520
250740;201701;1874;5363;1631;4998;155;583;1224;3616;1379;4199
250750;201701;95472;266637;87380;254828;10666;34332;58133;166791;68799;201123
250760;201701;2239;6247;1994;5895;124;470;1588;4602;1712;5072
250770;201701;3856;12669;3636;12385;381;1543;2627;8852;3008;10395
250780;201701;1710;5015;1482;4575;180;656;965;2893;1145;3549
250790;201701;2315;7525;2206;7331;452;1479;1306;4496;1758;5975
250800;201701;2609;7266;2316;6792;110;319;1882;5459;1992;5778
250810;201701;1238;3607;1078;3356;54;227;836;2553;890;2780
250820;201701;1837;5724;1762;5634;94;405;1556;4912;1650;5317
250830;201701;5514;17688;5107;16870;481;1913;3579;11586;4060;13499
250840;201701;881;2878;761;2628;52;215;500;1740;552;1955
250850;201701;1949;5940;1774;5667;78;371;1398;4353;1476;4724
250855;201701;1072;3132;944;2929;44;191;698;2101;742;2292
250860;201701;3196;10279;2747;9451;639;2368;1091;3836;1730;6204
250870;201701;1059;3068;926;2802;29;108;725;2170;754;2278
250880;201701;1499;4009;1259;3676;106;326;963;2850;1069;3176
250890;201701;9119;27150;8686;26562;1097;3981;6222;18539;7319;22520
250900;201701;2686;8675;2384;8093;157;565;1815;6114;1972;6679
250905;201701;1981;6264;1909;6178;174;662;1544;4939;1718;5601
250910;201701;4805;13830;4515;13418;203;781;3779;11121;3982;11902
250915;201701;1384;4200;1363;4172;61;149;1236;3864;1297;4013
250920;201701;3124;8878;2945;8610;212;693;2245;6444;2457;7137
250930;201701;1908;5805;1806;5634;131;536;1386;4199;1517;4735
250933;201701;1105;3632;1017;3450;86;368;706;2348;792;2716
250937;201701;632;1957;570;1844;47;180;419;1335;466;1515
250939;201701;1510;4534;1401;4359;130;430;1029;3170;1159;3600
250940;201701;3704;10863;3469;10482;88;374;3005;9061;3093;9435
250950;201701;1304;3929;1151;3726;52;217;917;2982;969;3199
250960;201701;1021;3320;972;3240;47;189;789;2596;836;2785
250970;201701;8305;22951;7276;21316;526;1745;5358;15468;5884;17213
250980;201701;2504;7304;2271;6871;94;398;1722;5012;1816;5410
250990;201701;1908;6449;1704;6005;221;957;1117;3782;1338;4739
251000;201701;2038;5964;1795;5570;52;245;1508;4620;1560;4865
251010;201701;2677;7887;2418;7462;95;349;2087;6415;2182;6764
251020;201701;1637;4589;1492;4407;60;192;1354;3996;1414;4188
251030;201701;992;2835;910;2681;47;178;649;1847;696;2025
251040;201701;1719;5393;1554;5107;85;431;1206;3815;1291;4246
251050;201701;1029;3005;856;2670;114;353;523;1605;637;1958
251060;201701;1015;2298;758;1971;26;105;596;1514;622;1619
251065;201701;448;1332;391;1250;25;100;266;797;291;897
251070;201701;610;1690;546;1597;20;79;450;1272;470;1351
251080;201701;18321;51187;16448;48273;4460;13592;7332;22300;11792;35892
251090;201701;2805;8612;2482;7989;144;578;1883;5943;2027;6521
251100;201701;922;2907;840;2767;53;261;594;1866;647;2127
251110;201701;1795;5266;1588;4850;110;354;1131;3414;1241;3768
251120;201701;6124;20401;5819;19857;536;2255;4355;14567;4891;16822
251130;201701;3769;9720;3494;9428;129;318;3294;8964;3423;9282
251140;201701;4160;12607;3911;12206;137;585;3259;10107;3396;10692
251150;201701;2562;8048;2370;7764;180;789;1803;5754;1983;6543
251160;201701;1785;5810;1744;5749;49;204;1604;5272;1653;5476
251170;201701;1377;4165;1306;4082;69;298;1122;3432;1191;3730
251180;201701;2416;7370;2206;7028;302;1049;1404;4432;1706;5481
251190;201701;4349;11951;4155;11714;114;385;3753;10444;3867;10829
251200;201701;3860;12483;3663;12243;96;410;3298;11028;3394;11438
251203;201701;985;3275;952;3210;42;191;718;2365;760;2556
251207;201701;1000;3128;875;2891;41;208;610;1940;651;2148
251210;201701;7694;21612;6621;20230;584;1814;5097;15891;5681;17705
251220;201701;1154;3041;954;2763;63;177;736;2161;799;2338
251230;201701;4427;13101;4072;12661;222;865;3590;11016;3812;11881
251240;201701;3189;9576;2911;9204;331;1113;2184;6878;2515;7991
251250;201701;10151;29713;9457;28727;715;2664;7249;21527;7964;24191
251260;201701;455;1447;419;1393;24;104;315;1028;339;1132
251270;201701;4159;13489;3803;13041;136;648;3245;11085;3381;11733
251272;201701;1331;3803;1274;3727;64;219;1155;3350;1219;3569
251274;201701;887;2726;799;2577;77;333;532;1638;609;1971
251275;201701;1200;3496;1125;3381;54;236;860;2465;914;2701
251276;201701;1177;3597;1126;3513;93;393;856;2611;949;3004
251278;201701;590;1808;522;1686;47;188;344;1104;391;1292
251280;201701;2285;6730;2107;6428;80;355;1665;4905;1745;5260
251290;201701;5425;14790;5089;14373;478;1740;3987;10895;4465;12635
251300;201701;729;2407;688;2342;25;111;564;1898;589;2009
251310;201701;2832;8514;2633;8242;143;654;2103;6379;2246;7033
251315;201701;1625;5482;1546;5348;138;508;1163;4004;1301;4512
251320;201701;1834;5029;1377;4284;67;264;947;2930;1014;3194
251330;201701;1726;4588;1464;4246;63;268;1271;3603;1334;3871
251335;201701;1017;3358;932;3219;75;335;673;2262;748;2597
251340;201701;3292;9633;2969;9161;158;628;2320;7049;2478;7677
251350;201701;1177;3755;1103;3620;55;235;874;2773;929;3008
251360;201701;1785;5574;1529;5219;54;216;1298;4482;1352;4698
251365;201701;692;2083;591;1859;19;82;436;1341;455;1423
251370;201701;22619;68742;21780;67613;1722;6611;17299;52446;19021;59057
251380;201701;1300;4017;1135;3740;41;214;958;3043;999;3257
251385;201701;735;1969;616;1784;38;124;431;1194;469;1318
251390;201701;5532;18732;4933;17546;1392;5108;2132;7667;3524;12775
251392;201701;1015;3009;889;2798;58;230;653;2000;711;2230
251394;201701;567;1800;487;1659;39;169;332;1099;371;1268
251396;201701;793;2247;687;2075;65;193;447;1347;512;1540
251398;201701;860;2515;774;2359;36;143;540;1581;576;1724
251400;201701;1108;3150;946;2909;70;267;692;2048;762;2315
251410;201701;1505;3875;1276;3511;36;147;1059;2811;1095;2958
251420;201701;1935;5522;1688;5231;153;562;1242;3790;1395;4352
251430;201701;1553;5279;1428;5079;61;318;1196;4178;1257;4496
251440;201701;1152;3451;962;3085;38;160;743;2365;781;2525
251445;201701;1482;4517;1408;4416;115;480;1094;3325;1209;3805
251450;201701;4529;14293;4199;13847;136;640;3455;11350;3591;11990
251455;201701;1052;3359;946;3149;88;369;661;2169;749;2538
251460;201701;804;2496;749;2400;49;180;609;1956;658;2136
251465;201701;424;1363;366;1235;16;89;275;891;291;980
251470;201701;1086;3200;923;2856;75;279;587;1783;662;2062
251480;201701;883;2512;788;2361;34;157;590;1696;624;1853
251490;201701;1727;5132;1547;4849;146;546;1061;3259;1207;3805
251500;201701;1706;5417;1632;5281;95;396;1327;4209;1422;4605
251510;201701;2504;8170;2277;7723;347;1296;1380;4665;1727;5961
251520;201701;913;2502;796;2289;85;261;544;1528;629;1789
251530;201701;11985;33047;11246;32035;305;1324;9695;27005;10000;28329
251540;201701;2784;8851;2590;8496;152;622;2048;6635;2200;7257
251550;201701;3306;8755;2800;8062;82;323;2289;6520;2371;6843
251560;201701;647;2024;586;1922;80;313;362;1141;442;1454
251570;201701;950;2813;777;2475;39;162;539;1662;578;1824
251580;201701;1812;5133;1651;4909;318;821;1074;3340;1392;4161
251590;201701;1461;4445;1385;4334;56;221;1114;3482;1170;3703
251593;201701;951;2913;878;2810;121;411;545;1705;666;2116
251597;201701;1891;5756;1829;5679;51;212;1619;4953;1670;5165
251600;201701;6346;18545;5907;17867;304;1076;4839;14490;5143;15566
251610;201701;3235;9602;2935;9061;255;765;2148;6726;2403;7491
251615;201701;1120;3186;914;2830;44;180;624;1883;668;2063
251620;201701;15181;40219;13746;38544;493;1420;11336;33445;11829;34865
251630;201701;4519;11676;3864;10740;258;806;2875;7829;3133;8635
251640;201701;2159;6553;1964;6180;81;355;1606;4946;1687;5301
251650;201701;3883;11168;3565;10740;205;702;2955;8849;3160;9551
251660;201701;3425;10912;3134;10382;113;567;2574;8311;2687;8878
251670;201701;4356;12828;3877;12238;31;118;3642;11635;3673;11753
251675;201701;675;2102;624;2033;101;380;408;1279;509;1659
251680;201701;2706;7747;2204;6981;100;415;1681;5269;1781;5684
251690;201701;3248;9652;2964;9104;127;461;2157;6475;2284;6936
251700;201701;1881;6064;1756;5898;93;455;1432;4669;1525;5124
251710;201701;872;2287;593;1730;86;301;272;740;358;1041
251720;201701;1393;4234;1199;3870;56;271;872;2703;928;2974
251740;201701;740;2092;595;1856;56;198;371;1138;427;1336
260005;201701;24108;59130;20882;54442;3985;10161;11832;31131;15817;41292
260010;201701;9674;26372;8173;24311;985;3066;4917;15115;5902;18181
260020;201701;6108;16668;5186;15331;197;778;4201;12421;4398;13199
260030;201701;6106;17409;5426;16329;360;1246;4184;12554;4544;13800
260040;201701;9489;23376;7906;21519;640;1730;5956;16825;6596;18555
260050;201701;11089;34159;10405;33337;459;1831;9011;29047;9470;30878
260060;201701;3774;10606;3348;9847;305;893;2441;7306;2746;8199
260070;201701;9612;27434;8790;26136;955;3309;6136;17791;7091;21100
260080;201701;5900;15292;5304;14495;492;1361;3957;10730;4449;12091
260090;201701;5090;13898;4734;13393;457;1332;3608;10265;4065;11597
260100;201701;3301;9086;2842;8455;136;554;2340;6901;2476;7455
260105;201701;5017;13812;4767;13415;167;694;4074;11202;4241;11896
260110;201701;20622;57480;18970;55545;711;2359;16863;49463;17574;51822
260120;201701;12738;37596;11381;35329;2248;7213;6171;19724;8419;26937
260130;201701;3095;8642;2899;8328;271;842;2185;6198;2456;7040
260140;201701;12342;30638;10772;28787;737;2342;8637;23103;9374;25445
260150;201701;3159;8617;2853;8218;182;672;2294;6527;2476;7199
260160;201701;5408;16902;4693;15946;254;1166;3771;12817;4025;13983
260170;201701;15934;44265;15134;43151;768;2603;12883;36366;13651;38969
260180;201701;3164;9578;2891;9188;152;556;2457;7788;2609;8344
260190;201701;16045;36881;14513;35013;334;1002;12617;29973;12951;30975
260200;201701;10763;27410;9966;26415;320;1126;8901;23435;9221;24561
260210;201701;11488;34344;10292;32462;447;1818;8465;26555;8912;28373
260220;201701;9218;26053;8860;25596;368;1422;7817;22190;8185;23612
260230;201701;9532;26841;8776;25800;407;1537;7098;20743;7505;22280
260240;201701;2858;8417;2489;7893;252;897;1852;5893;2104;6790
260250;201701;2231;6141;1966;5763;102;351;1581;4563;1683;4914
260260;201701;11957;33846;10830;32209;927;3182;8274;24517;9201;27699
260270;201701;3581;10315;3289;9869;216;985;2486;7138;2702;8123
260280;201701;12729;40858;11697;39342;645;2423;9741;32968;10386;35391
260290;201701;31867;93975;30076;90908;4850;15667;18960;56751;23810;72418
260300;201701;8619;26199;7648;24745;368;1593;5871;19049;6239;20642
260310;201701;4397;12896;4011;12331;775;2213;2545;8163;3320;10376
260320;201701;7335;23006;6714;21954;376;1475;5386;17515;5762;18990
260330;201701;2524;8084;2342;7739;127;576;1856;5973;1983;6549
260340;201701;1854;5375;1719;5173;44;159;1544;4624;1588;4783
260345;201701;21771;66631;20277;63841;5063;17554;8085;24446;13148;42000
260350;201701;4771;12729;4423;12246;146;555;3848;10523;3994;11078
260360;201701;2361;6715;2133;6319;113;483;1465;4279;1578;4762
260370;201701;5514;17070;4859;15896;352;1479;3534;11400;3886;12879
260380;201701;4799;15587;4340;14855;289;1278;3221;10907;3510;12185
260390;201701;4200;13232;3654;12155;266;998;2555;8394;2821;9392
260392;201701;3461;11034;3152;10638;204;944;2599;8597;2803;9541
260400;201701;13577;37784;12798;36546;1433;4626;9117;25508;10550;30134
260410;201701;59192;167740;51489;155630;13402;43139;20157;62709;33559;105848
260415;201701;3627;11319;3180;10412;227;1029;2113;6628;2340;7657
260420;201701;11967;27183;10588;25684;197;697;9665;23214;9862;23911
260430;201701;2842;9142;2504;8490;229;844;1642;5583;1871;6427
260440;201701;3194;9559;2833;8849;338;1195;1852;5618;2190;6813
260450;201701;4897;14092;4707;13837;153;532;4258;12540;4411;13072
260460;201701;5440;17226;4954;16291;834;3060;2742;8842;3576;11902
260470;201701;4505;13267;4098;12783;156;494;3548;11361;3704;11855
260480;201701;4051;11489;3555;10772;417;1426;2354;7197;2771;8623
260490;201701;4846;12609;4238;11590;206;695;3502;9332;3708;10027
260500;201701;5722;16331;5097;15331;717;2205;3312;10044;4029;12249
260510;201701;8666;22906;8059;22085;315;1062;7113;19301;7428;20363
260515;201701;4669;13909;3585;11752;228;886;2284;7468;2512;8354
260520;201701;16098;41187;15246;40030;1480;3971;11834;30870;13314;34841
260530;201701;9331;28720;8243;27041;362;1532;6895;22541;7257;24073
260540;201701;5939;14713;5405;14135;663;1238;4261;11802;4924;13040
260545;201701;62;221;42;165;9;37;8;29;17;66
260550;201701;2628;8502;2230;7624;383;1435;992;3377;1375;4812
260560;201701;6075;16114;5439;15222;159;698;4721;12983;4880;13681
260570;201701;6732;21786;6175;20908;552;2225;4630;15591;5182;17816
260580;201701;3614;10015;3338;9550;103;387;2870;8057;2973;8444
260590;201701;6040;15136;5659;14698;244;720;4960;12840;5204;13560
260600;201701;28344;81295;25131;76035;1808;6699;18426;55130;20234;61829
260610;201701;5983;18152;5682;17636;523;1888;4181;12680;4704;14568
260620;201701;15024;45191;14370;44044;2207;7784;9195;27365;11402;35149
260630;201701;2176;6385;1936;6030;101;446;1574;4804;1675;5250
260640;201701;16807;45934;15736;44497;2073;6339;10768;30339;12841;36678
260650;201701;5407;16655;4751;15529;261;1059;3819;12488;4080;13547
260660;201701;7578;20993;6813;20026;253;994;5727;16651;5980;17645
260670;201701;2266;6055;1876;5489;105;334;1355;3946;1460;4280
260680;201701;21143;59937;19284;56621;3448;10375;9871;29068;13319;39443
260690;201701;3653;9798;3033;8795;203;600;2292;6641;2495;7241
260700;201701;5752;17060;5603;16899;27;50;5487;16727;5514;16777
260710;201701;1319;3822;1246;3724;97;333;925;2824;1022;3157
260720;201701;17450;54604;16360;52562;3029;10204;9276;29725;12305;39929
260730;201701;6579;21704;6171;21033;625;2482;4680;15723;5305;18205
260740;201701;1202;3608;1072;3374;68;251;854;2673;922;2924
260750;201701;6882;20334;6054;19291;247;772;5334;17351;5581;18123
260760;201701;4707;12572;4434;12231;193;646;3737;10317;3930;10963
260765;201701;7497;25100;7113;24459;910;4134;4864;16025;5774;20159
260770;201701;3724;9980;3359;9396;124;418;2653;7344;2777;7762
260775;201701;4812;14155;4564;13780;389;1511;3280;9610;3669;11121
260780;201701;3514;11309;3272;10843;682;2480;1654;5296;2336;7776
260790;201701;107647;270043;99245;257455;18773;50039;57611;148374;76384;198413
260795;201701;3023;8840;2688;8328;210;786;1929;5989;2139;6775
260800;201701;4855;12876;4527;12436;130;553;4006;10649;4136;11202
260805;201701;3687;10960;3176;10135;308;1174;2175;6855;2483;8029
260810;201701;6598;18296;6357;17972;351;1077;5339;15033;5690;16110
260820;201701;3932;11083;3488;10380;625;2000;1869;5504;2494;7504
260825;201701;2846;9030;2534;8509;141;604;1919;6417;2060;7021
260830;201701;3562;11467;3208;10773;426;1477;2136;7226;2562;8703
260840;201701;4164;11855;3723;11212;232;774;2983;8919;3215;9693
260845;201701;3922;11408;3761;11105;396;1228;2859;8487;3255;9715
260850;201701;4628;15146;4145;14041;747;2821;1975;6612;2722;9433
260860;201701;3609;10838;3124;9867;176;646;2361;7391;2537;8037
260870;201701;4095;11021;3646;10442;242;789;2906;8241;3148;9030
260875;201701;6205;17511;5471;16284;792;2386;3535;10604;4327;12990
260880;201701;9643;28596;8707;27090;512;1726;6936;21698;7448;23424
260890;201701;12629;36052;11775;34739;619;2302;9005;26191;9624;28493
260900;201701;5532;16976;4804;15581;378;1603;3103;9815;3481;11418
260910;201701;3043;8997;2727;8492;135;502;2036;6323;2171;6825
260915;201701;4555;15027;4265;14620;87;449;3860;13193;3947;13642
260920;201701;3124;9552;2902;9250;143;535;2359;7627;2502;8162
260930;201701;3827;12411;3401;11687;313;1147;2415;8326;2728;9473
260940;201701;13619;35856;12504;34045;1383;4288;8512;22659;9895;26947
260950;201701;6176;18920;5483;17509;819;3063;2805;8486;3624;11549
260960;201701;53685;146779;48806;138997;8882;27198;26275;73884;35157;101082
260970;201701;4823;14376;4434;13867;224;879;3464;10824;3688;11703
260980;201701;3916;12725;3657;12403;111;489;3235;10960;3346;11449
260990;201701;17111;51891;15585;49796;971;3902;12458;39656;13429;43558
261000;201701;15363;41426;12686;37382;1919;6137;6959;21003;8878;27140
261010;201701;2429;6734;2221;6490;106;245;1977;5905;2083;6150
261020;201701;6359;18262;5597;16917;494;1672;4103;12119;4597;13791
261030;201701;3692;11327;3254;10602;180;728;2548;8169;2728;8897
261040;201701;5005;15989;4268;14437;340;1372;3001;9931;3341;11303
261050;201701;7736;22452;7236;21566;859;2681;4810;14371;5669;17052
261060;201701;12150;35069;11215;33415;960;3448;8328;24238;9288;27686
261070;201701;52296;126318;46215;117686;4890;13149;32010;80717;36900;93866
261080;201701;5571;15873;5296;15476;290;821;4590;13577;4880;14398
261090;201701;16268;44107;14939;42275;1012;3059;12050;34154;13062;37213
261100;201701;8143;25259;7243;23717;1091;3845;4382;14574;5473;18419
261110;201701;59396;175581;52732;165485;13187;43963;23214;74811;36401;118774
261120;201701;3785;9883;3299;9318;83;308;2918;8223;3001;8531
261130;201701;6984;17788;6481;17232;154;541;5742;15143;5896;15684
261140;201701;3125;8678;2836;8233;351;1187;1808;5125;2159;6312
261150;201701;5309;14868;4857;14192;227;839;4150;12025;4377;12864
261153;201701;2033;6044;1734;5564;92;396;1238;3931;1330;4327
261160;201701;189681;495911;174839;473890;43114;122664;78378;215066;121492;337730
261170;201701;5565;15018;5092;14328;299;874;4072;11478;4371;12352
261180;201701;9539;26254;8847;25308;869;2899;6001;16847;6870;19746
261190;201701;4978;15331;4647;14937;469;2012;3338;10422;3807;12434
261200;201701;3522;8739;3145;8288;302;821;2434;6433;2736;7254
261210;201701;1832;4880;1697;4704;103;292;1477;4095;1580;4387
261220;201701;13295;40706;11300;36600;1360;4993;6461;20708;7821;25701
261230;201701;4533;14055;4127;13538;127;545;3500;11578;3627;12123
261240;201701;4723;13649;4338;12994;510;1484;3142;9500;3652;10984
261245;201701;3441;10522;2981;9704;148;676;2301;7281;2449;7957
261247;201701;3091;9465;2652;8661;159;661;1904;6235;2063;6896
261250;201701;18563;49289;17249;47517;3105;8191;11277;32291;14382;40482
261255;201701;3930;12191;3506;11442;206;950;2754;8728;2960;9678
261260;201701;12238;34230;10920;32629;525;1831;9057;27293;9582;29124
261270;201701;3650;10838;3296;10249;290;1037;2351;7137;2641;8174
261280;201701;2507;7523;2311;7216;99;413;1876;5752;1975;6165
261290;201701;2885;8204;2612;7846;154;585;2026;6056;2180;6641
261300;201701;10742;33845;9341;31321;1107;4398;5946;19581;7053;23979
261310;201701;6895;21204;6471;20458;1548;5020;3558;11286;5106;16306
261320;201701;5731;17500;5249;16654;192;825;4206;13116;4398;13941
261330;201701;5522;15302;5205;14896;287;1120;4418;12364;4705;13484
261340;201701;3784;12570;3556;12194;313;1366;2506;8473;2819;9839
261350;201701;7932;25647;7476;24871;267;1405;6095;19749;6362;21154
261360;201701;8087;21090;7171;19824;542;1561;5613;15318;6155;16879
261370;201701;18758;55263;17607;53395;3535;11327;9831;29875;13366;41202
261380;201701;4041;13636;3746;13013;516;2053;2394;8209;2910;10262
261390;201701;16029;48362;14492;45769;1930;6668;8802;27932;10732;34600
261400;201701;4611;15753;4096;14666;259;1146;2911;10271;3170;11417
261410;201701;8788;23962;7842;22504;578;1868;6205;17712;6783;19580
261420;201701;7219;24059;6896;23628;1387;5374;4276;14432;5663;19806
261430;201701;3373;10311;2924;9636;188;661;2291;7613;2479;8274
261440;201701;1532;4826;1374;4556;55;286;1055;3415;1110;3701
261450;201701;13852;39198;13315;38538;278;1197;11895;34120;12173;35317
261460;201701;6958;20330;6532;19739;330;1055;5682;17220;6012;18275
261470;201701;3982;10856;3670;10435;67;244;3145;9030;3212;9274
261480;201701;3765;13188;3443;12612;255;1120;2555;9177;2810;10297
261485;201701;4865;14816;4334;13908;584;2190;2688;8493;3272;10683
261500;201701;5307;14931;4761;14200;495;1454;3391;10416;3886;11870
261510;201701;1827;5839;1648;5524;119;460;1220;4114;1339;4574
261520;201701;2684;8600;2534;8329;127;488;1654;5718;1781;6206
261530;201701;10744;34693;9804;32797;1850;7075;4523;14941;6373;22016
261540;201701;6747;21800;6322;21069;1439;4847;3495;11995;4934;16842
261550;201701;3418;9494;3184;9164;233;845;2421;6797;2654;7642
261560;201701;7104;23110;6419;22177;738;3033;4661;16105;5399;19138
261570;201701;3341;9928;2909;9214;325;1157;1842;5776;2167;6933
261580;201701;5993;17944;5441;17083;266;1152;4567;14130;4833;15282
261590;201701;2396;6742;2048;6191;156;490;1504;4581;1660;5071
261600;201701;5171;13967;4451;12938;298;951;3373;9815;3671;10766
261610;201701;2408;6728;2097;6298;86;340;1715;5129;1801;5469
261618;201701;2422;6703;2193;6403;154;535;1678;4769;1832;5304
261620;201701;3889;12096;3650;11690;719;2256;2290;7566;3009;9822
261630;201701;7400;21469;6260;19338;686;2593;3671;11005;4357;13598
261640;201701;34210;84022;32213;81710;1922;4480;26288;69627;28210;74107
261650;201701;3739;10939;3465;10581;244;945;2572;7918;2816;8863
270010;201701;4255;15682;3916;15017;288;1422;2944;11168;3232;12590
270020;201701;3808;10600;3526;10200;303;1049;2822;7955;3125;9004
270030;201701;36360;108100;33674;103660;6944;21903;19157;59628;26101;81531
270040;201701;10408;31443;9587;30362;1507;5094;6352;20338;7859;25432
270050;201701;4397;11929;3981;11440;295;984;3321;9527;3616;10511
270060;201701;1878;5438;1733;5244;255;787;1184;3662;1439;4449
270070;201701;4309;13145;3945;12650;193;934;3311;10346;3504;11280
270080;201701;1260;3922;1089;3592;130;469;717;2304;847;2773
270090;201701;2100;6534;1907;6150;89;444;1510;4665;1599;5109
270100;201701;5594;16845;5255;16296;561;2084;3905;11870;4466;13954
270110;201701;2925;8217;2611;7864;292;945;1915;5971;2207;6916
270120;201701;3018;8393;2670;7956;91;370;2374;7027;2465;7397
270130;201701;5098;15201;4685;14747;575;1961;3565;11398;4140;13359
270135;201701;1764;4698;1584;4479;164;355;1317;3885;1481;4240
270140;201701;10368;24323;8767;22290;571;2242;7091;17018;7662;19260
270150;201701;2619;8427;2544;8340;46;156;2461;8087;2507;8243
270160;201701;4871;16144;4515;15695;167;828;3874;13317;4041;14145
270170;201701;3637;11585;3356;11201;488;1946;2162;7064;2650;9010
270180;201701;2239;7281;2066;7038;89;465;1725;5731;1814;6196
270190;201701;1719;5583;1631;5471;78;310;1382;4661;1460;4971
270200;201701;2509;8264;2342;8028;207;919;1749;5807;1956;6726
270210;201701;4607;13499;4315;13101;238;1016;3687;10983;3925;11999
270220;201701;1239;4051;1142;3877;209;813;658;2163;867;2976
270230;201701;10571;32637;9218;30509;1057;4319;5628;18018;6685;22337
270235;201701;6102;19647;5717;19043;316;1384;4691;15466;5007;16850
270240;201701;9070;27539;7661;25700;1799;6378;3874;13334;5673;19712
270250;201701;3110;8199;2819;7832;376;1046;2146;6012;2522;7058
270255;201701;4716;14348;3811;12682;267;1161;2689;8724;2956;9885
270260;201701;5694;18201;5509;17951;370;1637;4675;14835;5045;16472
270270;201701;1142;3211;1053;3091;182;559;641;1848;823;2407
270280;201701;3436;9631;2997;9012;353;962;2090;6387;2443;7349
270290;201701;7686;26444;7207;25610;512;2474;5708;19860;6220;22334
270300;201701;3636;11366;3268;10931;333;1263;2413;8051;2746;9314
270310;201701;7384;22017;6519;20757;261;1336;5360;16568;5621;17904
270320;201701;5723;17597;5382;17052;718;2527;3752;11704;4470;14231
270330;201701;4125;14053;3861;13701;376;1433;3003;10792;3379;12225
270340;201701;1606;4864;1419;4610;99;403;1128;3578;1227;3981
270350;201701;1831;4902;1670;4714;135;453;1260;3540;1395;3993
270360;201701;2016;6127;1923;6023;143;444;1651;5269;1794;5713
270370;201701;1443;4740;1316;4525;99;443;959;3263;1058;3706
270375;201701;2858;7748;2537;7332;70;245;2259;6519;2329;6764
270380;201701;5702;17304;5308;16780;431;1389;4148;13392;4579;14781
270390;201701;1235;3400;1072;3162;57;212;810;2320;867;2532
270400;201701;6264;18584;5612;17630;326;1364;4149;12639;4475;14003
270410;201701;4703;14679;4305;13950;380;1424;3057;9753;3437;11177
270420;201701;5886;18402;5624;18055;302;1351;4560;14305;4862;15656
270430;201701;132605;377025;116399;353221;33848;108635;40481;128498;74329;237133
270440;201701;4527;13525;4157;13029;168;729;3385;10542;3553;11271
270450;201701;6215;18836;5894;18411;301;1328;4900;15003;5201;16331
270460;201701;3305;8696;3004;8340;101;378;2625;7148;2726;7526
270470;201701;10015;31710;9225;30467;1050;4055;6233;20581;7283;24636
270480;201701;2760;8392;2430;7821;290;1119;1663;5153;1953;6272
270490;201701;959;2992;878;2881;53;212;679;2212;732;2424
270500;201701;4793;16005;4492;15635;258;1218;3728;12833;3986;14051
270510;201701;5933;17177;5312;16324;582;2327;4002;11858;4584;14185
270520;201701;3422;10820;3125;10312;1046;3725;1014;3548;2060;7273
270530;201701;1275;3968;1190;3839;106;359;844;2768;950;3127
270540;201701;2007;6557;1846;6331;103;538;1526;5065;1629;5603
270550;201701;6627;19584;5982;18783;719;2415;4350;13931;5069;16346
270560;201701;3101;9149;2872;8807;240;898;2164;6524;2404;7422
270570;201701;3710;11892;3378;11323;207;909;2673;8767;2880;9676
270580;201701;2038;6136;1922;5987;126;398;1610;5095;1736;5493
270590;201701;1345;4395;1301;4328;7;28;1276;4255;1283;4283
270600;201701;2819;9202;2565;8773;166;813;2090;6966;2256;7779
270610;201701;3215;9816;2979;9477;148;581;2520;7921;2668;8502
270620;201701;1365;4485;1277;4333;83;385;1039;3396;1122;3781
270630;201701;15667;45689;14286;43506;1736;5554;9999;30836;11735;36390
270640;201701;5646;17193;5075;16309;313;1346;4017;12629;4330;13975
270642;201701;2309;8026;2160;7816;205;1023;1661;5819;1866;6842
270644;201701;2746;7961;2399;7483;244;800;1755;5590;1999;6390
270650;201701;3620;11172;3423;10901;442;2082;2476;7341;2918;9423
270660;201701;2104;5419;1667;4796;78;317;1213;3429;1291;3746
270670;201701;16427;41448;14214;38968;1596;4389;10582;29731;12178;34120
270680;201701;4241;12197;4028;11962;93;269;3780;11293;3873;11562
270690;201701;9062;24675;8027;23519;2527;6912;4121;13200;6648;20112
270700;201701;575;1821;514;1718;76;323;337;1068;413;1391
270710;201701;5855;18439;5533;18025;368;1575;4580;14656;4948;16231
270720;201701;3351;11134;3062;10620;141;817;2543;8595;2684;9412
270730;201701;6308;17845;5942;17464;438;1372;5051;15062;5489;16434
270740;201701;2285;6496;2147;6288;170;616;1758;5065;1928;5681
270750;201701;5190;15629;4784;14993;628;2202;3406;10633;4034;12835
270760;201701;3419;10065;3068;9503;133;533;2482;7597;2615;8130
270770;201701;18504;48444;15447;44777;2938;8455;9137;27960;12075;36415
270780;201701;1764;5593;1684;5465;187;694;1249;4032;1436;4726
270790;201701;1557;4904;1438;4730;314;1125;840;2735;1154;3860
270800;201701;11059;32287;10262;31218;571;2371;8689;25866;9260;28237
270810;201701;3148;9601;2508;8414;272;1039;1593;5363;1865;6402
270820;201701;1745;5564;1548;5229;233;896;991;3312;1224;4208
270830;201701;5533;14526;4976;13872;356;981;4081;11792;4437;12773
270840;201701;7736;24600;7148;23830;332;1719;6140;19928;6472;21647
270850;201701;7356;22314;7011;21874;753;3166;5213;15369;5966;18535
270860;201701;10675;29647;9016;27569;1000;3713;6174;18467;7174;22180
270870;201701;2130;6410;1814;5766;193;674;1203;3779;1396;4453
270880;201701;8179;25714;7589;24844;438;1854;6182;19972;6620;21826
270890;201701;2403;7245;2241;6962;227;845;1650;4980;1877;5825
270895;201701;2858;10247;2751;10089;133;694;2374;8577;2507;9271
270900;201701;1775;4867;1509;4493;105;362;1141;3298;1246;3660
270910;201701;3507;11275;3217;10762;215;997;2446;7970;2661;8967
270915;201701;9291;30555;8336;28884;1190;4865;5101;17291;6291;22156
270920;201701;6157;19163;5899;18801;309;1523;5113;15814;5422;17337
270930;201701;16077;43137;13734;40331;2762;7881;8309;25451;11071;33332
270940;201701;5453;17782;5139;17450;436;2072;3786;12488;4222;14560
280010;201701;634;1839;556;1703;36;176;385;1076;421;1252
280020;201701;4753;13402;4158;12438;535;1788;2707;7968;3242;9756
280030;201701;72262;186647;61591;171034;17244;49798;22975;66588;40219;116386
280040;201701;3079;9225;2759;8749;233;884;2027;6299;2260;7183
280050;201701;3632;11469;3347;10980;932;3256;1552;5130;2484;8386
280060;201701;4929;15089;4233;13898;806;2871;2131;7165;2937;10036
280067;201701;6883;19265;6004;17860;896;2728;3639;10894;4535;13622
280070;201701;1909;6145;1834;6030;169;599;1449;4745;1618;5344
280100;201701;3699;11323;3338;10710;398;1471;2284;7310;2682;8781
280110;201701;1369;4068;1257;3898;54;208;1049;3200;1103;3408
280120;201701;7676;23870;6984;22719;1008;3146;4889;16417;5897;19563
280130;201701;7428;20243;6830;19387;842;2621;4853;13801;5695;16422
280140;201701;5673;14973;5226;14332;387;1150;4201;11529;4588;12679
280150;201701;3368;9913;3160;9588;217;831;2438;7250;2655;8081
280160;201701;1313;3849;1125;3535;153;536;725;2220;878;2756
280170;201701;4713;13865;4296;13240;396;1263;3279;10247;3675;11510
280190;201701;1173;3034;1005;2778;69;253;801;2132;870;2385
280200;201701;1159;3424;1041;3244;109;414;742;2233;851;2647
280210;201701;14015;40138;12527;38116;2171;7184;7122;21953;9293;29137
280220;201701;1587;4756;1474;4574;71;304;1217;3724;1288;4028
280230;201701;3089;9276;2818;8850;289;1030;1937;6078;2226;7108
280240;201701;3384;9614;3087;9152;163;565;2478;7274;2641;7839
280250;201701;827;2170;671;1921;103;322;359;997;462;1319
280260;201701;2073;5404;1942;5250;57;184;1792;4841;1849;5025
280270;201701;2088;6482;1911;6212;100;389;1572;5022;1672;5411
280280;201701;4066;13228;3680;12587;710;2077;2191;8106;2901;10183
280290;201701;17348;51304;15651;48698;1856;6600;9976;31098;11832;37698
280300;201701;9644;28528;9001;27763;669;2428;6981;22358;7650;24786
280310;201701;1357;3765;1174;3452;45;191;868;2482;913;2673
280320;201701;8494;26452;7820;25373;1312;4735;4398;14106;5710;18841
280330;201701;4344;12365;3964;11724;420;1496;2914;8275;3334;9771
280340;201701;3750;10283;3520;9966;254;816;2889;8266;3143;9082
280350;201701;22065;60346;19510;56640;2572;8103;12952;37693;15524;45796
280360;201701;5544;17222;5116;16490;890;3200;2946;9321;3836;12521
280370;201701;1817;5017;1559;4594;147;401;1091;3242;1238;3643
280380;201701;1023;3126;919;2956;100;401;629;1946;729;2347
280390;201701;3056;8901;2626;8092;229;808;1806;5548;2035;6356
280400;201701;4057;11322;3688;10782;924;2667;1879;5729;2803;8396
280410;201701;2098;6634;1805;6059;210;794;1057;3434;1267;4228
280420;201701;4141;11794;3801;11273;181;579;3247;9647;3428;10226
280430;201701;2202;5633;1970;5307;99;385;1519;3986;1618;4371
280440;201701;4600;13158;4200;12655;291;993;3370;10046;3661;11039
280445;201701;2404;6561;2211;6227;64;239;1763;4859;1827;5098
280450;201701;9064;23648;8383;22770;528;1216;7050;19692;7578;20908
280460;201701;6675;17208;6088;16376;690;1914;4546;12344;5236;14258
280470;201701;1815;5375;1623;5039;113;365;1190;3708;1303;4073
280480;201701;32295;90427;30126;87327;4031;13445;20479;58134;24510;71579
280490;201701;3803;11282;3357;10561;209;835;2486;7667;2695;8502
280500;201701;907;2415;811;2294;48;153;651;1829;699;1982
280510;201701;2500;7316;2240;6953;157;619;1639;5031;1796;5650
280520;201701;1749;4676;1605;4497;114;327;1344;3776;1458;4103
280530;201701;2445;6479;2243;6223;130;420;1861;5167;1991;5587
280540;201701;9272;25195;8547;24166;244;1081;7459;20536;7703;21617
280550;201701;6820;17411;5658;15679;480;1358;3994;11062;4474;12420
280560;201701;7405;21633;6996;21056;315;1214;5959;17649;6274;18863
280570;201701;6258;16863;5387;15691;513;1742;3710;10698;4223;12440
280580;201701;5337;16420;4614;15116;673;2293;2853;9516;3526;11809
280590;201701;2594;7165;2277;6763;223;867;1487;4330;1710;5197
280600;201701;3416;10329;3172;9969;273;994;2431;7572;2704;8566
280610;201701;2379;6599;2170;6295;185;634;1581;4476;1766;5110
280620;201701;5297;15060;4653;14006;545;1588;3160;9893;3705;11481
280630;201701;3588;11590;3359;11247;296;1014;2604;8913;2900;9927
280640;201701;2146;6465;2040;6350;67;213;1901;5940;1968;6153
280650;201701;1068;3298;972;3144;93;353;693;2203;786;2556
280660;201701;2657;7318;2527;7173;239;684;2093;5965;2332;6649
280670;201701;16467;42236;15070;40366;1788;5211;10611;28157;12399;33368
280680;201701;2807;7437;2429;6837;163;485;1850;5106;2013;5591
280690;201701;914;2579;819;2452;102;343;572;1696;674;2039
280700;201701;989;2980;902;2822;66;217;647;2002;713;2219
280710;201701;12205;31013;11014;29634;586;1327;9493;26170;10079;27497
280720;201701;2302;6050;2100;5813;209;627;1480;4278;1689;4905
280730;201701;907;2688;842;2592;72;299;665;1981;737;2280
280740;201701;13202;34913;11358;32047;1249;3607;7438;21168;8687;24775
280750;201701;3427;10293;3157;9855;259;935;2272;7093;2531;8028
280760;201701;5652;16906;5176;16187;805;2709;3130;10031;3935;12740
290010;201701;2769;6290;2078;5229;54;220;1655;3972;1709;4192
290020;201701;4268;14110;4158;13967;356;1099;3465;11831;3821;12930
290030;201701;3194;9529;2996;9266;324;1053;2326;7207;2650;8260
290035;201701;4418;11274;3888;10542;223;713;2973;8247;3196;8960
290040;201701;4141;10792;3507;10088;204;831;2715;7760;2919;8591
290050;201701;2383;7724;2108;7240;149;640;1509;5114;1658;5754
290060;201701;1256;3217;1059;2977;115;420;783;2106;898;2526
290070;201701;32862;81137;28396;75488;4968;13549;15253;42236;20221;55785
290080;201701;5883;17412;5019;16224;666;2235;3365;11165;4031;13400
290090;201701;2008;4414;1640;4017;76;184;1448;3579;1524;3763
290100;201701;8941;25675;8009;24187;1078;3291;5085;15791;6163;19082
290110;201701;4737;13855;4499;13437;612;2037;2949;8632;3561;10669
290115;201701;4536;13673;4070;13069;220;682;3411;11212;3631;11894
290120;201701;6687;17304;5518;15932;257;985;4428;12579;4685;13564
290130;201701;4605;11916;3754;10859;162;642;2980;8392;3142;9034
290135;201701;4551;11116;3819;9984;281;849;2780;7000;3061;7849
290140;201701;4344;12875;3694;12031;218;840;3045;9947;3263;10787
290150;201701;2165;6431;2059;6280;233;778;1564;4662;1797;5440
290160;201701;3393;8446;3216;8224;253;582;2654;6795;2907;7377
290170;201701;2600;8367;2439;8156;148;658;2086;6861;2234;7519
290180;201701;2868;8260;2451;7618;141;563;1903;5871;2044;6434
290190;201701;3730;12240;3560;11989;214;960;2774;9227;2988;10187
290195;201701;2150;5755;1790;5191;64;294;1470;4190;1534;4484
290200;201701;3824;11705;3363;11012;221;809;2652;8633;2873;9442
290205;201701;3292;9250;2934;8680;183;703;2201;6354;2384;7057
290210;201701;14456;40886;13025;39048;1663;4436;9375;29572;11038;34008
290220;201701;2284;6676;2161;6489;124;521;1745;5105;1869;5626
290225;201701;2879;7018;2562;6663;104;301;2314;5989;2418;6290
290230;201701;2231;7089;2101;6935;108;473;1767;5800;1875;6273
290240;201701;3512;9581;3194;9104;205;666;2508;7022;2713;7688
290250;201701;3758;11629;3524;11321;115;327;3022;10192;3137;10519
290260;201701;5145;14241;4274;12944;307;1065;3263;9861;3570;10926
290265;201701;3421;10470;2991;9691;151;638;2285;7319;2436;7957
290270;201701;11902;42621;11392;41810;1120;4735;8520;31138;9640;35873
290280;201701;5422;17172;5005;16516;404;1462;3697;12208;4101;13670
290290;201701;9642;29766;8539;27941;1049;3579;5900;19529;6949;23108
290300;201701;4505;12670;3290;10386;216;761;2262;7253;2478;8014
290310;201701;1436;4253;1236;3926;169;586;746;2357;915;2943
290320;201701;28268;78681;23966;73290;4943;16118;12697;39948;17640;56066
290323;201701;3700;10175;3356;9763;122;424;2816;8097;2938;8521
290327;201701;4421;13140;3791;12013;454;1482;2469;7864;2923;9346
290330;201701;1828;4388;1684;4237;88;243;1500;3807;1588;4050
290340;201701;5078;15198;4665;14707;1089;3572;2856;9119;3945;12691
290350;201701;4168;12919;3692;12162;314;1093;2647;8883;2961;9976
290360;201701;4547;13528;3945;12710;138;607;3270;10598;3408;11205
290370;201701;4673;12660;3988;11737;248;774;3202;9500;3450;10274
290380;201701;5467;15810;4805;14819;304;1014;3750;11755;4054;12769
290390;201701;14838;44154;13227;41799;1732;5752;8527;27665;10259;33417
290395;201701;2572;8325;2305;7822;107;529;1769;5954;1876;6483
290400;201701;3659;10478;3053;9539;214;742;2190;6750;2404;7492
290405;201701;4671;14500;3969;13217;449;1566;2479;8414;2928;9980
290410;201701;5785;16964;4750;15301;337;1372;3368;10523;3705;11895
290420;201701;3194;9110;2641;8291;228;765;1996;6285;2224;7050
290430;201701;3122;9559;2754;8904;428;1436;1685;5551;2113;6987
290440;201701;2964;7683;2339;6795;135;437;1761;5169;1896;5606
290450;201701;3168;9167;2692;8454;165;683;1987;6089;2152;6772
290460;201701;12336;35416;11075;33258;3238;10060;4013;12105;7251;22165
290470;201701;4077;11459;3191;10075;622;2196;1529;4973;2151;7169
290475;201701;5622;17627;4997;16485;186;952;3901;12546;4087;13498
290480;201701;2355;6405;2225;6232;200;587;1598;4721;1798;5308
290485;201701;4678;14756;4093;13880;240;1201;3319;11041;3559;12242
290490;201701;8270;21226;7789;20619;531;1671;6461;16793;6992;18464
290500;201701;3969;12370;3256;10931;447;1653;1762;5851;2209;7504
290510;201701;3136;8934;2803;8481;129;502;2328;6979;2457;7481
290515;201701;3504;9777;2918;9007;190;577;2386;7513;2576;8090
290520;201701;11185;34283;9125;30218;588;2448;5722;18654;6310;21102
290530;201701;4975;14727;4394;13800;287;976;3504;10998;3791;11974
290540;201701;3648;10549;3410;10161;217;698;2715;8061;2932;8759
290550;201701;4426;11494;3967;10977;77;276;3649;10110;3726;10386
290560;201701;6287;17827;5528;16738;863;2821;3674;11071;4537;13892
290570;201701;41704;112024;38396;107661;3480;10187;28199;78985;31679;89172
290580;201701;6879;22882;6455;22213;589;2239;4910;17097;5499;19336
290590;201701;7165;22652;6246;21029;261;1120;5074;17071;5335;18191
290600;201701;17495;51740;16211;49940;1571;4905;12452;39216;14023;44121
290610;201701;2407;8054;1997;7250;114;543;1391;4930;1505;5473
290620;201701;6071;18388;5574;17581;301;1059;4595;14394;4896;15453
290630;201701;8153;20769;7091;19586;457;1362;5973;16561;6430;17923
290640;201701;2601;7431;2135;6691;117;468;1639;5040;1756;5508
290650;201701;10649;30603;10088;29829;2160;6335;6071;18503;8231;24838
290660;201701;3583;9779;3077;9044;121;396;2284;6982;2405;7378
290670;201701;6880;20721;6102;19430;585;1975;4305;13849;4890;15824
290680;201701;9944;29702;8925;28353;378;1751;7184;22447;7562;24198
290682;201701;4637;12968;4072;12166;191;741;3380;9967;3571;10708
290685;201701;3633;8571;2428;6883;254;765;1553;4498;1807;5263
290687;201701;7024;20288;5636;17995;1178;3835;2802;9339;3980;13174
290689;201701;3042;8742;2730;8289;247;838;1991;6233;2238;7071
290690;201701;5399;15108;4743;14252;648;1966;3076;9341;3724;11307
290700;201701;2383;7150;2225;6920;144;498;1779;5548;1923;6046
290710;201701;7589;23777;7051;22976;476;1567;5726;18842;6202;20409
290720;201701;18238;52946;16932;51334;1110;3380;14036;43381;15146;46761
290730;201701;6953;18950;6264;18045;518;1576;4647;13386;5165;14962
290740;201701;898;2616;710;2296;48;186;522;1665;570;1851
290750;201701;10340;28236;8956;25753;1303;4107;5253;14735;6556;18842
290755;201701;2283;6484;1813;5632;118;456;1263;3850;1381;4306
290760;201701;4087;12336;3333;10902;463;1404;1924;6575;2387;7979
290770;201701;2504;8627;2343;8411;121;572;1881;6767;2002;7339
290780;201701;8888;22170;7712;20485;631;1312;5926;16290;6557;17602
290790;201701;4371;12794;4023;12333;206;647;3462;10639;3668;11286
290800;201701;6892;14610;5424;13027;322;634;4344;10835;4666;11469
290810;201701;5343;15973;4501;14631;171;703;3374;10965;3545;11668
290820;201701;5271;14751;4774;14077;380;1294;3604;10652;3984;11946
290830;201701;4348;11234;4008;10778;181;644;3069;8112;3250;8756
290840;201701;16984;48182;15033;45221;1846;5373;9920;31101;11766;36474
290850;201701;5961;16940;5688;16602;695;1830;4199;12740;4894;14570
290860;201701;5148;16920;4787;16492;353;1317;3829;13505;4182;14822
290870;201701;4670;13531;3771;12021;216;903;2654;8402;2870;9305
290880;201701;1402;3741;1126;3323;101;285;776;2339;877;2624
290890;201701;7039;17720;6015;16583;381;969;5174;14469;5555;15438
290900;201701;2278;6473;1772;5568;173;606;1058;3303;1231;3909
290910;201701;4701;12293;3856;11054;82;355;3241;9138;3323;9493
290920;201701;4857;13026;4479;12538;203;621;3844;10710;4047;11331
290930;201701;8093;23805;6940;22012;277;1288;5520;17169;5797;18457
290940;201701;3525;10944;3103;10324;116;417;2377;8081;2493;8498
290950;201701;1544;4217;1344;3908;118;372;926;2716;1044;3088
290960;201701;5607;15653;5077;14997;189;640;4276;12647;4465;13287
290970;201701;3659;11118;3163;10317;207;741;2214;7256;2421;7997
290980;201701;10264;28929;8774;26168;2396;7475;2709;8142;5105;15617
290990;201701;8792;25953;7588;23958;602;2292;5683;17550;6285;19842
291000;201701;3067;8847;2750;8484;140;497;2377;7310;2517;7807
291005;201701;14405;36630;12744;34547;1154;3196;9500;26145;10654;29341
291010;201701;3201;9780;2535;8394;214;741;1669;5571;1883;6312
291020;201701;1191;3176;978;2810;85;253;564;1538;649;1791
291030;201701;2307;6156;1678;4928;124;407;1025;2898;1149;3305
291040;201701;5542;16273;4875;15280;285;1186;3790;11813;4075;12999
291050;201701;7615;24278;6957;23120;1379;5170;4000;12954;5379;18124
291060;201701;5905;21422;5544;20827;843;3654;3599;13286;4442;16940
291070;201701;15751;44745;13773;41821;725;2723;10749;32365;11474;35088
291072;201701;22981;66921;18603;58220;4449;15035;6463;20541;10912;35576
291075;201701;4894;13735;4361;12929;296;775;3299;9883;3595;10658
291077;201701;1382;3958;1151;3559;68;244;806;2485;874;2729
291080;201701;75312;233232;67941;219312;23889;78444;12410;41153;36299;119597
291085;201701;5556;14577;4777;13523;300;960;3912;11078;4212;12038
291090;201701;1681;3766;1476;3528;37;99;1321;3145;1358;3244
291100;201701;2564;6464;2036;5861;117;469;1557;4372;1674;4841
291110;201701;5199;17651;4671;16852;540;2232;3375;11924;3915;14156
291120;201701;7099;18968;6521;18122;627;1820;4785;13313;5412;15133
291125;201701;1817;3635;1420;3209;59;178;1181;2643;1240;2821
291130;201701;2790;8721;2341;7892;106;502;1748;5755;1854;6257
291140;201701;4141;12201;3518;11020;434;1297;2207;7005;2641;8302
291150;201701;1996;4973;1825;4780;75;260;1510;3867;1585;4127
291160;201701;4898;15575;4364;14646;684;2562;2562;8429;3246;10991
291165;201701;2472;6876;1938;5895;51;221;1384;4111;1435;4332
291170;201701;20537;54291;17720;50095;1494;4652;11114;31550;12608;36202
291180;201701;5924;15557;4935;14000;348;1063;3604;10255;3952;11318
291185;201701;3488;9541;3110;8947;136;425;2546;7246;2682;7671
291190;201701;7219;19176;6303;17901;352;1318;5203;14522;5555;15840
291200;201701;2858;8451;2253;7289;115;410;1456;4750;1571;5160
291210;201701;6616;16020;5665;14904;227;820;4381;11406;4608;12226
291220;201701;4195;12768;3830;12184;478;1799;2588;8035;3066;9834
291230;201701;3906;9752;3519;9329;71;147;3335;8915;3406;9062
291240;201701;4420;11823;3886;10894;133;464;3218;8855;3351;9319
291250;201701;3355;10312;2713;9100;217;745;1815;6171;2032;6916
291260;201701;1042;2967;944;2843;51;239;795;2301;846;2540
291270;201701;4631;14445;4102;13473;982;3355;2243;7460;3225;10815
291280;201701;2112;6122;1726;5470;328;1161;886;2743;1214;3904
291290;201701;5502;15282;4735;14260;668;2068;3004;9296;3672;11364
291300;201701;4102;11711;3166;10087;159;591;2274;7167;2433;7758
291310;201701;5310;14946;4650;13772;267;905;3593;10575;3860;11480
291320;201701;5938;18270;4812;16103;1209;4018;2134;7424;3343;11442
291330;201701;1559;4654;1375;4335;87;338;975;3015;1062;3353
291340;201701;3788;10422;3167;9519;109;426;2596;7703;2705;8129
291345;201701;3277;10337;3055;10064;178;617;2516;8453;2694;9070
291350;201701;5600;16370;4923;15216;274;925;3793;11899;4067;12824
291360;201701;32353;86329;27977;80449;5993;17551;14616;43370;20609;60921
291370;201701;8099;22962;7634;22368;498;1673;5950;17413;6448;19086
291380;201701;3629;10764;3167;10041;166;651;2424;7701;2590;8352
291390;201701;10237;27012;9472;26110;818;2416;7445;20517;8263;22933
291400;201701;14142;38173;12367;35540;1994;5313;7911;23949;9905;29262
291410;201701;2998;8049;2339;6945;111;502;1721;4904;1832;5406
291420;201701;2000;5343;1709;4977;64;249;1430;4128;1494;4377
291430;201701;3219;9131;2827;8582;156;730;2263;6603;2419;7333
291440;201701;6248;18903;5472;17561;480;1659;4107;13244;4587;14903
291450;201701;8332;23599;7218;22130;287;830;5842;18663;6129;19493
291460;201701;13000;38824;11729;36888;1279;4516;7863;24847;9142;29363
291465;201701;7781;22097;6815;20976;390;1697;5546;16751;5936;18448
291470;201701;15290;40498;13511;38419;744;2198;10376;30261;11120;32459
291480;201701;34809;86040;28639;77823;3911;11721;15991;43739;19902;55460
291490;201701;4155;13144;3876;12756;564;1876;2600;8728;3164;10604
291500;201701;4194;11879;3556;10917;179;706;2848;8672;3027;9378
291510;201701;3684;10821;3342;10352;71;301;2872;8981;2943;9282
291520;201701;3722;10028;3196;9316;273;925;2200;6408;2473;7333
291530;201701;2068;5542;1649;4925;331;989;893;2882;1224;3871
291535;201701;3547;10850;3283;10425;216;737;2545;8146;2761;8883
291540;201701;1982;4791;1689;4486;95;194;1496;4051;1591;4245
291550;201701;5058;13126;4404;12228;663;1771;2728;7744;3391;9515
291560;201701;18057;42503;13007;36541;772;2330;9105;26755;9877;29085
291570;201701;2169;5603;1941;5332;164;337;1598;4574;1762;4911
291580;201701;5234;15691;4648;14869;412;1688;3367;10665;3779;12353
291590;201701;1722;5349;1557;5085;142;526;1177;3871;1319;4397
291600;201701;5104;13954;3895;12007;889;2922;1784;5382;2673;8304
291610;201701;4700;14704;4545;14532;134;493;4184;13459;4318;13952
291620;201701;3003;6951;2212;6104;114;379;1727;4844;1841;5223
291630;201701;3025;7320;2513;6711;181;495;1970;5341;2151;5836
291640;201701;15868;43260;12615;38233;3159;10031;3442;11267;6601;21298
291650;201701;8140;23496;7495;22706;513;1386;6259;19258;6772;20644
291660;201701;2189;5616;1679;4828;147;530;1056;2857;1203;3387
291670;201701;1838;5058;1659;4814;99;286;1326;3902;1425;4188
291680;201701;3754;10815;3271;10001;499;1687;2065;6271;2564;7958
291685;201701;4795;11972;3967;10893;507;1311;2666;7619;3173;8930
291690;201701;3657;9818;2914;8577;185;570;2011;5818;2196;6388
291700;201701;8896;27387;7959;25721;799;2599;5911;19334;6710;21933
291710;201701;5086;13150;4087;11826;265;851;2942;8454;3207;9305
291720;201701;4568;14486;3836;12974;264;1088;2748;9068;3012;10156
291730;201701;6092;17617;5535;16889;391;1362;4397;13508;4788;14870
291733;201701;2721;7639;2260;6999;198;678;1452;4597;1650;5275
291735;201701;2927;7974;2509;7382;109;401;2062;6010;2171;6411
291740;201701;3710;10423;3143;9657;173;630;2522;7726;2695;8356
291750;201701;20924;53878;16736;47414;3170;9300;8634;25184;11804;34484
291760;201701;10434;33042;9160;30860;3476;12892;2292;7939;5768;20831
291770;201701;7391;21189;6218;19094;711;2443;4055;12137;4766;14580
291780;201701;4387;13065;4087;12576;172;614;3479;10678;3651;11292
291790;201701;2654;7917;2526;7731;91;375;2135;6447;2226;6822
291800;201701;29591;79098;25904;74154;3522;10362;16766;49234;20288;59596
291810;201701;10543;27974;8940;26030;349;1261;7351;21290;7700;22551
291820;201701;3702;10803;3311;10219;197;695;2503;7768;2700;8463
291830;201701;4055;10710;3753;10275;280;795;2992;8272;3272;9067
291835;201701;6135;19171;5043;17129;1083;3818;2693;9377;3776;13195
291840;201701;46901;130999;41114;124282;5578;16851;28016;87836;33594;104687
291845;201701;2530;7333;2363;7106;119;329;2069;6320;2188;6649
291850;201701;4379;12643;3625;11422;340;998;2615;8551;2955;9549
291855;201701;1813;4307;1564;4003;107;380;1223;3017;1330;3397
291860;201701;2157;5975;1648;4983;52;206;1080;3146;1132;3352
291870;201701;1367;3652;966;2918;72;281;602;1728;674;2009
291875;201701;2784;8596;2497;8150;136;543;1785;5727;1921;6270
291880;201701;4917;15672;4523;14876;465;1573;3201;10532;3666;12105
291890;201701;1271;3178;1019;2863;196;437;642;1913;838;2350
291900;201701;1241;3281;969;2823;48;189;732;2083;780;2272
291905;201701;2613;7090;1967;5897;66;240;1421;4149;1487;4389
291910;201701;2727;7253;2321;6776;114;429;1943;5643;2057;6072
291915;201701;6847;20901;5768;18955;292;1143;4396;14526;4688;15669
291920;201701;24333;72155;22522;69593;2879;10127;14824;45315;17703;55442
291930;201701;2519;7429;2229;6952;175;685;1595;4816;1770;5501
291940;201701;3279;9162;2425;7685;260;878;1435;4440;1695;5318
291950;201701;8474;27802;7624;26173;1167;4092;4430;15687;5597;19779
291955;201701;11013;30833;10126;29724;2416;7041;5325;16654;7741;23695
291960;201701;3035;8867;2503;8056;191;632;1861;6213;2052;6845
291970;201701;3843;11664;3544;11152;322;1228;2422;7582;2744;8810
291980;201701;11400;32431;9002;29024;789;2679;6269;20531;7058;23210
291990;201701;2068;6211;1923;6032;76;286;1693;5349;1769;5635
291992;201701;2858;8549;2785;8432;373;1084;2114;6466;2487;7550
291995;201701;2066;5815;1744;5353;90;356;1400;4219;1490;4575
292000;201701;2325;6486;2110;6195;173;576;1491;4463;1664;5039
292010;201701;5943;14908;4959;13540;450;1191;3658;10190;4108;11381
292020;201701;3964;13415;3738;13038;460;1797;2777;9608;3237;11405
292030;201701;1775;5757;1658;5571;184;698;966;3130;1150;3828
292040;201701;4316;11449;3703;10788;162;353;3156;9622;3318;9975
292045;201701;3364;10211;3000;9716;130;393;2674;8721;2804;9114
292050;201701;6293;18911;5317;16971;487;1745;3330;10567;3817;12312
292060;201701;12516;30881;11518;29662;676;1785;9683;24688;10359;26473
292070;201701;4852;14557;4471;14112;390;1234;3636;11577;4026;12811
292080;201701;3396;8799;2775;8000;163;579;2350;6747;2513;7326
292090;201701;3959;10014;3318;9258;212;757;2693;7506;2905;8263
292100;201701;10384;28031;9069;26162;1860;5626;4590;13676;6450;19302
292105;201701;2975;9051;2691;8581;105;486;2171;6883;2276;7369
292110;201701;6268;16716;4886;14505;1280;3796;2181;6668;3461;10464
292120;201701;7050;19659;5861;17479;967;2858;3429;10413;4396;13271
292130;201701;2741;7635;2369;7101;402;1130;1434;4523;1836;5653
292140;201701;4690;12402;3913;11234;501;1373;2733;8008;3234;9381
292145;201701;2256;6953;2001;6521;240;761;1384;4641;1624;5402
292150;201701;12506;37503;11689;36239;428;1783;9831;30216;10259;31999
292160;201701;2255;6684;2067;6437;76;342;1843;5653;1919;5995
292170;201701;8468;24005;7091;21652;771;2584;4624;14101;5395;16685
292180;201701;2986;8485;2325;7365;472;1430;1159;3816;1631;5246
292190;201701;3138;8976;2660;8200;501;1654;1351;4236;1852;5890
292200;201701;6654;19861;5646;18146;1525;5097;2229;7408;3754;12505
292205;201701;3726;11196;3365;10659;158;733;2765;8553;2923;9286
292210;201701;6291;16251;5332;14991;199;732;4597;12816;4796;13548
292220;201701;1779;4863;1603;4596;262;714;972;2800;1234;3514
292225;201701;3154;9746;2874;9322;151;668;2351;7506;2502;8174
292230;201701;6736;18713;6349;18119;267;1140;5095;14061;5362;15201
292240;201701;4800;14410;4241;13287;347;1131;2898;9035;3245;10166
292250;201701;5003;15078;4679;14544;828;2673;2666;8413;3494;11086
292260;201701;3160;9064;2921;8746;166;497;2466;7462;2632;7959
292265;201701;3169;9437;2730;8703;107;498;2104;6532;2211;7030
292270;201701;3941;9970;3296;9214;146;493;2799;7858;2945;8351
292273;201701;2395;5729;2035;5278;120;245;1625;4365;1745;4610
292275;201701;1664;5210;1503;4981;111;313;1222;4234;1333;4547
292280;201701;2206;5995;1931;5671;118;311;1528;4701;1646;5012
292285;201701;2363;6372;1970;5799;100;342;1543;4517;1643;4859
292290;201701;6016;19091;5400;18137;370;1571;4166;13959;4536;15530
292300;201701;8144;24029;7042;22648;1795;6076;3737;12386;5532;18462
292303;201701;2816;8448;2544;8059;81;323;2190;6871;2271;7194
292305;201701;2781;7509;2618;7272;52;228;2359;6464;2411;6692
292310;201701;5936;17230;5498;16604;182;722;4505;13453;4687;14175
292320;201701;6723;18358;5654;16553;372;1202;4320;12508;4692;13710
292330;201701;2185;5700;2009;5464;119;397;1654;4415;1773;4812
292335;201701;4971;13071;4489;12424;287;764;3687;10327;3974;11091
292340;201701;6382;17471;5454;15989;309;954;4084;11945;4393;12899
292350;201701;2262;6552;1936;6091;103;415;1580;4970;1683;5385
292360;201701;5244;13393;4855;12774;252;652;3851;10392;4103;11044
292370;201701;8465;23284;7394;21872;492;1382;5973;17821;6465;19203
292380;201701;7040;20790;6469;19870;602;1759;4879;15168;5481;16927
292390;201701;3558;7827;2902;7117;129;278;2547;6322;2676;6600
292400;201701;20224;62102;18692;59610;2759;9033;12100;38865;14859;47898
292405;201701;4385;10883;3583;9818;190;501;2885;7953;3075;8454
292410;201701;1998;5258;1819;5052;119;355;1499;4179;1618;4534
292420;201701;3678;11811;3465;11485;236;1043;2773;9061;3009;10104
292430;201701;5408;15748;4072;13849;362;1383;2623;9001;2985;10384
292440;201701;8367;27510;7799;26688;179;810;7096;24433;7275;25243
292450;201701;3864;11583;3191;10412;283;995;2251;7394;2534;8389
292460;201701;4405;13302;3884;12413;371;1324;2750;8774;3121;10098
292465;201701;2295;6806;1919;6199;176;629;1261;4133;1437;4762
292467;201701;1786;5690;1711;5578;235;799;1207;4012;1442;4811
292470;201701;2847;7479;2350;6667;111;344;1832;5202;1943;5546
292480;201701;6289;16068;5287;14796;130;462;4677;12960;4807;13422
292490;201701;2352;6324;1930;5722;142;481;1450;4294;1592;4775
292500;201701;6340;18790;5496;17284;628;2107;3635;11532;4263;13639
292510;201701;12447;35626;10628;32872;757;2933;7762;23964;8519;26897
292520;201701;5520;15299;4821;14289;907;2766;2781;8418;3688;11184
292525;201701;5198;13530;4471;12695;140;490;3865;11008;4005;11498
292530;201701;26469;75264;23409;70996;5410;16893;11572;36333;16982;53226
292540;201701;2930;7679;2587;7277;255;797;2038;5732;2293;6529
292550;201701;6605;19953;5620;18666;533;2010;4230;14261;4763;16271
292560;201701;3961;11040;3511;10339;197;834;2716;7846;2913;8680
292570;201701;4173;11462;3753;10973;80;232;3470;10284;3550;10516
292575;201701;6286;20389;6066;20060;356;1221;5129;17096;5485;18317
292580;201701;6521;19298;6095;18696;259;977;5222;15921;5481;16898
292590;201701;7458;20987;6978;20313;304;1068;6000;17154;6304;18222
292593;201701;2873;7438;2459;6779;275;730;1777;4878;2052;5608
292595;201701;5694;15575;5060;14760;284;963;4051;11752;4335;12715
292600;201701;10659;30065;9511;28544;721;1946;7350;22557;8071;24503
292610;201701;4575;12522;3786;11248;238;714;2423;7463;2661;8177
292620;201701;6148;18222;5430;17403;108;356;5052;16373;5160;16729
292630;201701;8838;22484;7370;20183;525;1524;5223;14393;5748;15917
292640;201701;7553;24319;7018;23446;371;1557;5314;17780;5685;19337
292650;201701;4362;11883;4060;11484;275;849;3425;9619;3700;10468
292660;201701;10814;31873;9838;30459;833;2793;7559;23520;8392;26313
292665;201701;2208;6987;2069;6813;23;89;1883;6264;1906;6353
292670;201701;3532;9903;2785;8553;164;613;1836;5594;2000;6207
292680;201701;3681;10665;3262;9914;294;945;2371;7122;2665;8067
292690;201701;2707;7385;1985;6224;160;509;1329;4299;1489;4808
292700;201701;9444;27498;8228;25784;974;2994;5385;17669;6359;20663
292710;201701;2121;6980;1986;6801;70;272;1753;6037;1823;6309
292720;201701;9163;23030;7988;21741;289;964;6783;18671;7072;19635
292730;201701;3599;10636;3455;10433;163;570;2849;8546;3012;9116
292740;201701;326285;863341;305488;831780;53641;155151;183122;493133;236763;648284
292750;201701;6411;17259;5541;16023;238;824;4365;12653;4603;13477
292760;201701;3866;11908;3508;11262;354;1272;2470;7890;2824;9162
292770;201701;5842;16917;5114;15850;843;2768;3107;9952;3950;12720
292780;201701;1793;4112;1387;3599;75;255;1051;2666;1126;2921
292790;201701;3392;8030;3241;7871;44;74;3149;7709;3193;7783
292800;201701;9189;26527;8460;25332;509;1713;6702;19984;7211;21697
292805;201701;2910;8100;2554;7588;216;672;1915;5740;2131;6412
292810;201701;9338;27215;7543;24588;770;2640;5129;17064;5899;19704
292820;201701;7402;20772;5564;18101;311;1410;4277;13730;4588;15140
292830;201701;1612;4789;1476;4589;50;220;1269;3891;1319;4111
292840;201701;8061;23779;7691;23286;266;1109;6822;20269;7088;21378
292850;201701;3070;8136;2468;7216;246;827;1572;4478;1818;5305
292860;201701;15070;38161;13786;36526;750;2126;11119;29384;11869;31510
292870;201701;18359;49940;16126;46480;1515;5192;9835;27665;11350;32857
292880;201701;11784;33308;10608;31687;644;2560;7859;22673;8503;25233
292890;201701;5262;17303;4730;16359;545;2040;3226;11203;3771;13243
292895;201701;2744;6607;2099;5601;168;454;1487;3985;1655;4439
292900;201701;2684;8101;2548;7881;152;688;1969;5826;2121;6514
292905;201701;4039;11746;3232;10469;288;948;2127;7028;2415;7976
292910;201701;4883;14275;4423;13457;528;1687;2687;8214;3215;9901
292920;201701;9298;26762;8875;26187;443;1747;7468;21495;7911;23242
292925;201701;4975;14941;4564;14339;286;972;3643;11446;3929;12418
292930;201701;6418;20201;5975;19376;427;1894;4179;13204;4606;15098
292935;201701;1896;5689;1615;5372;65;287;1376;4681;1441;4968
292937;201701;2983;7714;2599;7243;116;347;2161;6043;2277;6390
292940;201701;3046;8411;2550;7716;182;596;1851;5708;2033;6304
292950;201701;8140;23300;7532;22302;403;1578;5745;16640;6148;18218
292960;201701;5122;12968;4418;12046;238;758;3364;9076;3602;9834
292970;201701;4177;12283;3688;11642;133;661;3029;9479;3162;10140
292975;201701;3606;9250;3344;8928;300;713;2812;7598;3112;8311
292980;201701;3065;8094;2469;7192;175;597;1852;5269;2027;5866
292990;201701;11527;32542;9956;30175;358;1356;8024;24188;8382;25544
293000;201701;2811;7110;2560;6806;40;138;1927;5441;1967;5579
293010;201701;17284;47473;14708;43366;1939;6131;9009;26436;10948;32567
293015;201701;7329;24766;6344;22808;695;2901;4187;15001;4882;17902
293020;201701;8689;28885;8338;28377;284;1337;7332;24770;7616;26107
293030;201701;5499;15601;4390;13845;211;732;3009;9879;3220;10611
293040;201701;3706;11851;3535;11579;180;629;3064;10023;3244;10652
293050;201701;20402;55658;18044;52643;2981;9141;9738;29748;12719;38889
293060;201701;3515;9438;2926;8468;230;773;2116;6054;2346;6827
293070;201701;23866;63154;19499;57081;4193;12432;8898;27736;13091;40168
293075;201701;3191;10801;2967;10437;160;780;2355;8284;2515;9064
293076;201701;3646;9884;3238;9337;138;395;2621;7707;2759;8102
293077;201701;4982;15147;4361;14291;735;2517;2686;9068;3421;11585
293080;201701;4486;14031;4054;13354;164;805;3317;10722;3481;11527
293090;201701;3096;9831;2587;9008;206;792;1840;6491;2046;7283
293100;201701;5737;16553;4733;14768;427;1381;3432;10797;3859;12178
293105;201701;3893;12677;3441;11824;420;1508;2301;8000;2721;9508
293110;201701;1990;5546;1726;5170;79;265;1360;4067;1439;4332
293120;201701;3679;11834;3502;11561;231;758;2883;9613;3114;10371
293130;201701;3653;10712;3333;10333;114;442;2928;9094;3042;9536
293135;201701;30700;76769;23370;66371;5149;16629;8624;24700;13773;41329
293140;201701;1951;5339;1849;5206;108;403;1502;4086;1610;4489
293150;201701;5334;17406;4562;15914;598;2193;2879;10183;3477;12376
293160;201701;3684;9354;3306;8909;392;754;2542;7339;2934;8093
293170;201701;3322;9595;3041;9167;221;782;2157;6512;2378;7294
293180;201701;5015;14072;4102;12561;190;813;3190;9500;3380;10313
293190;201701;13536;40024;12272;38101;536;2392;10230;31181;10766;33573
293200;201701;7246;19642;6358;18523;211;904;4864;14325;5075;15229
293210;201701;5081;14266;4468;13249;263;890;3368;9908;3631;10798
293220;201701;4949;14481;4154;13029;1061;3312;1517;5024;2578;8336
293230;201701;3601;10806;3193;10146;416;1507;2150;6792;2566;8299
293240;201701;4242;11745;3450;10384;127;396;2578;7811;2705;8207
293245;201701;4178;11623;3742;11021;176;596;3081;9007;3257;9603
293250;201701;5417;14694;4889;13890;456;1394;3504;9850;3960;11244
293260;201701;4401;12861;3740;11884;235;867;2650;8377;2885;9244
293270;201701;5459;14342;4874;13690;258;691;4246;12065;4504;12756
293280;201701;5213;14192;4419;13119;217;652;3427;10278;3644;10930
293290;201701;13832;45500;12835;43667;3163;10991;5663;20190;8826;31181
293300;201701;6617;15631;5624;14446;379;943;4198;10935;4577;11878
293305;201701;4767;11760;4015;10768;132;460;3329;8869;3461;9329
293310;201701;2328;6109;1891;5354;185;545;1271;3584;1456;4129
293315;201701;4161;10432;3530;9497;242;603;2781;7536;3023;8139
293317;201701;2352;6626;2121;6211;162;458;1519;4449;1681;4907
293320;201701;7403;24047;7162;23742;1167;3812;5084;17300;6251;21112
293325;201701;1694;4831;1414;4385;209;722;913;2791;1122;3513
293330;201701;47252;153195;42940;145426;9821;35218;19696;67526;29517;102744
293340;201701;2489;7184;2003;6343;250;847;1177;3736;1427;4583
293345;201701;3203;9425;2828;8949;241;613;2182;7264;2423;7877
293350;201701;6304;18703;5982;18327;148;318;5499;17325;5647;17643
293360;201701;12932;38335;11770;36905;648;2466;10273;32096;10921;34562
310010;201701;751;2076;636;1902;83;317;304;843;387;1160
310020;201701;2476;7771;2080;7040;550;2090;275;878;825;2968
310030;201701;2117;6570;1773;5991;352;1376;1012;3337;1364;4713
310040;201701;954;2541;785;2301;69;261;595;1679;664;1940
310050;201701;1749;5956;1632;5708;334;1332;736;2468;1070;3800
310060;201701;3254;9766;2826;9213;214;868;2231;7245;2445;8113
310070;201701;354;968;264;806;13;60;166;467;179;527
310080;201701;712;2094;584;1870;95;382;205;615;300;997
310090;201701;4588;13381;3925;12265;486;1693;2554;7955;3040;9648
310100;201701;3494;10349;2936;9469;145;563;2265;7310;2410;7873
310110;201701;4698;13169;3980;11935;626;2155;2092;6052;2718;8207
310120;201701;626;1850;467;1554;128;528;169;444;297;972
310130;201701;366;1110;319;1024;65;259;173;500;238;759
310140;201701;165;550;139;510;44;192;42;127;86;319
310150;201701;4490;13591;3824;12287;946;3318;1207;3767;2153;7085
310160;201701;6482;20570;5393;18446;1751;6472;701;2389;2452;8861
310163;201701;1052;3347;888;3016;320;1170;210;673;530;1843
310170;201701;8810;24376;7827;22997;866;2787;5576;16451;6442;19238
310180;201701;1706;4795;1433;4387;208;735;851;2520;1059;3255
310190;201701;2881;9355;2567;8808;678;2598;527;1813;1205;4411
310200;201701;1625;5293;1376;4758;291;1121;500;1708;791;2829
310205;201701;1109;3129;840;2724;120;375;461;1548;581;1923
310210;201701;2757;7674;2364;7115;138;471;1752;5214;1890;5685
310220;201701;1007;2995;875;2782;131;489;555;1697;686;2186
310230;201701;2413;7299;2023;6426;232;934;1204;3603;1436;4537
310240;201701;879;3179;804;3029;106;477;480;1778;586;2255
310250;201701;791;2570;753;2505;123;525;474;1466;597;1991
310260;201701;2929;9235;2187;7736;521;2104;349;1080;870;3184
310270;201701;2583;7084;2085;6382;153;616;1607;4815;1760;5431
310280;201701;2256;5790;1804;5106;153;621;1137;3049;1290;3670
310285;201701;1974;7017;1832;6784;199;853;1276;4838;1475;5691
310290;201701;1087;3245;1016;3128;244;873;540;1524;784;2397
310300;201701;1616;5385;1537;5243;357;1397;739;2389;1096;3786
310310;201701;303;834;219;678;37;109;117;377;154;486
310320;201701;396;1205;319;1066;34;156;160;502;194;658
310330;201701;517;1276;335;939;39;124;134;331;173;455
310340;201701;8008;23607;6597;21176;1440;4613;2939;9941;4379;14554
310350;201701;13318;34618;9348;28109;2447;8081;2226;6609;4673;14690
310360;201701;436;1231;393;1168;22;89;304;876;326;965
310370;201701;1334;4442;1191;4173;264;930;576;2052;840;2982
310375;201701;1192;3244;793;2542;121;426;270;876;391;1302
310380;201701;354;907;211;662;53;173;63;181;116;354
310390;201701;438;1516;384;1410;99;377;83;267;182;644
310400;201701;9483;25945;7129;22076;1698;5775;2079;6391;3777;12166
310410;201701;676;2210;486;1885;110;473;103;388;213;861
310420;201701;4344;12242;3052;9567;616;2136;461;1247;1077;3383
310430;201701;1246;3953;894;3224;225;880;139;478;364;1358
310440;201701;509;1493;390;1251;70;260;162;518;232;778
310445;201701;1203;3874;993;3478;65;284;686;2362;751;2646
310450;201701;4352;12044;3487;10752;320;1053;2433;7588;2753;8641
310460;201701;1479;4310;1215;3912;338;1197;327;1117;665;2314
310470;201701;3996;8928;3389;8204;201;496;2963;7226;3164;7722
310480;201701;1227;3524;920;2917;192;643;400;1206;592;1849
310490;201701;2867;9126;2462;8330;551;2179;988;3223;1539;5402
310500;201701;1262;4213;1110;3893;270;1022;433;1498;703;2520
310510;201701;1859;5836;1460;4963;378;1398;245;839;623;2237
310520;201701;1401;3564;1057;3034;67;201;734;2091;801;2292
310530;201701;916;2695;480;1624;76;292;54;153;130;445
310540;201701;2965;9368;2639;8792;676;2413;1119;3624;1795;6037
310550;201701;1118;3119;905;2777;144;554;555;1615;699;2169
310560;201701;14023;42290;11890;38240;3064;11000;3710;11201;6774;22201
310570;201701;1153;3381;976;3077;138;565;650;1952;788;2517
310590;201701;4141;11999;3475;10803;513;1750;1765;5411;2278;7161
310600;201701;1391;4496;1198;4072;227;872;521;1665;748;2537
310610;201701;389;1308;341;1205;91;398;113;339;204;737
310620;201701;138540;417526;118393;379176;28310;101835;41611;121908;69921;223743
310630;201701;4174;12341;3740;11602;291;1028;2805;8629;3096;9657
310640;201701;1218;3721;997;3334;281;1063;265;836;546;1899
310650;201701;2648;8151;2061;7119;297;1100;1139;3943;1436;5043
310660;201701;1304;3927;1156;3733;104;361;867;2786;971;3147
310665;201701;1281;3769;1148;3581;68;232;940;3008;1008;3240
310670;201701;38908;117706;34546;108787;8323;27974;13457;41301;21780;69275
310680;201701;661;1831;588;1728;70;240;412;1190;482;1430
310690;201701;1273;4069;1057;3705;197;857;463;1534;660;2391
310700;201701;513;1261;401;1118;62;206;243;653;305;859
310710;201701;5908;19056;4540;16858;1083;4697;442;1496;1525;6193
310720;201701;797;2319;720;2207;56;204;533;1629;589;1833
310730;201701;8949;27455;8006;25859;1262;4546;4618;14747;5880;19293
310740;201701;4813;15093;3740;12867;847;3120;789;2625;1636;5745
310750;201701;1445;3592;1066;3083;206;651;434;1158;640;1809
310760;201701;556;1663;455;1487;71;250;188;627;259;877
310770;201701;938;2904;712;2532;118;481;337;1148;455;1629
310780;201701;3801;10228;3160;9162;383;1162;2071;5964;2454;7126
310790;201701;1897;6071;1735;5782;378;1279;803;2806;1181;4085
310800;201701;2548;8071;1957;6889;574;2350;141;463;715;2813
310810;201701;1082;3029;950;2785;136;473;542;1496;678;1969
310820;201701;1266;3621;898;2908;213;768;221;694;434;1462
310825;201701;2777;9693;2248;8784;135;753;1662;6474;1797;7227
310830;201701;1336;4262;1093;3814;290;1090;364;1251;654;2341
310840;201701;2128;6260;1534;5162;307;1084;398;1263;705;2347
310850;201701;1507;4386;1299;4128;122;503;956;2983;1078;3486
310855;201701;2814;8716;2434;8146;352;1307;1628;5430;1980;6737
310860;201701;7045;21541;5903;19404;624;2273;3613;11967;4237;14240
310870;201701;1074;2820;826;2420;125;396;510;1494;635;1890
310880;201701;984;3071;818;2748;121;470;450;1505;571;1975
310890;201701;2457;7295;1895;6356;496;1888;386;1147;882;3035
310900;201701;4066;12640;3200;10900;728;2806;1147;3629;1875;6435
310910;201701;1887;5280;1224;4012;198;745;150;400;348;1145
310920;201701;1818;5249;1431;4626;295;1060;667;2137;962;3197
310925;201701;927;2965;821;2778;242;897;391;1272;633;2169
310930;201701;5961;16574;4771;14809;633;2117;2884;9219;3517;11336
310940;201701;5915;16333;4982;14944;636;2141;3113;9198;3749;11339
310945;201701;1093;3217;986;3047;136;492;598;1782;734;2274
310950;201701;2067;6369;1497;5168;341;1402;516;1686;857;3088
310960;201701;380;1211;313;1080;80;299;133;474;213;773
310970;201701;1168;3801;892;3210;221;867;156;501;377;1368
310980;201701;369;889;232;662;34;121;123;319;157;440
310990;201701;1126;3582;918;3117;194;732;324;1033;518;1765
311000;201701;3406;11333;3109;10769;957;3658;1057;3473;2014;7131
311010;201701;704;2342;656;2231;215;773;276;953;491;1726
311020;201701;921;2696;734;2359;116;441;360;1096;476;1537
311030;201701;1627;4364;1131;3479;301;1070;351;974;652;2044
311040;201701;435;1440;362;1264;91;325;72;234;163;559
311050;201701;2234;6730;1927;6243;443;1604;845;2742;1288;4346
311060;201701;2429;7053;1795;5727;302;1126;611;1797;913;2923
311070;201701;1349;4533;1163;4180;238;992;493;1727;731;2719
311080;201701;791;2432;670;2198;148;554;239;726;387;1280
311090;201701;1778;6286;1508;5806;437;1913;511;1859;948;3772
311100;201701;1916;6415;1510;5540;491;1963;197;718;688;2681
311110;201701;3279;7869;2373;6606;390;1161;1155;3264;1545;4425
311115;201701;1189;3470;1004;3189;99;401;695;2161;794;2562
311120;201701;7240;20250;5565;17282;1151;3992;1658;4759;2809;8751
311130;201701;1988;6040;1643;5501;283;1172;693;2195;976;3367
311140;201701;1311;3397;990;2952;72;246;628;1898;700;2144
311150;201701;1547;5435;1418;5203;240;948;841;3108;1081;4056
311160;201701;3739;12407;3046;11151;1098;4390;698;2555;1796;6945
311170;201701;772;2301;618;2022;67;249;319;1078;386;1327
311180;201701;996;2910;786;2518;237;818;216;675;453;1493
311190;201701;1068;3033;833;2597;164;592;222;655;386;1247
311200;201701;1779;5388;1405;4622;403;1454;229;689;632;2143
311205;201701;968;3188;838;2924;120;515;400;1389;520;1904
311210;201701;993;3084;902;2966;120;383;661;2238;781;2621
311220;201701;792;2482;660;2197;145;542;250;799;395;1341
311230;201701;8168;25821;6384;22097;1285;4794;2083;7493;3368;12287
311240;201701;944;2851;750;2548;190;715;283;937;473;1652
311250;201701;752;2406;663;2251;200;748;220;677;420;1425
311260;201701;2078;5576;1619;4825;348;1157;588;1721;936;2878
311265;201701;1188;3306;942;2893;151;518;538;1644;689;2162
311270;201701;3276;10322;2895;9799;278;1333;2064;6687;2342;8020
311280;201701;1122;3159;696;2234;141;530;164;511;305;1041
311290;201701;1954;6397;1827;6097;297;1002;1124;3789;1421;4791
311300;201701;4269;13867;3811;13054;331;1538;2818;9434;3149;10972
311310;201701;590;1922;507;1760;106;366;136;427;242;793
311320;201701;3395;11243;3092;10574;551;2177;1213;3882;1764;6059
311330;201701;4228;12652;3687;11694;871;2999;1624;5160;2495;8159
311340;201701;11142;34515;9607;31599;2972;10496;2442;7969;5414;18465
311350;201701;2241;6190;1719;5201;240;877;795;2174;1035;3051
311360;201701;901;2676;784;2517;375;1233;117;425;492;1658
311370;201701;3661;10922;3070;9873;657;2548;1210;3504;1867;6052
311380;201701;414;1374;346;1233;104;393;108;390;212;783
311390;201701;1722;6102;1539;5835;683;2954;407;1388;1090;4342
311400;201701;1414;4339;1123;3769;202;793;456;1382;658;2175
311410;201701;1681;5758;1541;5581;392;1602;773;2801;1165;4403
311420;201701;1795;5798;1242;4473;229;895;111;302;340;1197
311430;201701;3502;10459;2483;8276;529;1932;388;1284;917;3216
311440;201701;2339;7506;1750;6389;574;2405;306;1118;880;3523
311450;201701;1819;6308;1523;5655;419;1712;286;982;705;2694
311455;201701;962;2589;749;2226;202;633;275;753;477;1386
311460;201701;586;1880;432;1577;84;367;105;363;189;730
311470;201701;456;1518;366;1329;104;422;62;202;166;624
311480;201701;789;2047;728;1959;142;374;470;1270;612;1644
311490;201701;208;759;186;696;56;233;61;200;117;433
311500;201701;425;1232;343;1092;67;254;161;509;228;763
311510;201701;2703;8205;2087;7110;639;2546;459;1582;1098;4128
311520;201701;582;1874;545;1798;167;603;230;726;397;1329
311530;201701;10322;26463;7531;22044;1903;6538;1835;5156;3738;11694
311535;201701;754;2165;493;1664;107;438;91;284;198;722
311540;201701;594;2025;552;1955;134;496;283;983;417;1479
311545;201701;2108;6270;1869;5985;161;637;1370;4309;1531;4946
311547;201701;1437;4013;1216;3670;70;229;844;2534;914;2763
311550;201701;2825;8742;2330;7777;362;1455;891;2867;1253;4322
311560;201701;262;683;221;629;31;101;127;330;158;431
311570;201701;1911;4931;1498;4375;67;198;1185;3590;1252;3788
311580;201701;2396;4708;1742;3964;318;654;1047;2570;1365;3224
311590;201701;481;1456;406;1343;92;362;187;609;279;971
311600;201701;1234;3645;1030;3373;173;578;651;2185;824;2763
311610;201701;2722;9483;2443;8967;731;2616;1002;3873;1733;6489
311615;201701;3119;9551;2584;8705;252;1021;1805;6012;2057;7033
311620;201701;411;1227;361;1145;48;181;234;735;282;916
311630;201701;1306;3794;1081;3401;142;478;712;2194;854;2672
311640;201701;763;2423;622;2191;121;462;282;1010;403;1472
311650;201701;2161;6041;1852;5570;220;758;1133;3397;1353;4155
311660;201701;2660;8412;2054;7168;408;1520;301;928;709;2448
311670;201701;1556;4401;1272;3957;376;1296;379;1159;755;2455
311680;201701;2016;6317;1700;5750;323;1153;948;3232;1271;4385
311690;201701;514;1284;440;1191;26;71;369;1019;395;1090
311700;201701;2279;5829;1783;5186;95;328;1375;3935;1470;4263
311710;201701;1573;4840;1162;4022;377;1455;310;1082;687;2537
311720;201701;386;1283;349;1215;47;191;161;540;208;731
311730;201701;5807;14368;3342;10217;1012;3547;530;1310;1542;4857
311740;201701;780;2376;750;2337;112;341;595;1878;707;2219
311750;201701;3992;12723;3413;11756;574;2259;1845;6186;2419;8445
311760;201701;651;2142;567;1944;124;472;142;391;266;863
311770;201701;2060;6580;1734;5953;422;1617;534;1756;956;3373
311780;201701;1204;4099;990;3619;250;1039;225;741;475;1780
311783;201701;2004;6327;1674;5689;67;322;1263;4219;1330;4541
311787;201701;592;1996;442;1581;83;342;131;401;214;743
311790;201701;1541;4499;1177;3833;265;1000;389;1234;654;2234
311800;201701;4869;16109;4187;14481;806;3105;492;1579;1298;4684
311810;201701;1023;3332;892;3079;79;346;538;1827;617;2173
311820;201701;560;1713;470;1502;100;376;265;765;365;1141
311830;201701;7894;25610;6299;21872;1857;7077;660;2183;2517;9260
311840;201701;2737;8237;2505;7883;542;1927;1439;4456;1981;6383
311850;201701;276;853;244;797;37;126;137;444;174;570
311860;201701;48118;138833;41091;126824;7081;24149;22135;66712;29216;90861
311870;201701;2092;6074;1533;4980;288;1070;472;1392;760;2462
311880;201701;6598;18532;5801;17488;625;1885;4179;12927;4804;14812
311890;201701;1381;4047;1134;3593;253;857;512;1587;765;2444
311900;201701;672;2031;574;1861;82;306;333;1071;415;1377
311910;201701;3944;11483;3294;10534;706;2418;1526;4868;2232;7286
311920;201701;1863;6003;1613;5549;177;719;987;3369;1164;4088
311930;201701;3267;9084;2713;8203;1090;3470;703;2057;1793;5527
311940;201701;12386;36553;9960;31701;2030;7052;3055;9260;5085;16312
311950;201701;2167;6316;1745;5652;148;598;1226;3891;1374;4489
311960;201701;372;1141;337;1068;66;264;158;424;224;688
311970;201701;368;1232;271;1007;57;249;66;225;123;474
311980;201701;542;1549;359;1202;61;230;118;404;179;634
311990;201701;440;1226;349;1090;113;395;131;391;244;786
311995;201701;1141;3471;690;2385;41;171;50;121;91;292
312000;201701;593;1761;532;1668;56;190;348;1113;404;1303
312010;201701;857;2786;704;2444;98;379;297;986;395;1365
312015;201701;1329;4241;1202;4010;142;553;791;2590;933;3143
312020;201701;1060;3381;945;3179;194;701;443;1472;637;2173
312030;201701;1785;5055;1595;4822;80;344;1387;4110;1467;4454
312040;201701;718;2560;594;2240;137;580;136;489;273;1069
312050;201701;1147;4050;995;3691;281;1173;176;579;457;1752
312060;201701;711;2196;638;2071;132;467;340;1079;472;1546
312070;201701;978;2962;654;2269;133;515;247;835;380;1350
312080;201701;2628;7076;2064;6228;268;1005;1192;3354;1460;4359
312083;201701;904;2478;768;2287;65;217;592;1750;657;1967
312087;201701;2095;6234;1900;5954;162;538;1462;4673;1624;5211
312090;201701;8459;25624;7077;23233;1866;6472;2738;8935;4604;15407
312100;201701;1422;4538;1119;4051;186;790;473;1654;659;2444
312110;201701;966;3367;845;3107;260;1070;169;555;429;1625
312120;201701;648;2081;543;1877;130;535;205;630;335;1165
312125;201701;1077;3428;965;3236;218;697;562;1993;780;2690
312130;201701;830;2340;650;1985;86;296;242;696;328;992
312140;201701;787;2495;675;2233;176;629;198;590;374;1219
312150;201701;435;1289;398;1216;21;93;252;715;273;808
312160;201701;7216;23750;6379;22011;1465;5618;2505;8316;3970;13934
312170;201701;865;2474;717;2232;61;231;459;1386;520;1617
312180;201701;1333;4066;1159;3729;198;746;512;1546;710;2292
312190;201701;580;1843;441;1557;145;569;71;258;216;827
312200;201701;4686;13292;3940;12111;698;2176;2283;7092;2981;9268
312210;201701;1078;2811;816;2427;151;530;470;1319;621;1849
312220;201701;1894;6373;1751;6213;122;310;1510;5609;1632;5919
312230;201701;10882;33112;8369;28292;2757;10282;1055;3406;3812;13688
312235;201701;1539;4565;1363;4313;156;569;981;3077;1137;3646
312240;201701;858;2863;685;2495;168;677;175;632;343;1309
312245;201701;2134;6272;1928;6015;87;334;1568;4885;1655;5219
312247;201701;762;2232;589;1943;157;543;240;827;397;1370
312250;201701;1117;3054;821;2541;144;539;324;941;468;1480
312260;201701;878;2755;730;2510;117;454;433;1435;550;1889
312270;201701;642;1893;527;1661;49;209;266;765;315;974
312280;201701;396;1299;352;1203;135;482;46;153;181;635
312290;201701;751;2482;686;2373;157;623;221;755;378;1378
312300;201701;801;2632;640;2246;163;633;54;135;217;768
312310;201701;774;2851;729;2749;179;763;322;1180;501;1943
312320;201701;1897;5355;1497;4632;450;1544;304;857;754;2401
312330;201701;974;2820;798;2572;120;456;572;1809;692;2265
312340;201701;291;791;238;706;35;126;129;350;164;476
312350;201701;273;679;241;644;21;79;200;509;221;588
312352;201701;1571;4883;1411;4649;217;747;956;3252;1173;3999
312360;201701;2851;9058;2408;8144;554;2041;725;2439;1279;4480
312370;201701;1647;5051;1453;4722;404;1477;582;1789;986;3266
312380;201701;1860;5042;1667;4781;64;191;1411;4147;1475;4338
312385;201701;1288;3696;1104;3411;82;335;797;2392;879;2727
312390;201701;2050;6467;1628;5652;404;1497;362;1189;766;2686
312400;201701;2944;9333;2443;8335;936;3290;547;1947;1483;5237
312410;201701;9704;31151;8653;29167;1811;6580;3894;12961;5705;19541
312420;201701;3760;11469;3558;11162;518;1683;2362;7525;2880;9208
312430;201701;7945;22881;6769;20833;875;2879;4267;13143;5142;16022
312440;201701;768;2406;641;2181;203;770;232;813;435;1583
312450;201701;1149;3731;899;3231;266;1007;302;1134;568;2141
312460;201701;335;999;293;946;52;194;168;534;220;728
312470;201701;591;1597;388;1218;76;279;120;348;196;627
312480;201701;1092;2826;822;2525;152;574;473;1373;625;1947
312490;201701;1880;4908;1479;4311;189;631;860;2424;1049;3055
312500;201701;665;1951;575;1807;104;380;230;702;334;1082
312510;201701;3550;10267;2880;8908;414;1462;1440;4234;1854;5696
312520;201701;225;709;180;637;65;239;62;223;127;462
312530;201701;560;1621;490;1524;48;188;341;1050;389;1238
312540;201701;1359;4266;1038;3618;204;773;473;1653;677;2426
312550;201701;688;2034;597;1844;103;347;296;856;399;1203
312560;201701;2075;5363;1704;4888;90;353;1384;3910;1474;4263
312570;201701;2157;6325;1797;5736;524;1754;642;2076;1166;3830
312580;201701;501;1622;421;1444;58;233;169;572;227;805
312590;201701;1616;5220;1406;4778;230;987;662;2098;892;3085
312595;201701;1779;6002;1646;5698;318;1136;924;3218;1242;4354
312600;201701;761;2409;577;2061;116;528;269;898;385;1426
312610;201701;6335;17608;4656;14568;1121;3792;901;2711;2022;6503
312620;201701;2155;6171;1665;5471;102;391;1237;4172;1339;4563
312630;201701;294;940;248;850;57;229;87;295;144;524
312640;201701;515;1637;423;1447;85;312;128;406;213;718
312650;201701;2095;5969;1538;4875;154;573;877;2688;1031;3261
312660;201701;1356;3562;1093;3179;105;371;753;2142;858;2513
312670;201701;5273;15532;4451;14419;1271;4589;1597;5120;2868;9709
312675;201701;1248;3932;1065;3551;109;434;728;2397;837;2831
312680;201701;1390;4192;1198;3928;153;626;787;2515;940;3141
312690;201701;2098;5501;1710;4954;249;813;1110;3121;1359;3934
312695;201701;808;2792;765;2723;120;422;524;1920;644;2342
312700;201701;1700;5162;1368;4495;174;631;741;2397;915;3028
312705;201701;1251;3522;1026;3124;64;241;707;2089;771;2330
312707;201701;1423;4577;1118;3966;142;628;590;1999;732;2627
312710;201701;6288;15668;4096;12239;1222;4073;771;2325;1993;6398
312720;201701;756;2512;648;2282;116;472;274;895;390;1367
312730;201701;1807;4355;1285;3717;140;492;806;2309;946;2801
312733;201701;1535;4103;1180;3475;58;189;718;2069;776;2258
312735;201701;781;2100;685;1960;126;447;418;1100;544;1547
312737;201701;797;2000;572;1673;148;439;214;631;362;1070
312738;201701;477;1478;344;1211;88;366;111;357;199;723
312740;201701;302;760;190;628;66;234;47;139;113;373
312750;201701;1199;4179;1116;4049;201;871;579;2031;780;2902
312760;201701;1786;5694;1376;4845;318;1180;378;1324;696;2504
312770;201701;40302;108178;29822;90540;7410;24323;8318;24646;15728;48969
312780;201701;2611;8847;2331;8362;382;1556;1317;4754;1699;6310
312790;201701;315;793;186;579;25;90;67;178;92;268
312800;201701;4770;15292;3847;13414;1153;4379;828;2928;1981;7307
312810;201701;1980;6025;1382;4804;363;1380;276;874;639;2254
312820;201701;1895;5320;1618;4851;83;308;1114;3238;1197;3546
312825;201701;1286;3433;1126;3225;79;249;875;2514;954;2763
312830;201701;2506;7623;1759;6149;445;1681;312;1073;757;2754
312840;201701;1198;3781;969;3336;145;591;324;1006;469;1597
312850;201701;674;2078;537;1812;99;404;166;537;265;941
312860;201701;1192;3457;894;2926;224;816;267;822;491;1638
312870;201701;5490;16797;3917;13507;701;2662;868;2867;1569;5529
312880;201701;1267;3681;1129;3481;99;343;729;2322;828;2665
312890;201701;1730;5181;1079;3714;192;724;388;1351;580;2075
312900;201701;1196;3450;1025;3207;94;317;722;2306;816;2623
312910;201701;1608;3165;940;2301;155;420;426;973;581;1393
312920;201701;824;2617;688;2351;160;641;279;886;439;1527
312930;201701;2073;5888;1774;5434;392;1231;815;2494;1207;3725
312940;201701;846;2734;745;2562;187;727;222;726;409;1453
312950;201701;2826;7911;2162;6922;781;2712;436;1422;1217;4134
312960;201701;1878;5328;1636;4993;118;349;1283;3995;1401;4344
312965;201701;1771;5532;1512;5050;129;524;949;3131;1078;3655
312970;201701;923;3049;747;2746;202;820;210;763;412;1583
312980;201701;17115;56021;15945;53593;4158;15215;6408;20702;10566;35917
312990;201701;450;1304;308;1053;84;335;105;351;189;686
313000;201701;470;1539;389;1381;85;405;144;442;229;847
313005;201701;2563;8054;2297;7571;348;1159;1443;4800;1791;5959
313010;201701;3584;11351;3047;10400;786;2938;1392;4622;2178;7560
313020;201701;894;2954;658;2376;129;532;82;253;211;785
313030;201701;1389;3669;1020;3142;190;686;465;1419;655;2105
313040;201701;726;2379;646;2197;80;340;323;1032;403;1372
313050;201701;1744;5385;1286;4656;316;1280;331;1100;647;2380
313055;201701;1545;4804;1428;4634;57;228;1218;3951;1275;4179
313060;201701;750;2378;595;2023;173;612;75;238;248;850
313065;201701;1843;5923;1583;5504;239;928;1069;3743;1308;4671
313070;201701;959;2769;792;2482;154;545;353;1082;507;1627
313080;201701;429;1303;322;1078;75;309;101;280;176;589
313090;201701;5080;14573;4393;13477;1195;4006;2064;6298;3259;10304
313100;201701;1087;3253;985;3094;71;222;782;2489;853;2711
313110;201701;1648;4673;1226;3844;171;628;533;1558;704;2186
313115;201701;2272;7485;2134;7199;442;1694;1016;3214;1458;4908
313120;201701;3377;8908;2907;8305;602;1935;1679;4747;2281;6682
313130;201701;24898;73924;21319;66887;4166;14515;9092;27085;13258;41600
313140;201701;497;1296;389;1129;23;81;287;808;310;889
313150;201701;1295;4057;1069;3639;426;1542;231;802;657;2344
313160;201701;888;2691;756;2431;157;583;366;1113;523;1696
313170;201701;9638;31718;7268;26063;1543;5954;1955;6692;3498;12646
313180;201701;2206;5977;1749;5335;368;1255;755;2197;1123;3452
313190;201701;3738;12306;2982;10495;650;2481;766;2550;1416;5031
313200;201701;1111;3532;977;3278;87;355;712;2338;799;2693
313210;201701;3968;12182;3348;11211;666;2444;1639;5292;2305;7736
313220;201701;1533;4498;1100;3633;246;916;252;703;498;1619
313230;201701;2218;7696;2077;7509;254;1031;1493;5336;1747;6367
313240;201701;7994;23768;6163;20395;1187;4474;2433;7687;3620;12161
313250;201701;6288;19835;5373;18193;536;2069;3001;10115;3537;12184
313260;201701;615;1806;428;1400;76;296;112;356;188;652
313270;201701;5229;15570;4362;14042;735;2557;2362;7558;3097;10115
313280;201701;361;1173;263;967;57;225;67;235;124;460
313290;201701;765;2719;645;2513;233;1020;100;363;333;1383
313300;201701;1709;5554;1418;4910;422;1607;177;533;599;2140
313310;201701;925;3159;824;2950;188;776;158;483;346;1259
313320;201701;2260;6390;1664;5450;344;1256;672;2181;1016;3437
313330;201701;3948;11928;3294;10804;344;1478;2036;6415;2380;7893
313340;201701;1634;4042;1273;3507;216;606;720;2016;936;2622
313350;201701;2417;7522;1931;6450;436;1598;437;1361;873;2959
313360;201701;1255;3539;944;3027;193;764;495;1473;688;2237
313370;201701;1133;3772;1062;3589;155;608;557;1794;712;2402
313375;201701;2071;5497;1486;4618;269;1003;487;1435;756;2438
313380;201701;4542;13854;3854;12488;1005;3571;1310;3982;2315;7553
313390;201701;855;2896;800;2803;73;316;557;1911;630;2227
313400;201701;3601;9685;3118;9118;312;881;2533;7542;2845;8423
313410;201701;1133;3210;951;2927;186;642;564;1693;750;2335
313420;201701;16307;39238;10198;29116;2117;6845;1529;4401;3646;11246
313430;201701;956;2995;728;2521;134;551;258;813;392;1364
313440;201701;6096;13723;4193;11484;202;585;2737;7644;2939;8229
313450;201701;577;1716;453;1463;86;306;153;461;239;767
313460;201701;2015;6747;1754;6298;485;2000;673;2214;1158;4214
313470;201701;3001;8169;2641;7636;369;1104;1749;5019;2118;6123
313480;201701;783;2290;623;2003;90;331;229;684;319;1015
313490;201701;1471;4134;823;3111;272;1167;66;238;338;1405
313500;201701;402;1319;322;1109;55;206;98;329;153;535
313505;201701;8793;25452;8192;24776;199;437;7691;23618;7890;24055
313507;201701;1339;3638;1148;3360;105;358;772;2262;877;2620
313510;201701;14294;41428;12574;38538;1721;5741;6774;20487;8495;26228
313520;201701;13835;42275;11588;38307;1274;4834;7401;24285;8675;29119
313530;201701;548;1628;457;1468;46;177;157;462;203;639
313535;201701;2480;7202;2233;6756;181;599;1598;4778;1779;5377
313540;201701;949;2950;711;2326;192;681;189;588;381;1269
313545;201701;1216;4423;1092;4189;166;744;643;2350;809;3094
313550;201701;1770;5595;1558;5193;329;1149;793;2613;1122;3762
313560;201701;2155;4887;1750;4440;162;390;1341;3470;1503;3860
313570;201701;845;2893;729;2671;201;815;277;989;478;1804
313580;201701;5570;15890;4400;14154;777;2759;2281;7483;3058;10242
313590;201701;912;2626;721;2355;333;1179;135;422;468;1601
313600;201701;3682;10980;3239;10267;302;1101;2378;7507;2680;8608
313610;201701;933;2695;801;2444;182;587;447;1356;629;1943
313620;201701;5073;15303;4409;14127;1103;3760;1689;5408;2792;9168
313630;201701;7726;21263;5818;18622;821;2950;3088;10430;3909;13380
313640;201701;755;2196;557;1886;170;618;161;561;331;1179
313650;201701;1773;5859;1587;5543;217;915;1017;3485;1234;4400
313652;201701;887;3080;818;2954;126;537;488;1685;614;2222
313655;201701;901;2841;762;2623;108;426;436;1503;544;1929
313657;201701;1333;3857;1086;3493;101;432;783;2364;884;2796
313660;201701;798;2610;704;2420;141;584;345;1105;486;1689
313665;201701;3710;11746;3178;10637;619;2315;1552;5032;2171;7347
313670;201701;43008;124098;31709;102327;7085;25170;10032;31508;17117;56678
313680;201701;1037;3021;911;2817;113;449;564;1685;677;2134
313690;201701;826;2944;718;2711;153;605;281;1089;434;1694
313695;201701;1313;4234;1140;3890;107;458;797;2713;904;3171
313700;201701;3417;11600;2981;11053;394;1520;2219;8400;2613;9920
313710;201701;1258;3368;965;2904;159;527;514;1541;673;2068
313720;201701;5258;16310;4116;13916;802;3026;1396;4360;2198;7386
313730;201701;1269;3307;966;2906;115;406;554;1651;669;2057
313740;201701;1812;6565;1546;5885;450;1894;96;333;546;2227
313750;201701;1977;5966;1645;5293;460;1621;473;1377;933;2998
313753;201701;1791;5051;1402;4376;223;796;691;2128;914;2924
313760;201701;4085;12894;3360;11457;936;3482;987;3182;1923;6664
313770;201701;3223;10107;2759;9463;716;2596;1341;4646;2057;7242
313780;201701;3956;10847;3046;9417;441;1574;1024;3156;1465;4730
313790;201701;443;1508;419;1467;64;228;268;949;332;1177
313800;201701;1148;3046;993;2807;93;305;707;2041;800;2346
313810;201701;1523;4331;1341;4066;145;466;949;2922;1094;3388
313820;201701;11915;31878;9593;28120;1642;5607;4012;11024;5654;16631
313830;201701;370;1195;327;1120;81;309;136;463;217;772
313835;201701;858;2830;789;2719;120;517;435;1412;555;1929
313840;201701;7115;20318;5604;17777;1390;4860;1268;3972;2658;8832
313850;201701;1071;2883;938;2647;169;584;498;1278;667;1862
313860;201701;2712;8115;2063;6736;428;1493;607;1893;1035;3386
313862;201701;1229;3086;889;2537;100;287;523;1574;623;1861
313865;201701;2225;6708;1998;6367;138;537;1511;4749;1649;5286
313867;201701;1096;3719;960;3435;300;1098;327;1197;627;2295
313868;201701;1636;5371;1393;4879;111;512;974;3312;1085;3824
313870;201701;732;2289;655;2160;162;620;209;605;371;1225
313880;201701;1265;3905;1065;3552;245;909;371;1084;616;1993
313890;201701;1827;4859;1495;4417;261;779;860;2734;1121;3513
313900;201701;3733;13249;3328;12348;1044;4252;851;3151;1895;7403
313910;201701;671;2223;549;1976;190;734;78;280;268;1014
313920;201701;3130;10386;2728;9650;534;1967;1478;5415;2012;7382
313925;201701;1762;4803;1384;4087;171;489;822;2462;993;2951
313930;201701;6446;23154;5464;21431;705;2617;3436;14533;4141;17150
313940;201701;8380;27040;6700;24275;1784;7217;1952;7571;3736;14788
313950;201701;3978;11043;3005;9476;903;3318;1015;2992;1918;6310
313960;201701;5291;13591;3774;11363;947;3174;1120;3225;2067;6399
313970;201701;1343;3996;1214;3829;136;488;705;2322;841;2810
313980;201701;1198;3707;924;3223;199;789;363;1229;562;2018
313990;201701;1574;5846;1377;5345;482;2032;286;993;768;3025
314000;201701;8063;25000;7230;23346;1015;3942;4286;13277;5301;17219
314010;201701;1155;3161;957;2891;75;277;661;1958;736;2235
314015;201701;1507;4838;1247;4392;250;1025;576;1965;826;2990
314020;201701;493;1464;324;1090;56;217;72;238;128;455
314030;201701;767;2491;615;2136;98;362;249;851;347;1213
314040;201701;732;2121;615;1899;156;518;231;713;387;1231
314050;201701;1543;4728;1227;4091;241;934;510;1584;751;2518
314053;201701;1550;4824;1359;4558;192;663;877;3103;1069;3766
314055;201701;2103;6243;1839;5856;75;312;1487;4759;1562;5071
314060;201701;1163;3521;925;3105;58;264;611;1998;669;2262
314070;201701;4034;12457;3245;10936;868;3120;852;2739;1720;5859
314080;201701;1734;5395;1245;4295;204;777;262;792;466;1569
314085;201701;1928;6420;1685;6059;463;1803;622;2259;1085;4062
314090;201701;3079;10609;2700;9852;591;2415;969;3705;1560;6120
314100;201701;3264;8140;2908;7683;140;296;2492;6876;2632;7172
314110;201701;3740;11803;3317;10928;648;2367;1424;4339;2072;6706
314120;201701;1001;2386;476;1516;90;320;117;373;207;693
314130;201701;685;1961;356;1224;64;248;64;204;128;452
314140;201701;4754;14558;3874;12812;709;2567;1794;5871;2503;8438
314150;201701;1500;4117;1200;3607;161;536;670;1972;831;2508
314160;201701;2512;6517;1913;5606;229;757;1014;3074;1243;3831
314170;201701;1021;3021;846;2663;90;309;495;1490;585;1799
314180;201701;4930;15399;4353;14482;1223;4309;1843;6259;3066;10568
314190;201701;664;1848;495;1569;110;419;186;527;296;946
314200;201701;2829;8669;2498;8079;253;1011;1738;5441;1991;6452
314210;201701;1963;5582;1756;5239;182;648;1107;3220;1289;3868
314220;201701;1438;4439;1072;3720;338;1288;223;701;561;1989
314225;201701;1316;3762;1188;3591;86;311;883;2678;969;2989
314230;201701;640;2030;597;1957;95;377;345;1112;440;1489
314240;201701;1071;3232;883;2927;165;593;440;1515;605;2108
314250;201701;528;1569;409;1317;87;307;116;331;203;638
314260;201701;954;3393;845;3130;183;792;259;891;442;1683
314270;201701;2741;8830;2264;7975;224;926;1513;5333;1737;6259
314280;201701;2969;8012;2038;6293;446;1616;715;2002;1161;3618
314290;201701;4635;12725;3974;11656;750;2239;2198;6449;2948;8688
314300;201701;1446;4753;1212;4208;345;1238;328;1121;673;2359
314310;201701;5513;15688;4531;14042;1071;3580;1751;5239;2822;8819
314315;201701;774;3018;707;2883;83;402;489;1977;572;2379
314320;201701;2859;8032;2046;6869;458;1641;992;3453;1450;5094
314330;201701;52371;155817;43896;141874;12876;44717;12078;38704;24954;83421
314340;201701;2755;7403;1587;5193;337;1261;127;310;464;1571
314345;201701;1185;3982;1076;3795;200;762;684;2372;884;3134
314350;201701;1134;3249;853;2770;243;850;132;382;375;1232
314360;201701;638;2050;421;1529;92;383;104;383;196;766
314370;201701;530;1709;489;1649;89;355;340;1104;429;1459
314380;201701;1227;3723;875;3005;246;926;130;464;376;1390
314390;201701;12233;34924;9032;29072;2194;7651;2042;6121;4236;13772
314400;201701;4311;12651;3619;11654;1131;3819;1229;4131;2360;7950
314410;201701;2551;7775;1978;6688;477;1790;616;2152;1093;3942
314420;201701;733;2039;571;1794;31;164;408;1227;439;1391
314430;201701;5917;17640;5066;16022;1325;4548;1679;5339;3004;9887
314435;201701;1326;4180;1173;3927;89;398;804;2663;893;3061
314437;201701;972;2587;801;2325;30;108;588;1712;618;1820
314440;201701;536;1637;446;1497;153;584;117;336;270;920
314450;201701;1483;4384;1257;4023;217;871;646;1885;863;2756
314460;201701;3630;12130;2926;10570;713;2816;518;1795;1231;4611
314465;201701;2213;6839;2043;6530;82;407;1616;5020;1698;5427
314467;201701;974;2746;836;2522;39;123;623;1901;662;2024
314470;201701;2047;6414;1783;5894;402;1515;677;2100;1079;3615
314480;201701;5552;18285;4063;14505;709;2775;539;1723;1248;4498
314490;201701;799;2390;622;2021;123;463;322;977;445;1440
314500;201701;1760;4991;1288;4134;263;947;405;1263;668;2210
314505;201701;1779;5041;1624;4837;165;559;1118;3361;1283;3920
314510;201701;1881;5013;1260;4160;356;1284;332;1120;688;2404
314520;201701;2668;9375;2002;7814;423;1911;204;744;627;2655
314530;201701;5678;19745;5357;19154;885;3160;3331;12245;4216;15405
314535;201701;2694;7399;2240;6758;222;762;1588;4776;1810;5538
314537;201701;1085;3343;892;2994;116;470;543;1783;659;2253
314540;201701;352;1057;279;908;52;177;103;324;155;501
314545;201701;1395;4195;1245;3980;71;253;997;3284;1068;3537
314550;201701;607;1631;451;1401;77;317;182;499;259;816
314560;201701;4137;14020;3495;12547;673;2736;1104;3703;1777;6439
314570;201701;300;874;232;742;37;145;113;340;150;485
314580;201701;498;1647;390;1409;101;415;36;125;137;540
314585;201701;823;2646;596;2148;152;639;160;539;312;1178
314587;201701;1938;5803;1639;5301;311;992;843;2798;1154;3790
314590;201701;2793;9412;2131;7735;458;1883;423;1444;881;3327
314600;201701;1556;5024;1107;4071;251;1030;148;461;399;1491
314610;201701;6618;22184;5938;20614;1320;5205;2540;8260;3860;13465
314620;201701;1551;4584;1377;4337;103;360;1047;3265;1150;3625
314625;201701;1476;4860;1332;4614;174;818;893;2925;1067;3743
314630;201701;4642;13726;4031;12741;286;1198;2907;9048;3193;10246
314640;201701;554;1485;423;1262;109;357;126;322;235;679
314650;201701;1025;2814;735;2342;90;344;279;791;369;1135
314655;201701;1527;4523;1161;3826;268;907;462;1530;730;2437
314660;201701;300;803;209;623;20;53;100;293;120;346
314670;201701;1608;4247;1139;3419;151;486;640;1863;791;2349
314675;201701;1787;5268;1553;4859;134;512;1128;3484;1262;3996
314690;201701;2061;6676;1710;6024;533;2075;342;1152;875;3227
314700;201701;8896;29103;6292;23337;1742;7174;868;3198;2610;10372
314710;201701;7957;23759;5684;18945;1035;3925;820;2505;1855;6430
314720;201701;2274;7417;1819;6411;425;1660;474;1686;899;3346
314730;201701;2021;6075;1641;5455;423;1571;578;1795;1001;3366
314740;201701;2712;8473;2313;7701;331;1330;1209;3854;1540;5184
314750;201701;319;995;253;849;45;164;103;333;148;497
314760;201701;1678;5431;1263;4472;188;796;270;790;458;1586
314770;201701;1053;3262;635;2159;71;276;115;326;186;602
314780;201701;291;767;215;655;44;173;100;277;144;450
314790;201701;9420;28692;7386;24882;2906;10827;552;1568;3458;12395
314795;201701;1565;4534;1363;4211;88;371;1013;2996;1101;3367
314800;201701;10917;31167;7410;24000;1874;6587;712;2186;2586;8773
314810;201701;10052;29033;7787;25132;2354;8185;1645;5415;3999;13600
314820;201701;838;2362;623;1984;158;556;236;737;394;1293
314830;201701;1518;5003;1345;4701;331;1327;645;2241;976;3568
314840;201701;886;3128;735;2909;136;678;435;1629;571;2307
314850;201701;1914;5361;1517;4665;157;646;1073;3164;1230;3810
314860;201701;3201;10443;2817;9711;436;1785;1659;5568;2095;7353
314870;201701;5353;16468;4591;15413;429;1861;3317;10946;3746;12807
314875;201701;1713;5518;1623;5394;109;369;1394;4687;1503;5056
314880;201701;893;2314;737;2117;45;101;539;1650;584;1751
314890;201701;529;1634;395;1320;77;294;150;455;227;749
314900;201701;538;1571;443;1430;88;304;184;569;272;873
314910;201701;1576;5078;1279;4583;364;1476;460;1574;824;3050
314915;201701;2407;7605;2100;7066;176;747;1455;4781;1631;5528
314920;201701;519;1426;371;1204;27;102;197;612;224;714
314930;201701;4442;14765;3900;13609;1058;3985;1105;3646;2163;7631
314940;201701;386;1108;352;1054;37;125;225;635;262;760
314950;201701;322;917;230;783;49;190;71;229;120;419
314960;201701;728;2221;572;1893;134;486;184;561;318;1047
314970;201701;552;1878;465;1706;106;441;137;501;243;942
314980;201701;1325;4074;1095;3697;341;1281;77;233;418;1514
314990;201701;2407;7491;1841;6259;499;1955;353;1038;852;2993
314995;201701;1580;4767;1375;4453;135;555;914;2899;1049;3454
315000;201701;1049;2966;846;2630;85;300;536;1662;621;1962
315010;201701;409;1253;324;1081;65;273;115;337;180;610
315015;201701;2011;6179;1830;5969;212;709;1367;4689;1579;5398
315020;201701;810;2485;598;2033;87;310;247;805;334;1115
315030;201701;586;1778;458;1538;131;471;102;314;233;785
315040;201701;884;2659;822;2544;153;514;494;1499;647;2013
315050;201701;1253;3600;992;3198;144;531;505;1618;649;2149
315053;201701;1015;3017;894;2784;143;566;446;1387;589;1953
315057;201701;1603;5494;1450;5206;256;952;799;2889;1055;3841
315060;201701;685;2196;475;1741;105;420;66;236;171;656
315070;201701;723;2129;582;1888;161;554;232;697;393;1251
315080;201701;2779;9054;2400;8248;609;2251;1065;3605;1674;5856
315090;201701;754;2596;612;2266;147;600;153;532;300;1132
315100;201701;1132;3763;810;2996;194;819;214;733;408;1552
315110;201701;1230;3678;1025;3298;216;775;416;1325;632;2100
315120;201701;13581;31849;9422;26461;1306;3808;4562;13728;5868;17536
315130;201701;1244;4098;1125;3863;297;1177;372;1198;669;2375
315140;201701;2674;8309;2200;7360;459;1773;858;2629;1317;4402
315150;201701;4285;11503;3222;9758;534;1788;1312;3968;1846;5756
315160;201701;1200;3519;959;3055;214;717;367;1144;581;1861
315170;201701;1454;4551;1135;3909;268;978;228;814;496;1792
315180;201701;16763;46659;9474;31326;1665;6241;1573;4848;3238;11089
315190;201701;1924;5002;1608;4514;329;973;999;2783;1328;3756
315200;201701;3561;11913;2980;10660;980;3828;566;1998;1546;5826
315210;201701;7625;22209;6080;18991;1088;3758;2245;6661;3333;10419
315213;201701;1094;3301;994;3148;46;162;799;2517;845;2679
315217;201701;2363;8049;1948;7269;211;998;1209;4399;1420;5397
315220;201701;9519;27222;8025;24661;2542;8002;2503;7960;5045;15962
315230;201701;2812;7521;2497;7155;135;227;2186;6617;2321;6844
315240;201701;2974;9000;2519;8292;710;2487;1144;3715;1854;6202
315250;201701;10049;30054;7872;25967;1808;6615;2559;8363;4367;14978
315260;201701;931;2877;618;2179;134;503;78;239;212;742
315270;201701;644;2067;487;1754;94;406;114;375;208;781
315280;201701;2801;7926;1744;5654;370;1281;264;810;634;2091
315290;201701;1203;3327;820;2687;260;929;179;615;439;1544
315300;201701;504;1309;340;1100;114;378;143;484;257;862
315310;201701;1243;3885;1011;3460;132;526;608;2007;740;2533
315320;201701;721;2150;576;1956;95;391;267;889;362;1280
315330;201701;731;2633;454;1878;103;457;66;261;169;718
315340;201701;3401;9573;2677;8454;539;1809;1013;3129;1552;4938
315350;201701;1793;4891;1372;4270;131;468;902;2851;1033;3319
315360;201701;1612;5342;1327;4706;263;1034;434;1454;697;2488
315370;201701;445;1394;391;1289;75;267;174;566;249;833
315380;201701;188;627;145;522;33;144;43;123;76;267
315390;201701;1175;3821;890;3179;201;799;189;635;390;1434
315400;201701;4162;12443;3376;10953;612;2138;1558;4983;2170;7121
315410;201701;2080;5276;1731;4816;206;636;1160;3223;1366;3859
315415;201701;1028;3270;892;3073;336;1220;279;986;615;2206
315420;201701;1101;3519;853;3016;214;803;128;404;342;1207
315430;201701;3516;9545;2674;8172;806;2728;614;1807;1420;4535
315440;201701;944;2818;820;2607;182;703;354;999;536;1702
315445;201701;2014;5503;1564;4800;209;725;1000;3066;1209;3791
315450;201701;2375;7323;2117;6916;336;1082;1294;4346;1630;5428
315460;201701;30204;97864;27171;91694;9807;35175;5352;17579;15159;52754
315470;201701;447;1341;371;1199;34;140;186;578;220;718
315480;201701;1655;5005;1152;3876;266;958;221;777;487;1735
315490;201701;3056;8083;2275;7008;416;1497;779;2267;1195;3764
315500;201701;469;1366;305;990;38;152;128;357;166;509
315510;201701;1342;3784;1146;3466;94;330;873;2585;967;2915
315520;201701;1034;3058;839;2745;107;413;521;1646;628;2059
315530;201701;616;2047;490;1720;166;641;150;476;316;1117
315540;201701;1013;3165;844;2848;171;708;301;999;472;1707
315550;201701;1710;4807;1308;4174;295;1062;422;1341;717;2403
315560;201701;6265;20708;5677;19884;573;2399;3821;13420;4394;15819
315570;201701;1816;5797;1661;5476;243;937;851;2688;1094;3625
315580;201701;2139;6202;1742;5486;476;1689;509;1539;985;3228
315590;201701;801;2375;703;2219;107;392;366;1130;473;1522
315600;201701;2340;8310;1889;7392;282;1202;1054;4234;1336;5436
315610;201701;955;2685;781;2339;140;544;326;830;466;1374
315620;201701;298;1058;281;1024;66;237;161;621;227;858
315630;201701;816;2569;655;2241;161;546;125;426;286;972
315640;201701;435;1263;367;1153;61;242;154;439;215;681
315645;201701;787;2316;635;2018;235;784;177;544;412;1328
315650;201701;1769;4855;1394;4320;94;397;1002;3058;1096;3455
315660;201701;2541;6498;2064;5731;186;518;1417;3910;1603;4428
315670;201701;10338;33392;9231;31258;2343;8577;3650;12102;5993;20679
315680;201701;2930;9649;2280;8330;678;2652;674;2451;1352;5103
315690;201701;3203;8943;2196;7131;545;1944;423;1483;968;3427
315700;201701;7142;21759;5966;19448;1037;3726;2751;8677;3788;12403
315710;201701;1807;5069;1392;4408;121;532;875;2664;996;3196
315720;201701;3695;11592;3288;10856;308;1324;1957;6176;2265;7500
315725;201701;1506;4632;1340;4394;199;673;980;3269;1179;3942
315727;201701;573;1720;453;1485;99;373;165;496;264;869
315730;201701;724;2276;669;2147;94;352;354;1082;448;1434
315733;201701;1003;2946;882;2724;244;851;322;939;566;1790
315737;201701;1180;3605;947;3182;70;302;609;2042;679;2344
315740;201701;979;2956;818;2634;129;519;429;1265;558;1784
315750;201701;1115;3361;1007;3173;72;279;737;2314;809;2593
315760;201701;1041;2701;1002;2653;12;37;944;2486;956;2523
315765;201701;1539;4607;1367;4392;44;189;1177;3818;1221;4007
315770;201701;1357;4304;1174;3995;321;1181;297;1028;618;2209
315780;201701;21081;68033;19054;63651;4139;15062;7357;23937;11496;38999
315790;201701;3570;11727;3139;10882;299;1034;2103;7498;2402;8532
315800;201701;1238;4813;980;4052;240;1070;173;677;413;1747
315810;201701;1306;3492;1116;3205;171;534;715;1969;886;2503
315820;201701;2279;7680;1986;7149;567;2061;875;3298;1442;5359
315830;201701;1110;3601;922;3229;116;506;299;947;415;1453
315840;201701;809;2097;523;1567;85;278;154;444;239;722
315850;201701;930;3266;900;3209;213;847;527;1789;740;2636
315860;201701;498;1655;364;1369;87;390;79;257;166;647
315870;201701;436;1260;359;1137;36;128;217;655;253;783
315880;201701;1165;3003;924;2700;205;736;341;939;546;1675
315890;201701;1455;4945;1300;4651;473;1791;489;1718;962;3509
315895;201701;5164;16091;4422;14462;862;3067;1599;4987;2461;8054
315900;201701;755;2174;720;2119;52;231;586;1616;638;1847
315910;201701;478;1589;444;1534;82;312;299;1008;381;1320
315920;201701;1597;4333;896;2886;185;663;169;469;354;1132
315930;201701;1035;2769;755;2280;196;639;199;585;395;1224
315935;201701;882;2941;790;2749;216;845;208;706;424;1551
315940;201701;604;1914;521;1751;98;372;246;820;344;1192
315950;201701;1169;3511;1033;3260;206;640;636;2042;842;2682
315960;201701;3604;11251;2445;8950;854;3653;104;239;958;3892
315970;201701;650;1841;500;1628;39;112;348;1175;387;1287
315980;201701;3684;9056;2378;6944;654;2159;585;1507;1239;3666
315990;201701;3852;10861;3130;9621;497;1765;1534;4628;2031;6393
316000;201701;561;1635;459;1493;116;454;166;520;282;974
316010;201701;629;1998;513;1784;65;281;252;795;317;1076
316020;201701;928;3019;847;2884;99;438;581;1877;680;2315
316030;201701;3102;9027;2287;7546;174;700;1388;4635;1562;5335
316040;201701;2955;9350;2270;7953;396;1578;472;1460;868;3038
316045;201701;1936;6002;1793;5766;217;711;1278;4131;1495;4842
316050;201701;353;1112;277;978;45;197;144;476;189;673
316060;201701;691;2046;548;1815;68;323;325;990;393;1313
316070;201701;6030;18501;5177;16671;1096;3981;2160;6649;3256;10630
316080;201701;706;2529;620;2318;150;616;73;279;223;895
316090;201701;515;1588;377;1294;60;240;125;408;185;648
316095;201701;1424;4483;1224;4141;137;485;778;2638;915;3123
316100;201701;2564;8365;1947;6927;477;1874;439;1449;916;3323
316105;201701;926;2609;698;2227;166;564;269;871;435;1435
316110;201701;11810;39464;10576;37372;1472;5511;6778;24539;8250;30050
316120;201701;1103;3499;856;2914;207;747;208;607;415;1354
316130;201701;1477;3379;887;2514;135;438;344;909;479;1347
316140;201701;923;2651;736;2381;98;324;460;1521;558;1845
316150;201701;1469;3957;1285;3627;188;616;751;2054;939;2670
316160;201701;1159;3390;911;2930;160;561;430;1318;590;1879
316165;201701;926;2453;754;2221;126;433;421;1244;547;1677
316170;201701;1262;3521;930;2974;149;513;394;1178;543;1691
316180;201701;1398;4325;999;3447;241;931;162;493;403;1424
316190;201701;2839;8664;1525;5304;287;984;268;842;555;1826
316200;201701;3672;11628;2823;9941;620;2529;671;2251;1291;4780
316210;201701;4455;14259;3720;12795;1283;4677;552;1945;1835;6622
316220;201701;780;2393;548;1924;117;468;50;184;167;652
316225;201701;1162;3205;970;2896;143;513;598;1700;741;2213
316230;201701;419;1191;343;1062;42;148;166;554;208;702
316240;201701;6367;19442;5662;18500;632;2152;4157;13672;4789;15824
316245;201701;3204;10987;2940;10569;258;1313;2194;7649;2452;8962
316250;201701;10124;28964;7803;24456;2073;7132;1730;5159;3803;12291
316255;201701;2521;7481;2203;7081;266;968;1539;5010;1805;5978
316257;201701;1253;3387;939;2830;142;502;357;1019;499;1521
316260;201701;1780;4898;1407;4353;83;314;777;2522;860;2836
316265;201701;1337;3731;984;3055;92;328;589;1806;681;2134
316270;201701;3508;11802;3232;11179;796;3003;1306;4363;2102;7366
316280;201701;3063;9836;2801;9317;459;1718;1493;4821;1952;6539
316290;201701;3276;10036;2716;8942;522;1990;1010;3282;1532;5272
316292;201701;3495;10727;3070;10047;451;1690;1981;6292;2432;7982
316294;201701;806;2534;602;2128;125;526;60;214;185;740
316295;201701;1794;5825;1679;5610;169;710;1196;3885;1365;4595
316300;201701;989;3087;844;2846;64;235;522;1803;586;2038
316310;201701;698;2002;471;1590;88;339;144;465;232;804
316320;201701;587;1853;482;1657;99;408;108;339;207;747
316330;201701;945;2860;746;2410;78;288;478;1491;556;1779
316340;201701;901;2843;730;2495;129;540;374;1202;503;1742
316350;201701;1251;3974;1133;3769;150;561;707;2344;857;2905
316360;201701;720;1916;583;1716;54;171;407;1191;461;1362
316370;201701;4375;13751;3686;12391;1093;4084;610;1945;1703;6029
316380;201701;1583;4098;1258;3653;66;236;924;2684;990;2920
316390;201701;863;2443;719;2215;145;492;332;1034;477;1526
316400;201701;1247;3800;942;3245;200;765;348;1134;548;1899
316410;201701;995;3266;920;3152;136;483;659;2249;795;2732
316420;201701;1926;6048;1688;5733;165;666;1184;3951;1349;4617
316430;201701;926;2813;645;2212;155;585;143;452;298;1037
316440;201701;653;2131;540;1964;191;795;96;363;287;1158
316443;201701;626;1832;504;1603;111;403;191;578;302;981
316447;201701;1557;4540;1406;4345;101;367;1177;3637;1278;4004
316450;201701;2118;7037;1793;6397;189;780;1236;4384;1425;5164
316460;201701;742;2271;675;2151;201;665;305;956;506;1621
316470;201701;7081;22313;5692;19516;1450;5738;1487;4863;2937;10601
316480;201701;178;592;153;534;40;148;37;121;77;269
316490;201701;311;941;251;811;52;162;87;253;139;415
316500;201701;1163;4024;795;2976;159;660;47;156;206;816
316510;201701;721;2634;646;2498;229;958;165;628;394;1586
316520;201701;996;2970;827;2697;145;545;321;949;466;1494
316530;201701;833;2668;699;2417;144;622;280;830;424;1452
316540;201701;730;2325;649;2178;91;382;207;639;298;1021
316550;201701;1177;3892;1105;3773;176;671;693;2364;869;3035
316553;201701;1912;6562;1513;5600;459;1841;292;1040;751;2881
316555;201701;2822;9502;2505;9100;223;919;1854;6898;2077;7817
316556;201701;628;1580;478;1337;42;136;308;824;350;960
316557;201701;767;2734;715;2645;285;1127;191;652;476;1779
316560;201701;279;1006;239;922;66;299;57;201;123;500
316570;201701;1164;3726;1037;3479;127;446;500;1704;627;2150
316580;201701;296;799;200;610;51;166;51;153;102;319
316590;201701;1425;3853;1023;3178;177;642;526;1500;703;2142
316600;201701;1019;3315;921;3123;210;784;412;1386;622;2170
316610;201701;561;2024;492;1882;83;422;293;1060;376;1482
316620;201701;2159;6433;1842;5911;177;690;1175;3740;1352;4430
316630;201701;1404;4602;1206;4183;444;1538;377;1399;821;2937
316640;201701;162;508;141;468;32;134;58;163;90;297
316650;201701;881;3151;774;2986;96;394;531;2100;627;2494
316660;201701;191;494;93;289;7;28;16;44;23;72
316670;201701;1922;5275;1551;4633;537;1755;459;1305;996;3060
316680;201701;1890;5110;1488;4530;125;416;1072;3236;1197;3652
316690;201701;1130;3818;1001;3533;282;1129;285;996;567;2125
316695;201701;1054;3273;927;3028;96;377;603;1935;699;2312
316700;201701;361;1052;329;1003;34;146;222;627;256;773
316710;201701;2675;9905;2290;9066;878;3629;560;2433;1438;6062
316720;201701;15768;50207;13082;44427;3268;11793;3703;12317;6971;24110
316730;201701;331;1028;297;953;78;284;119;348;197;632
316740;201701;661;2169;609;2081;70;315;418;1422;488;1737
316750;201701;393;1306;326;1167;61;253;109;364;170;617
316760;201701;3435;11248;2944;10550;1368;5150;995;3651;2363;8801
316770;201701;1360;3666;1179;3414;60;237;984;2830;1044;3067
316780;201701;568;1892;486;1723;152;607;62;182;214;789
316790;201701;741;2173;600;1928;169;583;179;577;348;1160
316800;201701;5076;16294;4366;14887;807;3045;2253;7330;3060;10375
316805;201701;785;1975;758;1938;33;60;663;1785;696;1845
316810;201701;591;1776;476;1544;125;461;185;537;310;998
316820;201701;391;1007;221;712;36;145;32;96;68;241
316830;201701;540;1851;509;1786;135;534;248;841;383;1375
316840;201701;2678;8153;2365;7587;506;1867;1075;3307;1581;5174
316850;201701;2017;5737;1642;5124;241;883;928;2820;1169;3703
316860;201701;17366;54105;14843;49520;3342;12733;5800;18730;9142;31463
316870;201701;6021;19197;4859;16619;1427;5250;905;3018;2332;8268
316880;201701;842;2524;726;2331;207;749;214;688;421;1437
316890;201701;1211;2898;895;2465;205;679;504;1276;709;1955
316900;201701;2450;7186;1929;6130;462;1676;544;1537;1006;3213
316905;201701;448;1458;381;1309;117;424;138;476;255;900
316910;201701;848;2608;620;2164;163;636;90;289;253;925
316920;201701;1537;4153;1101;3529;252;906;425;1338;677;2244
316930;201701;7666;25716;6086;22369;1440;5780;894;3177;2334;8957
316935;201701;4306;13051;3168;10612;836;3022;703;2337;1539;5359
316940;201701;6561;21037;5276;18236;1222;4514;1172;3809;2394;8323
316950;201701;1552;4153;1277;3770;86;296;962;2798;1048;3094
316960;201701;4568;11564;3622;10247;609;1876;2052;5765;2661;7641
316970;201701;3110;9821;2927;9485;639;2434;1234;3673;1873;6107
316980;201701;915;2756;649;2254;204;777;98;341;302;1118
316990;201701;9536;29630;7851;25937;2317;8270;693;2215;3010;10485
317000;201701;2734;9208;2637;9099;220;688;2070;7903;2290;8591
317005;201701;2563;7822;2236;7282;431;1480;1207;3946;1638;5426
317010;201701;26665;65715;16346;49896;4028;13850;3148;10352;7176;24202
317020;201701;63712;171001;38206;120487;7571;26339;7233;21316;14804;47655
317030;201701;659;1957;557;1798;52;217;343;1092;395;1309
317040;201701;9895;28208;7788;24504;1922;6442;2960;9448;4882;15890
317043;201701;698;1842;586;1687;112;328;308;872;420;1200
317047;201701;1094;2882;820;2432;70;221;465;1378;535;1599
317050;201701;1437;4787;1098;3989;218;858;346;1146;564;2004
317052;201701;2196;7140;2032;6868;184;764;1464;4842;1648;5606
317057;201701;1581;4376;1200;3701;94;383;761;2252;855;2635
317060;201701;419;1172;258;832;60;228;61;169;121;397
317065;201701;1242;3802;1101;3565;83;344;797;2523;880;2867
317070;201701;8898;27367;6199;21419;1392;5399;758;2558;2150;7957
317075;201701;1021;3065;803;2608;183;628;185;579;368;1207
317080;201701;6069;16201;5061;14515;1554;4672;1502;4197;3056;8869
317090;201701;4645;15194;4338;14731;476;1664;3079;10589;3555;12253
317100;201701;2893;7741;2089;6400;675;2227;616;1840;1291;4067
317103;201701;1750;6104;1545;5706;227;1050;797;2815;1024;3865
317107;201701;1301;3962;1154;3680;123;501;739;2184;862;2685
317110;201701;699;1720;396;1230;60;224;144;480;204;704
317115;201701;1108;3414;943;3077;75;250;666;2194;741;2444
317120;201701;9932;32907;8196;28816;1778;6905;3346;11426;5124;18331
317130;201701;7059;20663;5753;18287;1286;4532;2147;6743;3433;11275
317140;201701;536;1698;484;1611;74;269;297;985;371;1254
317150;201701;984;2707;852;2546;67;228;673;1996;740;2224
317160;201701;3396;8868;2533;7680;152;525;1777;5343;1929;5868
317170;201701;1924;5101;1450;4303;218;744;509;1324;727;2068
317180;201701;1741;5829;1427;5158;375;1453;372;1317;747;2770
317190;201701;1355;3765;1053;3329;72;252;697;2199;769;2451
317200;201701;4336;13356;3679;12027;950;3437;1052;3318;2002;6755
317210;201701;900;2730;793;2582;115;475;517;1636;632;2111
317220;201701;281;955;266;931;66;260;129;442;195;702
320010;201701;4755;14808;4063;13443;653;2322;2211;7207;2864;9529
320013;201701;1867;5643;1329;4467;241;825;529;1845;770;2670
320016;201701;2978;8258;2535;7623;220;637;1905;5770;2125;6407
320020;201701;3722;11441;3063;10151;868;3045;933;3168;1801;6213
320030;201701;1656;5226;1261;4380;374;1365;370;1243;744;2608
320035;201701;1755;5182;1518;4802;527;1832;563;1688;1090;3520
320040;201701;3074;9829;2581;8862;592;2174;929;3167;1521;5341
320050;201701;1555;4216;1366;3877;306;940;599;1637;905;2577
320060;201701;10941;34373;8323;28486;2058;7678;1679;5513;3737;13191
320070;201701;1356;4267;1114;3747;246;921;301;966;547;1887
320080;201701;5430;15496;4162;12996;945;3078;1254;4003;2199;7081
320090;201701;7660;22179;6101;19043;1575;5208;2143;6529;3718;11737
320100;201701;2502;7873;2039;6927;621;2157;617;2139;1238;4296
320110;201701;1188;3526;1023;3214;267;853;275;896;542;1749
320115;201701;1767;6239;1610;5962;810;3098;416;1629;1226;4727
320120;201701;15230;45234;11816;38828;2922;10563;3192;10517;6114;21080
320130;201701;35266;111723;31834;105073;6348;23675;15203;48638;21551;72313
320140;201701;3290;10322;2390;8351;651;2536;411;1421;1062;3957
320150;201701;13905;39552;10692;33205;3121;10398;1211;3577;4332;13975
320160;201701;4886;15105;4130;13573;1057;3832;1461;4574;2518;8406
320170;201701;1593;5091;1314;4471;304;1098;524;1771;828;2869
320180;201701;735;2487;637;2310;242;913;153;576;395;1489
320190;201701;3449;11787;2733;10035;732;2806;477;1740;1209;4546
320200;201701;939;2894;772;2606;235;869;224;785;459;1654
320210;201701;4508;12683;3773;11243;751;2489;1739;4869;2490;7358
320220;201701;2091;6469;1756;5874;486;1801;682;2324;1168;4125
320225;201701;1276;4290;1002;3636;352;1349;147;549;499;1898
320230;201701;4049;12875;3418;11776;977;3605;1332;4700;2309;8305
320240;201701;12315;35784;9977;31702;2560;8801;2976;9595;5536;18396
320245;201701;3024;10275;2795;9740;951;3504;660;2251;1611;5755
320250;201701;1845;5587;1317;4368;358;1348;218;656;576;2004
320255;201701;1651;5608;1449;5254;564;2124;537;2055;1101;4179
320260;201701;1012;3048;776;2546;212;767;208;601;420;1368
320265;201701;2407;7661;2057;7050;686;2449;807;2807;1493;5256
320270;201701;2658;7718;1965;6401;411;1434;867;2906;1278;4340
320280;201701;6214;19065;5375;17398;1403;4955;1403;4271;2806;9226
320290;201701;1396;4498;1010;3563;316;1183;144;518;460;1701
320300;201701;4066;13519;3561;12382;1193;4409;729;2508;1922;6917
320305;201701;4385;13973;3753;12569;933;3360;1452;4784;2385;8144
320310;201701;1819;5454;1520;4817;379;1237;557;1764;936;3001
320313;201701;2096;5938;1434;4491;332;1201;264;753;596;1954
320316;201701;1649;4931;1316;4248;404;1355;394;1259;798;2614
320320;201701;19310;57517;15094;49848;4078;14705;4820;15790;8898;30495
320330;201701;2884;8489;2373;7607;641;2043;979;3337;1620;5380
320332;201701;5129;16371;4449;15108;1397;5029;1646;5567;3043;10596
320334;201701;1984;6162;1365;4824;347;1359;289;989;636;2348
320335;201701;2201;6456;1372;4515;353;1282;138;390;491;1672
320340;201701;5445;14722;4687;13457;1038;3222;2081;6140;3119;9362
320350;201701;4920;13008;3717;10832;679;2068;1666;4815;2345;6883
320360;201701;1623;4323;1213;3538;202;629;491;1373;693;2002
320370;201701;2764;9119;2239;7895;638;2325;667;2335;1305;4660
320380;201701;2106;6228;1873;5817;381;1289;989;2999;1370;4288
320390;201701;6867;20560;5638;17948;1611;5515;1656;5088;3267;10603
320400;201701;3388;10405;2962;9632;647;2306;1335;4280;1982;6586
320405;201701;4175;12106;3633;11145;742;2440;1959;5931;2701;8371
320410;201701;5215;14246;3914;12346;895;3059;1727;5606;2622;8665
320420;201701;2344;6987;1881;6157;552;2002;475;1550;1027;3552
320425;201701;1956;5097;1560;4447;166;507;951;2674;1117;3181
320430;201701;2500;6939;2131;6193;405;1252;1139;3189;1544;4441
320435;201701;2686;8580;2208;7643;971;3491;547;2015;1518;5506
320440;201701;1012;3293;896;3006;207;761;310;1002;517;1763
320450;201701;1882;5871;1543;5201;407;1493;622;2036;1029;3529
320455;201701;4055;13129;3023;10705;832;3136;677;2319;1509;5455
320460;201701;2587;8184;1915;6655;486;1837;412;1325;898;3162
320465;201701;1548;4729;1187;3949;173;622;576;1917;749;2539
320470;201701;4080;12111;2889;9546;830;2986;543;1761;1373;4747
320480;201701;1661;5205;1441;4754;328;1190;582;1876;910;3066
320490;201701;15162;45981;12827;41840;3520;12605;4019;13122;7539;25727
320495;201701;1290;3702;827;2756;249;880;90;323;339;1203
320500;201701;46753;138846;40716;128213;8885;30282;19627;60609;28512;90891
320501;201701;4627;13923;3636;12282;1149;4359;951;3100;2100;7459
320503;201701;1863;6262;1501;5480;548;2246;419;1388;967;3634
320506;201701;4047;12377;2870;9651;820;2940;96;260;916;3200
320510;201701;8207;25260;7144;23288;1467;5269;3526;11327;4993;16596
320515;201701;1818;5265;1493;4567;458;1455;311;942;769;2397
320517;201701;2076;6641;1678;5855;528;1979;417;1439;945;3418
320520;201701;35538;105894;29325;94818;7250;25993;10186;32472;17436;58465
320530;201701;27121;80970;22633;72669;4203;15755;11125;33669;15328;49424
330010;201701;19683;59572;17727;55933;3955;13377;9153;28652;13108;42029
330015;201701;1475;4125;1270;3757;193;684;614;1772;807;2456
330020;201701;17057;49700;15564;47240;2856;9596;9158;27144;12014;36740
330022;201701;1831;5378;1540;4896;281;1008;863;2689;1144;3697
330023;201701;3070;9410;2663;8762;770;2730;790;2513;1560;5243
330025;201701;4411;11887;3427;10178;800;2565;1675;4999;2475;7564
330030;201701;8007;26332;7065;24487;1429;5491;3365;11190;4794;16681
330040;201701;11236;33626;10246;31715;2064;6941;5589;16782;7653;23723
330045;201701;72982;198178;63199;184445;7969;25328;42335;121906;50304;147234
330050;201701;2325;7020;1935;6302;542;1904;671;2061;1213;3965
330060;201701;5534;15754;4724;14523;1022;3569;2388;7118;3410;10687
330070;201701;19240;58020;17311;54853;3753;12916;8477;26899;12230;39815
330080;201701;7701;21638;7103;20709;683;2075;4965;14467;5648;16542
330090;201701;2555;6793;2276;6375;347;1097;1287;3496;1634;4593
330093;201701;1896;5649;1587;5102;297;981;733;2500;1030;3481
330095;201701;967;3265;835;2963;199;805;296;993;495;1798
330100;201701;57415;177380;52260;169205;7968;29532;30604;98119;38572;127651
330110;201701;2177;6841;1931;6412;489;1772;658;2155;1147;3927
330115;201701;1714;4923;1484;4574;266;920;823;2452;1089;3372
330120;201701;2605;7098;2294;6631;387;1300;1404;3948;1791;5248
330130;201701;3246;10474;2901;9868;697;2579;1386;4624;2083;7203
330140;201701;3006;9258;2744;8862;553;2037;1504;4787;2057;6824
330150;201701;1993;5934;1604;5166;413;1425;412;1334;825;2759
330160;201701;1131;3533;991;3295;264;1007;457;1436;721;2443
330170;201701;97458;291400;88916;277637;17421;57759;48746;151159;66167;208918
330180;201701;1999;5799;1676;5214;133;547;1065;3148;1198;3695
330185;201701;8099;24780;7032;22734;1376;4857;3788;11972;5164;16829
330187;201701;3715;10582;3181;9706;493;1658;1990;5976;2483;7634
330190;201701;24706;69688;23086;67239;3572;10942;16252;47191;19824;58133
330200;201701;13619;42473;12146;40016;3061;10419;6014;20135;9075;30554
330205;201701;1996;5518;1735;5073;216;724;1076;3047;1292;3771
330210;201701;3049;8455;2519;7445;650;1981;740;2186;1390;4167
330220;201701;9883;29872;8464;26892;2170;7445;2039;6031;4209;13476
330225;201701;3634;11236;3148;10326;402;1681;1799;5615;2201;7296
330227;201701;16413;47223;14787;44862;3123;9723;8607;26685;11730;36408
330230;201701;1199;3576;1088;3405;175;657;627;1876;802;2533
330240;201701;17076;51830;14573;47206;4570;15953;4387;13796;8957;29749
330245;201701;1190;3587;912;3091;247;910;158;491;405;1401
330250;201701;34121;99897;31020;94806;9097;28145;12200;38845;21297;66990
330260;201701;4047;12537;3509;11447;668;2369;1475;4626;2143;6995
330270;201701;19219;43513;12899;35087;3005;9171;4619;12688;7624;21859
330280;201701;2168;6404;1824;5740;297;1071;898;2666;1195;3737
330285;201701;17805;50619;16024;47959;2747;9003;9817;28975;12564;37978
330290;201701;3145;9118;2790;8571;467;1628;1552;4587;2019;6215
330300;201701;3168;10247;2853;9634;485;1883;1643;5321;2128;7204
330310;201701;2112;5960;1793;5412;239;755;1098;3303;1337;4058
330320;201701;12759;38191;11944;36930;1500;5182;8811;26886;10311;32068
330330;201701;27079;73888;23613;68529;4107;13382;14130;39639;18237;53021
330340;201701;13785;39719;10820;34386;2676;9114;3445;10787;6121;19901
330350;201701;85089;246086;76522;233824;10712;35043;51525;157141;62237;192184
330360;201701;5830;17059;5521;16600;491;1670;4235;12526;4726;14196
330370;201701;3431;12085;3089;11372;1045;4000;957;3504;2002;7504
330380;201701;4860;15662;4119;14158;988;3766;1415;4689;2403;8455
330385;201701;3771;12985;3445;12329;1040;3924;1334;4862;2374;8786
330390;201701;21675;70407;19025;65090;4796;17740;7768;26115;12564;43855
330395;201701;2985;8693;2741;8291;266;996;1801;5364;2067;6360
330400;201701;2545;7910;2303;7472;287;1180;1453;4345;1740;5525
330410;201701;2706;8219;2176;7222;437;1626;996;3150;1433;4776
330411;201701;2228;6902;1943;6314;250;950;1144;3542;1394;4492
330412;201701;1331;4469;1124;4045;217;876;512;1731;729;2607
330414;201701;23132;64863;20223;60775;3931;11766;11756;35848;15687;47614
330415;201701;3189;9856;2749;9071;696;2343;1020;3413;1716;5756
330420;201701;9492;26704;6486;21328;1402;5004;1371;4409;2773;9413
330430;201701;6946;20568;6145;19078;1351;4556;2709;8185;4060;12741
330440;201701;1512;5046;1353;4736;425;1658;357;1141;782;2799
330450;201701;1304;4298;1170;4066;259;1080;602;2022;861;3102
330452;201701;13264;38607;10675;33680;2667;9171;4197;12802;6864;21973
330455;201701;482758;1315557;392829;1170406;80462;256538;200233;590398;280695;846936
330460;201701;1133;3649;985;3377;208;796;435;1458;643;2254
330470;201701;4210;12535;3746;11725;835;2847;1774;5427;2609;8274
330475;201701;7562;23237;6691;21780;2002;7117;2539;8007;4541;15124
330480;201701;5441;15862;4903;15081;850;2814;2794;8378;3644;11192
330490;201701;106413;277833;94623;260542;10116;29720;65850;179869;75966;209589
330500;201701;5068;15512;4863;15160;691;2389;3380;10418;4071;12807
330510;201701;35718;108756;31871;102618;10025;32626;13385;44258;23410;76884
330513;201701;1312;3952;1211;3775;374;1193;528;1677;902;2870
330515;201701;2926;8980;2550;8239;844;2786;698;2253;1542;5039
330520;201701;10715;32408;9577;30356;1995;6788;4305;13381;6300;20169
330530;201701;1385;4070;1214;3738;310;1042;526;1550;836;2592
330540;201701;2855;8362;2338;7405;623;2092;810;2484;1433;4576
330550;201701;7582;25290;6710;23596;2909;10629;1069;3905;3978;14534
330555;201701;9620;28437;8611;26952;1566;5070;5258;16765;6824;21835
330560;201701;4145;12414;3721;11613;619;2135;1977;5932;2596;8067
330570;201701;3069;9057;2601;8246;646;2146;1226;3879;1872;6025
330575;201701;5034;14259;4500;13310;625;2134;2983;8473;3608;10607
330580;201701;12911;40393;10873;36258;2979;10512;4148;13779;7127;24291
330590;201701;1483;4554;1390;4403;224;760;944;2999;1168;3759
330600;201701;10701;31178;8748;27862;1474;5310;4189;13133;5663;18443
330610;201701;8457;26338;7644;24879;1239;4622;4352;13774;5591;18396
330615;201701;1553;5479;1450;5304;611;2340;459;1748;1070;4088
330620;201701;3377;11692;3014;10920;1027;3984;665;2402;1692;6386
330630;201701;22463;64663;18359;57444;2790;10154;10256;30830;13046;40984
350010;201701;1703;4973;1139;3853;290;1024;131;411;421;1435
350020;201701;435;1180;302;923;44;147;157;454;201;601
350030;201701;4378;13610;3365;11555;1023;3789;817;2776;1840;6565
350040;201701;435;1462;320;1199;70;276;89;327;159;603
350050;201701;839;2558;681;2258;162;628;218;612;380;1240
350055;201701;617;1798;521;1641;84;287;311;968;395;1255
350060;201701;114;352;92;318;23;89;45;157;68;246
350070;201701;3727;10929;2402;8189;483;1775;505;1555;988;3330
350075;201701;520;1729;411;1502;158;580;73;259;231;839
350080;201701;624;1804;395;1275;65;232;140;436;205;668
350090;201701;592;1564;382;1148;96;266;128;391;224;657
350100;201701;1846;5710;1324;4648;266;1082;408;1341;674;2423
350110;201701;450;1360;335;1109;33;128;186;598;219;726
350115;201701;1189;3553;1051;3287;196;695;536;1513;732;2208
350120;201701;617;1631;323;1007;70;233;56;169;126;402
350130;201701;3198;9458;2785;8622;369;1297;1552;4579;1921;5876
350140;201701;570;1859;475;1678;64;275;255;884;319;1159
350150;201701;428;1408;376;1297;139;513;77;275;216;788
350160;201701;7909;22826;5451;18004;1099;4086;2257;6917;3356;11003
350170;201701;1456;4927;1221;4342;324;1218;267;910;591;2128
350180;201701;1009;2795;648;1997;109;373;295;875;404;1248
350190;201701;3046;9332;2435;8080;507;1953;1021;2921;1528;4874
350200;201701;370;1140;332;1069;28;96;225;717;253;813
350210;201701;4698;12389;3371;10148;851;2665;1397;4197;2248;6862
350220;201701;2335;7383;2026;6691;429;1711;910;2769;1339;4480
350230;201701;702;2232;627;2082;137;485;272;902;409;1387
350240;201701;514;1571;410;1325;43;163;228;704;271;867
350250;201701;1941;6996;1798;6719;645;2586;557;2091;1202;4677
350260;201701;956;2516;632;1913;108;341;266;776;374;1117
350270;201701;4858;14719;4073;13010;749;2618;1785;5431;2534;8049
350275;201701;1847;6003;1671;5717;484;1732;636;2158;1120;3890
350280;201701;21207;51258;13370;38203;2749;8393;3414;9657;6163;18050
350290;201701;2144;6738;1682;5762;357;1355;531;1728;888;3083
350300;201701;529;1502;397;1223;90;281;195;584;285;865
350310;201701;853;2818;740;2549;103;399;300;995;403;1394
350315;201701;484;1532;360;1245;63;267;85;264;148;531
350320;201701;10123;31544;9050;29546;2643;9160;1475;5056;4118;14216
350330;201701;14022;38694;9584;28799;2006;5847;3207;9255;5213;15102
350335;201701;367;1140;325;1058;24;69;236;780;260;849
350340;201701;1034;3035;730;2438;149;568;226;754;375;1322
350350;201701;669;2089;579;1956;115;441;198;649;313;1090
350360;201701;819;2765;694;2480;159;553;290;1068;449;1621
350370;201701;518;1531;386;1243;87;297;76;234;163;531
350380;201701;4034;11706;2848;9551;736;2718;717;2233;1453;4951
350390;201701;9062;27517;7864;25255;2252;7469;2894;9169;5146;16638
350395;201701;357;979;185;632;27;98;45;133;72;231
350400;201701;7710;21968;6141;19116;1469;5040;2209;6547;3678;11587
350410;201701;8062;26471;6364;22987;1758;6961;1243;4275;3001;11236
350420;201701;519;1621;387;1385;87;367;36;126;123;493
350430;201701;659;2056;564;1889;92;372;325;1055;417;1427
350440;201701;1219;3806;1040;3386;230;759;468;1514;698;2273
350450;201701;7228;22289;5871;19520;1392;4979;1502;4774;2894;9753
350460;201701;1351;3642;830;2610;153;552;292;856;445;1408
350470;201701;226;606;189;543;26;97;116;314;142;411
350480;201701;739;2198;532;1787;95;364;100;311;195;675
350490;201701;1798;5376;1510;4879;350;1225;505;1493;855;2718
350500;201701;537;1610;470;1488;75;281;250;759;325;1040
350510;201701;1036;3118;776;2557;115;445;334;1042;449;1487
350520;201701;1483;5424;1195;4693;260;1122;296;1120;556;2242
350530;201701;2242;6511;1831;5689;527;1705;509;1534;1036;3239
350535;201701;1202;3893;1117;3746;171;703;704;2251;875;2954
350540;201701;1705;4764;1302;4063;314;1030;477;1521;791;2551
350550;201701;10082;26564;6970;21504;1277;4491;2501;7310;3778;11801
350560;201701;3207;10485;2807;9525;384;1381;1518;5104;1902;6485
350570;201701;17296;55842;15367;51974;4450;16301;5781;18731;10231;35032
350580;201701;1623;5161;1078;3777;203;757;111;322;314;1079
350590;201701;3735;11476;2942;9905;754;2871;1141;3511;1895;6382
350600;201701;41382;101484;27338;76976;4441;13723;11503;30253;15944;43976
350610;201701;6512;19368;5261;17031;1119;3960;2132;6713;3251;10673
350620;201701;386;1101;292;949;47;182;129;385;176;567
350630;201701;1578;4509;1164;3720;179;692;483;1403;662;2095
350635;201701;6536;18930;5152;16559;1149;4096;2129;6656;3278;10752
350640;201701;776;2387;537;1799;95;346;106;320;201;666
350650;201701;7631;22765;4867;16263;1057;3907;973;3031;2030;6938
350660;201701;4753;13670;3877;12127;716;2444;1883;5836;2599;8280
350670;201701;1446;4498;1336;4288;295;978;685;2168;980;3146
350680;201701;995;2953;751;2490;177;659;303;987;480;1646
350690;201701;808;2648;636;2271;149;593;211;694;360;1287
350700;201701;4142;12040;2889;9876;621;2396;956;2985;1577;5381
350710;201701;2674;8241;2315;7544;359;1303;1301;4142;1660;5445
350715;201701;739;2247;661;2090;126;437;338;1007;464;1444
350720;201701;128;367;115;346;26;84;40;119;66;203
350730;201701;391;1411;365;1349;84;346;156;569;240;915
350740;201701;1704;5174;1209;4046;225;817;309;930;534;1747
350745;201701;502;1554;308;1055;45;172;143;443;188;615
350750;201701;8779;26743;7299;23817;1697;6175;1903;5773;3600;11948
350760;201701;12782;36943;10209;32394;2701;9360;2615;7531;5316;16891
350770;201701;638;1802;445;1425;46;156;246;772;292;928
350775;201701;582;1526;482;1369;49;174;240;655;289;829
350780;201701;1794;5452;1401;4692;411;1525;269;930;680;2455
350790;201701;1801;5562;1324;4606;308;1155;230;711;538;1866
350800;201701;2895;9548;2714;9200;500;1926;1411;4601;1911;6527
350810;201701;1927;5424;1642;5018;420;1347;777;2474;1197;3821
350820;201701;560;1529;405;1233;63;231;171;493;234;724
350830;201701;817;2501;524;1826;74;287;134;414;208;701
350840;201701;2357;8249;1960;7345;631;2489;445;1638;1076;4127
350850;201701;5799;19170;4914;17244;1491;5495;1154;4029;2645;9524
350860;201701;3064;9342;2881;9054;154;660;2224;6885;2378;7545
350870;201701;2601;8236;2108;7377;436;1673;1124;3982;1560;5655
350880;201701;1243;4087;1005;3531;239;878;254;883;493;1761
350890;201701;642;1801;403;1280;51;178;101;271;152;449
350900;201701;4682;14531;3390;11708;1000;3764;420;1382;1420;5146
350910;201701;827;2410;717;2185;185;624;343;1001;528;1625
350920;201701;10594;29754;9396;27717;898;3024;6698;19010;7596;22034
350925;201701;4331;13466;3511;11861;833;3061;1203;3582;2036;6643
350930;201701;1417;3936;1016;3118;117;389;558;1634;675;2023
350940;201701;1718;5644;1574;5356;287;1123;872;2861;1159;3984
350945;201701;900;2798;755;2534;133;526;366;1142;499;1668
350950;201701;72461;215725;59030;186744;11947;41478;26840;80314;38787;121792
350960;201701;4691;15359;4021;13970;807;3198;2031;6703;2838;9901
350970;201701;3971;13568;3333;12019;1077;4213;557;1802;1634;6015
350980;201701;578;1876;517;1767;216;780;164;553;380;1333
350990;201701;1717;5686;1392;5083;379;1512;398;1398;777;2910
350995;201701;736;2480;698;2399;87;407;452;1448;539;1855
351000;201701;2761;8166;2236;7167;385;1368;922;2772;1307;4140
351010;201701;314;913;190;629;41;148;67;218;108;366
351015;201701;718;2455;614;2260;136;555;296;1079;432;1634
351020;201701;7678;23798;6678;22195;1654;5746;3171;10587;4825;16333
351030;201701;1888;6484;1623;5819;378;1502;545;1848;923;3350
351040;201701;3401;10072;3087;9541;376;1315;2121;6364;2497;7679
351050;201701;15057;41547;10622;34013;2495;8705;3171;10144;5666;18849
351060;201701;36560;104154;29695;92113;5496;18825;14887;45059;20383;63884
351070;201701;1372;3828;883;2932;227;831;91;257;318;1088
351080;201701;2567;7400;1990;6669;473;1797;922;2921;1395;4718
351090;201701;337;1154;264;1000;61;255;41;155;102;410
351100;201701;2330;6948;1590;5131;417;1439;427;1381;844;2820
351110;201701;6878;17643;4074;13058;893;3214;966;2983;1859;6197
351120;201701;644;1893;506;1610;82;289;221;610;303;899
351130;201701;956;2668;517;1771;98;354;107;339;205;693
351140;201701;1633;5461;1344;4847;428;1668;274;921;702;2589
351150;201701;1389;4795;992;3768;218;875;103;334;321;1209
351160;201701;1137;3954;996;3618;256;977;318;1041;574;2018
351170;201701;1290;4058;1092;3624;161;593;544;1697;705;2290
351190;201701;793;2515;623;2091;97;341;190;616;287;957
351200;201701;1807;5298;1522;4773;183;651;656;1943;839;2594
351210;201701;1134;3225;800;2550;118;426;299;871;417;1297
351220;201701;2838;9503;2599;8991;421;1648;1426;4798;1847;6446
351230;201701;1709;5267;1417;4711;279;1076;691;2158;970;3234
351240;201701;1057;3233;791;2660;206;698;254;815;460;1513
351250;201701;913;2688;570;1880;94;315;193;618;287;933
351260;201701;891;2596;761;2333;213;656;246;741;459;1397
351270;201701;297;986;257;898;67;260;95;279;162;539
351280;201701;5023;14214;3803;11834;692;2370;1463;4392;2155;6762
351290;201701;931;2633;656;2082;140;451;268;825;408;1276
351300;201701;12203;38676;9199;32405;2137;8286;2880;10103;5017;18389
351310;201701;2843;8590;2308;7593;444;1648;1059;3249;1503;4897
351320;201701;821;2719;684;2366;130;512;233;734;363;1246
351330;201701;254;703;202;621;64;192;38;112;102;304
351340;201701;5435;17983;4603;16335;1261;4689;1690;6009;2951;10698
351350;201701;7103;22652;6180;20784;1621;5730;2324;7500;3945;13230
351360;201701;3822;11806;3496;11183;915;3233;1062;3088;1977;6321
351370;201701;2183;6731;1711;5685;363;1351;677;2043;1040;3394
351380;201701;36771;105391;32702;97968;6416;20561;14805;43444;21221;64005
351385;201701;255;753;185;599;24;91;68;192;92;283
351390;201701;1133;3557;954;3185;253;1020;404;1186;657;2206
351400;201701;907;2962;858;2849;244;895;417;1351;661;2246
351410;201701;2317;6993;2001;6382;295;947;1165;3672;1460;4619
351420;201701;285;780;186;591;34;102;49;158;83;260
351430;201701;737;2334;690;2253;105;378;493;1587;598;1965
351440;201701;3028;9075;2255;7366;466;1604;298;913;764;2517
351450;201701;1497;4224;1175;3678;286;936;388;1290;674;2226
351460;201701;636;1895;548;1729;273;863;140;445;413;1308
351470;201701;984;2910;852;2654;146;527;415;1214;561;1741
351480;201701;2652;8513;2415;8110;387;1661;1342;4275;1729;5936
351490;201701;1692;5559;1503;5148;166;728;875;2816;1041;3544
351492;201701;269;863;228;759;14;52;127;414;141;466
351495;201701;195;626;148;504;30;124;62;197;92;321
351500;201701;28721;79189;21541;66238;4989;16558;8475;25064;13464;41622
351510;201701;8855;26617;7195;23299;1599;5560;3420;10922;5019;16482
351512;201701;482;1391;355;1109;62;182;155;480;217;662
351515;201701;2253;6815;1589;5360;376;1419;388;1177;764;2596
351518;201701;2086;6295;1442;5090;340;1349;518;1671;858;3020
351519;201701;759;2234;550;1775;93;349;132;322;225;671
351520;201701;650;1766;323;1129;52;206;85;282;137;488
351530;201701;355;1091;229;758;28;91;52;143;80;234
351535;201701;2285;5884;1746;5052;138;508;1135;3115;1273;3623
351540;201701;1677;4962;1315;4255;453;1598;183;534;636;2132
351550;201701;4832;14222;3430;11098;619;2204;1390;4269;2009;6473
351560;201701;401;1291;346;1163;80;306;55;181;135;487
351565;201701;162;550;145;505;30;101;56;188;86;289
351570;201701;13086;38642;10844;34138;2062;7084;6054;18396;8116;25480
351580;201701;308;851;192;611;42;127;48;157;90;284
351590;201701;445;1134;270;797;21;74;135;370;156;444
351600;201701;1760;4842;1421;4226;172;595;850;2404;1022;2999
351610;201701;661;1772;487;1473;49;179;234;636;283;815
351620;201701;17841;56046;14117;48551;2858;11104;4063;12666;6921;23770
351630;201701;21293;64404;18956;60503;3939;13404;10750;33643;14689;47047
351640;201701;13104;38461;10775;34362;1758;6209;6234;19413;7992;25622
351650;201701;419;1258;208;717;30;117;37;113;67;230
351660;201701;762;2399;547;1845;127;466;100;285;227;751
351670;201701;3820;11995;3083;10255;546;2036;1360;4220;1906;6256
351680;201701;557;1724;333;1157;73;248;56;195;129;443
351685;201701;400;1274;344;1162;80;251;155;522;235;773
351690;201701;1034;3064;758;2466;128;451;302;899;430;1350
351700;201701;1030;3030;885;2738;211;628;331;1030;542;1658
351710;201701;521;1725;439;1526;63;230;171;573;234;803
351720;201701;1503;4503;1053;3469;195;693;326;1021;521;1714
351730;201701;1047;2934;829;2605;165;617;361;1107;526;1724
351740;201701;3923;10673;3124;9113;605;1882;1223;3393;1828;5275
351750;201701;1095;3462;690;2501;126;477;194;726;320;1203
351760;201701;3291;10146;2585;8602;693;2510;746;2294;1439;4804
351770;201701;2104;6620;1769;5975;471;1659;721;2354;1192;4013
351780;201701;1431;3990;798;2563;134;474;170;514;304;988
351790;201701;1080;3042;906;2755;182;512;495;1540;677;2052
351800;201701;477;1057;263;695;41;107;79;214;120;321
351810;201701;999;2836;834;2542;89;265;559;1668;648;1933
351820;201701;2444;7670;1767;6197;342;1315;166;560;508;1875
351830;201701;4113;12525;3183;10547;509;1947;1539;4874;2048;6821
351840;201701;6556;22054;5756;20399;1399;5385;2108;7208;3507;12593
351850;201701;2027;5365;1434;4381;190;732;711;2004;901;2736
351860;201701;3071;9717;2654;8839;615;2182;1169;3809;1784;5991
351870;201701;26306;77526;21788;69350;6615;22097;8250;26131;14865;48228
351880;201701;111973;343141;94364;308366;27097;95165;26205;81547;53302;176712
351885;201701;608;2075;555;1959;150;548;223;744;373;1292
351890;201701;589;1829;473;1604;114;412;77;242;191;654
351900;201701;1156;3514;947;3170;256;899;278;926;534;1825
351905;201701;453;1397;360;1214;43;162;185;577;228;739
351907;201701;18342;53190;15201;47334;1300;4950;10155;30645;11455;35595
351910;201701;1006;3067;806;2615;179;630;316;971;495;1601
351920;201701;954;2565;769;2278;111;380;409;1194;520;1574
351925;201701;976;2929;800;2581;139;501;334;988;473;1489
351930;201701;2611;8243;2505;8044;362;1509;1888;5752;2250;7261
351940;201701;937;2810;773;2504;123;425;363;1170;486;1595
351950;201701;1489;4034;1057;3237;127;436;522;1581;649;2017
351960;201701;4370;12563;3270;10498;701;2477;1396;4434;2097;6911
351970;201701;5358;18869;4777;17712;1310;5265;1817;6495;3127;11760
351980;201701;863;2516;623;1996;126;444;213;595;339;1039
351990;201701;1430;3971;1117;3394;224;823;254;657;478;1480
352000;201701;2189;7134;1983;6680;356;1334;966;3059;1322;4393
352010;201701;1534;5115;1345;4706;328;1223;229;820;557;2043
352020;201701;1356;4200;1161;3825;286;1023;459;1438;745;2461
352030;201701;4699;13665;3896;12483;799;2790;2059;6579;2858;9369
352040;201701;1924;6130;1483;5175;305;1181;234;758;539;1939
352042;201701;3454;9379;2108;6530;401;1321;909;2758;1310;4079
352044;201701;1747;5245;1127;3956;187;716;222;713;409;1429
352050;201701;10835;32564;7524;25275;1787;6797;1352;4110;3139;10907
352060;201701;683;2065;549;1786;107;399;213;623;320;1022
352070;201701;773;1942;615;1676;130;397;211;573;341;970
352080;201701;421;1211;277;894;50;172;86;258;136;430
352090;201701;1271;4308;1029;3709;169;667;269;901;438;1568
352100;201701;2843;8554;2256;7465;556;1976;908;2873;1464;4849
352110;201701;502;1742;424;1579;115;437;148;517;263;954
352115;201701;464;1457;400;1338;54;187;239;801;293;988
352120;201701;882;2775;727;2485;109;460;355;1105;464;1565
352130;201701;1767;5268;1179;3888;278;974;247;781;525;1755
352140;201701;1687;4777;1027;3391;162;578;347;1087;509;1665
352150;201701;755;2243;597;1942;150;512;280;903;430;1415
352160;201701;960;2623;734;2219;164;539;237;643;401;1182
352170;201701;2640;7934;2320;7213;457;1528;1153;3396;1610;4924
352180;201701;2948;8397;2489;7492;652;2090;844;2427;1496;4517
352190;201701;1126;3358;923;2957;140;563;315;832;455;1395
352200;201701;368;1270;280;1074;36;154;95;345;131;499
352210;201701;15864;42778;13001;38572;2135;6869;7880;23585;10015;30454
352215;201701;526;1610;477;1537;56;214;295;921;351;1135
352220;201701;11784;36942;9538;32422;3121;11328;2237;7614;5358;18942
352230;201701;11934;39845;10215;36479;2811;11047;3365;11478;6176;22525
352240;201701;11792;33672;9186;29148;2468;8895;2839;8123;5307;17018
352250;201701;21694;68739;18906;63118;5731;20297;6220;20752;11951;41049
352260;201701;5152;14586;3411;10916;690;2490;1213;3544;1903;6034
352265;201701;850;2666;729;2456;65;294;487;1565;552;1859
352270;201701;1537;5260;1264;4666;323;1274;343;1233;666;2507
352280;201701;2166;6420;1777;5722;324;1246;791;2390;1115;3636
352290;201701;1086;3429;939;3095;176;689;415;1264;591;1953
352300;201701;954;2749;716;2268;141;509;305;880;446;1389
352310;201701;43894;127718;35101;112280;9180;30476;15891;51064;25071;81540
352320;201701;5280;16081;4497;14484;1130;3907;1507;4403;2637;8310
352330;201701;1950;6181;1647;5743;513;1927;505;1719;1018;3646
352340;201701;4877;15268;3751;13139;1044;3959;798;2642;1842;6601
352350;201701;1572;5252;1398;4856;269;1059;510;1666;779;2725
352360;201701;953;2909;854;2729;146;549;572;1732;718;2281
352370;201701;795;2708;716;2508;101;429;398;1338;499;1767
352380;201701;874;2780;742;2526;216;818;177;570;393;1388
352390;201701;18957;49554;12572;37882;2090;7203;5817;16409;7907;23612
352400;201701;3376;9647;2326;7632;708;2452;536;1636;1244;4088
352410;201701;2631;7962;2277;7381;481;1671;1002;3136;1483;4807
352420;201701;815;2240;663;1940;129;407;261;748;390;1155
352430;201701;5928;17673;5003;16164;1571;5459;1622;5249;3193;10708
352440;201701;15513;47401;12716;41886;2871;10083;5033;16445;7904;26528
352450;201701;597;1821;391;1359;79;312;116;393;195;705
352460;201701;2347;7433;1928;6607;522;1970;547;1735;1069;3705
352470;201701;3623;10078;2660;8304;354;1246;1173;3422;1527;4668
352480;201701;3895;10409;2904;8634;579;1941;1142;3048;1721;4989
352490;201701;627;2207;506;1893;100;399;138;525;238;924
352500;201701;7917;22047;6560;19895;3347;10747;1315;3354;4662;14101
352510;201701;2696;8435;2179;7470;634;2317;592;2008;1226;4325
352520;201701;1893;6637;1667;6089;443;1721;632;2284;1075;4005
352530;201701;8210;25856;6136;21029;1545;5724;839;2380;2384;8104
352540;201701;511;1582;364;1242;61;222;104;350;165;572
352550;201701;835;2727;616;2225;144;585;122;405;266;990
352560;201701;602;1806;421;1381;64;207;95;279;159;486
352570;201701;1788;5729;1308;4709;337;1365;200;603;537;1968
352580;201701;815;2440;636;2074;89;322;217;644;306;966
352585;201701;260;824;212;716;38;139;75;250;113;389
352590;201701;11749;35745;9572;31566;3114;10918;3487;10661;6601;21579
352600;201701;1709;5229;1390;4510;301;1062;576;1787;877;2849
352610;201701;3197;9790;2544;8598;640;2411;761;2422;1401;4833
352620;201701;5010;15162;4450;14242;1079;3575;2019;6400;3098;9975
352630;201701;585;1823;539;1712;129;484;219;629;348;1113
352640;201701;2435;7316;2061;6623;217;780;1328;4212;1545;4992
352650;201701;741;2252;554;1799;102;370;144;431;246;801
352660;201701;888;3138;752;2839;165;687;203;761;368;1448
352670;201701;10681;31605;6513;22381;1521;5814;455;1493;1976;7307
352680;201701;2797;9199;2175;7823;455;1860;761;2530;1216;4390
352690;201701;30098;82162;21695;65537;2897;9792;11122;32115;14019;41907
352700;201701;563;1685;480;1556;148;528;186;574;334;1102
352710;201701;5241;15065;3897;12377;954;3424;1298;3902;2252;7326
352720;201701;7521;23957;6700;22113;2249;7589;1874;6039;4123;13628
352725;201701;416;1150;217;712;29;117;89;262;118;379
352730;201701;2057;6732;1852;6173;403;1466;770;2313;1173;3779
352740;201701;2082;5478;1622;4762;194;682;941;2661;1135;3343
352750;201701;458;1304;242;819;28;107;55;169;83;276
352760;201701;1174;3958;953;3389;283;1070;249;834;532;1904
352770;201701;745;2300;618;2035;143;509;241;765;384;1274
352780;201701;630;2097;500;1779;97;382;158;547;255;929
352790;201701;626;1780;451;1461;73;241;121;384;194;625
352800;201701;1031;3642;767;2920;165;682;211;728;376;1410
352810;201701;981;2541;625;1857;122;378;203;567;325;945
352820;201701;610;1627;430;1343;93;320;92;276;185;596
352830;201701;484;1399;290;932;46;153;38;107;84;260
352840;201701;3781;12543;3379;11712;935;3427;1383;4653;2318;8080
352850;201701;9469;26879;7096;23066;1867;6495;2425;7803;4292;14298
352860;201701;778;2639;712;2488;142;552;277;912;419;1464
352870;201701;876;2201;581;1575;71;246;294;707;365;953
352880;201701;2140;5788;1531;4617;247;773;615;1708;862;2481
352885;201701;230;737;206;689;24;78;133;438;157;516
352890;201701;646;1690;448;1287;64;221;180;455;244;676
352900;201701;18602;53673;13493;43384;2754;9741;4866;14841;7620;24582
352910;201701;367;1052;209;697;24;86;45;131;69;217
352920;201701;2314;6825;1747;5642;321;1173;763;2300;1084;3473
352930;201701;5387;16665;4344;14403;912;3243;1388;4386;2300;7629
352940;201701;20984;66680;17436;58725;5763;21146;1923;5817;7686;26963
352950;201701;335;957;208;719;44;174;30;94;74;268
352960;201701;581;1741;348;1194;60;225;97;285;157;510
352965;201701;362;1037;222;716;51;175;36;102;87;277
352970;201701;3071;7616;2469;6734;224;662;1726;4698;1950;5360
352980;201701;1058;3342;904;3096;175;597;519;1853;694;2450
352990;201701;3973;12272;3491;11434;887;3252;1513;4704;2400;7956
353000;201701;429;1218;228;759;37;136;44;142;81;278
353010;201701;2889;7900;2098;6386;514;1782;579;1563;1093;3345
353020;201701;3930;10652;2311;7132;327;1076;732;2070;1059;3146
353030;201701;3361;9846;2665;8558;759;2595;490;1524;1249;4119
353040;201701;456;1286;375;1130;73;239;119;331;192;570
353050;201701;4543;15065;3752;13372;1015;3843;1321;4507;2336;8350
353060;201701;39745;114998;34555;106397;3739;13884;23683;69964;27422;83848
353070;201701;9796;29996;7135;24346;1651;6064;1856;6341;3507;12405
353080;201701;4652;14439;3284;11520;764;2945;824;2689;1588;5634
353090;201701;507;1723;464;1625;42;174;283;926;325;1100
353100;201701;279;780;123;419;22;74;18;47;40;121
353110;201701;6982;21359;6097;19946;1086;3907;3751;12301;4837;16208
353120;201701;643;1912;423;1405;82;307;109;317;191;624
353130;201701;2224;6400;1731;5594;536;1879;550;1714;1086;3593
353140;201701;2122;5853;1697;5030;333;1079;806;2269;1139;3348
353150;201701;1542;4600;1230;4039;331;1084;339;1125;670;2209
353160;201701;636;1761;412;1325;76;265;103;282;179;547
353170;201701;420;1279;370;1217;83;365;188;559;271;924
353180;201701;8512;23723;6869;20961;1092;3640;3953;11957;5045;15597
353190;201701;3488;10411;2827;8965;441;1563;1460;4339;1901;5902
353200;201701;1030;3428;780;2740;212;821;186;623;398;1444
353205;201701;339;1122;309;1052;71;255;142;481;213;736
353210;201701;1012;2514;661;1881;46;179;400;1090;446;1269
353215;201701;398;1231;328;1074;66;247;98;284;164;531
353220;201701;592;1815;474;1572;113;389;104;332;217;721
353230;201701;679;2203;614;2089;157;581;174;560;331;1141
353240;201701;2010;6357;1743;5831;295;1142;951;3076;1246;4218
353250;201701;1028;2764;772;2288;102;321;361;1029;463;1350
353260;201701;823;2290;579;1833;106;381;185;555;291;936
353270;201701;582;1705;499;1542;96;299;205;613;301;912
353280;201701;576;1874;451;1555;121;457;96;310;217;767
353282;201701;1753;5486;1606;5197;226;828;952;2970;1178;3798
353284;201701;354;937;202;624;38;122;46;132;84;254
353286;201701;119;359;85;290;17;58;17;57;34;115
353290;201701;795;2412;648;2132;86;345;368;1116;454;1461
353300;201701;1353;4185;1122;3677;246;918;391;1156;637;2074
353310;201701;191;551;155;507;47;166;48;156;95;322
353320;201701;558;1585;463;1402;63;190;243;718;306;908
353325;201701;613;1979;485;1689;72;252;142;490;214;742
353330;201701;563;1572;393;1192;54;193;191;543;245;736
353340;201701;2710;7875;1865;6270;556;1979;459;1577;1015;3556
353350;201701;3116;9337;2358;7707;682;2397;561;1699;1243;4096
353360;201701;441;1442;404;1363;46;177;260;868;306;1045
353370;201701;577;1911;498;1731;58;247;276;915;334;1162
353380;201701;307;1019;250;890;47;190;72;250;119;440
353390;201701;5605;15401;4062;12562;848;2757;1348;4049;2196;6806
353400;201701;441;1343;370;1200;75;275;80;213;155;488
353410;201701;593;1737;497;1555;100;361;241;711;341;1072
353420;201701;566;1600;362;1126;96;291;81;245;177;536
353430;201701;2045;6806;1534;5567;402;1523;258;913;660;2436
353440;201701;53694;168320;42398;143285;11193;39371;15047;49745;26240;89116
353450;201701;395;1149;300;935;57;210;105;301;162;511
353460;201701;3098;8840;2446;7586;288;1046;1137;3577;1425;4623
353470;201701;7093;21197;5294;17663;1222;4554;1296;4028;2518;8582
353475;201701;1399;3986;1049;3205;164;559;352;979;516;1538
353480;201701;1304;4025;1164;3746;137;460;800;2537;937;2997
353490;201701;865;2550;662;2119;157;504;235;736;392;1240
353500;201701;975;2596;800;2313;204;589;408;1180;612;1769
353510;201701;882;2812;655;2230;169;603;116;358;285;961
353520;201701;1055;2966;799;2541;118;424;359;1094;477;1518
353530;201701;2390;6925;2058;6323;290;1023;1102;3261;1392;4284
353540;201701;1841;5612;1579;5160;385;1319;694;2234;1079;3553
353550;201701;5904;16474;4802;14575;577;2080;2828;8125;3405;10205
353560;201701;1988;6538;1645;5904;493;1920;414;1403;907;3323
353570;201701;482;1437;359;1179;90;297;139;429;229;726
353580;201701;2296;6666;1984;6127;292;996;1252;3815;1544;4811
353590;201701;641;1899;451;1470;96;343;156;499;252;842
353600;201701;1695;4691;1480;4285;193;628;758;2101;951;2729
353610;201701;590;1991;441;1655;86;353;83;289;169;642
353620;201701;2181;6856;1799;6084;441;1575;493;1559;934;3134
353625;201701;401;1127;255;835;37;145;100;320;137;465
353630;201701;1342;4685;1068;3969;205;834;132;410;337;1244
353640;201701;1277;3769;955;3075;121;426;437;1384;558;1810
353650;201701;8288;24095;6229;19805;1119;3745;2394;7346;3513;11091
353657;201701;286;894;243;811;46;179;81;245;127;424
353660;201701;996;2629;720;2097;244;772;88;176;332;948
353670;201701;3334;10628;2818;9569;869;3281;968;3002;1837;6283
353680;201701;652;2043;534;1837;154;594;206;679;360;1273
353690;201701;487;1313;260;861;40;146;44;114;84;260
353700;201701;1922;5794;1655;5273;229;820;892;2703;1121;3523
353710;201701;3187;7608;1597;5064;372;1190;286;913;658;2103
353715;201701;505;1441;360;1149;32;119;95;286;127;405
353720;201701;1889;5781;1594;5325;313;1207;810;2573;1123;3780
353730;201701;4104;12360;3210;10421;620;2224;1126;3332;1746;5556
353740;201701;1590;4746;1199;3962;332;1199;304;970;636;2169
353750;201701;809;2715;611;2264;132;535;126;467;258;1002
353760;201701;9901;26538;8063;24013;1039;3593;5260;15347;6299;18940
353770;201701;646;1994;351;1249;52;210;23;47;75;257
353780;201701;3846;13255;3359;12212;1034;4011;855;3070;1889;7081
353790;201701;2084;7053;1703;6251;470;1983;411;1431;881;3414
353800;201701;15573;47128;12477;41555;3016;10904;4832;15788;7848;26692
353810;201701;954;3055;741;2580;141;553;239;802;380;1355
353820;201701;1356;4496;1193;4104;225;895;581;1893;806;2788
353830;201701;611;1638;483;1429;75;234;265;753;340;987
353850;201701;1630;5030;1402;4547;372;1247;516;1655;888;2902
353860;201701;2444;7944;2006;6966;543;2001;530;1824;1073;3825
353870;201701;27134;78386;19250;62494;3503;12680;6818;20147;10321;32827
353880;201701;2593;8214;2199;7487;293;1158;1184;3995;1477;5153
353890;201701;2309;5673;1623;4553;255;801;836;2231;1091;3032
353900;201701;789;2458;596;2072;127;474;165;567;292;1041
353910;201701;1219;4008;1111;3810;235;854;617;2113;852;2967
353920;201701;2268;6595;1587;5219;335;1217;283;809;618;2026
353930;201701;4316;12942;3082;10648;780;2976;517;1733;1297;4709
353940;201701;1067;3431;819;2854;155;575;233;765;388;1340
353950;201701;2978;9384;2557;8470;500;1819;1231;3806;1731;5625
353960;201701;528;1649;380;1314;80;289;89;274;169;563
353970;201701;563;1601;454;1420;51;175;274;852;325;1027
353980;201701;13041;38409;10982;34536;2249;7449;5391;16551;7640;24000
353990;201701;387;1192;347;1103;42;159;198;603;240;762
354000;201701;2091;5739;1346;4261;264;918;142;435;406;1353
354010;201701;355;1073;296;964;57;195;168;544;225;739
354020;201701;3973;12439;3411;11230;872;3121;1015;3074;1887;6195
354025;201701;791;2249;585;1868;114;378;194;625;308;1003
354030;201701;446;1205;288;904;45;163;116;346;161;509
354040;201701;724;1948;488;1486;47;157;281;798;328;955
354050;201701;881;2790;693;2401;175;663;138;463;313;1126
354060;201701;4619;14259;3206;11035;848;3058;788;2541;1636;5599
354070;201701;2628;8762;2222;7802;577;2162;423;1400;1000;3562
354075;201701;1824;6618;1657;6227;348;1470;801;2911;1149;4381
354080;201701;1326;4041;944;3208;171;621;296;942;467;1563
354085;201701;304;751;279;717;10;43;220;544;230;587
354090;201701;1288;3802;1216;3663;132;469;815;2434;947;2903
354100;201701;13683;45675;11329;41083;2890;11222;4648;16592;7538;27814
354105;201701;905;2630;791;2464;124;411;527;1632;651;2043
354110;201701;689;1878;532;1655;184;636;108;302;292;938
354120;201701;1858;5130;1326;4055;220;746;548;1568;768;2314
354130;201701;5931;16946;4340;13870;1569;5304;313;862;1882;6166
354140;201701;25475;64031;16172;47442;3394;10676;4612;12647;8006;23323
354150;201701;3648;9806;2780;8255;473;1533;1299;3746;1772;5279
354160;201701;3127;10097;2496;8638;618;2230;845;2903;1463;5133
354165;201701;484;1605;409;1452;105;414;156;555;261;969
354170;201701;1277;3987;1013;3369;163;598;424;1345;587;1943
354180;201701;442;1368;380;1230;59;227;156;432;215;659
354190;201701;1394;4358;1154;3859;261;953;364;1173;625;2126
354200;201701;913;2565;718;2202;91;308;333;943;424;1251
354210;201701;607;1906;502;1705;76;318;259;806;335;1124
354220;201701;2783;8003;2323;7147;458;1510;1111;3323;1569;4833
354230;201701;584;1905;516;1752;85;341;244;775;329;1116
354240;201701;1176;3830;872;3123;165;649;186;634;351;1283
354250;201701;637;1786;424;1422;128;450;110;394;238;844
354260;201701;7599;22441;6292;20157;1692;5770;1924;6341;3616;12111
354270;201701;1086;3592;900;3181;180;704;301;1043;481;1747
354280;201701;689;2013;617;1882;108;418;371;1048;479;1466
354290;201701;872;3062;776;2827;168;648;308;1123;476;1771
354300;201701;3629;11721;3384;11266;900;3129;1593;5206;2493;8335
354310;201701;802;2439;649;2135;139;469;318;1039;457;1508
354320;201701;695;2076;554;1792;131;493;191;562;322;1055
354323;201701;458;1255;333;1009;66;211;112;303;178;514
354325;201701;1195;3882;912;3222;167;631;321;1054;488;1685
354330;201701;6126;18079;4839;15535;944;3482;2248;6672;3192;10154
354340;201701;22726;68724;18421;61158;5006;18102;6895;22132;11901;40234
354350;201701;1049;3081;937;2858;204;700;502;1426;706;2126
354360;201701;424;1348;259;964;40;154;10;42;50;196
354370;201701;1078;3595;922;3269;105;468;496;1692;601;2160
354380;201701;764;2312;582;1947;165;638;102;294;267;932
354390;201701;12768;36434;8750;28767;1778;6296;1623;5296;3401;11592
354400;201701;1477;5132;1203;4449;281;1102;353;1297;634;2399
354410;201701;5121;15647;4214;13872;1060;3729;1606;5175;2666;8904
354420;201701;1137;3382;835;2691;186;639;341;1073;527;1712
354425;201701;2068;5936;1758;5334;512;1635;474;1458;986;3093
354430;201701;1290;4155;1154;3885;241;933;482;1546;723;2479
354440;201701;500;1502;361;1200;44;163;131;400;175;563
354450;201701;390;1118;232;769;33;122;38;114;71;236
354460;201701;953;2651;665;2082;135;462;274;866;409;1328
354470;201701;577;1531;454;1292;37;136;229;593;266;729
354480;201701;708;1933;564;1690;63;201;338;974;401;1175
354490;201701;701;2344;572;2031;69;274;256;872;325;1146
354500;201701;1990;6399;1776;6050;644;2451;390;1311;1034;3762
354510;201701;795;2179;728;2060;93;237;456;1294;549;1531
354515;201701;246;808;195;695;38;151;68;244;106;395
354520;201701;7661;24691;4389;15167;820;3237;1772;5671;2592;8908
354530;201701;3022;10234;2680;9481;679;2610;1099;3828;1778;6438
354540;201701;1142;3442;933;3049;314;1100;181;583;495;1683
354550;201701;452;1322;368;1162;80;276;176;532;256;808
354560;201701;1674;4636;1007;3136;146;470;421;1235;567;1705
354570;201701;1036;2897;496;1593;78;277;70;209;148;486
354580;201701;10283;28624;7156;22884;1271;4445;2684;8104;3955;12549
354600;201701;1523;4906;1304;4492;239;961;669;2233;908;3194
354610;201701;358;1019;207;668;21;75;67;197;88;272
354620;201701;366;1166;288;1024;55;244;128;423;183;667
354625;201701;279;865;181;636;27;105;45;134;72;239
354630;201701;2040;6700;1786;6174;732;2680;249;817;981;3497
354640;201701;3068;10050;2377;8410;501;2016;470;1466;971;3482
354650;201701;793;2323;679;2086;68;235;455;1402;523;1637
354660;201701;2261;6230;1635;5157;152;561;1039;3234;1191;3795
354670;201701;1071;3303;819;2695;195;706;192;578;387;1284
354680;201701;4117;13342;3746;12612;997;3498;1729;5793;2726;9291
354690;201701;731;2356;495;1780;88;331;120;419;208;750
354700;201701;1129;3160;787;2418;162;591;307;822;469;1413
354710;201701;503;1488;367;1195;33;134;166;482;199;616
354720;201701;249;674;139;444;43;143;18;51;61;194
354730;201701;8398;26022;6289;21952;1251;4770;2783;9437;4034;14207
354740;201701;231;703;131;473;15;67;18;68;33;135
354750;201701;2130;6720;1691;5781;416;1608;600;1922;1016;3530
354760;201701;1778;5587;1422;4845;479;1744;205;698;684;2442
354765;201701;296;837;141;480;18;65;22;70;40;135
354770;201701;2191;6050;1650;5108;545;1788;481;1458;1026;3246
354780;201701;53358;146882;44488;128628;6847;22284;23757;64816;30604;87100
354790;201701;767;2536;691;2371;113;403;347;1173;460;1576
354800;201701;2243;6437;1890;5915;407;1429;933;2815;1340;4244
354805;201701;967;2862;705;2305;83;309;200;572;283;881
354810;201701;551;1775;346;1292;63;266;54;187;117;453
354820;201701;916;3099;769;2786;163;672;160;524;323;1196
354830;201701;428;1158;324;964;92;286;119;322;211;608
354840;201701;663;1901;491;1542;90;281;231;723;321;1004
354850;201701;16522;49718;12209;41140;2393;9130;5512;17226;7905;26356
354860;201701;1282;4014;1094;3694;265;1020;390;1202;655;2222
354870;201701;44707;128394;38910;116828;7835;25620;18180;52948;26015;78568
354880;201701;4189;11524;2298;7356;329;1240;718;1938;1047;3178
354890;201701;14822;42707;12456;38471;2569;8569;5611;16814;8180;25383
354900;201701;417;1286;309;1042;57;213;70;219;127;432
354910;201701;5984;17710;3599;12680;641;2559;177;574;818;3133
354920;201701;357;1051;223;777;44;182;47;151;91;333
354925;201701;198;623;112;410;21;86;22;69;43;155
354930;201701;293;729;162;506;22;70;64;197;86;267
354940;201701;1618;5797;1340;5061;465;1876;131;463;596;2339
354950;201701;1404;4402;1172;3999;162;704;640;2063;802;2767
354960;201701;719;2213;631;2067;120;441;287;899;407;1340
354970;201701;3749;12160;3266;11147;573;2255;1727;5665;2300;7920
354980;201701;26668;69987;18093;55073;3068;10690;7200;20293;10268;30983
354990;201701;53990;154182;42109;131296;6858;23274;20676;62472;27534;85746
354995;201701;1728;5187;1423;4681;348;1207;704;2275;1052;3482
355000;201701;1289;4138;1147;3880;295;1162;222;631;517;1793
355010;201701;3285;10074;2489;8187;791;2788;538;1783;1329;4571
355020;201701;2744;9012;2135;7753;748;2967;532;1869;1280;4836
355030;201701;1116770;2989116;918737;2607604;193339;597972;406223;1098266;599562;1696238
355040;201701;2488;7541;2214;7068;362;1268;1378;4311;1740;5579
355050;201701;1063;3190;825;2717;256;861;137;446;393;1307
355060;201701;4136;13518;3365;11906;675;2749;1135;3683;1810;6432
355070;201701;6422;19608;5609;18236;1113;4104;2850;8743;3963;12847
355080;201701;821;2787;575;2214;98;440;35;122;133;562
355090;201701;1023;3478;871;3146;168;634;319;1143;487;1777
355100;201701;16331;49868;13532;45130;3318;12124;6739;21995;10057;34119
355110;201701;1079;3491;908;3176;285;1094;162;516;447;1610
355120;201701;589;1830;469;1592;89;358;174;562;263;920
355130;201701;603;1515;280;823;37;118;86;228;123;346
355140;201701;1091;3557;1005;3408;200;768;576;1988;776;2756
355150;201701;3365;9730;2771;8725;565;1915;1299;4069;1864;5984
355160;201701;1659;5180;1379;4709;396;1453;347;1165;743;2618
355170;201701;7730;21962;6062;19221;1978;6605;1817;5947;3795;12552
355180;201701;2663;8247;2145;7272;541;2192;677;2053;1218;4245
355190;201701;1322;4117;1126;3749;353;1304;334;1193;687;2497
355200;201701;741;2594;669;2433;269;1045;156;528;425;1573
355210;201701;2690;8320;2388;7669;289;1125;1512;4647;1801;5772
355220;201701;35511;105721;29032;92903;9195;31308;7672;22823;16867;54131
355230;201701;1378;3696;794;2472;154;464;174;498;328;962
355240;201701;23555;66920;16393;52256;3585;12095;5360;16803;8945;28898
355250;201701;28161;86379;23303;77115;6322;22505;8069;26119;14391;48624
355255;201701;849;2308;517;1633;101;342;130;401;231;743
355260;201701;1127;3355;944;3037;204;750;406;1197;610;1947
355270;201701;1538;4718;1319;4233;211;717;663;1975;874;2692
355280;201701;26097;74513;20902;64342;3914;13192;8768;26022;12682;39214
355290;201701;847;2690;666;2245;129;440;199;632;328;1072
355300;201701;1256;4004;1038;3535;227;826;322;1074;549;1900
355310;201701;985;2909;776;2543;119;433;412;1362;531;1795
355320;201701;543;1660;474;1519;93;351;189;532;282;883
355330;201701;1801;5467;1334;4526;258;944;597;1960;855;2904
355340;201701;2648;6691;2334;6210;376;1002;1413;3731;1789;4733
355350;201701;1277;4228;1011;3634;242;940;284;998;526;1938
355360;201701;1133;3589;1007;3302;185;631;617;2076;802;2707
355365;201701;326;958;200;705;49;179;36;117;85;296
355370;201701;6588;16884;5119;14956;1381;4329;2072;6399;3453;10728
355380;201701;3034;8973;2386;7589;519;1790;557;1557;1076;3347
355385;201701;992;3159;890;2950;246;885;288;895;534;1780
355390;201701;816;2383;617;1974;127;451;217;602;344;1053
355395;201701;1845;5582;1367;4455;199;647;581;1808;780;2455
355400;201701;8659;28344;7516;25953;2288;8512;2029;6751;4317;15263
355410;201701;17443;54898;13713;47475;4014;15209;2610;9174;6624;24383
355420;201701;685;2433;615;2289;179;774;173;636;352;1410
355430;201701;3439;9369;2777;8244;528;1704;1356;3925;1884;5629
355440;201701;861;2605;619;2056;126;426;152;459;278;885
355450;201701;3657;10404;2151;7088;397;1403;625;1907;1022;3310
355460;201701;543;1453;356;1114;65;243;127;342;192;585
355465;201701;326;1048;261;902;53;195;66;216;119;411
355470;201701;730;2180;570;1903;152;530;212;678;364;1208
355475;201701;148;462;144;455;36;130;81;240;117;370
355480;201701;2917;9951;2654;9439;586;2280;1303;4552;1889;6832
355490;201701;949;2710;611;1997;91;299;185;584;276;883
355495;201701;737;2445;631;2220;145;577;158;529;303;1106
355500;201701;6693;19644;4482;14677;841;2998;800;2475;1641;5473
355510;201701;1834;4881;1001;3204;150;572;267;763;417;1335
355520;201701;414;972;206;570;23;74;97;240;120;314
355530;201701;427;1028;175;549;25;90;40;111;65;201
355535;201701;604;1817;486;1600;145;540;134;366;279;906
355540;201701;7715;23987;7269;23256;1705;5798;3958;12370;5663;18168
355550;201701;712;2191;584;1938;94;358;243;790;337;1148
355560;201701;1118;3379;678;2357;135;536;38;105;173;641
355570;201701;185;587;115;415;20;70;12;44;32;114
355580;201701;1194;3304;813;2571;126;453;321;992;447;1445
355590;201701;209;562;162;478;20;69;93;263;113;332
355600;201701;1118;3350;921;2931;279;969;293;900;572;1869
355610;201701;1564;4288;1145;3502;189;619;512;1515;701;2134
355620;201701;4141;12832;3340;11004;554;2115;1531;4641;2085;6756
355630;201701;2636;7692;1802;6048;402;1393;495;1705;897;3098
355635;201701;880;2809;752;2596;73;283;533;1870;606;2153
355640;201701;2613;8293;1926;6918;414;1633;314;1130;728;2763
355645;201701;3572;11577;3073;10781;463;1897;1813;6282;2276;8179
355650;201701;7179;21271;6237;19520;1177;4249;3698;10781;4875;15030
355660;201701;1187;3765;935;3219;153;643;423;1360;576;2003
355670;201701;2723;8447;1993;6684;381;1465;844;2507;1225;3972
355680;201701;1525;5052;1110;4012;280;1090;151;533;431;1623
355690;201701;469;1469;344;1236;137;513;18;47;155;560
355695;201701;241;784;145;518;11;42;14;45;25;87
355700;201701;5244;16880;4437;15063;1114;3870;1712;5732;2826;9602
355710;201701;9160;22648;5471;15953;1142;3566;1397;3863;2539;7429
355715;201701;307;909;207;683;56;204;39;120;95;324
355720;201701;1418;4670;1167;4104;274;1048;381;1193;655;2241
355730;201701;812;2643;682;2335;210;725;182;601;392;1326
410010;201701;1306;4055;1114;3617;252;913;198;642;450;1555
410020;201701;1147;3682;973;3289;273;936;359;1223;632;2159
410030;201701;1093;3690;907;3241;248;923;162;598;410;1521
410040;201701;9371;30271;8088;27854;1896;7250;2537;8678;4433;15928
410045;201701;1017;2819;723;2275;165;570;179;504;344;1074
410050;201701;2570;7010;1656;5275;469;1580;136;368;605;1948
410060;201701;2122;6469;1835;5877;377;1240;775;2511;1152;3751
410070;201701;1661;4655;1264;3870;356;1195;339;1006;695;2201
410080;201701;1376;3859;1067;3284;189;663;438;1272;627;1935
410090;201701;953;2923;894;2809;165;572;398;1290;563;1862
410100;201701;2584;7915;1948;6379;386;1453;220;655;606;2108
410105;201701;343;1072;230;795;39;162;37;106;76;268
410110;201701;2799;8109;2241;7026;356;1242;707;2179;1063;3421
410115;201701;515;1386;391;1163;77;250;127;339;204;589
410120;201701;2373;8161;2209;7831;834;3130;602;2141;1436;5271
410130;201701;1074;3308;1006;3153;379;1279;260;737;639;2016
410140;201701;17136;44048;11152;33422;2250;7382;2521;7143;4771;14525
410150;201701;14841;38138;8068;24225;1581;5087;1221;3445;2802;8532
410160;201701;2838;8717;2553;8186;593;2135;946;3089;1539;5224
410165;201701;683;1988;548;1677;91;301;256;720;347;1021
410170;201701;2208;6307;1667;5106;455;1524;238;711;693;2235
410180;201701;11033;34518;9495;31066;1942;6846;4237;13033;6179;19879
410185;201701;517;1438;384;1176;85;267;77;211;162;478
410190;201701;1972;5792;1582;4954;341;1174;265;780;606;1954
410200;201701;3638;10034;2607;8050;559;1974;382;1145;941;3119
410210;201701;2558;7475;1831;5869;320;1191;384;1010;704;2201
410220;201701;643;1735;478;1435;79;278;141;424;220;702
410230;201701;1419;4391;1219;3978;245;919;505;1597;750;2516
410240;201701;4156;12507;3742;11650;1229;4379;533;1565;1762;5944
410250;201701;2649;7220;1853;5627;420;1391;348;1046;768;2437
410260;201701;1535;4381;1206;3815;256;886;501;1585;757;2471
410270;201701;554;1540;436;1300;51;169;207;606;258;775
410275;201701;775;2362;525;1758;83;297;222;746;305;1043
410280;201701;2085;6045;1515;4861;356;1277;392;1166;748;2443
410290;201701;3303;9880;2737;8789;588;1944;1070;3465;1658;5409
410300;201701;690;1940;576;1708;97;335;254;667;351;1002
410302;201701;427;1180;255;834;32;115;128;422;160;537
410304;201701;1192;3764;1083;3526;276;950;433;1442;709;2392
410305;201701;1795;4881;1446;4275;328;1034;691;2026;1019;3060
410310;201701;2201;6984;1948;6531;424;1568;682;2302;1106;3870
410315;201701;667;1863;417;1388;61;223;126;392;187;615
410320;201701;1177;3588;781;2659;111;438;89;297;200;735
410322;201701;533;1563;326;1099;46;153;77;257;123;410
410330;201701;1294;3614;1053;3136;238;741;251;751;489;1492
410335;201701;881;2610;750;2350;124;453;306;863;430;1316
410337;201701;778;2054;557;1636;82;281;192;519;274;800
410340;201701;542;1533;373;1101;48;161;156;399;204;560
410345;201701;1798;5195;1263;4041;297;990;308;956;605;1946
410347;201701;711;1910;511;1537;59;218;153;427;212;645
410350;201701;1041;3097;777;2577;146;558;174;523;320;1081
410360;201701;3789;10116;2946;8605;348;1178;1525;4334;1873;5512
410370;201701;11513;33586;8400;26172;1493;5173;2386;6539;3879;11712
410380;201701;1291;3711;1178;3467;140;520;553;1604;693;2124
410390;201701;2301;6906;1825;5867;574;1925;373;1114;947;3039
410395;201701;847;2795;750;2587;199;739;327;1134;526;1873
410400;201701;4217;12979;3408;11202;696;2471;1207;3816;1903;6287
410405;201701;806;2300;659;2032;161;559;225;664;386;1223
410410;201701;1190;3674;1154;3625;293;1135;586;1745;879;2880
410420;201701;6477;20885;5308;18259;1347;5071;697;2106;2044;7177
410425;201701;2647;8329;1996;6917;377;1422;263;829;640;2251
410430;201701;13504;36234;9888;29608;1850;6111;2665;7642;4515;13753
410440;201701;2512;8039;2229;7485;546;2020;913;3010;1459;5030
410442;201701;2550;8424;2261;7791;678;2432;670;2299;1348;4731
410445;201701;2273;7351;1941;6728;520;1982;616;2209;1136;4191
410450;201701;1873;5315;1439;4440;342;1137;158;356;500;1493
410460;201701;1623;4735;1272;4073;370;1244;252;753;622;1997
410465;201701;2173;7011;1841;6296;425;1514;630;2058;1055;3572
410470;201701;1722;5481;1366;4679;285;1117;279;954;564;2071
410480;201701;30041;83548;18324;59217;3009;10513;1382;3829;4391;14342
410490;201701;10936;33160;8309;27640;1848;6823;2187;6742;4035;13565
410500;201701;1478;4629;1174;3923;403;1488;156;444;559;1932
410510;201701;2419;6347;1646;4803;316;933;517;1426;833;2359
410520;201701;2953;10167;2777;9795;807;2969;1242;4432;2049;7401
410530;201701;1458;4004;940;2840;173;563;181;473;354;1036
410540;201701;2851;8439;2044;6723;396;1400;668;2171;1064;3571
410550;201701;5946;17144;4237;13471;842;2956;565;1631;1407;4587
410560;201701;1235;3628;964;3098;241;855;297;867;538;1722
410570;201701;2540;7933;2266;7479;609;2207;639;2337;1248;4544
410580;201701;21424;63382;17441;55480;4015;14244;5526;16485;9541;30729
410590;201701;1379;4239;902;2972;154;558;183;517;337;1075
410600;201701;1792;5197;1429;4486;347;1091;470;1502;817;2593
410610;201701;736;2055;576;1754;64;205;215;632;279;837
410620;201701;1683;5611;1235;4510;305;1202;124;427;429;1629
410630;201701;2379;7072;1648;5402;368;1342;157;412;525;1754
410640;201701;4485;12215;3280;9949;833;2918;486;1362;1319;4280
410645;201701;1115;3810;1034;3669;473;1744;233;886;706;2630
410650;201701;2038;6314;1647;5464;542;1919;257;777;799;2696
410655;201701;833;2318;608;1869;80;304;203;570;283;874
410657;201701;761;2105;535;1641;127;432;161;423;288;855
410660;201701;2905;8139;1632;5317;327;1118;170;562;497;1680
410670;201701;882;2434;594;1812;121;381;194;565;315;946
410680;201701;2825;9094;2247;7684;694;2344;510;1888;1204;4232
410685;201701;619;1785;527;1618;83;306;288;848;371;1154
410690;201701;111342;317524;78889;249852;15679;55033;19408;54419;35087;109452
410700;201701;2051;6094;1879;5741;457;1483;826;2409;1283;3892
410710;201701;898;2594;598;1940;142;469;134;380;276;849
410712;201701;779;2363;681;2174;250;864;196;633;446;1497
410715;201701;874;2800;639;2219;135;492;155;525;290;1017
410720;201701;3117;9266;2381;7734;453;1631;387;1129;840;2760
410725;201701;1058;2957;732;2321;127;409;111;331;238;740
410730;201701;476;1369;374;1190;100;342;80;267;180;609
410740;201701;886;2605;637;2102;107;415;260;837;367;1252
410750;201701;1772;5174;1459;4530;293;993;454;1339;747;2332
410752;201701;308;829;154;493;29;95;37;103;66;198
410753;201701;355;1050;219;735;29;100;44;136;73;236
410754;201701;1123;3213;966;2960;66;205;599;1994;665;2199
410755;201701;804;1979;598;1647;67;221;343;884;410;1105
410760;201701;2474;7311;2115;6681;573;1993;607;1872;1180;3865
410765;201701;14260;42843;11090;36680;1975;7410;958;3054;2933;10464
410770;201701;880;2449;620;1933;138;458;110;345;248;803
410773;201701;1317;3702;1172;3494;171;588;845;2459;1016;3047
410775;201701;1358;3881;1227;3684;323;1064;365;1094;688;2158
410780;201701;530;1451;360;1093;88;270;92;318;180;588
410785;201701;769;2393;653;2144;182;647;174;559;356;1206
410790;201701;436;1419;376;1260;108;382;32;80;140;462
410800;201701;2738;6792;2143;5808;303;943;770;1984;1073;2927
410810;201701;321;990;265;874;45;169;101;329;146;498
410820;201701;766;2295;555;1801;130;441;75;249;205;690
410830;201701;28777;80971;22962;70775;6297;21462;7279;21581;13576;43043
410832;201701;977;2799;831;2509;101;390;463;1302;564;1692
410840;201701;6520;18809;4322;14187;992;3553;352;942;1344;4495
410845;201701;1170;3446;990;3083;211;720;388;1176;599;1896
410850;201701;2589;7737;2296;7236;542;1907;839;2670;1381;4577
410855;201701;567;1565;416;1254;72;242;149;412;221;654
410860;201701;3723;10596;3006;9128;570;1866;903;2634;1473;4500
410865;201701;1440;4746;1373;4622;365;1319;727;2514;1092;3833
410870;201701;1235;3657;1130;3498;118;409;777;2425;895;2834
410880;201701;3598;11349;2992;10080;592;2189;428;1490;1020;3679
410890;201701;874;2841;669;2386;183;721;78;262;261;983
410895;201701;1024;3532;922;3298;355;1376;191;646;546;2022
410900;201701;897;2466;598;1873;88;303;177;506;265;809
410910;201701;379;988;272;796;25;83;139;389;164;472
410920;201701;793;2204;641;1951;159;550;212;649;371;1199
410930;201701;1507;4501;1248;3966;352;1271;325;993;677;2264
410940;201701;20436;64512;17123;58225;5273;19437;3267;11378;8540;30815
410950;201701;1764;5647;1638;5439;129;483;1260;4158;1389;4641
410960;201701;7399;20241;4642;15039;1334;4754;1001;3134;2335;7888
410965;201701;1038;3048;810;2583;219;728;270;815;489;1543
410970;201701;3998;11838;3159;10179;866;3229;489;1483;1355;4712
410975;201701;1563;4361;1222;3704;225;777;421;1237;646;2014
410980;201701;6102;17034;4042;12992;676;2434;1146;3527;1822;5961
410990;201701;952;2760;603;2005;191;703;71;185;262;888
411000;201701;473;1403;334;1100;58;216;60;162;118;378
411005;201701;473;1394;300;986;53;197;46;139;99;336
411007;201701;2258;7034;1977;6454;525;1825;543;1762;1068;3587
411010;201701;3918;13176;3550;12354;1056;3925;418;1438;1474;5363
411020;201701;2402;7358;2086;6795;643;2262;621;1963;1264;4225
411030;201701;623;1678;435;1288;75;257;126;324;201;581
411040;201701;745;2139;344;1127;60;210;67;217;127;427
411050;201701;1888;6458;1688;6041;519;2020;246;780;765;2800
411060;201701;1510;4510;1120;3657;234;897;140;440;374;1337
411065;201701;324;966;264;854;55;185;101;329;156;514
411070;201701;5926;17426;4767;15117;1140;3971;1256;3736;2396;7707
411080;201701;2062;6121;1840;5706;450;1547;533;1649;983;3196
411090;201701;769;1954;532;1558;66;232;86;231;152;463
411095;201701;1351;3795;969;2982;122;429;223;600;345;1029
411100;201701;1144;3351;822;2639;127;490;184;571;311;1061
411110;201701;542;1583;283;971;30;123;18;50;48;173
411120;201701;1549;4663;1170;3811;317;1208;265;749;582;1957
411125;201701;3925;12778;3691;12305;914;3247;1348;4540;2262;7787
411130;201701;654;1939;484;1579;101;330;135;473;236;803
411140;201701;2124;7169;1826;6437;420;1550;738;2653;1158;4203
411150;201701;3805;10649;2855;8757;632;2143;301;785;933;2928
411155;201701;920;2518;650;2014;86;294;262;774;348;1068
411160;201701;261;741;206;632;39;130;52;155;91;285
411170;201701;721;2243;582;1920;136;486;190;613;326;1099
411180;201701;5436;15970;4404;13992;911;3149;1453;4637;2364;7786
411190;201701;1353;3886;1105;3379;287;953;224;610;511;1563
411200;201701;4289;12571;3401;11019;896;3191;954;2976;1850;6167
411210;201701;1843;5233;1475;4559;367;1282;168;459;535;1741
411220;201701;920;2630;780;2352;176;606;311;870;487;1476
411230;201701;1215;3371;804;2576;162;549;238;755;400;1304
411240;201701;1478;3538;832;2408;133;415;324;863;457;1278
411250;201701;1897;5599;1572;5012;426;1483;424;1352;850;2835
411260;201701;320;827;209;636;25;79;87;248;112;327
411270;201701;1708;5287;1496;4858;237;884;694;2143;931;3027
411275;201701;1296;3752;1027;3159;240;772;227;636;467;1408
411280;201701;1467;4216;986;3187;179;644;200;606;379;1250
411290;201701;693;2034;526;1697;122;416;157;492;279;908
411295;201701;922;2531;827;2350;120;385;336;961;456;1346
411300;201701;1155;2937;756;2158;69;214;268;708;337;922
411310;201701;801;2193;640;1910;43;148;204;606;247;754
411320;201701;5002;14421;3651;11852;965;3281;664;2009;1629;5290
411325;201701;1476;4645;1313;4299;268;930;624;2076;892;3006
411330;201701;2885;8938;2392;7959;724;2656;565;1931;1289;4587
411340;201701;738;2262;527;1761;40;169;208;662;248;831
411342;201701;687;1908;567;1676;150;473;183;504;333;977
411345;201701;841;2608;761;2453;172;632;359;1136;531;1768
411350;201701;2693;7966;1993;6518;558;1994;199;647;757;2641
411360;201701;570;1424;396;1137;46;164;153;396;199;560
411370;201701;44236;123371;35010;106325;4973;17435;15761;44643;20734;62078
411373;201701;1419;4295;1233;3964;262;995;335;1080;597;2075
411375;201701;1100;2998;810;2445;156;518;228;640;384;1158
411380;201701;1033;2867;652;1969;127;400;174;478;301;878
411390;201701;1725;5054;1346;4194;280;943;333;948;613;1891
411400;201701;2079;5799;1644;4926;318;1047;493;1419;811;2466
411410;201701;1962;5952;1510;4907;348;1243;317;892;665;2135
411420;201701;3879;10834;2649;8332;419;1490;405;1033;824;2523
411430;201701;3225;9480;2689;8600;587;2035;1287;4061;1874;6096
411435;201701;429;1383;361;1204;74;255;134;414;208;669
411440;201701;2679;8520;2369;7853;683;2348;531;1893;1214;4241
411450;201701;2309;6992;2091;6573;446;1422;954;3152;1400;4574
411460;201701;3339;9677;1827;6254;284;1126;93;305;377;1431
411470;201701;781;2324;539;1770;91;335;92;263;183;598
411480;201701;4326;12977;3220;10771;767;2836;470;1475;1237;4311
411490;201701;1353;4103;1128;3668;230;823;269;821;499;1644
411500;201701;1805;4775;1279;3848;244;840;394;1168;638;2008
411510;201701;1964;5804;1619;5093;420;1477;278;842;698;2319
411520;201701;24883;67454;15358;47651;2570;8698;3372;9540;5942;18238
411530;201701;913;2583;655;2110;151;552;158;483;309;1035
411535;201701;483;1447;237;829;27;122;13;29;40;151
411540;201701;2947;7919;2173;6344;515;1686;598;1578;1113;3264
411545;201701;973;3146;871;2944;119;433;551;1919;670;2352
411550;201701;722;1943;588;1728;166;532;93;261;259;793
411560;201701;2171;6359;1481;4794;228;822;120;322;348;1144
411570;201701;6921;18087;5022;15039;1146;3905;1057;3253;2203;7158
411573;201701;808;2368;759;2289;88;280;501;1520;589;1800
411575;201701;1552;4790;1327;4321;317;1089;430;1424;747;2513
411580;201701;3797;10717;2515;8137;317;1229;315;874;632;2103
411585;201701;765;2415;402;1409;78;280;54;172;132;452
411590;201701;347;1050;294;949;36;128;137;416;173;544
411600;201701;304;842;207;687;48;188;74;248;122;436
411605;201701;1634;4456;1080;3286;164;576;394;1152;558;1728
411610;201701;2124;5968;1670;5070;366;1214;632;1865;998;3079
411620;201701;2724;8374;2459;7950;522;1848;1276;4135;1798;5983
411630;201701;506;1352;344;1109;77;294;49;124;126;418
411640;201701;439;1352;340;1114;45;154;108;326;153;480
411650;201701;206;644;154;540;29;113;22;69;51;182
411660;201701;906;2401;655;1955;78;257;312;904;390;1161
411670;201701;1031;2921;817;2442;154;486;266;774;420;1260
411680;201701;1472;4329;1267;3951;249;865;611;1908;860;2773
411690;201701;3256;9466;2562;8178;598;1989;649;2166;1247;4155
411695;201701;681;2205;533;1857;102;377;171;617;273;994
411700;201701;1611;4625;1129;3665;237;856;155;462;392;1318
411705;201701;1776;6159;1572;5751;379;1377;772;2992;1151;4369
411710;201701;1601;4682;1278;4032;331;1120;215;705;546;1825
411720;201701;866;2429;678;2040;110;378;177;486;287;864
411721;201701;742;2173;595;1853;144;465;79;239;223;704
411722;201701;633;1916;412;1409;81;313;90;266;171;579
411725;201701;1358;4323;860;3077;181;682;156;570;337;1252
411727;201701;1673;4924;1210;3904;324;1072;210;646;534;1718
411729;201701;622;1607;429;1243;107;320;98;238;205;558
411730;201701;5270;15085;4432;13493;1486;4658;1100;3360;2586;8018
411740;201701;626;1761;376;1221;70;246;64;187;134;433
411745;201701;893;2547;723;2192;138;438;215;632;353;1070
411750;201701;4888;14445;3758;11914;641;2203;1301;3964;1942;6167
411760;201701;7480;21790;6356;19817;2047;6806;1400;4518;3447;11324
411770;201701;3299;10676;2714;9316;773;2832;430;1432;1203;4264
411780;201701;2836;8631;2608;8243;626;2128;1318;4339;1944;6467
411790;201701;3312;9270;2217;6977;536;1863;441;1333;977;3196
411800;201701;1107;3196;760;2413;109;386;97;267;206;653
411810;201701;1649;4663;1339;4057;283;962;526;1484;809;2446
411820;201701;12485;40406;10575;36326;3697;13133;2512;8891;6209;22024
411830;201701;535;1368;404;1139;116;380;18;64;134;444
411840;201701;10029;28403;7395;23179;1653;5712;1430;4461;3083;10173
411845;201701;483;1485;297;991;52;194;24;69;76;263
411850;201701;7166;21149;5902;18603;1518;5241;1569;4822;3087;10063
411860;201701;848;2585;682;2217;139;492;216;654;355;1146
411870;201701;813;2615;558;1918;113;439;107;334;220;773
411880;201701;2153;6235;1699;5428;454;1653;313;946;767;2599
411885;201701;926;2577;785;2325;138;521;265;718;403;1239
411890;201701;1073;3281;743;2498;117;457;45;117;162;574
411900;201701;920;2857;615;2101;141;478;68;232;209;710
411910;201701;1159;3694;876;3027;227;845;213;674;440;1519
411915;201701;16939;45487;10668;33234;1961;6674;2309;6555;4270;13229
411920;201701;850;2848;745;2588;207;826;90;258;297;1084
411925;201701;583;1660;399;1317;95;328;88;276;183;604
411930;201701;5635;18590;4982;17278;2328;8657;536;1909;2864;10566
411940;201701;3100;10265;2684;9351;742;2750;538;1756;1280;4506
411950;201701;12401;38558;10601;35087;2320;8281;4624;15094;6944;23375
411960;201701;5256;15401;4848;14660;957;3201;1971;5778;2928;8979
411965;201701;530;1475;374;1207;74;277;90;298;164;575
411970;201701;753;2059;652;1916;165;478;301;983;466;1461
411980;201701;1581;4617;1360;4185;329;1065;403;1234;732;2299
411990;201701;31209;96514;24367;82046;5919;22133;6740;21855;12659;43988
411995;201701;2420;7229;2050;6568;602;2189;519;1569;1121;3758
412000;201701;2226;5439;1693;4551;236;788;853;2054;1089;2842
412010;201701;660;2237;531;1936;81;333;124;410;205;743
412015;201701;626;1867;521;1662;93;299;237;764;330;1063
412020;201701;329;1000;228;756;42;137;56;168;98;305
412030;201701;730;2184;524;1748;88;352;149;437;237;789
412033;201701;854;2436;587;1833;83;278;151;461;234;739
412035;201701;951;2602;602;1956;114;395;193;603;307;998
412040;201701;577;1749;431;1437;70;243;72;237;142;480
412050;201701;1737;4925;1314;4104;214;760;300;929;514;1689
412060;201701;6908;23250;6237;21910;1887;7236;1789;6234;3676;13470
412065;201701;781;2365;603;1980;134;485;167;522;301;1007
412070;201701;1282;3401;942;2701;145;454;367;1014;512;1468
412080;201701;1438;4415;898;3204;113;462;30;87;143;549
412085;201701;430;1248;149;519;17;64;12;31;29;95
412090;201701;4550;13624;4211;13010;872;2777;2231;7106;3103;9883
412100;201701;1827;5555;1458;4845;437;1566;310;1045;747;2611
412110;201701;1056;2950;719;2237;149;504;134;439;283;943
412120;201701;1605;5476;1365;4907;346;1363;384;1243;730;2606
412125;201701;614;2007;561;1896;130;477;192;628;322;1105
412130;201701;546;1657;422;1361;103;354;69;213;172;567
412135;201701;494;1379;299;938;54;169;100;291;154;460
412140;201701;1468;4375;1177;3734;265;918;201;590;466;1508
412150;201701;2922;8341;2507;7488;334;1104;1463;4244;1797;5348
412160;201701;1195;3802;745;2618;179;691;76;252;255;943
412170;201701;4471;13507;3681;11985;920;3288;1386;4282;2306;7570
412175;201701;1444;4664;1256;4270;250;913;611;2090;861;3003
412180;201701;1652;4960;1240;4164;261;1023;425;1308;686;2331
412190;201701;3286;9148;2449;7604;441;1496;822;2706;1263;4202
412200;201701;2041;6415;1510;5092;285;1030;446;1531;731;2561
412210;201701;641;1731;377;1184;72;271;52;123;124;394
412215;201701;3500;10614;3140;9946;765;2417;1653;5464;2418;7881
412217;201701;1067;3022;944;2790;84;323;658;1838;742;2161
412220;201701;5588;17827;5205;17118;1461;4809;2125;7281;3586;12090
412230;201701;2818;9160;2417;8334;483;1889;651;2084;1134;3973
412240;201701;8604;21968;5168;15637;941;3256;1012;2829;1953;6085
412250;201701;1835;5331;1558;4771;365;1193;198;519;563;1712
412260;201701;1262;3482;839;2568;119;419;287;763;406;1182
412265;201701;938;2854;821;2643;209;733;310;1000;519;1733
412270;201701;824;2559;551;1886;95;373;187;598;282;971
412280;201701;623;1917;472;1602;171;636;31;73;202;709
412290;201701;988;2769;740;2320;147;503;220;642;367;1145
412300;201701;1614;4898;1414;4502;386;1330;318;956;704;2286
412310;201701;940;2764;793;2507;124;502;344;1086;468;1588
412320;201701;830;2226;616;1828;99;368;204;589;303;957
412330;201701;1447;4149;1053;3315;141;488;442;1402;583;1890
412340;201701;888;2778;607;2048;84;317;104;321;188;638
412350;201701;2150;6642;1646;5510;343;1236;61;139;404;1375
412360;201701;292;849;175;562;16;65;59;170;75;235
412370;201701;857;2523;633;2119;135;488;105;356;240;844
412380;201701;1493;4646;1222;3995;298;1017;249;826;547;1843
412382;201701;652;1810;459;1414;68;226;111;314;179;540
412385;201701;2250;6928;2000;6352;712;2330;515;1695;1227;4025
412390;201701;2056;5823;1856;5494;423;1349;783;2386;1206;3735
412395;201701;746;2127;579;1821;82;297;280;839;362;1136
412400;201701;822;2574;697;2284;174;596;176;597;350;1193
412402;201701;1780;5182;1426;4466;310;1092;297;864;607;1956
412405;201701;3349;9734;2088;6872;331;1249;89;261;420;1510
412410;201701;4850;14366;3909;12563;1023;3801;806;2488;1829;6289
412420;201701;369;1099;243;791;44;153;73;200;117;353
412430;201701;539;1505;384;1207;65;233;105;305;170;538
412440;201701;2977;9057;2303;7750;577;2129;539;1835;1116;3964
412450;201701;255;839;198;686;28;95;20;55;48;150
412460;201701;686;2184;575;1931;153;534;97;332;250;866
412470;201701;1825;6166;1536;5427;502;1863;300;1139;802;3002
412480;201701;1106;3296;760;2421;118;402;101;251;219;653
412490;201701;857;2528;722;2249;138;451;255;743;393;1194
412500;201701;1835;5273;1529;4656;288;984;340;905;628;1889
412510;201701;2143;6957;1725;5938;513;1924;345;1093;858;3017
412520;201701;1388;3964;1046;3244;300;969;129;373;429;1342
412530;201701;546;1609;425;1327;80;271;73;226;153;497
412535;201701;742;2154;513;1614;86;289;107;317;193;606
412540;201701;1195;3384;902;2786;130;480;261;813;391;1293
412545;201701;691;1996;528;1632;89;296;161;443;250;739
412550;201701;29816;88733;21028;69229;4623;16238;4549;14150;9172;30388
412555;201701;244;717;170;548;27;88;36;97;63;185
412560;201701;5218;15891;4037;13257;791;3024;1013;3192;1804;6216
412570;201701;4076;11795;2711;8885;600;2182;385;1287;985;3469
412575;201701;830;2546;662;2125;127;441;202;622;329;1063
412580;201701;1229;3404;877;2698;160;543;320;909;480;1452
412590;201701;444;1296;280;940;59;207;53;168;112;375
412600;201701;1405;4259;1053;3458;222;810;278;854;500;1664
412610;201701;722;2166;463;1514;102;346;137;429;239;775
412620;201701;1181;3691;932;3193;258;1020;165;483;423;1503
412625;201701;8098;23494;6044;19326;1219;4253;568;1705;1787;5958
412627;201701;942;2894;679;2276;204;763;134;441;338;1204
412630;201701;3113;9780;2403;8169;490;1682;658;2135;1148;3817
412635;201701;457;1324;317;1011;68;229;33;76;101;305
412640;201701;863;2592;567;1894;95;345;66;214;161;559
412650;201701;1560;4693;1312;4202;275;1025;397;1163;672;2188
412660;201701;2514;7128;1976;6084;414;1443;425;1160;839;2603
412665;201701;631;1632;358;1101;92;291;80;235;172;526
412667;201701;1630;4619;1294;3957;269;891;394;1165;663;2056
412670;201701;502;1533;405;1350;110;410;65;203;175;613
412680;201701;1328;3948;836;2860;129;489;191;577;320;1066
412690;201701;718;2145;579;1863;144;506;120;391;264;897
412700;201701;1802;5417;1524;4998;476;1767;398;1248;874;3015
412710;201701;6161;19493;5222;17549;1182;4386;1276;3968;2458;8354
412720;201701;1336;4096;976;3225;156;558;172;475;328;1033
412730;201701;2033;6089;1208;4160;265;962;128;416;393;1378
412740;201701;1448;4589;1063;3698;237;923;129;489;366;1412
412750;201701;3991;12017;3540;11252;472;1742;2147;6729;2619;8471
412760;201701;2354;7371;2205;7105;277;1037;1421;4479;1698;5516
412770;201701;10294;28383;5938;19132;832;2931;971;2772;1803;5703
412780;201701;1248;3761;1063;3407;220;784;422;1284;642;2068
412785;201701;2147;5986;1637;4986;403;1237;717;2264;1120;3501
412788;201701;1421;4474;1208;4017;328;1228;324;965;652;2193
412790;201701;1048;3131;733;2417;179;643;134;349;313;992
412795;201701;947;2600;688;2083;130;418;249;741;379;1159
412796;201701;2602;7917;2369;7461;512;1762;954;2858;1466;4620
412800;201701;3018;8530;2287;6965;353;1221;796;2276;1149;3497
412810;201701;11037;29954;6626;20628;896;3218;1523;3963;2419;7181
412820;201701;7090;20645;5301;17117;1187;4060;1323;4336;2510;8396
412830;201701;356;1095;268;905;48;178;55;181;103;359
412840;201701;1777;5007;1427;4300;250;819;328;983;578;1802
412850;201701;2722;7937;2179;6971;428;1562;650;1932;1078;3494
412853;201701;1719;4913;1517;4518;152;505;794;2223;946;2728
412855;201701;1355;3938;1016;3147;213;737;207;522;420;1259
412860;201701;1135;3238;904;2793;237;813;304;879;541;1692
412862;201701;739;1904;487;1450;82;266;128;396;210;662
412863;201701;1137;3811;1109;3762;140;529;802;2680;942;3209
412865;201701;693;2058;520;1713;106;357;159;548;265;905
412870;201701;881;2535;702;2218;266;937;93;278;359;1215
412880;201701;776;2316;601;1940;143;531;45;114;188;645
420005;201701;520;1550;309;1065;54;211;96;315;150;526
420010;201701;3141;8727;2514;7835;318;1043;1688;5334;2006;6377
420020;201701;668;2150;396;1457;50;219;45;154;95;373
420030;201701;443;1149;226;758;51;207;24;81;75;288
420040;201701;663;2120;399;1507;86;364;28;84;114;448
420050;201701;699;1996;465;1506;99;343;185;586;284;929
420055;201701;185;565;103;363;19;73;16;54;35;127
420060;201701;223;721;154;551;22;97;29;86;51;183
420070;201701;1251;3993;952;3271;181;682;357;1242;538;1924
420075;201701;162;433;84;261;17;57;10;19;27;76
420080;201701;571;1792;468;1589;140;496;130;453;270;949
420090;201701;395;1345;283;1066;75;292;52;206;127;498
420100;201701;1132;3589;1040;3456;227;795;602;2008;829;2803
420110;201701;284;965;265;921;70;255;85;292;155;547
420120;201701;266;914;216;799;62;259;58;189;120;448
420125;201701;294;1067;267;1011;75;300;121;455;196;755
420127;201701;442;1269;163;590;38;159;15;44;53;203
420130;201701;1797;6032;1431;5273;392;1598;270;914;662;2512
420140;201701;4082;12138;3005;10012;702;2642;442;1298;1144;3940
420150;201701;596;1668;388;1295;53;197;175;559;228;756
420160;201701;257;709;153;511;30;99;42;140;72;239
420165;201701;211;654;123;426;26;102;27;84;53;186
420170;201701;201;619;131;476;37;164;13;43;50;207
420180;201701;365;1091;205;725;29;108;48;164;77;272
420190;201701;355;1097;184;681;33;130;11;34;44;164
420195;201701;1295;3830;1053;3392;274;965;224;687;498;1652
420200;201701;2364;7264;1459;5247;324;1336;241;817;565;2153
420205;201701;1038;3304;842;2930;183;697;445;1565;628;2262
420207;201701;1435;4205;1006;3334;289;1082;201;639;490;1721
420208;201701;578;1546;320;1106;94;359;85;311;179;670
420209;201701;277;851;175;606;30;119;76;254;106;373
420210;201701;1803;5335;1173;4297;281;1229;415;1426;696;2655
420213;201701;759;2675;709;2563;172;686;370;1338;542;2024
420215;201701;307;980;206;733;57;210;16;66;73;276
420220;201701;164;569;135;509;36;149;45;160;81;309
420230;201701;4060;11941;3098;10233;603;2378;1108;3497;1711;5875
420240;201701;10499;29121;6846;22310;1071;4141;2930;8660;4001;12801
420243;201701;587;1751;464;1515;92;316;161;525;253;841
420245;201701;1232;3619;845;2829;131;520;306;917;437;1437
420250;201701;492;1580;440;1481;97;394;196;621;293;1015
420253;201701;473;1245;362;1096;39;116;216;686;255;802
420257;201701;282;773;174;575;39;132;70;233;109;365
420260;201701;1113;3564;902;3171;194;755;362;1270;556;2025
420270;201701;651;1924;245;842;38;142;58;173;96;315
420280;201701;2053;5553;1257;4141;274;1007;385;1200;659;2207
420285;201701;146;425;71;261;10;46;4;8;14;54
420287;201701;492;1434;405;1301;133;464;126;409;259;873
420290;201701;5667;17024;3915;12992;785;2796;1133;3465;1918;6261
420300;201701;6502;19375;4139;14238;890;3432;753;2391;1643;5823
420310;201701;783;2082;619;1770;74;249;446;1226;520;1475
420315;201701;918;2885;707;2468;222;823;213;741;435;1564
420320;201701;4346;13404;3586;12036;1111;4148;1113;3669;2224;7817
420325;201701;192;637;166;578;32;120;65;214;97;334
420330;201701;918;3130;679;2543;140;583;191;671;331;1254
420340;201701;1379;4221;1034;3444;205;759;81;240;286;999
420350;201701;1438;4223;1044;3437;261;945;389;1226;650;2171
420360;201701;2860;8648;1759;6244;367;1477;153;508;520;1985
420370;201701;1714;4946;1354;4317;173;618;906;2838;1079;3456
420380;201701;5137;15253;3428;11513;797;2926;868;2815;1665;5741
420390;201701;1189;3363;696;2333;134;515;131;348;265;863
420395;201701;1270;3897;867;2975;130;509;93;273;223;782
420400;201701;1158;3424;814;2739;185;711;163;495;348;1206
420410;201701;688;1845;477;1480;79;287;275;821;354;1108
420415;201701;457;1407;333;1120;91;311;93;321;184;632
420417;201701;686;2180;556;1860;106;382;242;795;348;1177
420419;201701;304;995;214;789;76;306;13;53;89;359
420420;201701;10126;30730;8147;26859;2829;10110;1752;5446;4581;15556
420425;201701;1161;3094;785;2402;86;336;336;973;422;1309
420430;201701;3253;9910;2134;7267;458;1730;639;2117;1097;3847
420435;201701;266;785;166;566;36;146;74;238;110;384
420440;201701;764;2369;441;1507;165;613;90;279;255;892
420445;201701;375;1073;248;788;49;171;80;239;129;410
420450;201701;748;2284;529;1794;106;399;124;390;230;789
420455;201701;1881;5500;1580;4982;259;1024;728;2149;987;3173
420460;201701;8523;24801;6553;21338;1474;5521;2438;7527;3912;13048
420470;201701;1021;2676;581;1844;112;399;176;525;288;924
420475;201701;98;284;50;177;19;65;5;15;24;80
420480;201701;4756;13709;3421;11158;820;2888;633;2049;1453;4937
420490;201701;630;1653;349;1182;86;323;68;247;154;570
420500;201701;1418;4499;1077;3826;348;1387;335;1172;683;2559
420510;201701;119;443;91;368;21;98;45;182;66;280
420515;201701;75;232;59;207;13;53;16;60;29;113
420517;201701;829;2530;726;2345;122;440;416;1303;538;1743
420519;201701;462;1203;297;906;53;175;73;206;126;381
420520;201701;639;1647;339;1110;63;211;65;172;128;383
420530;201701;1150;3639;826;2930;186;758;207;640;393;1398
420535;201701;258;735;127;436;27;88;13;57;40;145
420540;201701;21916;61127;15281;47370;3367;11536;3968;10492;7335;22028
420543;201701;355;923;281;805;46;105;183;547;229;652
420545;201701;1541;4792;1225;4104;285;1054;367;1171;652;2225
420550;201701;3886;12127;2843;10052;766;3198;507;1714;1273;4912
420555;201701;351;1056;269;890;48;174;96;300;144;474
420560;201701;470;1380;354;1169;66;227;171;544;237;771
420570;201701;2104;6624;1608;5521;386;1499;511;1633;897;3132
420580;201701;1524;4567;1201;4022;284;1102;487;1606;771;2708
420590;201701;3183;9469;2080;6914;431;1588;334;930;765;2518
420600;201701;898;2912;816;2742;155;546;461;1597;616;2143
420610;201701;476;1445;270;981;64;258;59;208;123;466
420620;201701;536;1653;478;1539;127;438;134;432;261;870
420630;201701;953;2914;695;2296;165;600;251;760;416;1360
420640;201701;762;2268;381;1384;96;392;31;111;127;503
420650;201701;2392;6959;1549;5279;258;935;374;1166;632;2101
420660;201701;459;1352;325;1072;59;214;96;317;155;531
420665;201701;667;1857;451;1467;68;254;151;445;219;699
420670;201701;1628;4790;1147;3791;226;903;268;791;494;1694
420675;201701;182;600;138;488;26;108;31;105;57;213
420680;201701;438;1043;247;755;42;141;87;259;129;400
420690;201701;822;2840;620;2281;108;430;99;303;207;733
420700;201701;3039;8952;2355;7582;456;1612;785;2412;1241;4024
420710;201701;599;1980;457;1667;120;503;143;491;263;994
420720;201701;1621;4657;1272;4159;376;1288;537;1769;913;3057
420730;201701;3037;9069;2496;8135;542;1950;1063;3375;1605;5325
420740;201701;794;2445;630;2116;191;690;195;629;386;1319
420750;201701;2042;6533;1543;5394;248;970;486;1546;734;2516
420757;201701;94;215;36;127;6;23;16;58;22;81
420760;201701;375;1177;196;670;44;157;25;74;69;231
420765;201701;528;1669;277;1030;67;268;51;185;118;453
420768;201701;1172;3993;943;3526;384;1416;319;1290;703;2706
420770;201701;533;1601;328;1202;75;324;57;203;132;527
420775;201701;622;1873;357;1234;77;290;48;157;125;447
420780;201701;1397;4207;846;2902;147;532;127;410;274;942
420785;201701;260;789;200;642;31;108;53;147;84;255
420790;201701;1209;4115;952;3548;258;1065;353;1249;611;2314
420800;201701;873;2431;444;1457;88;314;140;450;228;764
420810;201701;1942;6557;1573;5776;506;2100;325;1117;831;3217
420820;201701;8331;24762;5854;20523;1443;5648;1504;5190;2947;10838
420830;201701;2703;8390;2216;7468;626;2315;725;2419;1351;4734
420840;201701;987;2870;481;1700;89;358;86;286;175;644
420845;201701;1399;4119;940;3281;243;1002;201;665;444;1667
420850;201701;1472;4653;906;3381;206;859;63;219;269;1078
420860;201701;371;1046;217;751;62;237;36;129;98;366
420870;201701;1037;2926;819;2580;288;1038;211;600;499;1638
420880;201701;973;3288;763;2737;167;670;130;406;297;1076
420890;201701;9017;24185;4748;15625;820;3003;1062;3072;1882;6075
420895;201701;204;590;118;385;35;113;18;55;53;168
420900;201701;1742;4898;1132;3749;228;867;287;862;515;1729
420910;201701;23921;70130;16588;55960;3050;11610;5061;15917;8111;27527
420915;201701;532;2093;385;1653;77;352;166;657;243;1009
420917;201701;472;1438;217;714;38;145;79;229;117;374
420920;201701;168;489;77;271;11;46;11;38;22;84
420930;201701;17840;50660;13571;43296;2874;10163;5267;16165;8141;26328
420940;201701;2738;8118;2056;6784;546;2007;156;457;702;2464
420945;201701;196;592;130;444;28;114;33;102;61;216
420950;201701;558;1541;285;1006;38;174;58;199;96;373
420960;201701;901;2558;713;2226;136;472;280;828;416;1300
420970;201701;2392;7567;1973;6780;638;2373;427;1511;1065;3884
420980;201701;436;1282;336;1132;118;430;122;451;240;881
420985;201701;476;1346;221;787;48;206;54;178;102;384
420990;201701;767;2151;431;1480;79;301;61;179;140;480
421000;201701;530;1818;345;1341;74;308;57;187;131;495
421003;201701;667;1782;248;833;28;98;21;53;49;151
421005;201701;138;418;105;362;26;95;51;188;77;283
421010;201701;4912;13917;3472;11388;815;2983;726;2197;1541;5180
421020;201701;431;1318;317;1115;34;143;180;623;214;766
421030;201701;721;2575;633;2350;209;867;93;327;302;1194
421040;201701;886;2238;568;1752;94;335;273;817;367;1152
421050;201701;1520;4343;889;2985;188;696;172;503;360;1199
421055;201701;196;550;104;333;25;83;19;40;44;123
421060;201701;523;1718;354;1281;88;352;105;373;193;725
421070;201701;650;2062;424;1500;87;332;60;211;147;543
421080;201701;694;3207;617;3093;87;280;471;2627;558;2907
421085;201701;493;1374;254;887;51;200;67;214;118;414
421090;201701;389;1077;183;606;27;103;47;143;74;246
421100;201701;952;2551;505;1607;126;427;48;147;174;574
421105;201701;1432;4294;1151;3818;259;921;359;1240;618;2161
421110;201701;937;3320;857;3137;330;1265;184;616;514;1881
421120;201701;1257;4042;850;3057;123;520;196;610;319;1130
421125;201701;402;1107;300;939;84;289;89;249;173;538
421130;201701;3095;10214;2675;9382;876;3308;896;3223;1772;6531
421140;201701;312;895;231;730;44;142;88;253;132;395
421145;201701;536;1670;334;1129;49;168;92;307;141;475
421150;201701;613;1757;446;1490;96;374;172;541;268;915
421160;201701;1136;3136;564;1847;113;419;178;548;291;967
421165;201701;220;747;186;668;27;89;86;326;113;415
421170;201701;1274;3616;1013;3211;167;572;583;1849;750;2421
421175;201701;1167;3315;810;2654;159;638;292;855;451;1493
421180;201701;527;1456;270;910;55;212;48;156;103;368
421185;201701;401;1103;283;883;57;177;120;398;177;575
421187;201701;328;987;228;752;38;129;87;269;125;398
421189;201701;400;1235;317;1057;67;245;85;268;152;513
421190;201701;11205;31718;6875;23283;1467;5546;1031;3275;2498;8821
421200;201701;895;2918;750;2618;176;658;243;800;419;1458
421205;201701;205;620;148;500;38;153;38;111;76;264
421210;201701;1376;4145;1006;3311;264;890;250;837;514;1727
421220;201701;1698;5784;1499;5327;484;1911;227;692;711;2603
421223;201701;505;1583;368;1308;84;323;131;483;215;806
421225;201701;1084;3447;923;3109;206;748;366;1257;572;2005
421227;201701;762;2408;675;2266;139;536;381;1241;520;1777
421230;201701;444;1422;376;1303;87;320;163;552;250;872
421240;201701;392;1231;214;780;25;120;32;96;57;216
421250;201701;1553;4465;1014;3531;278;1043;199;695;477;1738
421260;201701;351;989;87;311;19;63;15;54;34;117
421265;201701;786;2347;694;2203;110;403;424;1314;534;1717
421270;201701;729;1997;382;1264;78;256;83;298;161;554
421280;201701;1529;4840;1212;4272;311;1258;489;1677;800;2935
421290;201701;948;2624;587;1874;95;341;105;296;200;637
421300;201701;288;863;219;719;53;220;89;259;142;479
421310;201701;203;627;158;514;29;101;50;166;79;267
421315;201701;317;956;186;662;33;124;25;86;58;210
421320;201701;603;1827;370;1270;67;238;60;149;127;387
421330;201701;561;1804;426;1540;137;548;88;330;225;878
421335;201701;465;1578;392;1428;88;366;79;303;167;669
421340;201701;1706;4799;1343;4225;185;724;728;2242;913;2966
421350;201701;1032;3334;874;3020;147;616;479;1583;626;2199
421360;201701;2740;7860;1747;5936;360;1414;496;1565;856;2979
421370;201701;530;1791;403;1498;124;507;118;428;242;935
421380;201701;884;2538;751;2292;121;421;380;1110;501;1531
421390;201701;177;497;76;257;21;79;22;65;43;144
421400;201701;278;934;200;784;56;250;69;247;125;497
421410;201701;302;860;185;628;25;98;74;249;99;347
421415;201701;362;1171;160;590;34;136;26;91;60;227
421420;201701;760;2270;577;1879;93;343;228;676;321;1019
421430;201701;198;643;151;545;35;139;36;131;71;270
421440;201701;822;2326;556;1876;113;431;233;784;346;1215
421450;201701;423;1294;257;922;38;152;26;103;64;255
421460;201701;576;1600;305;1097;59;234;68;253;127;487
421470;201701;381;1255;296;1071;80;330;79;265;159;595
421480;201701;2994;8418;1965;6627;661;2634;265;695;926;3329
421490;201701;270;806;126;475;25;109;21;74;46;183
421500;201701;1994;6812;1648;6084;535;2200;219;799;754;2999
421505;201701;347;1135;304;1037;70;246;135;461;205;707
421507;201701;531;1586;351;1214;83;311;87;302;170;613
421510;201701;171;550;134;474;23;101;61;170;84;271
421520;201701;770;2093;509;1542;68;251;200;534;268;785
421530;201701;304;952;176;658;32;147;31;103;63;250
421535;201701;647;1873;355;1267;39;159;151;500;190;659
421540;201701;325;871;243;730;57;188;87;235;144;423
421545;201701;783;2449;570;2044;144;580;156;542;300;1122
421550;201701;2000;6244;1680;5700;493;1928;545;1730;1038;3658
421555;201701;316;913;111;387;17;70;15;42;32;112
421560;201701;170;535;78;278;15;60;15;52;30;112
421565;201701;751;2192;667;2091;200;701;322;1032;522;1733
421567;201701;582;2118;507;1940;257;1009;120;468;377;1477
421568;201701;504;1524;342;1154;71;255;97;323;168;578
421569;201701;231;692;103;375;22;82;16;59;38;141
421570;201701;1336;3998;777;2676;180;655;124;412;304;1067
421575;201701;346;1188;304;1063;50;186;158;542;208;728
421580;201701;2904;9154;2204;7621;516;2069;594;1830;1110;3899
421590;201701;213;644;168;557;25;89;87;281;112;370
421600;201701;494;1537;380;1269;87;319;86;255;173;574
421605;201701;591;1813;434;1517;84;334;128;431;212;765
421610;201701;1350;3675;953;2938;149;517;357;1049;506;1566
421620;201701;4344;13064;2887;10044;792;2943;762;2659;1554;5602
421625;201701;373;1028;155;524;34;110;17;56;51;166
421630;201701;2889;8537;1648;5636;328;1264;262;836;590;2100
421635;201701;217;654;111;376;15;65;28;71;43;136
421640;201701;1042;3039;738;2457;154;541;257;846;411;1387
421650;201701;2114;6711;1587;5526;415;1655;197;575;612;2230
421660;201701;7276;23590;6099;21234;1363;5291;1953;6341;3316;11632
421670;201701;1034;3073;719;2381;181;684;204;634;385;1318
421680;201701;1122;3582;920;3151;310;1135;208;689;518;1824
421690;201701;1427;4638;1073;3822;249;997;121;375;370;1372
421700;201701;462;1503;251;954;44;183;64;222;108;405
421710;201701;206;684;96;354;18;70;25;80;43;150
421715;201701;220;586;116;379;28;93;39;118;67;211
421720;201701;1887;5544;1175;4097;310;1199;171;519;481;1718
421725;201701;132;400;98;326;36;131;21;58;57;189
421730;201701;576;1640;278;928;41;144;71;214;112;358
421740;201701;676;2186;466;1661;109;441;83;281;192;722
421750;201701;977;2560;593;1819;105;350;213;595;318;945
421755;201701;303;874;171;555;37;136;50;152;87;288
421760;201701;902;2730;450;1618;71;263;82;286;153;549
421770;201701;2804;8350;2116;7015;507;1747;691;2409;1198;4156
421775;201701;464;1350;324;1089;57;213;112;360;169;573
421780;201701;980;3366;751;2805;189;826;204;690;393;1516
421790;201701;760;2029;445;1549;183;700;100;300;283;1000
421795;201701;344;1001;217;692;40;137;60;182;100;319
421800;201701;2610;7808;1958;6566;444;1624;727;2326;1171;3950
421810;201701;571;1743;407;1406;111;426;64;204;175;630
421820;201701;976;2833;593;2015;99;359;81;229;180;588
421825;201701;1430;4488;1345;4333;165;608;969;3052;1134;3660
421830;201701;2454;8287;2162;7695;548;2161;739;2485;1287;4646
421835;201701;161;476;120;417;17;76;78;264;95;340
421840;201701;282;883;199;700;43;181;66;204;109;385
421850;201701;417;1342;247;901;41;172;50;172;91;344
421860;201701;296;906;191;687;37;151;45;132;82;283
421870;201701;3640;10306;2545;8104;741;2584;543;1688;1284;4272
421875;201701;391;1152;181;660;32;129;20;63;52;192
421880;201701;809;2463;607;2026;143;530;122;379;265;909
421885;201701;288;906;236;821;74;270;65;216;139;486
421890;201701;814;2775;695;2536;241;1021;212;702;453;1723
421895;201701;374;1175;331;1103;67;247;192;641;259;888
421900;201701;936;2588;592;1892;156;524;151;461;307;985
421910;201701;478;1496;337;1181;71;303;62;181;133;484
421915;201701;488;1466;301;1026;59;195;53;180;112;375
421917;201701;585;1658;408;1393;134;525;112;369;246;894
421920;201701;675;1939;442;1615;223;831;117;457;340;1288
421930;201701;2977;7775;1599;5356;393;1436;232;704;625;2140
421935;201701;627;2030;475;1695;97;401;164;544;261;945
421940;201701;227;770;140;520;21;97;30;96;51;193
421950;201701;3429;9283;1637;5498;369;1353;206;690;575;2043
421960;201701;179;525;134;448;25;95;28;96;53;191
421970;201701;2300;6243;1348;4278;358;1193;357;1051;715;2244
421985;201701;448;1153;247;756;36;132;75;232;111;364
422000;201701;1262;3770;1050;3374;274;968;400;1287;674;2255
430003;201701;590;1880;499;1712;140;539;153;508;293;1047
430005;201701;325;956;230;770;47;172;96;307;143;479
430010;201701;2006;5498;1573;4746;375;1225;691;2105;1066;3330
430020;201701;644;1597;535;1449;85;273;329;855;414;1128
430030;201701;1034;2665;741;2135;233;702;148;413;381;1115
430040;201701;10597;28152;7655;22656;2045;6773;818;2286;2863;9059
430045;201701;683;1849;513;1511;81;253;213;619;294;872
430047;201701;283;663;130;386;16;51;43;126;59;177
430050;201701;1023;2797;589;1871;121;396;132;409;253;805
430055;201701;297;781;156;476;10;35;70;206;80;241
430057;201701;71;174;39;110;5;11;6;9;11;20
430060;201701;16476;51894;14216;48051;3918;14375;5550;18936;9468;33311
430063;201701;961;2829;755;2382;178;575;363;1160;541;1735
430064;201701;1198;3588;966;3161;258;881;306;1006;564;1887
430066;201701;169;392;115;306;8;25;63;164;71;189
430070;201701;634;1692;170;570;24;93;16;43;40;136
430080;201701;709;1992;430;1437;107;396;126;381;233;777
430085;201701;937;2399;581;1764;112;385;152;479;264;864
430087;201701;776;2456;691;2285;139;527;327;1008;466;1535
430090;201701;622;1641;241;790;31;118;57;182;88;300
430100;201701;844;2205;431;1352;105;349;118;323;223;672
430105;201701;1006;2880;663;2245;163;620;224;749;387;1369
430107;201701;216;708;162;564;30;117;41;130;71;247
430110;201701;1852;5231;1517;4721;343;1138;696;2085;1039;3223
430120;201701;1588;4812;1153;3884;263;916;461;1584;724;2500
430130;201701;3597;9401;3009;8468;870;2532;996;2886;1866;5418
430140;201701;1150;3528;764;2638;207;755;228;771;435;1526
430150;201701;714;1901;459;1406;106;354;117;373;223;727
430155;201701;316;873;185;598;27;99;47;140;74;239
430160;201701;16398;46954;14200;43256;3366;11068;5550;17261;8916;28329
430163;201701;1908;5519;1528;4863;228;805;827;2629;1055;3434
430165;201701;462;1127;118;393;14;49;15;37;29;86
430170;201701;915;2607;365;1315;60;245;39;112;99;357
430175;201701;866;2716;731;2402;184;585;314;1080;498;1665
430180;201701;772;2151;652;1945;131;454;340;963;471;1417
430185;201701;500;1332;302;947;55;186;100;261;155;447
430187;201701;644;1908;513;1628;113;402;175;532;288;934
430190;201701;1581;4716;1369;4286;277;944;692;2120;969;3064
430192;201701;181;552;85;270;7;26;14;39;21;65
430195;201701;383;1163;96;324;10;37;2;7;12;44
430200;201701;1330;4240;1143;3846;348;1218;303;1017;651;2235
430205;201701;546;1566;415;1307;42;158;281;871;323;1029
430210;201701;5830;15451;3686;11018;545;1815;1122;2749;1667;4564
430215;201701;351;968;241;735;47;158;93;263;140;421
430220;201701;643;1657;233;791;34;136;41;131;75;267
430222;201701;259;811;208;695;40;153;93;293;133;446
430223;201701;356;999;292;885;61;181;139;431;200;612
430225;201701;34;83;15;41;4;11;6;15;10;26
430230;201701;1593;4764;1525;4678;263;725;1176;3741;1439;4466
430235;201701;262;844;213;730;52;207;66;208;118;415
430237;201701;525;1336;381;1094;42;142;224;608;266;750
430240;201701;997;2533;677;2021;74;273;346;990;420;1263
430245;201701;797;2487;622;2124;171;581;256;925;427;1506
430250;201701;1065;3099;954;2918;331;1097;111;309;442;1406
430258;201701;163;462;121;389;12;42;50;169;62;211
430260;201701;673;1933;515;1622;83;281;264;859;347;1140
430265;201701;270;836;214;732;51;175;34;120;85;295
430270;201701;2816;7787;2429;7147;354;1216;1448;4114;1802;5330
430280;201701;4646;12339;3735;10773;815;2430;1630;4755;2445;7185
430290;201701;2414;6286;2223;6002;115;358;1910;5124;2025;5482
430300;201701;8825;25762;7377;23000;1609;5425;3331;10526;4940;15951
430310;201701;6556;19432;5060;16580;1130;4109;1958;6102;3088;10211
430320;201701;823;2401;525;1751;96;299;238;824;334;1123
430330;201701;661;1757;516;1481;132;380;210;560;342;940
430340;201701;698;1718;358;1140;71;228;168;531;239;759
430350;201701;5851;17643;5019;15889;1800;5904;1507;4645;3307;10549
430355;201701;382;961;148;463;25;87;17;51;42;138
430360;201701;969;2574;777;2233;166;523;288;770;454;1293
430367;201701;232;637;153;479;37;141;51;146;88;287
430370;201701;522;1433;328;1048;76;259;68;198;144;457
430380;201701;703;1855;396;1286;122;447;96;299;218;746
430390;201701;3769;10438;2405;7680;429;1532;297;897;726;2429
430400;201701;1315;3175;982;2630;293;780;381;989;674;1769
430410;201701;583;1553;415;1259;69;232;216;638;285;870
430420;201701;3427;9898;2740;8366;746;2377;915;2739;1661;5116
430430;201701;661;1814;426;1374;107;372;98;318;205;690
430435;201701;2001;5391;1478;4461;377;1167;448;1404;825;2571
430440;201701;4002;12444;3119;10426;644;2282;1286;4388;1930;6670
430450;201701;6899;19259;5697;16971;1701;5348;1633;4964;3334;10312
430460;201701;27582;81641;21419;70735;5789;21116;6242;20320;12031;41436
430461;201701;509;1345;166;529;23;73;40;123;63;196
430462;201701;284;802;192;645;32;119;36;135;68;254
430463;201701;3950;12549;3409;11516;758;2775;1615;5509;2373;8284
430465;201701;569;1592;499;1469;119;377;277;793;396;1170
430466;201701;3477;9346;3009;8619;665;2091;1574;4333;2239;6424
430467;201701;455;1343;381;1194;75;255;146;431;221;686
430468;201701;1342;3741;1128;3393;262;842;466;1359;728;2201
430469;201701;486;1317;65;218;9;26;9;21;18;47
430470;201701;7609;20249;5384;16569;1576;5154;990;3123;2566;8277
430471;201701;485;1613;440;1515;130;451;120;430;250;881
430480;201701;990;2627;526;1680;89;304;98;282;187;586
430485;201701;146;415;77;247;12;45;15;36;27;81
430490;201701;292;849;196;642;41;145;82;281;123;426
430495;201701;370;1103;247;854;51;192;73;232;124;424
430500;201701;1122;3099;932;2800;206;691;441;1279;647;1970
430510;201701;21599;61911;16991;53095;4952;16960;4983;14597;9935;31557
430511;201701;379;1175;169;592;32;117;14;32;46;149
430512;201701;1033;2664;889;2418;236;694;256;726;492;1420
430513;201701;795;2053;455;1329;105;333;165;449;270;782
430515;201701;457;1311;327;1047;51;157;147;490;198;647
430517;201701;1140;3579;940;3167;178;621;460;1575;638;2196
430520;201701;1467;4054;924;2895;185;663;212;600;397;1263
430530;201701;1087;2898;510;1624;68;252;130;369;198;621
430535;201701;2413;7138;1832;6013;386;1387;685;2193;1071;3580
430537;201701;461;1497;388;1331;36;142;265;896;301;1038
430540;201701;704;1563;467;1239;85;240;277;725;362;965
430543;201701;466;1179;409;1119;64;183;288;805;352;988
430544;201701;648;2054;538;1803;116;436;258;824;374;1260
430545;201701;1268;4094;1116;3914;372;1418;481;1683;853;3101
430550;201701;609;1723;357;1172;80;279;64;186;144;465
430558;201701;81;242;51;163;11;40;14;33;25;73
430560;201701;390;934;185;561;13;48;58;169;71;217
430570;201701;1072;2758;694;2021;135;455;282;707;417;1162
430580;201701;1189;2973;750;2264;107;358;365;1121;472;1479
430583;201701;170;453;42;130;5;14;5;18;10;32
430585;201701;305;768;182;522;30;105;77;192;107;297
430587;201701;155;490;120;397;29;94;28;102;57;196
430590;201701;1213;3292;1109;3118;99;324;859;2364;958;2688
430593;201701;23;85;21;78;5;20;8;28;13;48
430595;201701;291;834;84;288;10;44;10;27;20;71
430597;201701;332;969;234;735;31;108;62;162;93;270
430600;201701;1941;5194;1033;3132;197;650;285;800;482;1450
430605;201701;1247;3724;975;3172;169;636;403;1304;572;1940
430607;201701;760;1800;562;1507;55;158;344;953;399;1111
430610;201701;7299;19596;5640;17024;1684;5561;1241;3786;2925;9347
430613;201701;273;669;111;343;10;27;24;63;34;90
430620;201701;672;1878;558;1657;142;452;227;650;369;1102
430630;201701;382;1177;179;598;27;93;27;74;54;167
430632;201701;642;1805;325;1034;49;174;106;298;155;472
430635;201701;583;1665;453;1397;91;314;230;685;321;999
430637;201701;481;1360;427;1254;69;229;239;659;308;888
430640;201701;1571;4188;753;2433;105;353;74;206;179;559
430642;201701;458;1190;300;911;50;149;121;378;171;527
430645;201701;280;643;110;313;20;54;28;85;48;139
430650;201701;1753;5650;1498;5124;315;1121;801;2785;1116;3906
430655;201701;157;402;135;359;32;107;65;141;97;248
430660;201701;5312;14835;4298;13073;996;3262;1818;5504;2814;8766
430670;201701;436;1266;409;1214;39;119;307;936;346;1055
430673;201701;717;1680;322;968;70;215;87;258;157;473
430675;201701;248;738;78;277;13;60;16;44;29;104
430676;201701;3573;10475;2900;9232;714;2435;918;2963;1632;5398
430680;201701;1083;3073;660;2186;131;448;134;399;265;847
430690;201701;3940;11322;3197;9869;1034;3381;700;2141;1734;5522
430692;201701;252;832;193;724;19;90;125;451;144;541
430693;201701;1173;3207;731;2301;163;571;135;405;298;976
430695;201701;561;1516;367;1106;69;233;145;414;214;647
430697;201701;440;1238;319;1018;69;231;118;389;187;620
430700;201701;9243;23757;4815;15490;863;3201;331;1032;1194;4233
430705;201701;264;804;214;690;60;205;62;188;122;393
430710;201701;1677;4248;1261;3533;256;804;506;1419;762;2223
430720;201701;768;1923;504;1515;119;385;165;498;284;883
430730;201701;1580;4101;1024;3165;195;637;426;1356;621;1993
430740;201701;582;1612;342;1121;68;237;61;212;129;449
430745;201701;487;1392;242;782;32;100;38;127;70;227
430750;201701;1447;4002;1127;3446;213;702;563;1693;776;2395
430755;201701;469;1249;300;902;26;98;137;375;163;473
430760;201701;2766;6815;1861;5520;446;1488;688;2114;1134;3602
430770;201701;6149;17674;4915;15400;857;2926;2621;8069;3478;10995
430780;201701;2443;6469;1508;4752;294;1000;436;1371;730;2371
430781;201701;421;1238;307;1002;69;231;85;283;154;514
430783;201701;542;1306;332;951;46;143;152;415;198;558
430786;201701;75;252;50;196;8;30;11;39;19;69
430790;201701;4403;12054;3060;9380;680;2291;1120;3212;1800;5503
430800;201701;866;2412;580;1782;119;387;195;579;314;966
430805;201701;549;1525;335;1062;34;104;156;485;190;589
430807;201701;449;1268;304;959;58;208;84;254;142;462
430810;201701;704;1906;241;834;44;161;39;135;83;296
430820;201701;1363;3918;786;2662;173;609;141;466;314;1075
430825;201701;308;835;128;390;25;66;23;49;48;115
430830;201701;1606;4971;1473;4785;240;855;938;3011;1178;3866
430840;201701;965;2890;844;2672;217;680;379;1226;596;1906
430843;201701;79;200;38;117;5;15;14;40;19;55
430845;201701;259;765;216;669;97;337;27;58;124;395
430850;201701;2342;6882;1978;6187;526;1799;758;2324;1284;4123
430860;201701;1022;2665;493;1563;101;376;175;519;276;895
430865;201701;592;1563;535;1474;176;502;242;659;418;1161
430870;201701;727;2010;381;1253;81;277;68;189;149;466
430880;201701;1136;3167;800;2503;218;726;218;711;436;1437
430885;201701;241;568;132;405;14;51;92;289;106;340
430890;201701;1641;4426;1119;3421;91;351;184;478;275;829
430900;201701;2657;6967;2071;5971;412;1372;893;2444;1305;3816
430905;201701;1063;3008;688;2226;163;552;146;448;309;1000
430910;201701;1582;4596;1056;3447;225;811;364;1076;589;1887
430912;201701;456;1288;342;1079;48;170;210;656;258;826
430915;201701;576;1783;413;1479;145;565;93;361;238;926
430920;201701;17195;51184;15110;47362;2748;9548;8568;26117;11316;35665
430925;201701;136;305;58;166;10;30;17;52;27;82
430930;201701;9498;26322;6403;20692;1743;6006;1333;4606;3076;10612
430940;201701;1217;3700;693;2386;193;723;84;239;277;962
430950;201701;886;2399;591;1805;139;457;215;596;354;1053
430955;201701;165;479;70;233;13;54;12;32;25;86
430957;201701;232;774;194;695;38;130;91;331;129;461
430960;201701;1353;3565;1071;3065;245;787;494;1419;739;2206
430965;201701;1534;4210;1297;3816;97;348;941;2686;1038;3034
430970;201701;402;1093;237;749;39;124;90;270;129;394
430975;201701;554;1808;437;1530;97;363;159;571;256;934
430980;201701;356;912;230;714;53;168;77;238;130;406
430990;201701;559;1757;364;1245;63;238;111;371;174;609
430995;201701;602;1711;446;1398;117;364;165;500;282;864
431000;201701;1509;3813;737;2266;115;379;47;122;162;501
431010;201701;2624;7265;1562;5236;257;976;172;504;429;1480
431020;201701;10036;24501;6681;18807;1677;5012;1708;4654;3385;9666
431030;201701;324;924;157;547;35;130;16;53;51;183
431033;201701;2545;7899;2221;7390;597;2001;972;3521;1569;5522
431036;201701;218;564;93;298;15;49;18;44;33;93
431040;201701;904;2553;706;2193;132;494;344;1000;476;1494
431041;201701;494;1288;428;1195;121;359;176;503;297;862
431043;201701;474;1297;261;894;100;368;56;174;156;542
431046;201701;103;294;73;229;8;30;20;61;28;91
431050;201701;1594;4066;1178;3366;282;844;517;1481;799;2325
431053;201701;579;1823;458;1554;142;515;103;354;245;869
431055;201701;666;1763;613;1682;54;167;463;1254;517;1421
431057;201701;360;1050;222;745;42;160;60;181;102;341
431060;201701;5298;15840;4683;14804;1573;5209;1280;4219;2853;9428
431065;201701;531;1511;374;1196;63;221;115;334;178;555
431070;201701;610;1782;352;1161;82;283;59;153;141;436
431075;201701;237;744;177;609;33;131;54;194;87;325
431080;201701;678;2049;483;1598;103;360;125;401;228;761
431085;201701;756;2089;596;1737;104;296;330;961;434;1257
431087;201701;526;1512;470;1399;43;126;324;977;367;1103
431090;201701;472;1175;199;614;48;165;38;109;86;274
431100;201701;3229;8894;2609;7857;690;2293;859;2497;1549;4790
431110;201701;1455;3813;1094;3098;254;752;360;967;614;1719
431112;201701;545;1753;498;1656;114;388;241;776;355;1164
431113;201701;451;1328;364;1152;112;368;102;340;214;708
431115;201701;1342;3826;1164;3527;202;639;651;1966;853;2605
431120;201701;2631;7967;1993;6658;608;2356;610;1865;1218;4221
431123;201701;432;1248;282;944;65;209;134;462;199;671
431125;201701;1314;3942;933;3118;285;960;201;760;486;1720
431127;201701;253;684;59;197;9;25;10;26;19;51
431130;201701;3352;9642;2328;7604;521;1810;682;2262;1203;4072
431140;201701;4901;11978;2761;8299;381;1292;787;2162;1168;3454
431142;201701;459;1326;391;1203;61;199;235;731;296;930
431150;201701;1005;3012;772;2505;172;603;264;874;436;1477
431160;201701;814;2337;673;2078;128;367;303;1037;431;1404
431162;201701;522;1294;230;743;31;106;21;54;52;160
431164;201701;173;475;56;198;12;43;3;15;15;58
431170;201701;655;1801;460;1441;130;441;134;407;264;848
431171;201701;732;2155;635;1961;154;501;264;794;418;1295
431173;201701;442;1271;350;1112;132;452;80;253;212;705
431175;201701;967;2698;793;2385;228;720;208;613;436;1333
431177;201701;757;2423;567;2042;160;632;203;718;363;1350
431179;201701;364;787;96;276;17;49;13;30;30;79
431180;201701;2177;6081;1461;4694;353;1241;258;773;611;2014
431190;201701;580;1605;322;1044;44;151;54;150;98;301
431198;201701;335;1107;299;1037;108;392;85;317;193;709
431200;201701;404;1137;122;419;14;40;1;4;15;44
431205;201701;258;768;109;394;27;93;32;125;59;218
431210;201701;701;1859;592;1702;150;432;315;937;465;1369
431213;201701;235;704;187;617;29;109;90;296;119;405
431215;201701;234;726;146;516;37;139;15;47;52;186
431217;201701;162;489;111;379;27;92;44;148;71;240
431220;201701;828;2264;469;1498;37;133;188;550;225;683
431225;201701;1279;3564;981;3004;238;743;311;994;549;1737
431230;201701;774;2293;577;1855;98;358;242;757;340;1115
431235;201701;113;312;31;96;7;22;3;5;10;27
431237;201701;466;1378;374;1230;66;261;195;621;261;882
431238;201701;29;101;23;84;8;35;6;20;14;55
431240;201701;3386;9971;2906;9143;737;2525;1162;3603;1899;6128
431242;201701;379;1124;316;1008;91;290;112;374;203;664
431244;201701;351;825;193;550;26;85;78;196;104;281
431245;201701;1215;3145;807;2364;122;378;359;1040;481;1418
431247;201701;200;559;131;417;29;97;30;86;59;183
431250;201701;1329;4368;1179;4147;321;1204;435;1561;756;2765
431260;201701;340;954;168;577;21;93;39;115;60;208
431261;201701;248;818;208;724;38;150;90;299;128;449
431262;201701;414;1129;186;605;20;73;92;310;112;383
431265;201701;1366;3409;677;2045;111;354;199;503;310;857
431267;201701;275;790;167;513;21;81;99;278;120;359
431270;201701;2753;6785;1655;4963;410;1328;489;1499;899;2827
431275;201701;225;679;124;455;34;129;15;54;49;183
431280;201701;317;865;112;368;11;40;16;36;27;76
431290;201701;313;964;229;775;39;152;33;81;72;233
431295;201701;75;212;32;104;2;6;7;18;9;24
431300;201701;389;973;63;239;3;11;2;9;5;20
431301;201701;271;835;101;343;13;49;12;29;25;78
431303;201701;731;1942;443;1338;53;180;144;416;197;596
431306;201701;2139;5565;1319;4067;157;573;356;940;513;1513
431308;201701;36;125;33;113;17;61;10;34;27;95
431310;201701;717;2129;422;1438;92;332;126;441;218;773
431320;201701;736;2044;374;1254;73;272;64;202;137;474
431330;201701;2673;6666;1388;4336;337;1176;120;329;457;1505
431333;201701;406;1092;149;456;24;71;28;72;52;143
431335;201701;40;119;27;93;8;27;3;7;11;34
431337;201701;2392;7175;1754;5943;421;1542;251;872;672;2414
431339;201701;522;1419;366;1102;75;234;186;550;261;784
431340;201701;22653;60200;16513;49490;3888;12797;3792;11152;7680;23949
431342;201701;535;1307;399;1089;100;316;231;586;331;902
431344;201701;353;985;256;805;3;6;192;606;195;612
431346;201701;299;756;112;347;22;73;13;40;35;113
431349;201701;727;2017;426;1305;71;228;149;415;220;643
431350;201701;3927;11418;3122;9919;746;2634;990;2985;1736;5619
431360;201701;619;1578;388;1177;100;298;96;297;196;595
431365;201701;1374;4011;1166;3660;188;631;662;2128;850;2759
431370;201701;4691;13138;3664;11365;987;3258;1231;3974;2218;7232
431380;201701;874;2712;810;2590;115;419;455;1434;570;1853
431390;201701;2855;7543;1724;5409;337;1213;435;1211;772;2424
431395;201701;1198;3576;983;3189;225;773;425;1396;650;2169
431400;201701;373;1153;185;618;32;111;36;116;68;227
431402;201701;1065;2609;674;1907;134;410;339;902;473;1312
431403;201701;189;563;160;513;48;174;57;166;105;340
431405;201701;3961;11031;3229;9951;584;2012;1657;5043;2241;7055
431406;201701;623;1915;487;1650;96;340;275;931;371;1271
431407;201701;508;1451;342;1121;78;263;115;357;193;620
431410;201701;13790;39414;9388;30782;2633;9662;1533;4880;4166;14542
431413;201701;207;510;76;250;7;29;13;38;20;67
431415;201701;694;1969;497;1602;116;421;143;413;259;834
431417;201701;513;1306;434;1194;56;172;284;761;340;933
431420;201701;1273;3466;1111;3215;219;678;487;1495;706;2173
431430;201701;560;1459;338;1030;62;210;114;307;176;517
431440;201701;21504;58880;17110;51893;4942;15982;4962;16144;9904;32126
431442;201701;122;364;75;251;14;46;3;8;17;54
431445;201701;521;1478;207;682;29;94;49;154;78;248
431446;201701;380;1160;285;936;73;249;78;237;151;486
431447;201701;551;1578;425;1332;68;218;200;618;268;836
431449;201701;742;2020;585;1738;59;174;306;928;365;1102
431450;201701;2056;4978;1806;4614;193;595;1338;3283;1531;3878
431454;201701;62;216;54;195;11;41;22;86;33;127
431455;201701;687;1741;360;1021;74;217;114;296;188;513
431460;201701;3027;8341;2562;7443;658;1952;854;2604;1512;4556
431470;201701;1726;5003;1273;4039;267;848;440;1439;707;2287
431475;201701;201;593;37;148;5;25;2;6;7;31
431477;201701;701;1834;459;1333;59;171;212;584;271;755
431478;201701;260;663;85;251;13;40;9;19;22;59
431480;201701;3068;8354;2372;7177;474;1596;1044;3072;1518;4668
431490;201701;106560;287126;91411;264315;11179;38019;62352;175871;73531;213890
431500;201701;554;1529;440;1301;64;187;256;762;320;949
431505;201701;487;1174;326;934;29;81;197;565;226;646
431507;201701;362;873;198;556;34;94;95;259;129;353
431510;201701;1755;4963;1356;4161;308;1002;412;1211;720;2213
431513;201701;309;822;152;468;21;62;75;227;96;289
431514;201701;95;269;45;155;3;14;9;28;12;42
431515;201701;567;1571;385;1190;95;333;143;397;238;730
431517;201701;73;245;55;194;9;31;13;44;22;75
431520;201701;514;1291;241;780;46;169;32;96;78;265
431530;201701;4026;9504;2848;7942;874;2593;656;1910;1530;4503
431531;201701;229;670;171;550;18;59;59;173;77;232
431532;201701;505;1385;406;1168;83;250;150;424;233;674
431535;201701;294;749;132;400;28;99;42;105;70;204
431540;201701;2003;6603;1796;6280;143;597;1196;4286;1339;4883
431545;201701;341;950;54;190;4;15;14;54;18;69
431550;201701;2121;6236;1841;5724;403;1380;775;2297;1178;3677
431555;201701;668;1647;469;1315;54;150;277;786;331;936
431560;201701;20064;58282;14156;47206;3142;11829;3130;11090;6272;22919
431570;201701;5715;14452;4469;12802;1186;3566;1903;5563;3089;9129
431575;201701;377;1003;281;840;54;182;51;130;105;312
431580;201701;549;1537;305;1011;63;230;78;237;141;467
431590;201701;913;2418;570;1763;133;424;157;490;290;914
431595;201701;406;1156;303;930;40;123;160;474;200;597
431600;201701;1908;5234;1416;4396;307;1105;331;1025;638;2130
431610;201701;1381;3912;1007;3187;147;458;422;1368;569;1826
431620;201701;449;1282;219;686;47;143;91;263;138;406
431630;201701;1316;3575;809;2503;221;710;207;615;428;1325
431640;201701;6184;17076;5577;16222;962;2987;3478;10204;4440;13191
431642;201701;511;1350;378;1112;45;145;160;445;205;590
431643;201701;324;834;148;424;21;63;44;103;65;166
431645;201701;1630;4610;1371;4146;213;742;830;2480;1043;3222
431647;201701;137;413;92;307;11;42;17;47;28;89
431650;201701;313;952;224;747;38;150;68;201;106;351
431660;201701;950;2712;599;1985;117;428;115;335;232;763
431670;201701;1213;3152;908;2631;171;568;403;1089;574;1657
431673;201701;231;629;104;341;25;83;11;29;36;112
431675;201701;703;1773;139;460;15;51;40;119;55;170
431680;201701;8865;24392;6870;20645;1898;6055;1829;5583;3727;11638
431690;201701;21797;60762;17226;53059;4649;15149;5489;17466;10138;32615
431695;201701;141;419;100;328;23;79;26;62;49;141
431697;201701;431;1215;381;1130;98;310;184;552;282;862
431700;201701;1468;4159;1274;3801;192;615;705;2060;897;2675
431710;201701;11623;33703;9772;30808;3163;10624;2605;9067;5768;19691
431720;201701;6661;18427;4972;15075;1083;3494;1355;4005;2438;7499
431725;201701;30;85;18;60;4;13;5;15;9;28
431730;201701;3573;10387;2865;9147;761;2651;791;2710;1552;5361
431740;201701;4873;13315;3818;11446;1229;4064;633;1722;1862;5786
431750;201701;8233;23395;7110;21564;1733;5719;3014;9174;4747;14893
431755;201701;328;890;73;247;13;39;14;44;27;83
431760;201701;4021;11130;3207;9695;531;1797;1625;4714;2156;6511
431770;201701;1874;5021;1583;4596;270;814;936;2685;1206;3499
431775;201701;184;508;114;359;28;94;8;19;36;113
431780;201701;2110;5754;1562;4697;396;1253;386;1081;782;2334
431790;201701;1112;3298;860;2748;157;556;292;897;449;1453
431795;201701;374;1002;226;685;36;117;57;166;93;283
431800;201701;8169;23859;6554;20889;2156;7497;863;2688;3019;10185
431805;201701;327;809;100;341;13;50;19;70;32;120
431810;201701;3061;8307;2359;6931;460;1468;986;2804;1446;4272
431820;201701;2445;7506;2112;6868;438;1579;925;2936;1363;4515
431830;201701;10588;25552;8271;22174;2051;5983;3361;9101;5412;15084
431840;201701;2471;7428;2137;6823;457;1585;1071;3469;1528;5054
431842;201701;765;1936;290;896;40;130;58;151;98;281
431843;201701;345;997;283;881;38;144;130;389;168;533
431844;201701;281;776;75;255;22;80;10;29;32;109
431845;201701;492;1431;360;1139;23;75;218;698;241;773
431846;201701;304;917;256;841;27;105;187;610;214;715
431848;201701;230;617;124;397;10;43;19;48;29;91
431849;201701;470;1142;94;274;12;34;13;26;25;60
431850;201701;4494;13154;3812;11734;847;2786;1301;3946;2148;6732
431860;201701;746;1955;529;1543;82;280;259;706;341;986
431861;201701;98;294;51;190;7;26;10;29;17;55
431862;201701;474;1550;387;1392;76;308;164;583;240;891
431870;201701;17365;50597;14168;44708;3274;11263;5111;16121;8385;27384
431880;201701;4009;11780;3229;10216;758;2658;1152;3502;1910;6160
431890;201701;4757;12895;3358;10336;999;3293;666;2176;1665;5469
431900;201701;1105;3015;706;2196;173;615;276;794;449;1409
431910;201701;935;2258;458;1326;68;198;124;340;192;538
431912;201701;449;1325;373;1180;91;285;175;564;266;849
431915;201701;1193;3241;921;2770;219;708;353;1060;572;1768
431920;201701;1211;3420;1053;3157;114;359;732;2185;846;2544
431930;201701;1082;3033;781;2508;181;564;374;1232;555;1796
431935;201701;62;203;52;184;9;34;13;43;22;77
431936;201701;330;989;233;758;53;191;74;236;127;427
431937;201701;277;737;162;491;37;124;26;67;63;191
431940;201701;2381;6457;1565;4817;363;1221;411;1226;774;2447
431950;201701;1509;4558;1341;4261;254;908;678;2106;932;3014
431960;201701;2672;7574;2277;6792;639;2008;690;2030;1329;4038
431970;201701;406;1157;194;662;47;159;42;131;89;290
431971;201701;86;266;55;199;8;30;7;25;15;55
431973;201701;436;1526;386;1421;40;146;257;968;297;1114
431975;201701;106;244;23;83;2;8;4;13;6;21
431980;201701;1296;3801;1035;3272;257;842;319;986;576;1828
431990;201701;6695;18350;4824;15380;920;3325;1398;4411;2318;7736
432000;201701;9805;27156;7900;23905;2365;7378;2743;8410;5108;15788
432010;201701;2080;5767;1684;5068;279;945;809;2357;1088;3302
432020;201701;2239;5325;1626;4461;339;1048;904;2381;1243;3429
432023;201701;494;1347;303;943;48;173;127;332;175;505
432026;201701;1116;3400;844;2825;114;374;453;1505;567;1879
432030;201701;368;1041;274;837;59;182;121;353;180;535
432032;201701;531;1399;372;1098;57;189;157;418;214;607
432035;201701;797;2373;707;2216;231;803;198;618;429;1421
432040;201701;956;2241;462;1431;67;244;164;506;231;750
432045;201701;249;688;133;454;26;93;38;137;64;230
432050;201701;577;1593;496;1452;65;215;291;867;356;1082
432055;201701;904;2492;624;1966;144;493;259;795;403;1288
432057;201701;394;968;279;764;45;113;145;378;190;491
432060;201701;461;1220;180;612;31;129;45;130;76;259
432065;201701;227;644;174;550;50;168;63;193;113;361
432067;201701;872;2642;671;2217;125;393;304;1018;429;1411
432070;201701;2339;6415;1506;4749;297;1028;299;908;596;1936
432080;201701;3736;10413;3143;9379;875;2904;1150;3393;2025;6297
432085;201701;317;876;210;700;58;199;89;288;147;487
432090;201701;1428;4031;1137;3487;325;1051;442;1323;767;2374
432100;201701;1302;3738;607;2090;102;384;34;92;136;476
432110;201701;2426;7324;1790;6000;437;1697;153;477;590;2174
432120;201701;4201;12367;3499;11111;1220;4123;912;2898;2132;7021
432130;201701;2700;7355;2183;6696;625;2060;909;2850;1534;4910
432132;201701;304;867;154;531;26;93;41;133;67;226
432135;201701;712;2078;595;1844;98;319;364;1117;462;1436
432140;201701;1745;5600;1369;4874;305;1115;547;2078;852;3193
432143;201701;1314;3817;1094;3451;196;683;539;1728;735;2411
432145;201701;1317;3986;831;2860;136;531;126;402;262;933
432146;201701;176;557;122;430;30;112;25;85;55;197
432147;201701;599;1942;469;1653;146;551;92;326;238;877
432149;201701;362;992;239;714;40;112;93;275;133;387
432150;201701;3524;9858;2666;8298;579;2007;787;2379;1366;4386
432160;201701;4191;13213;3684;12289;1115;3917;1235;4208;2350;8125
432162;201701;375;906;58;182;11;41;8;24;19;65
432163;201701;280;774;66;212;6;20;1;2;7;22
432166;201701;602;1777;482;1526;81;311;185;518;266;829
432170;201701;1168;3542;809;2776;198;704;175;588;373;1292
432180;201701;2407;6584;1507;4687;362;1192;275;744;637;1936
432183;201701;372;1170;295;1003;100;373;51;169;151;542
432185;201701;876;2296;595;1782;78;249;319;928;397;1177
432190;201701;2955;7991;1902;5748;414;1336;536;1508;950;2844
432195;201701;1044;2785;735;2262;162;487;281;876;443;1363
432200;201701;2756;8386;2288;7558;567;2079;963;3130;1530;5209
432210;201701;387;1079;280;894;52;196;106;312;158;508
432215;201701;791;2427;687;2260;140;441;383;1323;523;1764
432218;201701;263;671;161;462;27;76;56;138;83;214
432220;201701;4054;10585;3230;9268;453;1484;1825;5056;2278;6540
432225;201701;104;317;83;274;24;84;25;86;49;170
432230;201701;980;2654;593;1809;115;377;142;369;257;746
432232;201701;461;1324;390;1180;65;233;171;490;236;723
432234;201701;362;971;224;687;40;128;45;125;85;253
432235;201701;110;317;38;133;6;23;2;4;8;27
432237;201701;439;1176;386;1086;16;61;271;736;287;797
432240;201701;13316;41357;11324;38627;1464;6072;6954;24306;8418;30378
432250;201701;4553;15432;4114;14548;1246;4706;1365;4956;2611;9662
432252;201701;443;1140;302;924;53;172;170;534;223;706
432253;201701;1264;3986;725;2552;158;613;46;157;204;770
432254;201701;875;2342;247;806;38;129;22;61;60;190
432255;201701;203;515;108;348;17;65;35;98;52;163
432260;201701;7421;18328;5297;14935;1130;3245;2182;6533;3312;9778
432270;201701;2462;7297;2095;6619;615;2071;516;1652;1131;3723
432280;201701;1370;3679;751;2362;101;332;183;526;284;858
432285;201701;195;612;25;88;4;11;2;2;6;13
432290;201701;469;1398;301;1017;75;239;75;255;150;494
432300;201701;23123;67941;20125;62799;3504;12029;11427;35168;14931;47197
432310;201701;784;2276;615;1988;148;497;294;945;442;1442
432320;201701;205;526;96;306;20;63;14;38;34;101
432330;201701;312;824;120;400;12;37;17;55;29;92
432335;201701;155;455;67;242;10;40;12;32;22;72
432340;201701;346;836;173;525;32;112;49;136;81;248
432345;201701;635;1729;588;1658;74;275;376;979;450;1254
432350;201701;378;1021;198;638;28;84;58;181;86;265
432360;201701;197;606;43;156;7;29;7;20;14;49
432370;201701;404;1100;293;875;33;104;168;510;201;614
432375;201701;699;1775;527;1491;58;184;313;864;371;1048
432377;201701;237;802;38;151;8;32;9;34;17;66
432380;201701;1041;3238;774;2664;202;761;308;1025;510;1786
500020;201701;2288;6546;1762;5675;364;1362;755;2357;1119;3719
500025;201701;1408;3249;851;2308;80;224;478;1271;558;1495
500060;201701;6830;20374;5407;17908;746;2521;3322;11511;4068;14032
500070;201701;4249;12090;3342;10499;736;2594;1269;4066;2005;6660
500080;201701;1353;3967;1009;3345;259;953;357;1164;616;2117
500085;201701;2097;5272;1433;4313;115;372;909;2698;1024;3070
500090;201701;2261;6440;1609;5261;333;1150;645;2228;978;3378
500100;201701;2913;8165;2359;7211;446;1545;946;2806;1392;4351
500110;201701;7826;23110;6172;20518;1135;4077;2725;9728;3860;13805
500124;201701;2052;6549;1778;6084;428;1386;885;3404;1313;4790
500150;201701;1329;3375;876;2603;163;563;315;816;478;1379
500190;201701;4913;12560;3766;11028;753;2334;1968;5996;2721;8330
500200;201701;2363;5904;1768;4855;393;1117;690;1786;1083;2903
500210;201701;4581;13639;3791;12382;889;3087;1663;5532;2552;8619
500215;201701;1422;4297;1075;3614;181;671;388;1312;569;1983
500220;201701;2980;9141;2423;8171;479;1744;1087;3727;1566;5471
500230;201701;2861;7229;2035;5941;350;1096;975;2905;1325;4001
500240;201701;4351;13582;3147;11130;573;2294;855;3219;1428;5513
500260;201701;2710;6696;1839;5373;273;864;925;2651;1198;3515
500270;201701;117527;303157;74937;228229;16902;56004;16905;51318;33807;107322
500280;201701;1351;3443;1068;3057;81;241;795;2316;876;2557
500290;201701;4343;9614;2438;6950;436;1357;852;2443;1288;3800
500295;201701;2494;7083;1478;4844;221;801;366;1022;587;1823
500310;201701;750;1971;606;1765;119;404;308;852;427;1256
500315;201701;3098;9639;2548;8722;368;1317;1552;5527;1920;6844
500320;201701;17197;54524;13401;47446;3889;15033;3435;13045;7324;28078
500325;201701;4269;10573;2993;8676;501;1568;1595;4705;2096;6273
500330;201701;6814;17547;4640;13643;673;2236;2076;6087;2749;8323
500345;201701;2085;5354;1605;4671;389;1209;697;2034;1086;3243
500348;201701;2178;6339;1887;5890;173;692;1255;3835;1428;4527
500350;201701;1265;3706;707;2394;75;255;220;769;295;1024
500370;201701;21519;64359;16250;54958;3554;13568;4888;16895;8442;30463
500375;201701;2780;7654;2069;6313;383;1288;613;1849;996;3137
500380;201701;3368;9086;2546;7666;535;1691;1026;3124;1561;4815
500390;201701;546;1231;317;869;51;167;156;404;207;571
500400;201701;1282;3865;956;3094;228;785;220;679;448;1464
500410;201701;2147;6128;1748;5549;336;1130;928;3051;1264;4181
500430;201701;2678;7273;1949;6228;371;1342;754;2563;1125;3905
500440;201701;1397;3687;916;2834;164;532;381;1199;545;1731
500450;201701;1306;3837;865;2941;191;722;128;362;319;1084
500460;201701;3943;11372;2726;9020;704;2593;544;1800;1248;4393
500470;201701;2906;8364;2021;6521;553;1944;332;1022;885;2966
500480;201701;2230;6668;2059;6459;163;484;1619;5454;1782;5938
500490;201701;930;2524;684;2115;189;676;129;423;318;1099
500500;201701;3785;11355;2942;10116;958;3812;939;3337;1897;7149
500510;201701;822;2104;521;1558;62;208;223;625;285;833
500515;201701;1904;4980;1539;4483;200;581;925;2915;1125;3496
500520;201701;3191;10929;2781;10124;397;1724;1646;5891;2043;7615
500525;201701;1171;3639;943;3237;163;644;433;1544;596;2188
500540;201701;6246;16749;3665;11998;907;3506;416;1228;1323;4734
500560;201701;4730;15213;4274;14511;448;1706;3059;10507;3507;12213
500568;201701;4195;10219;2767;8074;651;2344;734;1895;1385;4239
500570;201701;7320;19100;4576;14017;1209;4003;757;2334;1966;6337
500580;201701;3638;10063;2925;8928;300;956;2001;6216;2301;7172
500600;201701;3902;10229;2520;7729;608;2048;603;1846;1211;3894
500620;201701;7552;21495;5643;17863;968;3269;2388;7710;3356;10979
500625;201701;717;2064;398;1337;75;272;134;448;209;720
500627;201701;687;1836;460;1422;96;304;95;298;191;602
500630;201701;5524;14918;3829;12006;954;3196;1137;3537;2091;6733
500635;201701;2664;9773;2194;9053;272;1150;1536;6793;1808;7943
500640;201701;1616;3880;1232;3340;76;244;898;2385;974;2629
500660;201701;19083;54177;14715;47218;4527;16175;4072;13129;8599;29304
500690;201701;2385;7091;1926;6418;907;3135;446;1670;1353;4805
500710;201701;3323;9713;2708;8644;640;2288;988;3169;1628;5457
500720;201701;6066;15924;3802;12064;934;3272;702;2181;1636;5453
500730;201701;985;2705;669;2106;163;561;209;644;372;1205
500740;201701;4398;11764;3325;9830;372;1332;1629;4883;2001;6215
500750;201701;966;2634;787;2325;138;465;379;1063;517;1528
500755;201701;1157;3349;781;2595;152;533;142;372;294;905
500769;201701;5364;13966;3014;9259;507;1747;567;1503;1074;3250
500770;201701;1633;4704;1110;3679;240;878;280;938;520;1816
500780;201701;1140;3242;875;2747;233;760;207;653;440;1413
500790;201701;9435;25381;7823;22788;1442;4721;4106;11784;5548;16505
500793;201701;2155;6118;1595;5117;472;1572;279;819;751;2391
500795;201701;2332;6829;1975;6321;254;706;1349;4694;1603;5400
500797;201701;806;2180;552;1717;99;350;195;593;294;943
500800;201701;2908;7619;2170;6556;753;2585;483;1546;1236;4131
500830;201701;19321;50554;13494;40030;2592;8564;4647;13222;7239;21786
500840;201701;1336;3635;851;2666;100;344;312;915;412;1259
510010;201701;1222;3575;982;3185;224;719;523;1745;747;2464
510020;201701;3404;9430;2039;6689;453;1573;378;1136;831;2709
510025;201701;7086;20374;5060;16411;1147;4040;1234;3770;2381;7810
510030;201701;1582;4247;1286;3811;225;740;679;1959;904;2699
510035;201701;877;2420;606;2015;122;424;318;1088;440;1512
510040;201701;1728;4573;1323;3964;167;550;743;2224;910;2774
510050;201701;1796;5195;1327;4317;347;1242;380;1204;727;2446
510060;201701;1509;4248;1141;3561;192;661;477;1450;669;2111
510080;201701;1019;3255;826;2859;249;961;136;406;385;1367
510100;201701;651;1695;475;1361;47;156;220;581;267;737
510120;201701;307;651;197;513;10;37;134;341;144;378
510125;201701;2978;7715;2245;6450;381;1302;862;2291;1243;3593
510130;201701;1643;4585;1352;4084;352;1152;398;1185;750;2337
510140;201701;2774;8693;2171;7816;898;3620;484;1586;1382;5206
510160;201701;1232;4150;1110;3950;201;771;683;2438;884;3209
510170;201701;5002;14965;4029;13291;796;2863;1783;5813;2579;8676
510180;201701;12245;31589;8363;25407;2328;7569;2228;7730;4556;15299
510185;201701;1417;4129;1137;3751;181;562;677;2562;858;3124
510190;201701;2411;6477;1686;5428;267;896;906;3064;1173;3960
510250;201701;13782;40700;11843;37883;3322;11402;5007;16590;8329;27992
510260;201701;2164;8847;1761;8038;317;1355;922;4937;1239;6292
510263;201701;3809;10332;2691;8465;646;2199;515;1571;1161;3770
510267;201701;5354;15633;3724;12164;850;2991;756;2463;1606;5454
510268;201701;868;2471;729;2277;124;434;437;1355;561;1789
510269;201701;1007;3075;718;2480;241;885;158;536;399;1421
510270;201701;2704;8750;2215;7775;510;1813;778;2730;1288;4543
510279;201701;1700;5189;1351;4458;334;1174;429;1312;763;2486
510285;201701;1159;3345;875;2867;244;867;273;878;517;1745
510300;201701;3305;9513;2720;8690;196;710;2019;6555;2215;7265
510305;201701;1409;4395;1077;3768;256;951;331;1216;587;2167
510310;201701;753;2219;614;1980;213;727;189;602;402;1329
510320;201701;3675;10373;2800;8802;496;1843;918;2781;1414;4624
510325;201701;4923;15323;4134;14280;929;3295;2521;9183;3450;12478
510330;201701;2633;8446;2083;7464;518;1955;768;2946;1286;4901
510335;201701;4793;14264;3840;13046;474;1650;2542;9180;3016;10830
510336;201701;579;1757;430;1471;79;282;198;685;277;967
510337;201701;1890;6118;1478;5351;567;2158;276;1071;843;3229
510340;201701;74850;197074;51327;160090;16390;57393;9019;29346;25409;86739
510343;201701;1079;3085;814;2584;120;408;407;1273;527;1681
510345;201701;1543;4579;1207;3981;284;1000;415;1344;699;2344
510350;201701;3090;8289;2313;7200;569;1893;975;3177;1544;5070
510360;201701;1779;4250;1115;3451;99;409;768;2361;867;2770
510370;201701;1370;4362;1104;3952;235;925;573;2139;808;3064
510380;201701;512;1477;293;1024;86;323;26;94;112;417
510385;201701;941;3554;678;2959;88;426;320;1528;408;1954
510390;201701;1033;3310;905;3067;230;749;438;1581;668;2330
510395;201701;739;1803;535;1496;60;192;234;729;294;921
510410;201701;3752;11998;3203;10965;805;2837;1476;5277;2281;8114
510420;201701;2391;5904;1742;4884;188;625;917;2514;1105;3139
510450;201701;707;1840;471;1454;109;399;110;328;219;727
510452;201701;632;2017;482;1674;76;275;264;913;340;1188
510454;201701;859;2657;711;2373;114;414;420;1429;534;1843
510455;201701;908;2801;682;2303;122;478;243;775;365;1253
510460;201701;2312;5973;1713;5115;180;644;969;2803;1149;3447
510480;201701;4248;10923;3022;8762;552;1702;1065;2933;1617;4635
510490;201701;1548;4804;1308;4437;291;1108;684;2262;975;3370
510500;201701;1448;4258;998;3372;196;792;445;1453;641;2245
510510;201701;2671;9104;2280;8369;672;2687;546;2131;1218;4818
510515;201701;6164;17752;4210;13799;890;3162;933;2839;1823;6001
510517;201701;1529;4548;1239;4013;339;1148;265;861;604;2009
510520;201701;2100;4653;1421;3821;25;64;938;2752;963;2816
510523;201701;948;2748;843;2570;113;338;562;1775;675;2113
510525;201701;5299;16000;4281;13977;884;3073;1569;4914;2453;7987
510530;201701;479;1375;400;1255;36;166;273;800;309;966
510550;201701;2762;8907;2151;7729;568;2167;697;2592;1265;4759
510558;201701;1862;5331;1605;4978;163;562;993;3249;1156;3811
510560;201701;1579;4736;1012;3782;272;1114;223;891;495;2005
510562;201701;5261;15161;3886;12443;1067;3701;981;3328;2048;7029
510590;201701;3156;7973;2446;7099;445;1264;1472;4508;1917;5772
510600;201701;1591;4002;1054;3117;209;658;352;1034;561;1692
510610;201701;2884;8115;2297;7232;243;888;1441;4487;1684;5375
510615;201701;1985;6000;1675;5497;519;1778;699;2366;1218;4144
510617;201701;644;1890;541;1722;30;93;422;1405;452;1498
510618;201701;1410;4056;1028;3317;208;797;487;1490;695;2287
510619;201701;716;2006;421;1423;49;198;49;146;98;344
510620;201701;1381;3427;767;2466;198;727;115;339;313;1066
510621;201701;826;2785;736;2611;191;771;208;700;399;1471
510622;201701;3903;11605;2824;9357;825;2966;456;1427;1281;4393
510623;201701;3374;9187;2572;7874;604;2100;831;2436;1435;4536
510624;201701;1732;4761;895;3037;171;657;145;446;316;1103
510625;201701;1954;5460;1495;4703;425;1515;244;774;669;2289
510626;201701;1619;4419;1059;3627;303;1142;237;928;540;2070
510627;201701;693;1975;471;1507;133;464;107;353;240;817
510628;201701;1534;3755;1041;3066;183;536;603;1815;786;2351
510629;201701;1697;5488;1375;4771;384;1449;423;1506;807;2955
510630;201701;2475;8164;1706;6540;400;1681;284;1159;684;2840
510631;201701;376;1053;314;947;10;26;258;785;268;811
510637;201701;2727;7802;2283;7070;808;2704;663;2055;1471;4759
510642;201701;4716;15423;4021;14404;1171;4609;1685;6327;2856;10936
510645;201701;964;2139;601;1664;177;495;183;529;360;1024
510650;201701;6275;19997;5596;19203;1324;4796;3424;12252;4748;17048
510665;201701;1715;4462;1071;3284;176;570;419;1331;595;1901
510670;201701;367;814;208;593;22;77;105;305;127;382
510675;201701;6184;19091;4896;16609;1432;5289;1002;3455;2434;8744
510677;201701;1860;5017;1489;4538;196;603;1034;3346;1230;3949
510680;201701;699;2097;519;1740;114;406;80;250;194;656
510682;201701;1983;6318;1525;5451;466;1864;284;983;750;2847
510685;201701;923;2469;719;2141;88;309;400;1142;488;1451
510700;201701;4160;10748;2800;8852;627;2040;1284;4228;1911;6268
510704;201701;9821;25573;7200;21067;1373;4505;2825;7840;4198;12345
510706;201701;1860;5511;1270;4659;248;955;666;2599;914;3554
510710;201701;3143;8601;2199;6705;503;1589;615;1734;1118;3323
510715;201701;702;1693;487;1337;73;204;182;527;255;731
510718;201701;2328;5691;1485;4697;646;2116;294;1143;940;3259
510719;201701;382;868;236;675;17;63;122;341;139;404
510720;201701;1095;2700;768;2249;191;639;253;654;444;1293
510724;201701;706;2083;511;1710;107;390;185;589;292;979
510726;201701;713;1640;451;1254;71;208;252;673;323;881
510729;201701;717;1792;386;1173;85;287;116;346;201;633
510730;201701;2798;7866;2005;6448;569;1945;477;1513;1046;3458
510735;201701;990;3152;773;2844;140;569;395;1492;535;2061
510740;201701;1104;2659;750;2126;133;367;366;1115;499;1482
510757;201701;724;2361;598;2120;278;1027;156;539;434;1566
510760;201701;31875;79622;20874;62024;5739;18931;4024;11359;9763;30290
510770;201701;4378;10699;3558;9735;337;862;2306;7036;2643;7898
510774;201701;346;968;285;835;52;153;130;417;182;570
510775;201701;643;1939;531;1733;148;557;125;369;273;926
510776;201701;537;1484;416;1233;93;291;163;490;256;781
510777;201701;1548;4466;1151;3933;105;381;926;3207;1031;3588
510779;201701;600;1785;469;1552;71;227;236;816;307;1043
510780;201701;3674;10685;2958;9610;710;2385;1198;4298;1908;6683
510785;201701;1712;4899;1199;3991;346;1211;192;690;538;1901
510787;201701;2293;6845;1790;5960;780;2715;289;949;1069;3664
510788;201701;569;1461;409;1222;111;326;143;521;254;847
510790;201701;15011;43221;10207;34189;2215;8521;1063;3693;3278;12214
510792;201701;8252;23491;5519;18427;1153;4292;875;2845;2028;7137
510794;201701;1169;3605;910;3098;252;948;250;825;502;1773
510795;201701;7958;23479;5844;19575;1618;6019;1068;3878;2686;9897
510800;201701;1529;4254;1180;3727;255;858;489;1455;744;2313
510805;201701;2001;5495;1462;4581;299;1050;614;1811;913;2861
510810;201701;663;1591;500;1367;123;330;249;667;372;997
510820;201701;714;1637;462;1282;73;252;175;430;248;682
510830;201701;672;1989;550;1810;121;402;281;995;402;1397
510835;201701;619;1797;464;1522;95;341;191;600;286;941
510840;201701;43674;110189;35001;98859;8202;24277;16138;47519;24340;71796
510850;201701;1531;4160;959;3123;245;881;147;451;392;1332
510860;201701;2676;8117;1913;6711;668;2627;160;547;828;3174
510880;201701;573;1914;490;1765;129;487;209;782;338;1269
510885;201701;625;1737;498;1556;95;345;209;633;304;978
510890;201701;789;2451;640;2241;126;473;359;1295;485;1768
510895;201701;1131;3369;923;2987;191;697;338;1033;529;1730
520005;201701;1512;4721;1333;4476;379;1260;632;2271;1011;3531
520010;201701;1681;5570;1354;4887;522;2144;227;702;749;2846
520013;201701;3072;8637;2270;7097;509;1652;682;2211;1191;3863
520015;201701;478;1363;386;1234;94;324;125;424;219;748
520017;201701;1049;3064;867;2770;201;710;368;1126;569;1836
520020;201701;424;1101;335;971;66;206;148;416;214;622
520025;201701;30050;88072;27213;84742;3319;11217;20246;63217;23565;74434
520030;201701;4640;14150;3830;12809;664;2451;1931;6516;2595;8967
520050;201701;435;1088;269;787;22;57;161;495;183;552
520055;201701;785;2362;664;2123;139;440;321;1044;460;1484
520060;201701;1322;4090;1118;3708;284;1094;352;1110;636;2204
520080;201701;1868;5269;1522;4821;281;846;814;2783;1095;3629
520082;201701;1065;2821;943;2630;113;264;632;1835;745;2099
520085;201701;711;2120;617;1960;148;462;220;694;368;1156
520090;201701;942;2160;670;1816;131;303;351;1058;482;1361
520110;201701;40176;115198;31298;101798;11769;43493;3741;11840;15510;55333
520120;201701;178;462;107;344;16;56;32;105;48;161
520130;201701;3400;9456;3067;8978;700;2256;1594;4794;2294;7050
520140;201701;32702;106343;28359;98198;10513;39572;3843;13382;14356;52954
520145;201701;340;956;247;790;51;182;67;213;118;395
520150;201701;442;1189;369;1114;52;183;224;652;276;835
520160;201701;864;2281;700;2043;190;564;227;675;417;1239
520170;201701;4360;9864;3365;8721;219;651;2746;7155;2965;7806
520180;201701;2129;6171;1785;5679;315;1167;880;2770;1195;3937
520215;201701;1966;5005;1606;4443;197;567;998;2818;1195;3385
520235;201701;662;1684;481;1411;85;289;194;548;279;837
520250;201701;1521;4231;1082;3524;284;1017;209;696;493;1713
520260;201701;796;1992;514;1488;81;246;185;513;266;759
520280;201701;560;1632;478;1478;147;462;191;644;338;1106
520310;201701;1194;2835;832;2270;212;643;254;776;466;1419
520320;201701;1950;5939;1604;5314;151;519;987;3374;1138;3893
520330;201701;2470;7635;1904;6680;577;2269;280;969;857;3238
520340;201701;1888;4711;1414;4047;198;486;911;2797;1109;3283
520350;201701;3249;8676;2481;7298;653;2061;875;2501;1528;4562
520355;201701;1055;3377;933;3194;238;904;453;1526;691;2430
520357;201701;823;2190;671;1954;60;187;452;1322;512;1509
520360;201701;716;2036;597;1840;172;553;213;682;385;1235
520380;201701;1299;3481;866;2623;116;392;382;1114;498;1506
520390;201701;957;2317;576;1794;189;684;156;427;345;1111
520393;201701;536;1264;411;1092;52;152;226;580;278;732
520396;201701;667;2132;553;1914;71;292;341;1156;412;1448
520400;201701;1614;4622;1377;4276;274;926;809;2486;1083;3412
520410;201701;1465;3428;1033;2823;190;584;572;1537;762;2121
520420;201701;314;897;221;696;33;105;98;292;131;397
520425;201701;1223;3362;956;2855;262;795;390;1206;652;2001
520430;201701;1809;4783;1102;3463;248;794;139;415;387;1209
520440;201701;3601;9211;2405;7093;681;2204;473;1401;1154;3605
520450;201701;10586;28750;7294;22936;1812;6344;392;1246;2204;7590
520455;201701;690;2036;552;1808;200;700;170;572;370;1272
520460;201701;878;2450;725;2212;122;423;406;1209;528;1632
520465;201701;814;2155;718;2021;57;201;534;1445;591;1646
520470;201701;1678;5422;1513;5169;283;1011;1001;3534;1284;4545
520480;201701;886;2584;604;2057;111;399;119;359;230;758
520485;201701;1294;4043;1123;3779;225;837;689;2322;914;3159
520490;201701;3979;12153;3125;10803;610;2179;1685;5998;2295;8177
520495;201701;1411;3597;1170;3284;89;266;875;2556;964;2822
520500;201701;1247;3473;1024;3151;245;846;418;1263;663;2109
520505;201701;685;1940;578;1774;96;285;318;989;414;1274
520510;201701;8594;23447;6096;19566;1435;5191;1750;5713;3185;10904
520520;201701;1037;2862;836;2578;249;823;259;829;508;1652
520530;201701;1976;6427;1599;5779;556;2068;420;1696;976;3764
520540;201701;2766;7663;1973;6198;528;1749;317;1027;845;2776
520545;201701;964;2887;792;2583;148;538;249;784;397;1322
520547;201701;597;1864;515;1735;164;556;176;589;340;1145
520549;201701;9733;28567;8096;26261;2137;7302;3713;12354;5850;19656
520551;201701;3679;11100;3334;10595;725;2585;2060;6451;2785;9036
520552;201701;759;2226;683;2132;94;309;487;1550;581;1859
520570;201701;585;1595;422;1331;115;390;153;464;268;854
520580;201701;3052;7323;2138;6081;415;1304;1108;3165;1523;4469
520590;201701;1423;4026;1090;3449;269;884;200;642;469;1526
520620;201701;8012;23006;6822;21498;1611;5221;3755;12076;5366;17297
520630;201701;967;2478;698;2070;93;313;314;907;407;1220
520640;201701;2720;7316;2217;6470;545;1631;863;2605;1408;4236
520650;201701;861;2239;627;1812;96;315;346;971;442;1286
520660;201701;307;848;235;762;92;324;79;265;171;589
520670;201701;973;2825;853;2653;57;202;662;2028;719;2230
520680;201701;782;2037;591;1729;146;434;243;732;389;1166
520690;201701;296;765;211;627;55;149;98;302;153;451
520710;201701;552;1431;349;1035;7;21;203;594;210;615
520725;201701;1549;3948;1146;3271;159;498;724;2060;883;2558
520735;201701;816;2190;569;1729;108;372;201;604;309;976
520740;201701;1714;4476;1370;4038;217;698;782;2290;999;2988
520750;201701;600;1618;484;1440;97;269;223;726;320;995
520753;201701;1482;3916;1330;3715;153;417;900;2692;1053;3109
520760;201701;795;2083;680;1930;58;153;498;1502;556;1655
520780;201701;1829;4460;1381;3820;137;386;815;2218;952;2604
520790;201701;2975;7433;2220;6311;154;422;1610;4789;1764;5211
520800;201701;16689;45514;14112;42477;2691;7724;8789;28326;11480;36050
520810;201701;1107;2662;852;2373;57;165;664;1959;721;2124
520815;201701;597;1862;439;1527;173;679;24;81;197;760
520830;201701;1625;4067;1281;3681;52;147;1065;3054;1117;3201
520840;201701;1550;5013;1332;4661;558;2063;306;1153;864;3216
520850;201701;585;1757;431;1503;108;425;113;401;221;826
520860;201701;6287;18591;4825;16175;1161;4220;1611;5574;2772;9794
520870;201701;88321;239585;65981;204158;20236;68840;14442;43917;34678;112757
520880;201701;6405;18341;4921;16218;2053;7523;499;1651;2552;9174
520890;201701;3755;10372;2980;9083;587;2018;1423;4309;2010;6327
520910;201701;3551;10072;2530;8162;897;3131;484;1490;1381;4621
520915;201701;636;1858;501;1593;103;358;230;729;333;1087
520920;201701;3436;9071;2486;7640;451;1514;982;3169;1433;4683
520929;201701;602;1584;473;1375;83;226;246;776;329;1002
520940;201701;1115;3118;888;2784;91;312;634;1996;725;2308
520945;201701;651;1541;514;1320;95;222;277;690;372;912
520960;201701;995;2894;781;2495;67;219;372;1220;439;1439
520970;201701;2505;7711;2181;7113;616;2199;513;1644;1129;3843
520980;201701;747;2128;628;1945;164;543;326;1014;490;1557
520990;201701;2967;9353;2779;9109;317;1097;1948;6694;2265;7791
520993;201701;921;2317;737;2058;42;122;545;1553;587;1675
520995;201701;2220;5966;1925;5579;372;1066;1180;3489;1552;4555
521000;201701;6949;20988;5627;18417;2094;7413;968;3092;3062;10505
521010;201701;3959;11303;3098;9762;667;2115;1302;4152;1969;6267
521015;201701;679;1829;576;1664;110;319;360;1034;470;1353
521020;201701;2857;8165;1970;6328;557;1937;219;675;776;2612
521030;201701;645;1624;482;1357;84;229;198;590;282;819
521040;201701;6120;16348;5088;14758;1587;4803;1658;5060;3245;9863
521056;201701;828;2462;665;2182;206;737;198;692;404;1429
521060;201701;1039;2683;818;2345;102;305;453;1351;555;1656
521080;201701;1078;2591;630;1880;60;211;258;693;318;904
521090;201701;2882;7664;2224;6779;706;2247;696;2210;1402;4457
521100;201701;1912;4473;1409;3787;204;534;883;2438;1087;2972
521120;201701;4616;11788;3565;10480;726;2211;1559;5013;2285;7224
521130;201701;988;2640;710;2111;73;273;398;1168;471;1441
521140;201701;969;2913;785;2561;179;621;270;909;449;1530
521150;201701;11470;28745;7469;21906;2525;7854;1830;5575;4355;13429
521160;201701;873;2030;554;1510;94;273;245;653;339;926
521170;201701;1120;2753;831;2316;129;380;488;1349;617;1729
521180;201701;6003;19144;5390;18102;1444;5177;1878;6424;3322;11601
521190;201701;8704;24812;5834;19552;1495;5534;1165;3946;2660;9480
521200;201701;735;1992;586;1738;69;238;320;947;389;1185
521205;201701;610;1697;481;1476;56;190;283;867;339;1057
521210;201701;883;2434;555;1757;136;494;94;251;230;745
521220;201701;4232;10469;3083;8940;627;1998;1439;4284;2066;6282
521225;201701;382;949;316;876;32;84;231;671;263;755
521230;201701;1221;3777;1080;3507;330;1141;482;1544;812;2685
521250;201701;30206;91253;25491;84269;10695;37026;6633;23417;17328;60443
521260;201701;645;1553;535;1407;99;302;302;772;401;1074
521270;201701;1788;5099;1618;4867;118;303;1231;3854;1349;4157
521280;201701;1848;5584;1522;4958;466;1617;466;1510;932;3127
521290;201701;435;1205;327;1049;85;317;154;468;239;785
521295;201701;1175;2778;965;2491;112;278;691;1863;803;2141
521300;201701;1834;5167;1561;4743;167;546;1034;3143;1201;3689
521305;201701;718;2039;585;1827;105;334;313;1014;418;1348
521308;201701;4217;12431;3352;10780;745;2445;1479;4819;2224;7264
521310;201701;8084;23300;5697;18718;1478;5305;1216;3827;2694;9132
521340;201701;333;850;313;827;13;31;280;737;293;768
521350;201701;1958;5318;1570;4712;225;673;989;3030;1214;3703
521370;201701;913;2638;647;2148;217;781;96;330;313;1111
521375;201701;1330;3733;1066;3357;270;904;479;1508;749;2412
521377;201701;1070;2698;958;2573;51;107;821;2235;872;2342
521380;201701;5647;15791;3970;12682;547;1860;1082;3602;1629;5462
521385;201701;531;1379;454;1286;133;395;207;628;340;1023
521390;201701;810;2199;636;1967;206;738;184;554;390;1292
521400;201701;1959;5502;1755;5251;290;963;1219;3662;1509;4625
521405;201701;1388;3857;1089;3333;306;991;430;1348;736;2339
521410;201701;727;2172;679;2103;180;506;332;1118;512;1624
521440;201701;1336;3850;1067;3297;215;739;299;796;514;1535
521450;201701;3593;11695;2906;10306;905;3409;567;1979;1472;5388
521460;201701;6678;18933;5428;16739;1467;4911;2148;6488;3615;11399
521470;201701;675;1944;487;1555;113;358;92;291;205;649
521480;201701;347;1044;234;793;52;192;72;230;124;422
521483;201701;2728;7067;2035;5884;507;1514;565;1614;1072;3128
521486;201701;1641;4122;1320;3679;93;242;978;2739;1071;2981
521487;201701;487;1313;366;1120;95;328;86;257;181;585
521490;201701;796;2248;613;1924;41;181;411;1243;452;1424
521500;201701;1307;4100;958;3352;198;814;170;523;368;1337
521520;201701;864;1997;656;1725;138;386;322;901;460;1287
521523;201701;13512;47342;12494;45591;4208;16329;2155;8961;6363;25290
521525;201701;1066;2708;877;2437;104;329;537;1447;641;1776
521530;201701;1652;4699;1068;3524;246;859;155;506;401;1365
521540;201701;875;2353;608;1904;109;410;248;762;357;1172
521550;201701;1573;3966;1006;2830;182;544;448;1241;630;1785
521560;201701;3594;11864;2952;10963;914;3640;1305;5116;2219;8756
521565;201701;599;1540;501;1413;80;223;324;907;404;1130
521570;201701;4649;12727;2987;9470;627;2159;424;1377;1051;3536
521580;201701;531;1234;316;922;71;213;48;140;119;353
521590;201701;588;1621;466;1419;135;461;164;472;299;933
521600;201701;422;1211;302;967;79;258;65;203;144;461
521630;201701;1262;3105;875;2557;210;732;209;544;419;1276
521640;201701;2106;5245;1612;4578;386;1094;711;2115;1097;3209
521645;201701;538;1599;401;1319;83;288;133;409;216;697
521680;201701;1261;4032;1056;3630;415;1502;116;406;531;1908
521690;201701;542;1560;478;1454;117;425;232;663;349;1088
521710;201701;2667;7757;2120;6806;476;1595;565;1838;1041;3433
521720;201701;1895;5348;1448;4508;252;810;725;2196;977;3006
521730;201701;3598;11645;3077;10615;1135;4300;561;1702;1696;6002
521740;201701;3557;9797;2822;8740;517;1798;1364;4429;1881;6227
521760;201701;14469;44668;12241;41066;3308;12173;4413;15199;7721;27372
521770;201701;2510;7190;2005;6247;711;2410;521;1535;1232;3945
521800;201701;6698;20087;5706;18405;1735;5898;1990;6807;3725;12705
521805;201701;915;2031;657;1669;152;357;318;883;470;1240
521810;201701;749;1855;550;1579;94;286;245;749;339;1035
521830;201701;5078;15817;4486;14939;619;2284;2960;9819;3579;12103
521839;201701;688;1874;505;1535;105;348;205;587;310;935
521850;201701;6336;17043;4656;14191;1210;3996;914;2650;2124;6646
521860;201701;1847;4867;1412;4220;323;1117;429;1263;752;2380
521870;201701;482;1586;400;1417;107;394;132;454;239;848
521878;201701;775;2188;553;1743;87;316;209;617;296;933
521880;201701;21290;54901;14716;44491;3799;12246;4408;13928;8207;26174
521890;201701;3178;9353;2351;7685;631;2239;409;1307;1040;3546
521900;201701;1421;3677;956;2965;238;814;329;966;567;1780
521910;201701;895;2396;793;2276;122;384;446;1359;568;1743
521920;201701;288;905;238;814;85;318;52;175;137;493
521925;201701;682;2045;548;1791;106;368;148;454;254;822
521930;201701;3385;10780;2931;9942;1041;3706;569;2006;1610;5712
521935;201701;604;1680;504;1495;104;307;246;705;350;1012
521940;201701;928;2514;768;2286;139;462;447;1317;586;1779
521945;201701;651;1982;550;1803;93;308;268;946;361;1254
521950;201701;661;1659;532;1477;52;162;378;1050;430;1212
521960;201701;644;1917;508;1652;102;369;225;710;327;1079
521970;201701;2711;7069;2220;6486;129;335;1850;5638;1979;5973
521971;201701;996;2645;694;2105;123;393;167;494;290;887
521973;201701;943;2879;793;2618;149;524;384;1276;533;1800
521975;201701;12504;34166;11186;32537;1909;5916;7411;21453;9320;27369
521980;201701;2124;5703;1788;5284;231;602;1353;4154;1584;4756
521990;201701;1136;3177;907;2817;102;341;597;1906;699;2247
522000;201701;2269;6121;1647;5331;208;737;881;3019;1089;3756
522005;201701;380;913;266;750;81;216;93;272;174;488
522010;201701;3247;9170;2686;8239;966;3030;621;1933;1587;4963
522015;201701;895;2612;734;2344;164;521;337;1100;501;1621
522020;201701;5064;12935;3752;10874;902;2723;1729;4998;2631;7721
522026;201701;653;1798;485;1589;104;373;173;615;277;988
522028;201701;541;1514;431;1267;50;135;261;774;311;909
522040;201701;2297;5515;1813;4936;303;823;1245;3465;1548;4288
522045;201701;14731;47470;12137;42279;3363;12877;2082;7204;5445;20081
522050;201701;1115;3178;783;2517;169;564;201;581;370;1145
522060;201701;2286;6857;1916;6302;437;1523;957;3192;1394;4715
522068;201701;1680;5098;1486;4864;166;501;1079;3719;1245;4220
522070;201701;660;1960;588;1843;81;314;382;1155;463;1469
522100;201701;473;1395;403;1282;120;427;166;512;286;939
522108;201701;826;2565;682;2325;64;285;498;1642;562;1927
522119;201701;1369;4074;1136;3719;246;833;515;1737;761;2570
522130;201701;344;947;279;866;75;241;149;476;224;717
522140;201701;16017;46121;13067;40784;3934;13243;2607;7827;6541;21070
522145;201701;768;2098;637;1905;189;539;308;1011;497;1550
522150;201701;961;2511;773;2219;187;543;309;918;496;1461
522155;201701;830;2330;723;2166;157;436;400;1277;557;1713
522157;201701;648;1757;544;1606;37;136;402;1176;439;1312
522160;201701;6049;16894;4334;13804;1257;4385;437;1486;1694;5871
522170;201701;2248;6566;1744;5604;588;2014;350;1134;938;3148
522180;201701;327;925;238;776;67;227;59;212;126;439
522185;201701;15883;43741;12631;39592;3641;12134;5586;18276;9227;30410
522190;201701;867;2124;664;1838;113;328;309;890;422;1218
522200;201701;1653;5327;1316;4564;318;1173;270;896;588;2069
522205;201701;1272;3522;1014;3122;156;518;551;1673;707;2191
522220;201701;1384;3552;1109;3221;191;577;643;1999;834;2576
522230;201701;1229;3354;1035;3060;129;477;628;1848;757;2325
530010;201701;185388;572384;163342;535479;42507;155322;67619;216032;110126;371354
