ibge;anomes;cadunico_tot_fam;cadunico_tot_pes;cadunico_tot_fam_rpc_ate_meio_sm;cadunico_tot_pes_rpc_ate_meio_sm;cadunico_tot_fam_pob;cadunico_tot_pes_pob;cadunico_tot_fam_ext_pob;cadunico_tot_pes_ext_pob;cadunico_tot_fam_pob_e_ext_pob;cadunico_tot_pes_pob_e_ext_pob
110001;202012;3883;10783;2584;8363;591;2066;1000;3298;1591;5364
110002;202012;12673;32599;9075;26425;2467;7673;2464;7318;4931;14991
110003;202012;569;1690;420;1372;108;371;115;360;223;731
110004;202012;11417;29360;7564;22505;1565;5075;2217;6736;3782;11811
110005;202012;2460;6315;1694;5070;347;1130;453;1475;800;2605
110006;202012;1726;4797;1054;3362;183;670;219;670;402;1340
110007;202012;1208;3074;762;2323;239;786;185;700;424;1486
110008;202012;3276;8945;2410;7648;276;842;1589;5404;1865;6246
110009;202012;4261;11837;2737;9056;570;1997;1110;3719;1680;5716
110010;202012;7822;24530;5692;20350;1114;4052;2814;10894;3928;14946
110011;202012;6951;18323;4645;14109;1570;5045;618;1984;2188;7029
110012;202012;15478;38530;9048;27123;2004;6615;781;2532;2785;9147
110013;202012;5194;14966;3609;11711;1419;4887;442;1605;1861;6492
110014;202012;3825;9992;2636;7731;553;1734;1136;3219;1689;4953
110015;202012;5621;14376;3325;9897;711;2325;812;2227;1523;4552
110018;202012;3720;9338;2115;6486;401;1426;572;1758;973;3184
110020;202012;73054;173908;52488;145609;11684;33490;21410;65806;33094;99296
110025;202012;5134;12334;3427;9398;683;2000;1534;4210;2217;6210
110026;202012;518;1282;369;1071;82;275;149;453;231;728
110028;202012;6713;16883;3957;11903;974;3207;609;1862;1583;5069
110029;202012;1513;3684;874;2552;189;567;311;959;500;1526
110030;202012;12386;28334;7520;21036;1556;5101;1341;4155;2897;9256
110032;202012;3141;8771;1865;6040;585;1894;368;1309;953;3203
110033;202012;3491;10736;2625;9149;941;3314;676;2647;1617;5961
110034;202012;3271;7639;2168;6118;658;2090;715;2201;1373;4291
110037;202012;1618;4747;1203;4011;263;860;591;2040;854;2900
110040;202012;2857;7908;2053;6426;584;1977;644;1972;1228;3949
110045;202012;4857;13883;3544;11448;913;3177;1227;4070;2140;7247
110050;202012;1807;4863;1269;3933;493;1690;201;638;694;2328
110060;202012;855;2537;584;1887;196;689;75;241;271;930
110070;202012;1499;4700;1087;3772;340;1254;225;716;565;1970
110080;202012;6291;14591;4712;12702;666;1666;3081;8877;3747;10543
110090;202012;582;1557;394;1214;88;296;176;538;264;834
110092;202012;1148;3303;812;2679;144;494;406;1450;550;1944
110094;202012;2725;8120;2022;6746;823;2939;268;914;1091;3853
110100;202012;1673;4925;1326;4243;360;1221;556;1813;916;3034
110110;202012;1700;4623;1194;3789;404;1328;251;899;655;2227
110120;202012;1288;3705;974;3085;233;817;334;1026;567;1843
110130;202012;2728;6822;1668;4838;240;768;331;878;571;1646
110140;202012;2037;5971;1381;4608;327;1149;401;1384;728;2533
110143;202012;1324;3625;923;2817;276;858;154;482;430;1340
110145;202012;862;2241;517;1599;116;373;192;611;308;984
110146;202012;454;1182;316;970;65;183;156;517;221;700
110147;202012;752;1952;475;1418;61;207;183;477;244;684
110148;202012;722;1984;425;1393;119;453;50;157;169;610
110149;202012;3007;8186;2055;6635;711;2434;433;1494;1144;3928
110150;202012;2776;6739;1793;5311;528;1717;434;1560;962;3277
110155;202012;714;2092;501;1576;111;376;175;521;286;897
110160;202012;1456;4500;1056;3598;309;1075;252;897;561;1972
110170;202012;2101;5375;1299;3864;230;722;680;1959;910;2681
110175;202012;1637;4542;1155;3693;178;611;511;1722;689;2333
110180;202012;1427;3878;996;2999;134;439;530;1566;664;2005
120001;202012;3235;9486;2642;8605;421;1447;1670;5578;2091;7025
120005;202012;1944;7323;1769;7078;152;671;1422;5770;1574;6441
120010;202012;5334;15817;4505;14584;434;1345;3301;11057;3735;12402
120013;202012;2114;7389;1859;7083;400;1446;1185;4823;1585;6269
120017;202012;2469;7896;2161;7428;356;1227;1359;4967;1715;6194
120020;202012;15042;57415;13834;55075;1038;4634;11079;44361;12117;48995
120025;202012;3087;8671;2464;7927;362;1150;1710;5703;2072;6853
120030;202012;6319;25097;5855;24215;427;2225;4560;19032;4987;21257
120032;202012;1713;7519;1632;7374;104;651;1370;6072;1474;6723
120033;202012;4101;15073;3858;14628;108;635;3401;12733;3509;13368
120034;202012;2671;9642;2284;8965;109;648;1902;7341;2011;7989
120035;202012;3744;14583;3553;14250;289;1381;2927;11716;3216;13097
120038;202012;2637;8439;2231;7772;495;1787;1214;4312;1709;6099
120039;202012;2006;8641;1873;8372;113;721;1523;6744;1636;7465
120040;202012;43533;135815;36888;124974;5046;18064;23206;79771;28252;97835
120042;202012;3382;12373;3128;11903;132;705;2660;10028;2792;10733
120043;202012;1399;5705;1273;5500;37;225;1169;5055;1206;5280
120045;202012;6117;15634;5292;14705;124;499;4815;13235;4939;13734
120050;202012;9215;33355;8440;32177;372;2007;7117;27158;7489;29165
120060;202012;9480;36852;8672;35665;370;2268;7589;30918;7959;33186
120070;202012;3184;10086;2741;9486;259;896;1988;7112;2247;8008
120080;202012;4283;13553;3814;12859;449;1592;2829;9718;3278;11310
130002;202012;3172;12042;2833;11556;194;754;2428;10097;2622;10851
130006;202012;2456;8985;2034;8235;162;657;1560;6361;1722;7018
130008;202012;2691;9348;2392;8912;67;351;2087;7763;2154;8114
130010;202012;3989;11497;3346;10752;79;228;3077;10041;3156;10269
130014;202012;3224;9339;2481;8140;417;1373;1550;5196;1967;6569
130020;202012;2899;11053;2566;10533;130;759;2083;8470;2213;9229
130030;202012;10230;32691;9331;31642;374;1083;8282;28670;8656;29753
130040;202012;4191;12061;3451;11079;217;629;2841;9267;3058;9896
130050;202012;7571;27711;6316;26061;177;852;5724;23878;5901;24730
130060;202012;7656;29873;6554;28436;419;2213;5472;23717;5891;25930
130063;202012;6455;20864;5765;20100;199;846;5263;18436;5462;19282
130068;202012;3924;13363;3312;12482;199;1115;2542;9435;2741;10550
130070;202012;7557;21073;6197;19587;272;799;5139;16810;5411;17609
130080;202012;7313;25766;6422;24736;249;1307;5529;21634;5778;22941
130083;202012;2741;8901;2430;8512;144;567;2076;7320;2220;7887
130090;202012;3559;10927;3158;10429;48;208;2828;9519;2876;9727
130100;202012;8118;24175;6902;22904;73;143;6508;22162;6581;22305
130110;202012;8573;24293;7021;22366;1057;2702;5032;17402;6089;20104
130115;202012;5194;16198;4469;15384;98;344;3976;13881;4074;14225
130120;202012;14084;49639;12368;47331;1058;4438;10075;38972;11133;43410
130130;202012;5539;17105;4262;15423;376;1420;3248;11929;3624;13349
130140;202012;7332;25397;6435;24366;180;1041;5660;21510;5840;22551
130150;202012;3608;13544;3387;13299;73;456;3118;12279;3191;12735
130160;202012;5126;18175;4396;17240;279;1093;3749;15058;4028;16151
130165;202012;3215;12095;3027;11861;122;505;2738;10839;2860;11344
130170;202012;11753;33889;9500;31266;702;2496;7683;25806;8385;28302
130180;202012;4457;14335;4229;14078;41;215;4090;13577;4131;13792
130185;202012;18206;45030;14859;41454;968;1760;12504;37049;13472;38809
130190;202012;18777;61786;15084;56297;1676;6340;10747;41559;12423;47899
130195;202012;2484;8951;1996;8291;76;445;1686;6980;1762;7425
130200;202012;2613;7231;2141;6619;98;383;1806;5546;1904;5929
130210;202012;1355;5075;1227;4925;97;565;1005;3917;1102;4482
130220;202012;2256;7723;1918;7287;44;249;1719;6539;1763;6788
130230;202012;4835;19286;4207;18392;215;1327;3670;15976;3885;17303
130240;202012;12264;36662;9975;33633;175;1031;8992;30318;9167;31349
130250;202012;26267;77822;22502;73560;1604;4760;18232;61925;19836;66685
130255;202012;4541;14800;3961;13801;144;632;3245;11303;3389;11935
130260;202012;258871;713173;209772;642739;57037;184765;96154;306895;153191;491660
130270;202012;9883;34365;8192;31730;1386;5248;5257;21379;6643;26627
130280;202012;3579;14284;3297;13972;77;400;3094;13244;3171;13644
130290;202012;13338;43651;11550;41359;644;2365;9790;35822;10434;38187
130300;202012;4801;16399;4367;15808;142;785;3828;13806;3970;14591
130310;202012;6362;20971;5507;19865;280;1222;4720;17035;5000;18257
130320;202012;3372;10980;2794;10211;376;1322;2043;7755;2419;9077
130330;202012;4653;14814;3760;13733;213;943;3210;11736;3423;12679
130340;202012;24039;73042;20689;69238;1440;4017;17435;60360;18875;64377
130350;202012;3997;14342;3600;13842;148;773;3180;12161;3328;12934
130353;202012;7501;20080;5990;18175;765;2198;4313;13631;5078;15829
130356;202012;5247;16538;4336;15132;792;2651;2614;9744;3406;12395
130360;202012;2900;9621;2517;9086;87;388;2221;7959;2308;8347
130370;202012;5678;22569;4957;21524;308;1686;3986;17283;4294;18969
130380;202012;7306;30255;6777;29487;395;2187;5794;25015;6189;27202
130390;202012;5784;24375;5127;23279;551;2771;3901;17864;4452;20635
130395;202012;2322;7324;2004;6817;185;651;1556;5320;1741;5971
130400;202012;2840;8628;2433;8086;108;321;2177;7369;2285;7690
130406;202012;10909;37558;9091;35344;1720;6649;6051;24603;7771;31252
130410;202012;4314;15156;3670;14061;1072;4318;1681;6640;2753;10958
130420;202012;13867;47754;11537;44816;987;4605;8946;35098;9933;39703
130423;202012;4390;13583;3837;12953;192;807;3368;11296;3560;12103
130426;202012;2767;10991;2576;10767;63;348;2387;10048;2450;10396
130430;202012;4287;11953;3693;11164;236;848;3147;9405;3383;10253
130440;202012;4932;15238;4185;14344;77;347;3894;13412;3971;13759
140002;202012;2207;6476;1917;6125;89;342;1618;5246;1707;5588
140005;202012;3218;8990;2795;8494;132;350;2377;7468;2509;7818
140010;202012;54867;145372;43839;128930;10844;33674;18984;57110;29828;90784
140015;202012;3837;11326;3263;10621;223;700;2849;9438;3072;10138
140017;202012;4394;12142;3814;11403;249;669;3154;9726;3403;10395
140020;202012;5299;15254;4574;14311;240;964;3788;11762;4028;12726
140023;202012;2506;7423;2056;6778;203;667;1562;5289;1765;5956
140028;202012;2000;5156;1695;4771;80;255;1379;3877;1459;4132
140030;202012;5284;13406;4684;12710;328;636;4113;11533;4441;12169
140040;202012;2644;10130;2443;9866;86;528;2235;8891;2321;9419
140045;202012;2546;9418;2130;8843;334;1203;1428;6411;1762;7614
140047;202012;6300;17754;5295;16308;556;1748;3863;12071;4419;13819
140050;202012;1435;4183;1215;3870;115;337;928;3065;1043;3402
140060;202012;1687;4381;1464;4063;110;274;1199;3406;1309;3680
140070;202012;1872;9718;1810;9598;112;794;1536;8051;1648;8845
150010;202012;45040;112800;40713;107256;947;2187;36579;96406;37526;98593
150013;202012;1961;4971;1642;4631;146;281;1291;3889;1437;4170
150020;202012;14514;43268;13402;41821;1767;4597;10566;34382;12333;38979
150030;202012;8839;33091;8034;32097;473;1989;6966;28135;7439;30124
150034;202012;4199;10223;3450;9298;237;566;2872;7931;3109;8497
150040;202012;16296;42325;14357;40169;1286;1969;12023;36593;13309;38562
150050;202012;6963;24133;6364;23343;130;565;5858;21703;5988;22268
150060;202012;22109;59459;17749;52939;2768;8425;11412;34829;14180;43254
150070;202012;6856;25245;6017;24233;240;1103;5381;21896;5621;22999
150080;202012;91459;203904;75468;181772;18778;49552;20804;61731;39582;111283
150085;202012;7878;22449;7166;21604;109;358;6732;20441;6841;20799
150090;202012;9872;36088;9305;34984;812;2925;7368;28094;8180;31019
150095;202012;5691;16367;4980;15487;277;593;4254;13800;4531;14393
150100;202012;2802;9764;2481;9228;203;642;1971;7543;2174;8185
150110;202012;4414;17964;4098;17605;177;810;3783;16367;3960;17177
150120;202012;8180;25220;7757;24725;268;660;6929;22735;7197;23395
150125;202012;761;1987;565;1719;97;359;341;1019;438;1378
150130;202012;22163;63779;19107;59116;3483;9631;12172;40262;15655;49893
150140;202012;261159;594912;219548;537235;32936;77555;126892;322876;159828;400431
150145;202012;4219;13146;3564;12108;988;3114;1770;6794;2758;9908
150150;202012;16145;41021;14039;38332;522;1591;11793;32114;12315;33705
150157;202012;3521;9501;2824;8599;303;900;1994;6365;2297;7265
150160;202012;2994;8762;2783;8463;518;1466;1752;5580;2270;7046
150170;202012;24354;79498;21235;74168;3922;12871;13020;48537;16942;61408
150172;202012;4934;13356;3943;11948;280;743;2954;9282;3234;10025
150175;202012;1614;5048;1355;4551;249;866;783;2668;1032;3534
150178;202012;10366;27836;8650;25841;196;461;7784;23612;7980;24073
150180;202012;22629;79180;20432;76674;1202;3641;17939;69213;19141;72854
150190;202012;6740;22214;6258;21619;213;955;5618;19311;5831;20266
150195;202012;5100;16173;4795;15696;105;487;4373;14172;4478;14659
150200;202012;5882;17131;5372;16562;63;171;5084;15784;5147;15955
150210;202012;26284;90456;24523;88142;1716;5968;20275;75378;21991;81346
150215;202012;7639;21547;6573;19972;1134;3367;3976;12591;5110;15958
150220;202012;12650;35088;11040;32789;1115;3092;7650;23321;8765;26413
150230;202012;12287;34838;10863;32930;1229;3370;7429;23529;8658;26899
150240;202012;32302;88744;26711;79228;6967;21189;9656;28949;16623;50138
150250;202012;4281;16064;3979;15727;591;2253;3108;12609;3699;14862
150260;202012;2772;8886;2497;8472;149;475;2017;6941;2166;7416
150270;202012;8914;25198;6226;20370;1955;6752;1542;5434;3497;12186
150275;202012;6983;22000;6362;21134;244;908;5501;18237;5745;19145
150276;202012;2378;6191;2053;5801;261;662;1370;4343;1631;5005
150277;202012;5203;13494;4164;12269;322;868;3155;9926;3477;10794
150280;202012;6897;27554;6649;27159;467;1882;5714;23578;6181;25460
150285;202012;3260;11415;2857;10774;258;968;2094;8073;2352;9041
150290;202012;10307;27909;9306;26842;282;573;8446;24965;8728;25538
150293;202012;9214;22644;7096;19859;896;2515;4464;13126;5360;15641
150295;202012;7443;20146;5460;17429;1795;6093;1893;6914;3688;13007
150300;202012;2360;7054;2133;6768;34;120;1963;6261;1997;6381
150304;202012;4057;11971;3336;10862;590;1806;2048;7045;2638;8851
150307;202012;6043;19465;5569;18676;313;1096;4555;15402;4868;16498
150309;202012;6262;18545;5027;16407;844;2729;2849;9743;3693;12472
150310;202012;7454;29240;7129;28849;214;1138;6395;26112;6609;27250
150320;202012;9216;25165;8416;24002;397;1217;6578;18731;6975;19948
150330;202012;13735;43931;12682;42256;1177;3609;9645;33188;10822;36797
150340;202012;2517;7341;2221;6890;337;981;1512;4877;1849;5858
150345;202012;8102;23643;7261;22529;417;1366;6175;19210;6592;20576
150350;202012;8925;22340;8246;21452;671;1261;6818;18278;7489;19539
150360;202012;23974;65346;19194;59302;2046;4907;13632;45183;15678;50090
150370;202012;10818;32504;8894;29909;1032;2902;6449;23469;7481;26371
150375;202012;3614;14475;3267;13981;221;1074;2799;12054;3020;13128
150380;202012;11231;28373;9250;25784;106;421;8213;22874;8319;23295
150390;202012;7818;31116;7012;29876;1062;3922;5050;22857;6112;26779
150400;202012;6618;23477;6351;22983;272;965;5589;20331;5861;21296
150405;202012;9132;24145;7973;22768;480;1115;6488;19143;6968;20258
150410;202012;1924;6014;1633;5518;239;706;1017;3558;1256;4264
150420;202012;39018;107008;29891;93624;8345;27364;10407;38116;18752;65480
150430;202012;8497;24543;7738;23565;930;2064;5977;19210;6907;21274
150440;202012;5740;18038;5191;17262;1031;2996;3259;11736;4290;14732
150442;202012;26005;61352;21362;55575;2223;5629;14893;39599;17116;45228
150445;202012;6226;19210;5470;18052;186;659;4708;15555;4894;16214
150450;202012;5137;21744;4734;21202;390;1890;3992;17984;4382;19874
150460;202012;8347;27301;7636;26392;236;886;6619;23646;6855;24532
150470;202012;21412;55556;19096;52913;335;959;18032;49957;18367;50916
150475;202012;4899;15266;4206;14237;167;599;3535;12122;3702;12721
150480;202012;13725;43718;12312;41637;2271;6715;8160;29691;10431;36406
150490;202012;8405;28979;7702;28106;308;1217;6774;24927;7082;26144
150495;202012;5274;17769;5039;17438;110;539;4599;15817;4709;16356
150497;202012;2784;8806;2226;7836;485;1741;1187;4484;1672;6225
150500;202012;3296;8388;2908;7842;254;624;2249;6085;2503;6709
150503;202012;4714;12042;3235;10112;951;3225;1045;3749;1996;6974
150506;202012;10175;29955;8505;27695;1818;5168;5277;19197;7095;24365
150510;202012;9816;35487;8503;33077;1351;4849;5473;22635;6824;27484
150520;202012;6880;27082;6585;26713;224;1367;5915;23902;6139;25269
150530;202012;12149;41440;10499;39111;1501;4502;7571;30180;9072;34682
150540;202012;4911;13367;4202;12301;241;657;3515;10337;3756;10994
150543;202012;7192;19235;5918;17643;470;1406;4593;14293;5063;15699
150548;202012;10113;31640;9098;30241;240;996;8101;26989;8341;27985
150549;202012;1979;5843;1696;5444;50;192;1430;4608;1480;4800
150550;202012;20431;59426;16940;53652;4224;13569;7242;24530;11466;38099
150553;202012;30419;85751;23788;73968;6909;21746;8698;28841;15607;50587
150555;202012;1975;5162;1536;4466;175;391;1037;3210;1212;3601
150560;202012;1858;5576;1645;5154;286;844;958;3149;1244;3993
150563;202012;2545;7563;2130;6860;424;1431;1200;3920;1624;5351
150565;202012;4415;13958;3924;13194;98;428;3295;11175;3393;11603
150570;202012;6189;19629;5770;19052;262;967;5044;16629;5306;17596
150580;202012;10459;40831;8963;39163;618;3108;7242;32940;7860;36048
150590;202012;8210;27989;7027;26575;164;954;6431;24250;6595;25204
150600;202012;9706;31906;9039;31105;211;810;8409;29098;8620;29908
150610;202012;2916;8417;2603;7926;79;322;2227;6700;2306;7022
150611;202012;3235;8898;2875;8402;84;302;2555;7431;2639;7733
150613;202012;13463;36569;10146;30905;1812;5882;5120;15536;6932;21418
150616;202012;3529;9553;2563;7946;600;1933;1102;3396;1702;5329
150618;202012;6814;19611;5510;17618;475;1500;3569;12071;4044;13571
150619;202012;6525;17970;5391;16400;200;592;4576;14114;4776;14706
150620;202012;6830;22425;5858;20766;685;2313;3960;14492;4645;16805
150630;202012;6237;16735;5702;16080;360;958;4838;13743;5198;14701
150635;202012;4801;13084;4013;11820;557;1515;2607;7943;3164;9458
150640;202012;2260;6624;2069;6386;34;93;1927;6020;1961;6113
150650;202012;11219;31010;9713;28606;2839;7870;4320;13949;7159;21819
150655;202012;5736;16379;5194;15588;194;598;4514;13552;4708;14150
150658;202012;4489;12599;3481;11030;547;1807;2038;6831;2585;8638
150660;202012;5697;16200;5043;15293;474;1372;3532;10985;4006;12357
150670;202012;8176;18818;6413;16840;659;1371;5036;14030;5695;15401
150680;202012;68213;198574;52454;173573;12582;40556;23484;88223;36066;128779
150690;202012;2750;6813;2361;6356;70;159;2118;5825;2188;5984
150700;202012;6103;17921;5441;17066;346;844;4352;14064;4698;14908
150710;202012;3789;12535;3448;11990;303;1017;2594;9227;2897;10244
150715;202012;4915;14052;4008;12670;301;903;3148;10149;3449;11052
150720;202012;6894;24175;6413;23456;434;1677;5341;19815;5775;21492
150730;202012;12024;36067;10316;33633;1191;3980;7666;25726;8857;29706
150740;202012;4021;11032;3526;10248;318;763;2660;7939;2978;8702
150745;202012;4967;13966;3974;12509;786;2599;2538;8107;3324;10706
150746;202012;1653;4997;1495;4776;74;240;1226;3921;1300;4161
150747;202012;4932;15361;4337;14389;700;1999;2970;10403;3670;12402
150750;202012;3657;11368;3061;10459;231;832;2308;8176;2539;9008
150760;202012;11700;34509;10601;32973;1440;4074;7538;24229;8978;28303
150770;202012;6552;22994;6163;22556;187;538;5628;21220;5815;21758
150775;202012;930;2560;725;2290;128;449;394;1250;522;1699
150780;202012;4480;13512;3971;12909;157;428;3559;11898;3716;12326
150790;202012;5746;16062;4954;15210;238;588;3821;13254;4059;13842
150795;202012;14016;42818;12172;39958;2978;9220;6897;24231;9875;33451
150796;202012;3885;9334;3389;8768;215;478;2859;7556;3074;8034
150797;202012;4053;12255;3507;11501;141;350;3016;10105;3157;10455
150800;202012;13218;41180;11889;39407;1437;4437;8948;30738;10385;35175
150803;202012;7158;22493;6692;21766;406;1125;5661;18705;6067;19830
150805;202012;3442;10503;2915;9742;213;689;2280;7775;2493;8464
150808;202012;5801;16389;4233;13820;1670;6016;598;2259;2268;8275
150810;202012;20776;54021;15781;47994;3362;10429;7905;26815;11267;37244
150812;202012;5403;14913;4740;13824;414;1283;3530;10102;3944;11385
150815;202012;9637;27847;8037;25973;635;2004;6645;21862;7280;23866
150820;202012;11708;32123;9870;29811;1068;2755;7528;23837;8596;26592
150830;202012;11879;42850;10977;41750;454;1792;9449;37193;9903;38985
150835;202012;2309;7566;1949;6951;328;1140;1137;4132;1465;5272
150840;202012;7542;20980;6044;18603;976;3253;3448;10528;4424;13781
160005;202012;1223;3319;1083;3145;68;224;909;2661;977;2885
160010;202012;2424;6370;2255;6186;18;101;2190;5934;2208;6035
160015;202012;2786;8041;2461;7644;68;229;2273;7082;2341;7311
160020;202012;2056;6540;1802;6229;152;495;1418;5098;1570;5593
160021;202012;1168;4328;1078;4213;55;298;875;3418;930;3716
160023;202012;1271;4450;1120;4199;123;419;784;3131;907;3550
160025;202012;1856;5585;1756;5471;13;39;1706;5332;1719;5371
160027;202012;8899;24693;7946;23464;638;1791;6411;19330;7049;21121
160030;202012;73245;206900;59639;188296;12713;37640;31998;111505;44711;149145
160040;202012;5864;19441;5346;18790;68;302;5031;17794;5099;18096
160050;202012;4700;14069;3676;12681;1385;4571;1275;5568;2660;10139
160053;202012;3817;11639;3445;11167;277;765;2796;9441;3073;10206
160055;202012;912;2631;877;2591;28;93;816;2408;844;2501
160060;202012;25001;65280;20242;59888;931;2852;16078;50012;17009;52864
160070;202012;2642;10036;2363;9607;190;756;1872;7872;2062;8628
160080;202012;3347;10546;2978;10134;27;139;2793;9573;2820;9712
170025;202012;587;1532;426;1285;65;192;221;697;286;889
170030;202012;1233;3722;947;3218;149;508;455;1598;604;2106
170035;202012;1458;3771;1083;3178;87;275;681;1995;768;2270
170040;202012;1883;5247;1496;4698;106;375;939;3037;1045;3412
170070;202012;1882;4372;1335;3668;85;264;794;2274;879;2538
170100;202012;2413;6881;2012;6215;207;578;1267;4056;1474;4634
170105;202012;728;2107;503;1628;137;394;163;554;300;948
170110;202012;958;2876;732;2449;117;397;358;1183;475;1580
170130;202012;1278;3802;917;3114;181;654;436;1517;617;2171
170190;202012;1377;3834;1004;3236;363;1262;151;628;514;1890
170200;202012;2050;4832;1327;3637;196;556;569;1568;765;2124
170210;202012;24139;65330;18293;55558;6151;20395;2565;8639;8716;29034
170215;202012;1320;3514;1055;3140;39;161;834;2471;873;2632
170220;202012;5800;17840;4842;16101;1329;4235;1894;7008;3223;11243
170230;202012;1202;3574;892;2966;257;871;151;564;408;1435
170240;202012;2532;7088;1988;6192;125;461;1432;4367;1557;4828
170255;202012;3881;11207;2782;9233;483;1647;1269;4312;1752;5959
170270;202012;927;2252;619;1809;37;101;367;1066;404;1167
170290;202012;2825;8375;2450;7877;121;391;1918;6347;2039;6738
170300;202012;1997;5325;1612;4740;193;544;1078;3245;1271;3789
170305;202012;618;1681;517;1510;68;224;260;753;328;977
170307;202012;955;3213;777;2865;104;400;432;1609;536;2009
170310;202012;1549;3838;1081;3095;167;521;510;1468;677;1989
170320;202012;1001;2604;750;2208;63;190;476;1435;539;1625
170330;202012;898;2742;814;2616;38;171;681;2129;719;2300
170360;202012;517;1393;360;1133;21;73;239;718;260;791
170370;202012;1252;3355;900;2747;279;797;232;843;511;1640
170380;202012;1755;5058;1314;4374;92;362;773;2624;865;2986
170382;202012;532;1559;442;1411;30;120;328;1008;358;1128
170384;202012;1529;5424;1242;4868;253;1038;639;2552;892;3590
170386;202012;971;2617;604;1908;79;279;216;661;295;940
170388;202012;602;1715;422;1390;57;201;196;657;253;858
170389;202012;1028;3162;846;2868;44;180;618;2139;662;2319
170390;202012;1735;3925;1304;3405;36;88;1084;2901;1120;2989
170410;202012;565;1632;414;1358;32;128;247;779;279;907
170460;202012;342;909;283;815;37;100;187;556;224;656
170510;202012;905;2565;684;2160;42;166;446;1343;488;1509
170550;202012;6357;16937;4647;14156;1206;3942;1073;3553;2279;7495
170555;202012;1397;3743;1098;3282;73;225;543;1698;616;1923
170560;202012;1015;2811;775;2482;64;198;495;1697;559;1895
170600;202012;1230;3340;998;3013;213;515;548;1818;761;2333
170610;202012;1583;4187;1138;3522;85;288;710;2173;795;2461
170625;202012;413;1123;256;801;43;131;84;255;127;386
170650;202012;1201;3552;946;3127;124;427;551;1880;675;2307
170700;202012;3274;9692;2464;8088;495;1635;1106;3706;1601;5341
170710;202012;1435;3778;1111;3265;147;466;698;2067;845;2533
170720;202012;1706;4318;1282;3622;328;982;531;1538;859;2520
170730;202012;1038;2808;772;2370;140;382;394;1289;534;1671
170740;202012;2075;6759;1785;6228;171;658;1267;4400;1438;5058
170755;202012;877;2405;613;1951;69;220;302;956;371;1176
170765;202012;1105;2872;772;2334;149;444;335;1057;484;1501
170770;202012;1830;5279;1486;4743;169;520;975;3214;1144;3734
170820;202012;3282;9843;2569;8532;542;1842;1157;3986;1699;5828
170825;202012;979;2256;794;2006;92;206;573;1467;665;1673
170830;202012;1397;3704;1146;3314;151;410;765;2281;916;2691
170900;202012;2746;8475;2306;7839;209;645;1810;6292;2019;6937
170930;202012;3623;10012;2752;8344;649;2087;881;2694;1530;4781
170950;202012;10905;30043;7515;23885;2068;7515;848;2977;2916;10492
170980;202012;454;1195;359;1041;27;92;241;673;268;765
171050;202012;1610;5005;1404;4655;54;229;1172;3851;1226;4080
171070;202012;1322;3769;1133;3488;307;918;493;1789;800;2707
171090;202012;1047;2582;826;2267;80;226;544;1462;624;1688
171110;202012;567;1517;394;1194;62;186;187;526;249;712
171150;202012;1051;2604;651;1927;58;201;409;1194;467;1395
171180;202012;771;2090;517;1617;95;265;217;690;312;955
171190;202012;1793;5912;1552;5495;243;907;946;3480;1189;4387
171195;202012;772;2454;623;2168;82;335;381;1311;463;1646
171200;202012;568;1577;424;1328;91;302;153;478;244;780
171215;202012;362;1000;296;887;31;106;205;593;236;699
171240;202012;761;2480;605;2173;32;180;411;1445;443;1625
171245;202012;652;1935;508;1634;46;176;317;975;363;1151
171250;202012;994;2628;725;2225;129;410;337;1061;466;1471
171270;202012;475;1665;370;1433;80;307;163;696;243;1003
171280;202012;859;2582;685;2265;65;233;401;1376;466;1609
171320;202012;3949;10997;3026;9371;628;1912;1113;3668;1741;5580
171330;202012;2740;7503;2106;6376;460;1369;926;2939;1386;4308
171360;202012;1351;3930;1073;3515;75;255;772;2610;847;2865
171370;202012;689;1733;525;1503;45;117;359;1044;404;1161
171380;202012;1437;3860;1208;3541;140;392;847;2573;987;2965
171395;202012;966;2638;676;2103;59;216;425;1281;484;1497
171420;202012;1961;5698;1401;4571;246;850;628;2056;874;2906
171430;202012;1007;2959;842;2649;56;192;586;1777;642;1969
171488;202012;2308;6827;1824;6014;268;864;941;3263;1209;4127
171500;202012;970;2384;737;2029;47;123;559;1560;606;1683
171510;202012;800;2615;691;2403;46;206;485;1656;531;1862
171515;202012;460;1165;336;972;33;94;208;570;241;664
171525;202012;704;1974;530;1698;26;91;301;932;327;1023
171550;202012;342;989;260;856;36;132;138;446;174;578
171570;202012;1113;3359;935;3040;123;403;550;1842;673;2245
171575;202012;1766;4740;1133;3588;117;393;514;1631;631;2024
171610;202012;5585;15510;4166;13067;862;3056;1139;3866;2001;6922
171620;202012;2511;7205;2131;6651;103;418;1735;5403;1838;5821
171630;202012;962;2502;758;2221;102;299;520;1575;622;1874
171650;202012;1975;5600;1515;4822;385;1338;451;1584;836;2922
171660;202012;2327;5841;1593;4608;225;577;844;2488;1069;3065
171665;202012;1229;3438;961;2997;174;615;441;1375;615;1990
171670;202012;1874;4963;1442;4250;203;651;778;2312;981;2963
171700;202012;1193;3369;867;2774;107;340;471;1538;578;1878
171720;202012;785;1991;623;1743;52;159;455;1253;507;1412
171750;202012;1295;3614;884;2837;220;729;112;455;332;1184
171780;202012;1188;3045;871;2578;92;302;581;1683;673;1985
171790;202012;1388;4487;1144;3976;191;674;566;1995;757;2669
171800;202012;693;1905;526;1660;60;234;301;929;361;1163
171820;202012;11099;31030;8201;25972;2009;6613;2374;8197;4383;14810
171830;202012;1539;4879;1311;4479;132;515;839;2876;971;3391
171840;202012;746;1993;576;1728;25;79;379;1130;404;1209
171845;202012;639;1553;488;1332;49;170;315;825;364;995
171850;202012;896;2951;762;2650;72;320;537;1808;609;2128
171855;202012;1020;3105;870;2832;64;218;550;1767;614;1985
171865;202012;357;1111;295;1005;51;186;149;487;200;673
171870;202012;821;2243;581;1807;72;216;294;931;366;1147
171875;202012;1268;3671;1014;3259;39;172;763;2452;802;2624
171880;202012;1173;3489;1034;3305;42;128;817;2676;859;2804
171884;202012;843;2405;627;2031;123;457;232;772;355;1229
171886;202012;1313;3592;937;2990;272;995;192;625;464;1620
171888;202012;724;2009;496;1586;28;101;310;972;338;1073
171889;202012;366;1140;284;970;60;222;117;394;177;616
171890;202012;1167;3256;838;2720;172;521;466;1572;638;2093
171900;202012;536;1849;393;1490;81;300;163;646;244;946
172000;202012;566;1672;472;1501;54;171;269;827;323;998
172010;202012;958;3308;817;3029;67;281;506;1867;573;2148
172015;202012;371;1268;272;1064;69;275;106;437;175;712
172020;202012;2680;7544;2359;7121;173;559;1732;5451;1905;6010
172025;202012;697;1914;516;1615;37;140;380;1184;417;1324
172030;202012;1210;3566;1031;3282;55;207;806;2556;861;2763
172049;202012;1284;3084;872;2521;182;482;434;1384;616;1866
172065;202012;1404;3537;1103;3154;98;215;877;2691;975;2906
172080;202012;2349;6898;1901;6115;110;380;1274;4083;1384;4463
172085;202012;467;1265;303;915;56;170;103;294;159;464
172090;202012;4004;9943;3117;8768;132;377;2377;6769;2509;7146
172093;202012;458;1363;330;1129;17;88;199;641;216;729
172097;202012;676;1764;471;1408;62;192;210;636;272;828
172100;202012;47654;117203;33857;95532;5809;18103;12508;36155;18317;54258
172110;202012;1554;5692;1343;5355;128;538;993;4131;1121;4669
172120;202012;4885;14361;3823;12618;484;1691;2181;7410;2665;9101
172125;202012;368;985;281;839;21;74;170;475;191;549
172130;202012;618;1504;488;1297;23;85;345;836;368;921
172208;202012;2539;6171;2034;5514;190;413;1478;4139;1668;4552
172210;202012;2646;6690;2026;5896;321;1009;1164;3548;1485;4557
210005;202012;18505;52736;13938;45076;4025;13564;5314;18028;9339;31592
210010;202012;1912;5866;1730;5644;70;297;1512;4946;1582;5243
210015;202012;3270;9789;2896;9280;153;496;2407;7720;2560;8216
210020;202012;7279;17157;6178;15860;112;367;5645;14475;5757;14842
210030;202012;4609;15257;4245;14701;258;1030;3582;12450;3840;13480
210040;202012;1801;4289;1587;4021;32;86;1362;3377;1394;3463
210043;202012;5967;17297;5117;16096;414;1247;3985;12744;4399;13991
210047;202012;6395;19956;5228;18396;133;698;4523;15911;4656;16609
210050;202012;2175;7326;1727;6494;159;669;1205;4525;1364;5194
210055;202012;1875;6020;1699;5746;66;247;1448;4919;1514;5166
210060;202012;7228;26303;6421;24875;647;2595;4478;17803;5125;20398
210070;202012;6992;19909;6546;19324;45;204;6186;18198;6231;18402
210080;202012;4332;14340;4114;14102;44;257;3795;13084;3839;13341
210083;202012;5466;15730;4546;14747;34;161;4330;14095;4364;14256
210087;202012;2959;8076;2530;7502;91;277;2149;6425;2240;6702
210090;202012;9115;28439;8509;27375;490;1263;7249;23601;7739;24864
210095;202012;6396;20460;5836;19748;245;1045;4876;16813;5121;17858
210100;202012;6710;20413;5981;19234;402;1398;4622;14937;5024;16335
210110;202012;2882;9260;2660;8997;54;317;2397;8056;2451;8373
210120;202012;22449;61080;18512;55931;1871;4540;12524;40495;14395;45035
210125;202012;4389;11718;3817;11043;740;1691;2665;8273;3405;9964
210130;202012;4293;11163;3552;10236;153;321;3006;8783;3159;9104
210135;202012;1423;4269;1229;3954;61;172;999;3300;1060;3472
210140;202012;18903;49117;14512;43423;2850;8032;8031;25672;10881;33704
210150;202012;4310;10436;3856;9807;143;400;3275;8194;3418;8594
210160;202012;16235;47118;13968;44277;1166;3949;9920;32681;11086;36630
210170;202012;15104;46522;14040;45165;782;2144;12304;40086;13086;42230
210173;202012;2244;8653;2084;8366;108;608;1788;7109;1896;7717
210177;202012;3447;9426;2995;8868;170;378;2567;7899;2737;8277
210180;202012;1431;3793;1252;3580;25;62;1142;3283;1167;3345
210190;202012;5357;14261;4507;13111;78;323;3917;11246;3995;11569
210193;202012;1301;3780;1146;3529;30;134;859;2681;889;2815
210197;202012;2091;6430;1931;6213;149;474;1573;5149;1722;5623
210200;202012;7620;24382;6744;22914;396;1513;5344;18099;5740;19612
210203;202012;6954;20509;5917;19105;395;1347;4713;15513;5108;16860
210207;202012;3925;9460;2991;8466;158;333;2495;7277;2653;7610
210210;202012;7916;25679;7225;24704;167;960;6193;20962;6360;21922
210215;202012;2455;7700;2086;7143;121;620;1555;5242;1676;5862
210220;202012;6073;20956;5760;20482;182;1176;5042;17553;5224;18729
210230;202012;5046;15304;4594;14623;438;1114;3785;12423;4223;13537
210232;202012;10907;34324;8981;31376;1608;5512;5501;20592;7109;26104
210235;202012;3294;9997;2914;9469;165;664;2450;7949;2615;8613
210237;202012;2762;8953;2375;8502;32;189;2196;7858;2228;8047
210240;202012;2559;8012;2351;7646;72;251;1953;6235;2025;6486
210250;202012;5613;17025;5096;16364;74;430;4623;14777;4697;15207
210255;202012;2459;7547;2085;6900;288;989;1322;4367;1610;5356
210260;202012;5452;16183;4807;15242;255;961;4031;12677;4286;13638
210270;202012;4842;13293;4333;12673;92;420;3879;11247;3971;11667
210275;202012;3428;8695;2995;8147;73;195;2498;6784;2571;6979
210280;202012;5523;15622;4435;13948;263;1002;3286;10187;3549;11189
210290;202012;7257;19236;6495;18279;102;333;6077;17077;6179;17410
210300;202012;32152;87466;26243;78956;1881;5959;18676;58207;20557;64166
210310;202012;3049;7777;2694;7254;134;291;2347;6381;2481;6672
210312;202012;2643;6754;2339;6428;31;137;2199;5978;2230;6115
210315;202012;2953;8214;2536;7738;76;232;2255;7004;2331;7236
210317;202012;4089;12825;3700;12366;137;682;3286;10887;3423;11569
210320;202012;18927;56725;17316;54602;373;1744;15405;48372;15778;50116
210325;202012;3639;10215;3117;9531;108;315;2713;8504;2821;8819
210330;202012;23899;67257;19091;61103;5751;16533;9088;33825;14839;50358
210340;202012;9937;29203;8840;27729;714;2202;6749;21804;7463;24006
210350;202012;8950;25899;7911;24647;143;493;7073;22173;7216;22666
210355;202012;4224;13935;3733;13161;100;488;3184;11282;3284;11770
210360;202012;13638;42358;12138;40152;600;2765;9204;29863;9804;32628
210370;202012;10879;24383;8435;21804;244;409;7731;20461;7975;20870
210375;202012;3154;8418;2421;7413;654;2060;1013;3454;1667;5514
210380;202012;5341;13716;4618;12868;191;468;3982;11186;4173;11654
210390;202012;2535;8910;2345;8580;126;584;1975;7197;2101;7781
210400;202012;4439;13479;3928;12849;130;400;3534;11736;3664;12136
210405;202012;6691;18054;5385;16180;1024;2867;3051;9798;4075;12665
210407;202012;1951;6413;1647;5862;77;336;1339;4702;1416;5038
210408;202012;2540;9356;2379;9117;146;692;1884;7259;2030;7951
210409;202012;3766;12924;3446;12486;108;577;2866;10467;2974;11044
210410;202012;3367;10219;2868;9389;159;618;2187;7117;2346;7735
210420;202012;3766;12002;3412;11382;195;608;2878;9701;3073;10309
210430;202012;2216;6472;1965;6147;85;238;1679;5325;1764;5563
210440;202012;4310;11605;3740;10881;76;276;3406;9823;3482;10099
210450;202012;2354;7015;2028;6545;79;290;1684;5400;1763;5690
210455;202012;4325;11304;3281;9977;934;2854;1500;4867;2434;7721
210460;202012;3657;10402;3098;9678;62;267;2715;8430;2777;8697
210462;202012;1633;4936;1398;4556;39;155;1137;3747;1176;3902
210465;202012;2689;7778;2341;7295;90;405;1835;5571;1925;5976
210467;202012;5801;18420;5063;17450;294;1108;4186;14650;4480;15758
210470;202012;1949;5209;1430;4455;102;227;1091;3558;1193;3785
210480;202012;15924;46919;13206;43549;1102;3309;9744;34662;10846;37971
210490;202012;3612;9155;2936;8222;92;267;2475;6923;2567;7190
210500;202012;6385;24074;5847;23139;393;1862;4789;18831;5182;20693
210510;202012;5857;19393;5127;18610;116;508;4625;17052;4741;17560
210515;202012;3696;10843;3216;10294;257;940;2541;8278;2798;9218
210520;202012;2491;7169;2227;6815;70;253;1904;5766;1974;6019
210530;202012;49948;123258;38458;106165;6793;22430;10922;37398;17715;59828
210535;202012;3033;10269;2843;9970;157;577;2354;8323;2511;8900
210540;202012;14536;41717;12045;38204;1493;4357;8338;27817;9831;32174
210542;202012;6430;14840;5153;13446;340;581;4203;11743;4543;12324
210545;202012;2181;6754;2057;6553;45;184;1826;5760;1871;5944
210547;202012;3494;12465;3102;11708;281;1039;2369;9128;2650;10167
210550;202012;6002;18027;4758;16075;344;1320;3379;11719;3723;13039
210560;202012;3551;10705;3174;10104;120;371;2684;8485;2804;8856
210565;202012;1460;4752;1219;4402;74;392;921;3325;995;3717
210570;202012;10312;27955;9172;26558;336;931;7895;23372;8231;24303
210580;202012;2956;7880;2427;7222;127;280;1916;6008;2043;6288
210590;202012;4176;12456;3620;11747;66;371;3233;10410;3299;10781
210592;202012;2604;7645;2382;7285;21;106;2023;6101;2044;6207
210594;202012;2453;6612;1866;5699;88;267;1378;4366;1466;4633
210596;202012;2518;8856;2280;8397;105;431;1887;6970;1992;7401
210598;202012;1799;5233;1663;5028;61;247;1450;4315;1511;4562
210600;202012;2988;7940;2458;7191;110;275;1900;5616;2010;5891
210610;202012;2699;7470;2315;7004;62;270;1988;6013;2050;6283
210620;202012;2761;7339;2302;6785;57;178;2059;6073;2116;6251
210630;202012;2955;9938;2699;9513;125;593;2225;7746;2350;8339
210632;202012;4372;13950;3896;13263;223;934;3080;10428;3303;11362
210635;202012;1706;6089;1616;5935;95;344;1338;5005;1433;5349
210637;202012;2406;7961;2083;7493;158;693;1542;5598;1700;6291
210640;202012;4485;16028;4206;15696;68;338;3830;14329;3898;14667
210650;202012;7367;21002;6681;20113;100;365;6029;18145;6129;18510
210660;202012;7876;23527;7031;22148;281;1164;5959;18442;6240;19606
210663;202012;2543;7368;2333;7123;148;348;1973;6235;2121;6583
210667;202012;1936;6276;1744;5989;57;238;1550;5375;1607;5613
210670;202012;4491;14979;4099;14361;106;509;3610;12568;3716;13077
210675;202012;5000;13502;4271;12558;271;674;3472;10555;3743;11229
210680;202012;4596;11036;3874;10176;109;195;3480;9262;3589;9457
210690;202012;7523;22977;6278;21597;232;1012;5581;19335;5813;20347
210700;202012;2726;7641;2142;6785;142;431;1554;5132;1696;5563
210710;202012;4752;14947;4186;14148;97;553;3698;12330;3795;12883
210720;202012;2876;9513;2565;9125;73;427;2225;7843;2298;8270
210725;202012;1288;4307;1128;4068;41;162;817;3074;858;3236
210730;202012;1152;3039;966;2776;47;127;829;2379;876;2506
210735;202012;4639;13439;3967;12553;196;547;3401;11062;3597;11609
210740;202012;5218;13782;4547;13025;83;276;3896;11160;3979;11436
210745;202012;4357;11859;4043;11460;112;350;3665;10350;3777;10700
210750;202012;22810;58349;19731;54408;1914;4745;13615;39833;15529;44578
210760;202012;5854;15411;4954;14456;32;73;4714;13880;4746;13953
210770;202012;5993;15435;5182;14496;59;258;4865;13507;4924;13765
210780;202012;7294;22790;6378;21264;582;1682;4894;16707;5476;18389
210790;202012;4152;13156;3749;12630;180;441;3097;10947;3277;11388
210800;202012;4795;12827;4115;11923;127;497;3596;10279;3723;10776
210805;202012;3907;14122;3712;13835;117;635;3260;12055;3377;12690
210810;202012;4753;13851;4331;13287;304;691;3550;11246;3854;11937
210820;202012;6700;19121;5587;17321;667;2112;3223;10365;3890;12477
210825;202012;6645;20599;5984;19713;271;884;5119;17153;5390;18037
210830;202012;7651;21344;6943;20489;313;723;6118;18430;6431;19153
210840;202012;3120;8358;2799;7918;58;195;2505;7008;2563;7203
210845;202012;6466;17325;5783;16581;34;112;5519;15963;5553;16075
210850;202012;5701;19397;4782;18029;212;1106;3793;14304;4005;15410
210860;202012;21149;53462;17596;49026;1018;2387;13862;40923;14880;43310
210870;202012;7189;18717;5687;17007;221;589;4990;15045;5211;15634
210880;202012;4212;12873;3775;12339;184;746;3016;9800;3200;10546
210890;202012;3768;11075;3365;10551;255;661;2686;8721;2941;9382
210900;202012;4374;12725;3358;10802;1328;4585;484;1794;1812;6379
210905;202012;1977;5431;1647;5004;46;82;1507;4689;1553;4771
210910;202012;6997;21214;5815;19279;770;2584;3777;12676;4547;15260
210920;202012;3162;10389;2737;9834;72;412;2443;8678;2515;9090
210923;202012;1562;4611;1316;4213;83;296;934;3008;1017;3304
210927;202012;5113;16220;4496;15476;353;1173;3514;12469;3867;13642
210930;202012;2417;8370;2123;7797;153;626;1604;5880;1757;6506
210940;202012;4016;11308;3730;10973;106;447;3410;9899;3516;10346
210945;202012;6510;18569;5833;17759;238;674;4894;15318;5132;15992
210950;202012;5078;14128;3908;12493;615;1523;2555;8974;3170;10497
210955;202012;1495;4759;1288;4408;133;461;887;3138;1020;3599
210960;202012;8745;26047;7585;24299;1202;3523;5004;16814;6206;20337
210970;202012;1316;4043;1049;3580;91;286;753;2561;844;2847
210975;202012;1725;5361;1550;5084;71;265;1246;4098;1317;4363
210980;202012;9957;23150;8709;21857;93;236;8238;20769;8331;21005
210990;202012;16054;44801;12578;40207;663;2281;9292;30731;9955;33012
211000;202012;14379;41864;12028;38935;797;2653;9214;31145;10011;33798
211003;202012;5582;16569;4703;15505;143;550;4072;13696;4215;14246
211010;202012;6263;22410;5623;21630;175;792;4985;19516;5160;20308
211020;202012;8026;23210;6950;21988;267;1002;5870;19110;6137;20112
211023;202012;1912;6225;1785;6058;90;315;1521;5163;1611;5478
211027;202012;3029;9692;2865;9435;192;512;2477;8260;2669;8772
211030;202012;3736;10338;3337;9842;225;552;2727;8254;2952;8806
211040;202012;4579;16455;4233;15857;123;713;3781;14036;3904;14749
211050;202012;8903;23184;8087;22082;83;302;7380;20106;7463;20408
211060;202012;6848;20662;6247;19851;161;660;5517;17519;5678;18179
211065;202012;2172;6079;1797;5600;107;348;1413;4515;1520;4863
211070;202012;7712;24217;6553;22465;561;1847;5022;17479;5583;19326
211080;202012;1278;3531;1023;3130;34;187;789;2271;823;2458
211085;202012;2015;5639;1729;5268;98;228;1483;4708;1581;4936
211090;202012;3137;8620;2835;8271;34;159;2643;7668;2677;7827
211100;202012;6766;16938;6238;16301;45;150;5799;15210;5844;15360
211102;202012;3076;10381;2812;9989;143;660;2430;8518;2573;9178
211105;202012;2329;7291;1935;6570;175;607;1379;4653;1554;5260
211107;202012;4643;14453;3965;13465;138;607;3132;11047;3270;11654
211110;202012;5849;15846;4552;13875;362;1030;3352;10441;3714;11471
211120;202012;43964;107023;35912;97560;5188;12712;23070;67162;28258;79874
211125;202012;2058;6150;1738;5656;51;183;1471;4823;1522;5006
211130;202012;179341;424418;153736;391086;23372;56129;74400;215397;97772;271526
211140;202012;4899;14420;4271;13608;227;620;3593;11587;3820;12207
211150;202012;9144;24946;7733;23104;331;912;6531;19663;6862;20575
211153;202012;2356;6931;1868;6317;228;816;1247;4382;1475;5198
211157;202012;1121;3529;933;3180;33;153;675;2300;708;2453
211160;202012;3961;11169;3119;9960;142;503;2362;7490;2504;7993
211163;202012;1578;5123;1443;4938;76;323;1242;4254;1318;4577
211167;202012;1498;4758;1405;4609;45;202;1229;3981;1274;4183
211170;202012;6344;15643;5884;15111;59;157;5592;14323;5651;14480
211172;202012;2489;6690;2127;6137;107;337;1634;4579;1741;4916
211174;202012;2802;8115;2538;7820;36;184;2378;7288;2414;7472
211176;202012;4159;11819;3232;10449;150;639;2591;8341;2741;8980
211178;202012;4497;10579;3927;9948;30;132;3739;9389;3769;9521
211180;202012;3996;13121;3709;12705;216;808;3072;10549;3288;11357
211190;202012;3034;8868;2574;8193;34;191;2296;7240;2330;7431
211195;202012;1390;3898;1192;3593;78;151;994;3102;1072;3253
211200;202012;2112;6015;1705;5445;208;630;1193;3888;1401;4518
211210;202012;6107;18792;5539;18032;246;1030;4700;15154;4946;16184
211220;202012;36227;91241;29739;83244;2881;7448;22085;63471;24966;70919
211223;202012;5206;13602;4277;12376;376;1101;3120;9067;3496;10168
211227;202012;1730;5717;1556;5468;65;315;1209;4290;1274;4605
211230;202012;7438;21454;6507;20050;409;1062;5239;16552;5648;17614
211240;202012;7922;25060;7531;24557;131;725;7024;22638;7155;23363
211245;202012;6938;17408;6175;16616;84;209;5967;16070;6051;16279
211250;202012;12918;40779;11695;39051;735;2743;9451;31482;10186;34225
211260;202012;7983;25768;7115;24615;236;994;6351;22104;6587;23098
211270;202012;10351;32793;8837;30750;369;1679;7178;25175;7547;26854
211280;202012;12369;33996;11115;32413;833;1936;9154;27746;9987;29682
211285;202012;1765;5726;1565;5446;136;522;1153;4107;1289;4629
211290;202012;7358;22046;6644;21114;172;698;5757;18250;5929;18948
211300;202012;7589;21919;6697;20496;219;746;5620;16993;5839;17739
211400;202012;11327;31944;9266;29126;1067;3372;6162;20367;7229;23739
220005;202012;1826;4689;1657;4455;33;111;1420;3761;1453;3872
220010;202012;1468;4186;1202;3707;27;114;936;2861;963;2975
220020;202012;3631;9949;3133;9249;134;470;2590;7590;2724;8060
220025;202012;2198;5017;1888;4560;26;72;1583;3710;1609;3782
220027;202012;1272;3187;1088;2940;21;79;935;2479;956;2558
220030;202012;3313;8345;3097;8059;80;217;2739;7068;2819;7285
220040;202012;7064;21220;6172;19493;1511;4299;3144;10572;4655;14871
220045;202012;1445;4419;1188;3992;27;151;977;3223;1004;3374
220050;202012;4712;12695;4014;11793;58;271;3695;10731;3753;11002
220060;202012;2340;4902;1995;4504;25;60;1885;4243;1910;4303
220070;202012;2396;6031;2048;5513;70;143;1709;4626;1779;4769
220080;202012;731;2047;630;1897;21;68;541;1622;562;1690
220090;202012;1733;4172;1455;3777;17;53;1209;3263;1226;3316
220095;202012;640;1599;598;1554;26;43;539;1425;565;1468
220100;202012;1356;3733;1096;3318;44;150;883;2606;927;2756
220105;202012;1998;6189;1747;5692;106;398;1337;4338;1443;4736
220110;202012;3319;9142;3058;8687;34;167;2747;7708;2781;7875
220115;202012;2669;7665;2477;7410;72;215;2250;6712;2322;6927
220117;202012;1383;3291;1104;2912;5;23;935;2422;940;2445
220120;202012;12805;34077;11709;32706;78;280;11031;30757;11109;31037
220130;202012;1100;2944;946;2735;14;80;862;2460;876;2540
220140;202012;2142;4377;1805;3975;102;251;1579;3436;1681;3687
220150;202012;6211;18406;5671;17490;104;515;4819;14599;4923;15114
220155;202012;1165;3329;929;2896;34;115;663;2029;697;2144
220157;202012;1055;2564;890;2314;24;81;704;1773;728;1854
220160;202012;2854;7852;2461;7143;34;153;2025;5773;2059;5926
220170;202012;1590;4100;1354;3744;13;56;1216;3315;1229;3371
220173;202012;2156;5933;1738;5199;47;203;1386;4026;1433;4229
220177;202012;1982;5587;1881;5475;10;37;1859;5402;1869;5439
220180;202012;1096;2630;894;2303;4;21;711;1725;715;1746
220190;202012;6991;17253;5951;15829;374;1008;4486;12189;4860;13197
220191;202012;1568;4649;1426;4412;82;280;1015;3096;1097;3376
220192;202012;2064;5380;1505;4390;29;93;1215;3482;1244;3575
220194;202012;1703;4822;1519;4532;57;206;1253;3696;1310;3902
220196;202012;2002;5124;1817;4848;28;111;1570;4118;1598;4229
220198;202012;1279;3480;1088;3231;8;38;1008;3007;1016;3045
220200;202012;5089;14585;4441;13746;74;329;3852;11905;3926;12234
220202;202012;2135;5973;1844;5497;26;138;1589;4648;1615;4786
220205;202012;2440;7011;2192;6553;53;200;1856;5472;1909;5672
220207;202012;759;2274;625;2045;59;203;400;1318;459;1521
220208;202012;1653;5036;1368;4478;178;626;797;2573;975;3199
220209;202012;1543;4413;1352;4066;23;98;1122;3333;1145;3431
220210;202012;1761;4200;1519;3821;10;42;1327;3253;1337;3295
220211;202012;1612;4049;1488;3880;16;64;1300;3398;1316;3462
220213;202012;1760;4654;1512;4233;28;101;1222;3328;1250;3429
220217;202012;2200;6431;2061;6269;41;83;1911;5919;1952;6002
220220;202012;10367;26904;8615;24202;587;1445;5795;17229;6382;18674
220225;202012;994;2615;815;2382;5;33;768;2221;773;2254
220230;202012;5587;13925;4808;12846;156;369;4152;11162;4308;11531
220240;202012;3001;8598;2734;8156;113;360;2236;6669;2349;7029
220245;202012;1790;4057;1375;3549;12;49;1258;3270;1270;3319
220250;202012;2939;8182;2603;7760;15;85;2454;7287;2469;7372
220253;202012;1573;4265;1418;4010;59;194;1198;3304;1257;3498
220255;202012;1920;4450;1648;4071;29;127;1433;3420;1462;3547
220260;202012;4298;13087;3772;12119;164;598;2985;9580;3149;10178
220265;202012;1292;4102;1157;3924;31;167;961;3207;992;3374
220270;202012;6015;19194;5672;18560;209;1005;4769;15094;4978;16099
220271;202012;1474;3759;1290;3504;26;90;1132;3056;1158;3146
220272;202012;1743;5000;1550;4650;51;157;1173;3432;1224;3589
220273;202012;1225;3463;1024;3096;33;130;792;2356;825;2486
220275;202012;2302;5357;1842;4729;40;88;1625;4197;1665;4285
220277;202012;2129;5323;1820;4877;27;70;1539;4059;1566;4129
220280;202012;1648;3821;1373;3467;23;74;1160;2909;1183;2983
220285;202012;1410;3541;1226;3330;10;38;1133;3054;1143;3092
220290;202012;6520;18030;5183;16138;364;1184;3769;12067;4133;13251
220300;202012;1946;5587;1596;5127;34;176;1344;4293;1378;4469
220310;202012;3023;8019;2379;7269;43;212;1999;6072;2042;6284
220320;202012;3040;8800;2349;7512;72;338;1844;5718;1916;6056
220323;202012;1615;4676;1277;4128;50;193;1058;3359;1108;3552
220325;202012;1249;3681;1075;3392;23;113;895;2769;918;2882
220327;202012;1527;4284;1327;3962;40;164;1101;3199;1141;3363
220330;202012;4494;10596;3806;9764;59;194;3440;8773;3499;8967
220335;202012;1636;4931;1479;4731;32;102;1317;4232;1349;4334
220340;202012;1851;4840;1427;4137;58;182;984;2755;1042;2937
220342;202012;1161;3344;1037;3155;53;183;818;2486;871;2669
220345;202012;3103;6931;2399;5934;17;49;2173;5358;2190;5407
220350;202012;3295;8333;2643;7372;134;386;1875;5261;2009;5647
220360;202012;1225;3125;973;2712;16;43;776;2160;792;2203
220370;202012;8536;24776;7777;23537;151;641;6794;20305;6945;20946
220375;202012;1582;4474;1405;4259;2;13;1335;4072;1337;4085
220380;202012;1458;3443;1186;3066;13;36;1046;2679;1059;2715
220385;202012;831;1970;679;1694;6;15;596;1474;602;1489
220390;202012;10305;26467;7875;22692;2043;5766;2742;8892;4785;14658
220400;202012;1474;3477;1136;2954;29;88;868;2177;897;2265
220410;202012;1146;3153;941;2796;51;152;756;2212;807;2364
220415;202012;786;1999;661;1809;19;53;533;1435;552;1488
220420;202012;2004;5547;1610;4798;52;165;1248;3667;1300;3832
220430;202012;2460;6557;2306;6336;68;225;1986;5397;2054;5622
220435;202012;1732;4438;1498;4097;48;162;1243;3320;1291;3482
220440;202012;2349;7288;2006;6758;79;352;1712;5659;1791;6011
220450;202012;2480;6392;2022;5821;63;208;1722;4974;1785;5182
220455;202012;1255;3878;1195;3795;9;52;1068;3388;1077;3440
220460;202012;975;2392;904;2302;35;85;778;1962;813;2047
220465;202012;2302;7107;2043;6694;181;587;1500;5038;1681;5625
220470;202012;3538;9664;3195;9121;97;240;2615;7381;2712;7621
220480;202012;2825;7184;2264;6279;225;510;1453;4101;1678;4611
220490;202012;2470;6131;2134;5708;25;124;1863;4906;1888;5030
220500;202012;2834;7133;2450;6515;61;181;1995;5187;2056;5368
220510;202012;2515;7081;1991;6127;73;200;1562;4856;1635;5056
220515;202012;1628;3921;1505;3749;41;58;1306;3261;1347;3319
220520;202012;4880;12621;4424;11977;103;289;3856;10368;3959;10657
220525;202012;1349;3349;1167;3118;7;37;1078;2843;1085;2880
220527;202012;1294;3599;1108;3326;11;51;954;2911;965;2962
220530;202012;1416;3505;1228;3260;29;89;1129;2972;1158;3061
220535;202012;804;2172;755;2108;30;81;610;1700;640;1781
220540;202012;3197;10158;2995;9770;134;450;2543;8268;2677;8718
220545;202012;1412;4218;1306;4043;68;256;1086;3323;1154;3579
220550;202012;8455;25852;7548;24273;471;1603;5755;18372;6226;19975
220551;202012;1399;3928;1244;3678;26;109;1020;2949;1046;3058
220552;202012;1551;4488;1270;3991;25;124;1030;3129;1055;3253
220553;202012;1763;4489;1456;4080;56;100;1180;3436;1236;3536
220554;202012;915;2354;666;1952;54;130;426;1242;480;1372
220555;202012;2313;6825;2060;6489;40;165;1711;5505;1751;5670
220556;202012;1183;3395;1032;3111;53;216;752;2175;805;2391
220557;202012;1626;4930;1371;4396;67;249;1018;3158;1085;3407
220558;202012;1379;3569;1085;3162;17;71;934;2699;951;2770
220559;202012;1778;4345;1518;3950;13;32;1239;3258;1252;3290
220560;202012;1726;3875;1418;3482;38;72;1288;3194;1326;3266
220570;202012;7038;20998;6421;20125;448;1403;5110;16143;5558;17546
220580;202012;6820;18595;6235;17652;79;278;5671;15951;5750;16229
220585;202012;2034;6355;1677;5693;45;145;1371;4720;1416;4865
220590;202012;1332;3550;1095;3193;70;190;779;2318;849;2508
220595;202012;2548;6893;2317;6572;21;103;2071;5807;2092;5910
220600;202012;1382;3069;1164;2799;87;106;973;2434;1060;2540
220605;202012;1566;4608;1345;4205;20;118;1101;3344;1121;3462
220610;202012;2751;7991;2582;7734;29;125;2419;7224;2448;7349
220620;202012;7765;23866;7167;23061;166;845;6542;20815;6708;21660
220630;202012;371;1079;285;918;22;76;192;611;214;687
220635;202012;1672;5163;1487;4759;48;238;1145;3549;1193;3787
220640;202012;2435;6758;2073;6235;73;296;1685;5015;1758;5311
220650;202012;2048;5628;1778;5220;37;136;1443;4225;1480;4361
220660;202012;2553;7954;2177;7315;74;362;1826;6013;1900;6375
220665;202012;1218;3661;1028;3343;31;172;861;2720;892;2892
220667;202012;1604;4934;1440;4630;59;222;1164;3722;1223;3944
220669;202012;1575;4772;1510;4673;46;222;1354;4088;1400;4310
220670;202012;2182;5616;1756;5019;15;74;1532;4366;1547;4440
220672;202012;3212;7795;2601;7051;94;313;2315;6192;2409;6505
220675;202012;1255;3419;1118;3168;29;91;928;2601;957;2692
220680;202012;2677;7223;2553;7052;96;215;2344;6525;2440;6740
220690;202012;1542;4052;1367;3786;51;149;1099;3042;1150;3191
220695;202012;891;2445;826;2334;22;66;723;2034;745;2100
220700;202012;9767;23959;7882;21387;326;901;6058;16370;6384;17271
220710;202012;898;2453;657;1998;36;108;494;1474;530;1582
220720;202012;2098;4966;1889;4687;17;71;1654;4049;1671;4120
220730;202012;1305;3620;1108;3282;12;65;941;2728;953;2793
220735;202012;961;2225;756;1909;19;67;625;1520;644;1587
220740;202012;1334;3450;1079;3121;27;70;906;2667;933;2737
220750;202012;3767;9567;3312;8920;189;456;2873;7784;3062;8240
220755;202012;1332;3216;1102;2874;20;75;906;2299;926;2374
220760;202012;3082;8394;2718;7904;63;186;2463;7219;2526;7405
220770;202012;23140;67833;19492;61565;5835;19446;6799;22490;12634;41936
220775;202012;1152;2902;1024;2741;14;46;981;2611;995;2657
220777;202012;1584;4011;1202;3426;31;78;923;2648;954;2726
220779;202012;1252;3207;1086;2966;17;59;959;2590;976;2649
220780;202012;5557;13892;4824;12781;204;642;3949;10237;4153;10879
220785;202012;1475;3246;1291;3009;10;30;1239;2866;1249;2896
220790;202012;10125;28518;9136;27091;205;926;7687;22577;7892;23503
220793;202012;921;2414;736;2089;9;22;617;1771;626;1793
220795;202012;1370;3527;1210;3303;20;74;1075;2921;1095;2995
220800;202012;17754;39128;15085;35635;631;1429;11746;27788;12377;29217
220810;202012;2997;8235;2532;7417;52;155;2089;6066;2141;6221
220820;202012;4823;12639;4213;11739;260;640;3188;8874;3448;9514
220830;202012;7207;18968;6470;17951;254;791;5372;14691;5626;15482
220840;202012;12019;36685;10024;32586;2235;6928;4678;15868;6913;22796
220850;202012;3112;9525;2811;9148;54;283;2510;8163;2564;8446
220855;202012;686;1732;599;1617;16;53;543;1458;559;1511
220860;202012;1047;2591;912;2376;17;68;825;2118;842;2186
220865;202012;2429;6383;1888;5414;89;334;1382;3829;1471;4163
220870;202012;3005;8212;2515;7563;29;146;2320;6959;2349;7105
220880;202012;5255;12318;4524;11407;86;307;4126;10290;4212;10597
220885;202012;1384;4144;1150;3749;54;186;910;3012;964;3198
220887;202012;1580;3344;1322;3009;14;31;1232;2787;1246;2818
220890;202012;1396;4218;1225;3961;47;163;1020;3345;1067;3508
220900;202012;1990;4708;1666;4286;32;74;1471;3777;1503;3851
220910;202012;1506;4107;1269;3761;57;171;1044;3127;1101;3298
220915;202012;937;2525;762;2208;4;18;585;1647;589;1665
220920;202012;1428;4390;1235;4135;52;220;1024;3446;1076;3666
220930;202012;1748;4644;1468;4241;17;52;1371;3951;1388;4003
220935;202012;1086;3112;876;2665;26;107;569;1635;595;1742
220937;202012;1450;3813;1240;3491;25;91;993;2751;1018;2842
220940;202012;1540;4240;1231;3689;34;113;958;2836;992;2949
220945;202012;436;1497;377;1367;21;122;282;983;303;1105
220950;202012;1400;3217;917;2465;17;57;732;1903;749;1960
220955;202012;1613;4058;1337;3584;24;69;1146;3032;1170;3101
220960;202012;790;1998;595;1669;20;62;417;1110;437;1172
220965;202012;1778;4814;1554;4482;21;130;1347;3798;1368;3928
220970;202012;1968;4624;1443;3846;30;84;1216;3203;1246;3287
220975;202012;680;1911;587;1792;15;81;525;1548;540;1629
220980;202012;1132;3190;1004;3017;38;140;832;2478;870;2618
220985;202012;1225;3195;1066;2962;43;120;868;2347;911;2467
220987;202012;1395;4165;1218;3851;56;210;983;3094;1039;3304
220990;202012;1693;4614;1492;4318;19;101;1266;3603;1285;3704
220995;202012;1069;3217;884;2873;38;126;633;2074;671;2200
220997;202012;2345;7085;2168;6801;45;199;1936;6014;1981;6213
221000;202012;4434;11990;3913;11213;80;362;3357;9503;3437;9865
221005;202012;1458;3795;1332;3591;17;91;1162;3035;1179;3126
221010;202012;1246;2782;994;2472;20;59;867;2111;887;2170
221020;202012;1503;4607;1397;4411;18;68;1066;3330;1084;3398
221030;202012;1624;3982;1398;3711;22;63;1209;3253;1231;3316
221035;202012;1483;3830;1302;3585;19;25;1158;3271;1177;3296
221037;202012;675;1849;559;1649;8;25;399;1129;407;1154
221038;202012;513;1445;397;1235;12;42;277;857;289;899
221039;202012;850;2308;736;2113;21;95;602;1658;623;1753
221040;202012;3987;11796;3464;10859;157;546;2745;8602;2902;9148
221050;202012;3862;10108;3416;9540;64;223;3077;8584;3141;8807
221060;202012;8392;23219;6984;20977;297;780;5672;17210;5969;17990
221062;202012;1124;3614;968;3358;37;171;790;2701;827;2872
221063;202012;1054;2877;914;2674;57;181;715;2054;772;2235
221065;202012;2588;6637;2275;6081;18;61;2010;5291;2028;5352
221070;202012;3360;10355;2715;9002;294;954;1664;5643;1958;6597
221080;202012;3456;8471;2826;7527;59;214;2327;6082;2386;6296
221090;202012;1389;3532;1142;3129;9;34;987;2651;996;2685
221093;202012;1349;3787;1224;3536;138;384;820;2333;958;2717
221095;202012;856;2230;729;2036;11;35;617;1694;628;1729
221097;202012;834;2151;641;1810;21;61;469;1262;490;1323
221100;202012;115355;305711;95725;271977;9870;30087;62228;171981;72098;202068
221110;202012;9813;29143;9026;28121;138;694;8104;25004;8242;25698
221120;202012;4724;12923;4213;12115;150;459;3678;10567;3828;11026
221130;202012;5342;13770;4003;11176;819;2147;1883;5349;2702;7496
221135;202012;1643;4273;1475;4049;48;141;1305;3590;1353;3731
221140;202012;1310;3063;1107;2808;11;37;999;2486;1010;2523
221150;202012;1098;2716;855;2294;21;96;667;1673;688;1769
221160;202012;714;1765;629;1655;16;20;517;1369;533;1389
221170;202012;968;2786;889;2638;13;46;773;2266;786;2312
230010;202012;2965;7698;2453;6841;31;112;2043;5577;2074;5689
230015;202012;3015;9622;2636;8857;161;593;1882;6289;2043;6882
230020;202012;12677;39783;11839;38489;328;1340;10121;32721;10449;34061
230030;202012;12918;31869;10824;29167;196;562;9520;25642;9716;26204
230040;202012;4437;11325;3683;10117;50;232;3087;8344;3137;8576
230050;202012;2725;8375;2061;6823;336;1071;926;2997;1262;4068
230060;202012;2300;6324;1857;5537;38;163;1461;4290;1499;4453
230070;202012;3927;10269;3147;8768;147;432;2247;6191;2394;6623
230075;202012;8745;28451;8026;27188;475;1945;6392;21400;6867;23345
230080;202012;3005;6303;2287;5433;6;18;2095;4992;2101;5010
230090;202012;4328;10563;3660;9514;183;447;2938;7609;3121;8056
230100;202012;17925;46023;15702;43020;1271;3353;11247;31173;12518;34526
230110;202012;12577;37058;10527;33042;1711;5312;5526;17545;7237;22857
230120;202012;7409;19625;6509;18167;530;1281;4821;13663;5351;14944
230125;202012;3155;8286;2558;7329;87;288;1976;5582;2063;5870
230130;202012;5646;17274;4562;14881;402;1374;2959;9541;3361;10915
230140;202012;3342;9970;2842;8955;95;389;2195;6740;2290;7129
230150;202012;1576;4716;1291;4087;203;558;752;2471;955;3029
230160;202012;6363;16434;5485;15067;179;611;4484;12116;4663;12727
230170;202012;6213;17525;5064;15188;289;846;3675;10865;3964;11711
230180;202012;1618;4452;1372;3985;19;83;1128;3182;1147;3265
230185;202012;4406;12330;3725;11192;264;869;2769;8298;3033;9167
230190;202012;13070;37709;10972;33851;1446;4603;6325;19403;7771;24006
230195;202012;5223;15292;4752;14395;415;1216;3536;10709;3951;11925
230200;202012;4946;13564;4152;12083;156;493;3194;9121;3350;9614
230205;202012;4154;12106;3646;11328;211;660;2759;8571;2970;9231
230210;202012;10088;24253;8514;22143;333;1091;6731;17171;7064;18262
230220;202012;13714;34361;12013;31904;586;1547;9940;26175;10526;27722
230230;202012;6787;20169;6052;18679;404;1222;4471;13799;4875;15021
230240;202012;12762;34154;11034;31189;268;1157;9155;25273;9423;26430
230250;202012;8875;24599;8243;23623;237;804;6700;18699;6937;19503
230260;202012;14586;42898;12593;39341;1930;5751;7006;22496;8936;28247
230270;202012;7596;20276;5792;16879;504;1424;3788;11125;4292;12549
230280;202012;20161;53563;16430;47225;461;1922;13002;35985;13463;37907
230290;202012;4923;13395;4061;11789;241;625;3103;8989;3344;9614
230300;202012;4830;12635;4370;12013;95;263;3859;10577;3954;10840
230310;202012;4493;12773;3804;11548;127;552;2762;8165;2889;8717
230320;202012;7687;22059;6464;19831;230;944;4985;14970;5215;15914
230330;202012;4528;12345;3591;10544;133;442;2721;7809;2854;8251
230340;202012;3625;11090;3094;10009;264;915;2098;6695;2362;7610
230350;202012;17790;48297;15535;45009;815;2683;10573;30835;11388;33518
230360;202012;2898;7572;2279;6486;130;376;1575;4422;1705;4798
230365;202012;3030;7426;2498;6641;55;238;2133;5577;2188;5815
230370;202012;57928;159363;49162;146286;7159;21444;29690;89543;36849;110987
230380;202012;6144;17005;4870;14679;125;503;3625;10684;3750;11187
230390;202012;3361;9824;2908;9092;88;360;2288;7057;2376;7417
230393;202012;3302;9602;2637;8224;83;418;2038;6100;2121;6518
230395;202012;5689;15456;4957;14238;317;855;3535;10179;3852;11034
230400;202012;5342;14655;4762;13694;94;484;3844;10727;3938;11211
230410;202012;13761;40452;11386;36048;879;3008;7882;24929;8761;27937
230420;202012;28785;78011;23371;68668;2834;8638;13261;38647;16095;47285
230423;202012;4679;13706;4086;12528;80;366;3378;10159;3458;10525
230425;202012;5590;17012;5097;16014;416;1388;3647;11367;4063;12755
230426;202012;2789;7227;2028;5744;28;106;1528;4226;1556;4332
230427;202012;1802;5061;1280;3955;59;193;855;2532;914;2725
230428;202012;9395;24882;7985;22746;1083;3036;4711;13407;5794;16443
230430;202012;5039;13912;3946;11992;161;529;2952;8834;3113;9363
230435;202012;5871;15282;4874;13514;633;1648;2929;8233;3562;9881
230440;202012;411681;1009169;341197;905383;32482;91463;224348;587218;256830;678681
230445;202012;4232;11164;3420;9750;176;492;2350;6545;2526;7037
230450;202012;3531;10041;3067;9365;245;915;2236;6617;2481;7532
230460;202012;2108;5819;1837;5394;52;215;1552;4520;1604;4735
230465;202012;4051;11237;3445;10073;96;378;2625;7386;2721;7764
230470;202012;11191;36742;9995;34529;882;3394;7062;24042;7944;27436
230480;202012;1435;4139;1220;3749;62;250;913;2694;975;2944
230490;202012;2511;7002;2107;6228;162;554;1332;3700;1494;4254
230495;202012;5657;16706;4987;15505;396;1426;3308;10177;3704;11603
230500;202012;9310;29447;8318;27641;249;1031;6852;22736;7101;23767
230510;202012;1590;4721;1248;3984;167;582;644;2027;811;2609
230520;202012;4549;12693;3925;11586;335;933;2730;8101;3065;9034
230523;202012;15368;44799;12156;37909;2716;8446;3179;10587;5895;19033
230526;202012;3688;10426;3140;9499;188;528;2287;6990;2475;7518
230530;202012;5398;16704;4531;14986;276;1034;3315;10780;3591;11814
230533;202012;4490;10520;3708;9280;99;267;3106;7647;3205;7914
230535;202012;5232;14452;4426;13086;294;876;2987;8919;3281;9795
230540;202012;15843;42874;13622;39617;279;1050;11309;32650;11588;33700
230550;202012;20862;54566;16741;47593;1474;4318;10867;30706;12341;35024
230560;202012;8021;19425;6533;17086;57;227;5637;14607;5694;14834
230565;202012;3036;8355;2561;7488;101;407;1967;5635;2068;6042
230570;202012;3342;8580;2858;7905;81;231;2353;6495;2434;6726
230580;202012;10935;28018;9366;25786;350;955;7754;21261;8104;22216
230590;202012;8930;24974;7421;22210;416;1433;5529;16002;5945;17435
230600;202012;3620;9296;2869;7981;78;211;1990;5574;2068;5785
230610;202012;6627;18121;5879;16868;454;1257;4647;13271;5101;14528
230620;202012;2069;5549;1586;4610;118;368;972;2724;1090;3092
230625;202012;7925;22218;6628;19841;1986;6184;1823;5900;3809;12084
230630;202012;10710;31596;9270;28749;1403;4124;5456;17285;6859;21409
230640;202012;27361;82020;24773;77939;1153;4513;19937;61807;21090;66320
230650;202012;5223;13818;4415;12419;131;489;3602;9884;3733;10373
230655;202012;9200;30862;8643;29898;659;2282;6900;24174;7559;26456
230660;202012;5978;17593;4895;15715;150;793;3987;12523;4137;13316
230670;202012;6159;14497;4497;11846;132;439;3645;9359;3777;9798
230680;202012;2624;7128;2223;6417;123;344;1603;4648;1726;4992
230690;202012;7148;20896;6131;18886;400;1404;3893;11783;4293;13187
230700;202012;10066;25770;8129;22174;316;823;6029;16185;6345;17008
230710;202012;6713;21028;5862;19219;618;1948;3925;12795;4543;14743
230720;202012;1816;5355;1481;4682;112;327;1024;3170;1136;3497
230725;202012;4002;11665;3582;10932;364;1267;2135;6409;2499;7676
230730;202012;55815;149517;43738;131173;9624;31112;14897;47209;24521;78321
230740;202012;6014;16521;5103;15058;129;443;4091;12044;4220;12487
230750;202012;8277;21824;6891;19544;160;534;5532;15315;5692;15849
230760;202012;10881;28465;9470;26361;475;1576;7239;19671;7714;21247
230763;202012;4912;13000;4130;11622;116;533;3374;9185;3490;9718
230765;202012;40559;108881;33488;97326;5069;15249;17344;49881;22413;65130
230770;202012;24888;61308;20755;55853;2078;5634;13864;37425;15942;43059
230780;202012;6420;22232;5836;20851;847;2969;3424;12588;4271;15557
230790;202012;2992;8523;2687;8022;109;443;2047;5927;2156;6370
230800;202012;8141;25596;7139;23558;919;3200;4141;13502;5060;16702
230810;202012;11024;32922;9880;31089;363;1346;7728;23891;8091;25237
230820;202012;3396;10996;2777;9615;268;1052;1633;5413;1901;6465
230830;202012;7416;20094;6343;18300;126;527;5271;14830;5397;15357
230835;202012;4245;10053;3223;8414;92;274;2605;6673;2697;6947
230837;202012;3019;9190;2682;8611;107;466;2171;6813;2278;7279
230840;202012;9137;26371;7859;24206;886;2517;5522;17243;6408;19760
230850;202012;9600;27525;8044;24451;345;1222;5849;17494;6194;18716
230860;202012;5236;13039;4326;11727;58;193;3858;10397;3916;10590
230870;202012;16307;39376;14021;35561;385;1070;11569;28820;11954;29890
230880;202012;2088;6260;1914;5976;49;252;1522;4630;1571;4882
230890;202012;4494;14246;4095;13455;324;1143;2996;9718;3320;10861
230900;202012;2912;8331;2499;7545;180;612;1699;5027;1879;5639
230910;202012;3092;8269;2504;7356;61;274;2027;5945;2088;6219
230920;202012;4548;12694;3820;11543;119;488;3054;9033;3173;9521
230930;202012;6447;17835;5385;15950;301;861;3785;11214;4086;12075
230940;202012;8257;20488;7122;18755;212;500;5982;15647;6194;16147
230945;202012;6502;18437;5554;16627;289;1017;3984;11676;4273;12693
230950;202012;6103;15339;5394;14362;97;247;4678;12476;4775;12723
230960;202012;13254;37967;11594;34819;1965;5800;5733;17427;7698;23227
230970;202012;13498;35400;11206;31813;1674;4608;6536;18819;8210;23427
230980;202012;2653;7649;2344;7112;341;969;1472;4627;1813;5596
230990;202012;1616;4520;1333;3955;63;262;960;2720;1023;2982
231000;202012;2486;6619;2028;5726;80;203;1508;4159;1588;4362
231010;202012;3593;8339;2817;7006;38;152;2452;5910;2490;6062
231020;202012;7893;24446;7035;22784;1280;3767;4044;13664;5324;17431
231025;202012;7350;20036;6391;18483;699;1967;4499;13140;5198;15107
231030;202012;7350;21580;5750;18204;996;2980;2918;9344;3914;12324
231040;202012;2919;8290;2534;7576;128;376;1986;5848;2114;6224
231050;202012;11403;29132;9215;25253;630;1692;6944;18619;7574;20311
231060;202012;2850;7931;2506;7388;58;180;2096;6178;2154;6358
231070;202012;7642;22051;6562;20166;660;2105;4369;13336;5029;15441
231080;202012;3913;11037;3323;10067;132;531;2541;7531;2673;8062
231085;202012;6660;16045;5260;14387;208;519;4118;11278;4326;11797
231090;202012;4513;11615;3303;9302;110;419;2250;6088;2360;6507
231095;202012;2250;6622;1774;5606;142;439;1196;3778;1338;4217
231100;202012;3178;9052;2616;7989;115;414;1967;5944;2082;6358
231110;202012;3625;10468;3296;9858;139;495;2487;7331;2626;7826
231120;202012;2264;6472;1868;5786;86;310;1353;4154;1439;4464
231123;202012;1879;4815;1573;4289;77;157;1157;3189;1234;3346
231126;202012;5388;14726;4389;12835;303;843;3178;9198;3481;10041
231130;202012;21314;53702;17689;49173;1031;3569;13181;35974;14212;39543
231135;202012;4023;11299;3343;9960;154;509;2412;7071;2566;7580
231140;202012;16249;45167;13007;39530;609;2414;9296;27529;9905;29943
231150;202012;5733;15416;4375;12879;658;1964;1949;5904;2607;7868
231160;202012;6191;18771;5436;17384;768;2337;3151;10328;3919;12665
231170;202012;4163;12094;3461;10774;164;590;2483;7473;2647;8063
231180;202012;14169;39710;11483;34066;3101;8878;4005;12399;7106;21277
231190;202012;3802;10637;3117;9394;74;293;2401;7098;2475;7391
231195;202012;4952;14681;4127;12987;266;928;3008;9415;3274;10343
231200;202012;7747;23840;6746;21798;177;891;5395;16866;5572;17757
231210;202012;4744;13800;4050;12663;170;629;3101;9514;3271;10143
231220;202012;12051;30987;9265;25723;411;1207;6836;18341;7247;19548
231230;202012;9141;28989;8064;26994;529;2001;5910;19868;6439;21869
231240;202012;11453;33040;10062;30406;1561;4542;6109;18747;7670;23289
231250;202012;2153;5465;1405;3811;113;320;845;2238;958;2558
231260;202012;3230;9002;2792;8310;265;759;1902;5787;2167;6546
231270;202012;6232;16233;5057;14326;144;551;3825;10574;3969;11125
231280;202012;1668;5192;1522;4922;83;277;1158;3725;1241;4002
231290;202012;37518;110894;31045;97782;5290;16429;14457;45371;19747;61800
231300;202012;4044;11073;3176;9345;182;591;2144;6161;2326;6752
231310;202012;7354;18732;5835;15929;485;1330;4035;10788;4520;12118
231320;202012;7786;21117;6096;18124;87;392;4784;14005;4871;14397
231325;202012;2384;6197;1958;5558;164;368;1354;3957;1518;4325
231330;202012;9300;27445;7680;24200;1399;4181;4113;13581;5512;17762
231335;202012;5582;14663;4765;13364;76;340;4218;11698;4294;12038
231340;202012;17514;53046;15771;49959;1295;4094;11677;37331;12972;41425
231350;202012;15567;42470;14217;40518;243;886;12810;36139;13053;37025
231355;202012;4337;12796;3913;11996;221;728;3070;9286;3291;10014
231360;202012;7363;22031;6365;20302;265;949;5068;16103;5333;17052
231370;202012;2137;5859;1707;5094;36;114;1307;3887;1343;4001
231375;202012;4254;13228;3888;12629;132;603;3259;10454;3391;11057
231380;202012;5994;16232;5427;15452;193;507;4410;12734;4603;13241
231390;202012;3263;9493;2924;8925;119;458;2180;6474;2299;6932
231395;202012;3975;11549;3284;10439;417;1327;1942;6265;2359;7592
231400;202012;9584;27311;8020;24453;263;1119;6086;18158;6349;19277
231410;202012;14555;44806;13235;42596;608;2155;10767;34360;11375;36515
240010;202012;2574;6675;2006;5656;202;574;1209;3352;1411;3926
240020;202012;12265;34268;10291;30759;623;2325;6909;20349;7532;22674
240030;202012;2812;6840;2543;6424;82;230;2211;5551;2293;5781
240040;202012;805;2318;671;2057;30;117;464;1371;494;1488
240050;202012;3246;8656;2632;7545;47;146;2022;5693;2069;5839
240060;202012;1373;3667;1129;3226;22;83;926;2591;948;2674
240070;202012;2090;6028;1882;5590;176;555;1374;3973;1550;4528
240080;202012;2868;7706;2336;6749;52;204;1796;5091;1848;5295
240090;202012;2203;5423;1803;4755;18;48;1518;3976;1536;4024
240100;202012;10038;24458;7973;20769;196;584;6283;15820;6479;16404
240110;202012;4499;12682;3784;11380;182;666;2770;8174;2952;8840
240120;202012;3240;8956;2608;8172;182;602;1863;5978;2045;6580
240130;202012;3588;7485;2985;6699;28;85;2728;6036;2756;6121
240140;202012;1706;5143;1468;4667;151;534;1007;3169;1158;3703
240145;202012;6401;17733;5205;15688;783;2405;2964;9053;3747;11458
240150;202012;902;2645;792;2412;52;183;607;1795;659;1978
240160;202012;1421;4287;1188;3852;45;204;898;2916;943;3120
240165;202012;959;2601;793;2284;24;83;656;1854;680;1937
240170;202012;2519;6753;2117;6033;189;606;1454;4014;1643;4620
240180;202012;2947;8683;2345;7452;559;1685;1040;3521;1599;5206
240185;202012;1207;3748;1108;3569;57;221;916;2920;973;3141
240190;202012;1073;3119;919;2862;18;86;786;2455;804;2541
240200;202012;10692;27053;8484;23328;853;2540;4935;13256;5788;15796
240210;202012;3252;7949;2648;6995;26;137;2238;5727;2264;5864
240220;202012;7182;21382;6443;20215;324;1409;5129;15795;5453;17204
240230;202012;5722;14533;4586;12639;213;571;3641;10085;3854;10656
240240;202012;1795;5144;1117;3554;104;345;387;1103;491;1448
240250;202012;2950;7654;2583;7157;88;265;2187;6028;2275;6293
240260;202012;13737;40394;11882;37262;1690;4954;7371;24257;9061;29211
240270;202012;2263;6706;1965;6203;106;319;1420;4652;1526;4971
240280;202012;1677;4281;1418;3856;55;149;1133;3048;1188;3197
240290;202012;1141;3318;926;2842;29;134;671;1937;700;2071
240300;202012;2293;5821;1645;4636;66;203;1036;2858;1102;3061
240310;202012;8295;21853;6526;18680;855;2596;3383;9542;4238;12138
240320;202012;2078;5588;1511;4482;35;157;1133;3204;1168;3361
240325;202012;31070;82089;24620;70728;4225;12440;11235;32410;15460;44850
240330;202012;1741;4723;1336;3956;55;190;917;2587;972;2777
240340;202012;1912;4405;1570;3894;59;145;1299;3170;1358;3315
240350;202012;2156;5462;1933;5215;32;97;1743;4718;1775;4815
240360;202012;8992;24460;7989;22894;768;2234;5709;16513;6477;18747
240370;202012;1913;4932;1488;4071;64;184;1067;2848;1131;3032
240375;202012;896;2239;749;1980;28;104;611;1561;639;1665
240380;202012;2199;6229;1626;4947;141;401;947;2857;1088;3258
240390;202012;1045;2511;738;1929;29;65;474;1160;503;1225
240400;202012;1464;3536;1133;2969;34;110;800;1972;834;2082
240410;202012;542;1629;457;1442;39;147;292;872;331;1019
240420;202012;4485;15678;3936;14438;442;1918;2358;8467;2800;10385
240430;202012;3367;8576;2794;7586;172;532;2095;5514;2267;6046
240440;202012;2479;5361;2096;4835;140;262;1708;3977;1848;4239
240450;202012;4465;12053;3469;10186;339;1031;2059;5820;2398;6851
240460;202012;2891;8186;2567;7660;215;697;2021;6000;2236;6697
240470;202012;3605;10798;2739;8995;480;1488;1399;4798;1879;6286
240480;202012;565;1547;383;1144;31;98;184;535;215;633
240485;202012;2172;6017;1754;5262;120;367;1210;3623;1330;3990
240490;202012;1582;4060;1244;3428;85;195;914;2547;999;2742
240500;202012;2140;5728;1861;5254;101;266;1494;4242;1595;4508
240510;202012;1677;4375;1459;4055;63;227;1204;3280;1267;3507
240520;202012;1477;3545;1150;3091;58;163;864;2339;922;2502
240530;202012;2154;6041;1941;5704;94;294;1626;4741;1720;5035
240540;202012;2279;5652;1984;5190;60;103;1721;4529;1781;4632
240550;202012;671;1904;608;1777;18;74;510;1446;528;1520
240560;202012;3248;8402;2740;7714;271;668;1995;5752;2266;6420
240570;202012;2784;7245;1837;5159;276;773;714;1899;990;2672
240580;202012;7913;23050;7000;21359;540;1561;5607;17270;6147;18831
240590;202012;729;1890;626;1713;11;38;473;1258;484;1296
240600;202012;1756;4774;1293;3805;44;142;858;2444;902;2586
240610;202012;4069;10891;3472;9814;122;409;2690;7471;2812;7880
240615;202012;1260;3211;1008;2762;113;295;683;1842;796;2137
240620;202012;1818;5063;1568;4638;104;267;1245;3696;1349;3963
240630;202012;2032;5743;1832;5401;135;288;1315;4042;1450;4330
240640;202012;955;2533;756;2200;30;109;565;1608;595;1717
240650;202012;3980;11099;3420;9942;239;694;2593;7436;2832;8130
240660;202012;3041;7744;2703;7309;46;146;2464;6664;2510;6810
240670;202012;2442;6864;1959;5874;146;460;1264;3698;1410;4158
240680;202012;1613;4246;1303;3711;51;152;995;2767;1046;2919
240690;202012;1000;2482;786;2129;15;65;632;1644;647;1709
240700;202012;2417;6946;1967;6105;53;185;1546;4730;1599;4915
240710;202012;15903;40966;13288;36485;1688;4534;8370;22965;10058;27499
240720;202012;5050;12327;4357;11367;383;1031;3224;8326;3607;9357
240725;202012;1113;3144;850;2624;40;126;573;1708;613;1834
240730;202012;2249;6234;1810;5369;55;190;1370;4005;1425;4195
240740;202012;1805;4822;1433;4088;44;167;1062;2871;1106;3038
240750;202012;2084;6833;1761;6152;257;974;946;3327;1203;4301
240760;202012;1646;3783;1175;3061;69;100;898;2432;967;2532
240770;202012;3195;8754;2695;8026;125;442;2194;6467;2319;6909
240780;202012;4629;12793;3802;11416;520;1531;2349;7252;2869;8783
240790;202012;860;2416;720;2142;19;85;551;1587;570;1672
240800;202012;47316;112322;36575;96079;5041;13464;18996;49994;24037;63458
240810;202012;89403;228800;75497;205757;8670;24346;49296;132127;57966;156473
240820;202012;5802;17128;5021;15725;681;2096;3120;9961;3801;12057
240830;202012;8637;24362;7669;22906;262;1057;6344;18714;6606;19771
240840;202012;1102;2711;872;2341;29;74;628;1620;657;1694
240850;202012;1355;3667;971;2860;51;157;541;1542;592;1699
240860;202012;1307;3470;985;2890;16;76;738;2064;754;2140
240870;202012;1074;2709;809;2252;130;374;439;1254;569;1628
240880;202012;1253;3945;1102;3649;78;334;860;2775;938;3109
240890;202012;4318;11700;3274;9712;440;1432;1693;4832;2133;6264
240895;202012;2808;8528;2585;8169;160;478;2203;7072;2363;7550
240910;202012;3367;9019;2877;8125;55;193;2357;6531;2412;6724
240920;202012;902;2434;743;2178;68;179;421;1290;489;1469
240930;202012;3640;8229;3002;7454;195;285;2251;5909;2446;6194
240933;202012;1676;4068;1405;3686;37;147;1242;3208;1279;3355
240940;202012;5861;14489;4587;12299;531;1441;2748;7195;3279;8636
240950;202012;1014;3010;887;2775;27;114;723;2211;750;2325
240960;202012;679;2072;609;1931;27;97;469;1458;496;1555
240970;202012;1858;4773;1494;4154;60;216;1216;3281;1276;3497
240980;202012;3273;9718;2887;9020;104;463;2350;7216;2454;7679
240990;202012;2540;7102;2227;6486;252;806;1579;4436;1831;5242
241000;202012;935;2448;739;2097;26;66;551;1540;577;1606
241010;202012;2785;8786;2537;8244;166;622;1866;5988;2032;6610
241020;202012;2102;5562;1568;4493;136;391;1024;2880;1160;3271
241025;202012;1778;5029;1413;4345;48;201;1030;3116;1078;3317
241030;202012;2452;7620;1960;6566;222;762;1266;4252;1488;5014
241040;202012;2278;7159;2005;6677;89;412;1614;5307;1703;5719
241050;202012;1342;3736;1111;3318;35;130;815;2369;850;2499
241060;202012;734;2058;646;1878;27;87;459;1285;486;1372
241070;202012;653;1779;558;1614;12;39;437;1223;449;1262
241080;202012;1119;3163;861;2638;8;35;628;1895;636;1930
241090;202012;1966;5716;1602;5088;45;219;1270;3970;1315;4189
241100;202012;1187;3280;915;2733;70;214;590;1714;660;1928
241105;202012;947;2859;771;2525;241;768;254;866;495;1634
241110;202012;973;2709;734;2214;35;99;491;1427;526;1526
241120;202012;7529;21150;6362;19080;940;2747;3772;11646;4712;14393
241140;202012;3268;8591;2567;7202;139;407;1861;5111;2000;5518
241142;202012;773;2056;565;1661;28;94;338;944;366;1038
241150;202012;5899;15233;5213;14107;143;465;4312;11469;4455;11934
241160;202012;1127;3020;899;2596;128;376;590;1662;718;2038
241170;202012;1334;3355;1128;3004;29;109;947;2424;976;2533
241180;202012;1025;2594;757;2071;94;263;379;1038;473;1301
241190;202012;1107;2893;928;2537;17;69;685;1807;702;1876
241200;202012;19401;50223;16700;45741;2649;7239;9768;26771;12417;34010
241210;202012;1399;3684;1011;2917;111;350;578;1632;689;1982
241220;202012;8877;25682;7736;23758;1719;5247;3762;12005;5481;17252
241230;202012;2932;7659;2579;7100;109;319;2149;5851;2258;6170
241240;202012;1209;3346;759;2352;66;209;336;1048;402;1257
241250;202012;5493;15728;4380;13634;157;708;3189;9555;3346;10263
241255;202012;2215;6885;1959;6338;108;437;1504;4766;1612;5203
241260;202012;4912;12662;3885;10948;81;317;3083;8502;3164;8819
241270;202012;1662;4792;1386;4268;105;351;1001;3089;1106;3440
241280;202012;2170;5400;1862;4840;59;148;1593;4085;1652;4233
241290;202012;3360;8192;2482;6767;73;233;1959;5206;2032;5439
241300;202012;1483;3922;1186;3395;37;128;810;2256;847;2384
241310;202012;2124;5208;1836;4802;13;51;1580;4177;1593;4228
241320;202012;915;2958;784;2712;82;346;516;1765;598;2111
241330;202012;1741;4451;1365;3948;18;95;1190;3406;1208;3501
241335;202012;3306;9104;2902;8360;110;348;2362;6719;2472;7067
241340;202012;1530;4243;1185;3532;247;785;491;1427;738;2212
241350;202012;2077;5879;1813;5410;94;320;1414;4161;1508;4481
241355;202012;1296;3492;1066;3042;14;42;831;2352;845;2394
241360;202012;2019;5206;1533;4226;40;118;1115;2978;1155;3096
241370;202012;1333;3678;1038;3064;48;155;725;2057;773;2212
241380;202012;637;1777;483;1479;73;189;242;772;315;961
241390;202012;2727;7917;2427;7465;195;528;1873;5879;2068;6407
241400;202012;3541;9740;3153;9139;140;468;2574;7395;2714;7863
241410;202012;2415;7118;1957;6177;341;1096;996;3158;1337;4254
241415;202012;1629;4818;1330;4236;59;214;936;2939;995;3153
241420;202012;2314;7166;1983;6602;464;1712;969;3234;1433;4946
241430;202012;597;1634;418;1244;17;57;263;743;280;800
241440;202012;7657;23122;6838;21670;378;1283;5386;17077;5764;18360
241445;202012;1120;2808;990;2639;21;55;880;2411;901;2466
241450;202012;2659;6511;2264;5874;387;849;1464;3978;1851;4827
241460;202012;3768;10129;3060;8644;194;568;2131;5889;2325;6457
241470;202012;1358;3599;1114;3234;28;101;927;2689;955;2790
241475;202012;1212;3354;955;2853;21;97;697;1987;718;2084
241480;202012;2927;9059;2394;7886;719;2342;793;2912;1512;5254
241490;202012;627;1475;513;1322;27;63;371;940;398;1003
241500;202012;789;2190;705;2083;3;10;658;1964;661;1974
250010;202012;2474;7430;2065;6585;57;226;1518;4740;1575;4966
250020;202012;1654;4338;1192;3444;44;80;841;2454;885;2534
250030;202012;6880;18709;6098;17464;547;1562;4536;12885;5083;14447
250040;202012;3977;12086;3438;11099;233;826;2507;7978;2740;8804
250050;202012;3580;9519;3240;9069;120;421;2672;7473;2792;7894
250053;202012;1160;3236;1058;3071;74;210;763;2234;837;2444
250057;202012;643;2289;601;2224;10;44;543;2037;553;2081
250060;202012;5430;14019;4870;13325;264;705;4073;11214;4337;11919
250070;202012;3971;10928;3347;9835;35;141;2707;7775;2742;7916
250073;202012;755;1994;615;1785;9;20;503;1428;512;1448
250077;202012;2184;5850;1643;4959;54;193;1252;3756;1306;3949
250080;202012;4864;12057;4110;11097;61;280;3602;9588;3663;9868
250090;202012;3340;8083;2904;7506;55;161;2496;6329;2551;6490
250100;202012;3619;10907;3256;10243;159;567;2566;7921;2725;8488
250110;202012;4878;13613;4393;12902;243;892;3456;9944;3699;10836
250115;202012;701;1801;509;1507;10;43;364;1068;374;1111
250120;202012;1865;5351;1560;4848;29;140;1234;3796;1263;3936
250130;202012;5515;15034;4661;13823;72;385;3963;11590;4035;11975
250135;202012;1169;3234;1020;2973;25;96;883;2558;908;2654
250140;202012;2244;6512;2086;6314;106;423;1801;5412;1907;5835
250150;202012;4690;14473;4197;13632;148;627;3352;10715;3500;11342
250153;202012;1375;3631;1150;3287;30;89;923;2614;953;2703
250157;202012;1789;5159;1618;4836;59;233;1311;3843;1370;4076
250160;202012;3875;9601;3090;8537;41;149;2720;7523;2761;7672
250170;202012;1807;4649;1622;4387;23;88;1419;3792;1442;3880
250180;202012;20031;47771;17088;44043;724;2200;13488;33945;14212;36145
250190;202012;3964;10546;3310;9574;312;933;2306;6520;2618;7453
250200;202012;1903;5071;1650;4725;59;183;1395;4001;1454;4184
250205;202012;850;2599;734;2422;13;65;610;1985;623;2050
250210;202012;1529;4601;1380;4367;68;293;1089;3393;1157;3686
250215;202012;1561;4244;1305;3890;76;248;775;2327;851;2575
250220;202012;656;1806;524;1610;24;91;345;1041;369;1132
250230;202012;1645;3686;1102;2848;16;55;921;2299;937;2354
250240;202012;2250;6860;1977;6357;36;181;1656;5245;1692;5426
250250;202012;4526;12517;3959;11690;85;280;3381;10008;3466;10288
250260;202012;1670;4624;1409;4173;51;124;1117;3287;1168;3411
250270;202012;1172;3544;1065;3410;53;196;805;2660;858;2856
250280;202012;3328;9158;2994;8670;106;295;2381;6918;2487;7213
250290;202012;1525;4022;1314;3718;19;63;1050;2961;1069;3024
250300;202012;5436;14448;4888;13805;181;805;4103;11184;4284;11989
250310;202012;1157;3179;968;2866;38;128;735;2150;773;2278
250320;202012;12095;26805;10403;24855;244;674;9354;22068;9598;22742
250330;202012;2356;6458;1978;5937;104;311;1600;4808;1704;5119
250340;202012;1093;2765;980;2623;13;35;907;2424;920;2459
250350;202012;4121;11457;3629;10623;201;470;2847;8609;3048;9079
250355;202012;1953;5912;1757;5642;29;156;1566;4999;1595;5155
250360;202012;1735;4786;1561;4551;37;140;1317;3799;1354;3939
250370;202012;13449;34274;11133;30751;238;862;9418;25642;9656;26504
250375;202012;1167;2993;941;2723;5;22;893;2597;898;2619
250380;202012;1602;4090;1464;3915;30;112;1288;3348;1318;3460
250390;202012;1809;4608;1525;4155;82;230;1225;3305;1307;3535
250400;202012;68280;166527;50131;138366;14040;41698;13956;40984;27996;82682
250403;202012;1743;4798;1551;4566;71;356;1214;3402;1285;3758
250407;202012;1257;3080;990;2685;76;164;679;1926;755;2090
250410;202012;643;1716;555;1567;4;9;463;1277;467;1286
250415;202012;1839;5143;1610;4773;29;136;1380;4070;1409;4206
250420;202012;1159;3248;1052;3093;29;101;932;2723;961;2824
250430;202012;6085;14993;5154;13761;130;395;4280;11213;4410;11608
250435;202012;1526;4247;1224;3728;14;73;942;2810;956;2883
250440;202012;4508;11918;3892;11143;70;195;3456;9900;3526;10095
250450;202012;1794;4720;1479;4285;28;97;1226;3567;1254;3664
250460;202012;7178;19394;6368;18195;336;1008;5108;14558;5444;15566
250470;202012;1523;3916;1265;3518;49;156;1002;2733;1051;2889
250480;202012;3935;10627;3344;9916;39;136;2953;8823;2992;8959
250485;202012;723;1616;531;1336;44;75;384;939;428;1014
250490;202012;5091;12051;4525;11403;163;484;4025;9955;4188;10439
250500;202012;1959;5373;1748;5004;71;224;1422;4074;1493;4298
250510;202012;5361;13484;4617;12496;75;195;4046;11036;4121;11231
250520;202012;1795;4818;1525;4426;122;390;1097;3166;1219;3556
250523;202012;2206;5433;1951;5108;72;284;1621;4087;1693;4371
250527;202012;1665;4244;1497;4051;24;71;1328;3617;1352;3688
250530;202012;622;1585;537;1466;5;11;476;1299;481;1310
250535;202012;1323;3902;1195;3659;26;113;969;2887;995;3000
250540;202012;2980;6762;2476;6199;76;136;2179;5558;2255;5694
250550;202012;759;2417;666;2234;21;83;500;1650;521;1733
250560;202012;1753;4778;1547;4482;37;137;1305;3703;1342;3840
250570;202012;2645;7852;2262;7150;80;293;1777;5546;1857;5839
250580;202012;1049;2736;922;2558;48;180;774;2102;822;2282
250590;202012;800;2239;718;2123;19;65;588;1749;607;1814
250600;202012;8083;20650;6722;18882;235;733;5543;15437;5778;16170
250610;202012;2927;8246;2621;7796;117;439;2178;6403;2295;6842
250620;202012;797;2054;685;1870;11;23;502;1351;513;1374
250625;202012;2458;7027;2193;6588;43;213;1871;5461;1914;5674
250630;202012;10145;27722;8210;24358;866;2581;5253;15292;6119;17873
250640;202012;3457;9403;3095;8925;102;388;2635;7492;2737;7880
250650;202012;947;2267;801;2068;13;36;701;1788;714;1824
250660;202012;1602;3970;1272;3509;39;108;1049;2823;1088;2931
250670;202012;2285;7130;2079;6767;43;190;1815;5810;1858;6000
250680;202012;5728;13265;5118;12574;55;210;4754;11531;4809;11741
250690;202012;6718;15062;5653;13728;100;239;5017;12097;5117;12336
250700;202012;4180;11727;3648;10917;444;1316;2512;7517;2956;8833
250710;202012;4286;12346;3756;11604;281;944;2741;8472;3022;9416
250720;202012;2707;7239;2418;6823;36;181;2127;5931;2163;6112
250730;202012;4071;10802;3559;10119;101;426;2986;8245;3087;8671
250740;202012;1891;4677;1586;4280;92;206;1245;3392;1337;3598
250750;202012;103309;251434;87416;229081;6905;19462;64276;165291;71181;184753
250760;202012;2337;6014;2037;5527;80;236;1631;4308;1711;4544
250770;202012;3950;11895;3541;11347;385;1187;2549;8288;2934;9475
250780;202012;1743;4660;1459;4145;51;179;1130;3121;1181;3300
250790;202012;2440;7142;2102;6635;130;512;1440;4434;1570;4946
250800;202012;2388;6323;2091;5839;87;177;1710;4823;1797;5000
250810;202012;1263;3306;1056;3015;29;60;890;2581;919;2641
250820;202012;1972;5407;1813;5233;28;126;1648;4726;1676;4852
250830;202012;5807;17260;4777;15177;274;1027;3272;10111;3546;11138
250840;202012;748;2365;643;2157;14;56;491;1657;505;1713
250850;202012;1770;5220;1589;4890;33;148;1319;3966;1352;4114
250855;202012;978;2837;834;2593;53;206;614;1884;667;2090
250860;202012;3113;9201;2586;8307;429;1461;1518;4885;1947;6346
250870;202012;993;2738;852;2504;36;130;700;2030;736;2160
250880;202012;1595;4069;1322;3672;74;210;1025;2849;1099;3059
250890;202012;10176;26011;8982;24408;437;1635;7172;18645;7609;20280
250900;202012;2892;7810;2505;7133;98;265;2092;5882;2190;6147
250905;202012;2431;6780;2237;6508;42;164;2046;5943;2088;6107
250910;202012;5974;14567;4935;13384;80;276;4337;11795;4417;12071
250915;202012;2152;4943;1489;4230;26;56;1298;3775;1324;3831
250920;202012;3474;8764;3041;8112;329;747;2239;6026;2568;6773
250930;202012;2241;5976;2027;5697;53;222;1759;4840;1812;5062
250933;202012;1154;3411;1018;3164;17;85;790;2394;807;2479
250937;202012;677;1818;557;1623;21;70;430;1270;451;1340
250939;202012;1771;4687;1536;4377;63;198;1197;3395;1260;3593
250940;202012;4020;10579;3539;9947;15;61;3168;8905;3183;8966
250950;202012;1725;4366;1383;3926;25;95;1124;3128;1149;3223
250960;202012;1100;3233;967;3020;26;136;790;2383;816;2519
250970;202012;8158;20946;7179;19365;208;661;6010;15915;6218;16576
250980;202012;2355;6255;2126;5919;30;134;1852;5034;1882;5168
250990;202012;2040;6122;1708;5548;55;251;1271;4074;1326;4325
251000;202012;2010;5663;1630;5002;36;161;1342;4084;1378;4245
251010;202012;2623;7293;2386;6938;20;78;2151;6259;2171;6337
251020;202012;1608;4387;1438;4110;33;149;1245;3487;1278;3636
251030;202012;997;2639;819;2319;34;93;571;1605;605;1698
251040;202012;1812;5065;1520;4571;33;163;1253;3742;1286;3905
251050;202012;1027;2807;859;2477;46;156;618;1710;664;1866
251060;202012;1062;2265;800;1933;8;26;623;1485;631;1511
251065;202012;474;1285;362;1075;11;32;250;728;261;760
251070;202012;721;1842;608;1677;9;35;524;1413;533;1448
251080;202012;18304;46551;14802;41253;1956;5603;9353;26238;11309;31841
251090;202012;2820;8061;2368;7252;58;203;1883;5731;1941;5934
251100;202012;784;2496;701;2339;22;84;548;1764;570;1848
251110;202012;1657;4428;1411;4002;49;127;1080;3060;1129;3187
251120;202012;7313;20179;6151;18765;263;939;4879;14919;5142;15858
251130;202012;3844;8522;3395;8013;55;159;3092;7251;3147;7410
251140;202012;4231;11740;3782;11120;70;291;3166;9199;3236;9490
251150;202012;2547;7487;2319;7110;93;400;1935;5800;2028;6200
251160;202012;2112;6182;1825;5763;37;180;1577;4891;1614;5071
251170;202012;1531;4156;1332;3899;30;105;1158;3370;1188;3475
251180;202012;2574;6856;2105;6196;157;467;1449;4247;1606;4714
251190;202012;4379;11363;3979;10910;43;241;3618;9716;3661;9957
251200;202012;4285;12533;3772;11878;70;307;3329;10496;3399;10803
251203;202012;923;3028;849;2858;21;111;640;2095;661;2206
251207;202012;1057;2899;830;2518;18;91;588;1741;606;1832
251210;202012;7543;18934;6178;17080;272;613;4759;13436;5031;14049
251220;202012;1153;2810;915;2492;52;117;702;1956;754;2073
251230;202012;4554;12589;3927;11497;107;387;3126;8919;3233;9306
251240;202012;3607;9801;3042;8861;162;428;2292;6599;2454;7027
251250;202012;10250;27368;8991;25244;737;2112;6636;18129;7373;20241
251260;202012;477;1345;433;1274;15;68;344;978;359;1046
251270;202012;4197;13050;3781;12492;109;441;3088;10420;3197;10861
251272;202012;1322;3585;1201;3421;47;176;1007;2797;1054;2973
251274;202012;885;2466;705;2135;57;195;471;1364;528;1559
251275;202012;1190;3354;1015;3064;26;121;809;2376;835;2497
251276;202012;1305;3540;1136;3317;29;149;922;2596;951;2745
251278;202012;576;1588;516;1499;45;110;382;1136;427;1246
251280;202012;2175;5911;1971;5612;47;142;1665;4695;1712;4837
251290;202012;5778;13570;5223;12894;142;458;4590;10982;4732;11440
251300;202012;853;2496;772;2372;7;38;661;2021;668;2059
251310;202012;2665;7629;2313;7089;46;254;1893;5658;1939;5912
251315;202012;1689;5239;1543;4965;88;265;1163;3713;1251;3978
251320;202012;1594;4239;1167;3499;32;112;872;2562;904;2674
251330;202012;2063;4790;1699;4363;22;79;1535;3970;1557;4049
251335;202012;1085;3091;970;2905;23;105;856;2507;879;2612
251340;202012;3655;8759;2928;7796;118;353;2264;6013;2382;6366
251350;202012;1018;2941;920;2779;27;102;759;2258;786;2360
251360;202012;1793;5036;1451;4545;19;106;1216;3802;1235;3908
251365;202012;713;1929;568;1642;5;20;448;1279;453;1299
251370;202012;24249;63282;20704;58184;2855;8040;12501;36072;15356;44112
251380;202012;1171;3303;1020;3044;17;99;852;2476;869;2575
251385;202012;736;1887;566;1577;23;67;413;1107;436;1174
251390;202012;6247;18013;5530;16904;465;1453;3743;11508;4208;12961
251392;202012;958;2589;811;2363;28;114;631;1800;659;1914
251394;202012;601;1724;492;1537;18;77;368;1135;386;1212
251396;202012;640;1728;554;1574;13;39;397;1106;410;1145
251398;202012;953;2390;656;1880;19;71;481;1345;500;1416
251400;202012;1221;2941;966;2597;23;94;770;1999;793;2093
251410;202012;1534;3572;1245;3164;19;77;1060;2585;1079;2662
251420;202012;1888;4967;1551;4573;41;150;1238;3611;1279;3761
251430;202012;1564;4688;1408;4414;31;147;1215;3793;1246;3940
251440;202012;1084;3000;876;2610;39;89;695;2103;734;2192
251445;202012;1535;4224;1413;4053;35;120;1208;3413;1243;3533
251450;202012;4358;12787;3900;12085;81;315;3256;10002;3337;10317
251455;202012;851;2566;776;2426;21;90;618;1884;639;1974
251460;202012;880;2551;766;2376;15;53;630;1963;645;2016
251465;202012;441;1283;380;1175;6;26;287;863;293;889
251470;202012;1170;3202;873;2585;73;238;510;1436;583;1674
251480;202012;980;2580;801;2261;18;76;621;1676;639;1752
251490;202012;1846;4843;1464;4304;59;181;1094;3244;1153;3425
251500;202012;1915;5369;1761;5174;32;120;1595;4685;1627;4805
251510;202012;2584;7727;2143;6841;103;378;1478;4615;1581;4993
251520;202012;982;2559;751;2130;68;186;474;1315;542;1501
251530;202012;14588;34871;11724;31309;102;562;10381;27242;10483;27804
251540;202012;2953;8370;2675;7848;66;226;2243;6494;2309;6720
251550;202012;3736;8801;3009;7902;107;202;2519;6678;2626;6880
251560;202012;527;1609;466;1510;56;195;324;1016;380;1211
251570;202012;934;2633;762;2293;19;84;601;1759;620;1843
251580;202012;1858;4426;1664;4144;33;148;1452;3474;1485;3622
251590;202012;1538;3838;1295;3552;48;134;1089;2933;1137;3067
251593;202012;898;2632;803;2477;87;269;516;1581;603;1850
251597;202012;2083;5851;1872;5571;20;104;1672;4899;1692;5003
251600;202012;6303;16951;5496;15717;174;527;4548;12838;4722;13365
251610;202012;3123;8919;2695;8121;239;653;1844;5674;2083;6327
251615;202012;1252;3087;1015;2734;24;65;815;2141;839;2206
251620;202012;18962;43159;14588;37778;95;333;12620;33000;12715;33333
251630;202012;4618;10825;3722;9576;198;501;2818;7196;3016;7697
251640;202012;2103;5730;1867;5362;29;139;1631;4575;1660;4714
251650;202012;3933;10539;3434;9871;132;402;2908;8364;3040;8766
251660;202012;3426;10248;3025;9543;72;329;2519;7817;2591;8146
251670;202012;3947;11149;3518;10530;48;243;3129;9295;3177;9538
251675;202012;619;1775;557;1699;75;221;372;1162;447;1383
251680;202012;2479;6525;2073;5989;42;135;1688;4927;1730;5062
251690;202012;2996;8416;2538;7625;84;267;1927;5736;2011;6003
251700;202012;2098;5877;1752;5441;42;186;1484;4528;1526;4714
251710;202012;771;1993;534;1507;39;131;316;844;355;975
251720;202012;1290;3642;1037;3196;23;104;805;2412;828;2516
251740;202012;600;1668;484;1451;41;152;325;932;366;1084
260005;202012;29598;62441;24325;55597;1683;3759;18687;41931;20370;45690
260010;202012;10064;26230;8338;23477;451;1327;4957;14074;5408;15401
260020;202012;6739;15711;5750;14295;90;406;4901;11968;4991;12374
260030;202012;6799;17244;5750;15721;133;397;4695;12778;4828;13175
260040;202012;7496;19092;6258;17290;409;1117;4482;12551;4891;13668
260050;202012;13886;35799;11568;33235;173;687;10671;30683;10844;31370
260060;202012;4061;9976;3489;9066;225;504;2723;7139;2948;7643
260070;202012;10522;26247;8999;24040;307;1072;7336;19085;7643;20157
260080;202012;6437;14671;5617;13577;108;359;4735;11251;4843;11610
260090;202012;4500;11661;4012;10992;445;1245;2886;7908;3331;9153
260100;202012;2888;7853;2437;7180;49;250;2020;5849;2069;6099
260105;202012;4950;13528;4425;12812;127;448;3727;10644;3854;11092
260110;202012;21957;60525;19562;57034;906;3077;16228;46651;17134;49728
260120;202012;14356;37986;12116;34632;1409;3924;7813;22712;9222;26636
260130;202012;3157;8005;2795;7471;276;705;2010;5328;2286;6033
260140;202012;12803;28682;11044;26606;525;1410;9345;22173;9870;23583
260150;202012;3538;8193;3053;7596;88;253;2693;6635;2781;6888
260160;202012;6435;16673;5469;15509;90;308;4952;14165;5042;14473
260170;202012;20239;47364;17156;43187;903;2298;13724;34157;14627;36455
260180;202012;3462;9157;2998;8526;68;253;2596;7273;2664;7526
260190;202012;17841;35880;15052;32594;161;431;13429;28542;13590;28973
260200;202012;10915;26268;9399;24326;434;987;7863;20672;8297;21659
260210;202012;11624;32647;9890;29793;303;1116;7903;23654;8206;24770
260220;202012;10210;24410;9437;23419;163;523;8336;20381;8499;20904
260230;202012;10544;25791;9199;24007;181;623;7823;20051;8004;20674
260240;202012;2687;8010;2359;7375;99;329;1827;5679;1926;6008
260250;202012;2184;5688;1900;5229;121;265;1453;4014;1574;4279
260260;202012;12805;32940;11404;30812;349;1155;9123;24165;9472;25320
260270;202012;4258;10173;3755;9569;119;424;3170;7933;3289;8357
260280;202012;12686;37844;11448;36092;424;1774;9779;30388;10203;32162
260290;202012;40494;101441;34724;93098;3720;10154;23699;63326;27419;73480
260300;202012;9424;25362;8246;23758;177;798;7039;20169;7216;20967
260310;202012;5198;13106;4587;12339;328;794;3557;9718;3885;10512
260320;202012;7543;21775;6382;19805;249;816;5201;16130;5450;16946
260330;202012;2551;7807;2233;7153;74;276;1766;5522;1840;5798
260340;202012;2019;5397;1752;5001;24;110;1518;4234;1542;4344
260345;202012;25003;64058;20769;57901;3102;9181;11030;30258;14132;39439
260350;202012;5580;12929;4837;12084;60;177;4326;10748;4386;10925
260360;202012;2474;6470;2242;6040;47;204;1583;4156;1630;4360
260370;202012;5500;15669;4743;14411;222;733;3680;11133;3902;11866
260380;202012;4995;14506;4285;13341;173;540;3248;10028;3421;10568
260390;202012;4465;13303;3705;11743;233;709;2479;7741;2712;8450
260392;202012;3319;10609;2996;10199;110;662;2440;8277;2550;8939
260400;202012;18192;41695;15679;38415;453;1264;12422;29308;12875;30572
260410;202012;71496;172797;55058;149791;9691;27592;24917;70113;34608;97705
260415;202012;4349;11494;3763;10539;57;240;3097;8505;3154;8745
260420;202012;12435;25843;10566;23764;96;271;9815;21872;9911;22143
260430;202012;2674;8311;2310;7582;103;419;1645;5314;1748;5733
260440;202012;3640;9371;3233;8770;67;239;2735;7286;2802;7525
260450;202012;5702;14253;5100;13484;273;545;4245;11419;4518;11964
260460;202012;5113;15136;4345;13788;463;1628;2606;8135;3069;9763
260470;202012;4778;12708;4070;11881;76;190;3749;11081;3825;11271
260480;202012;3911;10388;3287;9500;218;762;2288;6619;2506;7381
260490;202012;5297;12122;4708;11266;32;137;4305;10131;4337;10268
260500;202012;5948;14881;5069;13656;438;1107;3580;9797;4018;10904
260510;202012;9789;23991;8220;21801;110;426;7275;19123;7385;19549
260515;202012;4329;11494;3370;9713;156;422;2284;6426;2440;6848
260520;202012;16796;38694;14605;35893;696;1662;11987;29093;12683;30755
260530;202012;9714;27640;8299;25461;139;655;7165;21681;7304;22336
260540;202012;7128;15453;6296;14399;141;339;5682;12891;5823;13230
260545;202012;69;211;43;148;3;12;19;62;22;74
260550;202012;3024;8230;2491;7376;107;404;1726;4995;1833;5399
260560;202012;5892;14989;4945;13604;124;471;4167;11232;4291;11703
260570;202012;7641;20691;6727;19454;356;1123;5331;15481;5687;16604
260580;202012;4446;10475;4000;9882;27;94;3651;8956;3678;9050
260590;202012;6616;15357;5537;14144;224;545;4595;11912;4819;12457
260600;202012;30391;78023;24717;69354;1059;3267;18863;52011;19922;55278
260610;202012;7243;18605;6458;17573;391;1127;4867;13192;5258;14319
260620;202012;16437;42005;14315;38948;1237;3774;10499;27975;11736;31749
260630;202012;2349;6321;1925;5657;36;150;1563;4490;1599;4640
260640;202012;22043;49066;18384;44855;825;1998;14945;36265;15770;38263
260650;202012;6205;15887;4980;14397;434;876;4015;12006;4449;12882
260660;202012;6923;18097;5985;16856;163;663;5138;14153;5301;14816
260670;202012;2218;5764;1864;5223;76;191;1356;3737;1432;3928
260680;202012;28587;67516;24063;61115;1652;4453;17127;42668;18779;47121
260690;202012;3455;8932;2905;8081;78;305;2296;6321;2374;6626
260700;202012;6113;17014;5710;16553;18;68;5542;16153;5560;16221
260710;202012;1339;3477;1152;3211;31;116;917;2550;948;2666
260720;202012;23441;57403;20102;53033;1883;5036;14805;38947;16688;43983
260730;202012;7802;21948;6820;20586;242;839;5743;17121;5985;17960
260740;202012;1312;3708;1112;3383;14;73;870;2706;884;2779
260750;202012;7092;19342;5963;17931;257;518;5202;16152;5459;16670
260760;202012;5647;13234;4847;12299;197;521;3993;10180;4190;10701
260765;202012;8005;22858;6942;21396;403;1639;4919;14886;5322;16525
260770;202012;3848;9746;3195;8663;127;395;2502;6689;2629;7084
260775;202012;5173;13672;4534;12705;185;683;3564;9642;3749;10325
260780;202012;3637;10733;3246;10105;295;1059;2051;6172;2346;7231
260790;202012;118934;263570;97963;236233;14772;34354;60815;147422;75587;181776
260795;202012;2941;7479;2522;6942;78;269;1985;5500;2063;5769
260800;202012;5332;12320;4760;11513;127;400;4199;9829;4326;10229
260805;202012;3626;10131;3060;9137;157;551;2311;6761;2468;7312
260810;202012;6406;17355;5614;15825;473;1239;4031;11188;4504;12427
260820;202012;4509;10337;3974;9696;93;337;3338;7961;3431;8298
260825;202012;2898;8519;2534;7870;108;374;1912;5868;2020;6242
260830;202012;4134;11999;3438;10760;449;1239;2193;7103;2642;8342
260840;202012;4166;10765;3729;10160;205;525;3113;8508;3318;9033
260845;202012;4385;11456;3883;10609;220;636;2919;7846;3139;8482
260850;202012;5116;13889;4252;12247;347;1068;2730;7613;3077;8681
260860;202012;3332;9460;2868;8667;94;333;2314;6831;2408;7164
260870;202012;4492;10753;3848;9974;68;255;3447;8813;3515;9068
260875;202012;7077;17083;5788;15213;539;1401;3986;10559;4525;11960
260880;202012;9558;26727;8311;24569;485;1454;6510;19244;6995;20698
260890;202012;12871;32692;11138;30066;573;1637;8161;21518;8734;23155
260900;202012;5336;14676;4387;13348;322;1010;2923;8907;3245;9917
260910;202012;3213;8593;2789;7957;100;311;2205;6258;2305;6569
260915;202012;5106;14923;4474;14185;55;252;4099;13004;4154;13256
260920;202012;3262;7997;2749;7444;88;211;2372;6495;2460;6706
260930;202012;3717;11623;3182;10662;191;754;2373;7771;2564;8525
260940;202012;14750;34735;12826;32065;1023;2475;9654;23843;10677;26318
260950;202012;7062;18577;5697;16225;365;1213;3740;10158;4105;11371
260960;202012;69982;154331;56048;136520;6043;15041;35970;86607;42013;101648
260970;202012;5682;14677;5071;13864;271;596;3772;10567;4043;11163
260980;202012;4535;13030;3995;12353;51;184;3664;11406;3715;11590
260990;202012;18075;48823;15340;45086;844;2679;12050;34998;12894;37677
261000;202012;16206;37814;13627;34564;359;1240;11039;27341;11398;28581
261010;202012;2349;6123;2062;5745;72;187;1800;5031;1872;5218
261020;202012;5949;16082;5142;14732;173;657;4255;11730;4428;12387
261030;202012;3934;11410;3463;10587;123;501;2755;8206;2878;8707
261040;202012;5281;15156;4299;13301;153;591;3253;9782;3406;10373
261050;202012;7765;19995;7061;18903;429;823;5473;14784;5902;15607
261060;202012;14174;35054;12343;32859;261;844;10385;27358;10646;28202
261070;202012;65249;140385;54175;125817;2925;6497;41600;94596;44525;101093
261080;202012;6714;15900;6133;15185;132;319;5690;14059;5822;14378
261090;202012;19467;45220;17312;42415;276;932;15269;36723;15545;37655
261100;202012;8290;22669;7219;21078;503;1546;5299;15515;5802;17061
261110;202012;66541;182843;55727;163340;7722;23825;33097;95723;40819;119548
261120;202012;3572;8997;3126;8382;86;221;2698;7245;2784;7466
261130;202012;7246;17543;6373;16358;118;349;5661;14403;5779;14752
261140;202012;3691;8386;3281;7840;180;446;2623;6185;2803;6631
261150;202012;5180;13493;4600;12620;70;264;4008;10881;4078;11145
261153;202012;1888;5663;1592;5085;59;193;1064;3438;1123;3631
261160;202012;210844;482762;170024;426420;41337;106786;70752;180769;112089;287555
261170;202012;5975;14853;5326;13885;312;737;4258;11045;4570;11782
261180;202012;9439;23354;8236;21775;457;1145;6006;16015;6463;17160
261190;202012;4561;13146;4074;12350;162;708;3244;9513;3406;10221
261200;202012;3366;7708;2989;7203;114;306;2539;6012;2653;6318
261210;202012;1893;4553;1619;4159;64;180;1363;3443;1427;3623
261220;202012;13630;38183;11355;33990;1438;4635;6495;19176;7933;23811
261230;202012;3971;11302;3322;10407;45;182;2776;8785;2821;8967
261240;202012;5358;13273;4721;12259;283;703;3858;9935;4141;10638
261245;202012;3714;10268;3109;9205;81;376;2490;7095;2571;7471
261247;202012;2940;8712;2440;7810;161;544;1656;5268;1817;5812
261250;202012;22074;50028;19153;46626;1667;3607;14668;36659;16335;40266
261255;202012;4069;11824;3300;10324;135;583;2444;7418;2579;8001
261260;202012;12611;33954;10963;31802;339;1377;9453;27049;9792;28426
261270;202012;4455;10797;3890;10080;192;520;3223;8259;3415;8779
261280;202012;2526;6979;2226;6460;63;221;1781;5033;1844;5254
261290;202012;2935;7519;2457;6980;69;263;1992;5699;2061;5962
261300;202012;12493;34343;10648;31239;573;2011;7826;22431;8399;24442
261310;202012;8838;22174;7550;20429;606;1793;5593;14811;6199;16604
261320;202012;5912;16554;5177;15359;78;329;4400;12863;4478;13192
261330;202012;5733;14045;5161;13295;120;429;4510;11410;4630;11839
261340;202012;4232;11692;3670;10976;139;504;3060;9050;3199;9554
261350;202012;8739;25410;7718;23678;129;569;6278;19010;6407;19579
261360;202012;7963;19124;6749;17402;231;644;5430;13660;5661;14304
261370;202012;24072;59175;20117;53705;2088;5403;13088;35265;15176;40668
261380;202012;4084;12165;3608;11335;446;1469;2377;7364;2823;8833
261390;202012;16758;47025;14144;42781;1204;3980;9475;28345;10679;32325
261400;202012;4581;14398;4001;13125;164;719;3015;9608;3179;10327
261410;202012;9555;23553;7857;20951;424;1239;6270;16312;6694;17551
261420;202012;7241;21336;6509;20438;748;2649;4603;14409;5351;17058
261430;202012;3416;9607;2898;8782;59;267;2428;7246;2487;7513
261440;202012;1478;4360;1240;3910;42;193;890;2690;932;2883
261450;202012;14783;39621;13061;36957;173;632;10829;30714;11002;31346
261460;202012;7529;20492;6650;19114;298;909;5312;15216;5610;16125
261470;202012;4109;10145;3599;9468;23;115;3138;8233;3161;8348
261480;202012;5078;15388;4378;14210;199;793;3404;10817;3603;11610
261485;202012;4858;13702;4199;12678;321;1054;3062;9119;3383;10173
261500;202012;5889;14905;5141;13887;376;900;3622;10172;3998;11072
261510;202012;1865;5474;1625;5085;59;217;1241;3909;1300;4126
261520;202012;2337;7104;2102;6625;65;235;1549;4837;1614;5072
261530;202012;12027;34830;9688;30553;886;3337;4971;15067;5857;18404
261540;202012;8005;22836;7187;21653;1051;3099;4085;13016;5136;16115
261550;202012;3673;9675;3165;8884;229;687;2275;6260;2504;6947
261560;202012;7667;22727;6652;21206;272;1044;5153;16423;5425;17467
261570;202012;3465;9269;2766;8157;183;637;1928;5588;2111;6225
261580;202012;6812;17640;5876;16374;106;479;5290;14530;5396;15009
261590;202012;2679;6871;2175;6152;72;247;1644;4628;1716;4875
261600;202012;5160;12800;4379;11657;299;663;3096;8471;3395;9134
261610;202012;2144;6078;1721;5299;94;349;1166;3555;1260;3904
261618;202012;2527;6242;2208;5768;95;225;1753;4578;1848;4803
261620;202012;4160;11601;3791;11056;737;1884;2492;7619;3229;9503
261630;202012;6142;17170;5231;15461;354;1247;3552;10093;3906;11340
261640;202012;37248;82834;31642;75912;1867;3517;23847;59070;25714;62587
261650;202012;4105;10140;3488;9327;158;487;2610;6922;2768;7409
270010;202012;4300;14234;3735;13272;160;914;2988;10280;3148;11194
270020;202012;3795;9454;3315;8835;127;431;2851;7418;2978;7849
270030;202012;33805;90561;28071;81311;3391;9657;19024;55028;22415;64685
270040;202012;10669;28398;9149;26602;366;1310;7598;21950;7964;23260
270050;202012;5428;12590;4632;11685;234;539;4036;10248;4270;10787
270060;202012;2165;5418;1811;5013;148;351;1439;4048;1587;4399
270070;202012;4650;12949;4042;12108;136;511;3359;9881;3495;10392
270080;202012;1436;3871;1210;3479;45;142;934;2580;979;2722
270090;202012;1732;5280;1558;4938;62;252;1284;3973;1346;4225
270100;202012;5411;14124;4661;13018;159;583;3896;10683;4055;11266
270110;202012;3214;7455;2589;6741;139;298;2059;5629;2198;5927
270120;202012;2675;7329;2329;6869;71;305;1970;5704;2041;6009
270130;202012;5049;12795;4390;12004;120;372;3819;10452;3939;10824
270135;202012;1982;4760;1688;4437;34;123;1548;4031;1582;4154
270140;202012;9473;22015;7573;19368;314;1030;5961;14537;6275;15567
270150;202012;2685;8009;2455;7672;4;21;2316;7223;2320;7244
270160;202012;6192;16501;5254;15440;93;339;4864;14318;4957;14657
270170;202012;3326;9684;2798;8951;174;820;2138;6550;2312;7370
270180;202012;2205;6794;2025;6564;33;166;1842;5911;1875;6077
270190;202012;1603;4795;1424;4573;34;177;1255;4001;1289;4178
270200;202012;2350;7122;2047;6702;105;394;1508;4947;1613;5341
270210;202012;5647;13252;4807;12313;72;299;4428;11156;4500;11455
270220;202012;1522;3944;1215;3510;205;615;688;1972;893;2587
270230;202012;9121;25040;7555;22625;624;2020;5430;16167;6054;18187
270235;202012;5587;17185;4800;15926;115;531;3983;13076;4098;13607
270240;202012;10472;28750;8478;25923;971;3150;5830;17965;6801;21115
270250;202012;2753;6896;2408;6399;183;476;1912;5075;2095;5551
270255;202012;4293;12334;3363;10639;108;448;2586;8047;2694;8495
270260;202012;5514;16202;4992;15335;98;498;4387;13178;4485;13676
270270;202012;1027;2666;851;2450;93;277;632;1805;725;2082
270280;202012;3737;9020;2985;8077;461;758;2122;6185;2583;6943
270290;202012;7306;23174;6570;21954;167;802;5769;19042;5936;19844
270300;202012;4218;10840;3285;9831;163;426;2564;7869;2727;8295
270310;202012;6956;19260;5970;17710;84;454;5139;14863;5223;15317
270320;202012;5421;15893;4694;14487;397;1283;3357;10091;3754;11374
270330;202012;3868;12515;3445;11864;250;991;2675;9145;2925;10136
270340;202012;1555;4196;1345;3926;43;143;1149;3308;1192;3451
270350;202012;1854;4329;1528;3947;143;399;1093;2847;1236;3246
270360;202012;2582;6432;2296;6110;76;156;2119;5687;2195;5843
270370;202012;1385;4212;1269;4003;33;154;1083;3362;1116;3516
270375;202012;3091;7166;2557;6576;18;57;2400;6189;2418;6246
270380;202012;5386;15052;4518;13919;597;1747;2994;9603;3591;11350
270390;202012;1185;2967;961;2713;24;96;795;2243;819;2339
270400;202012;6168;16165;5167;14654;271;739;4016;11354;4287;12093
270410;202012;4530;12931;3923;12009;143;510;3285;10006;3428;10516
270420;202012;5438;15994;4889;15187;120;562;4255;12969;4375;13531
270430;202012;131092;309158;102912;273059;20074;55285;49622;133701;69696;188986
270440;202012;4609;12449;3981;11684;79;351;3498;10137;3577;10488
270450;202012;6963;18518;6086;17452;261;839;5099;14811;5360;15650
270460;202012;3709;8212;3180;7580;157;313;2859;6846;3016;7159
270470;202012;10821;29992;9389;27965;610;2028;7329;21796;7939;23824
270480;202012;2921;7660;2456;6990;90;353;2020;5610;2110;5963
270490;202012;930;2548;812;2404;48;145;657;1939;705;2084
270500;202012;4860;14747;4309;13831;292;1060;3372;10693;3664;11753
270510;202012;5443;14372;4571;13265;320;1260;3429;9494;3749;10754
270520;202012;3942;11134;3108;9712;647;2109;1274;4138;1921;6247
270530;202012;1274;3581;1074;3275;55;153;765;2371;820;2524
270540;202012;2240;6274;1926;5863;61;268;1687;5050;1748;5318
270550;202012;6673;17128;5292;15597;583;1389;3949;12118;4532;13507
270560;202012;2932;7552;2524;7008;119;386;2079;5716;2198;6102
270570;202012;4069;11349;3447;10421;119;375;2823;8487;2942;8862
270580;202012;2241;6281;2023;5959;100;305;1748;5104;1848;5409
270590;202012;1566;4714;1443;4549;16;82;1359;4259;1375;4341
270600;202012;2700;8294;2444;7907;45;234;2184;6987;2229;7221
270610;202012;3676;9430;3188;8794;99;264;2844;7828;2943;8092
270620;202012;1198;3616;1099;3427;32;140;956;2899;988;3039
270630;202012;17340;42120;14875;38716;605;1869;12452;31738;13057;33607
270640;202012;5261;15110;4578;14003;163;662;3769;11308;3932;11970
270642;202012;2480;7935;2197;7477;144;623;1691;5629;1835;6252
270644;202012;3556;8816;2924;7999;299;715;2171;6130;2470;6845
270650;202012;3043;8923;2670;8400;349;1169;1916;6006;2265;7175
270660;202012;1978;5015;1693;4601;81;280;1275;3411;1356;3691
270670;202012;16021;36501;13288;33137;354;1057;11419;27816;11773;28873
270680;202012;5547;13051;4948;12395;119;173;4631;11750;4750;11923
270690;202012;8999;21951;7535;20107;423;1146;5993;15905;6416;17051
270700;202012;507;1525;443;1416;31;118;327;1024;358;1142
270710;202012;5326;16074;4725;15135;216;917;3817;12016;4033;12933
270720;202012;3583;10345;3188;9684;56;314;2836;8430;2892;8744
270730;202012;8033;17778;7046;16721;236;450;5538;14617;5774;15067
270740;202012;2351;6128;2073;5807;86;292;1735;4788;1821;5080
270750;202012;5661;14789;4955;13892;78;373;4446;12362;4524;12735
270760;202012;3213;8999;2779;8422;44;231;2378;7115;2422;7346
270770;202012;20595;49966;16468;44912;2583;6288;10238;29496;12821;35784
270780;202012;1773;4861;1629;4658;80;273;1401;3946;1481;4219
270790;202012;1610;4362;1343;3999;106;336;997;2942;1103;3278
270800;202012;10841;29166;9772;27639;327;1151;8449;23565;8776;24716
270810;202012;3282;9310;2577;8117;168;642;1818;5618;1986;6260
270820;202012;1568;4714;1333;4339;51;252;1056;3348;1107;3600
270830;202012;5030;12032;4068;10844;153;525;3323;8702;3476;9227
270840;202012;8199;24284;7315;23022;163;882;6417;19691;6580;20573
270850;202012;8908;20953;7850;19698;640;1816;6513;16078;7153;17894
270860;202012;14241;31318;11250;27930;589;1326;9111;22636;9700;23962
270870;202012;2147;6008;1769;5411;234;678;1162;3677;1396;4355
270880;202012;7979;23759;7127;22485;209;891;5965;18486;6174;19377
270890;202012;2802;7500;2332;6824;171;516;1631;4779;1802;5295
270895;202012;3088;9334;2802;8961;71;380;2489;7803;2560;8183
270900;202012;1795;4611;1345;3885;37;108;1053;3010;1090;3118
270910;202012;3843;11007;3307;10171;86;287;2731;8287;2817;8574
270915;202012;9298;26398;7469;23382;635;2305;5107;15654;5742;17959
270920;202012;5014;15522;4550;14732;144;712;3787;11854;3931;12566
270930;202012;16960;39098;13071;34570;1766;4248;8808;24507;10574;28755
270940;202012;6638;17012;5620;15802;205;825;4609;12619;4814;13444
280010;202012;686;1862;540;1550;14;58;386;1008;400;1066
280020;202012;4832;12142;4087;10949;450;1144;2795;7550;3245;8694
280030;202012;74395;173725;58716;151493;12140;31594;26708;71695;38848;103289
280040;202012;2867;7996;2497;7427;249;760;1681;4983;1930;5743
280050;202012;3795;10757;3262;9939;558;1745;1927;5875;2485;7620
280060;202012;5688;14833;4521;13008;865;2633;2126;6373;2991;9006
280067;202012;6849;16798;5810;15210;300;795;4299;11114;4599;11909
280070;202012;1892;5555;1759;5347;121;381;1459;4402;1580;4783
280100;202012;3916;10337;3305;9377;316;930;2277;6445;2593;7375
280110;202012;1365;3683;1199;3432;17;83;1060;2960;1077;3043
280120;202012;7537;21566;6711;20243;767;2105;4876;15140;5643;17245
280130;202012;8969;20929;7855;19352;396;1068;6407;15608;6803;16676
280140;202012;5366;12759;4741;11938;188;561;4063;10091;4251;10652
280150;202012;4149;10373;3594;9620;362;886;2738;7385;3100;8271
280160;202012;1195;3378;1003;3063;94;312;690;2061;784;2373
280170;202012;5072;13380;4544;12702;232;625;3680;10323;3912;10948
280190;202012;1266;2771;1131;2592;54;125;934;2095;988;2220
280200;202012;1215;3183;1003;2888;69;253;753;2123;822;2376
280210;202012;16518;40945;14344;37849;1527;4160;9221;24358;10748;28518
280220;202012;1741;4602;1486;4269;47;210;1230;3495;1277;3705
280230;202012;4398;10893;3691;9855;321;696;2583;7043;2904;7739
280240;202012;3283;8729;2927;8185;51;264;2515;6821;2566;7085
280250;202012;882;2138;721;1894;81;218;479;1232;560;1450
280260;202012;2229;5291;1965;4955;39;94;1784;4540;1823;4634
280270;202012;2421;6453;2142;6017;140;390;1751;4895;1891;5285
280280;202012;4168;12217;3703;11522;497;1327;2588;8423;3085;9750
280290;202012;17755;46426;15228;42925;1274;3797;10313;29340;11587;33137
280300;202012;12044;28552;10535;26929;298;816;7835;21974;8133;22790
280310;202012;1380;3519;1139;3109;40;134;860;2276;900;2410
280320;202012;8461;22750;7339;21071;872;2508;4936;14063;5808;16571
280330;202012;4646;11436;3948;10472;249;702;2905;7687;3154;8389
280340;202012;5384;11330;4480;10347;225;395;3879;9126;4104;9521
280350;202012;25868;60185;22738;56022;1084;2848;18114;43809;19198;46657
280360;202012;5599;15361;4896;14182;730;2127;2890;8526;3620;10653
280370;202012;2105;5193;1767;4636;55;155;1416;3648;1471;3803
280380;202012;993;2604;848;2408;78;213;578;1662;656;1875
280390;202012;3610;8821;3057;7970;162;379;2427;6332;2589;6711
280400;202012;3831;9632;3324;8935;524;1214;2038;5792;2562;7006
280410;202012;2230;6138;1771;5380;189;595;1028;3071;1217;3666
280420;202012;4281;11278;3946;10853;69;260;3640;9937;3709;10197
280430;202012;2035;4888;1782;4555;65;232;1459;3605;1524;3837
280440;202012;4214;11163;3725;10438;144;484;3153;8611;3297;9095
280445;202012;2334;5921;2084;5483;48;152;1562;3932;1610;4084
280450;202012;10132;23397;8761;21527;1015;2122;5814;14909;6829;17031
280460;202012;6838;16065;6183;15169;328;768;5309;12873;5637;13641
280470;202012;1667;4674;1430;4249;64;223;1071;3098;1135;3321
280480;202012;42794;102882;36864;94482;3014;8222;26313;66056;29327;74278
280490;202012;3765;10640;3227;9708;91;387;2502;7284;2593;7671
280500;202012;1004;2368;859;2171;32;103;727;1799;759;1902
280510;202012;2536;6322;2194;5843;79;281;1710;4458;1789;4739
280520;202012;1568;4021;1374;3751;53;151;1101;2958;1154;3109
280530;202012;2413;6007;2085;5541;288;644;1449;3999;1737;4643
280540;202012;8796;23460;8024;22348;253;859;7044;19366;7297;20225
280550;202012;6553;15112;5434;13539;159;579;4542;10903;4701;11482
280560;202012;7147;19612;6723;18979;141;518;5943;16555;6084;17073
280570;202012;6390;15435;5210;13938;224;689;3907;10417;4131;11106
280580;202012;5657;14785;4932;13720;582;1422;3494;9902;4076;11324
280590;202012;2840;6418;2433;5946;103;394;1936;4537;2039;4931
280600;202012;3509;9262;3100;8689;166;512;2231;6259;2397;6771
280610;202012;2454;6017;2212;5651;140;350;1807;4583;1947;4933
280620;202012;5492;13220;4721;12207;418;904;3323;8990;3741;9894
280630;202012;3815;10567;3506;10138;158;582;2897;8263;3055;8845
280640;202012;2325;6245;2049;5930;51;160;1827;5297;1878;5457
280650;202012;1175;3055;949;2721;84;282;703;1923;787;2205
280660;202012;3656;7997;3135;7383;216;402;2604;6252;2820;6654
280670;202012;19490;43839;16776;40339;1161;2764;13074;31394;14235;34158
280680;202012;2712;6471;2339;5942;222;419;1700;4402;1922;4821
280690;202012;957;2305;808;2109;52;119;638;1644;690;1763
280700;202012;1162;2897;1007;2667;25;95;804;2094;829;2189
280710;202012;15211;33968;12884;31303;529;999;10860;27126;11389;28125
280720;202012;2636;6000;2184;5463;57;185;1613;4146;1670;4331
280730;202012;1073;2725;954;2534;51;154;726;1860;777;2014
280740;202012;13895;33786;11894;30747;707;1986;8645;21745;9352;23731
280750;202012;3612;9993;3138;9177;189;597;2270;6537;2459;7134
280760;202012;6386;16750;5544;15448;588;1498;3665;10539;4253;12037
290010;202012;3180;6638;2079;4926;5;16;1714;3891;1719;3907
290020;202012;5348;14042;4865;13419;342;622;4098;11720;4440;12342
290030;202012;4628;10441;3716;9436;172;396;3162;8128;3334;8524
290035;202012;5140;11064;4256;9924;352;531;3394;8240;3746;8771
290040;202012;4143;10097;3542;9374;105;282;2804;7830;2909;8112
290050;202012;2001;6437;1670;5705;114;476;1116;3712;1230;4188
290060;202012;1320;3092;978;2570;99;267;634;1670;733;1937
290070;202012;36534;79559;31376;73160;1689;4168;24651;56754;26340;60922
290080;202012;5194;15163;4491;14097;464;1553;3122;9907;3586;11460
290090;202012;2150;4103;1508;3416;17;53;1377;3098;1394;3151
290100;202012;9623;24970;7766;22183;1261;3391;4240;12716;5501;16107
290110;202012;5119;13444;4546;12557;316;888;3299;9018;3615;9906
290115;202012;3899;11194;3268;10065;223;746;2420;7393;2643;8139
290120;202012;6486;15826;5476;14420;131;420;4731;12262;4862;12682
290130;202012;4674;11312;3639;9965;156;437;2830;7757;2986;8194
290135;202012;4223;9844;3485;8647;166;439;2768;6649;2934;7088
290140;202012;4431;11485;3416;10142;94;341;2884;8531;2978;8872
290150;202012;2449;6278;2106;5850;138;376;1628;4560;1766;4936
290160;202012;3378;7621;2987;7082;260;542;2387;5666;2647;6208
290170;202012;3350;8435;2958;8005;112;294;2643;7228;2755;7522
290180;202012;2957;8015;2441;7169;79;289;2007;5840;2086;6129
290190;202012;4218;11683;3702;10974;139;527;3056;8933;3195;9460
290195;202012;2273;5655;1821;5063;26;135;1551;4272;1577;4407
290200;202012;4015;11183;3263;9917;169;578;2490;7489;2659;8067
290205;202012;3405;8740;2992;8115;137;481;2331;6116;2468;6597
290210;202012;12589;35349;11171;33191;814;2264;8695;26240;9509;28504
290220;202012;2872;7017;2515;6557;118;309;2071;5390;2189;5699
290225;202012;3118;6690;2401;5933;148;266;2005;5057;2153;5323
290230;202012;2430;6410;2216;6153;32;95;1994;5531;2026;5626
290240;202012;3690;9232;2932;8285;70;243;2473;6989;2543;7232
290250;202012;3909;11344;3267;10372;100;344;2692;8666;2792;9010
290260;202012;5450;13133;4585;11889;158;516;3867;9779;4025;10295
290265;202012;3514;10109;2849;8834;222;654;1999;6226;2221;6880
290270;202012;10710;36407;10012;35211;521;2285;8137;28331;8658;30616
290280;202012;6033;17904;5218;16290;288;1010;3788;11694;4076;12704
290290;202012;9818;28296;7957;24895;781;2637;5260;16221;6041;18858
290300;202012;4120;11176;3043;9135;147;490;2204;6579;2351;7069
290310;202012;1558;3813;1231;3417;46;211;967;2587;1013;2798
290320;202012;23758;61495;18799;53951;4147;11635;8988;27303;13135;38938
290323;202012;3709;10042;3226;9293;104;321;2566;7384;2670;7705
290327;202012;4020;11609;3446;10510;248;704;2505;7595;2753;8299
290330;202012;2182;4541;1692;4015;40;63;1505;3637;1545;3700
290340;202012;5613;13867;4301;12259;419;1218;3114;9020;3533;10238
290350;202012;4717;13010;3934;11681;282;836;2798;8358;3080;9194
290360;202012;5035;13089;4412;12274;133;336;3793;10653;3926;10989
290370;202012;5229;12673;3821;10805;170;433;2738;7917;2908;8350
290380;202012;5571;14705;4654;13455;118;284;3982;11727;4100;12011
290390;202012;14354;40743;11926;36871;1298;3922;7755;24417;9053;28339
290395;202012;2846;8139;2289;7193;60;283;1756;5438;1816;5721
290400;202012;3726;9987;3020;8811;82;337;2330;6649;2412;6986
290405;202012;4630;13360;3977;12232;295;928;2747;8643;3042;9571
290410;202012;5692;15278;4376;13171;119;521;3308;9697;3427;10218
290420;202012;2977;8143;2465;7354;66;225;1928;5713;1994;5938
290430;202012;3173;8575;2601;7686;233;713;1775;5158;2008;5871
290440;202012;2866;6981;2054;5712;51;123;1446;4104;1497;4227
290450;202012;3494;8786;2741;7634;154;385;1988;5623;2142;6008
290460;202012;11636;32621;9751;29024;1974;5975;4306;12837;6280;18812
290470;202012;4495;10971;3309;9337;386;1201;1895;5441;2281;6642
290475;202012;6422;18526;5447;16807;83;464;4497;13587;4580;14051
290480;202012;1750;4415;1433;3969;75;266;1012;2667;1087;2933
290485;202012;4446;12891;3932;12171;98;500;3378;10274;3476;10774
290490;202012;8992;21108;8063;19833;483;1072;6343;15862;6826;16934
290500;202012;4011;11914;3084;9900;536;1804;1361;4271;1897;6075
290510;202012;3427;8509;2853;7759;69;218;2476;6701;2545;6919
290515;202012;3624;10005;3157;9363;36;115;2858;8613;2894;8728
290520;202012;11456;32383;8857;27366;612;2008;5344;16328;5956;18336
290530;202012;4948;14061;4172;12792;123;498;3545;10788;3668;11286
290540;202012;3338;8708;2989;8324;47;154;2771;7699;2818;7853
290550;202012;4227;11034;3706;10414;10;58;3421;9709;3431;9767
290560;202012;6227;16073;4726;13874;387;1434;3122;8853;3509;10287
290570;202012;44148;107862;39072;101330;2459;6490;31514;81292;33973;87782
290580;202012;7768;22512;6683;20935;596;1806;4916;15797;5512;17603
290590;202012;7032;21437;5931;19466;149;581;4780;15762;4929;16343
290600;202012;19037;51974;16770;48283;668;2048;13631;39061;14299;41109
290610;202012;2563;7862;2014;6739;94;367;1416;4692;1510;5059
290620;202012;6196;17398;5363;16026;190;545;4541;13553;4731;14098
290630;202012;9166;21938;7294;19510;596;1541;5597;15161;6193;16702
290640;202012;2764;7077;2135;6164;85;247;1546;4577;1631;4824
290650;202012;12876;31644;11346;29923;2477;6228;7127;19663;9604;25891
290660;202012;3579;9176;3003;8341;54;156;2265;6477;2319;6633
290670;202012;6600;18109;5589;16446;363;1018;4275;12777;4638;13795
290680;202012;10759;29671;8996;27059;205;1059;7450;21942;7655;23001
290682;202012;4721;12079;4096;11243;123;281;3469;9608;3592;9889
290685;202012;3442;7739;2470;6350;202;473;1518;4192;1720;4665
290687;202012;6389;17250;5213;15321;676;1898;3387;10223;4063;12121
290689;202012;2843;7808;2143;6511;195;644;1460;4416;1655;5060
290690;202012;5297;13763;4293;12356;286;896;3142;8894;3428;9790
290700;202012;2588;7070;2273;6669;60;221;1924;5658;1984;5879
290710;202012;8121;22894;6968;21290;158;636;5891;18015;6049;18651
290720;202012;18235;49718;16608;47219;906;2853;13408;37644;14314;40497
290730;202012;7018;16568;5980;15359;287;570;4717;12349;5004;12919
290740;202012;1002;2710;786;2359;36;116;649;1951;685;2067
290750;202012;10761;26656;9315;24373;601;1682;6986;17787;7587;19469
290755;202012;1997;5638;1622;4961;88;277;1145;3538;1233;3815
290760;202012;3655;10641;2974;9344;172;503;2035;6599;2207;7102
290770;202012;2645;8295;2434;8029;46;232;2063;6862;2109;7094
290780;202012;8129;20121;7041;18689;259;581;5521;15002;5780;15583
290790;202012;4630;12763;4030;11897;169;484;3303;9893;3472;10377
290800;202012;6967;14435;4927;12043;291;657;3668;9061;3959;9718
290810;202012;5205;13669;4205;12204;110;348;3217;9539;3327;9887
290820;202012;4750;12861;4278;12190;174;505;3265;9425;3439;9930
290830;202012;4421;10027;3912;9383;26;73;3451;8174;3477;8247
290840;202012;17177;44794;14651;40865;1978;4541;9330;27798;11308;32339
290850;202012;6624;15807;5916;15047;203;506;5089;13070;5292;13576
290860;202012;6139;17372;5344;16463;218;705;4517;14195;4735;14900
290870;202012;4712;12906;3575;10736;155;479;2507;7475;2662;7954
290880;202012;1377;3407;1103;3049;70;179;755;2179;825;2358
290890;202012;9159;18447;8245;17428;143;314;7764;16346;7907;16660
290900;202012;2380;6147;1831;5178;104;239;1147;3245;1251;3484
290910;202012;5083;12120;3905;10330;48;154;3335;8729;3383;8883
290920;202012;5082;12702;4617;12162;81;129;4330;11580;4411;11709
290930;202012;7466;20781;6037;18272;218;899;4708;13877;4926;14776
290940;202012;3544;10000;2980;9190;157;561;2424;7441;2581;8002
290950;202012;1448;3622;1179;3218;69;187;821;2255;890;2442
290960;202012;5436;14050;4875;13352;172;440;4152;11417;4324;11857
290970;202012;3233;9504;2651;8434;102;378;2057;6544;2159;6922
290980;202012;12071;28608;10107;25638;787;2158;6373;15718;7160;17876
290990;202012;9561;25175;8489;23435;260;1025;7171;19150;7431;20175
291000;202012;3342;8572;2591;7619;109;334;2127;6313;2236;6647
291005;202012;15130;37116;13313;34739;1239;2939;10332;27222;11571;30161
291010;202012;3037;9121;2478;7926;118;424;1645;5119;1763;5543
291020;202012;1220;2990;978;2565;23;80;715;1770;738;1850
291030;202012;2503;6049;1744;4743;111;271;1084;2877;1195;3148
291040;202012;5358;14534;4480;13303;150;565;3556;10520;3706;11085
291050;202012;7491;19360;6366;17821;586;1836;4682;12896;5268;14732
291060;202012;5949;17998;5029;16767;314;1343;3814;12658;4128;14001
291070;202012;15845;42318;13257;38174;417;1412;10845;31071;11262;32483
291072;202012;24055;60804;17304;49448;3139;9300;7565;21801;10704;31101
291075;202012;5346;13089;4809;12274;102;270;4052;10168;4154;10438
291077;202012;1609;4172;1252;3552;56;117;885;2519;941;2636
291080;202012;109227;265461;85284;231800;25045;69830;23692;69966;48737;139796
291085;202012;5553;13966;4674;12605;168;507;3914;10535;4082;11042
291090;202012;1981;3753;1425;3129;47;100;1147;2472;1194;2572
291100;202012;3170;6878;2182;5696;99;257;1670;4329;1769;4586
291110;202012;5926;17483;5048;16003;313;1240;3861;11825;4174;13065
291120;202012;7423;18101;6246;16616;286;818;4840;12852;5126;13670
291125;202012;2168;3799;1642;3214;89;130;1331;2648;1420;2778
291130;202012;3280;9216;2406;7506;65;288;1801;5432;1866;5720
291140;202012;4879;13010;3521;10547;451;1214;2173;6532;2624;7746
291150;202012;2466;5327;1894;4683;4;12;1788;4416;1792;4428
291160;202012;4978;13540;4121;12307;359;1141;2792;8281;3151;9422
291165;202012;2128;5760;1605;4727;28;123;1195;3419;1223;3542
291170;202012;20700;52067;17279;46326;907;2676;11528;30345;12435;33021
291180;202012;6339;14415;4632;12175;239;611;3636;9553;3875;10164
291185;202012;3019;8069;2654;7493;94;278;2044;5801;2138;6079
291190;202012;7651;18569;6302;16839;279;849;5006;13338;5285;14187
291200;202012;2785;7548;2050;6153;82;256;1282;3691;1364;3947
291210;202012;7038;14972;5242;12904;134;438;3874;9599;4008;10037
291220;202012;4001;11314;3604;10729;166;607;2899;8516;3065;9123
291230;202012;4406;9420;3312;8225;32;84;2994;7507;3026;7591
291240;202012;4134;10559;3534;9552;59;207;3047;8125;3106;8332
291250;202012;3314;9713;2588;8377;142;438;1689;5508;1831;5946
291260;202012;1440;3361;1183;3024;29;92;970;2499;999;2591
291270;202012;5357;13770;4146;12009;631;1830;2593;7704;3224;9534
291280;202012;2634;6270;1938;5261;151;420;1255;3373;1406;3793
291290;202012;5725;14945;4401;12890;322;1018;3047;8856;3369;9874
291300;202012;3757;10178;2959;8858;111;407;2284;6724;2395;7131
291310;202012;5007;13260;4290;11962;115;362;3649;10049;3764;10411
291320;202012;5947;16411;4617;13957;1021;2883;2313;7426;3334;10309
291330;202012;1756;4474;1457;3983;76;200;1094;2957;1170;3157
291340;202012;4253;10885;3429;9453;81;270;2618;7112;2699;7382
291345;202012;2879;8602;2612;8186;99;344;2211;6931;2310;7275
291350;202012;6771;16642;5253;14822;45;147;4585;13169;4630;13316
291360;202012;36373;82829;28567;73439;2680;6849;18930;49851;21610;56700
291370;202012;8033;21656;7080;20190;526;1591;5270;14746;5796;16337
291380;202012;3382;9170;2968;8602;101;408;2489;7149;2590;7557
291390;202012;13102;27872;10090;24539;426;999;8362;20361;8788;21360
291400;202012;13617;34738;11198;31100;1509;3686;6663;19982;8172;23668
291410;202012;2944;7667;2307;6581;38;153;1696;4754;1734;4907
291420;202012;1965;4715;1541;4196;23;96;1360;3679;1383;3775
291430;202012;2707;7620;2342;7016;64;289;1901;5518;1965;5807
291440;202012;6325;17972;5493;16603;337;1057;4265;12925;4602;13982
291450;202012;9677;22665;7982;20710;76;131;7041;18774;7117;18905
291460;202012;15602;40966;13680;38099;676;2080;10361;28656;11037;30736
291465;202012;9274;22510;7297;20253;126;565;6352;17504;6478;18069
291470;202012;17052;37570;14204;34353;804;1714;10532;26274;11336;27988
291480;202012;41458;91226;30658;76575;3597;9242;16350;40897;19947;50139
291490;202012;5513;13633;4740;12756;132;426;4287;11477;4419;11903
291500;202012;4942;12052;4137;10977;65;284;3781;9974;3846;10258
291510;202012;4283;10548;3174;9154;49;286;2658;7595;2707;7881
291520;202012;4506;10148;3389;8676;185;500;2630;6685;2815;7185
291530;202012;2312;5201;1627;4312;324;789;898;2633;1222;3422
291535;202012;3359;9768;2959;9067;160;448;2301;7253;2461;7701
291540;202012;2232;4924;1529;4096;69;221;1260;3337;1329;3558
291550;202012;5594;12752;4348;11183;390;823;2975;7856;3365;8679
291560;202012;18075;42597;13094;36022;1321;3468;7834;22471;9155;25939
291570;202012;2393;5661;1886;5040;53;153;1565;4325;1618;4478
291580;202012;6264;15995;4931;14226;238;748;3651;10460;3889;11208
291590;202012;2193;5254;1902;4917;69;241;1697;4288;1766;4529
291600;202012;5417;12443;4166;10542;362;971;2880;7055;3242;8026
291610;202012;5592;14457;5011;13821;71;265;4610;12681;4681;12946
291620;202012;3081;6904;2306;6057;104;259;1801;4829;1905;5088
291630;202012;3323;7376;2480;6270;295;806;1768;4392;2063;5198
291640;202012;15890;38639;11985;33013;1721;4514;5489;15706;7210;20220
291650;202012;9409;23283;8350;22034;560;1027;7028;19081;7588;20108
291660;202012;2022;4921;1483;4100;131;419;969;2528;1100;2947
291670;202012;2036;5351;1713;4884;98;248;1308;3779;1406;4027
291680;202012;4042;9825;3281;8744;297;807;2346;6243;2643;7050
291685;202012;4689;11107;3751;9910;219;456;2843;7783;3062;8239
291690;202012;4116;9010;2854;7187;256;514;2153;5496;2409;6010
291700;202012;8567;24591;7530;22778;323;1161;6159;18283;6482;19444
291710;202012;5189;12244;3850;10380;208;645;2824;7482;3032;8127
291720;202012;4450;13313;3728;11859;554;1818;2274;7128;2828;8946
291730;202012;6231;15801;5368;14674;255;768;4473;12155;4728;12923
291733;202012;2775;7095;2372;6566;55;160;1744;5067;1799;5227
291735;202012;2909;7648;2326;6614;71;164;1770;4998;1841;5162
291740;202012;3940;10095;2915;8176;94;229;2044;5683;2138;5912
291750;202012;19314;45809;15756;40610;1531;3830;10654;27897;12185;31727
291760;202012;10074;28858;7860;25321;2396;8718;2186;7024;4582;15742
291770;202012;7054;18694;5905;16734;327;1011;4518;12477;4845;13488
291780;202012;5144;13503;4624;12779;87;307;4073;11143;4160;11450
291790;202012;2755;7477;2499;7148;232;548;1887;5583;2119;6131
291800;202012;28821;71862;21404;60824;3489;9574;10379;30814;13868;40388
291810;202012;10493;24687;8786;22593;301;734;7429;19308;7730;20042
291820;202012;3805;9915;3317;9287;84;279;2694;7550;2778;7829
291830;202012;4457;10390;3640;9297;191;388;2879;7388;3070;7776
291835;202012;6510;19349;5125;16706;521;1812;3289;10868;3810;12680
291840;202012;46828;127823;40685;118232;4199;13032;28819;83145;33018;96177
291845;202012;2527;6486;1981;5811;120;358;1598;4749;1718;5107
291850;202012;3784;10835;3114;9726;240;728;2253;7206;2493;7934
291855;202012;2222;4282;1722;3728;40;95;1552;3366;1592;3461
291860;202012;2254;5834;1570;4521;49;137;1062;2945;1111;3082
291870;202012;1267;3176;850;2453;41;118;581;1650;622;1768
291875;202012;2906;8660;2506;7821;63;259;1852;5623;1915;5882
291880;202012;5670;15911;4786;14409;224;647;3562;10809;3786;11456
291890;202012;1620;3279;1050;2619;130;293;703;1773;833;2066
291900;202012;1272;2984;984;2542;20;73;773;1944;793;2017
291905;202012;2403;6121;1981;5456;77;276;1525;4050;1602;4326
291910;202012;3004;7376;2543;6815;56;193;2181;5991;2237;6184
291915;202012;7281;20519;5936;18259;213;747;4498;14006;4711;14753
291920;202012;26088;67029;21976;61301;2014;6147;15522;42436;17536;48583
291930;202012;2483;6619;2127;6133;225;655;1459;4245;1684;4900
291940;202012;3880;9833;2579;7614;190;558;1520;4467;1710;5025
291950;202012;9012;27069;7662;24465;271;1001;5370;16964;5641;17965
291955;202012;15187;38160;13469;35937;1100;3093;10612;28339;11712;31432
291960;202012;2998;7908;2515;7258;123;361;1969;5819;2092;6180
291970;202012;4461;11148;3728;10245;127;430;2849;7857;2976;8287
291980;202012;9431;26885;7489;23471;1049;3029;4482;14476;5531;17505
291990;202012;2323;5944;1907;5446;30;124;1763;5042;1793;5166
291992;202012;3844;9254;3095;8289;237;527;2460;6741;2697;7268
291995;202012;2088;5717;1715;5099;53;225;1311;3811;1364;4036
292000;202012;2612;6042;2136;5483;89;330;1692;4290;1781;4620
292010;202012;5605;13057;4579;11614;162;494;3832;9505;3994;9999
292020;202012;4557;13043;3778;11668;203;738;2734;8168;2937;8906
292030;202012;1788;5453;1629;5159;73;262;1052;3271;1125;3533
292040;202012;4425;11204;3450;9743;226;586;2637;7586;2863;8172
292045;202012;4030;10397;2975;8841;31;84;2635;7972;2666;8056
292050;202012;6424;17816;5210;15696;239;825;3377;10043;3616;10868
292060;202012;11099;25616;10239;24537;452;1016;9011;21410;9463;22426
292070;202012;5658;14731;4933;13866;280;809;4252;11864;4532;12673
292080;202012;3043;7705;2539;7050;75;260;2260;6213;2335;6473
292090;202012;4532;9791;3195;8178;237;648;2403;6181;2640;6829
292100;202012;10938;26350;9385;24424;936;2512;6557;17103;7493;19615
292105;202012;3597;8696;3138;8078;93;211;2620;6759;2713;6970
292110;202012;5951;14288;4175;11482;903;2538;2009;5517;2912;8055
292120;202012;6846;17412;5671;15469;346;985;4332;11621;4678;12606
292130;202012;3397;8080;2809;7356;105;319;2200;5684;2305;6003
292140;202012;4978;11706;4207;10547;315;787;3363;8405;3678;9192
292145;202012;2321;6706;1968;6101;69;184;1511;4746;1580;4930
292150;202012;14522;38663;12603;35546;293;1113;10333;28623;10626;29736
292160;202012;2944;7103;2213;6160;36;98;1807;5278;1843;5376
292170;202012;8341;22091;6962;19861;324;1102;5296;14777;5620;15879
292180;202012;2822;7687;2073;6277;157;473;1292;3856;1449;4329
292190;202012;2904;7609;2479;6964;89;309;1961;5453;2050;5762
292200;202012;8571;20914;6346;17776;1061;3118;3218;9319;4279;12437
292205;202012;3808;10472;3303;9727;55;252;2893;8478;2948;8730
292210;202012;6441;14950;5193;13382;87;378;4671;11904;4758;12282
292220;202012;2204;5102;1932;4690;50;125;1543;3624;1593;3749
292225;202012;3142;9138;2772;8573;70;329;2376;7202;2446;7531
292230;202012;8496;20260;7621;19151;155;512;6587;16275;6742;16787
292240;202012;4638;13376;4069;12345;305;898;2888;8784;3193;9682
292250;202012;5795;14788;5215;13931;401;1053;3965;10533;4366;11586
292260;202012;3392;8755;3019;8271;92;249;2637;7230;2729;7479
292265;202012;3335;9016;2791;8193;67;283;2226;6419;2293;6702
292270;202012;4327;9875;3448;8831;110;276;2876;7384;2986;7660
292273;202012;2761;5822;2206;5147;48;80;1618;4054;1666;4134
292275;202012;1589;4124;1241;3655;54;157;946;2835;1000;2992
292280;202012;2631;6147;2111;5551;81;160;1785;4831;1866;4991
292285;202012;2526;6066;2027;5393;72;152;1661;4457;1733;4609
292290;202012;7492;19429;5917;17245;167;610;4863;14121;5030;14731
292300;202012;10479;25761;8239;22759;800;2323;5708;15836;6508;18159
292303;202012;2911;8267;2539;7668;80;191;2128;6486;2208;6677
292305;202012;2250;6019;2080;5790;43;189;1890;5174;1933;5363
292310;202012;6677;16620;5767;15516;137;445;5070;13503;5207;13948
292320;202012;6090;16508;4841;14187;271;877;3523;10059;3794;10936
292330;202012;2691;5932;2180;5360;101;196;1701;4366;1802;4562
292335;202012;4627;11993;4125;11268;205;491;3498;9637;3703;10128
292340;202012;5448;15204;4511;13400;210;603;3372;9955;3582;10558
292350;202012;2462;6676;2058;6118;76;282;1677;5000;1753;5282
292360;202012;4896;12947;4081;11572;234;727;2878;8059;3112;8786
292370;202012;10228;23832;8842;22037;116;395;8239;20286;8355;20681
292380;202012;6609;18451;5931;17244;373;1106;4560;13131;4933;14237
292390;202012;4526;8573;3330;7178;120;224;2920;6305;3040;6529
292400;202012;22071;62134;19068;57370;1852;5636;13169;39876;15021;45512
292405;202012;4495;10778;3793;9681;88;223;3164;7962;3252;8185
292410;202012;2223;5250;1844;4771;67;147;1624;4232;1691;4379
292420;202012;3337;10129;3062;9716;98;507;2673;8251;2771;8758
292430;202012;4778;14162;3602;11999;267;909;2369;7914;2636;8823
292440;202012;8482;26603;7873;25676;128;630;7079;22956;7207;23586
292450;202012;3989;11332;3123;9651;85;316;2452;7538;2537;7854
292460;202012;4873;13199;3977;11698;325;897;2897;8547;3222;9444
292465;202012;2658;6766;2281;6288;91;196;1529;4645;1620;4841
292467;202012;1863;5233;1634;4920;235;629;1140;3571;1375;4200
292470;202012;2896;7319;2257;6346;55;114;1779;5011;1834;5125
292480;202012;6228;14602;5068;13188;73;275;4612;11889;4685;12164
292490;202012;2066;5281;1748;4812;121;266;1329;3755;1450;4021
292500;202012;6516;17689;5197;15375;490;1521;3381;9877;3871;11398
292510;202012;13157;35078;10255;30476;523;1769;7201;21346;7724;23115
292520;202012;6932;17137;6139;15993;433;1155;4842;12508;5275;13663
292525;202012;5871;13850;4816;12669;115;259;4191;11209;4306;11468
292530;202012;28099;73399;21563;62411;5006;14646;8808;26043;13814;40689
292540;202012;4355;7948;3407;6936;118;204;3079;6290;3197;6494
292550;202012;8348;21415;6404;19081;500;1403;4491;14378;4991;15781
292560;202012;4349;10770;3789;10032;88;236;3153;8428;3241;8664
292570;202012;3558;9355;2987;8283;81;295;2513;6798;2594;7093
292575;202012;6809;19364;6251;18620;374;1072;5048;15207;5422;16279
292580;202012;7592;18897;6285;16979;130;424;5328;14243;5458;14667
292590;202012;7314;19381;6220;17480;280;878;5099;14109;5379;14987
292593;202012;2795;6933;2319;6140;65;169;1970;5163;2035;5332
292595;202012;5359;14134;4570;13168;144;494;3865;11067;4009;11561
292600;202012;10706;29037;9269;26835;313;899;7424;21553;7737;22452
292610;202012;4125;10663;3513;9579;191;430;2655;7343;2846;7773
292620;202012;6333;17221;5285;15951;124;273;4814;14828;4938;15101
292630;202012;8451;20428;6794;17811;724;1889;4362;11540;5086;13429
292640;202012;8215;23808;7133;21997;197;746;5104;15888;5301;16634
292650;202012;4405;10835;3974;10276;105;293;3623;9269;3728;9562
292660;202012;11302;30071;9575;27558;442;1393;7352;21203;7794;22596
292665;202012;2177;6362;1883;5973;67;200;1585;5099;1652;5299
292670;202012;3505;9401;2712;7921;116;368;1846;5280;1962;5648
292680;202012;3919;10254;3102;8823;178;466;2293;6414;2471;6880
292690;202012;2580;6602;1788;5308;195;533;1076;3344;1271;3877
292700;202012;9854;26526;8609;24618;749;1867;5943;17607;6692;19474
292710;202012;2501;7587;2326;7349;40;133;2126;6746;2166;6879
292720;202012;8968;21166;7572;19560;206;548;6052;15920;6258;16468
292730;202012;4599;10336;4294;9965;297;478;3646;8693;3943;9171
292740;202012;313355;748648;268579;684574;36586;92919;169784;431296;206370;524215
292750;202012;6064;16143;5336;15099;221;633;4170;11999;4391;12632
292760;202012;3867;11043;3372;10168;212;698;2493;7462;2705;8160
292770;202012;6227;15977;5026;14318;734;2158;3277;9575;4011;11733
292780;202012;2056;4041;1523;3402;49;135;1240;2640;1289;2775
292790;202012;4061;8498;3093;7449;160;392;2568;6224;2728;6616
292800;202012;11171;27832;9550;25383;288;820;8025;21056;8313;21876
292805;202012;3623;8561;2838;7541;106;321;2260;5950;2366;6271
292810;202012;10594;27468;8448;24089;209;851;6419;17730;6628;18581
292820;202012;7232;19947;5307;16696;417;1388;3720;11522;4137;12910
292830;202012;2869;6723;2456;6212;86;236;2099;5346;2185;5582
292840;202012;8574;22384;7260;20603;142;530;6368;17801;6510;18331
292850;202012;2465;6508;2067;5919;148;441;1453;4141;1601;4582
292860;202012;16927;37039;15199;35005;386;973;13242;30116;13628;31089
292870;202012;17801;43743;15289;40232;983;2574;10486;27380;11469;29954
292880;202012;10832;29367;9224;26940;245;1006;7330;20705;7575;21711
292890;202012;7065;19238;6258;18087;171;688;5509;15795;5680;16483
292895;202012;3052;6417;2249;5233;106;235;1820;4199;1926;4434
292900;202012;2562;6829;2320;6461;56;218;1928;5226;1984;5444
292905;202012;4185;10749;3331;9495;118;398;2499;7057;2617;7455
292910;202012;4748;12879;4333;12287;202;564;3374;9507;3576;10071
292920;202012;9623;26276;8867;25195;265;978;7665;21381;7930;22359
292925;202012;5352;15015;4464;13423;219;632;3238;9676;3457;10308
292930;202012;6282;18318;5423;16754;455;1565;3515;10631;3970;12196
292935;202012;2463;6050;1912;5441;20;110;1724;4917;1744;5027
292937;202012;2752;6868;2366;6355;64;176;1980;5335;2044;5511
292940;202012;2807;7078;2232;6231;173;396;1636;4754;1809;5150
292950;202012;9256;23322;8088;21622;504;1154;6151;16435;6655;17589
292960;202012;5129;12359;4294;11178;123;312;3447;8905;3570;9217
292970;202012;3767;10681;3337;10033;78;352;2809;8457;2887;8809
292975;202012;4423;9360;3926;8804;113;186;3602;8165;3715;8351
292980;202012;3202;7684;2589;6784;76;241;2147;5544;2223;5785
292990;202012;11137;30627;9333;27384;629;1927;6859;19833;7488;21760
293000;202012;2668;6192;2288;5623;38;134;1847;4540;1885;4674
293010;202012;17881;45423;14441;40076;1933;5535;8814;24475;10747;30010
293015;202012;8209;24975;6504;21681;435;1560;4333;14747;4768;16307
293020;202012;9666;27860;8715;26504;136;568;7892;24017;8028;24585
293030;202012;5121;13439;3926;11573;97;317;2731;8246;2828;8563
293040;202012;4375;11357;3678;10370;72;269;3222;9052;3294;9321
293050;202012;22465;54106;19859;50250;1131;2824;15064;37630;16195;40454
293060;202012;3421;9047;2768;7840;228;669;1938;5409;2166;6078
293070;202012;24333;58556;21274;54659;1884;5049;15879;40647;17763;45696
293075;202012;3568;11070;3100;10264;141;618;2499;8247;2640;8865
293076;202012;3465;8479;3164;8124;50;140;2849;7367;2899;7507
293077;202012;6254;17073;5044;15148;449;1446;3199;9966;3648;11412
293080;202012;4741;13782;4076;12635;87;393;3331;10118;3418;10511
293090;202012;3208;9236;2465;7996;204;648;1601;5278;1805;5926
293100;202012;5797;15194;4801;13422;203;570;3801;10531;4004;11101
293105;202012;3731;11809;3264;10832;241;828;2282;7521;2523;8349
293110;202012;2377;5890;1964;5281;66;232;1609;4227;1675;4459
293120;202012;4375;11774;3896;11028;109;272;3257;9242;3366;9514
293130;202012;3657;10032;3189;9422;73;277;2764;8083;2837;8360
293135;202012;29834;69146;22138;59050;3326;9652;10718;28915;14044;38567
293140;202012;2364;5204;2049;4817;56;126;1734;4074;1790;4200
293150;202012;5466;16107;4478;14236;324;1039;3088;9876;3412;10915
293160;202012;3750;9151;3196;8550;236;379;2698;7572;2934;7951
293170;202012;4872;10169;4254;9407;115;244;3727;8209;3842;8453
293180;202012;4309;12065;3595;10760;81;329;2868;8373;2949;8702
293190;202012;13905;37513;12313;35228;132;606;11007;31245;11139;31851
293200;202012;8388;20637;6770;18068;190;667;5496;14351;5686;15018
293210;202012;5106;13476;4391;12366;273;775;3407;9570;3680;10345
293220;202012;4777;12183;3500;10076;812;2355;1441;4250;2253;6605
293230;202012;3753;9573;2752;8152;203;665;1894;5671;2097;6336
293240;202012;4471;11794;3588;10349;65;152;2731;8217;2796;8369
293245;202012;3713;10060;3368;9550;143;472;2887;8066;3030;8538
293250;202012;5854;13489;4762;12092;154;389;3994;10146;4148;10535
293260;202012;4603;12097;3806;10848;170;489;2619;7526;2789;8015
293270;202012;7119;15623;5617;14014;398;578;4396;11840;4794;12418
293280;202012;4310;11396;3782;10647;232;577;2968;8481;3200;9058
293290;202012;14480;41318;12739;38591;1583;4879;8593;26224;10176;31103
293300;202012;5651;13661;4861;12504;272;690;3581;9279;3853;9969
293305;202012;4039;9492;3537;8876;53;120;3214;8067;3267;8187
293310;202012;2050;5252;1732;4763;49;149;1391;3777;1440;3926
293315;202012;4061;9509;3365;8454;193;423;2786;7010;2979;7433
293317;202012;2623;6122;2335;5726;144;270;1854;4566;1998;4836
293320;202012;12169;28807;10775;27258;232;658;9713;24404;9945;25062
293325;202012;1743;4257;1349;3741;206;556;820;2323;1026;2879
293330;202012;58895;163853;47710;144115;8592;26965;22503;67795;31095;94760
293340;202012;2154;6043;1787;5400;78;258;1279;3817;1357;4075
293345;202012;3504;9388;2813;8365;370;854;1813;5934;2183;6788
293350;202012;6486;18639;5593;17570;60;309;5124;16280;5184;16589
293360;202012;15129;37789;12896;34794;284;1182;11404;30223;11688;31405
310010;202012;923;2076;599;1619;46;167;227;568;273;735
310020;202012;2700;7182;2008;5952;433;1389;460;1303;893;2692
310030;202012;1856;5174;1424;4418;204;695;927;2778;1131;3473
310040;202012;867;2248;685;1935;30;130;470;1231;500;1361
310050;202012;1465;4345;1220;3954;118;489;816;2538;934;3027
310060;202012;3084;8689;2685;8150;74;296;2250;6760;2324;7056
310070;202012;335;752;236;614;11;25;175;452;186;477
310080;202012;663;1744;474;1406;69;225;224;628;293;853
310090;202012;4676;12210;3844;10859;283;847;2843;7915;3126;8762
310100;202012;3485;9485;2932;8569;75;339;2406;6830;2481;7169
310110;202012;4536;11831;3514;10070;736;2298;1572;4347;2308;6645
310120;202012;621;1504;392;1143;40;142;235;639;275;781
310130;202012;355;914;300;835;26;101;225;597;251;698
310140;202012;261;751;183;617;40;157;69;202;109;359
310150;202012;5441;14146;4030;11564;516;1690;1959;5294;2475;6984
310160;202012;7806;19216;5558;15509;1028;3157;2023;5670;3051;8827
310163;202012;998;2958;800;2578;182;671;266;782;448;1453
310170;202012;9235;23196;7364;20279;630;1787;5228;14379;5858;16166
310180;202012;1736;4267;1267;3502;154;458;741;1997;895;2455
310190;202012;2624;7536;2126;6630;469;1637;353;1034;822;2671
310200;202012;1848;5414;1349;4449;165;621;656;2130;821;2751
310205;202012;1102;3013;872;2654;139;476;475;1419;614;1895
310210;202012;2546;6773;2103;5995;112;322;1520;4244;1632;4566
310220;202012;1261;3393;971;2823;78;245;652;1818;730;2063
310230;202012;2205;6012;1768;5189;220;706;1128;3095;1348;3801
310240;202012;978;2948;830;2685;50;193;589;1852;639;2045
310250;202012;1052;2772;844;2430;18;75;591;1685;609;1760
310260;202012;3110;7911;2035;6016;595;2062;625;1460;1220;3522
310270;202012;2699;6541;2157;5808;91;282;1782;4789;1873;5071
310280;202012;2432;5592;1889;4811;253;679;1123;2756;1376;3435
310285;202012;1822;5760;1508;5192;163;620;930;3183;1093;3803
310290;202012;1103;2876;896;2514;190;611;473;1197;663;1808
310300;202012;1509;4327;1281;3940;137;511;753;2163;890;2674
310310;202012;300;725;195;541;34;99;94;253;128;352
310320;202012;529;1323;365;1068;23;83;204;566;227;649
310330;202012;474;1114;285;784;43;136;115;286;158;422
310340;202012;7853;20619;6355;18133;821;2321;3327;9625;4148;11946
310350;202012;12559;29907;8595;23516;1429;4193;4107;10813;5536;15006
310360;202012;487;1098;369;946;10;31;252;651;262;682
310370;202012;1275;3876;1078;3508;202;719;354;1212;556;1931
310375;202012;852;2102;591;1705;91;265;325;942;416;1207
310380;202012;393;885;215;604;33;98;97;258;130;356
310390;202012;439;1286;344;1099;73;245;98;274;171;519
310400;202012;10017;24161;7235;19984;655;2098;4552;12281;5207;14379
310410;202012;856;2457;559;1900;83;310;223;708;306;1018
310420;202012;4377;11261;3002;8666;391;1261;1289;3438;1680;4699
310430;202012;1460;3912;964;2989;202;686;357;985;559;1671
310440;202012;652;1692;452;1329;42;150;239;660;281;810
310445;202012;1363;3830;994;3090;57;180;718;2191;775;2371
310450;202012;4542;11332;3441;9599;136;505;2649;7182;2785;7687
310460;202012;1698;4477;1268;3682;200;634;470;1262;670;1896
310470;202012;3620;7984;2822;6930;293;690;1958;4962;2251;5652
310480;202012;962;2451;749;2106;82;242;478;1309;560;1551
310490;202012;2749;7430;2168;6479;217;799;1250;3514;1467;4313
310500;202012;1325;3695;995;3135;174;626;537;1618;711;2244
310510;202012;2040;5251;1337;3964;239;787;508;1501;747;2288
310520;202012;1150;2976;836;2409;135;377;446;1295;581;1672
310530;202012;720;1802;469;1354;67;234;163;386;230;620
310540;202012;2891;8129;2389;7257;503;1618;1108;3216;1611;4834
310550;202012;1242;3127;877;2520;76;277;496;1318;572;1595
310560;202012;14600;37646;10388;30233;1404;4670;4585;12058;5989;16728
310570;202012;1007;2627;796;2332;55;199;589;1693;644;1892
310590;202012;4056;10691;3227;9120;193;617;1885;5013;2078;5630
310600;202012;1294;3785;1058;3299;140;493;552;1621;692;2114
310610;202012;467;1248;296;971;108;366;39;110;147;476
310620;202012;169364;424809;122308;340275;16698;54026;61722;156248;78420;210274
310630;202012;4454;12076;3480;10152;339;1056;2158;6069;2497;7125
310640;202012;1092;3204;891;2818;181;612;366;1107;547;1719
310650;202012;2379;6665;1740;5425;172;564;1021;3085;1193;3649
310660;202012;1300;3454;1061;3128;29;97;899;2635;928;2732
310665;202012;1410;3565;1139;3179;27;103;932;2631;959;2734
310670;202012;57930;146897;48758;131243;4347;13276;34002;87254;38349;100530
310680;202012;766;1780;635;1599;18;64;547;1325;565;1389
310690;202012;1947;5034;1392;4094;107;360;804;2242;911;2602
310700;202012;472;1043;376;927;21;68;301;718;322;786
310710;202012;5516;15516;4038;13319;825;3243;778;2277;1603;5520
310720;202012;1023;2335;795;2047;30;93;603;1504;633;1597
310730;202012;10091;26417;8613;24069;378;1308;6446;17629;6824;18937
310740;202012;6269;16901;4454;13177;642;2128;1749;4679;2391;6807
310750;202012;1208;2894;910;2461;101;307;494;1247;595;1554
310760;202012;647;1630;453;1329;34;108;245;727;279;835
310770;202012;1078;2850;736;2331;77;301;389;1122;466;1423
310780;202012;4245;10065;3540;9139;70;187;2908;7516;2978;7703
310790;202012;1761;5519;1496;4945;342;1200;243;713;585;1913
310800;202012;2335;6825;1714;5562;347;1365;106;273;453;1638
310810;202012;1268;3097;1037;2719;46;133;751;1893;797;2026
310820;202012;1211;3044;727;2229;162;513;160;514;322;1027
310825;202012;2573;7653;2064;6811;69;397;1676;5331;1745;5728
310830;202012;1863;5174;1316;4101;238;861;558;1628;796;2489
310840;202012;2043;5493;1503;4578;339;1192;392;1031;731;2223
310850;202012;1434;3945;1205;3621;43;218;945;2710;988;2928
310855;202012;3037;7974;2346;6853;163;576;1687;4786;1850;5362
310860;202012;6785;19564;5442;16942;545;1782;3359;10556;3904;12338
310870;202012;940;2253;742;1966;53;130;553;1472;606;1602
310880;202012;978;2910;768;2478;110;376;434;1357;544;1733
310890;202012;2157;6131;1383;4559;256;916;216;613;472;1529
310900;202012;3744;10310;2521;7614;368;1140;1089;3086;1457;4226
310910;202012;2159;5199;1506;4164;139;440;323;830;462;1270
310920;202012;1880;4850;1433;4180;194;614;826;2365;1020;2979
310925;202012;915;2480;743;2196;64;226;510;1426;574;1652
310930;202012;5708;14746;3968;11898;770;2362;1793;5608;2563;7970
310940;202012;6633;15547;5345;13685;187;573;4128;10291;4315;10864
310945;202012;1257;3273;981;2830;174;527;473;1327;647;1854
310950;202012;1856;5477;1229;4059;224;811;377;1062;601;1873
310960;202012;728;1942;398;1236;67;246;78;219;145;465
310970;202012;1119;3266;772;2524;199;722;138;413;337;1135
310980;202012;255;610;168;480;19;64;106;294;125;358
310990;202012;1270;3468;994;2991;157;511;525;1562;682;2073
311000;202012;3853;10617;2804;8857;681;2300;1161;3578;1842;5878
311010;202012;896;2538;720;2191;212;713;304;902;516;1615
311020;202012;1112;2801;701;2051;39;122;381;1094;420;1216
311030;202012;1621;3966;1141;3192;216;685;529;1412;745;2097
311040;202012;265;821;219;722;66;228;75;232;141;460
311050;202012;2882;6970;2132;5875;343;1086;1104;2862;1447;3948
311060;202012;3130;7914;2314;6397;319;1007;961;2421;1280;3428
311070;202012;2250;5565;1627;4592;161;593;919;2409;1080;3002
311080;202012;1140;2555;920;2213;60;169;716;1640;776;1809
311090;202012;2015;6377;1586;5567;363;1395;492;1687;855;3082
311100;202012;2367;6667;1373;4588;260;988;252;743;512;1731
311110;202012;3591;7334;2003;5105;356;963;721;1890;1077;2853
311115;202012;1374;3015;1159;2734;61;154;940;2175;1001;2329
311120;202012;6595;17166;5033;14335;699;2226;1930;4893;2629;7119
311130;202012;1811;4697;1384;4119;94;357;827;2376;921;2733
311140;202012;1400;3423;1113;3036;68;219;792;2115;860;2334
311150;202012;1430;4537;1104;3897;173;679;601;2063;774;2742
311160;202012;3745;10684;2629;8566;657;2371;793;2460;1450;4831
311170;202012;879;2206;697;1968;39;113;440;1312;479;1425
311180;202012;1342;3000;836;2253;156;460;373;995;529;1455
311190;202012;840;2302;633;1907;112;389;259;681;371;1070
311200;202012;1980;5278;1424;4221;264;858;536;1452;800;2310
311205;202012;848;2520;691;2215;49;214;435;1317;484;1531
311210;202012;964;2803;833;2622;102;289;606;1962;708;2251
311220;202012;729;2003;610;1790;45;156;398;1104;443;1260
311230;202012;7775;23074;5865;19177;1107;3779;2175;7217;3282;10996
311240;202012;1039;2669;801;2327;174;526;338;989;512;1515
311250;202012;1108;3188;850;2690;180;541;333;1011;513;1552
311260;202012;2652;6457;1691;4793;254;801;744;1912;998;2713
311265;202012;1287;3316;943;2735;39;151;651;1845;690;1996
311270;202012;2920;8660;2543;8041;132;584;1877;5695;2009;6279
311280;202012;1021;2623;455;1448;72;260;33;84;105;344
311290;202012;1818;5480;1660;5158;135;417;1126;3504;1261;3921
311300;202012;4661;12801;3823;11409;190;745;3054;8918;3244;9663
311310;202012;551;1528;469;1384;43;133;294;835;337;968
311320;202012;3182;9582;2723;8599;358;1350;1339;3832;1697;5182
311330;202012;5134;13297;4042;11513;420;1293;2300;6688;2720;7981
311340;202012;10197;28162;8065;24382;2021;6645;2355;6710;4376;13355
311350;202012;2420;5876;1730;4626;162;446;930;2269;1092;2715
311360;202012;1089;2637;698;2046;191;629;247;693;438;1322
311370;202012;4623;11054;3388;9121;140;540;2292;5803;2432;6343
311380;202012;349;1045;250;839;61;204;110;395;171;599
311390;202012;1724;5173;1368;4674;584;2226;355;1110;939;3336
311400;202012;1493;4067;1082;3270;177;571;379;1013;556;1584
311410;202012;1695;4912;1353;4399;211;778;771;2423;982;3201
311420;202012;1492;4313;1027;3346;187;692;282;765;469;1457
311430;202012;4073;10589;2705;7901;482;1448;908;2607;1390;4055
311440;202012;2840;7866;2137;6663;544;2003;469;1353;1013;3356
311450;202012;1650;4874;1187;4014;310;1196;324;946;634;2142
311455;202012;997;2188;662;1692;173;453;254;694;427;1147
311460;202012;471;1429;312;1094;60;278;83;238;143;516
311470;202012;503;1531;335;1148;81;322;51;161;132;483
311480;202012;1012;2585;822;2285;44;127;633;1753;677;1880
311490;202012;246;720;183;597;33;131;84;241;117;372
311500;202012;441;1064;346;932;20;64;233;611;253;675
311510;202012;3182;8201;2186;6490;291;970;955;2671;1246;3641
311520;202012;636;1748;556;1595;71;259;312;872;383;1131
311530;202012;8406;19470;5288;14467;1283;3879;1409;3657;2692;7536
311535;202012;779;2127;510;1551;82;258;186;516;268;774
311540;202012;477;1501;424;1400;74;284;288;912;362;1196
311545;202012;1975;5596;1685;5145;90;312;1312;3958;1402;4270
311547;202012;1436;3656;1247;3363;64;164;842;2307;906;2471
311550;202012;2685;7428;2121;6401;287;994;936;2680;1223;3674
311560;202012;299;644;189;474;76;184;41;95;117;279
311570;202012;1602;3669;1139;3030;33;93;904;2439;937;2532
311580;202012;2056;3833;1365;3011;142;282;923;2045;1065;2327
311590;202012;477;1252;380;1102;64;213;217;615;281;828
311600;202012;1711;3847;1431;3477;68;160;1217;2923;1285;3083
311610;202012;2212;7057;1836;6274;185;717;1071;3579;1256;4296
311615;202012;3192;8879;2603;7893;109;397;2058;6132;2167;6529
311620;202012;431;1094;375;1032;9;34;328;891;337;925
311630;202012;1329;3615;1088;3116;90;296;728;2003;818;2299
311640;202012;653;1743;519;1516;62;212;255;677;317;889
311650;202012;1911;4863;1568;4325;171;502;986;2642;1157;3144
311660;202012;2835;8027;2096;6556;378;1320;599;1590;977;2910
311670;202012;1528;3962;1111;3209;168;538;439;1269;607;1807
311680;202012;2092;5914;1587;4990;156;476;1084;3418;1240;3894
311690;202012;595;1282;468;1125;34;65;351;895;385;960
311700;202012;2151;5139;1709;4528;23;116;1460;3745;1483;3861
311710;202012;1486;4249;1079;3527;268;949;386;1253;654;2202
311720;202012;414;1213;326;1054;35;125;164;536;199;661
311730;202012;3407;8834;2212;6452;640;2007;454;1365;1094;3372
311740;202012;885;2282;739;2108;68;189;602;1767;670;1956
311750;202012;3794;11245;3042;9869;404;1417;1773;5545;2177;6962
311760;202012;622;1727;508;1521;68;250;259;671;327;921
311770;202012;2075;5888;1613;5068;249;813;744;2260;993;3073
311780;202012;1316;3727;926;2949;151;546;309;842;460;1388
311783;202012;2242;5995;1814;5261;36;166;1472;4092;1508;4258
311787;202012;788;2238;595;1776;85;283;260;660;345;943
311790;202012;1453;3906;935;2950;236;830;249;725;485;1555
311800;202012;4752;14152;3812;12121;769;2615;608;1668;1377;4283
311810;202012;935;2791;742;2452;45;160;505;1642;550;1802
311820;202012;766;1840;561;1525;62;201;354;904;416;1105
311830;202012;7951;22499;5394;16977;1532;5229;682;2092;2214;7321
311840;202012;3583;8924;2874;7908;225;662;2143;5847;2368;6509
311850;202012;359;944;290;815;13;41;192;519;205;560
311860;202012;58551;146059;44713;122369;6215;18444;25513;66561;31728;85005
311870;202012;1834;4834;1254;3787;223;789;480;1282;703;2071
311880;202012;6222;16042;5212;14649;285;693;3912;11234;4197;11927
311890;202012;1685;3995;1293;3436;84;261;923;2325;1007;2586
311900;202012;733;1855;550;1610;54;184;356;1011;410;1195
311910;202012;3998;10255;3010;8966;514;1505;1548;4769;2062;6274
311920;202012;2085;5461;1677;4873;113;298;1056;3179;1169;3477
311930;202012;3756;8658;2685;7159;802;2330;818;2011;1620;4341
311940;202012;15337;39764;11263;31977;1565;4880;5226;13832;6791;18712
311950;202012;2310;6122;1751;5182;123;406;1049;3171;1172;3577
311960;202012;477;1153;376;1002;23;84;245;594;268;678
311970;202012;407;1305;300;1029;55;226;71;205;126;431
311980;202012;447;1200;232;771;23;73;83;272;106;345
311990;202012;518;1193;323;903;60;211;141;348;201;559
311995;202012;945;2586;472;1500;19;63;69;145;88;208
312000;202012;764;1886;563;1585;53;139;347;1008;400;1147
312010;202012;957;2572;737;2216;44;146;485;1391;529;1537
312015;202012;1346;3901;1188;3642;46;203;973;2916;1019;3119
312020;202012;1580;4830;1187;3975;232;826;294;911;526;1737
312030;202012;2008;4882;1750;4597;17;56;1646;4322;1663;4378
312040;202012;835;2413;586;1929;66;222;266;845;332;1067
312050;202012;1169;3577;936;3131;209;838;307;901;516;1739
312060;202012;849;2040;548;1663;134;413;263;811;397;1224
312070;202012;908;2559;637;2001;38;137;363;1080;401;1217
312080;202012;2568;6282;1918;5320;105;344;1271;3372;1376;3716
312083;202012;846;2186;628;1845;47;173;433;1227;480;1400
312087;202012;2474;6401;1996;5661;41;130;1570;4490;1611;4620
312090;202012;10036;25925;7831;22451;1110;3490;4103;11413;5213;14903
312100;202012;1540;4383;1227;3797;97;369;751;2221;848;2590
312110;202012;1027;3144;849;2785;174;671;321;953;495;1624
312120;202012;994;2650;663;2053;167;602;199;501;366;1103
312125;202012;1668;4255;1388;3857;102;330;1047;2797;1149;3127
312130;202012;1023;2488;772;2069;62;188;356;874;418;1062
312140;202012;685;1957;556;1698;110;379;244;680;354;1059
312150;202012;441;1219;374;1082;14;56;272;738;286;794
312160;202012;8712;23497;6616;19805;808;2757;3305;9430;4113;12187
312170;202012;877;2368;675;1981;38;135;445;1270;483;1405
312180;202012;1373;3648;1088;3108;158;461;558;1544;716;2005
312190;202012;647;1765;473;1437;75;257;170;474;245;731
312200;202012;4371;11980;3438;10456;1060;3201;1176;3721;2236;6922
312210;202012;1354;2986;981;2453;36;106;744;1823;780;1929
312220;202012;1564;4828;1354;4428;104;372;856;2799;960;3171
312230;202012;13041;33336;8650;25385;2010;6716;1773;4398;3783;11114
312235;202012;1922;4826;1521;4260;84;278;1096;2983;1180;3261
312240;202012;668;2153;504;1806;109;423;148;512;257;935
312245;202012;2615;6738;2140;6001;64;180;1759;4906;1823;5086
312247;202012;939;2272;682;1900;119;345;363;1019;482;1364
312250;202012;950;2503;605;1809;78;244;230;670;308;914
312260;202012;922;2450;731;2159;38;152;568;1607;606;1759
312270;202012;711;1948;537;1601;29;115;305;831;334;946
312280;202012;416;1213;319;1031;89;299;47;140;136;439
312290;202012;764;2230;613;1958;106;372;208;646;314;1018
312300;202012;962;2891;635;2081;157;557;118;320;275;877
312310;202012;950;2813;756;2414;119;409;355;1082;474;1491
312320;202012;1950;4970;1416;4036;329;992;324;885;653;1877
312330;202012;807;2396;652;2055;59;214;405;1245;464;1459
312340;202012;243;629;172;510;43;155;75;196;118;351
312350;202012;239;478;169;405;18;51;116;265;134;316
312352;202012;1542;4614;1368;4299;85;270;844;2832;929;3102
312360;202012;2693;7688;1966;6300;376;1343;678;2026;1054;3369
312370;202012;1845;4713;1500;4127;167;515;919;2412;1086;2927
312380;202012;2103;4735;1736;4268;4;12;1560;3792;1564;3804
312385;202012;1214;3286;947;2804;145;453;432;1287;577;1740
312390;202012;1856;5294;1390;4430;193;716;522;1522;715;2238
312400;202012;2727;7763;2254;6949;672;2245;730;2226;1402;4471
312410;202012;11378;31104;9172;27380;1584;4879;5115;15094;6699;19973
312420;202012;3706;9859;3071;8826;565;1761;1643;4593;2208;6354
312430;202012;7707;20412;6316;17908;381;1268;4541;12552;4922;13820
312440;202012;903;2893;728;2486;354;1287;110;334;464;1621
312450;202012;1155;3366;874;2870;241;832;287;987;528;1819
312460;202012;434;1128;299;920;49;147;149;483;198;630
312470;202012;471;1128;296;821;29;84;109;270;138;354
312480;202012;1016;2495;707;2035;96;310;351;957;447;1267
312490;202012;2060;5013;1604;4344;203;583;877;2309;1080;2892
312500;202012;1009;2466;828;2211;46;162;590;1552;636;1714
312510;202012;3665;9649;2570;7564;625;1788;650;1952;1275;3740
312520;202012;158;420;123;369;31;102;54;161;85;263
312530;202012;563;1384;483;1288;15;54;425;1136;440;1190
312540;202012;1565;4302;1051;3270;139;459;600;1811;739;2270
312550;202012;768;2001;590;1657;45;144;385;994;430;1138
312560;202012;1909;4949;1529;4344;71;213;1157;3286;1228;3499
312570;202012;2182;5258;1626;4551;452;1306;620;1838;1072;3144
312580;202012;590;1598;410;1223;54;188;190;531;244;719
312590;202012;1577;4550;1246;3881;75;344;799;2297;874;2641
312595;202012;1964;5679;1644;5145;253;732;990;3267;1243;3999
312600;202012;1159;2749;654;1796;109;375;126;390;235;765
312610;202012;6637;16626;4322;12306;640;2014;1522;3932;2162;5946
312620;202012;2485;6391;1844;5490;56;243;1474;4472;1530;4715
312630;202012;275;793;192;637;36;138;73;236;109;374
312640;202012;508;1379;357;1119;37;129;146;460;183;589
312650;202012;1994;5086;1371;3918;60;198;983;2684;1043;2882
312660;202012;1300;3129;986;2604;93;254;666;1708;759;1962
312670;202012;4815;12703;4018;11431;175;704;2951;8035;3126;8739
312675;202012;1271;3279;1041;2946;56;173;854;2387;910;2560
312680;202012;1353;3804;1173;3529;50;205;966;2825;1016;3030
312690;202012;2909;6100;2269;5333;45;122;1906;4488;1951;4610
312695;202012;949;2548;795;2291;40;92;630;1819;670;1911
312700;202012;2020;5290;1455;4252;144;494;815;2249;959;2743
312705;202012;1390;3266;1198;2987;14;50;1099;2717;1113;2767
312707;202012;1314;3807;1017;3284;66;307;668;2039;734;2346
312710;202012;6331;14450;3730;10382;912;2724;1068;3110;1980;5834
312720;202012;1043;2763;783;2342;96;301;480;1396;576;1697
312730;202012;1607;3755;1133;3101;95;293;657;1728;752;2021
312733;202012;1344;3526;1013;2899;35;140;713;1933;748;2073
312735;202012;694;1863;581;1642;71;221;336;855;407;1076
312737;202012;781;1731;557;1414;66;183;372;916;438;1099
312738;202012;686;1733;489;1404;43;138;280;765;323;903
312740;202012;411;1027;240;733;44;149;61;139;105;288
312750;202012;1555;4475;1151;3705;198;665;499;1536;697;2201
312760;202012;1691;4955;1198;3931;217;763;445;1399;662;2162
312770;202012;43625;103898;27310;75842;5442;16241;9367;25271;14809;41512
312780;202012;2379;7042;2004;6433;232;775;1291;4159;1523;4934
312790;202012;235;552;123;376;6;27;36;95;42;122
312800;202012;4798;13384;3628;11151;866;2810;1313;3921;2179;6731
312810;202012;1512;4019;1010;3182;255;887;374;1077;629;1964
312820;202012;1691;4477;1362;3908;54;193;1030;2877;1084;3070
312825;202012;1333;3099;1162;2877;19;64;1006;2442;1025;2506
312830;202012;2718;7599;1657;5394;325;1203;437;1332;762;2535
312840;202012;1305;3491;1040;3045;83;315;589;1599;672;1914
312850;202012;928;2236;651;1822;22;94;405;1036;427;1130
312860;202012;1069;2754;721;2206;181;586;174;485;355;1071
312870;202012;5940;15867;3603;11342;579;1977;853;2487;1432;4464
312880;202012;1424;3524;1098;2967;37;123;651;1763;688;1886
312890;202012;2209;5447;1622;4485;114;298;831;2346;945;2644
312900;202012;1202;3040;984;2764;146;453;465;1424;611;1877
312910;202012;1550;2836;824;1881;174;332;313;750;487;1082
312920;202012;984;2581;673;2065;115;405;284;802;399;1207
312930;202012;2326;5685;1797;4894;400;1104;796;2221;1196;3325
312940;202012;947;2571;737;2262;68;257;389;1134;457;1391
312950;202012;2955;7283;1919;5600;493;1577;620;1744;1113;3321
312960;202012;1796;4708;1514;4277;78;200;1170;3398;1248;3598
312965;202012;1592;4386;1327;3977;116;354;922;2725;1038;3079
312970;202012;1361;3782;1078;3321;143;534;642;1847;785;2381
312980;202012;23453;63629;18798;55256;3643;11625;8912;24590;12555;36215
312990;202012;478;1187;306;888;52;172;153;404;205;576
313000;202012;470;1333;352;1116;29;123;212;632;241;755
313005;202012;2466;7080;2070;6382;160;470;1472;4520;1632;4990
313010;202012;4963;13398;3958;11797;689;2227;2354;6901;3043;9128
313020;202012;1050;3111;739;2401;130;456;147;401;277;857
313030;202012;1098;2505;740;1980;87;283;478;1201;565;1484
313040;202012;787;2398;646;2116;42;178;389;1206;431;1384
313050;202012;1730;4724;1202;3926;196;776;392;1140;588;1916
313055;202012;1873;5008;1664;4709;52;171;1447;4065;1499;4236
313060;202012;958;2292;690;1833;174;559;133;312;307;871
313065;202012;1624;4784;1427;4458;45;162;1119;3418;1164;3580
313070;202012;932;2429;703;2036;67;208;422;1195;489;1403
313080;202012;379;1051;280;858;52;179;106;276;158;455
313090;202012;5002;13186;4244;11965;328;1063;2863;7973;3191;9036
313100;202012;1325;3409;1026;2976;25;102;787;2227;812;2329
313110;202012;1429;3775;1048;3103;98;360;589;1636;687;1996
313115;202012;2576;7350;2059;6337;269;945;1086;3111;1355;4056
313120;202012;3669;8660;2666;7338;218;693;1736;4737;1954;5430
313130;202012;31009;78750;23468;64955;2447;7669;13491;35234;15938;42903
313140;202012;623;1318;366;956;30;74;243;641;273;715
313150;202012;1328;3679;980;3045;298;1009;170;459;468;1468
313160;202012;1175;2881;914;2489;22;82;705;1863;727;1945
313170;202012;10908;30726;7895;25118;1333;4643;3246;9688;4579;14331
313180;202012;2021;5315;1434;4130;191;570;826;2337;1017;2907
313190;202012;4190;11944;3032;9582;555;1896;1073;3151;1628;5047
313200;202012;1089;2990;949;2745;15;52;800;2242;815;2294
313210;202012;3748;10763;3063;9517;370;1267;1853;5585;2223;6852
313220;202012;1697;4425;1125;3292;161;527;458;1190;619;1717
313230;202012;2962;8192;2441;7545;44;154;2044;6463;2088;6617
313240;202012;9571;23206;5992;17452;973;3260;2628;7133;3601;10393
313250;202012;5909;17399;4482;14276;813;2616;2012;6244;2825;8860
313260;202012;647;1666;466;1347;62;234;230;601;292;835
313270;202012;5737;14059;4608;12499;546;1404;3173;8800;3719;10204
313280;202012;461;1291;296;950;38;137;129;391;167;528
313290;202012;933;2877;686;2435;204;784;218;776;422;1560
313300;202012;1562;4125;1125;3350;278;914;281;716;559;1630
313310;202012;1174;3429;902;2860;146;559;267;717;413;1276
313320;202012;2063;5482;1500;4562;258;910;607;1855;865;2765
313330;202012;4103;10622;3091;9090;175;612;1995;5855;2170;6467
313340;202012;1366;3036;966;2483;82;221;677;1727;759;1948
313350;202012;2895;8013;1846;5609;228;774;660;1753;888;2527
313360;202012;1482;3564;1011;2810;150;508;533;1347;683;1855
313370;202012;1443;4006;1184;3484;139;487;654;1764;793;2251
313375;202012;1747;4541;1096;3298;199;642;232;646;431;1288
313380;202012;6154;15240;4369;11986;734;2268;2101;5141;2835;7409
313390;202012;793;2538;689;2366;50;233;461;1517;511;1750
313400;202012;3587;8855;2768;7729;138;431;2141;5882;2279;6313
313410;202012;1310;3345;1015;2834;49;169;764;2078;813;2247
313420;202012;15412;33980;7884;21352;1791;5419;1110;2978;2901;8397
313430;202012;952;2779;729;2312;121;474;315;865;436;1339
313440;202012;5962;13001;3937;10326;387;1047;2428;6392;2815;7439
313450;202012;743;1952;520;1518;87;278;183;461;270;739
313460;202012;2054;5785;1619;5100;322;1153;767;2287;1089;3440
313470;202012;2814;7153;2221;6282;234;670;1471;4203;1705;4873
313480;202012;989;2808;556;1831;64;237;170;505;234;742
313490;202012;2695;6489;1337;4042;332;1100;277;810;609;1910
313500;202012;523;1455;381;1145;38;115;147;409;185;524
313505;202012;10114;26441;8609;24397;330;1138;6951;19691;7281;20829
313507;202012;1445;3721;1183;3315;34;136;951;2582;985;2718
313510;202012;13539;37153;10576;31337;1267;3855;4967;14445;6234;18300
313520;202012;14095;39376;11284;34539;562;2099;8542;25511;9104;27610
313530;202012;515;1517;383;1227;43;150;156;450;199;600
313535;202012;2286;6323;1883;5545;255;688;1155;3414;1410;4102
313540;202012;761;2238;608;1864;105;330;258;723;363;1053
313545;202012;1114;3658;939;3298;149;553;505;1721;654;2274
313550;202012;1726;5213;1418;4489;288;1009;731;2209;1019;3218
313560;202012;2674;5228;2005;4407;52;82;1701;3764;1753;3846
313570;202012;978;2812;797;2479;190;621;319;967;509;1588
313580;202012;5733;14621;4437;12459;486;1406;2635;7453;3121;8859
313590;202012;1028;2876;836;2600;199;657;393;1294;592;1951
313600;202012;4044;10602;3360;9537;87;349;2839;7902;2926;8251
313610;202012;1052;2631;850;2295;86;262;547;1398;633;1660
313620;202012;5377;14093;4177;11913;496;1599;2462;6761;2958;8360
313630;202012;8497;20306;6027;16591;570;1839;3737;10042;4307;11881
313640;202012;1177;2536;706;1936;135;408;340;922;475;1330
313650;202012;1694;5033;1336;4428;101;380;878;2942;979;3322
313652;202012;744;2311;664;2148;103;352;424;1339;527;1691
313655;202012;1125;2802;881;2498;46;130;683;1942;729;2072
313657;202012;1113;2980;890;2628;36;136;658;1844;694;1980
313660;202012;903;2525;733;2219;77;277;457;1315;534;1592
313665;202012;4832;12734;3790;10885;398;1281;2397;6561;2795;7842
313670;202012;48502;117541;30976;87800;4357;13551;14206;38070;18563;51621
313680;202012;1014;2692;838;2405;62;203;569;1587;631;1790
313690;202012;760;2333;587;2020;141;542;151;494;292;1036
313695;202012;1813;4822;1363;4070;90;274;913;2777;1003;3051
313700;202012;2831;9043;2451;8525;234;816;1853;6501;2087;7317
313710;202012;1463;3281;1036;2717;76;210;690;1834;766;2044
313720;202012;5473;14998;3816;11484;522;1666;1609;4473;2131;6139
313730;202012;1333;2959;1001;2511;85;178;657;1669;742;1847
313740;202012;1648;5819;1375;5093;311;1336;260;811;571;2147
313750;202012;1984;5211;1521;4398;270;879;739;1996;1009;2875
313753;202012;2171;5153;1450;3983;143;424;805;2142;948;2566
313760;202012;5301;14450;4012;11957;776;2589;1849;5103;2625;7692
313770;202012;3940;10988;3142;9701;197;631;2350;7350;2547;7981
313780;202012;3872;10243;2822;8503;216;774;843;2591;1059;3365
313790;202012;486;1474;433;1382;39;139;258;813;297;952
313800;202012;1359;3076;988;2558;122;362;517;1265;639;1627
313810;202012;1578;3991;1263;3541;49;176;984;2679;1033;2855
313820;202012;17212;43598;10671;29721;1713;5009;2927;7928;4640;12937
313830;202012;376;1061;265;812;45;161;92;256;137;417
313835;202012;903;2630;749;2344;58;233;423;1238;481;1471
313840;202012;7091;18345;5388;15495;1274;3891;1162;3470;2436;7361
313850;202012;980;2368;772;2086;144;467;360;869;504;1336
313860;202012;2525;6690;1893;5506;293;964;810;2162;1103;3126
313862;202012;1307;2744;623;1737;38;111;297;821;335;932
313865;202012;2563;6739;2113;5998;79;224;1599;4475;1678;4699
313867;202012;1354;4046;1120;3614;178;554;650;2169;828;2723
313868;202012;1672;5116;1380;4541;42;206;1063;3378;1105;3584
313870;202012;774;2065;558;1670;86;266;221;606;307;872
313880;202012;1699;4365;1214;3521;156;518;586;1530;742;2048
313890;202012;1986;4309;1480;3650;44;151;1103;2639;1147;2790
313900;202012;4040;11566;2857;9144;724;2544;699;2036;1423;4580
313910;202012;648;1868;495;1586;100;343;107;336;207;679
313920;202012;2906;8893;2408;7852;504;1604;1202;3971;1706;5575
313925;202012;1555;3914;1249;3376;183;478;813;2187;996;2665
313930;202012;4524;13610;3677;12057;267;1011;2400;7745;2667;8756
313940;202012;8669;24825;6352;20746;688;2793;1524;5627;2212;8420
313950;202012;5058;11125;3758;9526;390;1230;2262;5749;2652;6979
313960;202012;5642;13522;3774;10382;724;2262;1253;3140;1977;5402
313970;202012;1464;3925;1227;3529;20;63;787;2217;807;2280
313980;202012;1264;3259;816;2559;121;434;335;987;456;1421
313990;202012;1888;5914;1355;4708;332;1337;443;1346;775;2683
314000;202012;9467;24048;7918;21395;566;1969;5341;14236;5907;16205
314010;202012;1453;3465;1144;3046;42;138;883;2272;925;2410
314015;202012;1910;5247;1465;4476;185;655;814;2427;999;3082
314020;202012;473;1288;322;1025;72;276;66;222;138;498
314030;202012;786;2225;621;1914;61;186;336;1012;397;1198
314040;202012;598;1611;485;1405;75;247;263;728;338;975
314050;202012;1839;4836;1346;3943;146;508;740;2005;886;2513
314053;202012;1751;5229;1433;4600;303;966;744;2468;1047;3434
314055;202012;2195;5863;1850;5322;43;159;1517;4358;1560;4517
314060;202012;1269;3311;952;2813;35;129;678;1977;713;2106
314070;202012;4680;12689;3633;10792;709;2111;1633;4798;2342;6909
314080;202012;2121;5429;1455;4287;181;601;629;1679;810;2280
314085;202012;2172;5961;1779;5356;212;661;1019;3123;1231;3784
314090;202012;4722;12511;4044;11521;228;764;2653;7814;2881;8578
314100;202012;3024;7230;2336;6272;38;115;1756;4739;1794;4854
314110;202012;4833;13374;3921;11624;426;1441;2220;6149;2646;7590
314120;202012;714;1672;304;914;57;206;73;205;130;411
314130;202012;618;1598;398;1203;27;106;239;705;266;811
314140;202012;4440;12461;3538;10780;462;1455;1818;5452;2280;6907
314150;202012;1504;3707;1095;3002;67;180;755;2029;822;2209
314160;202012;2155;5619;1578;4543;225;713;668;1913;893;2626
314170;202012;887;2477;717;2143;37;142;480;1339;517;1481
314180;202012;5336;14729;4285;13022;349;1150;2611;7926;2960;9076
314190;202012;589;1451;420;1206;76;256;205;529;281;785
314200;202012;2963;8213;2433;7307;158;531;1715;5020;1873;5551
314210;202012;1993;5159;1587;4429;197;550;776;2131;973;2681
314220;202012;1371;3712;998;3051;220;753;358;1001;578;1754
314225;202012;1020;2883;849;2603;70;175;629;1980;699;2155
314230;202012;779;2020;632;1833;84;265;401;1198;485;1463
314240;202012;1041;2791;795;2398;185;594;304;922;489;1516
314250;202012;494;1373;304;969;49;147;106;309;155;456
314260;202012;945;2525;724;2224;165;547;391;1176;556;1723
314270;202012;3227;9095;2659;8220;73;312;1974;6052;2047;6364
314280;202012;3369;7765;2253;6040;238;711;1283;3258;1521;3969
314290;202012;4375;11279;3609;9912;302;842;2486;6691;2788;7533
314300;202012;2021;5646;1311;4134;219;746;474;1388;693;2134
314310;202012;3878;10023;2547;7710;790;2670;385;1003;1175;3673
314315;202012;932;3132;798;2846;52;233;559;1928;611;2161
314320;202012;2994;8080;1954;6118;344;1181;708;2125;1052;3306
314330;202012;47593;132933;35739;111655;9416;30776;7473;24630;16889;55406
314340;202012;2409;5928;1492;4284;269;889;388;959;657;1848
314345;202012;1457;4211;1168;3688;142;451;711;2229;853;2680
314350;202012;782;2110;499;1593;111;363;117;324;228;687
314360;202012;532;1547;327;1097;54;200;105;314;159;514
314370;202012;735;1938;590;1723;43;147;400;1117;443;1264
314380;202012;1102;2962;722;2289;165;592;155;464;320;1056
314390;202012;13757;34446;8926;25623;1497;4639;2898;7401;4395;12040
314400;202012;3805;11410;2895;9592;738;2526;1080;3709;1818;6235
314410;202012;2628;7348;1821;5831;241;889;609;2046;850;2935
314420;202012;832;2031;597;1640;36;140;405;1045;441;1185
314430;202012;7774;18805;5430;14881;771;2231;2607;6792;3378;9023
314435;202012;1844;4849;1447;4191;112;379;973;2722;1085;3101
314437;202012;895;2260;641;1840;69;210;322;922;391;1132
314440;202012;609;1735;426;1366;125;438;85;225;210;663
314450;202012;1360;3623;1140;3265;109;368;664;1827;773;2195
314460;202012;3115;9376;2261;7609;580;2075;549;1772;1129;3847
314465;202012;2192;6277;1856;5642;59;209;1425;4209;1484;4418
314467;202012;908;2366;749;2105;21;57;615;1677;636;1734
314470;202012;2315;6524;1901;5693;325;1054;903;2529;1228;3583
314480;202012;6409;17939;4628;14185;759;2652;1786;4828;2545;7480
314490;202012;1078;2819;789;2223;63;192;507;1379;570;1571
314500;202012;1645;3911;1178;3266;310;834;403;1176;713;2010
314505;202012;2005;4896;1637;4365;97;275;1204;3115;1301;3390
314510;202012;1910;4948;1340;4063;269;920;593;1772;862;2692
314520;202012;4766;14464;3514;11844;714;2643;449;1350;1163;3993
314530;202012;5268;16901;4746;15891;292;1211;3525;11518;3817;12729
314535;202012;2439;6355;1987;5702;72;283;1538;4371;1610;4654
314537;202012;1093;3063;839;2658;41;166;612;1892;653;2058
314540;202012;386;945;259;732;19;59;153;412;172;471
314545;202012;1923;4550;1718;4310;27;78;1512;3877;1539;3955
314550;202012;673;1623;496;1368;37;133;292;733;329;866
314560;202012;4428;13128;3237;10449;472;1697;1137;3277;1609;4974
314570;202012;294;811;212;655;27;92;91;284;118;376
314580;202012;444;1318;355;1145;96;307;117;371;213;678
314585;202012;645;1992;488;1642;59;245;209;682;268;927
314587;202012;1997;5411;1500;4611;206;603;850;2690;1056;3293
314590;202012;4009;10752;2901;8648;375;1254;1341;3687;1716;4941
314600;202012;1890;5092;1111;3594;225;769;131;408;356;1177
314610;202012;8755;21486;6123;17621;948;3264;2712;7938;3660;11202
314620;202012;2218;5192;1754;4602;41;132;1457;3811;1498;3943
314625;202012;1534;4155;1323;3862;29;171;1148;3274;1177;3445
314630;202012;5354;13345;4403;12081;104;423;3678;10004;3782;10427
314640;202012;679;1585;496;1305;71;214;281;683;352;897
314650;202012;802;1843;493;1362;52;168;277;688;329;856
314655;202012;1575;4306;1120;3495;168;507;559;1752;727;2259
314660;202012;315;714;207;523;13;27;137;335;150;362
314670;202012;1583;3592;1106;2921;20;62;738;1916;758;1978
314675;202012;1673;4391;1423;3974;67;211;1121;3051;1188;3262
314690;202012;2005;5493;1523;4783;389;1368;546;1666;935;3034
314700;202012;10072;27760;6559;20956;1264;4483;2159;6675;3423;11158
314710;202012;7687;21389;5556;16838;896;2999;2074;5524;2970;8523
314720;202012;2091;6152;1447;4808;282;1032;369;1151;651;2183
314730;202012;2251;5778;1616;4645;241;774;705;1857;946;2631
314740;202012;2887;8097;2225;6897;294;961;1127;3408;1421;4369
314750;202012;277;751;211;617;24;82;130;342;154;424
314760;202012;1955;5767;1267;4192;209;793;330;850;539;1643
314770;202012;1090;3130;592;1877;49;170;190;556;239;726
314780;202012;342;810;232;644;39;133;125;301;164;434
314790;202012;11239;29687;7767;23216;1517;5206;2849;7777;4366;12983
314795;202012;1494;3888;1265;3492;28;117;1024;2725;1052;2842
314800;202012;10454;26547;6430;19064;1143;3694;1779;4717;2922;8411
314810;202012;8477;22477;6122;18345;1572;5007;2005;5894;3577;10901
314820;202012;1242;2971;974;2559;65;219;612;1536;677;1755
314830;202012;1513;4565;1280;4129;210;775;634;1958;844;2733
314840;202012;834;2585;650;2261;48;212;451;1489;499;1701
314850;202012;2138;4847;1729;4332;41;130;1504;3767;1545;3897
314860;202012;3163;9224;2626;8254;181;736;1843;5630;2024;6366
314870;202012;6282;15675;4767;13679;277;862;3560;10324;3837;11186
314875;202012;1738;5165;1518;4867;125;313;1205;3968;1330;4281
314880;202012;793;1948;611;1667;28;85;370;1011;398;1096
314890;202012;402;1191;308;998;49;178;128;390;177;568
314900;202012;721;1924;562;1640;73;247;265;727;338;974
314910;202012;1640;4586;1214;3891;192;715;617;1868;809;2583
314915;202012;2163;6404;1814;5781;115;373;1199;3760;1314;4133
314920;202012;463;1208;298;955;6;15;201;660;207;675
314930;202012;5441;15143;4071;12550;673;2318;1684;4800;2357;7118
314940;202012;386;965;313;840;36;92;197;501;233;593
314950;202012;531;1319;355;1025;26;91;191;497;217;588
314960;202012;826;1956;632;1635;27;90;455;1104;482;1194
314970;202012;949;2764;719;2277;135;461;321;930;456;1391
314980;202012;1481;3780;1098;3213;192;647;540;1533;732;2180
314990;202012;2364;6774;1680;5223;334;1106;364;1019;698;2125
314995;202012;1561;4306;1237;3726;35;151;841;2404;876;2555
315000;202012;1094;2750;779;2266;59;181;524;1504;583;1685
315010;202012;369;1004;278;848;44;157;137;399;181;556
315015;202012;2272;6317;1969;5804;183;605;1329;3851;1512;4456
315020;202012;784;2277;549;1744;69;272;237;689;306;961
315030;202012;583;1546;395;1195;89;271;77;207;166;478
315040;202012;825;2278;665;1992;84;277;415;1215;499;1492
315050;202012;1194;3086;874;2566;54;198;469;1325;523;1523
315053;202012;1050;2724;810;2310;49;156;483;1305;532;1461
315057;202012;1708;5092;1384;4539;133;433;937;3125;1070;3558
315060;202012;575;1716;417;1404;87;294;106;346;193;640
315070;202012;505;1320;342;1035;80;268;88;248;168;516
315080;202012;2917;8092;2248;6813;220;753;1460;4193;1680;4946
315090;202012;775;2318;568;1915;82;300;232;759;314;1059
315100;202012;1312;3803;860;2782;142;542;381;1081;523;1623
315110;202012;1914;4541;1382;3726;134;355;700;1949;834;2304
315120;202012;12291;28312;9090;23493;1153;2721;5038;13482;6191;16203
315130;202012;1601;4344;1328;3859;144;479;549;1500;693;1979
315140;202012;2849;7873;2220;6730;377;1240;1142;3295;1519;4535
315150;202012;4239;10137;2989;8138;443;1423;1433;3789;1876;5212
315160;202012;1744;4206;1140;3233;240;734;529;1478;769;2212
315170;202012;1293;4087;896;3113;210;799;237;774;447;1573
315180;202012;16760;40290;9108;26212;1195;3915;3080;7793;4275;11708
315190;202012;2175;4755;1694;4121;198;474;1228;3031;1426;3505
315200;202012;3843;10820;2764;8883;780;2723;751;2311;1531;5034
315210;202012;8479;21859;5754;16118;669;2049;2896;7344;3565;9393
315213;202012;1102;2886;959;2691;22;75;797;2188;819;2263
315217;202012;2811;8055;2147;6938;97;423;1478;4575;1575;4998
315220;202012;8467;22857;6646;19630;1057;3295;2926;8682;3983;11977
315230;202012;3004;7054;2541;6439;181;255;1952;5273;2133;5528
315240;202012;2350;6891;1966;6219;432;1411;950;3036;1382;4447
315250;202012;12910;34538;9294;27707;1431;4582;3996;11362;5427;15944
315260;202012;859;2348;454;1490;71;234;39;105;110;339
315270;202012;819;2333;581;1878;80;278;207;569;287;847
315280;202012;2731;6774;1646;4836;407;1298;274;783;681;2081
315290;202012;1128;2742;660;1989;181;614;199;572;380;1186
315300;202012;619;1511;426;1237;75;237;226;672;301;909
315310;202012;1212;3386;917;2819;77;265;519;1504;596;1769
315320;202012;648;1891;455;1502;65;232;186;571;251;803
315330;202012;740;2511;408;1599;67;308;127;441;194;749
315340;202012;2871;6911;2065;5753;284;822;1094;3019;1378;3841
315350;202012;1535;4196;1229;3712;175;626;695;2045;870;2671
315360;202012;1677;4941;1260;4049;188;640;533;1595;721;2235
315370;202012;470;1342;373;1148;74;221;145;439;219;660
315380;202012;200;583;145;464;40;141;33;76;73;217
315390;202012;1105;3100;868;2648;137;500;422;1171;559;1671
315400;202012;3927;10647;3089;9133;431;1350;1709;4830;2140;6180
315410;202012;2389;5472;1789;4590;462;1306;272;707;734;2013
315415;202012;1376;3722;1113;3311;241;846;413;1245;654;2091
315420;202012;1422;3976;968;3099;180;614;190;584;370;1198
315430;202012;3516;8538;2466;6940;429;1417;1087;2870;1516;4287
315440;202012;1024;2701;815;2356;62;213;493;1340;555;1553
315445;202012;1894;4567;1355;3793;84;282;993;2740;1077;3022
315450;202012;2220;6100;1818;5444;229;633;1132;3402;1361;4035
315460;202012;37060;101509;30452;89575;4265;14246;17248;47630;21513;61876
315470;202012;642;1778;453;1314;28;90;263;724;291;814
315480;202012;1078;3105;750;2384;139;471;252;772;391;1243
315490;202012;2852;7202;2010;5829;284;866;771;2130;1055;2996
315500;202012;515;1380;319;953;39;135;163;433;202;568
315510;202012;1205;3113;1025;2863;20;87;904;2485;924;2572
315520;202012;980;2668;804;2376;44;151;626;1803;670;1954
315530;202012;596;1662;470;1431;119;412;239;679;358;1091
315540;202012;1471;3910;1027;3093;97;355;480;1399;577;1754
315550;202012;1858;4845;1185;3594;240;835;305;915;545;1750
315560;202012;6162;18637;5190;16853;295;903;3437;11418;3732;12321
315570;202012;2051;5453;1630;4746;104;343;931;2661;1035;3004
315580;202012;2939;6852;2217;5712;325;951;854;2074;1179;3025
315590;202012;876;2200;668;1872;69;245;390;1007;459;1252
315600;202012;2476;7675;1775;6268;288;949;887;3320;1175;4269
315610;202012;955;2407;701;1952;104;366;319;765;423;1131
315620;202012;506;1335;383;1156;39;130;221;680;260;810
315630;202012;1009;2671;760;2208;123;378;360;957;483;1335
315640;202012;341;835;253;725;27;102;154;414;181;516
315645;202012;965;2471;658;1963;155;500;172;485;327;985
315650;202012;1663;4012;1340;3563;34;107;1093;2824;1127;2931
315660;202012;2434;5989;1825;4933;102;319;1312;3419;1414;3738
315670;202012;13398;36157;10158;30272;1938;6064;4676;13357;6614;19421
315680;202012;3140;8909;2301;7302;293;1072;1228;3682;1521;4754
315690;202012;3339;8011;2003;5723;460;1300;578;1806;1038;3106
315700;202012;7892;21563;5932;17685;967;3060;2650;7570;3617;10630
315710;202012;1808;4459;1278;3655;44;193;905;2469;949;2662
315720;202012;4392;12087;3640;10699;196;743;2558;7210;2754;7953
315725;202012;2174;5613;1665;4778;197;548;1020;3069;1217;3617
315727;202012;554;1425;418;1201;57;199;177;481;234;680
315730;202012;556;1728;489;1584;96;343;151;439;247;782
315733;202012;1099;2777;784;2241;118;396;307;842;425;1238
315737;202012;1147;3196;902;2723;25;102;660;1908;685;2010
315740;202012;774;2157;623;1859;65;229;414;1152;479;1381
315750;202012;1225;3230;974;2831;94;285;592;1751;686;2036
315760;202012;1104;2606;973;2435;43;132;815;1992;858;2124
315765;202012;1936;5066;1591;4609;29;120;1407;4051;1436;4171
315770;202012;968;2657;738;2331;295;1026;156;410;451;1436
315780;202012;29551;79617;24577;70762;1270;4575;17306;47503;18576;52078
315790;202012;3530;10870;3002;9846;336;1160;1850;6169;2186;7329
315800;202012;1278;4362;944;3507;130;552;326;1056;456;1608
315810;202012;1263;3142;1033;2743;55;191;803;2032;858;2223
315820;202012;2534;6773;2058;6096;189;616;1426;4230;1615;4846
315830;202012;1179;3492;799;2659;77;281;280;837;357;1118
315840;202012;843;2012;589;1573;41;134;299;720;340;854
315850;202012;1152;3369;897;2903;183;633;434;1315;617;1948
315860;202012;464;1330;328;1081;59;211;114;334;173;545
315870;202012;462;1214;372;1078;17;60;271;751;288;811
315880;202012;1084;2802;722;2150;99;345;165;468;264;813
315890;202012;1655;4698;1335;4249;332;1153;659;2084;991;3237
315895;202012;6179;16506;4605;13431;430;1396;2446;6634;2876;8030
315900;202012;802;2036;691;1877;61;163;523;1393;584;1556
315910;202012;489;1346;409;1221;58;176;286;849;344;1025
315920;202012;1407;3559;774;2358;121;451;253;701;374;1152
315930;202012;1056;2338;711;1852;136;324;310;843;446;1167
315935;202012;803;2407;625;2061;126;446;222;721;348;1167
315940;202012;587;1608;466;1421;53;167;248;729;301;896
315950;202012;1122;3109;927;2790;78;227;721;2167;799;2394
315960;202012;5257;14772;3499;11175;985;3544;331;694;1316;4238
315970;202012;583;1536;463;1376;57;179;311;937;368;1116
315980;202012;4103;8778;2221;5720;400;1098;845;1991;1245;3089
315990;202012;3531;8973;2762;7658;264;776;1585;4260;1849;5036
316000;202012;574;1449;435;1246;51;187;216;575;267;762
316010;202012;809;2165;602;1804;42;141;369;1032;411;1173
316020;202012;919;2781;728;2398;103;388;400;1236;503;1624
316030;202012;2646;7441;2032;6331;233;736;1294;4113;1527;4849
316040;202012;2291;6504;1706;5396;293;1060;452;1241;745;2301
316045;202012;2070;5325;1904;5127;76;148;1659;4584;1735;4732
316050;202012;378;1037;293;893;33;101;161;454;194;555
316060;202012;645;1615;477;1378;17;75;340;939;357;1014
316070;202012;5184;14306;4204;12450;727;2213;1971;5733;2698;7946
316080;202012;712;2230;548;1893;139;504;85;258;224;762
316090;202012;383;1109;287;912;41;139;141;424;182;563
316095;202012;1269;3909;1002;3235;281;961;327;1004;608;1965
316100;202012;2425;7017;1754;5606;313;1097;664;1929;977;3026
316105;202012;798;2092;656;1856;35;115;454;1323;489;1438
316110;202012;13641;38941;11417;35182;810;2860;7820;23758;8630;26618
316120;202012;1202;3398;773;2382;128;413;235;582;363;995
316130;202012;1216;2754;797;2061;63;180;472;1194;535;1374
316140;202012;1202;3172;769;2362;98;330;371;1116;469;1446
316150;202012;1916;4186;1530;3655;189;575;644;1452;833;2027
316160;202012;982;2647;792;2300;36;125;555;1570;591;1695
316165;202012;820;2035;630;1732;90;288;339;874;429;1162
316170;202012;1163;2852;875;2419;42;145;619;1641;661;1786
316180;202012;1375;3872;930;2951;139;522;167;495;306;1017
316190;202012;2642;7436;1545;4810;228;741;597;1635;825;2376
316200;202012;3127;8973;2357;7628;566;1961;608;1883;1174;3844
316210;202012;4388;12874;3129;9962;1136;3949;176;471;1312;4420
316220;202012;593;1776;394;1323;88;336;44;169;132;505
316225;202012;1584;3558;1182;2917;51;186;898;2057;949;2243
316230;202012;406;1089;311;926;36;111;175;534;211;645
316240;202012;5460;15748;4782;14562;356;1175;3634;10900;3990;12075
316245;202012;2996;9607;2715;9115;116;662;2124;6795;2240;7457
316250;202012;10165;24159;7426;19864;1552;4526;2822;7457;4374;11983
316255;202012;2846;7870;2504;7326;111;337;1900;5629;2011;5966
316257;202012;1367;3288;1001;2639;113;294;606;1525;719;1819
316260;202012;2120;5309;1654;4533;221;584;856;2415;1077;2999
316265;202012;1097;2935;850;2515;21;79;636;1838;657;1917
316270;202012;3638;11077;3113;9935;469;1593;1562;4775;2031;6368
316280;202012;2809;7910;2394;7137;301;990;1372;3971;1673;4961
316290;202012;3253;8972;2620;7809;282;985;1153;3306;1435;4291
316292;202012;4969;13107;3981;11452;496;1533;2580;7133;3076;8666
316294;202012;804;2381;604;2029;113;431;165;516;278;947
316295;202012;3186;8840;2578;7774;141;514;1820;5235;1961;5749
316300;202012;996;2818;800;2495;41;144;600;1845;641;1989
316310;202012;780;2068;507;1579;107;389;95;252;202;641
316320;202012;658;1824;517;1605;54;202;233;689;287;891
316330;202012;1078;2775;822;2338;55;192;624;1709;679;1901
316340;202012;991;2640;737;2183;68;256;430;1221;498;1477
316350;202012;1267;3550;1044;3182;93;303;733;2211;826;2514
316360;202012;617;1646;502;1454;51;158;372;1064;423;1222
316370;202012;4947;13016;3665;10699;612;2073;1534;3994;2146;6067
316380;202012;1698;4085;1341;3572;52;113;930;2504;982;2617
316390;202012;777;2091;547;1678;223;767;86;240;309;1007
316400;202012;1148;3217;747;2402;109;386;245;724;354;1110
316410;202012;1111;3068;933;2802;58;184;737;2170;795;2354
316420;202012;1954;5279;1694;4938;38;137;1413;4034;1451;4171
316430;202012;803;2091;509;1574;91;310;166;476;257;786
316440;202012;809;2452;634;2135;113;435;172;524;285;959
316443;202012;514;1427;376;1159;98;355;78;222;176;577
316447;202012;1951;5210;1715;4812;22;87;1500;4145;1522;4232
316450;202012;2098;6396;1607;5370;220;792;955;3114;1175;3906
316460;202012;1202;3025;969;2656;120;368;629;1632;749;2000
316470;202012;6646;18942;4724;14868;753;2673;1856;5332;2609;8005
316480;202012;186;508;156;466;46;134;72;212;118;346
316490;202012;317;846;219;666;37;116;77;200;114;316
316500;202012;1154;3554;766;2619;163;614;180;579;343;1193
316510;202012;745;2388;591;2081;106;390;295;1028;401;1418
316520;202012;1321;3157;1031;2685;121;396;548;1288;669;1684
316530;202012;1113;2887;807;2333;82;315;426;1096;508;1411
316540;202012;858;2208;670;1918;110;357;330;856;440;1213
316550;202012;1323;3846;1134;3490;48;168;886;2710;934;2878
316553;202012;4298;12554;3041;9523;441;1532;1200;3320;1641;4852
316555;202012;2503;7863;2268;7536;102;371;1899;6333;2001;6704
316556;202012;496;1251;378;1034;31;86;216;532;247;618
316557;202012;1035;3161;898;2933;280;997;328;1025;608;2022
316560;202012;317;877;216;723;46;186;68;198;114;384
316570;202012;1238;3564;1023;3166;253;799;350;1132;603;1931
316580;202012;376;792;214;523;34;98;105;238;139;336
316590;202012;1330;3412;930;2625;193;481;446;1239;639;1720
316600;202012;935;2840;801;2571;121;405;417;1330;538;1735
316610;202012;600;1865;487;1681;60;265;289;960;349;1225
316620;202012;2086;5422;1828;5063;83;249;1465;4036;1548;4285
316630;202012;1507;4504;1230;3976;314;1035;493;1737;807;2772
316640;202012;137;360;108;316;16;57;51;122;67;179
316650;202012;1040;3237;833;2906;80;295;519;1832;599;2127
316660;202012;181;448;78;238;7;26;15;39;22;65
316670;202012;1742;4416;1294;3687;311;960;468;1303;779;2263
316680;202012;2245;5695;1657;4575;99;284;1248;3352;1347;3636
316690;202012;1385;3883;1047;3269;173;583;485;1467;658;2050
316695;202012;1014;2933;831;2606;25;99;586;1824;611;1923
316700;202012;395;921;321;828;16;48;247;611;263;659
316710;202012;3035;9900;2329;8409;442;1701;977;3492;1419;5193
316720;202012;20055;54343;14676;44022;2492;8001;6432;18305;8924;26306
316730;202012;443;1179;357;1017;46;157;173;461;219;618
316740;202012;739;2138;635;1967;69;250;397;1233;466;1483
316750;202012;383;1152;293;981;64;242;129;400;193;642
316760;202012;3315;10642;2736;9452;1088;4072;592;1925;1680;5997
316770;202012;1578;3557;1211;3046;24;71;992;2562;1016;2633
316780;202012;540;1597;419;1356;160;569;71;205;231;774
316790;202012;704;1906;498;1490;92;303;146;399;238;702
316800;202012;6202;17287;4950;15015;565;1904;2487;7306;3052;9210
316805;202012;987;2185;794;1975;59;162;609;1529;668;1691
316810;202012;590;1638;408;1273;77;278;217;634;294;912
316820;202012;295;721;164;477;20;75;62;158;82;233
316830;202012;769;2009;612;1760;78;244;373;1050;451;1294
316840;202012;2727;6973;2158;6016;181;635;1509;3995;1690;4630
316850;202012;1855;4892;1339;3940;227;718;577;1629;804;2347
316860;202012;18499;47229;13466;39730;2142;7363;6186;17797;8328;25160
316870;202012;7649;20677;5639;16783;835;2737;2593;7234;3428;9971
316880;202012;876;2339;713;2109;134;440;351;991;485;1431
316890;202012;1120;2458;660;1845;86;311;412;1053;498;1364
316900;202012;2254;6031;1735;4992;339;1074;539;1450;878;2524
316905;202012;510;1521;411;1325;108;377;162;531;270;908
316910;202012;851;2214;505;1591;134;457;41;121;175;578
316920;202012;1738;4256;1226;3491;218;665;581;1605;799;2270
316930;202012;7494;21447;5517;17834;1258;4391;1507;4587;2765;8978
316935;202012;3964;10715;2861;8638;508;1665;1159;3341;1667;5006
316940;202012;6321;18453;4832;15360;721;2521;1977;5824;2698;8345
316950;202012;1862;4343;1459;3793;40;133;1223;3128;1263;3261
316960;202012;4998;11207;3596;9305;313;907;2502;6312;2815;7219
316970;202012;3728;10499;3218;9547;501;1555;1357;3858;1858;5413
316980;202012;634;1912;484;1613;165;619;52;185;217;804
316990;202012;11756;31230;8567;24757;2133;6746;1344;3496;3477;10242
317000;202012;2472;7266;2178;6833;162;452;1621;5146;1783;5598
317005;202012;2492;6984;1994;5978;323;1018;1067;3132;1390;4150
317010;202012;23360;54413;14387;40593;2811;8786;5655;16304;8466;25090
317020;202012;59342;140357;34508;97374;6319;19567;11241;29329;17560;48896
317030;202012;686;1794;532;1581;12;53;416;1218;428;1271
317040;202012;10684;26806;7444;21216;1639;5046;2662;7807;4301;12853
317043;202012;845;1893;601;1548;46;120;441;1124;487;1244
317047;202012;1172;2803;812;2229;74;220;519;1363;593;1583
317050;202012;1127;3467;803;2693;108;391;339;988;447;1379
317052;202012;2324;6444;1867;5709;267;806;1150;3554;1417;4360
317057;202012;1786;4252;1320;3502;34;121;864;2274;898;2395
317060;202012;513;1324;324;949;39;122;139;353;178;475
317065;202012;1134;3326;925;2911;57;178;582;1739;639;1917
317070;202012;7182;19828;5095;15772;917;3174;1559;4564;2476;7738
317075;202012;892;2298;647;1885;100;324;305;807;405;1131
317080;202012;5880;13679;4322;11193;1159;3261;1449;3606;2608;6867
317090;202012;4674;13512;4152;12656;294;849;3113;9564;3407;10413
317100;202012;2598;6159;1665;4614;380;1083;598;1640;978;2723
317103;202012;2202;5756;1884;5278;77;348;1485;3985;1562;4333
317107;202012;1432;3771;1087;3113;78;268;653;1670;731;1938
317110;202012;661;1553;336;1032;52;186;117;374;169;560
317115;202012;1046;3008;909;2759;55;146;615;1880;670;2026
317120;202012;14588;38886;11714;34228;1075;3760;7304;20332;8379;24092
317130;202012;11186;25800;7088;19082;1118;3333;2426;6463;3544;9796
317140;202012;851;2022;664;1742;40;112;447;1207;487;1319
317150;202012;989;2349;743;2043;32;100;585;1577;617;1677
317160;202012;3477;8345;2304;6465;166;488;1278;3695;1444;4183
317170;202012;1751;4351;1275;3531;178;591;578;1406;756;1997
317180;202012;1942;5995;1424;4751;272;973;385;1193;657;2166
317190;202012;1149;3094;846;2602;216;638;353;1095;569;1733
317200;202012;5551;14633;4195;12099;1030;3209;919;2432;1949;5641
317210;202012;1165;2823;910;2474;25;98;677;1865;702;1963
317220;202012;233;728;197;658;47;160;76;266;123;426
320010;202012;4485;12937;3579;11103;373;1286;2298;6927;2671;8213
320013;202012;2031;5447;1384;4158;230;705;617;1945;847;2650
320016;202012;2963;7584;2337;6624;168;449;1750;4972;1918;5421
320020;202012;3798;9743;2752;7929;589;1876;998;2975;1587;4851
320030;202012;1702;4724;1112;3508;210;709;396;1197;606;1906
320035;202012;1891;5164;1541;4560;382;1239;669;1922;1051;3161
320040;202012;4076;11431;3357;10129;460;1465;1909;5524;2369;6989
320050;202012;1747;3964;1503;3612;185;529;894;2073;1079;2602
320060;202012;12675;34391;9380;27839;1436;4622;4455;12409;5891;17031
320070;202012;1520;4233;1066;3300;183;630;398;1165;581;1795
320080;202012;5705;14559;3940;11024;798;2378;1444;3805;2242;6183
320090;202012;8480;22405;5550;16319;1222;3835;2011;5510;3233;9345
320100;202012;3038;8219;2476;7245;436;1395;1255;3668;1691;5063
320110;202012;2044;4725;1365;3630;198;549;672;1719;870;2268
320115;202012;1784;5721;1511;5262;641;2362;402;1455;1043;3817
320120;202012;23644;60035;16302;46616;2321;7142;7660;20681;9981;27823
320130;202012;46078;126923;37683;111628;4756;15499;22369;64213;27125;79712
320140;202012;3485;9438;2288;7073;336;1208;937;2858;1273;4066
320150;202012;13432;34665;9573;27221;2385;7509;1576;3957;3961;11466
320160;202012;5984;16605;4374;13470;703;2385;2010;6090;2713;8475
320170;202012;1679;4804;1197;3819;330;1028;437;1480;767;2508
320180;202012;681;2142;544;1874;204;751;145;452;349;1203
320190;202012;2769;8751;2091;7227;514;1884;543;1782;1057;3666
320200;202012;1321;3509;879;2703;193;651;339;1033;532;1684
320210;202012;4243;10770;3270;9094;527;1577;1730;4600;2257;6177
320220;202012;2886;7475;2181;6326;347;1084;1158;3169;1505;4253
320225;202012;1332;4137;937;3205;326;1218;193;652;519;1870
320230;202012;4936;13557;3773;11603;813;2761;1513;4456;2326;7217
320240;202012;15902;39996;11703;33184;2819;8726;3793;10541;6612;19267
320245;202012;3032;8899;2360;7547;851;2876;422;1318;1273;4194
320250;202012;2347;6540;1572;4697;358;1176;464;1208;822;2384
320255;202012;1870;5794;1593;5275;410;1402;727;2476;1137;3878
320260;202012;1426;3988;841;2675;177;615;203;542;380;1157
320265;202012;2447;7475;1965;6491;869;3082;326;1070;1195;4152
320270;202012;2160;6211;1655;5213;426;1456;587;1855;1013;3311
320280;202012;7029;18612;5691;16314;1099;3426;2853;7865;3952;11291
320290;202012;1339;3960;859;2799;236;837;225;683;461;1520
320300;202012;3632;10859;2863;9270;815;2867;725;2194;1540;5061
320305;202012;5067;14269;3906;11962;729;2444;1918;5680;2647;8124
320310;202012;2196;6016;1520;4579;270;858;688;1946;958;2804
320313;202012;2395;5955;1559;4405;307;979;415;1065;722;2044
320316;202012;1468;4116;1184;3624;185;575;702;2156;887;2731
320320;202012;21852;56942;15462;45702;3559;10988;5677;16792;9236;27780
320330;202012;2886;7821;2228;6619;402;1200;1183;3588;1585;4788
320332;202012;7430;19833;5881;17021;1328;4131;2662;7621;3990;11752
320334;202012;1714;4817;1189;3736;260;991;298;701;558;1692
320335;202012;1411;4188;995;3210;231;830;256;757;487;1587
320340;202012;4727;11790;3909;10589;489;1447;2284;6248;2773;7695
320350;202012;5351;13173;3763;10299;450;1362;2018;5188;2468;6550
320360;202012;1409;3587;1037;2880;124;342;521;1385;645;1727
320370;202012;2516;7693;1833;6208;550;1967;583;1962;1133;3929
320380;202012;2589;6889;2137;6143;244;748;1359;3803;1603;4551
320390;202012;7129;19073;5222;15259;1080;3379;2105;5770;3185;9149
320400;202012;3274;9188;2455;7421;691;2225;792;2287;1483;4512
320405;202012;4863;12676;3677;10623;547;1725;1817;5105;2364;6830
320410;202012;4715;12160;3541;10255;644;1813;1777;5381;2421;7194
320420;202012;2891;7469;2119;6104;531;1700;335;970;866;2670
320425;202012;2096;5051;1598;4201;106;306;1040;2643;1146;2949
320430;202012;3113;7761;2425;6513;326;952;1515;3902;1841;4854
320435;202012;2085;6493;1644;5619;584;2122;523;1798;1107;3920
320440;202012;1499;4123;1090;3322;174;577;489;1407;663;1984
320450;202012;1709;4857;1331;4131;258;913;603;1745;861;2658
320455;202012;4298;12877;2868;9469;710;2525;707;2119;1417;4644
320460;202012;2039;5998;1441;4732;342;1191;399;1222;741;2413
320465;202012;1279;3571;955;2949;135;417;508;1581;643;1998
320470;202012;3625;9917;2564;7692;575;1829;648;1731;1223;3560
320480;202012;1640;4486;1337;3975;182;607;799;2319;981;2926
320490;202012;21093;55159;15565;45400;2611;8298;6546;18914;9157;27212
320495;202012;1216;3352;858;2639;184;649;318;931;502;1580
320500;202012;51278;135634;40683;117260;5508;17252;23883;65930;29391;83182
320501;202012;4252;12359;3141;10292;856;3151;1037;3336;1893;6487
320503;202012;2291;6587;1477;4862;402;1439;418;1321;820;2760
320506;202012;2594;7713;1878;6106;559;1966;170;546;729;2512
320510;202012;10079;27064;8105;23619;854;2870;5073;14296;5927;17166
320515;202012;1765;4840;1348;3976;361;1172;460;1281;821;2453
320517;202012;2150;6407;1709;5456;534;1861;527;1658;1061;3519
320520;202012;36324;93059;26884;76979;4510;14211;11703;32235;16213;46446
320530;202012;32359;84909;25409;72466;2298;7753;16262;43754;18560;51507
330010;202012;22694;59432;18666;52756;2326;7193;12366;33886;14692;41079
330015;202012;1448;3523;1120;3024;190;575;613;1578;803;2153
330020;202012;19599;48702;16412;44082;2310;6910;11376;29882;13686;36792
330022;202012;1842;4913;1421;4193;246;735;827;2426;1073;3161
330023;202012;4990;11708;3587;9739;571;1739;2038;5411;2609;7150
330025;202012;6821;15747;3916;10857;887;2736;792;2088;1679;4824
330030;202012;10258;27134;7728;22998;801;2769;4782;13578;5583;16347
330040;202012;14359;36983;11351;31914;992;3121;7754;20980;8746;24101
330045;202012;83909;196731;68836;177493;5200;13186;54688;140637;59888;153823
330050;202012;2469;6489;1816;5375;341;1077;913;2583;1254;3660
330060;202012;5099;13252;3951;11182;762;2436;1685;4388;2447;6824
330070;202012;22015;55165;17601;48794;2713;8036;10535;28967;13248;37003
330080;202012;8644;21674;7326;19815;896;2586;5122;13676;6018;16262
330090;202012;3317;6962;2300;5549;155;403;1602;3868;1757;4271
330093;202012;2670;6336;1989;5382;109;323;1534;4127;1643;4450
330095;202012;1261;3514;980;2992;78;285;608;1720;686;2005
330100;202012;70434;184673;59864;169001;3491;11711;46180;128376;49671;140087
330110;202012;2061;5701;1642;4990;260;870;942;2760;1202;3630
330115;202012;2515;6015;1755;4831;243;763;996;2635;1239;3398
330120;202012;3479;7750;2594;6617;206;586;1839;4525;2045;5111
330130;202012;4378;11736;3547;10470;479;1476;2225;6533;2704;8009
330140;202012;3770;9714;2973;8566;421;1350;1910;5365;2331;6715
330150;202012;2102;5547;1584;4723;276;869;802;2331;1078;3200
330160;202012;1325;3574;974;2942;179;584;521;1506;700;2090
330170;202012;109013;266485;86943;236546;11534;30924;58910;162313;70444;193237
330180;202012;1931;4606;1474;3964;92;282;1021;2678;1113;2960
330185;202012;9664;24067;8023;21797;468;1565;6458;17100;6926;18665
330187;202012;4307;10805;3344;9226;454;1351;2002;5472;2456;6823
330190;202012;33711;80449;28249;72930;1863;5221;22479;57297;24342;62518
330200;202012;15719;39375;12635;35567;2438;6463;7909;23066;10347;29529
330205;202012;2089;5128;1571;4298;98;329;1099;2876;1197;3205
330210;202012;3488;8599;2512;6898;361;1071;1257;3220;1618;4291
330220;202012;11868;29033;8261;23004;1663;5223;3071;7874;4734;13097
330225;202012;3897;9680;2953;8232;186;633;2166;5875;2352;6508
330227;202012;16865;40346;14018;36896;517;1492;12041;31372;12558;32864
330230;202012;2114;4551;1359;3605;119;341;807;2149;926;2490
330240;202012;23059;59506;18889;53024;2212;6846;12775;35006;14987;41852
330245;202012;1741;4235;1027;2978;198;576;399;1152;597;1728
330250;202012;38135;96244;31207;85973;5155;14621;19376;53124;24531;67745
330260;202012;4822;11517;3625;9883;318;1016;2632;6934;2950;7950
330270;202012;30342;67397;18413;47904;2893;8048;7708;19218;10601;27266
330280;202012;2318;6011;1723;5001;185;578;1021;2865;1206;3443
330285;202012;24404;57516;19088;49874;1375;4270;14270;35993;15645;40263
330290;202012;3879;9283;3107;8271;335;989;2222;5720;2557;6709
330300;202012;5743;13389;4162;11129;316;962;2928;7671;3244;8633
330310;202012;2681;6520;1890;5197;135;318;1258;3477;1393;3795
330320;202012;16575;38505;12561;33495;1459;3704;8992;24316;10451;28020
330330;202012;40694;87521;31211;74670;2689;7132;22533;52613;25222;59745
330340;202012;17455;40451;12347;32609;1726;5284;6685;16392;8411;21676
330350;202012;143125;326180;117553;294866;7271;18914;97073;241848;104344;260762
330360;202012;7341;17742;6262;16417;196;513;5331;13915;5527;14428
330370;202012;4860;13765;3718;11832;891;2907;1534;5090;2425;7997
330380;202012;5288;13881;3980;11585;640;2184;2074;5744;2714;7928
330385;202012;4001;11312;3243;10202;744;2577;1562;4826;2306;7403
330390;202012;26324;69829;19902;58813;2613;8968;11857;32997;14470;41965
330395;202012;3173;7769;2604;7034;152;478;1905;5020;2057;5498
330400;202012;3335;8672;2814;7842;144;515;2126;5592;2270;6107
330410;202012;3292;8690;2310;6961;464;1525;1003;2853;1467;4378
330411;202012;2730;7319;2096;6152;138;486;1469;4148;1607;4634
330412;202012;1503;4223;1204;3720;128;464;760;2204;888;2668
330414;202012;23772;59265;19223;53014;1435;4219;14473;39377;15908;43596
330415;202012;4274;11569;3288;9848;339;1068;1957;5808;2296;6876
330420;202012;11619;28427;8139;22737;942;3030;4348;11284;5290;14314
330430;202012;9483;22626;7894;20435;304;1007;6253;15699;6557;16706
330440;202012;2512;6641;1887;5595;285;992;1108;3131;1393;4123
330450;202012;1387;3886;1080;3354;142;479;594;1810;736;2289
330452;202012;17334;43397;13833;38025;1607;5068;9082;24012;10689;29080
330455;202012;543670;1276823;418028;1096371;56782;159053;271255;698512;328037;857565
330460;202012;1154;3110;851;2661;140;482;472;1432;612;1914
330470;202012;4748;11728;3369;9600;1125;3328;892;2646;2017;5974
330475;202012;9617;24581;7759;22187;1176;3860;5028;14022;6204;17882
330480;202012;5914;15183;4963;13790;399;1250;3470;9330;3869;10580
330490;202012;110844;252337;89348;223284;9758;25338;64279;159117;74037;184455
330500;202012;7398;18051;6104;16281;603;1809;4419;11591;5022;13400
330510;202012;40013;97271;29329;82160;4492;13570;18332;50498;22824;64068
330513;202012;1202;3083;943;2726;202;624;452;1322;654;1946
330515;202012;2463;6467;1955;5756;364;1171;1092;3126;1456;4297
330520;202012;11062;28861;8929;25527;1119;3572;5603;15579;6722;19151
330530;202012;1697;4056;1235;3365;249;740;563;1514;812;2254
330540;202012;2771;7296;2143;6211;517;1549;925;2609;1442;4158
330550;202012;8910;22537;6735;19681;1806;5809;2900;8339;4706;14148
330555;202012;18203;37862;15016;34118;773;1959;12326;28225;13099;30184
330560;202012;4064;10771;3264;9440;494;1467;1946;5495;2440;6962
330570;202012;2638;7206;2234;6588;341;1090;1485;4336;1826;5426
330575;202012;5323;13672;4541;12340;267;836;3669;9674;3936;10510
330580;202012;17248;45462;13323;38419;2336;7259;6633;18347;8969;25606
330590;202012;1422;3813;1165;3482;216;644;725;2197;941;2841
330600;202012;11949;30999;9677;27351;865;2858;6284;17227;7149;20085
330610;202012;9013;23952;7194;21059;532;1829;5052;14447;5584;16276
330615;202012;2058;5616;1621;5021;304;968;1004;3179;1308;4147
330620;202012;3973;11244;3084;9711;672;2284;1337;3956;2009;6240
330630;202012;24011;59569;18790;51467;1253;4087;13557;35882;14810;39969
350010;202012;1992;5109;1051;3132;219;697;205;453;424;1150
350020;202012;691;1749;396;1183;49;153;158;442;207;595
350030;202012;3428;9548;2548;8013;626;2171;1109;3292;1735;5463
350040;202012;711;2019;398;1331;46;182;139;354;185;536
350050;202012;1313;3207;843;2386;175;575;303;700;478;1275
350055;202012;886;2306;688;1990;79;242;401;1101;480;1343
350060;202012;198;504;115;337;14;47;51;149;65;196
350070;202012;3149;8266;2009;6200;403;1395;662;1808;1065;3203
350075;202012;588;1699;429;1387;169;574;49;170;218;744
350080;202012;645;1666;414;1253;58;201;166;447;224;648
350090;202012;582;1361;347;957;65;192;152;388;217;580
350100;202012;2284;6004;1588;4773;120;442;999;2817;1119;3259
350110;202012;474;1187;321;918;17;58;185;518;202;576
350115;202012;1212;3488;987;3022;172;583;511;1424;683;2007
350120;202012;665;1530;371;994;31;108;202;474;233;582
350130;202012;3061;8038;2371;6767;413;1194;1172;3191;1585;4385
350140;202012;763;2141;516;1662;48;207;275;822;323;1029
350150;202012;540;1640;429;1421;98;325;125;383;223;708
350160;202012;10714;26791;7103;20138;882;2818;4305;11584;5187;14402
350170;202012;2269;6412;1817;5416;309;1002;846;2305;1155;3307
350180;202012;1002;2457;528;1564;101;312;130;350;231;662
350190;202012;2774;7821;1874;5892;331;1182;786;2120;1117;3302
350200;202012;444;1245;340;1047;16;54;222;642;238;696
350210;202012;5729;13145;3863;10219;477;1382;2402;6109;2879;7491
350220;202012;2825;7681;1878;5788;400;1309;609;1692;1009;3001
350230;202012;959;2446;782;2200;143;430;442;1210;585;1640
350240;202012;625;1791;391;1244;88;274;95;283;183;557
350250;202012;2515;7010;1870;5942;595;2080;444;1391;1039;3471
350260;202012;814;1915;523;1419;53;165;325;844;378;1009
350270;202012;4466;11902;3533;10121;523;1646;1897;5055;2420;6701
350275;202012;2309;6164;1790;5358;296;972;1047;2994;1343;3966
350280;202012;18159;40992;10744;28785;1772;4996;4359;11155;6131;16151
350290;202012;3137;8639;2093;6438;372;1257;848;2445;1220;3702
350300;202012;614;1644;453;1346;58;173;245;681;303;854
350310;202012;882;2531;645;2058;111;406;252;712;363;1118
350315;202012;580;1443;379;1104;24;86;201;540;225;626
350320;202012;14926;37876;10738;30404;2209;6920;4195;10983;6404;17903
350330;202012;13527;33032;9555;25457;1017;3012;6065;15195;7082;18207
350335;202012;363;1029;280;870;37;130;126;366;163;496
350340;202012;1137;2862;692;2056;115;405;293;763;408;1168
350350;202012;749;1865;576;1675;65;220;351;1004;416;1224
350360;202012;1049;3076;789;2532;209;683;243;796;452;1479
350370;202012;610;1515;423;1176;145;379;133;378;278;757
350380;202012;4295;11692;3036;9136;869;2562;797;2464;1666;5026
350390;202012;10550;27493;8238;23532;1597;4781;4017;11019;5614;15800
350395;202012;418;1072;213;675;24;70;79;231;103;301
350400;202012;7837;19061;5379;15033;1318;3980;1505;4164;2823;8144
350410;202012;9785;26970;7044;21627;1405;4802;2808;7976;4213;12778
350420;202012;758;2025;517;1495;79;258;127;312;206;570
350430;202012;649;1717;526;1527;69;237;325;863;394;1100
350440;202012;2037;5074;1641;4473;124;360;1077;2872;1201;3232
350450;202012;6338;17316;4885;14805;1058;3511;2054;5856;3112;9367
350460;202012;1691;4330;880;2677;141;465;251;672;392;1137
350470;202012;247;623;190;524;12;38;135;357;147;395
350480;202012;972;2380;619;1778;126;444;161;355;287;799
350490;202012;1928;4991;1361;4074;317;974;422;1167;739;2141
350500;202012;659;1742;491;1438;62;199;238;651;300;850
350510;202012;1152;2980;856;2442;93;298;513;1394;606;1692
350520;202012;2111;6383;1611;5379;253;939;727;2193;980;3132
350530;202012;2787;6970;2054;5568;221;674;1248;3151;1469;3825
350535;202012;1422;3869;1226;3590;178;566;761;2165;939;2731
350540;202012;1958;4598;1443;3829;168;460;923;2355;1091;2815
350550;202012;8135;19917;5574;15667;585;1977;3263;8496;3848;10473
350560;202012;3848;10749;3051;9339;294;951;1939;5750;2233;6701
350570;202012;23798;65634;19089;56551;3419;11173;9931;28138;13350;39311
350580;202012;2018;5361;1200;3678;325;1081;223;555;548;1636
350590;202012;5002;13403;3663;10411;476;1548;2176;5709;2652;7257
350600;202012;34417;78910;21131;55847;3061;9196;10081;24477;13142;33673
350610;202012;6712;18226;4742;14293;822;2734;2228;6289;3050;9023
350620;202012;411;1044;256;805;27;89;145;434;172;523
350630;202012;1412;3638;1030;2955;65;234;681;1821;746;2055
350635;202012;9213;22488;6850;18773;913;2741;4220;11093;5133;13834
350640;202012;890;2368;465;1438;70;215;138;372;208;587
350650;202012;8336;22070;5652;16757;1079;3458;2167;5969;3246;9427
350660;202012;4429;11544;3388;9824;560;1637;1792;5211;2352;6848
350670;202012;1775;4692;1444;4208;143;426;983;2875;1126;3301
350680;202012;1076;2880;717;2214;132;426;295;862;427;1288
350690;202012;1251;3218;881;2598;154;487;470;1354;624;1841
350700;202012;4745;11935;3368;9779;678;2253;1466;4063;2144;6316
350710;202012;2744;7477;2318;6719;389;1332;1278;3412;1667;4744
350715;202012;781;2217;641;1970;69;267;359;1027;428;1294
350720;202012;149;402;106;328;17;51;29;77;46;128
350730;202012;621;1660;519;1489;29;114;392;1056;421;1170
350740;202012;1650;4370;1130;3315;201;639;384;1036;585;1675
350745;202012;562;1410;314;958;36;135;132;367;168;502
350750;202012;9543;24582;7165;20487;1211;4046;3323;8510;4534;12556
350760;202012;14504;35747;10362;28576;2145;6536;4413;10977;6558;17513
350770;202012;990;2460;616;1794;36;114;405;1146;441;1260
350775;202012;656;1526;445;1208;52;144;217;586;269;730
350780;202012;2269;5440;1589;4463;260;862;567;1818;827;2680
350790;202012;1904;5016;1188;3654;239;804;336;838;575;1642
350800;202012;3458;9873;2947;8968;239;823;2055;6059;2294;6882
350810;202012;2772;6731;2141;5802;323;830;1159;3220;1482;4050
350820;202012;929;2149;528;1436;52;173;263;646;315;819
350830;202012;861;2375;485;1531;73;241;155;413;228;654
350840;202012;3204;9240;2375;7668;532;1907;1077;3211;1609;5118
350850;202012;7342;20187;5699;17184;1072;3517;2785;7962;3857;11479
350860;202012;3562;9476;3047;8783;107;396;2352;6719;2459;7115
350870;202012;2526;7086;1861;6003;258;937;1042;3266;1300;4203
350880;202012;1268;3594;983;3019;261;835;268;792;529;1627
350890;202012;532;1369;331;949;52;151;127;337;179;488
350900;202012;7063;18903;4440;13411;921;3042;1613;4491;2534;7533
350910;202012;888;2155;758;1957;88;230;551;1406;639;1636
350920;202012;11982;29260;10107;26226;401;1281;8332;20821;8733;22102
350925;202012;4086;11060;2886;8893;545;1806;1381;3943;1926;5749
350930;202012;1460;3774;1010;2898;78;232;639;1800;717;2032
350940;202012;2213;5762;1682;4904;169;554;1076;3007;1245;3561
350945;202012;809;2275;602;1863;98;335;308;883;406;1218
350950;202012;87045;221444;66725;183652;8434;25496;41636;109400;50070;134896
350960;202012;6353;17091;4889;14333;576;1936;2948;8182;3524;10118
350970;202012;3457;9554;2439;7634;704;2474;516;1378;1220;3852
350980;202012;619;1683;503;1475;130;399;235;686;365;1085
350990;202012;1715;4766;1262;4026;304;1083;446;1339;750;2422
350995;202012;775;2395;689;2225;53;209;481;1490;534;1699
351000;202012;2823;7305;1949;5751;353;1094;717;2067;1070;3161
351010;202012;334;822;222;630;28;91;115;311;143;402
351015;202012;811;2429;645;2069;108;382;292;834;400;1216
351020;202012;8588;23205;6501;19619;1406;4293;3018;8912;4424;13205
351030;202012;2759;8168;2191;7037;317;1132;1187;3714;1504;4846
351040;202012;4877;12065;4061;10831;202;655;3341;8679;3543;9334
351050;202012;16452;39974;11818;32744;2302;6723;5334;14641;7636;21364
351060;202012;46764;117273;35443;97845;3591;10966;23963;64028;27554;74994
351070;202012;1365;3343;720;2218;175;594;125;373;300;967
351080;202012;2716;6486;1920;5535;197;671;1297;3563;1494;4234
351090;202012;319;923;229;755;48;162;65;210;113;372
351100;202012;2527;6821;1621;4995;364;1188;477;1526;841;2714
351110;202012;5967;15063;3817;11103;632;2032;1679;4585;2311;6617
351120;202012;755;1903;495;1464;62;191;193;560;255;751
351130;202012;1171;3006;524;1630;100;321;140;408;240;729
351140;202012;2114;5913;1544;4814;296;1030;673;1888;969;2918
351150;202012;2592;7373;1726;5452;276;959;691;1960;967;2919
351160;202012;1062;3280;770;2594;162;590;198;559;360;1149
351170;202012;1334;3635;1137;3279;86;271;820;2287;906;2558
351190;202012;992;2725;645;2003;119;372;237;676;356;1048
351200;202012;1558;3684;1140;3061;86;268;810;2034;896;2302
351210;202012;1533;3763;941;2630;81;263;553;1435;634;1698
351220;202012;3243;9051;2753;8236;296;916;1843;5463;2139;6379
351230;202012;1699;4572;1251;3774;214;768;582;1586;796;2354
351240;202012;2347;5921;1429;4006;312;948;526;1323;838;2271
351250;202012;1041;2765;621;1926;85;282;225;683;310;965
351260;202012;891;2242;638;1781;123;352;244;642;367;994
351270;202012;437;1158;351;1008;39;141;208;520;247;661
351280;202012;3669;9584;2784;7917;561;1599;1282;3516;1843;5115
351290;202012;1203;2962;844;2348;114;347;506;1351;620;1698
351300;202012;17934;48172;12142;36961;2124;7042;5324;15460;7448;22502
351310;202012;3393;8202;2557;6908;170;584;1909;4890;2079;5474
351320;202012;937;2687;695;2178;126;416;250;711;376;1127
351330;202012;493;1178;402;1007;23;67;284;641;307;708
351340;202012;6056;17171;4855;15011;1179;3801;2145;6622;3324;10423
351350;202012;11204;27813;9197;24658;934;2664;6744;17591;7678;20255
351360;202012;3686;9795;3003;8766;720;2247;1199;3235;1919;5482
351370;202012;2005;5528;1326;4112;312;1043;421;1187;733;2230
351380;202012;47712;114123;33430;89230;4122;11857;19555;49810;23677;61667
351385;202012;322;854;142;442;27;82;40;115;67;197
351390;202012;1321;3210;809;2442;111;400;478;1345;589;1745
351400;202012;893;2480;731;2145;110;322;464;1334;574;1656
351410;202012;2545;7020;1804;5544;307;994;742;2198;1049;3192
351420;202012;423;992;233;656;27;72;138;360;165;432
351430;202012;925;2476;721;2139;59;175;500;1430;559;1605
351440;202012;3321;8587;2150;6229;399;1214;616;1532;1015;2746
351450;202012;1684;4448;1100;3356;217;715;186;437;403;1152
351460;202012;832;2150;641;1847;148;410;352;1018;500;1428
351470;202012;1181;2986;914;2536;85;296;601;1561;686;1857
351480;202012;2465;7209;1940;6285;368;1327;848;2561;1216;3888
351490;202012;1974;5515;1679;4985;68;278;1366;3917;1434;4195
351492;202012;341;920;278;785;7;21;214;594;221;615
351495;202012;169;434;128;354;17;42;71;196;88;238
351500;202012;37343;90887;28151;75474;4031;11581;17266;44235;21297;55816
351510;202012;12549;31000;9033;24984;1081;3425;5680;14988;6761;18413
351512;202012;472;1271;341;988;60;180;119;313;179;493
351515;202012;3157;7009;1942;5128;348;1031;581;1640;929;2671
351518;202012;2261;5666;1430;4187;188;620;800;2129;988;2749
351519;202012;692;1896;423;1366;85;272;69;201;154;473
351520;202012;1288;3168;537;1617;53;181;232;620;285;801
351530;202012;345;903;202;603;31;97;84;203;115;300
351535;202012;1829;4481;1319;3599;206;612;691;1763;897;2375
351540;202012;2515;6208;1661;4696;281;919;632;1569;913;2488
351550;202012;7029;17273;4668;12982;466;1491;2683;6921;3149;8412
351560;202012;434;1234;334;1035;80;271;103;294;183;565
351565;202012;228;639;183;556;42;147;49;125;91;272
351570;202012;20914;55362;15814;45108;1607;4990;9996;27331;11603;32321
351580;202012;234;599;130;399;10;33;59;190;69;223
351590;202012;515;1177;273;743;21;83;162;394;183;477
351600;202012;1333;3509;1008;2885;102;316;602;1619;704;1935
351610;202012;774;1828;486;1318;24;68;284;725;308;793
351620;202012;22347;58168;15963;47177;2564;8622;7424;19867;9988;28489
351630;202012;27967;72741;22305;62950;3074;9242;14064;38325;17138;47567
351640;202012;17468;45476;13590;38453;1313;4262;9240;24982;10553;29244
351650;202012;360;946;170;544;24;79;51;142;75;221
351660;202012;732;2029;459;1424;76;250;74;187;150;437
351670;202012;5754;15351;3692;10889;792;2327;1579;4379;2371;6706
351680;202012;410;1158;256;822;42;134;64;167;106;301
351685;202012;391;1112;308;972;82;264;100;294;182;558
351690;202012;1079;2691;587;1721;82;268;261;689;343;957
351700;202012;1274;3154;924;2560;154;435;510;1331;664;1766
351710;202012;741;1984;529;1581;53;184;286;768;339;952
351720;202012;1341;3450;867;2623;136;435;363;1039;499;1474
351730;202012;924;2429;767;2187;59;213;491;1314;550;1527
351740;202012;3407;8524;2665;7092;471;1362;1349;3297;1820;4659
351750;202012;1275;3281;775;2402;143;467;305;909;448;1376
351760;202012;3216;9006;2342;7252;484;1694;874;2436;1358;4130
351770;202012;1719;5004;1389;4368;250;831;747;2285;997;3116
351780;202012;1171;2952;708;2098;93;316;258;716;351;1032
351790;202012;1308;3109;1026;2728;160;437;620;1657;780;2094
351800;202012;523;1201;252;688;29;85;98;219;127;304
351810;202012;1026;2675;840;2390;49;139;601;1628;650;1767
351820;202012;2558;7164;1756;5577;462;1584;414;1216;876;2800
351830;202012;4438;11813;3403;10006;317;1127;2176;6061;2493;7188
351840;202012;8390;22832;6200;18779;872;2994;3315;9328;4187;12322
351850;202012;1506;4106;988;3085;169;606;348;930;517;1536
351860;202012;2637;7556;2008;6373;340;1187;1070;3430;1410;4617
351870;202012;23144;58452;16979;48246;4131;12160;7134;20534;11265;32694
351880;202012;129884;330959;96453;273467;20987;65974;46336;124465;67323;190439
351885;202012;912;2400;713;2068;56;198;478;1322;534;1520
351890;202012;833;2132;516;1595;107;347;92;239;199;586
351900;202012;1099;2888;839;2503;117;347;488;1441;605;1788
351905;202012;413;1104;287;863;24;81;144;377;168;458
351907;202012;20536;53301;15853;44988;1784;5623;10306;28112;12090;33735
351910;202012;1609;4165;1104;3059;75;229;650;1629;725;1858
351920;202012;840;2216;631;1814;98;326;277;715;375;1041
351925;202012;903;2337;686;1952;85;285;370;967;455;1252
351930;202012;3182;8814;2837;8183;585;1687;1867;5305;2452;6992
351940;202012;1070;2725;761;2179;123;375;376;1061;499;1436
351950;202012;1670;3761;1240;3120;56;166;883;2132;939;2298
351960;202012;4940;12405;3537;9880;771;2321;1621;4215;2392;6536
351970;202012;6975;20416;5448;17722;843;3091;3022;9523;3865;12614
351980;202012;958;2216;603;1643;82;258;353;888;435;1146
351990;202012;1437;3394;1031;2787;53;197;509;1241;562;1438
352000;202012;2602;7347;2226;6565;246;831;1484;4103;1730;4934
352010;202012;2235;5917;1781;5160;472;1497;387;1145;859;2642
352020;202012;1330;3625;1012;3099;149;505;506;1469;655;1974
352030;202012;5664;14833;4332;12612;811;2575;2145;6042;2956;8617
352040;202012;2854;7487;1933;5637;270;895;743;1841;1013;2736
352042;202012;2894;6981;1895;5396;357;1157;852;2317;1209;3474
352044;202012;2043;5326;1160;3648;189;670;234;697;423;1367
352050;202012;12312;32409;7966;23838;1973;6763;1591;3988;3564;10751
352060;202012;666;1806;488;1470;73;241;215;595;288;836
352070;202012;921;1839;588;1396;61;156;295;622;356;778
352080;202012;474;1168;264;748;28;99;97;238;125;337
352090;202012;1452;4249;1190;3720;135;491;590;1667;725;2158
352100;202012;3329;9327;2677;8089;573;1900;1183;3440;1756;5340
352110;202012;584;1663;434;1361;99;318;175;508;274;826
352115;202012;493;1311;402;1171;55;189;240;680;295;869
352120;202012;874;2582;714;2253;80;248;427;1264;507;1512
352130;202012;2002;5545;1325;3900;198;630;556;1506;754;2136
352140;202012;1127;3074;793;2418;140;454;371;1094;511;1548
352150;202012;869;2277;671;1946;73;227;481;1358;554;1585
352160;202012;987;2416;712;1977;75;263;407;1074;482;1337
352170;202012;2959;7841;2326;6602;307;991;1442;3811;1749;4802
352180;202012;2350;6283;1783;5254;399;1335;558;1465;957;2800
352190;202012;1237;3324;971;2910;184;508;481;1515;665;2023
352200;202012;319;953;219;747;33;128;80;259;113;387
352210;202012;19533;45652;15309;40061;923;2728;12019;30807;12942;33535
352215;202012;657;1682;555;1524;74;228;349;924;423;1152
352220;202012;20854;51118;14270;39399;2611;7890;6557;16738;9168;24628
352230;202012;14102;40238;10802;33978;2564;9000;3936;11393;6500;20393
352240;202012;10046;25708;7616;21663;1639;5256;3371;8877;5010;14133
352250;202012;22081;61318;17558;53547;2794;9113;10574;31735;13368;40848
352260;202012;4676;11615;3081;8525;427;1370;1767;4395;2194;5765
352265;202012;904;2502;794;2348;51;173;601;1733;652;1906
352270;202012;1418;4178;1042;3371;218;763;375;1135;593;1898
352280;202012;2432;6073;1829;5197;197;669;1103;2909;1300;3578
352290;202012;1102;3157;884;2735;117;402;484;1353;601;1755
352300;202012;846;2295;570;1710;76;263;305;848;381;1111
352310;202012;42998;113780;31875;94197;7696;23365;13987;41582;21683;64947
352320;202012;6456;16842;4959;13969;742;2378;2692;6846;3434;9224
352330;202012;2145;5683;1623;4952;275;987;894;2553;1169;3540
352340;202012;5856;15355;4289;12462;649;2174;2219;5928;2868;8102
352350;202012;2077;5851;1601;4798;164;608;912;2465;1076;3073
352360;202012;1207;3195;987;2808;77;270;745;2043;822;2313
352370;202012;1063;2984;921;2751;21;84;753;2208;774;2292
352380;202012;816;2199;607;1827;126;380;214;619;340;999
352390;202012;14105;34599;9510;26468;1521;4629;5294;13940;6815;18569
352400;202012;3396;9289;2753;8093;586;2018;1399;3819;1985;5837
352410;202012;3231;8218;2431;6885;205;693;1529;4147;1734;4840
352420;202012;799;1911;563;1570;108;316;212;555;320;871
352430;202012;7945;19625;5627;15543;1143;3578;2664;6912;3807;10490
352440;202012;17589;47208;13018;38413;3174;9657;4842;13932;8016;23589
352450;202012;732;1737;361;1116;51;177;125;367;176;544
352460;202012;2898;7973;1993;6313;398;1379;823;2452;1221;3831
352470;202012;3261;8212;2448;6894;277;898;1522;4052;1799;4950
352480;202012;3890;9171;2577;6805;390;1165;1265;2999;1655;4164
352490;202012;732;2086;583;1823;95;330;290;857;385;1187
352500;202012;9872;25286;6548;19016;2664;8503;672;1101;3336;9604
352510;202012;3724;10017;2744;8291;552;1815;1301;3734;1853;5549
352520;202012;2863;7345;2203;6226;381;1237;1282;3280;1663;4517
352530;202012;10332;26432;6848;19768;1156;3838;2504;6209;3660;10047
352540;202012;574;1677;414;1315;64;224;143;400;207;624
352550;202012;988;2740;679;2137;124;446;237;667;361;1113
352560;202012;559;1543;422;1275;79;254;201;560;280;814
352570;202012;2297;6540;1420;4589;334;1170;143;368;477;1538
352580;202012;648;1675;540;1479;43;139;376;977;419;1116
352585;202012;316;832;228;681;19;74;139;375;158;449
352590;202012;12701;33160;8780;25649;2160;6895;3939;10679;6099;17574
352600;202012;1886;5066;1475;4311;153;491;937;2589;1090;3080
352610;202012;2756;7707;2065;6490;401;1424;870;2576;1271;4000
352620;202012;5517;13981;4179;12053;1172;3441;1660;4843;2832;8284
352630;202012;818;2017;602;1707;111;357;278;721;389;1078
352640;202012;2903;7408;2081;5940;202;606;1205;3300;1407;3906
352650;202012;575;1626;393;1233;55;192;143;432;198;624
352660;202012;1055;3083;874;2717;99;328;525;1589;624;1917
352670;202012;9336;24954;6130;18559;1542;5051;1670;4682;3212;9733
352680;202012;3321;9755;2292;7381;346;1333;1101;3159;1447;4492
352690;202012;26832;66797;20840;56591;1303;4252;14987;38983;16290;43235
352700;202012;561;1397;414;1200;147;489;98;276;245;765
352710;202012;5096;13024;3585;10278;839;2667;1517;3982;2356;6649
352720;202012;7672;20598;5911;17321;2330;7029;1493;4062;3823;11091
352725;202012;574;1368;326;925;23;58;165;451;188;509
352730;202012;5062;14611;4539;13408;523;1694;2106;5454;2629;7148
352740;202012;2242;5312;1676;4467;172;546;1029;2579;1201;3125
352750;202012;418;1038;252;734;40;133;111;282;151;415
352760;202012;1587;4369;1232;3664;94;266;739;2225;833;2491
352770;202012;854;2303;579;1772;121;378;228;670;349;1048
352780;202012;598;1669;432;1346;97;281;116;373;213;654
352790;202012;452;1200;313;921;35;119;123;315;158;434
352800;202012;1249;3778;869;2869;240;813;116;330;356;1143
352810;202012;1144;2677;728;1947;113;326;439;1098;552;1424
352820;202012;458;1294;334;1068;68;208;73;247;141;455
352830;202012;572;1439;258;778;25;81;60;146;85;227
352840;202012;3909;11128;3178;9790;1039;3445;1062;3157;2101;6602
352850;202012;10486;25515;7173;20106;1905;5797;2331;5917;4236;11714
352860;202012;1002;2757;743;2280;141;471;283;825;424;1296
352870;202012;852;2103;588;1574;52;165;368;933;420;1098
352880;202012;1695;3985;1184;3103;198;547;641;1610;839;2157
352885;202012;295;808;218;674;18;63;135;396;153;459
352890;202012;685;1646;438;1128;39;114;269;619;308;733
352900;202012;17557;45540;11501;33553;1880;5873;5143;14081;7023;19954
352910;202012;430;1130;232;706;28;92;69;180;97;272
352920;202012;2606;6584;1890;5363;121;375;1321;3646;1442;4021
352930;202012;5581;14965;4113;12105;726;2375;1968;5381;2694;7756
352940;202012;21278;57016;15324;44648;3010;9616;6882;18830;9892;28446
352950;202012;524;1378;316;995;89;280;62;177;151;457
352960;202012;714;1889;397;1220;71;237;113;301;184;538
352965;202012;220;618;137;449;41;132;34;102;75;234
352970;202012;2874;6830;2192;5701;234;663;1438;3669;1672;4332
352980;202012;1328;3532;1060;3130;251;810;541;1558;792;2368
352990;202012;3997;11197;3108;9713;622;2131;1553;4646;2175;6777
353000;202012;470;1284;260;797;38;123;62;159;100;282
353010;202012;2543;6280;1651;4641;330;1065;703;1785;1033;2850
353020;202012;3489;8966;2067;6025;286;931;723;1963;1009;2894
353030;202012;4331;10803;2935;8387;661;2074;877;2376;1538;4450
353040;202012;637;1438;436;1145;82;207;225;580;307;787
353050;202012;5083;14457;3557;11318;665;2286;1636;4982;2301;7268
353060;202012;46960;119418;38716;106214;2622;8629;29251;77478;31873;86107
353070;202012;9128;25853;6601;20453;1240;4231;2851;8153;4091;12384
353080;202012;3989;10842;2584;8104;473;1687;1041;2875;1514;4562
353090;202012;575;1709;445;1433;33;110;288;903;321;1013
353100;202012;289;772;135;423;25;84;38;95;63;179
353110;202012;7342;19362;5876;17261;1255;3791;2986;9122;4241;12913
353120;202012;379;935;278;771;40;134;134;322;174;456
353130;202012;2433;5666;1487;4024;375;1140;503;1213;878;2353
353140;202012;2667;6569;1917;5306;106;358;1358;3606;1464;3964
353150;202012;1569;3826;1104;3064;216;614;483;1277;699;1891
353160;202012;607;1556;439;1276;73;219;184;483;257;702
353170;202012;517;1373;383;1185;77;261;171;527;248;788
353180;202012;9594;23201;7561;20019;643;1884;5702;14698;6345;16582
353190;202012;3296;8822;2604;7433;330;999;1546;4150;1876;5149
353200;202012;1773;4678;938;2957;154;534;246;703;400;1237
353205;202012;363;1090;310;983;52;181;153;467;205;648
353210;202012;878;2032;562;1518;27;81;382;1010;409;1091
353215;202012;376;1033;293;885;43;143;142;396;185;539
353220;202012;713;1893;454;1356;93;265;75;212;168;477
353230;202012;831;2274;644;1977;179;604;254;713;433;1317
353240;202012;2291;6183;1868;5492;261;884;1122;3184;1383;4068
353250;202012;1282;2874;790;2054;101;302;460;1126;561;1428
353260;202012;1170;2674;637;1805;88;275;308;838;396;1113
353270;202012;664;1717;559;1527;49;149;387;992;436;1141
353280;202012;652;1743;454;1388;126;394;116;348;242;742
353282;202012;1758;4920;1472;4400;175;572;909;2569;1084;3141
353284;202012;343;777;181;477;19;71;83;185;102;256
353286;202012;171;423;102;308;14;46;35;98;49;144
353290;202012;1464;3846;907;2715;151;460;296;814;447;1274
353300;202012;1950;5166;1410;4107;234;775;645;1681;879;2456
353310;202012;387;943;277;741;22;79;186;464;208;543
353320;202012;634;1547;535;1413;7;31;468;1221;475;1252
353325;202012;650;1871;448;1435;95;294;159;493;254;787
353330;202012;522;1331;358;1029;43;128;200;532;243;660
353340;202012;2709;7358;1909;5753;377;1269;894;2493;1271;3762
353350;202012;3459;8759;2379;6630;524;1548;705;1756;1229;3304
353360;202012;640;1784;492;1502;51;160;290;862;341;1022
353370;202012;549;1582;456;1437;36;114;327;1000;363;1114
353380;202012;275;821;227;721;21;71;126;370;147;441
353390;202012;6177;15192;4615;12558;451;1397;2803;7197;3254;8594
353400;202012;447;1182;332;961;57;198;133;320;190;518
353410;202012;509;1373;377;1133;69;205;213;653;282;858
353420;202012;379;986;226;656;57;156;18;40;75;196
353430;202012;2160;5932;1654;4991;334;1085;764;2198;1098;3283
353440;202012;63406;169461;45920;135836;7210;23347;25244;70468;32454;93815
353450;202012;359;896;242;693;34;115;121;312;155;427
353460;202012;3142;8503;2244;6794;166;580;1024;2994;1190;3574
353470;202012;7579;19711;5385;15665;864;2914;2434;6458;3298;9372
353475;202012;1480;3828;1027;2902;154;474;526;1378;680;1852
353480;202012;1578;4197;1256;3647;52;191;897;2520;949;2711
353490;202012;1071;2821;709;2120;101;340;327;913;428;1253
353500;202012;1043;2445;768;2032;158;428;428;1119;586;1547
353510;202012;725;2175;525;1689;131;467;133;357;264;824
353520;202012;1025;2667;645;1973;76;259;307;877;383;1136
353530;202012;2349;6184;1827;5238;255;833;972;2569;1227;3402
353540;202012;2035;5438;1656;4831;266;815;982;2784;1248;3599
353550;202012;5659;14505;4568;12723;738;2147;2624;7034;3362;9181
353560;202012;2249;6023;1666;5101;447;1500;494;1354;941;2854
353570;202012;581;1494;426;1245;46;142;254;703;300;845
353580;202012;1999;5267;1502;4293;336;969;703;1969;1039;2938
353590;202012;674;1754;446;1327;87;275;194;571;281;846
353600;202012;1681;4139;1263;3413;152;407;697;1838;849;2245
353610;202012;565;1683;402;1348;83;343;121;367;204;710
353620;202012;2595;6876;1814;5529;357;1217;594;1663;951;2880
353625;202012;491;1206;328;918;22;74;210;567;232;641
353630;202012;1286;3932;1069;3445;234;845;397;1169;631;2014
353640;202012;1362;3520;1088;3093;155;436;598;1694;753;2130
353650;202012;7319;19332;5466;15854;573;1863;3369;9248;3942;11111
353657;202012;385;994;277;808;26;84;138;371;164;455
353660;202012;1268;2663;853;2107;393;972;196;471;589;1443
353670;202012;3952;10871;3016;9017;574;1932;1499;4148;2073;6080
353680;202012;671;1740;494;1487;72;247;283;790;355;1037
353690;202012;393;1017;177;547;21;66;36;98;57;164
353700;202012;2013;5235;1655;4634;114;371;1234;3311;1348;3682
353710;202012;5241;11655;3099;7865;330;872;1759;3988;2089;4860
353715;202012;406;1078;240;761;11;45;82;246;93;291
353720;202012;1952;5114;1504;4446;225;702;838;2441;1063;3143
353730;202012;4310;11171;3240;9288;469;1567;1722;4514;2191;6081
353740;202012;1953;5136;1353;4074;326;1070;458;1232;784;2302
353750;202012;826;2473;580;1981;137;521;108;356;245;877
353760;202012;12308;28431;9307;24366;1828;4893;5082;13087;6910;17980
353770;202012;730;2183;420;1405;75;274;55;161;130;435
353780;202012;5076;13987;4034;12006;833;2779;2020;5567;2853;8346
353790;202012;2600;7776;1864;6209;508;1887;400;1158;908;3045
353800;202012;17837;46228;13824;39701;1971;5980;7837;22417;9808;28397
353810;202012;1126;2990;718;2141;105;353;318;902;423;1255
353820;202012;1698;4528;1176;3482;248;796;394;1097;642;1893
353830;202012;614;1550;454;1277;79;235;201;542;280;777
353850;202012;1595;4394;1209;3657;247;739;457;1342;704;2081
353860;202012;2568;7012;1946;5942;451;1585;888;2443;1339;4028
353870;202012;28784;74875;20231;58164;2590;8389;10798;28324;13388;36713
353880;202012;3094;8463;2431;7203;208;719;1514;4317;1722;5036
353890;202012;2644;5644;1817;4497;124;344;1316;3059;1440;3403
353900;202012;725;2022;521;1610;80;276;211;603;291;879
353910;202012;2316;6373;1908;5731;195;685;1317;3874;1512;4559
353920;202012;1831;5029;1286;3953;300;1043;321;814;621;1857
353930;202012;4227;11143;2824;8506;477;1662;1205;3195;1682;4857
353940;202012;1026;2887;692;2225;118;401;253;752;371;1153
353950;202012;3153;8487;2406;7111;451;1448;1308;3624;1759;5072
353960;202012;695;1800;472;1367;88;265;210;583;298;848
353970;202012;635;1511;475;1270;44;132;326;847;370;979
353980;202012;16242;40553;12596;34193;791;2528;9244;23979;10035;26507
353990;202012;914;2212;544;1527;95;292;251;667;346;959
354000;202012;2378;5697;1322;3708;301;891;234;629;535;1520
354010;202012;342;892;239;723;48;157;127;366;175;523
354020;202012;3416;9286;2650;7693;595;1863;1113;2950;1708;4813
354025;202012;709;1972;469;1490;72;257;130;389;202;646
354030;202012;507;1112;276;726;66;186;130;320;196;506
354040;202012;787;1828;503;1358;23;76;376;982;399;1058
354050;202012;907;2555;625;2045;142;492;201;647;343;1139
354060;202012;3185;9005;2201;6924;477;1620;845;2450;1322;4070
354070;202012;3528;9190;2332;6852;404;1385;1046;2638;1450;4023
354075;202012;2591;7417;2021;6383;266;958;1162;3575;1428;4533
354080;202012;1339;3634;868;2701;183;588;234;670;417;1258
354085;202012;426;882;332;759;0;0;253;534;253;534
354090;202012;1632;4510;1395;4017;80;242;1090;3078;1170;3320
354100;202012;18883;50697;12817;40130;2794;9489;4903;15205;7697;24694
354105;202012;1414;3562;963;2736;125;357;454;1215;579;1572
354110;202012;442;1246;310;988;54;173;106;327;160;500
354120;202012;1316;3534;875;2587;178;580;306;796;484;1376
354130;202012;5240;13750;3418;10250;830;2628;197;397;1027;3025
354140;202012;18738;45848;12546;34374;2108;6411;5506;13848;7614;20259
354150;202012;2865;6774;2160;5649;480;1298;860;2223;1340;3521
354160;202012;2737;7918;2010;6466;569;1982;557;1616;1126;3598
354165;202012;662;1969;496;1628;79;299;257;786;336;1085
354170;202012;1793;4969;1502;4419;90;313;950;2672;1040;2985
354180;202012;371;1027;264;793;47;149;109;293;156;442
354190;202012;1442;4017;1007;3128;73;257;482;1421;555;1678
354200;202012;859;2074;661;1774;65;196;437;1106;502;1302
354210;202012;788;2054;624;1773;36;123;463;1243;499;1366
354220;202012;3068;8189;2296;6653;354;1100;1232;3377;1586;4477
354230;202012;744;1816;590;1633;43;146;436;1164;479;1310
354240;202012;1652;4559;1090;3412;188;641;344;943;532;1584
354250;202012;520;1243;318;927;88;261;77;239;165;500
354260;202012;7955;20993;6003;17553;1208;3803;2593;7264;3801;11067
354270;202012;981;2936;791;2560;175;555;314;999;489;1554
354280;202012;782;1951;661;1778;59;193;427;1058;486;1251
354290;202012;901;2843;758;2546;120;404;387;1334;507;1738
354300;202012;3492;10186;2942;9164;780;2424;1207;3731;1987;6155
354310;202012;718;2096;578;1802;131;438;227;661;358;1099
354320;202012;983;2379;637;1790;103;323;241;596;344;919
354323;202012;448;1074;299;805;36;78;138;365;174;443
354325;202012;1467;4367;1001;3269;163;525;342;1068;505;1593
354330;202012;9283;23350;6205;17091;736;2322;3697;9477;4433;11799
354340;202012;31978;79774;21388;61171;3234;10459;11397;31048;14631;41507
354350;202012;1160;2983;918;2580;101;299;607;1640;708;1939
354360;202012;591;1510;345;1103;66;212;77;246;143;458
354370;202012;980;2792;779;2467;123;420;462;1427;585;1847
354380;202012;685;1795;488;1471;89;359;123;279;212;638
354390;202012;13288;31900;8617;23671;1550;4564;3852;10005;5402;14569
354400;202012;1502;4788;1133;3907;195;740;423;1440;618;2180
354410;202012;5788;15468;4349;12589;890;2789;2006;5488;2896;8277
354420;202012;1450;3750;1058;3040;145;452;643;1765;788;2217
354425;202012;2634;6340;1839;4973;429;1152;805;2171;1234;3323
354430;202012;1465;3894;1132;3363;111;379;688;1927;799;2306
354440;202012;541;1444;355;1061;57;192;157;432;214;624
354450;202012;413;1075;227;717;37;116;74;206;111;322
354460;202012;833;2089;550;1588;74;230;299;840;373;1070
354470;202012;458;1161;302;853;21;68;154;382;175;450
354480;202012;1184;2676;764;2006;67;173;520;1316;587;1489
354490;202012;803;2366;580;1867;90;301;272;812;362;1113
354500;202012;2074;5757;1673;5137;520;1665;385;1214;905;2879
354510;202012;696;1935;555;1657;55;177;297;808;352;985
354515;202012;333;955;242;766;37;138;105;319;142;457
354520;202012;6811;18450;4743;14005;649;2221;2678;7332;3327;9553
354530;202012;4177;11816;3180;9835;766;2406;1208;3787;1974;6193
354540;202012;1300;3413;934;2760;214;672;349;1021;563;1693
354550;202012;541;1395;422;1169;63;198;244;644;307;842
354560;202012;2271;5445;1198;3364;149;431;604;1582;753;2013
354570;202012;1203;2996;480;1359;82;243;59;154;141;397
354580;202012;8212;21367;5258;15733;780;2551;2690;7716;3470;10267
354600;202012;1839;4841;1413;4046;146;500;943;2541;1089;3041
354610;202012;435;1110;245;724;24;70;118;331;142;401
354620;202012;442;1228;270;886;53;201;103;301;156;502
354625;202012;289;759;157;498;30;99;24;46;54;145
354630;202012;2012;5973;1601;5115;557;1881;296;865;853;2746
354640;202012;3178;9039;2315;7295;383;1331;906;2658;1289;3989
354650;202012;873;2254;695;1960;56;160;441;1219;497;1379
354660;202012;3554;8284;1822;5364;159;572;868;2336;1027;2908
354670;202012;1033;2865;692;2166;147;489;254;728;401;1217
354680;202012;5189;13431;3854;11249;876;2683;1893;5646;2769;8329
354690;202012;475;1501;338;1195;73;266;89;306;162;572
354700;202012;889;2383;635;1882;77;244;324;906;401;1150
354710;202012;471;1256;333;979;43;137;134;332;177;469
354720;202012;267;639;114;341;42;135;25;76;67;211
354730;202012;9372;26324;7057;21800;979;3333;4047;12017;5026;15350
354740;202012;306;820;127;418;17;67;24;70;41;137
354750;202012;2542;6479;1643;4798;257;822;747;1948;1004;2770
354760;202012;2079;5504;1421;4256;338;1111;472;1226;810;2337
354765;202012;339;890;136;429;22;73;32;84;54;157
354770;202012;2339;5776;1717;4687;314;928;808;2064;1122;2992
354780;202012;52736;133158;39636;107367;4070;12456;25407;64587;29477;77043
354790;202012;959;2635;736;2254;72;250;454;1328;526;1578
354800;202012;2508;6393;1952;5540;477;1363;885;2366;1362;3729
354805;202012;1302;2968;886;2359;97;265;533;1325;630;1590
354810;202012;625;1843;357;1263;45;187;87;289;132;476
354820;202012;931;2632;654;2103;118;428;188;477;306;905
354830;202012;458;1116;292;817;48;138;100;269;148;407
354840;202012;913;2247;550;1522;51;151;314;810;365;961
354850;202012;20600;53096;14156;41495;1590;5378;8538;23725;10128;29103
354860;202012;1716;4781;1027;3313;169;613;308;894;477;1507
354870;202012;56571;142473;43363;117962;4520;13551;27563;70925;32083;84476
354880;202012;5676;13831;2748;7645;319;1026;1124;2552;1443;3578
354890;202012;15596;38851;11949;32684;1596;4943;7151;18919;8747;23862
354900;202012;384;960;233;688;46;147;63;162;109;309
354910;202012;5454;14212;3234;10115;773;2558;565;1700;1338;4258
354920;202012;501;1365;256;858;28;100;57;174;85;274
354925;202012;297;836;178;561;20;70;50;136;70;206
354930;202012;358;859;229;638;18;57;115;293;133;350
354940;202012;2294;6795;1604;5250;561;1951;308;935;869;2886
354950;202012;1478;3795;1174;3374;61;244;879;2384;940;2628
354960;202012;910;2430;685;2087;53;191;403;1158;456;1349
354970;202012;4105;11278;3184;9719;331;1150;2105;6205;2436;7355
354980;202012;32413;76164;21606;57552;2248;7184;13437;33331;15685;40515
354990;202012;65222;163910;48766;133549;3873;12392;32453;83679;36326;96071
354995;202012;2807;6277;2102;5348;138;417;1579;3855;1717;4272
355000;202012;1534;3796;1141;3222;185;605;560;1452;745;2057
355010;202012;3701;9986;2200;6806;730;2326;262;849;992;3175
355020;202012;3598;10009;2634;8303;541;1874;1037;3097;1578;4971
355030;202012;1331709;3252133;953273;2519988;142179;413474;488957;1190756;631136;1604230
355040;202012;2904;7111;2232;6224;289;814;1593;4442;1882;5256
355050;202012;967;2248;694;1850;168;513;272;655;440;1168
355060;202012;5931;15925;4247;12774;701;2446;2088;5712;2789;8158
355070;202012;8657;22176;6950;19429;812;2587;4481;11816;5293;14403
355080;202012;895;2543;556;1897;108;398;79;220;187;618
355090;202012;1128;3214;852;2733;211;678;283;914;494;1592
355100;202012;21261;55308;16305;47898;2587;8028;9804;28586;12391;36614
355110;202012;789;2163;559;1803;166;616;97;280;263;896
355120;202012;688;1779;487;1484;41;140;218;619;259;759
355130;202012;829;1845;415;1093;24;81;261;640;285;721
355140;202012;1919;4328;1605;3893;94;259;1321;3108;1415;3367
355150;202012;4063;10700;3214;9193;353;1126;2097;5750;2450;6876
355160;202012;1965;5328;1393;4302;355;1201;347;1006;702;2207
355170;202012;10312;25837;7943;21802;1420;4232;4312;11452;5732;15684
355180;202012;2835;7533;1989;6105;402;1351;739;2079;1141;3430
355190;202012;1812;4785;1409;4138;342;986;742;2294;1084;3280
355200;202012;781;2419;654;2211;177;660;273;880;450;1540
355210;202012;2860;7765;2203;6400;412;1354;1126;3063;1538;4417
355220;202012;43068;113961;33692;95761;7605;22968;14351;37890;21956;60858
355230;202012;1118;2806;603;1785;104;294;219;605;323;899
355240;202012;24246;63784;16744;48616;2167;6864;9261;25295;11428;32159
355250;202012;36349;96708;26682;77774;6658;20490;10285;28655;16943;49145
355255;202012;656;1642;346;1066;56;194;133;398;189;592
355260;202012;1445;3516;1036;2830;130;442;598;1490;728;1932
355270;202012;1123;3321;850;2752;197;656;299;899;496;1555
355280;202012;30474;77215;21391;60035;2863;8737;10906;28650;13769;37387
355290;202012;846;2296;642;1932;131;384;276;807;407;1191
355300;202012;1235;3627;952;3046;167;594;331;989;498;1583
355310;202012;931;2574;691;2167;94;283;387;1231;481;1514
355320;202012;517;1359;383;1115;77;254;152;361;229;615
355330;202012;2868;7170;2173;5993;126;453;1664;4361;1790;4814
355340;202012;4074;8973;3111;7682;389;874;1925;4850;2314;5724
355350;202012;1273;3631;937;2980;196;651;359;1118;555;1769
355360;202012;1164;2961;881;2536;117;369;528;1487;645;1856
355365;202012;337;897;177;604;38;121;27;96;65;217
355370;202012;5212;13336;3982;11353;968;2577;1730;5435;2698;8012
355380;202012;2832;7531;2107;6172;367;1184;782;1975;1149;3159
355385;202012;1420;3719;1162;3328;104;366;746;1949;850;2315
355390;202012;817;2211;585;1702;132;411;234;623;366;1034
355395;202012;1940;5307;1321;4040;224;730;476;1296;700;2026
355400;202012;8786;24951;6895;21196;1660;5842;2523;6923;4183;12765
355410;202012;21777;59405;13245;41738;2698;9332;3628;11127;6326;20459
355420;202012;600;1907;490;1695;138;520;123;411;261;931
355430;202012;3672;9263;2741;7575;605;1672;1314;3573;1919;5245
355440;202012;764;2073;455;1418;74;238;137;410;211;648
355450;202012;2919;7461;1873;5406;330;1026;797;2091;1127;3117
355460;202012;487;1174;300;864;43;153;137;353;180;506
355465;202012;411;1070;318;917;45;144;172;479;217;623
355470;202012;1034;2661;585;1763;156;529;184;485;340;1014
355475;202012;338;805;267;702;16;35;199;515;215;550
355480;202012;3811;10469;3081;9376;403;1417;2059;6119;2462;7536
355490;202012;924;2453;510;1570;40;134;275;787;315;921
355495;202012;793;2219;569;1816;71;273;211;591;282;864
355500;202012;6424;16512;3753;11270;587;1952;1306;3620;1893;5572
355510;202012;1307;3179;815;2322;111;371;348;883;459;1254
355520;202012;354;779;161;468;29;78;48;136;77;214
355530;202012;391;903;137;400;19;64;48;124;67;188
355535;202012;493;1335;368;1129;74;279;169;468;243;747
355540;202012;10615;26332;8632;23510;1242;3689;5737;15118;6979;18807
355550;202012;584;1713;476;1513;63;228;259;760;322;988
355560;202012;1096;2783;597;1841;128;466;32;97;160;563
355570;202012;240;678;125;412;24;81;31;97;55;178
355580;202012;1171;2849;740;2110;138;438;295;784;433;1222
355590;202012;170;425;132;365;20;61;80;211;100;272
355600;202012;1473;3569;968;2724;160;480;378;1054;538;1534
355610;202012;1727;4234;1129;3191;128;395;607;1635;735;2030
355620;202012;4605;12189;3392;9805;371;1301;1942;5172;2313;6473
355630;202012;2258;6200;1578;4908;253;825;788;2403;1041;3228
355635;202012;846;2479;607;1998;108;393;178;521;286;914
355640;202012;2915;8094;1912;6056;364;1250;583;1796;947;3046
355645;202012;4114;11506;2981;9512;434;1534;1610;4988;2044;6522
355650;202012;6135;16571;4690;13867;1285;3919;1423;3802;2708;7721
355660;202012;1293;3330;898;2614;132;414;311;896;443;1310
355670;202012;3559;9478;2322;6690;286;971;1164;2925;1450;3896
355680;202012;2636;7193;1139;3685;302;1030;115;402;417;1432
355690;202012;776;2287;488;1696;122;458;17;40;139;498
355695;202012;239;672;143;459;12;60;28;63;40;123
355700;202012;7163;20361;5773;17253;946;3041;3158;8867;4104;11908
355710;202012;8686;20422;5620;14830;827;2458;2683;6304;3510;8762
355715;202012;453;1207;235;721;51;167;49;131;100;298
355720;202012;1442;4012;1131;3466;184;611;615;1757;799;2368
355730;202012;878;2415;713;2102;119;388;344;933;463;1321
410010;202012;1244;3454;942;2812;192;619;212;609;404;1228
410020;202012;1018;3065;774;2503;279;853;166;564;445;1417
410030;202012;1509;4128;1287;3782;172;548;718;2131;890;2679
410040;202012;12095;33287;8719;26850;1917;6307;2799;8002;4716;14309
410045;202012;856;2265;600;1772;86;287;218;595;304;882
410050;202012;2231;5574;1530;4339;286;889;518;1382;804;2271
410060;202012;2042;5748;1567;4790;353;1150;488;1441;841;2591
410070;202012;1933;4872;1433;3959;234;715;568;1431;802;2146
410080;202012;1317;3518;937;2806;237;735;252;770;489;1505
410090;202012;1088;2792;920;2519;93;245;545;1563;638;1808
410100;202012;1725;4976;1110;3480;170;607;148;445;318;1052
410105;202012;480;1207;270;796;31;93;99;275;130;368
410110;202012;3206;8019;2222;6137;266;815;1058;2713;1324;3528
410115;202012;565;1457;410;1182;58;179;160;438;218;617
410120;202012;2531;7098;2183;6567;480;1595;1129;3282;1609;4877
410130;202012;1220;3271;1059;2968;192;626;562;1455;754;2081
410140;202012;15645;37753;10071;27706;1867;5641;2697;6755;4564;12396
410150;202012;16228;37938;8058;21929;1389;4198;1984;4880;3373;9078
410160;202012;2761;7631;2200;6645;504;1645;742;2270;1246;3915
410165;202012;736;1968;604;1698;56;191;361;948;417;1139
410170;202012;2750;7123;1830;5135;412;1278;117;350;529;1628
410180;202012;13739;37952;10435;31226;1415;4648;5540;15492;6955;20140
410185;202012;407;1195;290;889;56;181;88;249;144;430
410190;202012;2132;5285;1515;4182;315;889;414;1099;729;1988
410200;202012;5312;12173;2923;8067;456;1437;427;1141;883;2578
410210;202012;3053;7602;1885;5489;295;971;663;1664;958;2635
410220;202012;514;1329;332;986;60;188;81;236;141;424
410230;202012;1672;4426;1270;3627;184;576;629;1677;813;2253
410240;202012;4996;13105;3400;10015;797;2598;352;937;1149;3535
410250;202012;2646;6262;1948;5134;152;507;940;2401;1092;2908
410260;202012;1718;4320;1060;3061;175;522;473;1349;648;1871
410270;202012;451;1200;321;967;47;164;117;336;164;500
410275;202012;607;1726;446;1405;68;236;190;556;258;792
410280;202012;2256;5999;1471;4399;213;713;596;1643;809;2356
410290;202012;3308;9237;2231;6927;617;1876;575;1801;1192;3677
410300;202012;624;1590;496;1385;42;131;257;677;299;808
410302;202012;351;879;198;593;24;80;97;281;121;361
410304;202012;1239;3206;1020;2792;116;329;621;1646;737;1975
410305;202012;1718;4088;1191;3327;121;390;766;2049;887;2439
410310;202012;2478;6962;1968;5978;304;1018;986;2950;1290;3968
410315;202012;610;1463;365;1066;129;378;88;271;217;649
410320;202012;1065;2955;715;2228;114;395;126;367;240;762
410322;202012;547;1423;308;895;31;106;161;426;192;532
410330;202012;1489;3619;1027;2756;164;478;297;785;461;1263
410335;202012;856;2274;649;1884;97;300;284;770;381;1070
410337;202012;837;2029;583;1537;62;168;247;622;309;790
410340;202012;499;1416;333;1003;23;76;167;429;190;505
410345;202012;2410;6223;1239;3655;252;779;331;840;583;1619
410347;202012;738;1867;540;1490;53;169;179;502;232;671
410350;202012;1492;3698;1044;2932;152;453;442;1175;594;1628
410360;202012;4278;10468;3283;8720;432;1232;1669;4274;2101;5506
410370;202012;13254;35313;8541;24244;1007;3123;3663;9197;4670;12320
410380;202012;1575;3954;1156;3197;162;449;386;989;548;1438
410390;202012;2600;6560;1695;4915;386;1251;533;1398;919;2649
410395;202012;909;2586;740;2229;160;503;283;858;443;1361
410400;202012;6406;16665;4768;13486;668;2020;2448;6511;3116;8531
410405;202012;867;2045;614;1666;105;325;278;708;383;1033
410410;202012;1253;3333;1170;3201;161;518;733;2073;894;2591
410420;202012;10408;28299;7862;23218;1212;4024;3301;8765;4513;12789
410425;202012;3157;8768;2124;6628;354;1202;770;2157;1124;3359
410430;202012;12829;32025;8906;24809;1372;4194;3246;8428;4618;12622
410440;202012;2223;6644;1895;6025;273;988;1017;3177;1290;4165
410442;202012;2156;6549;1753;5667;440;1449;471;1424;911;2873
410445;202012;2205;6370;1599;5181;309;1162;312;1060;621;2222
410450;202012;1403;3467;1024;2853;198;620;383;997;581;1617
410460;202012;2067;5101;1565;4279;165;464;782;2064;947;2528
410465;202012;2656;7648;2080;6558;380;1260;742;2190;1122;3450
410470;202012;1933;5332;1350;4252;349;1259;211;721;560;1980
410480;202012;35696;84784;18849;54598;2999;9718;4244;10587;7243;20305
410490;202012;10784;29897;7753;23604;1417;4664;3164;9027;4581;13691
410500;202012;1850;4771;1289;3701;263;863;394;1001;657;1864
410510;202012;1764;4413;1160;3272;230;632;326;921;556;1553
410520;202012;2984;9389;2639;8688;925;3114;889;3021;1814;6135
410530;202012;1601;3878;756;2123;98;280;201;463;299;743
410540;202012;2743;7331;1882;5583;296;971;853;2414;1149;3385
410550;202012;7228;19225;4723;13714;776;2468;1333;3332;2109;5800
410560;202012;1435;3768;1056;2977;228;712;370;924;598;1636
410570;202012;2425;6611;1747;5398;477;1752;199;641;676;2393
410580;202012;24652;63649;17591;50625;3308;10248;7611;20496;10919;30744
410590;202012;1542;4362;1018;3115;145;463;289;746;434;1209
410600;202012;1747;4642;1350;3873;300;827;439;1319;739;2146
410610;202012;698;1808;526;1489;57;192;236;620;293;812
410620;202012;2415;6934;1619;5045;351;1214;241;700;592;1914
410630;202012;2393;6258;1556;4568;291;984;323;806;614;1790
410640;202012;4644;10781;3115;8126;676;2049;387;1021;1063;3070
410645;202012;1051;2964;852;2703;268;889;364;1166;632;2055
410650;202012;2263;6107;1543;4643;311;993;535;1492;846;2485
410655;202012;906;2154;635;1674;27;80;328;819;355;899
410657;202012;612;1647;376;1135;52;180;131;337;183;517
410660;202012;3270;8346;1857;5247;337;989;530;1385;867;2374
410670;202012;1016;2522;613;1742;117;339;227;585;344;924
410680;202012;2574;7712;1767;5658;421;1378;299;987;720;2365
410685;202012;502;1284;373;1063;87;289;147;372;234;661
410690;202012;127861;309469;84081;228306;12962;40356;33404;80061;46366;120417
410700;202012;2458;6182;2025;5500;318;882;1011;2684;1329;3566
410710;202012;873;2190;569;1618;103;303;217;565;320;868
410712;202012;629;1780;514;1560;127;432;202;578;329;1010
410715;202012;767;2217;477;1576;64;233;177;550;241;783
410720;202012;3054;7750;2401;6495;341;1084;539;1435;880;2519
410725;202012;1082;2680;610;1780;116;370;86;213;202;583
410730;202012;670;1770;514;1481;118;392;103;295;221;687
410740;202012;922;2575;670;2077;83;288;271;822;354;1110
410750;202012;1701;4286;1348;3632;187;569;628;1610;815;2179
410752;202012;354;878;183;542;26;77;84;239;110;316
410753;202012;301;920;203;694;37;146;42;125;79;271
410754;202012;1039;2685;862;2423;56;123;595;1770;651;1893
410755;202012;539;1400;378;1080;54;169;168;430;222;599
410760;202012;3598;9217;2578;7376;662;2176;569;1495;1231;3671
410765;202012;13291;36823;10233;30750;1739;5677;2343;6270;4082;11947
410770;202012;1053;2489;740;1959;69;190;381;1026;450;1216
410773;202012;1245;3322;1088;3082;105;339;695;1906;800;2245
410775;202012;1463;3629;1276;3353;62;193;859;2204;921;2397
410780;202012;629;1547;418;1142;63;181;112;278;175;459
410785;202012;687;1810;527;1539;90;290;189;571;279;861
410790;202012;772;2164;621;1864;159;520;62;138;221;658
410800;202012;3365;7465;2733;6558;54;166;1789;4166;1843;4332
410810;202012;417;1112;326;933;21;67;173;446;194;513
410820;202012;883;2483;445;1361;93;297;81;203;174;500
410830;202012;37079;89490;25454;69982;4828;15338;9777;25042;14605;40380
410832;202012;1017;2638;810;2270;92;288;483;1269;575;1557
410840;202012;8333;21021;4868;14316;920;2946;1262;3476;2182;6422
410845;202012;1130;2807;881;2438;174;504;362;986;536;1490
410850;202012;2182;6285;1899;5756;301;992;946;2780;1247;3772
410855;202012;769;1916;503;1406;48;128;239;620;287;748
410860;202012;4169;10193;3256;8727;317;994;1875;4738;2192;5732
410865;202012;1395;4056;1199;3668;140;473;705;2191;845;2664
410870;202012;1222;3308;1006;2939;82;262;674;1955;756;2217
410880;202012;4510;12030;3158;9532;534;1674;469;1519;1003;3193
410890;202012;949;2693;701;2198;153;535;178;541;331;1076
410895;202012;973;3081;824;2752;245;910;188;588;433;1498
410900;202012;827;2196;574;1692;97;307;119;289;216;596
410910;202012;392;936;234;631;13;47;135;324;148;371
410920;202012;837;2000;594;1598;77;231;304;792;381;1023
410930;202012;1631;4168;1113;3253;262;898;219;617;481;1515
410940;202012;21879;59383;15667;48126;3202;10902;4925;14800;8127;25702
410950;202012;1869;5475;1667;5161;50;190;1381;4223;1431;4413
410960;202012;7356;18215;5041;14293;1150;3610;1973;5534;3123;9144
410965;202012;1098;2799;761;2161;79;245;436;1221;515;1466
410970;202012;3916;10432;2748;8177;623;2209;373;920;996;3129
410975;202012;1312;3250;998;2746;111;335;491;1329;602;1664
410980;202012;7457;18501;4744;13556;537;1679;2068;5371;2605;7050
410990;202012;1347;3284;916;2601;212;709;314;861;526;1570
411000;202012;629;1641;412;1227;62;216;117;285;179;501
411005;202012;449;1148;270;767;46;149;85;207;131;356
411007;202012;2196;6136;1777;5413;421;1357;634;1917;1055;3274
411010;202012;4068;12158;3171;10303;800;2847;344;1010;1144;3857
411020;202012;2289;6433;1832;5602;514;1628;499;1487;1013;3115
411030;202012;759;1858;540;1419;35;128;307;702;342;830
411040;202012;964;2394;501;1379;67;214;163;382;230;596
411050;202012;1896;5897;1530;5074;392;1413;223;643;615;2056
411060;202012;1906;5035;1199;3550;260;903;203;540;463;1443
411065;202012;386;987;261;746;34;99;118;319;152;418
411070;202012;7154;18171;5609;15562;754;2345;2775;7425;3529;9770
411080;202012;2059;5398;1623;4645;415;1366;320;888;735;2254
411090;202012;814;2139;536;1594;44;151;157;443;201;594
411095;202012;2751;6352;1418;3851;169;481;365;893;534;1374
411100;202012;1190;3056;828;2414;87;287;274;819;361;1106
411110;202012;603;1572;277;871;37;119;17;41;54;160
411120;202012;1262;3461;1043;3040;311;1057;226;596;537;1653
411125;202012;5024;14617;4493;13671;990;2967;2174;6964;3164;9931
411130;202012;709;1887;502;1497;106;282;175;573;281;855
411140;202012;2224;6852;1894;6154;558;1951;496;1586;1054;3537
411150;202012;3707;9371;2465;6883;500;1637;247;501;747;2138
411155;202012;948;2417;554;1665;81;226;229;655;310;881
411160;202012;353;817;240;653;29;85;57;160;86;245
411170;202012;709;2092;555;1743;139;434;186;575;325;1009
411180;202012;5350;14128;4133;11966;607;1954;2022;5465;2629;7419
411190;202012;1668;4257;1234;3478;205;618;490;1251;695;1869
411200;202012;4713;12774;3305;10106;821;2804;660;1729;1481;4533
411210;202012;3160;7007;2074;5226;353;996;712;1687;1065;2683
411220;202012;852;2188;587;1666;140;442;161;425;301;867
411230;202012;829;2202;592;1744;119;379;222;630;341;1009
411240;202012;1549;3692;1033;2756;110;340;504;1234;614;1574
411250;202012;2183;5779;1575;4666;304;1040;491;1408;795;2448
411260;202012;319;832;214;619;25;75;89;228;114;303
411270;202012;2014;5351;1480;4261;208;639;748;1967;956;2606
411275;202012;1416;3244;983;2534;138;428;463;1103;601;1531
411280;202012;1255;3385;834;2570;222;709;119;344;341;1053
411290;202012;811;2133;516;1549;52;143;275;845;327;988
411295;202012;1239;3104;870;2375;104;309;384;974;488;1283
411300;202012;1003;2502;637;1786;60;180;302;731;362;911
411310;202012;863;1976;652;1677;55;142;282;721;337;863
411320;202012;5375;13776;3880;11063;612;1866;1707;4401;2319;6267
411325;202012;1322;3803;1123;3461;182;545;643;2058;825;2603
411330;202012;3272;8820;2351;7124;519;1697;738;2273;1257;3970
411340;202012;824;2244;486;1490;73;240;152;442;225;682
411342;202012;1032;2477;598;1630;100;297;221;560;321;857
411345;202012;1048;2692;784;2250;53;165;570;1646;623;1811
411350;202012;2647;7124;1683;5146;429;1410;268;760;697;2170
411360;202012;698;1670;488;1333;70;198;160;419;230;617
411370;202012;56869;138664;40910;111407;2895;9467;24777;62920;27672;72387
411373;202012;1355;3431;1099;3044;97;326;596;1658;693;1984
411375;202012;1084;2716;786;2153;128;358;308;824;436;1182
411380;202012;1132;2582;760;1898;40;113;481;1116;521;1229
411390;202012;1461;4036;1144;3333;187;601;483;1243;670;1844
411400;202012;2245;5525;1668;4428;161;511;868;2180;1029;2691
411410;202012;2545;6968;1850;5467;399;1289;436;1214;835;2503
411420;202012;4243;10279;2226;6373;297;960;425;938;722;1898
411430;202012;3367;9105;2541;7528;524;1680;909;2492;1433;4172
411435;202012;399;1114;245;786;50;160;75;198;125;358
411440;202012;2433;6782;1975;5920;404;1300;704;2056;1108;3356
411450;202012;2400;6492;1807;5488;237;720;969;3005;1206;3725
411460;202012;4106;10520;2571;7592;415;1447;479;1264;894;2711
411470;202012;752;1916;555;1534;106;314;209;516;315;830
411480;202012;4814;12678;3507;10234;679;2383;1317;3411;1996;5794
411490;202012;1610;4160;1227;3516;163;546;510;1310;673;1856
411500;202012;1273;3405;846;2491;153;483;162;388;315;871
411510;202012;2272;5775;1818;4993;387;1234;446;1234;833;2468
411520;202012;29624;71655;16899;46991;1958;6388;6638;16602;8596;22990
411530;202012;912;2391;536;1646;80;276;92;257;172;533
411535;202012;487;1400;298;950;35;127;86;223;121;350
411540;202012;2597;6334;1767;4824;155;491;911;2407;1066;2898
411545;202012;891;2563;748;2313;73;230;484;1496;557;1726
411550;202012;708;1779;511;1412;75;223;86;259;161;482
411560;202012;1922;5185;1075;3346;158;556;64;177;222;733
411570;202012;7174;16548;4769;12878;1068;3157;860;2344;1928;5501
411573;202012;739;2006;626;1823;99;293;314;901;413;1194
411575;202012;1987;5399;1464;4308;274;890;358;1017;632;1907
411580;202012;4710;10749;2812;7828;417;1421;502;1265;919;2686
411585;202012;592;1790;269;885;65;234;49;144;114;378
411590;202012;374;1022;267;804;41;122;131;369;172;491
411600;202012;300;759;191;588;39;122;58;166;97;288
411605;202012;1532;3527;983;2664;140;479;504;1329;644;1808
411610;202012;2493;5875;1758;4600;70;234;1193;2907;1263;3141
411620;202012;2696;7208;2293;6566;388;1171;1246;3565;1634;4736
411630;202012;742;1943;494;1464;75;273;186;496;261;769
411640;202012;453;1162;313;869;40;125;111;273;151;398
411650;202012;200;584;125;414;24;85;29;72;53;157
411660;202012;914;2332;666;1871;52;149;280;743;332;892
411670;202012;1336;3224;903;2398;98;276;444;1098;542;1374
411680;202012;1380;3710;1020;2992;135;455;452;1278;587;1733
411690;202012;3795;9601;2853;7977;620;1760;807;2408;1427;4168
411695;202012;617;1872;410;1332;46;166;177;532;223;698
411700;202012;1664;4265;1100;3181;230;715;187;512;417;1227
411705;202012;1875;5757;1584;5261;284;911;948;3335;1232;4246
411710;202012;1920;4833;1309;3702;298;853;267;746;565;1599
411720;202012;1011;2310;725;1832;145;373;268;649;413;1022
411721;202012;971;2416;727;1971;145;379;211;566;356;945
411722;202012;837;2173;480;1377;81;264;188;445;269;709
411725;202012;1150;3205;783;2486;189;650;175;549;364;1199
411727;202012;1479;4065;944;2904;216;685;149;419;365;1104
411729;202012;674;1633;419;1153;53;194;159;383;212;577
411730;202012;5163;13677;4010;11421;794;2428;1766;4930;2560;7358
411740;202012;519;1342;265;792;53;143;61;165;114;308
411745;202012;757;2162;512;1594;71;238;101;248;172;486
411750;202012;5327;13971;3864;11100;531;1639;1902;5157;2433;6796
411760;202012;6382;17034;4872;14393;1586;4895;945;3137;2531;8032
411770;202012;2977;8594;2142;6731;493;1657;348;1001;841;2658
411780;202012;2609;7364;2249;6685;633;1967;768;2315;1401;4282
411790;202012;2693;6481;1477;4295;293;1003;284;714;577;1717
411800;202012;975;2747;730;2194;129;408;147;418;276;826
411810;202012;1562;4010;1146;3162;187;525;537;1397;724;1922
411820;202012;10710;30621;8635;26975;2074;7015;3759;11423;5833;18438
411830;202012;557;1399;426;1182;79;240;98;287;177;527
411840;202012;11857;31482;7961;23355;1351;4278;2156;5765;3507;10043
411845;202012;555;1572;313;992;43;161;72;193;115;354
411850;202012;7021;17875;4729;13825;1160;3858;764;2041;1924;5899
411860;202012;664;1847;476;1448;73;230;121;333;194;563
411870;202012;569;1666;389;1253;91;329;95;272;186;601
411880;202012;2227;5527;1614;4529;220;705;579;1541;799;2246
411885;202012;1057;2740;750;2181;113;390;231;611;344;1001
411890;202012;1340;3545;943;2807;152;515;102;297;254;812
411900;202012;747;2056;468;1459;110;370;76;213;186;583
411910;202012;935;2752;680;2206;156;591;265;783;421;1374
411915;202012;14476;35558;9746;26860;1388;4303;4079;10048;5467;14351
411920;202012;1082;3164;903;2771;193;691;332;938;525;1629
411925;202012;457;1205;323;961;69;229;127;360;196;589
411930;202012;4822;14649;4049;13209;1770;6271;272;1082;2042;7353
411940;202012;3209;9434;2455;7772;601;1983;793;2268;1394;4251
411950;202012;13839;37168;11354;33031;1495;4944;6791;18922;8286;23866
411960;202012;5805;15548;4569;13015;837;2618;1776;4813;2613;7431
411965;202012;457;1254;324;986;43;142;147;422;190;564
411970;202012;1085;2500;835;2165;167;413;365;1071;532;1484
411980;202012;1436;3545;1026;2864;251;700;384;1063;635;1763
411990;202012;36917;96179;23260;70896;4275;14368;8137;23638;12412;38006
411995;202012;3366;8194;2522;6890;741;2262;684;1798;1425;4060
412000;202012;1824;4243;1284;3311;33;107;905;2187;938;2294
412010;202012;583;1811;429;1472;72;262;128;385;200;647
412015;202012;530;1487;433;1313;61;199;261;784;322;983
412020;202012;433;1202;269;847;44;160;106;298;150;458
412030;202012;589;1652;429;1352;73;238;128;390;201;628
412033;202012;926;2444;662;1902;82;252;257;642;339;894
412035;202012;744;2024;469;1504;47;182;263;809;310;991
412040;202012;583;1560;352;1075;56;163;57;171;113;334
412050;202012;1591;3960;1079;3005;226;707;262;726;488;1433
412060;202012;7139;20718;5924;18268;1543;5379;1691;5011;3234;10390
412065;202012;596;1639;443;1335;100;321;104;309;204;630
412070;202012;1168;3014;920;2535;114;346;377;957;491;1303
412080;202012;2125;5930;1421;4480;211;706;365;1041;576;1747
412085;202012;292;697;101;308;10;31;21;54;31;85
412090;202012;5627;14675;4153;11889;1050;3167;1522;4388;2572;7555
412100;202012;1577;4304;1190;3572;365;1199;252;834;617;2033
412110;202012;806;2124;549;1596;79;239;178;482;257;721
412120;202012;1931;5547;1467;4625;297;1028;394;1071;691;2099
412125;202012;611;1740;425;1354;83;273;115;350;198;623
412130;202012;813;2045;554;1557;90;269;140;401;230;670
412135;202012;626;1669;285;862;50;163;86;223;136;386
412140;202012;1621;3909;1063;2937;185;640;214;557;399;1197
412150;202012;2719;7086;2311;6375;337;1071;1413;3680;1750;4751
412160;202012;881;2731;488;1657;80;296;75;222;155;518
412170;202012;4222;11525;3532;10413;713;2320;1452;3937;2165;6257
412175;202012;1283;3636;1071;3271;221;698;477;1449;698;2147
412180;202012;1594;4388;1158;3563;142;502;531;1516;673;2018
412190;202012;3289;8241;2426;6729;324;982;1048;2880;1372;3862
412200;202012;1637;4840;1168;3760;310;1110;188;558;498;1668
412210;202012;613;1453;376;1041;48;148;148;369;196;517
412215;202012;3248;8818;2543;7428;623;1767;1092;3517;1715;5284
412217;202012;964;2495;813;2224;54;163;561;1484;615;1647
412220;202012;5483;15302;4443;13381;1289;3761;1402;4570;2691;8331
412230;202012;2609;7628;2048;6518;334;1209;533;1453;867;2662
412240;202012;7123;18261;4446;12900;763;2380;1339;3511;2102;5891
412250;202012;1983;5102;1468;4114;349;1039;317;811;666;1850
412260;202012;1187;3190;858;2479;136;407;264;725;400;1132
412265;202012;880;2393;692;2063;148;460;280;800;428;1260
412270;202012;976;2662;617;1901;84;285;239;663;323;948
412280;202012;376;1056;293;916;63;202;89;259;152;461
412290;202012;1008;2562;695;1992;109;338;225;594;334;932
412300;202012;1629;4203;1113;3282;244;759;248;764;492;1523
412310;202012;738;2061;588;1759;100;356;211;578;311;934
412320;202012;812;2080;522;1486;52;174;163;467;215;641
412330;202012;1561;4171;1059;3207;211;700;346;1073;557;1773
412340;202012;1108;3038;696;2141;102;384;124;336;226;720
412350;202012;2777;7179;1758;5167;346;1087;306;832;652;1919
412360;202012;257;704;181;537;6;31;113;313;119;344
412370;202012;839;2405;566;1816;116;413;57;193;173;606
412380;202012;1466;3983;1027;3095;268;832;126;444;394;1276
412382;202012;474;1171;310;906;39;146;138;337;177;483
412385;202012;2153;5865;1755;5092;562;1536;552;1799;1114;3335
412390;202012;2423;5790;1940;5042;321;837;707;1844;1028;2681
412395;202012;640;1842;449;1407;53;144;196;632;249;776
412400;202012;902;2385;639;1881;122;396;176;508;298;904
412402;202012;2066;5064;1421;3989;352;1023;178;515;530;1538
412405;202012;2949;7769;1912;5806;496;1767;95;256;591;2023
412410;202012;5947;15306;4383;12743;760;2582;1498;4099;2258;6681
412420;202012;523;1324;347;973;24;82;173;427;197;509
412430;202012;588;1471;304;877;35;112;122;329;157;441
412440;202012;2641;7190;1730;5396;418;1433;262;869;680;2302
412450;202012;452;1298;304;925;46;134;28;67;74;201
412460;202012;1020;2636;782;2233;141;441;359;1004;500;1445
412470;202012;1479;4718;1204;4088;306;1091;259;877;565;1968
412480;202012;1011;2668;678;1944;117;359;219;555;336;914
412490;202012;1280;3151;1022;2673;123;322;511;1260;634;1582
412500;202012;1889;4761;1425;3893;312;866;378;958;690;1824
412510;202012;1822;5558;1250;4093;287;1014;133;362;420;1376
412520;202012;1140;2986;629;1868;151;429;59;194;210;623
412530;202012;692;1822;501;1430;75;236;101;287;176;523
412535;202012;771;1982;509;1471;88;276;112;271;200;547
412540;202012;1166;2956;836;2354;94;331;277;819;371;1150
412545;202012;662;1699;462;1296;68;190;169;466;237;656
412550;202012;31898;84813;22401;65538;3629;11591;9207;24518;12836;36109
412555;202012;286;743;192;541;21;62;58;130;79;192
412560;202012;4396;12787;3252;10105;585;1987;958;3005;1543;4992
412570;202012;4367;10973;2491;7325;518;1708;313;1000;831;2708
412575;202012;1021;2562;813;2201;106;317;437;1103;543;1420
412580;202012;1391;3619;981;2825;80;279;532;1464;612;1743
412590;202012;399;1041;221;680;34;110;22;58;56;168
412600;202012;1593;4283;1200;3483;173;572;558;1499;731;2071
412610;202012;794;2080;555;1558;55;164;284;709;339;873
412620;202012;1255;3289;952;2820;189;645;278;762;467;1407
412625;202012;8442;22110;5020;15213;705;2422;332;912;1037;3334
412627;202012;1138;3187;737;2349;135;471;198;630;333;1101
412630;202012;2787;8139;1990;6402;377;1248;588;1726;965;2974
412635;202012;381;1041;261;776;34;123;91;222;125;345
412640;202012;1033;2709;582;1762;68;209;183;504;251;713
412650;202012;1646;4464;1308;3767;212;679;521;1313;733;1992
412660;202012;2362;6050;1647;4666;272;814;497;1276;769;2090
412665;202012;379;969;301;829;48;141;153;407;201;548
412667;202012;1734;4545;1283;3664;180;559;537;1459;717;2018
412670;202012;833;1948;540;1471;103;315;159;402;262;717
412680;202012;1968;5207;1360;4029;177;611;503;1317;680;1928
412690;202012;1116;2942;794;2307;131;414;305;836;436;1250
412700;202012;1909;5059;1583;4545;189;634;871;2434;1060;3068
412710;202012;5761;16695;4267;13424;828;2958;1235;3417;2063;6375
412720;202012;1114;3289;847;2692;141;480;173;469;314;949
412730;202012;2379;6308;1652;4824;314;1027;578;1587;892;2614
412740;202012;1831;5062;1232;3822;216;784;176;529;392;1313
412750;202012;3778;9916;3084;8918;288;1008;2047;5580;2335;6588
412760;202012;2848;7707;2359;6875;437;1434;1241;3384;1678;4818
412770;202012;9879;24942;5186;15598;717;2307;1249;3221;1966;5528
412780;202012;1134;3028;851;2499;188;600;329;940;517;1540
412785;202012;2017;4834;1416;3818;129;361;967;2539;1096;2900
412788;202012;1306;3643;1064;3216;288;874;450;1337;738;2211
412790;202012;1321;3487;743;2291;112;399;230;616;342;1015
412795;202012;1231;3149;652;1974;95;312;132;357;227;669
412796;202012;2116;6064;1735;5334;360;1166;579;1652;939;2818
412800;202012;3606;8728;2475;6636;281;879;1158;2748;1439;3627
412810;202012;11474;29062;7324;20623;869;2872;2909;7287;3778;10159
412820;202012;6057;16591;4242;12885;1033;3322;1236;3772;2269;7094
412830;202012;329;930;233;716;34;100;59;173;93;273
412840;202012;1833;4537;1300;3489;145;442;586;1435;731;1877
412850;202012;2726;7136;1959;5776;318;1003;828;2415;1146;3418
412853;202012;1437;3629;1195;3197;181;532;607;1446;788;1978
412855;202012;1180;3085;764;2224;124;424;221;606;345;1030
412860;202012;733;1805;496;1430;69;220;274;749;343;969
412862;202012;675;1653;455;1279;82;235;194;512;276;747
412863;202012;1238;3722;1100;3467;234;770;573;1790;807;2560
412865;202012;694;1889;503;1493;142;420;126;406;268;826
412870;202012;818;2110;586;1718;164;536;125;403;289;939
412880;202012;828;2211;540;1616;86;292;97;254;183;546
420005;202012;387;1131;237;800;33;110;111;380;144;490
420010;202012;3177;7769;2110;5965;129;406;1555;4420;1684;4826
420020;202012;388;1218;251;863;40;163;59;164;99;327
420030;202012;63;205;44;168;12;53;18;60;30;113
420040;202012;486;1463;290;1018;59;230;19;49;78;279
420050;202012;706;1602;470;1184;68;201;299;679;367;880
420055;202012;152;458;80;285;15;70;22;66;37;136
420060;202012;92;243;49;140;8;25;13;29;21;54
420070;202012;650;1958;487;1621;102;357;199;637;301;994
420075;202012;76;187;41;116;5;17;15;25;20;42
420080;202012;340;972;266;806;71;241;108;322;179;563
420090;202012;398;1231;247;865;53;200;43;121;96;321
420100;202012;1210;3163;1009;2854;46;161;824;2294;870;2455
420110;202012;230;736;209;692;40;160;106;325;146;485
420120;202012;546;1469;357;1049;64;213;172;432;236;645
420125;202012;326;1002;225;773;58;206;87;291;145;497
420127;202012;265;704;93;296;13;49;25;71;38;120
420130;202012;3155;8685;2382;7370;343;1277;1163;3288;1506;4565
420140;202012;3353;9027;2361;7281;676;2344;330;1058;1006;3402
420150;202012;659;1646;453;1293;39;128;280;772;319;900
420160;202012;189;460;68;223;8;28;20;65;28;93
420165;202012;148;417;82;266;20;68;26;75;46;143
420170;202012;258;824;175;604;24;79;55;158;79;237
420180;202012;160;513;97;347;15;54;31;97;46;151
420190;202012;193;596;115;396;33;127;33;103;66;230
420195;202012;1295;3292;932;2706;287;996;97;190;384;1186
420200;202012;4301;10261;2542;6981;325;1109;1062;2500;1387;3609
420205;202012;1699;4573;1121;3387;161;518;617;1850;778;2368
420207;202012;1636;4280;1002;3069;193;682;414;1187;607;1869
420208;202012;302;861;175;620;54;210;45;149;99;359
420209;202012;146;480;92;305;15;49;36;109;51;158
420210;202012;2942;7521;1971;5932;322;1099;994;2899;1316;3998
420213;202012;743;2269;626;2037;142;500;319;1024;461;1524
420215;202012;182;545;128;424;32;118;29;89;61;207
420220;202012;243;700;144;484;24;98;70;209;94;307
420230;202012;4873;13140;3668;10857;550;1774;1975;5596;2525;7370
420240;202012;12975;35650;8177;24654;1031;3542;4052;10690;5083;14232
420243;202012;347;991;274;845;44;156;167;493;211;649
420245;202012;1162;3028;830;2464;57;203;531;1517;588;1720
420250;202012;414;1155;340;1029;52;178;198;558;250;736
420253;202012;460;1134;323;936;31;102;187;537;218;639
420257;202012;152;400;95;298;17;66;49;151;66;217
420260;202012;1038;2714;755;2319;121;436;489;1461;610;1897
420270;202012;495;1286;241;707;32;106;113;321;145;427
420280;202012;1087;3275;839;2744;145;533;311;992;456;1525
420285;202012;119;243;50;143;11;45;11;23;22;68
420287;202012;427;979;306;815;90;244;108;291;198;535
420290;202012;4442;12560;3382;10166;454;1578;2006;5566;2460;7144
420300;202012;6892;19429;3958;12413;728;2538;1265;3452;1993;5990
420310;202012;757;1733;375;1036;32;101;216;553;248;654
420315;202012;732;2040;501;1633;101;348;200;651;301;999
420320;202012;4883;13133;3444;10694;965;3322;898;2573;1863;5895
420325;202012;293;810;202;622;27;85;98;278;125;363
420330;202012;941;2714;587;1963;102;403;178;529;280;932
420340;202012;880;2446;657;2041;154;501;106;295;260;796
420350;202012;1099;2899;809;2378;68;229;575;1659;643;1888
420360;202012;2717;7409;1442;4625;279;981;121;390;400;1371
420370;202012;1047;2822;855;2511;77;261;590;1673;667;1934
420380;202012;4086;10746;2715;8249;579;1887;1040;3014;1619;4901
420390;202012;1031;2485;706;1825;121;373;298;532;419;905
420395;202012;1025;2885;689;2217;107;412;100;224;207;636
420400;202012;934;2620;635;1988;106;386;257;749;363;1135
420410;202012;531;1434;407;1174;42;125;277;786;319;911
420415;202012;268;793;203;652;52;187;77;248;129;435
420417;202012;566;1671;456;1440;126;412;167;542;293;954
420419;202012;132;467;101;391;38;155;8;32;46;187
420420;202012;10517;27086;6872;20412;1909;6478;1939;5231;3848;11709
420425;202012;586;1561;386;1153;35;121;194;564;229;685
420430;202012;2986;7990;1735;5246;405;1250;577;1643;982;2893
420435;202012;238;616;115;377;14;47;58;183;72;230
420440;202012;689;1868;418;1284;111;379;154;444;265;823
420445;202012;246;595;153;422;31;86;74;192;105;278
420450;202012;671;1970;484;1557;91;344;175;499;266;843
420455;202012;1930;4710;1379;3869;186;603;673;1766;859;2369
420460;202012;8656;23025;6389;18786;901;2980;3335;9401;4236;12381
420470;202012;563;1465;301;948;51;188;63;170;114;358
420475;202012;64;166;21;69;6;21;2;7;8;28
420480;202012;5031;12412;3045;9097;620;2051;1055;3138;1675;5189
420490;202012;335;936;238;741;54;189;92;276;146;465
420500;202012;1318;3648;834;2724;147;526;365;1188;512;1714
420510;202012;147;409;78;244;9;36;23;65;32;101
420515;202012;59;155;33;97;3;18;15;36;18;54
420517;202012;733;2019;622;1802;51;155;447;1296;498;1451
420519;202012;274;673;199;563;22;70;120;352;142;422
420520;202012;267;727;138;467;26;91;9;32;35;123
420530;202012;761;2243;521;1718;82;326;207;582;289;908
420535;202012;233;681;95;321;13;51;44;141;57;192
420540;202012;34426;81629;21903;60571;3169;9986;7929;18921;11098;28907
420543;202012;191;573;151;487;17;61;83;248;100;309
420545;202012;1094;3242;812;2610;147;533;319;902;466;1435
420550;202012;3221;8564;2038;6550;321;1215;843;2759;1164;3974
420555;202012;269;771;184;591;22;86;111;330;133;416
420560;202012;370;923;244;731;48;157;143;422;191;579
420570;202012;2145;5835;1682;4962;288;987;773;2168;1061;3155
420580;202012;1741;4439;1245;3680;288;911;421;1290;709;2201
420590;202012;2573;6833;1480;4442;269;965;426;983;695;1948
420600;202012;949;2746;720;2316;92;349;418;1280;510;1629
420610;202012;307;891;176;588;41;146;62;219;103;365
420620;202012;720;1751;472;1345;99;296;194;551;293;847
420630;202012;878;2633;630;2026;75;266;383;1168;458;1434
420640;202012;464;1263;220;758;68;225;23;82;91;307
420650;202012;3396;8893;2046;6081;284;922;818;2107;1102;3029
420660;202012;404;1045;261;742;50;150;71;179;121;329
420665;202012;578;1493;368;1131;66;234;159;434;225;668
420670;202012;1182;3281;749;2378;129;504;286;788;415;1292
420675;202012;171;480;100;335;18;82;48;140;66;222
420680;202012;306;714;156;504;30;105;77;240;107;345
420690;202012;811;2391;487;1620;68;279;135;375;203;654
420700;202012;2353;6146;1743;5120;213;683;1011;2875;1224;3558
420710;202012;894;2541;680;2080;68;286;428;1178;496;1464
420720;202012;1109;3101;797;2546;139;478;417;1264;556;1742
420730;202012;2883;7464;2116;6179;338;1093;1153;3250;1491;4343
420740;202012;470;1385;260;919;69;271;22;97;91;368
420750;202012;1825;5282;1160;3731;203;762;491;1439;694;2201
420757;202012;78;192;38;124;3;5;18;58;21;63
420760;202012;297;869;151;468;32;112;45;125;77;237
420765;202012;417;1219;184;637;26;105;80;264;106;369
420768;202012;1290;3625;1113;3324;143;430;817;2423;960;2853
420770;202012;442;1189;216;732;39;152;88;274;127;426
420775;202012;251;755;170;568;36;134;55;155;91;289
420780;202012;869;2414;521;1632;108;371;95;256;203;627
420785;202012;191;497;134;375;14;48;67;154;81;202
420790;202012;966;2917;710;2398;120;478;388;1232;508;1710
420800;202012;608;1535;291;890;79;271;78;226;157;497
420810;202012;1337;4145;1076;3624;304;1172;385;1121;689;2293
420820;202012;11561;28666;8230;23197;1527;4844;3879;10060;5406;14904
420830;202012;3824;9993;2811;8129;507;1581;1237;3478;1744;5059
420840;202012;449;1311;214;772;59;232;25;76;84;308
420845;202012;2293;5833;1388;4185;256;939;568;1629;824;2568
420850;202012;1004;3234;614;2200;119;467;122;375;241;842
420860;202012;297;745;163;511;29;101;49;130;78;231
420870;202012;721;2013;534;1664;145;521;225;640;370;1161
420880;202012;970;2961;747;2489;152;600;297;902;449;1502
420890;202012;7739;20942;4745;14703;694;2392;1695;4624;2389;7016
420895;202012;165;479;105;324;29;86;31;100;60;186
420900;202012;1455;3585;871;2557;117;419;412;1049;529;1468
420910;202012;28346;74417;17439;53122;2600;9035;7068;19111;9668;28146
420915;202012;483;1748;352;1368;53;199;195;777;248;976
420917;202012;327;780;177;481;30;87;89;238;119;325
420920;202012;70;195;29;106;1;2;5;20;6;22
420930;202012;15164;39631;10630;31568;1943;6415;4715;13318;6658;19733
420940;202012;2827;6879;1624;4782;384;1291;329;803;713;2094
420945;202012;128;366;101;308;24;83;40;113;64;196
420950;202012;327;949;181;598;28;112;46;141;74;253
420960;202012;957;2341;691;1890;117;377;310;750;427;1127
420970;202012;2234;6113;1571;4889;444;1441;455;1397;899;2838
420980;202012;259;855;222;777;107;383;61;224;168;607
420985;202012;278;805;137;493;35;142;44;139;79;281
420990;202012;278;873;159;570;27;100;36;122;63;222
421000;202012;514;1541;365;1209;78;281;96;285;174;566
421003;202012;457;1078;150;438;8;23;22;52;30;75
421005;202012;51;134;36;112;8;24;17;57;25;81
421010;202012;3075;8428;2172;6741;444;1566;610;1648;1054;3214
421020;202012;348;1079;271;940;43;179;139;454;182;633
421030;202012;694;2073;535;1750;168;617;177;523;345;1140
421040;202012;603;1431;375;1080;25;87;239;674;264;761
421050;202012;954;2548;616;1796;127;410;241;609;368;1019
421055;202012;168;460;93;283;15;50;58;158;73;208
421060;202012;604;1742;425;1351;78;293;212;600;290;893
421070;202012;612;1838;363;1199;68;257;122;367;190;624
421080;202012;480;1379;399;1226;39;142;246;751;285;893
421085;202012;344;986;119;427;17;55;13;39;30;94
421090;202012;252;652;137;393;11;43;41;102;52;145
421100;202012;736;1639;316;943;92;319;91;224;183;543
421105;202012;1456;3977;986;3022;172;547;457;1335;629;1882
421110;202012;1036;2691;850;2454;17;50;630;1926;647;1976
421120;202012;950;2867;701;2306;109;382;219;645;328;1027
421125;202012;287;750;205;601;74;240;74;184;148;424
421130;202012;4564;13277;3743;11667;852;3053;1929;5604;2781;8657
421140;202012;329;892;192;589;34;108;64;180;98;288
421145;202012;423;1170;274;848;69;225;95;268;164;493
421150;202012;570;1542;365;1133;61;223;195;565;256;788
421160;202012;482;1310;346;1045;49;164;223;639;272;803
421165;202012;209;609;129;424;27;91;56;177;83;268
421170;202012;945;2587;803;2352;133;376;490;1479;623;1855
421175;202012;949;2373;576;1793;114;398;254;761;368;1159
421180;202012;364;942;200;607;34;129;90;236;124;365
421185;202012;308;822;207;613;22;71;124;365;146;436
421187;202012;261;793;166;549;27;90;58;183;85;273
421189;202012;313;914;246;785;41;142;98;290;139;432
421190;202012;10554;28484;7128;21881;1315;4338;2703;7689;4018;12027
421200;202012;609;1748;502;1555;60;211;320;963;380;1174
421205;202012;179;473;132;398;24;93;61;158;85;251
421210;202012;998;2537;573;1812;120;391;218;700;338;1091
421220;202012;1284;3832;984;3199;218;795;312;916;530;1711
421223;202012;296;821;182;609;44;142;86;291;130;433
421225;202012;773;2272;644;2050;109;397;396;1232;505;1629
421227;202012;593;1689;367;1207;72;259;159;537;231;796
421230;202012;541;1396;342;1024;56;203;140;413;196;616
421240;202012;264;781;124;439;11;44;20;63;31;107
421250;202012;1889;4787;1345;3908;134;458;827;2300;961;2758
421260;202012;173;514;50;182;15;67;9;28;24;95
421265;202012;603;1604;536;1509;10;32;477;1328;487;1360
421270;202012;326;855;132;464;20;66;48;162;68;228
421280;202012;1742;4653;1305;3919;177;668;756;2146;933;2814
421290;202012;918;2447;469;1414;87;276;112;313;199;589
421300;202012;264;686;130;418;12;52;22;63;34;115
421310;202012;169;473;114;367;24;80;60;194;84;274
421315;202012;201;537;127;379;43;117;24;83;67;200
421320;202012;598;1885;314;1056;35;100;39;95;74;195
421330;202012;558;1657;400;1326;81;309;114;350;195;659
421335;202012;326;991;268;893;67;253;108;347;175;600
421340;202012;1297;3561;918;2845;169;612;405;1138;574;1750
421350;202012;1385;3579;917;2746;175;590;380;1067;555;1657
421360;202012;2167;5824;1256;3918;223;820;485;1326;708;2146
421370;202012;648;2115;389;1405;72;263;119;378;191;641
421380;202012;773;2048;660;1870;86;276;393;1067;479;1343
421390;202012;154;424;53;193;13;40;18;63;31;103
421400;202012;299;943;214;746;36;142;109;361;145;503
421410;202012;177;499;82;293;21;83;24;74;45;157
421415;202012;164;482;99;307;21;70;20;51;41;121
421420;202012;535;1452;437;1271;49;167;277;776;326;943
421430;202012;90;276;66;214;7;27;16;47;23;74
421440;202012;558;1506;335;1101;67;214;145;465;212;679
421450;202012;422;1245;240;826;31;124;40;141;71;265
421460;202012;354;1052;191;696;22;88;33;101;55;189
421470;202012;244;684;144;473;32;105;50;179;82;284
421480;202012;2573;6867;1677;5058;344;1227;660;1787;1004;3014
421490;202012;112;394;65;252;7;29;17;52;24;81
421500;202012;1970;5766;1350;4478;351;1375;336;969;687;2344
421505;202012;262;743;217;679;33;123;141;424;174;547
421507;202012;400;1123;209;703;46;172;80;245;126;417
421510;202012;308;870;194;593;28;89;103;291;131;380
421520;202012;470;1233;307;871;26;80;185;477;211;557
421530;202012;266;774;158;532;28;123;47;128;75;251
421535;202012;355;937;221;702;34;130;122;372;156;502
421540;202012;271;636;134;404;19;63;46;123;65;186
421545;202012;608;1792;455;1519;100;403;224;692;324;1095
421550;202012;1923;5109;1543;4535;289;879;897;2620;1186;3499
421555;202012;159;480;70;246;8;34;10;23;18;57
421560;202012;84;277;55;205;10;38;18;60;28;98
421565;202012;849;2195;552;1726;143;496;148;461;291;957
421567;202012;401;1267;257;869;84;304;72;219;156;523
421568;202012;315;940;234;752;33;118;107;339;140;457
421569;202012;145;411;68;218;13;46;35;109;48;155
421570;202012;1082;2899;761;2297;167;574;225;621;392;1195
421575;202012;266;762;192;571;27;89;88;233;115;322
421580;202012;3878;10530;2474;7588;372;1350;976;2551;1348;3901
421590;202012;131;411;105;348;30;108;35;107;65;215
421600;202012;543;1466;371;1103;74;254;117;294;191;548
421605;202012;696;1804;495;1477;86;226;268;851;354;1077
421610;202012;977;2676;656;2047;115;388;217;657;332;1045
421620;202012;3550;9355;2080;6644;431;1592;620;1863;1051;3455
421625;202012;120;339;54;175;14;49;12;38;26;87
421630;202012;2308;5989;1464;4351;252;917;543;1321;795;2238
421635;202012;241;652;175;513;15;49;112;307;127;356
421640;202012;648;1734;462;1451;93;335;208;636;301;971
421650;202012;2256;6156;1496;4733;347;1283;487;1324;834;2607
421660;202012;9487;26210;6574;20569;996;3474;2956;8477;3952;11951
421670;202012;708;2021;495;1511;88;304;239;701;327;1005
421680;202012;975;2644;726;2197;191;630;366;1014;557;1644
421690;202012;1213;3442;801;2568;149;540;293;921;442;1461
421700;202012;469;1375;312;1028;61;226;103;319;164;545
421710;202012;186;595;89;304;17;62;22;72;39;134
421715;202012;104;283;80;230;18;49;45;130;63;179
421720;202012;1794;4864;1053;3271;284;945;275;744;559;1689
421725;202012;235;558;119;355;19;61;53;128;72;189
421730;202012;361;1020;190;563;27;87;99;276;126;363
421740;202012;694;1957;469;1465;106;350;143;410;249;760
421750;202012;815;1914;374;1093;90;283;134;355;224;638
421755;202012;146;408;87;265;15;59;46;123;61;182
421760;202012;899;2333;604;1799;100;342;236;581;336;923
421770;202012;2193;5825;1575;4737;409;1224;567;1830;976;3054
421775;202012;199;510;119;354;15;45;56;156;71;201
421780;202012;754;2200;478;1623;99;386;210;657;309;1043
421790;202012;821;2237;480;1589;108;369;224;723;332;1092
421795;202012;167;459;121;347;24;83;44;114;68;197
421800;202012;2340;6306;1676;5059;201;709;996;2852;1197;3561
421810;202012;570;1558;390;1225;44;167;232;710;276;877
421820;202012;858;2487;495;1585;100;373;163;420;263;793
421825;202012;1265;3564;1120;3342;120;380;792;2313;912;2693
421830;202012;1875;5534;1516;4855;303;1044;650;2032;953;3076
421835;202012;193;474;118;352;27;88;32;83;59;171
421840;202012;186;596;123;449;27;105;33;111;60;216
421850;202012;340;955;186;635;39;153;54;141;93;294
421860;202012;284;785;157;528;25;98;55;160;80;258
421870;202012;4009;10030;2932;8045;456;1490;1536;3759;1992;5249
421875;202012;271;790;114;351;18;61;36;91;54;152
421880;202012;571;1617;372;1170;86;318;94;285;180;603
421885;202012;192;555;119;386;28;90;29;84;57;174
421890;202012;786;2380;582;1963;107;434;317;992;424;1426
421895;202012;383;976;325;900;40;116;219;635;259;751
421900;202012;983;2591;725;2051;92;301;353;906;445;1207
421910;202012;295;851;183;585;30;126;54;139;84;265
421915;202012;355;993;197;622;44;138;38;111;82;249
421917;202012;545;1278;309;975;106;352;78;263;184;615
421920;202012;340;1038;239;836;93;340;65;224;158;564
421930;202012;2393;6021;1239;3825;274;967;427;1151;701;2118
421935;202012;373;1171;296;1004;59;210;167;550;226;760
421940;202012;349;1009;166;534;22;74;48;140;70;214
421950;202012;2763;6915;1569;4658;319;1030;408;1082;727;2112
421960;202012;169;433;87;276;17;69;18;47;35;116
421970;202012;1757;4516;1076;3116;209;721;423;1040;632;1761
421985;202012;270;721;157;490;13;44;66;194;79;238
422000;202012;1848;4754;1495;4196;145;491;1034;2853;1179;3344
430003;202012;554;1494;362;1145;64;217;157;499;221;716
430005;202012;248;647;156;482;32;105;73;214;105;319
430010;202012;1603;3872;1267;3357;128;379;909;2331;1037;2710
430020;202012;568;1294;422;1096;44;139;280;701;324;840
430030;202012;933;2213;505;1437;120;391;166;436;286;827
430040;202012;9982;23645;5876;16422;1567;4694;729;2172;2296;6866
430045;202012;466;1176;327;916;27;89;223;610;250;699
430047;202012;230;503;91;252;26;77;27;73;53;150
430050;202012;837;2121;482;1402;106;323;121;330;227;653
430055;202012;244;614;124;362;16;60;69;180;85;240
430057;202012;79;166;31;81;6;21;11;23;17;44
430060;202012;16313;43115;12496;37096;2549;8065;5906;17332;8455;25397
430063;202012;795;2222;640;1902;127;376;351;1044;478;1420
430064;202012;1000;2720;740;2187;224;685;280;821;504;1506
430066;202012;93;198;66;157;6;13;50;113;56;126
430070;202012;716;1809;98;320;8;28;16;39;24;67
430080;202012;827;2030;507;1406;78;257;275;655;353;912
430085;202012;841;1876;502;1331;96;271;217;562;313;833
430087;202012;748;1810;626;1651;66;179;433;1130;499;1309
430090;202012;491;1292;186;599;10;40;62;196;72;236
430100;202012;749;1780;458;1232;89;280;178;406;267;686
430105;202012;1113;2933;725;2266;119;423;348;1049;467;1472
430107;202012;166;484;97;305;22;76;28;75;50;151
430110;202012;2187;5406;1621;4562;287;867;840;2327;1127;3194
430120;202012;1124;3303;744;2343;137;454;331;1042;468;1496
430130;202012;3317;7579;2400;6291;850;2261;414;1333;1264;3594
430140;202012;934;2406;664;1906;170;446;339;962;509;1408
430150;202012;526;1352;278;849;61;205;94;273;155;478
430155;202012;237;600;111;335;19;53;22;61;41;114
430160;202012;19153;44330;14823;38231;1745;4870;8850;22550;10595;27420
430163;202012;2990;7046;2090;5612;83;294;1537;4029;1620;4323
430165;202012;277;677;82;260;12;26;14;39;26;65
430170;202012;939;2471;310;1062;49;177;41;123;90;300
430175;202012;637;1879;530;1645;140;439;244;756;384;1195
430180;202012;607;1447;475;1232;55;132;330;867;385;999
430185;202012;619;1536;317;912;81;213;62;167;143;380
430187;202012;672;1477;476;1236;74;202;252;691;326;893
430190;202012;1352;3516;1065;3063;230;709;492;1355;722;2064
430192;202012;122;326;40;120;5;15;9;22;14;37
430195;202012;401;1182;59;211;6;21;9;26;15;47
430200;202012;1011;3010;801;2627;280;941;221;742;501;1683
430205;202012;438;1154;392;1070;13;48;345;913;358;961
430210;202012;5391;13757;3593;9910;587;1733;1211;2736;1798;4469
430215;202012;292;748;184;535;39;118;67;199;106;317
430220;202012;629;1564;186;614;24;87;41;107;65;194
430222;202012;178;493;130;395;15;54;44;124;59;178
430223;202012;236;602;187;520;15;41;122;336;137;377
430225;202012;16;32;10;23;0;0;7;16;7;16
430230;202012;1894;5114;1567;4606;133;437;1165;3355;1298;3792
430235;202012;335;937;213;665;49;180;69;181;118;361
430237;202012;492;1150;368;949;18;51;277;698;295;749
430240;202012;1256;2901;709;1935;78;255;377;938;455;1193
430245;202012;699;1952;544;1657;151;478;255;800;406;1278
430250;202012;899;2195;647;1794;224;668;39;97;263;765
430258;202012;135;356;95;274;8;16;52;153;60;169
430260;202012;632;1663;437;1291;58;196;247;722;305;918
430265;202012;217;614;139;455;30;92;45;152;75;244
430270;202012;2849;6999;2234;6035;380;1125;1346;3516;1726;4641
430280;202012;4960;11557;3424;8939;658;1730;1498;3862;2156;5592
430290;202012;2177;4961;1773;4491;46;147;1536;3800;1582;3947
430300;202012;9788;24482;7275;20086;1125;3431;3909;10470;5034;13901
430310;202012;11397;27983;7620;21014;978;2990;3767;9691;4745;12681
430320;202012;991;2518;543;1627;61;193;307;916;368;1109
430330;202012;678;1641;396;1075;69;195;162;392;231;587
430340;202012;567;1321;371;1000;63;169;221;578;284;747
430350;202012;7564;18909;5660;15535;726;2171;3410;8909;4136;11080
430355;202012;299;790;103;331;18;61;14;35;32;96
430360;202012;800;1898;526;1416;99;301;221;555;320;856
430367;202012;295;671;166;444;30;95;96;243;126;338
430370;202012;422;1159;207;631;32;104;60;153;92;257
430380;202012;688;1691;332;1031;80;287;96;280;176;567
430390;202012;3060;7276;1792;4940;339;1080;286;572;625;1652
430400;202012;1002;2136;768;1816;63;161;471;1078;534;1239
430410;202012;520;1239;358;976;63;179;217;577;280;756
430420;202012;2493;6740;1893;5443;459;1396;883;2417;1342;3813
430430;202012;562;1422;254;778;64;190;58;196;122;386
430435;202012;1439;3621;1109;3091;196;594;583;1617;779;2211
430440;202012;3634;9858;2821;8461;285;951;1760;5240;2045;6191
430450;202012;6516;16192;5151;13776;866;2570;2691;6853;3557;9423
430460;202012;31462;78987;23233;65436;3940;12247;12116;32581;16056;44828
430461;202012;232;612;74;230;13;43;31;84;44;127
430462;202012;242;666;145;465;26;94;54;168;80;262
430463;202012;5767;14922;4196;12105;832;2689;1943;5331;2775;8020
430465;202012;423;1073;342;926;55;170;213;557;268;727
430466;202012;4001;10021;3086;8537;738;2115;1427;3759;2165;5874
430467;202012;489;1155;343;925;47;152;189;470;236;622
430468;202012;1214;2968;946;2564;80;246;640;1681;720;1927
430469;202012;513;1356;67;216;8;25;14;28;22;53
430470;202012;5277;13517;3449;10190;1027;3310;900;2474;1927;5784
430471;202012;526;1474;427;1294;62;201;256;738;318;939
430480;202012;673;1860;414;1269;48;169;99;263;147;432
430485;202012;169;441;65;198;19;49;6;24;25;73
430490;202012;340;885;192;571;25;91;99;266;124;357
430495;202012;378;995;242;730;33;104;120;343;153;447
430500;202012;959;2467;659;1961;222;721;170;461;392;1182
430510;202012;24926;64391;18065;50961;2940;9386;8605;22284;11545;31670
430511;202012;319;912;130;419;19;64;19;58;38;122
430512;202012;942;2096;728;1775;166;409;269;681;435;1090
430513;202012;753;1878;348;1005;50;151;174;477;224;628
430515;202012;351;991;253;788;29;86;136;420;165;506
430517;202012;1146;3410;845;2719;166;530;394;1318;560;1848
430520;202012;1234;3108;643;1849;122;368;150;387;272;755
430530;202012;949;2351;375;1128;68;198;107;311;175;509
430535;202012;3386;8646;2434;6896;345;1017;1248;3394;1593;4411
430537;202012;330;1123;304;1054;18;54;247;855;265;909
430540;202012;602;1423;333;953;57;162;159;458;216;620
430543;202012;817;1409;458;1005;57;119;192;490;249;609
430544;202012;732;2057;502;1538;123;393;169;499;292;892
430545;202012;2244;5710;1645;4782;315;928;857;2549;1172;3477
430550;202012;337;920;245;725;45;146;96;257;141;403
430558;202012;112;261;53;145;8;15;20;58;28;73
430560;202012;271;633;128;382;20;70;51;140;71;210
430570;202012;836;2022;583;1556;103;309;301;741;404;1050
430580;202012;819;2031;576;1655;150;462;245;702;395;1164
430583;202012;199;494;34;106;4;12;10;26;14;38
430585;202012;225;549;114;307;19;59;51;119;70;178
430587;202012;190;519;140;420;21;68;57;166;78;234
430590;202012;1363;3257;1128;2912;58;173;933;2359;991;2532
430593;202012;16;48;12;37;1;3;5;15;6;18
430595;202012;425;1057;117;380;7;27;24;60;31;87
430597;202012;450;1131;229;679;22;67;79;185;101;252
430600;202012;1948;4964;865;2460;155;461;239;621;394;1082
430605;202012;1246;3251;879;2550;107;362;422;1159;529;1521
430607;202012;515;1210;427;1069;27;70;316;780;343;850
430610;202012;5701;13166;3786;10269;1064;3302;840;2195;1904;5497
430613;202012;266;617;74;212;13;35;18;35;31;70
430620;202012;599;1435;438;1134;63;190;264;612;327;802
430630;202012;388;1053;108;347;19;59;22;63;41;122
430632;202012;448;1169;193;585;27;86;86;249;113;335
430635;202012;523;1215;390;995;44;116;287;733;331;849
430637;202012;445;1081;346;932;40;123;224;574;264;697
430640;202012;1014;2674;652;1932;96;299;260;704;356;1003
430642;202012;343;940;254;737;43;121;137;378;180;499
430645;202012;150;349;53;144;7;19;19;45;26;64
430650;202012;1582;4491;1255;3932;371;1166;546;1844;917;3010
430655;202012;270;677;166;466;28;92;82;197;110;289
430660;202012;5109;12947;3879;10891;846;2492;1705;4735;2551;7227
430670;202012;641;1558;486;1289;33;93;286;775;319;868
430673;202012;513;1164;215;606;39;109;84;217;123;326
430675;202012;237;681;51;183;6;20;20;71;26;91
430676;202012;4942;12129;3893;10497;462;1381;2509;6593;2971;7974
430680;202012;1024;2722;590;1820;153;487;140;416;293;903
430690;202012;2675;7261;2094;6209;717;2231;584;1656;1301;3887
430692;202012;215;660;163;565;12;39;122;433;134;472
430693;202012;909;2365;545;1646;108;384;144;399;252;783
430695;202012;396;1005;237;686;29;73;128;353;157;426
430697;202012;384;959;294;816;75;191;144;436;219;627
430700;202012;6950;16990;4085;11587;823;2557;965;2452;1788;5009
430705;202012;389;923;188;546;18;51;80;211;98;262
430710;202012;1612;3456;1130;2808;150;422;681;1661;831;2083
430720;202012;657;1583;340;1027;43;129;177;536;220;665
430730;202012;966;2621;667;2056;98;291;351;1075;449;1366
430740;202012;612;1641;311;1012;50;162;83;278;133;440
430745;202012;334;907;215;656;45;155;69;179;114;334
430750;202012;1333;3355;917;2643;205;620;435;1230;640;1850
430755;202012;433;1065;267;724;23;66;152;386;175;452
430760;202012;1927;4711;1454;3976;320;959;670;1734;990;2693
430770;202012;6022;14950;4628;12843;566;1821;2979;7976;3545;9797
430780;202012;1771;4308;1026;3028;191;636;400;1122;591;1758
430781;202012;455;1263;254;787;35;105;80;214;115;319
430783;202012;340;779;205;569;19;60;130;337;149;397
430786;202012;31;110;21;78;3;13;2;9;5;22
430790;202012;4237;10210;2947;8003;320;1031;1839;4655;2159;5686
430800;202012;728;1680;542;1403;32;83;367;950;399;1033
430805;202012;325;851;210;608;13;48;139;381;152;429
430807;202012;481;1195;253;758;36;115;96;260;132;375
430810;202012;662;1567;279;825;32;116;132;362;164;478
430820;202012;1116;2994;665;2114;123;416;220;665;343;1081
430825;202012;227;565;83;219;11;28;26;64;37;92
430830;202012;1643;4643;1323;4033;70;225;953;2873;1023;3098
430840;202012;1033;2500;701;1949;98;269;466;1299;564;1568
430843;202012;161;376;71;188;4;13;34;86;38;99
430845;202012;455;1066;300;816;51;152;138;353;189;505
430850;202012;2179;5597;1453;4207;231;727;561;1646;792;2373
430860;202012;817;1888;360;1015;51;173;172;402;223;575
430865;202012;495;1233;365;1010;73;206;161;448;234;654
430870;202012;582;1527;247;771;41;146;81;214;122;360
430880;202012;1469;3319;984;2563;162;423;539;1372;701;1795
430885;202012;170;448;90;293;5;16;57;180;62;196
430890;202012;936;2303;619;1773;57;243;135;363;192;606
430900;202012;3026;6569;2086;5223;170;509;1408;3308;1578;3817
430905;202012;787;1968;500;1418;89;287;205;538;294;825
430910;202012;1722;4586;1256;3641;198;655;618;1596;816;2251
430912;202012;494;1381;333;1052;24;73;226;721;250;794
430915;202012;477;1421;361;1200;137;434;90;320;227;754
430920;202012;21851;55134;16491;46226;2166;6700;10001;27361;12167;34061
430925;202012;88;203;36;114;4;12;18;55;22;67
430930;202012;9892;23282;6217;17590;1187;3413;2570;7613;3757;11026
430940;202012;881;2251;522;1505;121;365;163;418;284;783
430950;202012;759;1742;483;1263;35;124;315;751;350;875
430955;202012;364;944;82;243;21;64;23;57;44;121
430957;202012;161;548;146;514;21;79;99;342;120;421
430960;202012;1252;2982;695;1956;148;444;302;817;450;1261
430965;202012;1570;3724;1211;3159;71;183;914;2451;985;2634
430970;202012;329;786;165;467;23;75;81;200;104;275
430975;202012;478;1420;361;1148;78;266;198;595;276;861
430980;202012;381;862;224;594;26;84;107;255;133;339
430990;202012;499;1443;316;999;42;133;151;475;193;608
430995;202012;533;1348;402;1136;43;132;237;646;280;778
431000;202012;1307;3083;532;1545;95;302;44;113;139;415
431010;202012;2061;5412;1313;4087;257;892;327;890;584;1782
431020;202012;7484;16205;4382;11541;993;2962;1515;3467;2508;6429
431030;202012;359;965;163;546;32;113;22;71;54;184
431033;202012;3662;8448;2344;6383;491;1366;860;2346;1351;3712
431036;202012;330;722;61;181;7;24;21;49;28;73
431040;202012;847;2152;544;1615;78;260;257;707;335;967
431041;202012;433;1003;318;826;25;56;193;503;218;559
431043;202012;300;773;170;531;40;139;83;258;123;397
431046;202012;99;263;41;128;4;9;7;21;11;30
431050;202012;1321;3204;937;2572;172;522;443;1254;615;1776
431053;202012;628;1670;353;1075;78;281;118;308;196;589
431055;202012;563;1367;473;1228;51;122;341;878;392;1000
431057;202012;213;608;113;371;26;85;32;95;58;180
431060;202012;5260;13248;3478;10183;796;2552;1013;2873;1809;5425
431065;202012;391;967;278;774;43;130;138;379;181;509
431070;202012;401;1098;234;724;54;179;61;181;115;360
431075;202012;207;601;129;421;30;106;33;109;63;215
431080;202012;554;1492;379;1117;58;205;149;410;207;615
431085;202012;768;1982;486;1341;62;171;250;671;312;842
431087;202012;384;1088;310;936;20;58;220;685;240;743
431090;202012;395;931;155;477;27;91;45;145;72;236
431100;202012;3223;7008;2182;5638;309;817;1129;2973;1438;3790
431110;202012;1358;3116;911;2340;248;667;369;857;617;1524
431112;202012;574;1582;481;1404;63;209;305;856;368;1065
431113;202012;362;981;311;881;47;152;197;540;244;692
431115;202012;924;2595;717;2214;89;349;430;1228;519;1577
431120;202012;2484;6606;1691;5052;489;1639;374;1027;863;2666
431123;202012;392;1056;251;753;45;118;139;437;184;555
431125;202012;939;2670;751;2303;279;827;254;847;533;1674
431127;202012;194;509;59;194;7;24;12;35;19;59
431130;202012;2811;7114;2059;5858;293;959;1180;3263;1473;4222
431140;202012;5410;12609;3266;8595;394;1157;1526;3462;1920;4619
431142;202012;480;1264;354;1040;45;139;222;654;267;793
431150;202012;1022;2697;726;2150;134;435;332;943;466;1378
431160;202012;623;1790;410;1308;71;244;123;387;194;631
431162;202012;481;1153;277;789;30;94;159;420;189;514
431164;202012;167;378;41;125;8;27;5;11;13;38
431170;202012;431;1181;302;917;91;282;84;242;175;524
431171;202012;651;1522;528;1354;117;262;306;817;423;1079
431173;202012;351;937;265;813;74;252;114;330;188;582
431175;202012;1249;2877;773;2062;131;355;290;731;421;1086
431177;202012;757;2044;594;1782;127;448;365;1038;492;1486
431179;202012;329;720;95;283;18;53;23;66;41;119
431180;202012;2068;5221;1269;3637;301;893;395;1082;696;1975
431190;202012;501;1294;247;719;26;84;97;233;123;317
431198;202012;361;1029;278;873;92;303;87;296;179;599
431200;202012;358;886;82;225;18;53;11;29;29;82
431205;202012;188;522;95;312;29;94;32;108;61;202
431210;202012;593;1442;477;1282;123;333;216;613;339;946
431213;202012;263;683;195;558;13;46;105;300;118;346
431215;202012;575;1364;253;735;20;59;134;370;154;429
431217;202012;142;371;98;291;12;40;54;147;66;187
431220;202012;512;1324;312;936;29;102;182;506;211;608
431225;202012;1444;3389;1104;2818;113;303;754;1927;867;2230
431230;202012;660;1881;528;1595;76;241;329;957;405;1198
431235;202012;145;368;21;77;3;8;4;20;7;28
431237;202012;294;924;239;794;48;172;127;403;175;575
431238;202012;29;77;24;67;5;16;11;23;16;39
431240;202012;4287;10511;3365;9047;440;1345;2074;5266;2514;6611
431242;202012;235;615;204;563;38;110;114;301;152;411
431244;202012;303;729;159;447;22;79;61;141;83;220
431245;202012;1209;2816;764;2047;75;216;408;1041;483;1257
431247;202012;267;673;160;455;28;89;71;176;99;265
431250;202012;1634;4033;1195;3440;259;763;627;1912;886;2675
431260;202012;247;681;161;512;21;79;55;168;76;247
431261;202012;230;688;184;613;14;52;103;329;117;381
431262;202012;332;923;165;541;11;30;113;376;124;406
431265;202012;1544;3629;602;1753;80;270;204;519;284;789
431267;202012;255;642;166;456;8;35;125;314;133;349
431270;202012;2744;6118;1453;3948;325;898;488;1350;813;2248
431275;202012;113;324;60;196;23;70;12;42;35;112
431280;202012;237;637;72;229;4;13;9;21;13;34
431290;202012;312;910;195;616;34;116;38;85;72;201
431295;202012;68;167;19;58;3;8;6;18;9;26
431300;202012;278;715;56;170;7;20;16;33;23;53
431301;202012;302;846;66;206;8;21;7;22;15;43
431303;202012;538;1413;324;963;24;90;149;410;173;500
431306;202012;2240;5257;1335;3733;175;555;593;1468;768;2023
431308;202012;25;76;22;70;10;34;10;31;20;65
431310;202012;519;1440;363;1094;53;158;160;450;213;608
431320;202012;599;1641;315;1020;48;147;69;188;117;335
431330;202012;1653;3887;804;2291;141;458;330;851;471;1309
431333;202012;206;536;113;325;20;56;41;106;61;162
431335;202012;36;101;20;65;4;8;2;6;6;14
431337;202012;2428;6377;1772;5286;319;1074;962;2761;1281;3835
431339;202012;406;1046;299;848;83;244;117;328;200;572
431340;202012;17624;42577;12177;33413;2016;6143;5626;14462;7642;20605
431342;202012;416;911;307;742;27;50;253;613;280;663
431344;202012;385;971;226;668;9;30;122;348;131;378
431346;202012;228;561;88;282;15;53;25;76;40;129
431349;202012;601;1583;325;958;82;228;118;351;200;579
431350;202012;3916;10005;2889;8245;387;1268;1578;4329;1965;5597
431360;202012;543;1296;264;749;83;239;69;198;152;437
431365;202012;1996;4656;1580;4093;124;360;1195;3066;1319;3426
431370;202012;4280;10314;3051;8296;624;1782;1527;4233;2151;6015
431380;202012;784;2072;629;1823;45;139;445;1292;490;1431
431390;202012;2567;6238;1561;4451;152;516;785;1963;937;2479
431395;202012;1263;3099;879;2507;191;573;401;1178;592;1751
431400;202012;304;855;164;522;34;102;36;114;70;216
431402;202012;850;1881;611;1515;72;190;421;1013;493;1203
431403;202012;200;549;155;456;23;70;70;194;93;264
431405;202012;4400;11493;3356;9721;578;1873;1647;4505;2225;6378
431406;202012;515;1459;373;1158;73;221;201;638;274;859
431407;202012;434;1203;302;926;68;228;151;444;219;672
431410;202012;15970;39692;10582;30168;1505;4982;5550;14644;7055;19626
431413;202012;197;517;52;171;7;25;8;29;15;54
431415;202012;630;1531;391;1127;65;228;200;514;265;742
431417;202012;533;1178;360;916;58;166;201;503;259;669
431420;202012;1588;3529;1188;2972;165;427;679;1666;844;2093
431430;202012;548;1396;259;799;42;139;85;237;127;376
431440;202012;28716;66620;19722;52490;3283;9515;7945;19813;11228;29328
431442;202012;117;331;53;182;12;41;8;25;20;66
431445;202012;387;1075;116;369;16;42;9;23;25;65
431446;202012;244;721;187;606;34;125;93;292;127;417
431447;202012;712;1867;406;1208;82;267;146;433;228;700
431449;202012;768;1987;455;1333;90;239;179;543;269;782
431450;202012;2231;4583;1739;3889;81;195;1362;2969;1443;3164
431454;202012;33;105;28;91;8;23;8;24;16;47
431455;202012;585;1374;285;762;37;109;146;350;183;459
431460;202012;2798;6738;1932;5193;505;1418;506;1385;1011;2803
431470;202012;1350;3799;975;2989;179;550;435;1358;614;1908
431475;202012;235;631;48;166;5;18;7;14;12;32
431477;202012;371;973;222;659;36;103;96;259;132;362
431478;202012;217;575;49;154;11;30;7;17;18;47
431480;202012;3136;7693;2477;6663;591;1574;1264;3463;1855;5037
431490;202012;102652;240437;77015;201226;5455;16861;56196;141308;61651;158169
431500;202012;463;1171;340;937;56;157;182;483;238;640
431505;202012;243;585;165;468;10;33;119;337;129;370
431507;202012;331;775;132;387;44;139;35;91;79;230
431510;202012;1533;3916;1026;2924;237;740;336;958;573;1698
431513;202012;202;452;114;303;9;19;79;212;88;231
431514;202012;107;270;75;213;3;10;51;136;54;146
431515;202012;449;1126;323;892;78;213;172;456;250;669
431517;202012;53;163;44;139;6;17;22;65;28;82
431520;202012;386;966;151;469;20;71;68;182;88;253
431530;202012;4139;8676;2329;5973;543;1400;605;1579;1148;2979
431531;202012;202;494;123;343;14;38;53;134;67;172
431532;202012;528;1217;321;848;69;207;134;344;203;551
431535;202012;235;611;104;320;18;56;26;71;44;127
431540;202012;1733;5572;1610;5398;56;224;1314;4423;1370;4647
431545;202012;340;882;61;203;5;17;13;40;18;57
431550;202012;2043;5149;1472;4072;240;722;748;1986;988;2708
431555;202012;636;1428;382;1001;24;68;233;605;257;673
431560;202012;21800;52551;14766;41433;3100;9010;5010;14885;8110;23895
431570;202012;4203;10262;3501;9207;439;1261;2489;6291;2928;7552
431575;202012;235;579;182;487;68;160;45;132;113;292
431580;202012;551;1419;340;993;37;131;196;541;233;672
431590;202012;550;1532;409;1234;91;287;167;519;258;806
431595;202012;350;942;227;680;50;144;90;241;140;385
431600;202012;1340;3105;932;2510;213;622;379;1009;592;1631
431610;202012;1355;3441;913;2625;132;362;475;1395;607;1757
431620;202012;476;1217;217;627;36;107;83;226;119;333
431630;202012;1283;3154;587;1721;98;308;219;593;317;901
431640;202012;6114;14384;5146;13165;495;1305;3887;9989;4382;11294
431642;202012;546;1325;340;905;31;82;160;395;191;477
431643;202012;381;921;177;497;17;44;55;157;72;201
431645;202012;1764;3930;1378;3414;58;184;1119;2726;1177;2910
431647;202012;285;694;91;260;10;25;27;66;37;91
431650;202012;114;315;76;253;6;23;42;123;48;146
431660;202012;820;2159;395;1259;67;251;115;311;182;562
431670;202012;1118;2650;683;1848;106;302;346;889;452;1191
431673;202012;232;582;81;269;10;35;21;64;31;99
431675;202012;405;1058;103;352;10;38;22;61;32;99
431680;202012;7360;18677;5296;14829;1238;3595;2240;6114;3478;9709
431690;202012;23069;56013;15209;41846;3002;8834;6299;17145;9301;25979
431695;202012;168;406;102;299;22;77;52;129;74;206
431697;202012;448;1043;348;886;49;118;205;526;254;644
431700;202012;1261;3264;1047;2869;154;387;643;1764;797;2151
431710;202012;12719;30082;8789;24399;1453;4349;4559;12725;6012;17074
431720;202012;6195;15191;3640;10266;893;2671;741;1875;1634;4546
431725;202012;28;81;22;71;3;10;10;30;13;40
431730;202012;3856;9068;2370;6732;538;1613;751;2288;1289;3901
431740;202012;4970;11623;3241;8718;864;2698;834;1902;1698;4600
431750;202012;7176;18362;5394;15485;1179;3626;2249;6348;3428;9974
431755;202012;311;842;68;236;10;36;9;32;19;68
431760;202012;5215;11636;3502;8907;396;1138;2144;5174;2540;6312
431770;202012;1869;4351;1442;3778;104;302;1079;2754;1183;3056
431775;202012;196;499;98;303;19;57;14;39;33;96
431780;202012;2035;4991;1297;3615;209;644;554;1473;763;2117
431790;202012;746;1993;519;1550;92;265;245;729;337;994
431795;202012;225;571;113;337;28;75;28;75;56;150
431800;202012;7980;18813;4827;13769;1218;4095;491;1498;1709;5593
431805;202012;284;662;85;272;11;37;20;61;31;98
431810;202012;3221;7561;1997;5318;381;1044;857;2186;1238;3230
431820;202012;2031;5427;1584;4711;460;1429;543;1710;1003;3139
431830;202012;8731;18734;6352;15565;1615;4681;1795;4387;3410;9068
431840;202012;2500;6448;1980;5607;298;847;1259;3582;1557;4429
431842;202012;533;1328;175;530;22;72;66;168;88;240
431843;202012;326;856;237;673;31;91;118;318;149;409
431844;202012;198;515;67;211;13;46;25;78;38;124
431845;202012;496;1310;351;1023;38;113;204;589;242;702
431846;202012;261;684;222;623;10;30;200;563;210;593
431848;202012;90;233;57;168;9;29;11;25;20;54
431849;202012;402;970;66;186;8;19;8;16;16;35
431850;202012;4031;10816;3067;8889;718;2245;1027;2931;1745;5176
431860;202012;625;1482;336;931;56;167;192;511;248;678
431861;202012;87;240;49;152;10;34;15;45;25;79
431862;202012;434;1368;358;1236;66;249;179;593;245;842
431870;202012;19614;49327;15753;43222;1772;5570;9952;26194;11724;31764
431880;202012;3811;9697;2673;7671;416;1380;1266;3431;1682;4811
431890;202012;4278;10681;2641;7575;744;2353;466;1491;1210;3844
431900;202012;917;2278;583;1676;91;288;301;821;392;1109
431910;202012;734;1747;266;736;39;111;88;199;127;310
431912;202012;465;1244;360;1059;72;218;204;604;276;822
431915;202012;1009;2482;797;2132;24;82;624;1626;648;1708
431920;202012;1220;2791;1006;2515;30;69;859;2140;889;2209
431930;202012;640;1708;428;1300;158;445;160;523;318;968
431935;202012;83;223;60;177;14;45;14;40;28;85
431936;202012;297;847;155;490;37;118;64;191;101;309
431937;202012;141;347;89;239;12;33;43;98;55;131
431940;202012;2974;6984;1691;4642;192;569;851;2250;1043;2819
431950;202012;1769;4650;1399;4035;416;1244;522;1468;938;2712
431960;202012;2829;6858;2085;5518;558;1570;568;1506;1126;3076
431970;202012;392;983;163;477;35;99;48;125;83;224
431971;202012;77;189;28;90;2;8;4;8;6;16
431973;202012;465;1492;384;1332;38;136;279;968;317;1104
431975;202012;106;212;20;60;2;7;1;3;3;10
431980;202012;943;2450;722;2086;145;443;350;976;495;1419
431990;202012;5299;12645;3610;10204;413;1422;1872;5089;2285;6511
432000;202012;10857;25640;7859;21011;1936;5176;3306;9030;5242;14206
432010;202012;2119;5144;1549;4155;237;689;906;2301;1143;2990
432020;202012;1701;4401;1033;2971;216;648;411;1140;627;1788
432023;202012;483;1149;255;718;31;99;129;330;160;429
432026;202012;915;2556;673;2089;176;553;228;708;404;1261
432030;202012;350;861;196;547;17;48;112;303;129;351
432032;202012;320;826;220;625;23;76;125;330;148;406
432035;202012;622;1771;537;1624;171;511;231;723;402;1234
432040;202012;1007;2330;366;1122;55;175;130;361;185;536
432045;202012;150;432;97;320;24;70;36;128;60;198
432050;202012;499;1234;367;1009;78;210;153;443;231;653
432055;202012;549;1466;355;1101;127;399;70;204;197;603
432057;202012;215;573;157;431;17;44;66;166;83;210
432060;202012;417;989;123;381;32;105;38;106;70;211
432065;202012;199;546;139;416;30;94;57;169;87;263
432067;202012;705;2031;593;1782;52;176;451;1305;503;1481
432070;202012;1599;4162;1044;3082;229;746;347;913;576;1659
432080;202012;4608;10766;3488;9010;595;1793;1641;3981;2236;5774
432085;202012;331;850;229;693;58;181;92;292;150;473
432090;202012;1700;4171;1034;2915;183;556;511;1322;694;1878
432100;202012;941;2347;461;1401;98;322;81;206;179;528
432110;202012;1927;5089;1301;3959;312;1074;129;356;441;1430
432120;202012;2578;6968;1975;5926;370;1236;809;2292;1179;3528
432130;202012;2455;6202;2025;5563;587;1633;894;2514;1481;4147
432132;202012;176;503;108;354;23;74;49;139;72;213
432135;202012;973;2280;649;1731;39;122;476;1257;515;1379
432140;202012;1552;4626;1171;3849;179;610;698;2285;877;2895
432143;202012;1332;3455;1009;2951;61;193;675;1959;736;2152
432145;202012;1640;4278;1027;3001;155;486;354;891;509;1377
432146;202012;101;282;67;221;24;87;23;67;47;154
432147;202012;443;1238;261;858;88;310;68;190;156;500
432149;202012;430;1040;220;614;20;56;108;268;128;324
432150;202012;2972;7440;2158;5984;438;1306;899;2440;1337;3746
432160;202012;4829;12537;3490;10392;827;2759;1292;3669;2119;6428
432162;202012;230;492;31;86;7;21;6;11;13;32
432163;202012;99;246;19;49;0;0;3;4;3;4
432166;202012;587;1639;452;1360;92;305;153;412;245;717
432170;202012;1407;3760;921;2839;162;552;379;1090;541;1642
432180;202012;2998;7037;1603;4415;298;863;606;1468;904;2331
432183;202012;345;1007;237;758;54;194;72;210;126;404
432185;202012;801;2051;455;1365;37;124;227;638;264;762
432190;202012;1846;4410;1228;3427;181;575;688;1787;869;2362
432195;202012;798;2051;536;1566;158;426;184;575;342;1001
432200;202012;3160;7929;2269;6519;359;1057;1297;3748;1656;4805
432210;202012;367;961;228;688;42;164;107;271;149;435
432215;202012;592;1749;539;1668;50;132;408;1285;458;1417
432218;202012;243;607;110;320;14;51;54;140;68;191
432220;202012;3406;7951;2507;6516;463;1256;1324;3393;1787;4649
432225;202012;82;235;62;193;10;26;35;116;45;142
432230;202012;708;1632;377;1012;42;116;175;415;217;531
432232;202012;469;1154;291;847;59;180;104;274;163;454
432234;202012;252;635;117;349;18;51;16;43;34;94
432235;202012;44;124;16;51;5;17;4;13;9;30
432237;202012;303;781;270;728;10;19;227;603;237;622
432240;202012;15306;37541;11016;31752;840;2479;7038;21269;7878;23748
432250;202012;5150;14552;3833;11916;982;3189;1620;4972;2602;8161
432252;202012;404;969;253;694;31;90;134;349;165;439
432253;202012;831;2540;542;1793;128;457;52;152;180;609
432254;202012;684;1592;183;530;31;84;39;106;70;190
432255;202012;98;250;55;167;3;9;28;77;31;86
432260;202012;4703;11954;3470;9596;991;2820;1161;3068;2152;5888
432270;202012;1741;4809;1390;4133;401;1305;327;890;728;2195
432280;202012;1354;3354;701;2065;100;313;262;647;362;960
432285;202012;142;427;20;60;2;6;3;7;5;13
432290;202012;324;889;177;549;60;195;33;71;93;266
432300;202012;24539;61365;18110;50970;2556;8120;10619;28814;13175;36934
432310;202012;822;2188;590;1765;63;197;407;1213;470;1410
432320;202012;195;449;74;225;7;24;28;75;35;99
432330;202012;247;550;75;247;10;23;13;42;23;65
432335;202012;159;456;59;210;5;21;17;58;22;79
432340;202012;301;720;132;409;8;26;48;136;56;162
432345;202012;685;1536;597;1429;16;42;499;1175;515;1217
432350;202012;338;859;178;552;27;89;70;220;97;309
432360;202012;231;675;43;140;4;7;15;49;19;56
432370;202012;285;696;189;536;14;49;131;360;145;409
432375;202012;445;1117;329;882;60;161;174;466;234;627
432377;202012;164;522;27;96;6;27;3;8;9;35
432380;202012;1568;4119;1008;3091;172;614;517;1522;689;2136
500020;202012;2424;6289;1760;5174;150;526;1127;3199;1277;3725
500025;202012;1165;2840;722;2006;71;208;395;1048;466;1256
500060;202012;7743;21758;5242;16533;670;2183;3043;9871;3713;12054
500070;202012;4099;10579;2858;8449;533;1611;1239;3734;1772;5345
500080;202012;1603;3909;964;2721;173;534;388;961;561;1495
500085;202012;1941;4838;1342;3809;310;925;630;1717;940;2642
500090;202012;2118;5580;1412;4329;235;769;485;1596;720;2365
500100;202012;3429;8729;2590;7351;421;1351;1299;3489;1720;4840
500110;202012;7658;19426;4863;15010;1039;3553;1438;5243;2477;8796
500124;202012;1982;5791;1569;5102;257;771;834;2866;1091;3637
500150;202012;1299;2905;811;2196;136;393;330;875;466;1268
500190;202012;4710;12195;2936;8694;629;1901;682;1913;1311;3814
500200;202012;2261;5340;1641;4308;173;466;995;2526;1168;2992
500210;202012;4492;10705;3167;8971;855;2357;1396;4098;2251;6455
500215;202012;1358;3726;977;3033;101;345;548;1682;649;2027
500220;202012;2693;7518;1717;5577;279;968;476;1471;755;2439
500230;202012;1926;4485;1462;3844;167;409;996;2601;1163;3010
500240;202012;3851;11276;2700;8851;406;1464;1125;3756;1531;5220
500260;202012;3202;6786;2044;5200;272;702;1096;2674;1368;3376
500270;202012;132012;308617;79007;218840;12728;38890;30403;78684;43131;117574
500280;202012;1299;3260;885;2620;139;424;453;1338;592;1762
500290;202012;3459;8264;2034;5781;298;993;673;1678;971;2671
500295;202012;3442;8244;2159;5965;338;1038;863;2060;1201;3098
500310;202012;946;1971;637;1580;93;207;331;849;424;1056
500315;202012;3716;10154;2950;9006;241;756;2143;6662;2384;7418
500320;202012;18758;50191;12951;40532;3282;10771;4475;14929;7757;25700
500325;202012;4178;9319;2870;7590;215;596;1957;5222;2172;5818
500330;202012;6425;14574;4232;11407;354;1042;2281;6339;2635;7381
500345;202012;2023;4952;1342;3885;307;929;456;1312;763;2241
500348;202012;2308;5994;1726;4975;242;737;988;2878;1230;3615
500350;202012;1297;3530;712;2235;85;267;297;892;382;1159
500370;202012;25834;65664;18198;53137;2316;7771;9849;28286;12165;36057
500375;202012;2361;6225;1544;4537;274;870;530;1455;804;2325
500380;202012;3203;8023;2194;6277;610;1895;479;1397;1089;3292
500390;202012;606;1253;361;951;50;161;222;551;272;712
500400;202012;1498;3786;988;2800;170;536;351;890;521;1426
500410;202012;2340;5742;1644;4703;172;481;939;2811;1111;3292
500430;202012;2497;6130;1704;4933;223;774;744;2251;967;3025
500440;202012;1177;2856;736;2172;114;372;269;854;383;1226
500450;202012;1446;3511;819;2391;135;429;223;592;358;1021
500460;202012;3427;9242;2065;6512;341;1227;663;2030;1004;3257
500470;202012;2327;6240;1400;4330;393;1355;307;819;700;2174
500480;202012;2041;6242;1726;5738;169;578;1290;4352;1459;4930
500490;202012;1014;2326;596;1701;118;410;166;481;284;891
500500;202012;4055;10802;2575;8351;871;3287;375;1256;1246;4543
500510;202012;661;1665;431;1231;28;87;274;764;302;851
500515;202012;1649;4240;1266;3621;137;432;796;2174;933;2606
500520;202012;3133;9479;2419;8185;627;2111;1002;3688;1629;5799
500525;202012;897;2607;711;2331;56;197;464;1518;520;1715
500540;202012;4225;10979;2553;8018;671;2665;236;669;907;3334
500560;202012;5292;14395;4226;13050;281;873;3389;10683;3670;11556
500568;202012;4179;9171;2564;6784;646;1753;894;2407;1540;4160
500570;202012;7453;17258;4613;12457;802;2364;1832;4616;2634;6980
500580;202012;2935;7793;2111;6333;489;1509;965;2928;1454;4437
500600;202012;3297;8200;2340;6657;526;1556;969;2820;1495;4376
500620;202012;7672;19969;5161;15209;1031;3196;1983;5618;3014;8814
500625;202012;534;1461;342;1053;64;203;90;261;154;464
500627;202012;709;1850;434;1349;80;273;144;420;224;693
500630;202012;6518;14877;3734;10277;739;2238;1109;3045;1848;5283
500635;202012;2892;9003;2230;8148;167;640;1540;6188;1707;6828
500640;202012;1656;3614;1089;2859;37;111;742;1925;779;2036
500660;202012;17085;43522;11698;35746;3636;12688;2964;9287;6600;21975
500690;202012;2256;6225;1454;4845;501;1937;77;205;578;2142
500710;202012;2702;7214;2074;6156;577;1830;681;1890;1258;3720
500720;202012;4672;11708;3016;8922;683;2148;932;2853;1615;5001
500730;202012;1067;2630;570;1709;116;332;138;458;254;790
500740;202012;4418;10500;3011;8296;387;1126;1580;4301;1967;5427
500750;202012;942;2397;631;1849;81;217;240;658;321;875
500755;202012;883;2275;483;1512;89;301;105;295;194;596
500769;202012;4901;11929;2675;7744;513;1670;350;844;863;2514
500770;202012;1381;3732;907;2897;157;582;308;968;465;1550
500780;202012;1151;2779;737;2089;147;476;198;513;345;989
500790;202012;6596;17690;5095;15147;1048;3349;2497;7463;3545;10812
500793;202012;2003;5116;1433;4131;347;1063;482;1282;829;2345
500795;202012;2691;6616;2153;5933;111;280;1716;4984;1827;5264
500797;202012;698;1751;432;1262;129;385;130;386;259;771
500800;202012;3173;7090;1927;5251;605;1956;196;583;801;2539
500830;202012;17307;43011;11824;32944;2455;7336;4350;11453;6805;18789
500840;202012;1330;3248;831;2304;105;297;330;857;435;1154
510010;202012;1751;3947;1173;3213;114;274;835;2328;949;2602
510020;202012;3534;8836;1795;5399;353;1162;439;1162;792;2324
510025;202012;6251;15086;3754;11063;545;1798;1615;4634;2160;6432
510030;202012;2504;5584;1654;4307;333;871;670;1711;1003;2582
510035;202012;1201;3121;758;2425;83;288;455;1548;538;1836
510040;202012;2271;5054;1676;4284;180;443;1040;2788;1220;3231
510050;202012;2063;4292;1370;3414;164;427;955;2357;1119;2784
510060;202012;1357;3386;852;2475;177;567;213;577;390;1144
510080;202012;1194;3119;748;2383;239;792;217;616;456;1408
510100;202012;612;1439;424;1141;53;148;229;595;282;743
510120;202012;269;487;145;339;11;24;106;251;117;275
510125;202012;1867;4626;1464;4064;145;531;796;2072;941;2603
510130;202012;1405;3505;975;2811;205;652;301;902;506;1554
510140;202012;2942;7491;1981;6281;690;2570;740;2226;1430;4796
510160;202012;1673;4292;1230;3722;159;463;885;2747;1044;3210
510170;202012;4214;11154;3090;9326;751;2391;1216;3771;1967;6162
510180;202012;14271;31797;9095;24292;1977;5774;2797;8413;4774;14187
510185;202012;1700;4369;1085;3487;428;1397;259;1103;687;2500
510190;202012;1963;5577;1243;4377;351;1363;216;853;567;2216
510250;202012;16610;41716;12184;35026;2388;7178;5975;17853;8363;25031
510260;202012;1803;7681;1496;7138;246;1280;930;4795;1176;6075
510263;202012;3007;8371;1824;5933;298;1083;320;904;618;1987
510267;202012;4733;13381;2653;8738;475;1676;384;1140;859;2816
510268;202012;1171;2877;902;2470;100;255;610;1677;710;1932
510269;202012;972;2617;584;1872;139;496;185;555;324;1051
510270;202012;2929;8265;1988;6555;338;1264;828;2692;1166;3956
510279;202012;1672;4287;1016;3149;182;639;428;1267;610;1906
510285;202012;1094;2872;728;2230;235;802;158;437;393;1239
510300;202012;3490;8843;2559;7581;366;1120;1496;4650;1862;5770
510305;202012;1371;3767;830;2707;178;613;193;710;371;1323
510310;202012;833;2029;561;1581;152;445;162;486;314;931
510320;202012;3453;8533;2367;6681;515;1616;589;1647;1104;3263
510325;202012;4098;12021;2989;9954;849;2994;845;2905;1694;5899
510330;202012;2538;7686;1693;6178;314;1150;630;2706;944;3856
510335;202012;4771;13622;3590;11724;545;1914;2022;6762;2567;8676
510336;202012;425;1190;304;1002;51;164;158;579;209;743
510337;202012;1419;4075;897;3124;348;1341;186;654;534;1995
510340;202012;88255;195402;56088;148962;13742;42936;16816;42183;30558;85119
510343;202012;931;2570;644;2038;112;401;283;854;395;1255
510345;202012;1215;3466;918;2883;151;479;416;1280;567;1759
510350;202012;2736;7001;1787;5398;369;1208;746;2169;1115;3377
510360;202012;1840;3814;1192;3057;70;131;826;2296;896;2427
510370;202012;1681;4731;1244;4023;177;633;741;2503;918;3136
510380;202012;524;1295;301;915;48;173;120;364;168;537
510385;202012;1178;3942;876;3372;88;391;572;2273;660;2664
510390;202012;1227;3193;823;2688;250;828;265;1021;515;1849
510395;202012;706;1597;476;1256;26;72;299;842;325;914
510410;202012;4560;12567;3303;10361;629;2074;1722;5619;2351;7693
510420;202012;2448;5058;1632;3980;122;310;1062;2588;1184;2898
510450;202012;388;979;225;661;54;158;33;116;87;274
510452;202012;776;2151;559;1750;81;267;321;976;402;1243
510454;202012;898;2458;696;2111;74;225;435;1378;509;1603
510455;202012;924;2519;664;2001;113;364;279;786;392;1150
510460;202012;1675;4165;1206;3470;95;332;787;2185;882;2517
510480;202012;4495;10720;2952;7932;545;1618;1176;3112;1721;4730
510490;202012;1652;4223;1234;3706;169;503;819;2485;988;2988
510500;202012;1465;3640;906;2747;180;577;308;947;488;1524
510510;202012;3367;9689;2431;8033;585;2193;783;2741;1368;4934
510515;202012;5067;12834;3326;9739;758;2513;933;2393;1691;4906
510517;202012;1004;2888;752;2453;232;847;137;396;369;1243
510520;202012;2090;4208;1167;3056;100;260;581;1640;681;1900
510523;202012;1114;2679;823;2236;174;455;478;1340;652;1795
510525;202012;7129;19364;5258;15690;798;2616;2541;7165;3339;9781
510530;202012;537;1372;390;1155;28;89;254;742;282;831
510550;202012;2178;6467;1576;5429;358;1294;720;2498;1078;3792
510558;202012;2273;6050;1636;5046;225;639;745;2542;970;3181
510560;202012;1460;4175;877;3010;181;703;218;817;399;1520
510562;202012;5435;13994;3982;11413;962;2986;1320;3987;2282;6973
510590;202012;2955;7378;2179;6364;169;508;1562;4674;1731;5182
510600;202012;1284;2933;851;2302;151;413;396;1074;547;1487
510610;202012;2483;5982;1697;4976;164;541;1085;3203;1249;3744
510615;202012;2524;6258;1772;5056;285;865;973;2832;1258;3697
510617;202012;949;2877;734;2530;97;385;477;1687;574;2072
510618;202012;1149;3027;806;2453;182;602;376;1096;558;1698
510619;202012;739;1829;467;1372;62;189;140;392;202;581
510620;202012;1400;3141;646;1909;174;629;34;71;208;700
510621;202012;1505;4042;902;2864;192;696;287;831;479;1527
510622;202012;4441;12336;3001;9327;973;3272;415;1189;1388;4461
510623;202012;2560;6350;1832;5200;462;1502;599;1652;1061;3154
510624;202012;1568;3990;749;2465;94;344;184;543;278;887
510625;202012;2803;6775;1466;4378;242;864;332;998;574;1862
510626;202012;1398;3401;869;2554;231;783;202;612;433;1395
510627;202012;606;1552;328;1016;79;270;80;263;159;533
510628;202012;1381;3193;914;2569;176;528;349;963;525;1491
510629;202012;1512;4261;1094;3492;214;732;397;1268;611;2000
510630;202012;3290;9024;1905;6397;437;1563;346;1256;783;2819
510631;202012;563;1338;412;1112;13;30;315;879;328;909
510637;202012;3515;8308;2462;6774;621;1925;687;1913;1308;3838
510642;202012;5197;14727;3925;12799;918;3283;1762;5822;2680;9105
510645;202012;964;1832;572;1339;180;387;220;543;400;930
510650;202012;6882;17546;5432;15948;627;1665;3709;12086;4336;13751
510665;202012;1791;3874;1127;2810;244;574;417;1132;661;1706
510670;202012;430;918;247;652;26;68;137;369;163;437
510675;202012;6059;16569;4141;12993;1157;3989;806;2412;1963;6401
510677;202012;2058;5217;1409;4250;189;665;769;2262;958;2927
510680;202012;668;1694;373;1139;74;252;81;217;155;469
510682;202012;1408;4132;1032;3517;355;1356;247;810;602;2166
510685;202012;462;1356;336;1103;53;187;180;588;233;775
510700;202012;3909;9328;2732;7704;240;743;2051;5774;2291;6517
510704;202012;10191;23858;6708;17903;1552;4419;1699;4457;3251;8876
510706;202012;1994;5912;1387;4894;263;947;731;2807;994;3754
510710;202012;2551;6355;1673;4684;367;1088;553;1490;920;2578
510715;202012;567;1224;407;1003;30;95;213;512;243;607
510718;202012;2267;5103;1321;3826;362;1053;490;1708;852;2761
510719;202012;446;937;258;686;25;72;149;376;174;448
510720;202012;804;1893;542;1495;89;280;267;698;356;978
510724;202012;782;2103;539;1645;74;235;300;892;374;1127
510726;202012;1024;1855;536;1267;65;171;256;612;321;783
510729;202012;578;1345;256;737;30;103;64;203;94;306
510730;202012;2824;6767;1901;5363;240;778;983;2692;1223;3470
510735;202012;1000;2833;758;2496;70;288;561;1832;631;2120
510740;202012;906;2231;576;1613;103;293;265;733;368;1026
510757;202012;471;1502;371;1349;114;468;144;496;258;964
510760;202012;41835;91225;24848;65356;5023;15218;7970;19316;12993;34534
510770;202012;4091;9271;2788;7621;213;561;1926;5489;2139;6050
510774;202012;338;846;237;687;32;93;130;387;162;480
510775;202012;597;1578;376;1216;77;276;83;249;160;525
510776;202012;413;1034;286;803;65;178;104;310;169;488
510777;202012;1444;3862;1023;3318;146;544;653;2105;799;2649
510779;202012;678;1823;522;1572;58;166;299;987;357;1153
510780;202012;3586;9161;2640;7812;641;1862;1148;3834;1789;5696
510785;202012;1865;4882;1088;3505;297;1038;181;665;478;1703
510787;202012;2541;7135;1671;5338;510;1741;194;636;704;2377
510788;202012;565;1353;403;1099;61;177;191;595;252;772
510790;202012;17086;43498;10552;31594;2307;7731;1893;5058;4200;12789
510792;202012;8689;23837;5361;17292;1160;4203;887;2562;2047;6765
510794;202012;1115;2998;761;2386;253;871;147;408;400;1279
510795;202012;7830;20318;5088;15382;1143;3837;1393;4109;2536;7946
510800;202012;1591;4058;1025;3120;322;1009;122;363;444;1372
510805;202012;1394;3891;984;3128;232;797;340;986;572;1783
510810;202012;592;1206;366;906;102;254;142;378;244;632
510820;202012;732;1385;406;971;33;96;210;512;243;608
510830;202012;789;1907;565;1624;39;116;418;1273;457;1389
510835;202012;523;1257;348;1007;40;134;216;606;256;740
510840;202012;54561;114202;36653;92346;7210;17041;17800;49779;25010;66820
510850;202012;1681;4024;959;2878;317;1084;118;321;435;1405
510860;202012;2115;5574;1284;4154;394;1494;108;354;502;1848
510880;202012;713;2001;533;1662;130;426;194;606;324;1032
510885;202012;618;1459;403;1150;75;229;134;386;209;615
510890;202012;621;1795;456;1507;111;383;199;666;310;1049
510895;202012;1250;3151;820;2446;152;544;363;1014;515;1558
520005;202012;2570;6494;1971;5757;579;1695;802;2734;1381;4429
520010;202012;2225;6297;1589;5076;395;1385;504;1438;899;2823
520013;202012;2714;6895;1765;5158;390;1178;499;1597;889;2775
520015;202012;487;1215;348;1011;82;240;140;427;222;667
520017;202012;1165;2906;863;2440;187;558;430;1207;617;1765
520020;202012;388;855;295;742;23;73;233;563;256;636
520025;202012;32297;89873;27621;83301;2741;8942;19938;59860;22679;68802
520030;202012;5547;13925;4441;12382;299;906;3192;8867;3491;9773
520050;202012;386;909;239;655;14;39;153;432;167;471
520055;202012;1757;4208;1127;2985;110;275;639;1661;749;1936
520060;202012;1408;3756;1028;3076;244;840;298;857;542;1697
520080;202012;1709;4491;1301;3933;229;703;645;2125;874;2828
520082;202012;917;2303;712;1963;73;197;385;1106;458;1303
520085;202012;804;2112;620;1819;110;339;312;904;422;1243
520090;202012;818;1597;562;1320;67;110;422;1052;489;1162
520110;202012;36102;96419;24722;77360;7434;26625;2260;6448;9694;33073
520120;202012;192;458;108;319;11;41;46;133;57;174
520130;202012;3624;8788;2833;7575;575;1537;1219;3362;1794;4899
520140;202012;38594;101969;26363;81024;9351;31276;3450;11094;12801;42370
520145;202012;599;1339;410;1080;61;180;246;597;307;777
520150;202012;614;1389;451;1197;71;192;249;670;320;862
520160;202012;703;1627;509;1332;106;263;218;623;324;886
520170;202012;4633;9345;3070;7577;158;454;2382;5832;2540;6286
520180;202012;2187;5893;1782;5317;318;1033;991;2930;1309;3963
520215;202012;1649;3941;1154;3178;272;799;392;1036;664;1835
520235;202012;574;1309;325;930;34;120;126;348;160;468
520250;202012;1453;3672;1017;2945;322;1003;246;787;568;1790
520260;202012;780;1804;502;1366;95;268;206;574;301;842
520280;202012;703;1701;548;1466;113;308;263;751;376;1059
520310;202012;996;2157;655;1654;141;401;258;687;399;1088
520320;202012;1562;4185;1166;3528;152;501;646;1898;798;2399
520330;202012;3902;10328;2822;8574;397;1435;1524;4518;1921;5953
520340;202012;2444;5355;1519;4068;185;467;880;2475;1065;2942
520350;202012;2655;6313;1897;5190;549;1580;756;2099;1305;3679
520355;202012;1818;4946;1291;3909;442;1440;248;642;690;2082
520357;202012;711;1696;509;1400;29;70;379;1085;408;1155
520360;202012;671;1760;518;1504;136;414;158;487;294;901
520380;202012;1371;3391;804;2338;86;262;404;1100;490;1362
520390;202012;979;2129;570;1623;155;474;196;609;351;1083
520393;202012;479;1143;318;890;39;123;146;385;185;508
520396;202012;832;2124;693;1912;40;130;514;1388;554;1518
520400;202012;1585;3857;1225;3368;150;459;846;2306;996;2765
520410;202012;1842;4197;1124;3083;195;574;434;1139;629;1713
520420;202012;360;828;282;711;20;54;221;532;241;586
520425;202012;1353;3279;737;2140;185;567;133;372;318;939
520430;202012;2227;5060;1255;3556;223;744;37;102;260;846
520440;202012;2799;6747;1684;4785;404;1256;443;1193;847;2449
520450;202012;11400;26716;7558;20969;2336;7147;1562;4525;3898;11672
520455;202012;680;1866;491;1574;140;475;135;458;275;933
520460;202012;1000;2311;775;2025;64;147;632;1677;696;1824
520465;202012;714;1816;576;1631;72;241;417;1137;489;1378
520470;202012;1972;5086;1497;4449;468;1458;556;1770;1024;3228
520480;202012;884;2412;611;1955;193;642;150;492;343;1134
520485;202012;1513;4300;1256;3946;148;472;905;2839;1053;3311
520490;202012;3869;10619;2910;9079;991;3196;1041;3395;2032;6591
520495;202012;1544;3399;1181;2907;50;128;966;2371;1016;2499
520500;202012;1143;3088;773;2364;182;597;324;991;506;1588
520505;202012;763;1670;524;1371;59;165;342;884;401;1049
520510;202012;7156;17663;4762;14002;1054;3466;1438;4491;2492;7957
520520;202012;1132;2822;833;2354;197;601;304;862;501;1463
520530;202012;2006;5590;1533;4812;394;1322;680;2188;1074;3510
520540;202012;2798;7251;1766;5241;319;1032;479;1322;798;2354
520545;202012;898;2326;672;1953;139;405;279;824;418;1229
520547;202012;775;2105;623;1846;152;463;312;921;464;1384
520549;202012;13371;35250;11127;32048;1416;4338;7676;21917;9092;26255
520551;202012;4416;11820;3659;10697;370;1256;2627;7512;2997;8768
520552;202012;798;2047;657;1866;138;383;377;1143;515;1526
520570;202012;490;1091;331;869;84;192;129;390;213;582
520580;202012;2143;4859;1624;4251;113;357;1208;3106;1321;3463
520590;202012;1235;3029;852;2415;279;797;223;657;502;1454
520620;202012;7528;20420;5928;18048;1470;4662;2628;8321;4098;12983
520630;202012;681;1765;492;1429;86;264;156;422;242;686
520640;202012;2273;5569;1717;4607;398;1042;744;2078;1142;3120
520650;202012;842;1931;629;1641;90;237;354;980;444;1217
520660;202012;511;1235;275;822;49;163;77;237;126;400
520670;202012;924;2477;776;2264;61;190;527;1508;588;1698
520680;202012;649;1654;500;1424;73;204;266;771;339;975
520690;202012;289;676;196;538;58;147;59;183;117;330
520710;202012;389;948;279;764;12;29;200;540;212;569
520725;202012;1413;3325;971;2616;108;338;614;1593;722;1931
520735;202012;716;1770;472;1361;100;272;181;564;281;836
520740;202012;2033;4543;1537;3965;261;624;878;2460;1139;3084
520750;202012;645;1542;440;1213;79;212;209;584;288;796
520753;202012;1183;3201;894;2662;175;558;363;1000;538;1558
520760;202012;1190;2659;1045;2485;29;54;960;2317;989;2371
520780;202012;1388;3267;1009;2731;115;307;521;1410;636;1717
520790;202012;3330;7880;2353;6295;345;945;1252;3507;1597;4452
520800;202012;15564;40281;12161;35232;1784;5398;7267;21571;9051;26969
520810;202012;1270;2672;953;2309;158;389;616;1580;774;1969
520815;202012;525;1621;400;1354;75;275;118;408;193;683
520830;202012;1846;3852;1302;3235;54;106;1074;2670;1128;2776
520840;202012;2525;6736;2045;6110;851;2765;555;1770;1406;4535
520850;202012;623;1565;462;1331;145;488;133;382;278;870
520860;202012;6260;16672;4558;13903;1231;4083;1662;4951;2893;9034
520870;202012;103093;237433;69018;186460;14757;43231;25228;66991;39985;110222
520880;202012;6531;18705;5004;15922;1114;3709;1915;6138;3029;9847
520890;202012;3824;9112;2588;7177;496;1515;1162;3176;1658;4691
520910;202012;4520;11286;2853;8396;682;2183;696;1981;1378;4164
520915;202012;693;1943;401;1276;72;247;135;411;207;658
520920;202012;4328;9661;3031;8029;400;1091;1635;4530;2035;5621
520929;202012;658;1534;495;1299;63;134;265;748;328;882
520940;202012;901;2402;706;2128;39;112;526;1564;565;1676
520945;202012;479;1046;377;906;15;36;270;638;285;674
520960;202012;1043;2469;818;2129;196;451;422;1166;618;1617
520970;202012;2420;6581;1881;5709;455;1557;490;1616;945;3173
520980;202012;742;1808;542;1538;90;269;225;621;315;890
520990;202012;2927;7738;2326;6964;339;972;1540;4708;1879;5680
520993;202012;1119;2625;769;2082;113;346;432;1113;545;1459
520995;202012;2232;5623;1656;4810;256;751;655;1986;911;2737
521000;202012;8274;21445;5400;16263;1054;3285;1667;4985;2721;8270
521010;202012;3430;8892;2565;7385;242;694;1519;4349;1761;5043
521015;202012;773;1903;536;1483;39;125;339;893;378;1018
521020;202012;3166;7993;1825;5399;539;1802;128;399;667;2201
521030;202012;499;1087;336;839;73;160;137;372;210;532
521040;202012;7376;17989;5418;14901;1169;3346;2266;6399;3435;9745
521056;202012;893;2332;697;2043;216;625;196;648;412;1273
521060;202012;937;2500;688;2034;109;340;286;842;395;1182
521080;202012;1091;2340;561;1514;80;235;238;561;318;796
521090;202012;3077;8221;2050;6156;547;1766;265;841;812;2607
521100;202012;1635;3829;1198;3208;189;488;730;1994;919;2482
521120;202012;4386;10437;3226;8992;178;464;1607;5206;1785;5670
521130;202012;963;2142;540;1418;17;50;285;798;302;848
521140;202012;1212;3102;886;2530;110;329;437;1266;547;1595
521150;202012;11870;25809;7320;19315;1207;3698;3482;9417;4689;13115
521160;202012;599;1246;428;997;50;109;285;647;335;756
521170;202012;982;2290;713;1891;53;149;472;1218;525;1367
521180;202012;7095;19370;5801;17144;929;2996;3066;8805;3995;11801
521190;202012;10466;25709;6034;18297;1516;4939;1264;4056;2780;8995
521200;202012;676;1626;471;1296;45;130;276;764;321;894
521205;202012;614;1500;459;1251;16;49;353;923;369;972
521210;202012;629;1601;363;1071;70;224;73;164;143;388
521220;202012;3421;8276;2217;6418;361;1156;880;2556;1241;3712
521225;202012;378;795;276;684;51;118;155;401;206;519
521230;202012;1293;3268;1140;3082;354;959;569;1663;923;2622
521250;202012;29316;77557;22672;67733;8306;25864;6711;21539;15017;47403
521260;202012;514;1201;378;982;56;143;220;559;276;702
521270;202012;1783;4437;1555;4172;77;178;1213;3278;1290;3456
521280;202012;1718;4591;1280;3863;302;1006;553;1686;855;2692
521290;202012;468;1084;323;899;41;134;207;561;248;695
521295;202012;1081;2361;838;2098;63;109;701;1810;764;1919
521300;202012;1834;4482;1440;3923;271;684;895;2534;1166;3218
521305;202012;704;1649;495;1343;75;185;284;785;359;970
521308;202012;4659;12356;3199;9594;299;880;1893;5586;2192;6466
521310;202012;7732;19700;5405;15807;1153;3705;2350;6577;3503;10282
521340;202012;389;900;281;746;21;58;184;482;205;540
521350;202012;1977;5012;1495;4293;126;457;1064;2905;1190;3362
521370;202012;1189;3006;698;2161;206;727;89;303;295;1030
521375;202012;1193;2886;806;2326;186;536;246;798;432;1334
521377;202012;1469;3098;1082;2624;99;168;866;2214;965;2382
521380;202012;6012;15792;3830;11759;420;1413;1011;3344;1431;4757
521385;202012;626;1494;486;1313;50;128;282;824;332;952
521390;202012;681;1661;467;1348;136;430;177;536;313;966
521400;202012;2571;5944;2001;5254;217;543;1385;3747;1602;4290
521405;202012;1281;3273;922;2638;162;482;467;1316;629;1798
521410;202012;779;2087;573;1723;95;277;289;922;384;1199
521440;202012;1099;2721;786;2257;265;838;221;649;486;1487
521450;202012;3823;11230;2780;9211;737;2442;701;2537;1438;4979
521460;202012;5364;14004;3721;11088;1224;3818;882;2705;2106;6523
521470;202012;566;1492;338;1035;45;125;109;334;154;459
521480;202012;350;878;210;616;46;133;68;194;114;327
521483;202012;2302;5437;1597;4378;333;977;649;1755;982;2732
521486;202012;1728;4091;1298;3486;85;215;924;2483;1009;2698
521487;202012;388;932;267;766;41;117;140;414;181;531
521490;202012;881;2318;657;1953;38;132;447;1284;485;1416
521500;202012;2187;5244;1627;4400;95;311;1200;3168;1295;3479
521520;202012;705;1637;500;1338;73;200;205;563;278;763
521523;202012;11541;34751;9396;31291;2641;9621;2445;8462;5086;18083
521525;202012;1034;2339;782;1992;84;213;561;1430;645;1643
521530;202012;2181;5565;1302;3810;270;813;366;1075;636;1888
521540;202012;816;2030;560;1624;72;236;279;836;351;1072
521550;202012;1560;3956;838;2477;146;497;223;669;369;1166
521560;202012;4370;11349;2978;9469;443;1626;1510;5138;1953;6764
521565;202012;630;1498;480;1291;71;176;295;785;366;961
521570;202012;3154;8675;2129;6665;420;1553;179;596;599;2149
521580;202012;471;1126;267;780;37;113;87;234;124;347
521590;202012;614;1434;451;1209;77;229;267;698;344;927
521600;202012;365;972;236;719;29;71;111;336;140;407
521630;202012;1640;3553;1000;2623;203;577;341;874;544;1451
521640;202012;1783;4088;1171;3211;251;731;419;1128;670;1859
521645;202012;542;1392;341;1024;83;238;105;313;188;551
521680;202012;1062;3202;809;2713;233;849;136;504;369;1353
521690;202012;535;1279;443;1158;59;167;284;726;343;893
521710;202012;3090;7586;1963;5747;357;1197;521;1399;878;2596
521720;202012;2113;4855;1356;3722;133;416;769;2121;902;2537
521730;202012;3409;9358;2594;7944;698;2552;776;1980;1474;4532
521740;202012;3699;9566;2776;8226;646;2075;1052;3285;1698;5360
521760;202012;14093;38272;10797;33217;2704;9196;4086;13233;6790;22429
521770;202012;2990;7047;1926;5352;560;1673;498;1420;1058;3093
521800;202012;6296;16665;4545;13766;993;3070;1876;6168;2869;9238
521805;202012;444;1090;340;940;101;250;150;428;251;678
521810;202012;596;1402;422;1166;56;160;258;718;314;878
521830;202012;5398;14834;4269;13087;276;1025;3094;9307;3370;10332
521839;202012;719;1693;506;1347;81;250;283;674;364;924
521850;202012;5194;11992;3248;9111;559;1771;664;1794;1223;3565
521860;202012;1436;3817;989;3018;180;600;309;922;489;1522
521870;202012;668;1857;474;1474;94;327;127;352;221;679
521878;202012;636;1636;433;1238;54;183;239;616;293;799
521880;202012;17726;43039;11981;34110;3008;8990;4336;12536;7344;21526
521890;202012;2944;7620;1948;5866;540;1779;380;1048;920;2827
521900;202012;1436;3325;792;2334;229;645;79;238;308;883
521910;202012;1204;2537;787;2048;71;189;440;1258;511;1447
521920;202012;483;1306;351;1079;60;208;158;466;218;674
521925;202012;734;1879;530;1575;75;236;302;896;377;1132
521930;202012;5237;12435;3425;9680;869;2319;1285;4085;2154;6404
521935;202012;1041;2462;694;1852;65;188;407;1034;472;1222
521940;202012;1284;2785;814;2158;190;560;334;870;524;1430
521945;202012;624;1628;501;1425;106;306;268;785;374;1091
521950;202012;731;1751;504;1395;124;347;204;554;328;901
521960;202012;702;1808;458;1349;53;170;240;655;293;825
521970;202012;2473;6059;1970;5458;161;438;1497;4197;1658;4635
521971;202012;718;1683;507;1363;149;398;149;407;298;805
521973;202012;1367;3503;1101;3127;40;105;884;2501;924;2606
521975;202012;11498;30235;9395;27287;1577;4717;5821;17018;7398;21735
521980;202012;2473;5790;1904;5036;146;382;1439;3903;1585;4285
521990;202012;1013;2877;806;2505;182;596;290;900;472;1496
522000;202012;2551;6665;2051;6053;309;915;1264;3911;1573;4826
522005;202012;319;771;236;646;46;126;118;328;164;454
522010;202012;3894;9396;2732;7526;574;1747;1049;2789;1623;4536
522015;202012;991;2562;724;2151;232;668;265;823;497;1491
522020;202012;5424;12754;3501;9716;710;2073;1385;4004;2095;6077
522026;202012;752;1979;496;1524;88;298;181;513;269;811
522028;202012;406;985;300;816;70;194;128;355;198;549
522040;202012;3017;6753;2141;5587;265;745;1462;3762;1727;4507
522045;202012;16777;46159;12280;38165;2909;9748;3425;10401;6334;20149
522050;202012;1069;2791;728;2201;199;666;261;691;460;1357
522060;202012;2874;7476;1995;6004;176;543;1152;3571;1328;4114
522068;202012;1734;4436;1373;4002;113;306;1090;3216;1203;3522
522070;202012;636;1518;517;1345;18;50;434;1114;452;1164
522100;202012;712;1803;482;1448;61;209;255;733;316;942
522108;202012;1025;2532;800;2213;58;190;642;1728;700;1918
522119;202012;1586;3805;1207;3307;201;562;604;1787;805;2349
522130;202012;388;996;276;839;24;72;196;612;220;684
522140;202012;18164;47228;12488;37058;3129;9925;3422;9789;6551;19714
522145;202012;761;1881;518;1513;142;407;184;542;326;949
522150;202012;1000;2458;715;1995;194;545;219;643;413;1188
522155;202012;1065;2656;815;2260;157;384;461;1335;618;1719
522157;202012;587;1374;482;1241;27;82;381;985;408;1067
522160;202012;5612;14385;3595;10682;982;3150;295;965;1277;4115
522170;202012;2520;6409;1889;5475;278;821;1084;3198;1362;4019
522180;202012;538;1252;338;884;58;159;84;234;142;393
522185;202012;19115;46720;13390;38842;5187;16422;2742;8668;7929;25090
522190;202012;744;1767;495;1336;87;249;204;533;291;782
522200;202012;1543;4369;1021;3390;210;764;193;579;403;1343
522205;202012;1673;3882;1271;3342;144;403;850;2243;994;2646
522220;202012;1251;3073;924;2577;111;325;552;1561;663;1886
522230;202012;1106;2762;874;2433;195;663;429;1108;624;1771
530010;202012;161573;430650;129421;383639;19267;62669;77778;226919;97045;289588
110001;202011;3856;10733;2569;8338;591;2072;1005;3327;1596;5399
110002;202011;12444;32128;8888;26001;2416;7549;2380;7103;4796;14652
110003;202011;561;1663;413;1350;104;360;114;358;218;718
110004;202011;11296;29093;7494;22333;1557;5077;2204;6696;3761;11773
110005;202011;2441;6279;1681;5044;344;1124;451;1474;795;2598
110006;202011;1719;4778;1049;3345;186;687;213;645;399;1332
110007;202011;1204;3065;758;2314;241;792;184;694;425;1486
110008;202011;3262;8932;2395;7627;271;838;1583;5394;1854;6232
110009;202011;4233;11795;2718;9033;568;2001;1109;3733;1677;5734
110010;202011;7733;24386;5617;20223;1106;4057;2775;10809;3881;14866
110011;202011;6874;18157;4603;14012;1574;5066;625;2005;2199;7071
110012;202011;15334;38282;8979;26975;2001;6617;778;2535;2779;9152
110013;202011;5144;14858;3592;11664;1425;4906;439;1602;1864;6508
110014;202011;3782;9918;2613;7695;553;1748;1120;3181;1673;4929
110015;202011;5588;14327;3305;9862;713;2333;796;2188;1509;4521
110018;202011;3687;9273;2093;6434;397;1413;568;1747;965;3160
110020;202011;72421;172787;52075;144819;11579;33256;21340;65684;32919;98940
110025;202011;5103;12273;3403;9353;688;2010;1515;4177;2203;6187
110026;202011;514;1275;368;1068;81;270;152;464;233;734
110028;202011;6659;16777;3927;11840;974;3214;599;1835;1573;5049
110029;202011;1498;3649;861;2525;190;574;305;939;495;1513
110030;202011;12310;28190;7487;20958;1557;5105;1356;4190;2913;9295
110032;202011;3105;8702;1852;6014;574;1865;369;1312;943;3177
110033;202011;3456;10649;2595;9067;928;3289;670;2627;1598;5916
110034;202011;3264;7635;2163;6112;657;2086;720;2219;1377;4305
110037;202011;1608;4725;1202;4010;265;863;589;2038;854;2901
110040;202011;2844;7888;2046;6415;582;1971;642;1974;1224;3945
110045;202011;4835;13866;3530;11445;914;3191;1223;4070;2137;7261
110050;202011;1796;4847;1264;3926;489;1674;206;662;695;2336
110060;202011;853;2529;586;1891;197;690;73;236;270;926
110070;202011;1493;4687;1083;3764;342;1262;225;710;567;1972
110080;202011;6241;14505;4666;12624;654;1651;3051;8831;3705;10482
110090;202011;579;1544;394;1208;88;296;177;537;265;833
110092;202011;1146;3307;813;2687;145;496;406;1455;551;1951
110094;202011;2689;8047;2016;6743;848;3023;268;916;1116;3939
110100;202011;1671;4927;1325;4246;362;1232;554;1806;916;3038
110110;202011;1673;4576;1170;3745;387;1276;258;925;645;2201
110120;202011;1288;3705;974;3087;231;812;336;1031;567;1843
110130;202011;2704;6759;1677;4856;258;836;347;935;605;1771
110140;202011;2029;5965;1377;4611;333;1172;397;1376;730;2548
110143;202011;1324;3631;922;2820;278;868;155;484;433;1352
110145;202011;858;2234;515;1594;116;373;191;608;307;981
110146;202011;455;1187;317;975;65;183;156;517;221;700
110147;202011;751;1952;473;1416;62;210;181;475;243;685
110148;202011;724;1989;425;1393;120;457;49;153;169;610
110149;202011;2991;8159;2046;6620;701;2415;432;1492;1133;3907
110150;202011;2773;6735;1794;5316;528;1716;435;1564;963;3280
110155;202011;714;2092;501;1576;111;376;175;521;286;897
110160;202011;1456;4498;1053;3590;311;1086;252;894;563;1980
110170;202011;2087;5355;1290;3848;229;721;672;1938;901;2659
110175;202011;1631;4538;1153;3693;176;608;512;1728;688;2336
110180;202011;1425;3873;997;3002;134;433;530;1570;664;2003
120001;202011;3224;9450;2634;8576;421;1437;1667;5574;2088;7011
120005;202011;1936;7324;1760;7078;153;679;1413;5763;1566;6442
120010;202011;5291;15731;4464;14497;425;1332;3271;10989;3696;12321
120013;202011;2107;7381;1855;7078;402;1455;1184;4823;1586;6278
120017;202011;2444;7871;2149;7421;348;1201;1362;4988;1710;6189
120020;202011;14937;57303;13746;54995;1034;4653;11014;44311;12048;48964
120025;202011;3073;8650;2455;7914;360;1149;1709;5705;2069;6854
120030;202011;6314;25085;5849;24203;419;2203;4562;19041;4981;21244
120032;202011;1700;7478;1619;7333;104;653;1360;6038;1464;6691
120033;202011;4076;15021;3835;14581;108;631;3379;12697;3487;13328
120034;202011;2657;9619;2270;8941;108;642;1889;7324;1997;7966
120035;202011;3746;14586;3555;14253;290;1377;2929;11730;3219;13107
120038;202011;2632;8433;2228;7769;497;1802;1212;4303;1709;6105
120039;202011;2005;8616;1872;8347;112;717;1526;6731;1638;7448
120040;202011;43266;135413;36647;124605;5039;18134;23018;79407;28057;97541
120042;202011;3366;12347;3114;11882;132;706;2650;10017;2782;10723
120043;202011;1397;5679;1271;5474;38;232;1167;5024;1205;5256
120045;202011;6114;15640;5293;14717;124;500;4817;13254;4941;13754
120050;202011;9213;33379;8438;32202;376;2030;7115;27172;7491;29202
120060;202011;9461;36777;8659;35593;371;2277;7576;30839;7947;33116
120070;202011;3176;10071;2734;9470;257;899;1980;7091;2237;7990
120080;202011;4254;13507;3787;12810;444;1578;2815;9702;3259;11280
130002;202011;3164;12042;2825;11551;198;771;2415;10067;2613;10838
130006;202011;2444;8950;2024;8203;162;657;1547;6314;1709;6971
130008;202011;2643;9295;2350;8866;69;363;2041;7700;2110;8063
130010;202011;3974;11475;3336;10736;80;231;3068;10022;3148;10253
130014;202011;3190;9270;2462;8090;417;1375;1537;5164;1954;6539
130020;202011;2877;11011;2552;10506;132;770;2065;8427;2197;9197
130030;202011;10205;32678;9316;31640;369;1084;8269;28656;8638;29740
130040;202011;4155;12022;3423;11048;204;609;2832;9271;3036;9880
130050;202011;7545;27661;6299;26019;177;862;5713;23846;5890;24708
130060;202011;7608;29754;6517;28336;417;2225;5437;23606;5854;25831
130063;202011;6435;20820;5750;20061;202;856;5244;18386;5446;19242
130068;202011;3903;13344;3299;12471;200;1118;2527;9415;2727;10533
130070;202011;7522;21031;6170;19553;277;827;5107;16741;5384;17568
130080;202011;7278;25697;6395;24675;251;1307;5499;21563;5750;22870
130083;202011;2739;8900;2429;8512;143;571;2076;7318;2219;7889
130090;202011;3531;10883;3138;10397;51;222;2805;9475;2856;9697
130100;202011;8107;24155;6896;22889;71;140;6507;22152;6578;22292
130110;202011;8542;24244;6996;22323;1052;2686;5023;17387;6075;20073
130115;202011;5190;16196;4468;15385;98;344;3974;13876;4072;14220
130120;202011;14036;49591;12339;47307;1055;4456;10060;38954;11115;43410
130130;202011;5500;17070;4228;15389;364;1380;3228;11935;3592;13315
130140;202011;7305;25367;6416;24345;180;1052;5642;21476;5822;22528
130150;202011;3604;13524;3387;13283;77;483;3115;12250;3192;12733
130160;202011;5110;18134;4381;17200;274;1085;3741;15029;4015;16114
130165;202011;3197;12072;3013;11843;123;525;2728;10817;2851;11342
130170;202011;11681;33813;9449;31212;699;2520;7649;25764;8348;28284
130180;202011;4456;14318;4226;14059;41;215;4086;13556;4127;13771
130185;202011;18163;44985;14834;41431;967;1766;12492;37030;13459;38796
130190;202011;18690;61618;15025;56162;1672;6335;10718;41493;12390;47828
130195;202011;2479;8939;1994;8282;76;445;1682;6967;1758;7412
130200;202011;2576;7187;2124;6605;101;394;1787;5522;1888;5916
130210;202011;1355;5075;1227;4925;97;565;1005;3917;1102;4482
130220;202011;2243;7707;1910;7276;43;249;1708;6518;1751;6767
130230;202011;4774;19184;4149;18288;215;1338;3614;15864;3829;17202
130240;202011;12220;36604;9940;33583;175;1037;8953;30244;9128;31281
130250;202011;26209;77758;22461;73519;1599;4769;18199;61872;19798;66641
130255;202011;4515;14746;3938;13751;143;633;3227;11260;3370;11893
130260;202011;257636;711434;208874;641436;56687;184152;96071;306962;152758;491114
130270;202011;9761;34083;8092;31476;1361;5213;5187;21182;6548;26395
130280;202011;3563;14254;3282;13943;78;407;3078;13208;3156;13615
130290;202011;13308;43599;11521;41308;642;2357;9767;35780;10409;38137
130300;202011;4749;16321;4327;15744;143;795;3790;13741;3933;14536
130310;202011;6333;20925;5486;19833;279;1219;4698;16993;4977;18212
130320;202011;3366;10967;2789;10203;372;1313;2044;7757;2416;9070
130330;202011;4616;14734;3728;13655;216;949;3183;11669;3399;12618
130340;202011;23916;72867;20580;69079;1440;4042;17327;60167;18767;64209
130350;202011;3978;14291;3582;13792;148;773;3165;12124;3313;12897
130353;202011;7445;19998;5963;18131;762;2192;4313;13652;5075;15844
130356;202011;5243;16526;4335;15125;787;2648;2614;9729;3401;12377
130360;202011;2893;9600;2509;9056;88;391;2213;7930;2301;8321
130370;202011;5661;22520;4951;21494;304;1666;3986;17270;4290;18936
130380;202011;7244;30062;6720;29304;394;2218;5742;24808;6136;27026
130390;202011;5768;24310;5108;23208;548;2764;3889;17817;4437;20581
130395;202011;2311;7302;1994;6798;184;645;1547;5301;1731;5946
130400;202011;2830;8627;2427;8092;105;320;2173;7370;2278;7690
130406;202011;10855;37592;9057;35399;1691;6610;6071;24753;7762;31363
130410;202011;4300;15099;3655;14007;1075;4345;1680;6618;2755;10963
130420;202011;13803;47600;11479;44674;981;4600;8899;34977;9880;39577
130423;202011;4378;13584;3830;12959;198;834;3353;11266;3551;12100
130426;202011;2766;10988;2575;10764;62;341;2388;10050;2450;10391
130430;202011;4257;11928;3677;11156;235;845;3131;9389;3366;10234
130440;202011;4905;15193;4173;14315;81;364;3877;13362;3958;13726
140002;202011;2204;6476;1914;6124;90;345;1612;5237;1702;5582
140005;202011;3209;8961;2786;8466;131;350;2373;7450;2504;7800
140010;202011;54765;145315;43779;128945;10823;33639;19003;57240;29826;90879
140015;202011;3816;11289;3244;10586;218;692;2838;9418;3056;10110
140017;202011;4387;12133;3810;11401;248;668;3154;9735;3402;10403
140020;202011;5241;15182;4524;14247;242;976;3738;11693;3980;12669
140023;202011;2495;7399;2046;6760;201;661;1554;5271;1755;5932
140028;202011;1999;5166;1696;4783;80;254;1381;3887;1461;4141
140030;202011;5261;13384;4666;12696;327;632;4096;11521;4423;12153
140040;202011;2557;9991;2360;9734;87;540;2150;8741;2237;9281
140045;202011;2546;9409;2132;8841;334;1204;1428;6405;1762;7609
140047;202011;6268;17672;5277;16245;558;1761;3851;12018;4409;13779
140050;202011;1432;4166;1212;3852;115;340;926;3045;1041;3385
140060;202011;1678;4375;1459;4061;111;275;1196;3406;1307;3681
140070;202011;1873;9720;1811;9600;112;794;1537;8053;1649;8847
150010;202011;44893;112473;40609;106990;938;2174;36518;96240;37456;98414
150013;202011;1946;4944;1636;4612;145;282;1288;3872;1433;4154
150020;202011;14420;43142;13332;41728;1644;4305;10659;34640;12303;38945
150030;202011;8842;33114;8039;32122;472;1993;6972;28158;7444;30151
150034;202011;4183;10211;3435;9285;237;565;2860;7921;3097;8486
150040;202011;16236;42203;14315;40072;1274;1952;11996;36526;13270;38478
150050;202011;6939;24105;6340;23314;129;566;5835;21671;5964;22237
150060;202011;22020;59338;17686;52845;2760;8405;11364;34758;14124;43163
150070;202011;6837;25218;6002;24210;236;1084;5372;21894;5608;22978
150080;202011;90857;202508;75101;180752;18550;48838;20981;62219;39531;111057
150085;202011;7808;22334;7098;21494;109;366;6666;20322;6775;20688
150090;202011;9825;36055;9262;34957;783;2873;7367;28151;8150;31024
150095;202011;5646;16307;4940;15433;273;584;4217;13755;4490;14339
150100;202011;2793;9740;2474;9208;201;634;1968;7536;2169;8170
150110;202011;4412;17969;4096;17610;178;817;3781;16370;3959;17187
150120;202011;8126;25153;7705;24661;258;644;6895;22698;7153;23342
150125;202011;757;1984;564;1720;96;357;340;1021;436;1378
150130;202011;22026;63529;19014;58937;3421;9483;12201;40346;15622;49829
150140;202011;258650;590833;217482;533781;32534;77026;125774;321047;158308;398073
150145;202011;4199;13075;3551;12051;964;3027;1802;6887;2766;9914
150150;202011;16070;40952;13982;38286;524;1590;11741;32088;12265;33678
150157;202011;3506;9481;2816;8588;301;902;1986;6344;2287;7246
150160;202011;2975;8752;2768;8456;515;1464;1740;5559;2255;7023
150170;202011;24260;79372;21164;74094;3900;12866;13003;48539;16903;61405
150172;202011;4908;13331;3920;11924;273;735;2944;9278;3217;10013
150175;202011;1601;5027;1343;4532;243;846;778;2665;1021;3511
150178;202011;10341;27818;8634;25834;195;460;7778;23616;7973;24076
150180;202011;22513;79064;20325;76567;1172;3623;17852;69100;19024;72723
150190;202011;6711;22199;6229;21602;221;990;5579;19252;5800;20242
150195;202011;5093;16180;4789;15704;101;477;4372;14189;4473;14666
150200;202011;5851;17090;5354;16536;64;172;5064;15753;5128;15925
150210;202011;26222;90362;24461;88043;1704;5959;20248;75321;21952;81280
150215;202011;7545;21309;6496;19764;1113;3307;3930;12465;5043;15772
150220;202011;12599;35037;11001;32759;1103;3096;7637;23327;8740;26423
150230;202011;12200;34647;10794;32765;1207;3288;7414;23525;8621;26813
150240;202011;32058;88334;26518;78891;6966;21226;9553;28756;16519;49982
150250;202011;4266;16048;3973;15720;592;2251;3101;12605;3693;14856
150260;202011;2757;8864;2489;8459;148;474;2010;6926;2158;7400
150270;202011;8744;24867;6149;20218;1951;6739;1545;5477;3496;12216
150275;202011;6951;21992;6339;21137;240;901;5488;18258;5728;19159
150276;202011;2375;6184;2050;5793;262;662;1368;4338;1630;5000
150277;202011;5184;13467;4153;12253;309;830;3174;10009;3483;10839
150280;202011;6881;27495;6633;27100;458;1851;5705;23539;6163;25390
150285;202011;3256;11400;2856;10767;250;947;2101;8088;2351;9035
150290;202011;10295;27897;9294;26830;280;575;8441;24954;8721;25529
150293;202011;9157;22553;7044;19773;893;2514;4423;13046;5316;15560
150295;202011;7424;20148;5459;17448;1785;6073;1903;6950;3688;13023
150300;202011;2346;7031;2121;6747;34;120;1950;6237;1984;6357
150304;202011;4026;11909;3317;10815;586;1809;2036;6994;2622;8803
150307;202011;6024;19456;5555;18674;316;1109;4549;15429;4865;16538
150309;202011;6224;18482;4999;16365;842;2734;2831;9700;3673;12434
150310;202011;7380;29109;7058;28723;208;1134;6337;26007;6545;27141
150320;202011;9207;25155;8416;24004;395;1213;6583;18744;6978;19957
150330;202011;13695;43888;12650;42223;1168;3600;9633;33173;10801;36773
150340;202011;2510;7330;2219;6888;339;984;1513;4876;1852;5860
150345;202011;8080;23618;7240;22503;415;1366;6158;19186;6573;20552
150350;202011;8870;22270;8191;21380;663;1255;6779;18232;7442;19487
150360;202011;23889;65296;19156;59323;2017;4893;13629;45209;15646;50102
150370;202011;10701;32297;8805;29745;1012;2884;6411;23391;7423;26275
150375;202011;3600;14423;3253;13929;221;1068;2782;11998;3003;13066
150380;202011;11153;28263;9179;25683;105;415;8143;22777;8248;23192
150390;202011;7806;31115;7005;29882;1060;3932;5047;22853;6107;26785
150400;202011;6574;23380;6311;22892;274;986;5552;20237;5826;21223
150405;202011;9092;24041;7940;22669;478;1115;6468;19068;6946;20183
150410;202011;1920;6011;1629;5513;234;690;1024;3589;1258;4279
150420;202011;38782;106554;29757;93304;8295;27238;10403;38118;18698;65356
150430;202011;8462;24497;7711;23531;931;2094;5940;19123;6871;21217
150440;202011;5693;17987;5152;17220;992;2895;3279;11816;4271;14711
150442;202011;25961;61312;21343;55568;2219;5629;14886;39610;17105;45239
150445;202011;6221;19209;5467;18059;187;661;4705;15567;4892;16228
150450;202011;5134;21690;4732;21150;388;1860;4013;18054;4401;19914
150460;202011;8291;27248;7584;26343;228;878;6577;23595;6805;24473
150470;202011;21420;55588;19105;52948;332;956;18045;49994;18377;50950
150475;202011;4866;15229;4192;14222;163;595;3531;12122;3694;12717
150480;202011;13612;43603;12218;41544;2208;6600;8166;29789;10374;36389
150490;202011;8377;28947;7675;28078;306;1228;6758;24913;7064;26141
150495;202011;5262;17787;5030;17459;111;542;4586;15826;4697;16368
150497;202011;2777;8794;2222;7833;484;1741;1186;4484;1670;6225
150500;202011;3284;8387;2901;7847;245;608;2249;6092;2494;6700
150503;202011;4696;12013;3221;10087;949;3217;1039;3736;1988;6953
150506;202011;10132;29901;8480;27662;1809;5134;5281;19223;7090;24357
150510;202011;9769;35388;8475;33020;1300;4696;5514;22760;6814;27456
150520;202011;6876;27056;6581;26688;222;1354;5909;23873;6131;25227
150530;202011;12140;41432;10494;39115;1492;4488;7573;30185;9065;34673
150540;202011;4890;13367;4185;12310;240;654;3494;10331;3734;10985
150543;202011;7190;19244;5919;17654;468;1403;4594;14302;5062;15705
150548;202011;10041;31496;9038;30122;238;1009;8046;26858;8284;27867
150549;202011;1974;5849;1692;5452;47;191;1437;4646;1484;4837
150550;202011;20242;59003;16804;53310;4120;13258;7256;24627;11376;37885
150553;202011;29976;84867;23479;73264;6817;21528;8590;28621;15407;50149
150555;202011;1920;5078;1502;4408;166;377;1034;3204;1200;3581
150560;202011;1850;5570;1638;5149;280;830;963;3172;1243;4002
150563;202011;2527;7517;2121;6829;420;1420;1194;3900;1614;5320
150565;202011;4387;13894;3903;13144;100;435;3272;11116;3372;11551
150570;202011;6160;19602;5742;19025;257;956;5020;16608;5277;17564
150580;202011;10435;40820;8949;39161;610;3094;7242;32967;7852;36061
150590;202011;8160;27898;6985;26494;172;1010;6383;24121;6555;25131
150600;202011;9661;31875;8999;31080;205;798;8376;29091;8581;29889
150610;202011;2903;8404;2594;7917;81;331;2211;6666;2292;6997
150611;202011;3212;8868;2852;8372;86;312;2531;7388;2617;7700
150613;202011;13305;36289;10046;30712;1807;5868;5050;15411;6857;21279
150616;202011;3499;9490;2546;7907;603;1943;1093;3380;1696;5323
150618;202011;6762;19519;5466;17534;470;1481;3550;12050;4020;13531
150619;202011;6494;17887;5373;16333;197;596;4561;14049;4758;14645
150620;202011;6812;22428;5848;20785;683;2314;3956;14507;4639;16821
150630;202011;6217;16710;5686;16058;369;991;4812;13686;5181;14677
150635;202011;4755;12987;3978;11741;540;1472;2598;7935;3138;9407
150640;202011;2243;6603;2054;6367;35;95;1917;6009;1952;6104
150650;202011;11204;31004;9707;28615;2835;7863;4321;13966;7156;21829
150655;202011;5714;16359;5178;15577;188;587;4502;13548;4690;14135
150658;202011;4424;12469;3459;10992;535;1762;2061;6931;2596;8693
150660;202011;5657;16113;5010;15215;466;1347;3514;10948;3980;12295
150670;202011;8137;18780;6393;16824;650;1355;5032;14041;5682;15396
150680;202011;67865;197942;52232;173129;12510;40398;23443;88197;35953;128595
150690;202011;2807;7119;2416;6658;70;158;2177;6133;2247;6291
150700;202011;6090;17901;5429;17045;346;851;4337;14035;4683;14886
150710;202011;3766;12499;3425;11953;293;993;2584;9219;2877;10212
150715;202011;4898;14038;4002;12673;299;903;3148;10162;3447;11065
150720;202011;6883;24192;6405;23477;431;1668;5340;19851;5771;21519
150730;202011;11893;35853;10263;33554;1186;3987;7640;25694;8826;29681
150740;202011;4009;11023;3519;10248;316;760;2661;7943;2977;8703
150745;202011;4946;13948;3966;12508;785;2600;2539;8119;3324;10719
150746;202011;1627;4919;1479;4711;77;243;1221;3897;1298;4140
150747;202011;4887;15322;4304;14363;694;2006;2947;10358;3641;12364
150750;202011;3643;11341;3053;10445;225;816;2312;8187;2537;9003
150760;202011;11688;34497;10600;32982;1438;4077;7546;24250;8984;28327
150770;202011;6502;22906;6117;22472;180;531;5592;21149;5772;21680
150775;202011;921;2542;719;2273;125;444;393;1240;518;1684
150780;202011;4451;13442;3947;12849;154;421;3539;11849;3693;12270
150790;202011;5719;16029;4928;15178;234;577;3817;13249;4051;13826
150795;202011;13863;42617;12062;39814;2933;9120;6900;24333;9833;33453
150796;202011;3849;9304;3355;8740;206;470;2838;7536;3044;8006
150797;202011;3990;12118;3457;11377;138;335;2974;10005;3112;10340
150800;202011;13160;41063;11846;39310;1418;4406;8958;30777;10376;35183
150803;202011;7120;22465;6658;21747;400;1133;5642;18704;6042;19837
150805;202011;3435;10520;2907;9749;206;670;2288;7817;2494;8487
150808;202011;5764;16295;4208;13746;1658;5982;596;2243;2254;8225
150810;202011;20701;53914;15748;47938;3352;10395;7908;26826;11260;37221
150812;202011;5373;14880;4717;13814;412;1267;3503;10087;3915;11354
150815;202011;9569;27749;7984;25892;623;1987;6611;21818;7234;23805
150820;202011;11696;32127;9862;29820;1065;2759;7531;23853;8596;26612
150830;202011;11812;42794;10916;41703;447;1781;9412;37162;9859;38943
150835;202011;2302;7556;1947;6944;328;1139;1136;4125;1464;5264
150840;202011;7484;20872;6005;18521;975;3252;3426;10477;4401;13729
160005;202011;1222;3317;1082;3143;68;224;909;2662;977;2886
160010;202011;2423;6372;2256;6190;18;102;2191;5937;2209;6039
160015;202011;2774;8027;2449;7630;66;227;2263;7070;2329;7297
160020;202011;2036;6506;1787;6201;152;493;1412;5089;1564;5582
160021;202011;1136;4248;1049;4137;56;303;875;3417;931;3720
160023;202011;1259;4424;1110;4176;120;413;779;3118;899;3531
160025;202011;1856;5590;1756;5476;13;39;1706;5337;1719;5376
160027;202011;8897;24693;7946;23468;637;1786;6412;19336;7049;21122
160030;202011;72927;206322;59366;187776;12645;37524;31883;111290;44528;148814
160040;202011;5808;19367;5288;18713;67;301;4975;17718;5042;18019
160050;202011;4680;14039;3658;12655;1375;4558;1276;5571;2651;10129
160053;202011;3791;11585;3421;11118;272;752;2790;9433;3062;10185
160055;202011;903;2621;868;2581;28;93;807;2398;835;2491
160060;202011;24874;65128;20137;59765;926;2845;16023;49940;16949;52785
160070;202011;2640;10036;2362;9607;190;756;1873;7876;2063;8632
160080;202011;3337;10534;2972;10126;28;143;2787;9563;2815;9706
170025;202011;585;1531;424;1284;64;191;221;697;285;888
170030;202011;1232;3721;946;3217;147;504;456;1601;603;2105
170035;202011;1451;3757;1077;3165;87;275;673;1976;760;2251
170040;202011;1865;5224;1480;4680;103;368;930;3034;1033;3402
170070;202011;1866;4332;1324;3636;84;264;787;2248;871;2512
170100;202011;2407;6870;2009;6209;205;572;1268;4059;1473;4631
170105;202011;729;2108;504;1628;137;390;163;554;300;944
170110;202011;956;2875;732;2450;116;393;358;1179;474;1572
170130;202011;1270;3790;913;3111;172;623;434;1516;606;2139
170190;202011;1380;3846;1004;3241;361;1252;156;650;517;1902
170200;202011;2038;4818;1317;3630;193;550;568;1572;761;2122
170210;202011;23943;64955;18149;55270;6147;20414;2499;8497;8646;28911
170215;202011;1317;3509;1053;3139;38;155;834;2480;872;2635
170220;202011;5770;17802;4820;16075;1319;4210;1899;7027;3218;11237
170230;202011;1198;3579;891;2975;258;875;154;576;412;1451
170240;202011;2525;7078;1983;6190;125;466;1429;4361;1554;4827
170255;202011;3864;11159;2762;9171;485;1663;1259;4279;1744;5942
170270;202011;926;2250;619;1811;37;101;368;1069;405;1170
170290;202011;2821;8365;2448;7872;120;389;1918;6346;2038;6735
170300;202011;1991;5317;1605;4732;189;537;1071;3228;1260;3765
170305;202011;611;1668;510;1497;67;227;257;741;324;968
170307;202011;955;3213;776;2859;105;402;429;1596;534;1998
170310;202011;1545;3831;1078;3086;169;529;508;1461;677;1990
170320;202011;996;2587;747;2193;61;183;478;1438;539;1621
170330;202011;896;2734;812;2608;37;167;680;2123;717;2290
170360;202011;512;1384;356;1122;22;79;234;702;256;781
170370;202011;1250;3357;897;2748;279;803;230;840;509;1643
170380;202011;1751;5058;1311;4373;90;358;774;2632;864;2990
170382;202011;528;1555;438;1407;30;120;324;1004;354;1124
170384;202011;1519;5402;1233;4849;249;1025;639;2555;888;3580
170386;202011;965;2602;598;1891;76;268;212;651;288;919
170388;202011;595;1699;419;1382;57;201;196;654;253;855
170389;202011;1022;3149;840;2854;43;175;615;2136;658;2311
170390;202011;1720;3910;1296;3395;37;89;1078;2894;1115;2983
170410;202011;564;1633;415;1362;35;146;247;775;282;921
170460;202011;342;910;283;816;37;100;187;557;224;657
170510;202011;895;2548;673;2144;41;160;441;1342;482;1502
170550;202011;6326;16864;4628;14102;1191;3889;1089;3613;2280;7502
170555;202011;1387;3722;1089;3262;70;215;538;1687;608;1902
170560;202011;1008;2810;769;2482;62;200;493;1697;555;1897
170600;202011;1228;3338;997;3012;209;506;552;1830;761;2336
170610;202011;1579;4188;1136;3531;85;289;709;2182;794;2471
170625;202011;413;1124;256;802;42;126;84;256;126;382
170650;202011;1194;3542;941;3121;124;427;547;1876;671;2303
170700;202011;3262;9674;2454;8072;493;1638;1099;3684;1592;5322
170710;202011;1426;3768;1107;3263;144;459;696;2065;840;2524
170720;202011;1701;4310;1280;3616;313;938;544;1575;857;2513
170730;202011;1038;2809;771;2370;140;382;394;1290;534;1672
170740;202011;2061;6728;1775;6204;167;650;1260;4379;1427;5029
170755;202011;873;2403;610;1950;66;214;301;955;367;1169
170765;202011;1095;2848;763;2311;147;436;332;1054;479;1490
170770;202011;1820;5273;1475;4734;172;537;965;3193;1137;3730
170820;202011;3279;9841;2572;8540;542;1843;1161;3997;1703;5840
170825;202011;971;2242;786;1992;92;205;567;1457;659;1662
170830;202011;1399;3705;1148;3314;151;411;763;2266;914;2677
170900;202011;2738;8465;2301;7834;209;645;1805;6281;2014;6926
170930;202011;3599;9999;2740;8356;640;2057;889;2729;1529;4786
170950;202011;10847;29919;7472;23783;2068;7521;850;2983;2918;10504
170980;202011;447;1182;357;1040;26;88;245;685;271;773
171050;202011;1607;5017;1402;4666;52;223;1171;3866;1223;4089
171070;202011;1320;3758;1131;3478;310;941;487;1760;797;2701
171090;202011;1038;2559;825;2257;76;210;547;1474;623;1684
171110;202011;563;1507;391;1185;62;186;184;517;246;703
171150;202011;1045;2593;643;1910;59;207;403;1178;462;1385
171180;202011;769;2086;514;1610;96;270;217;690;313;960
171190;202011;1776;5872;1538;5459;240;906;939;3457;1179;4363
171195;202011;771;2465;623;2180;81;333;381;1311;462;1644
171200;202011;556;1551;417;1310;90;297;154;483;244;780
171215;202011;358;996;295;887;32;111;205;593;237;704
171240;202011;762;2490;606;2183;32;179;411;1448;443;1627
171245;202011;653;1943;509;1642;46;176;318;983;364;1159
171250;202011;994;2628;725;2225;129;410;336;1060;465;1470
171270;202011;473;1659;371;1436;77;294;163;696;240;990
171280;202011;855;2576;678;2253;61;216;396;1373;457;1589
171320;202011;3928;10950;3010;9336;619;1892;1117;3679;1736;5571
171330;202011;2720;7473;2093;6360;446;1336;934;2963;1380;4299
171360;202011;1346;3922;1071;3513;75;255;770;2608;845;2863
171370;202011;686;1730;520;1497;45;122;356;1038;401;1160
171380;202011;1432;3856;1204;3538;138;387;847;2578;985;2965
171395;202011;962;2633;672;2096;59;214;423;1277;482;1491
171420;202011;1952;5679;1397;4569;242;842;630;2061;872;2903
171430;202011;1004;2949;840;2640;58;198;578;1749;636;1947
171488;202011;2296;6806;1813;5995;262;847;940;3274;1202;4121
171500;202011;961;2361;730;2013;46;120;556;1550;602;1670
171510;202011;797;2607;690;2401;45;199;486;1662;531;1861
171515;202011;460;1166;336;973;34;95;206;567;240;662
171525;202011;698;1961;525;1683;26;89;301;930;327;1019
171550;202011;340;982;257;848;34;126;137;444;171;570
171570;202011;1109;3356;927;3026;120;396;548;1834;668;2230
171575;202011;1767;4743;1134;3590;117;393;515;1630;632;2023
171610;202011;5563;15457;4156;13040;858;3049;1141;3866;1999;6915
171620;202011;2507;7189;2129;6639;103;417;1735;5399;1838;5816
171630;202011;962;2503;756;2218;101;295;519;1574;620;1869
171650;202011;1961;5575;1506;4807;386;1342;450;1582;836;2924
171660;202011;2320;5833;1588;4599;226;579;840;2486;1066;3065
171665;202011;1226;3433;957;2990;169;603;443;1383;612;1986
171670;202011;1870;4965;1439;4253;204;661;776;2309;980;2970
171700;202011;1190;3366;865;2770;109;343;468;1539;577;1882
171720;202011;784;1986;622;1738;50;154;455;1252;505;1406
171750;202011;1289;3602;878;2825;222;735;112;453;334;1188
171780;202011;1186;3054;868;2578;94;304;576;1671;670;1975
171790;202011;1386;4483;1143;3976;193;678;567;2007;760;2685
171800;202011;690;1904;520;1654;59;240;299;927;358;1167
171820;202011;11032;30898;8156;25882;2000;6605;2383;8246;4383;14851
171830;202011;1520;4833;1293;4433;130;508;829;2858;959;3366
171840;202011;738;1985;571;1722;23;72;378;1136;401;1208
171845;202011;636;1549;487;1330;49;170;314;823;363;993
171850;202011;894;2936;760;2635;72;320;533;1789;605;2109
171855;202011;1015;3088;865;2815;64;218;544;1748;608;1966
171865;202011;354;1104;292;998;50;185;148;485;198;670
171870;202011;817;2232;578;1793;73;217;292;920;365;1137
171875;202011;1264;3664;1011;3255;39;172;761;2452;800;2624
171880;202011;1170;3480;1029;3293;41;123;818;2681;859;2804
171884;202011;841;2404;625;2031;121;452;235;786;356;1238
171886;202011;1311;3590;935;2988;272;995;192;625;464;1620
171888;202011;725;2009;497;1583;29;106;312;971;341;1077
171889;202011;363;1137;285;973;62;226;116;392;178;618
171890;202011;1162;3245;837;2715;172;520;465;1570;637;2090
171900;202011;536;1851;393;1490;81;300;163;646;244;946
172000;202011;561;1658;468;1485;53;168;268;824;321;992
172010;202011;953;3296;813;3015;68;282;503;1857;571;2139
172015;202011;370;1264;271;1060;69;275;104;430;173;705
172020;202011;2671;7531;2354;7114;168;550;1731;5448;1899;5998
172025;202011;690;1907;515;1617;37;140;378;1182;415;1322
172030;202011;1200;3553;1020;3266;59;229;798;2542;857;2771
172049;202011;1276;3065;866;2505;177;480;437;1387;614;1867
172065;202011;1395;3527;1094;3145;96;213;871;2682;967;2895
172080;202011;2331;6869;1885;6088;107;374;1262;4065;1369;4439
172085;202011;467;1266;302;913;56;170;103;294;159;464
172090;202011;3978;9909;3100;8745;132;383;2357;6737;2489;7120
172093;202011;456;1356;328;1123;16;82;197;635;213;717
172097;202011;678;1769;472;1411;62;192;211;639;273;831
172100;202011;47087;116132;33441;94681;5787;18139;12337;35849;18124;53988
172110;202011;1538;5653;1329;5325;125;537;981;4100;1106;4637
172120;202011;4858;14306;3811;12584;479;1682;2180;7398;2659;9080
172125;202011;364;973;275;822;23;78;162;458;185;536
172130;202011;615;1495;484;1287;22;81;342;829;364;910
172208;202011;2527;6152;2023;5498;192;419;1469;4122;1661;4541
172210;202011;2630;6673;2014;5882;319;1007;1162;3544;1481;4551
210005;202011;18274;52305;13834;44838;4014;13551;5295;18009;9309;31560
210010;202011;1908;5854;1727;5634;68;295;1511;4937;1579;5232
210015;202011;3257;9775;2891;9276;151;497;2402;7708;2553;8205
210020;202011;7253;17128;6145;15821;121;397;5593;14382;5714;14779
210030;202011;4591;15228;4232;14679;255;1019;3578;12455;3833;13474
210040;202011;1796;4281;1581;4007;32;86;1357;3365;1389;3451
210043;202011;5950;17255;5097;16052;414;1248;3951;12650;4365;13898
210047;202011;6388;19960;5223;18398;134;704;4520;15905;4654;16609
210050;202011;2162;7301;1721;6486;154;657;1204;4528;1358;5185
210055;202011;1863;5995;1688;5723;67;249;1434;4891;1501;5140
210060;202011;7200;26236;6394;24809;645;2602;4461;17754;5106;20356
210070;202011;7007;19978;6567;19402;45;204;6206;18270;6251;18474
210080;202011;4307;14305;4091;14071;43;254;3773;13056;3816;13310
210083;202011;5415;15691;4508;14723;35;168;4289;14053;4324;14221
210087;202011;2958;8081;2537;7525;87;247;2165;6501;2252;6748
210090;202011;9057;28333;8461;27284;494;1278;7210;23534;7704;24812
210095;202011;6374;20440;5814;19727;243;1053;4848;16758;5091;17811
210100;202011;6690;20387;5970;19228;396;1394;4620;14950;5016;16344
210110;202011;2876;9263;2657;9005;54;318;2392;8058;2446;8376
210120;202011;22363;61034;18460;55927;1860;4533;12516;40569;14376;45102
210125;202011;4378;11692;3809;11021;729;1659;2671;8282;3400;9941
210130;202011;4285;11182;3548;10266;148;314;3008;8816;3156;9130
210135;202011;1409;4250;1218;3940;59;170;992;3289;1051;3459
210140;202011;18768;48908;14414;43270;2779;7892;8043;25731;10822;33623
210150;202011;4303;10432;3848;9799;144;407;3250;8139;3394;8546
210160;202011;16145;47006;13896;44189;1173;3995;9866;32597;11039;36592
210170;202011;14982;46351;13936;45016;770;2133;12231;39980;13001;42113
210173;202011;2239;8635;2079;8345;107;609;1783;7087;1890;7696
210177;202011;3441;9402;2989;8845;162;355;2574;7915;2736;8270
210180;202011;1421;3783;1247;3576;26;68;1137;3279;1163;3347
210190;202011;5326;14210;4482;13069;75;314;3893;11210;3968;11524
210193;202011;1296;3763;1144;3517;30;133;857;2670;887;2803
210197;202011;2077;6414;1917;6197;146;474;1564;5133;1710;5607
210200;202011;7559;24281;6685;22816;385;1503;5300;18028;5685;19531
210203;202011;6926;20450;5899;19057;397;1363;4696;15451;5093;16814
210207;202011;3935;9524;3019;8549;157;328;2518;7347;2675;7675
210210;202011;7896;25737;7214;24778;166;967;6194;21058;6360;22025
210215;202011;2446;7694;2081;7143;121;624;1551;5243;1672;5867
210220;202011;6064;20935;5751;20463;184;1182;5028;17520;5212;18702
210230;202011;5034;15279;4582;14598;436;1111;3776;12407;4212;13518
210232;202011;10858;34241;8951;31324;1588;5455;5498;20612;7086;26067
210235;202011;3289;9984;2912;9460;166;669;2451;7949;2617;8618
210237;202011;2752;8949;2364;8497;33;194;2185;7853;2218;8047
210240;202011;2555;8009;2347;7642;73;258;1949;6228;2022;6486
210250;202011;5588;16997;5072;16337;79;453;4574;14654;4653;15107
210255;202011;2455;7522;2082;6872;295;1012;1312;4328;1607;5340
210260;202011;5438;16168;4801;15242;249;940;4027;12676;4276;13616
210270;202011;4818;13250;4315;12639;92;424;3857;11196;3949;11620
210275;202011;3426;8686;2996;8141;73;195;2499;6776;2572;6971
210280;202011;5448;15513;4372;13853;256;991;3232;10099;3488;11090
210290;202011;7201;19183;6450;18240;106;343;6022;17012;6128;17355
210300;202011;32069;87248;26204;78825;1832;5804;18733;58348;20565;64152
210310;202011;3040;7769;2687;7249;133;291;2339;6366;2472;6657
210312;202011;2644;6755;2340;6429;31;137;2200;5979;2231;6116
210315;202011;2940;8186;2526;7714;75;228;2246;6985;2321;7213
210317;202011;4081;12815;3692;12356;145;715;3268;10844;3413;11559
210320;202011;18819;56599;17220;54487;368;1763;15325;48253;15693;50016
210325;202011;3629;10196;3111;9518;108;317;2709;8491;2817;8808
210330;202011;23840;67188;19063;61068;5739;16510;9085;33834;14824;50344
210340;202011;9890;29137;8807;27681;709;2196;6723;21767;7432;23963
210350;202011;8933;25873;7899;24626;144;498;7064;22157;7208;22655
210355;202011;4207;13902;3720;13138;101;500;3171;11248;3272;11748
210360;202011;13568;42241;12082;40051;594;2746;9166;29797;9760;32543
210370;202011;10837;24335;8390;21750;245;414;7673;20368;7918;20782
210375;202011;3143;8397;2416;7403;643;2023;1032;3519;1675;5542
210380;202011;5329;13700;4610;12859;190;462;3977;11186;4167;11648
210390;202011;2532;8900;2342;8570;124;575;1973;7186;2097;7761
210400;202011;4413;13443;3909;12820;128;399;3522;11717;3650;12116
210405;202011;6669;18040;5377;16185;1018;2854;3057;9821;4075;12675
210407;202011;1934;6387;1631;5835;77;336;1321;4667;1398;5003
210408;202011;2533;9341;2372;9101;146;695;1880;7246;2026;7941
210409;202011;3758;12925;3440;12492;112;603;2846;10401;2958;11004
210410;202011;3351;10210;2860;9394;159;619;2173;7100;2332;7719
210420;202011;3754;11980;3409;11371;189;596;2881;9699;3070;10295
210430;202011;2212;6470;1964;6149;84;237;1678;5325;1762;5562
210440;202011;4297;11577;3727;10853;72;272;3399;9805;3471;10077
210450;202011;2350;7009;2024;6539;78;289;1680;5390;1758;5679
210455;202011;4278;11228;3254;9923;938;2890;1488;4821;2426;7711
210460;202011;3645;10367;3088;9647;63;268;2705;8399;2768;8667
210462;202011;1624;4919;1391;4540;38;152;1133;3741;1171;3893
210465;202011;2689;7795;2345;7317;87;401;1836;5576;1923;5977
210467;202011;5783;18392;5051;17430;297;1118;4169;14609;4466;15727
210470;202011;1948;5207;1432;4460;103;228;1091;3555;1194;3783
210480;202011;15889;46871;13176;43508;1096;3294;9747;34673;10843;37967
210490;202011;3606;9158;2932;8224;96;284;2470;6921;2566;7205
210500;202011;6308;23966;5776;23043;392;1850;4723;18741;5115;20591
210510;202011;5847;19379;5121;18599;118;521;4619;17039;4737;17560
210515;202011;3687;10810;3210;10264;261;956;2535;8246;2796;9202
210520;202011;2487;7170;2226;6822;70;253;1903;5770;1973;6023
210530;202011;49672;122741;38308;105853;6758;22374;10890;37319;17648;59693
210535;202011;3026;10254;2836;9954;158;582;2347;8305;2505;8887
210540;202011;14427;41502;11972;38035;1458;4255;8324;27796;9782;32051
210542;202011;6388;14790;5137;13425;332;566;4207;11761;4539;12327
210545;202011;2172;6735;2049;6537;45;184;1818;5744;1863;5928
210547;202011;3480;12436;3087;11674;281;1040;2347;9068;2628;10108
210550;202011;5990;17992;4755;16061;337;1296;3381;11732;3718;13028
210560;202011;3550;10705;3176;10110;120;373;2684;8483;2804;8856
210565;202011;1459;4753;1218;4402;75;398;920;3326;995;3724
210570;202011;10294;27939;9151;26537;337;939;7872;23327;8209;24266
210580;202011;2951;7885;2428;7234;128;277;1918;6017;2046;6294
210590;202011;4176;12455;3620;11746;67;377;3234;10411;3301;10788
210592;202011;2603;7656;2379;7292;21;108;2020;6105;2041;6213
210594;202011;2452;6605;1866;5696;88;272;1379;4364;1467;4636
210596;202011;2502;8828;2264;8369;106;446;1867;6913;1973;7359
210598;202011;1793;5225;1657;5020;62;253;1443;4300;1505;4553
210600;202011;2970;7914;2445;7171;107;270;1894;5608;2001;5878
210610;202011;2689;7453;2310;6992;62;271;1983;6000;2045;6271
210620;202011;2741;7322;2290;6780;56;173;2046;6072;2102;6245
210630;202011;2937;9874;2685;9458;122;584;2218;7711;2340;8295
210632;202011;4348;13923;3874;13235;223;943;3051;10363;3274;11306
210635;202011;1702;6075;1612;5921;95;346;1337;5000;1432;5346
210637;202011;2400;7948;2079;7480;158;692;1542;5596;1700;6288
210640;202011;4495;16071;4215;15738;68;338;3839;14369;3907;14707
210650;202011;7343;20959;6660;20073;97;360;6015;18118;6112;18478
210660;202011;7851;23480;7013;22118;281;1164;5938;18404;6219;19568
210663;202011;2545;7374;2335;7129;148;348;1975;6241;2123;6589
210667;202011;1928;6262;1736;5975;57;236;1542;5359;1599;5595
210670;202011;4479;14963;4091;14355;118;560;3582;12484;3700;13044
210675;202011;4974;13456;4253;12522;228;558;3522;10693;3750;11251
210680;202011;4567;11011;3846;10146;115;211;3418;9123;3533;9334
210690;202011;7499;22936;6266;21571;234;1013;5575;19325;5809;20338
210700;202011;2718;7625;2135;6770;138;426;1554;5130;1692;5556
210710;202011;4741;14941;4173;14135;103;576;3647;12184;3750;12760
210720;202011;2877;9516;2566;9128;73;426;2225;7843;2298;8269
210725;202011;1286;4322;1128;4085;39;153;824;3118;863;3271
210730;202011;1149;3032;966;2774;49;129;824;2369;873;2498
210735;202011;4619;13403;3951;12520;195;547;3386;11021;3581;11568
210740;202011;5122;13632;4460;12884;82;290;3806;10980;3888;11270
210745;202011;4345;11844;4031;11443;112;354;3656;10336;3768;10690
210750;202011;22735;58147;19670;54242;1884;4701;13591;39757;15475;44458
210760;202011;5841;15403;4946;14454;31;67;4706;13888;4737;13955
210770;202011;5987;15414;5180;14477;65;281;4845;13435;4910;13716
210780;202011;7266;22714;6356;21196;571;1657;4896;16702;5467;18359
210790;202011;4127;13121;3725;12596;179;448;3082;10927;3261;11375
210800;202011;4777;12798;4106;11904;126;494;3587;10257;3713;10751
210805;202011;3894;14099;3701;13815;119;652;3243;12001;3362;12653
210810;202011;4748;13846;4324;13266;306;696;3544;11230;3850;11926
210820;202011;6657;19038;5565;17273;655;2094;3219;10341;3874;12435
210825;202011;6626;20561;5967;19677;262;860;5114;17138;5376;17998
210830;202011;7573;21228;6870;20377;315;738;6051;18324;6366;19062
210840;202011;3118;8356;2797;7916;58;195;2504;7006;2562;7201
210845;202011;6449;17281;5769;16541;31;105;5512;15935;5543;16040
210850;202011;5689;19440;4780;18085;220;1148;3787;14328;4007;15476
210860;202011;21035;53324;17512;48926;991;2333;13840;40927;14831;43260
210870;202011;7193;18742;5688;17032;218;574;4994;15077;5212;15651
210880;202011;4200;12854;3769;12331;183;747;3013;9785;3196;10532
210890;202011;3762;11078;3365;10569;241;630;2700;8770;2941;9400
210900;202011;4348;12664;3331;10735;1316;4546;494;1831;1810;6377
210905;202011;1969;5420;1642;4997;45;76;1502;4686;1547;4762
210910;202011;6979;21170;5805;19249;766;2567;3775;12662;4541;15229
210920;202011;3163;10387;2740;9832;73;415;2443;8670;2516;9085
210923;202011;1563;4613;1312;4205;85;302;917;2953;1002;3255
210927;202011;5108;16189;4493;15450;339;1130;3533;12500;3872;13630
210930;202011;2417;8371;2123;7798;153;626;1604;5881;1757;6507
210940;202011;4009;11293;3723;10958;107;450;3404;9887;3511;10337
210945;202011;6481;18507;5808;17701;234;668;4878;15275;5112;15943
210950;202011;5053;14083;3898;12478;605;1507;2556;8973;3161;10480
210955;202011;1495;4751;1291;4405;133;462;891;3142;1024;3604
210960;202011;8692;25985;7544;24261;1201;3527;4978;16780;6179;20307
210970;202011;1310;4042;1045;3581;87;276;756;2578;843;2854
210975;202011;1712;5342;1538;5068;74;272;1226;4049;1300;4321
210980;202011;9954;23141;8708;21850;92;235;8241;20767;8333;21002
210990;202011;15952;44658;12496;40083;663;2301;9250;30633;9913;32934
211000;202011;14296;41770;11988;38887;788;2644;9202;31141;9990;33785
211003;202011;5553;16534;4686;15486;146;564;4055;13667;4201;14231
211010;202011;6253;22377;5614;21598;174;791;4978;19488;5152;20279
211020;202011;8024;23215;6950;21996;266;1001;5871;19116;6137;20117
211023;202011;1907;6230;1779;6062;87;311;1521;5174;1608;5485
211027;202011;3031;9699;2867;9442;191;511;2480;8268;2671;8779
211030;202011;3736;10323;3336;9826;223;546;2741;8285;2964;8831
211040;202011;4555;16383;4214;15789;127;727;3759;13960;3886;14687
211050;202011;8854;23100;8049;22020;82;297;7343;20056;7425;20353
211060;202011;6824;20640;6226;19831;157;648;5499;17510;5656;18158
211065;202011;2164;6062;1793;5589;106;340;1409;4503;1515;4843
211070;202011;7639;24089;6476;22326;540;1833;4939;17240;5479;19073
211080;202011;1275;3524;1023;3127;34;185;787;2267;821;2452
211085;202011;2000;5610;1713;5238;91;219;1475;4688;1566;4907
211090;202011;3107;8574;2821;8246;34;164;2630;7645;2664;7809
211100;202011;6735;16908;6207;16271;46;152;5769;15186;5815;15338
211102;202011;3056;10328;2795;9942;141;647;2414;8483;2555;9130
211105;202011;2319;7281;1928;6566;174;609;1375;4654;1549;5263
211107;202011;4602;14393;3928;13411;135;603;3114;11013;3249;11616
211110;202011;5809;15788;4528;13845;359;1027;3339;10429;3698;11456
211120;202011;43727;106627;35738;97256;5083;12498;23042;67164;28125;79662
211125;202011;2058;6145;1738;5651;52;184;1471;4819;1523;5003
211130;202011;178598;423108;153170;390025;23118;55753;74089;214720;97207;270473
211140;202011;4885;14399;4262;13594;229;623;3584;11570;3813;12193
211150;202011;9122;24922;7721;23092;332;913;6529;19677;6861;20590
211153;202011;2349;6918;1865;6309;231;825;1244;4367;1475;5192
211157;202011;1118;3517;930;3168;34;159;675;2299;709;2458
211160;202011;3947;11141;3107;9935;142;497;2354;7477;2496;7974
211163;202011;1575;5114;1439;4928;79;332;1236;4237;1315;4569
211167;202011;1496;4759;1402;4607;47;212;1218;3951;1265;4163
211170;202011;6328;15654;5875;15133;57;167;5583;14334;5640;14501
211172;202011;2475;6667;2109;6105;106;341;1609;4520;1715;4861
211174;202011;2796;8098;2531;7802;36;186;2371;7269;2407;7455
211176;202011;4147;11803;3225;10443;158;670;2577;8301;2735;8971
211178;202011;4478;10541;3907;9908;30;133;3720;9350;3750;9483
211180;202011;3984;13084;3697;12668;211;796;3072;10541;3283;11337
211190;202011;3024;8846;2563;8168;33;186;2282;7208;2315;7394
211195;202011;1384;3880;1184;3571;74;147;993;3091;1067;3238
211200;202011;2101;5992;1697;5427;206;629;1186;3867;1392;4496
211210;202011;6088;18772;5524;18021;241;1021;4692;15152;4933;16173
211220;202011;35943;90865;29536;82962;2803;7311;21991;63382;24794;70693
211223;202011;5188;13576;4269;12368;371;1089;3115;9062;3486;10151
211227;202011;1724;5699;1553;5455;67;324;1206;4272;1273;4596
211230;202011;7387;21363;6457;19964;403;1063;5198;16470;5601;17533
211240;202011;7902;25058;7513;24558;133;735;7004;22628;7137;23363
211245;202011;6905;17380;6160;16608;86;211;5954;16078;6040;16289
211250;202011;12868;40679;11650;38960;724;2705;9448;31524;10172;34229
211260;202011;7968;25759;7110;24618;236;997;6349;22113;6585;23110
211270;202011;10323;32750;8820;30721;370;1696;7165;25140;7535;26836
211280;202011;12303;33905;11050;32320;840;1940;9074;27633;9914;29573
211285;202011;1751;5684;1554;5412;134;511;1149;4100;1283;4611
211290;202011;7357;22065;6642;21128;172;698;5753;18253;5925;18951
211300;202011;7580;21903;6694;20491;217;750;5638;17044;5855;17794
211400;202011;11248;31823;9208;29033;1062;3375;6143;20341;7205;23716
220005;202011;1817;4687;1650;4455;30;105;1416;3766;1446;3871
220010;202011;1460;4181;1195;3705;26;111;929;2854;955;2965
220020;202011;3623;9938;3129;9243;134;472;2586;7587;2720;8059
220025;202011;2197;5008;1890;4555;25;68;1589;3718;1614;3786
220027;202011;1258;3169;1078;2928;20;72;925;2470;945;2542
220030;202011;3314;8345;3099;8060;80;218;2741;7068;2821;7286
220040;202011;7024;21136;6139;19428;1492;4268;3141;10560;4633;14828
220045;202011;1440;4408;1184;3981;30;171;965;3181;995;3352
220050;202011;4697;12674;4004;11777;60;275;3685;10715;3745;10990
220060;202011;2322;4876;1978;4479;25;60;1868;4218;1893;4278
220070;202011;2391;6025;2047;5512;69;142;1711;4630;1780;4772
220080;202011;728;2047;629;1900;23;80;537;1611;560;1691
220090;202011;1729;4165;1454;3776;17;53;1206;3255;1223;3308
220095;202011;639;1597;597;1552;26;43;539;1425;565;1468
220100;202011;1351;3722;1092;3308;45;151;878;2595;923;2746
220105;202011;1983;6168;1737;5677;105;395;1328;4315;1433;4710
220110;202011;3313;9135;3052;8678;34;167;2743;7704;2777;7871
220115;202011;2647;7629;2457;7377;68;207;2234;6688;2302;6895
220117;202011;1371;3270;1092;2891;6;26;922;2397;928;2423
220120;202011;12758;33993;11671;32640;77;276;10993;30694;11070;30970
220130;202011;1093;2927;940;2719;13;73;856;2446;869;2519
220140;202011;2128;4366;1795;3969;103;255;1567;3421;1670;3676
220150;202011;6205;18400;5667;17485;106;527;4815;14589;4921;15116
220155;202011;1161;3325;923;2885;35;116;650;1996;685;2112
220157;202011;1054;2562;889;2312;24;81;703;1772;727;1853
220160;202011;2844;7831;2455;7130;34;153;2021;5768;2055;5921
220170;202011;1585;4085;1353;3738;12;55;1216;3316;1228;3371
220173;202011;2149;5916;1731;5182;47;202;1380;4007;1427;4209
220177;202011;1978;5590;1877;5478;10;37;1855;5405;1865;5442
220180;202011;1093;2627;891;2300;4;21;709;1722;713;1743
220190;202011;6940;17161;5907;15746;369;1005;4435;12063;4804;13068
220191;202011;1557;4629;1420;4403;80;279;1011;3081;1091;3360
220192;202011;2061;5374;1502;4384;30;95;1210;3470;1240;3565
220194;202011;1702;4822;1517;4531;55;201;1253;3697;1308;3898
220196;202011;1996;5116;1813;4842;28;111;1566;4112;1594;4223
220198;202011;1277;3480;1086;3231;8;38;1004;3004;1012;3042
220200;202011;5069;14561;4425;13727;75;337;3839;11892;3914;12229
220202;202011;2133;5980;1841;5503;27;144;1585;4654;1612;4798
220205;202011;2431;7006;2185;6550;49;188;1855;5484;1904;5672
220207;202011;758;2269;623;2039;59;203;399;1315;458;1518
220208;202011;1644;5015;1359;4455;178;629;794;2563;972;3192
220209;202011;1535;4395;1344;4047;23;98;1113;3311;1136;3409
220210;202011;1717;4150;1476;3769;11;48;1286;3204;1297;3252
220211;202011;1606;4044;1483;3875;16;64;1296;3395;1312;3459
220213;202011;1758;4657;1513;4240;28;101;1220;3329;1248;3430
220217;202011;2185;6412;2045;6249;44;91;1896;5908;1940;5999
220220;202011;10360;26879;8609;24178;581;1442;5796;17214;6377;18656
220225;202011;992;2611;814;2379;5;33;767;2218;772;2251
220230;202011;5581;13919;4808;12848;155;367;4155;11173;4310;11540
220240;202011;2986;8565;2721;8125;112;357;2226;6648;2338;7005
220245;202011;1784;4044;1370;3537;12;49;1252;3256;1264;3305
220250;202011;2928;8168;2595;7750;15;85;2446;7276;2461;7361
220253;202011;1562;4246;1412;3997;61;200;1191;3287;1252;3487
220255;202011;1909;4434;1639;4057;31;138;1420;3389;1451;3527
220260;202011;4271;13025;3750;12065;163;596;2971;9552;3134;10148
220265;202011;1289;4090;1156;3915;31;167;960;3198;991;3365
220270;202011;6010;19186;5670;18556;208;1005;4767;15085;4975;16090
220271;202011;1471;3762;1286;3506;27;96;1128;3057;1155;3153
220272;202011;1741;4996;1549;4647;50;155;1173;3430;1223;3585
220273;202011;1219;3459;1021;3096;32;124;789;2355;821;2479
220275;202011;2275;5337;1824;4719;36;89;1610;4182;1646;4271
220277;202011;2119;5318;1814;4876;27;70;1535;4060;1562;4130
220280;202011;1642;3811;1370;3460;23;74;1158;2905;1181;2979
220285;202011;1405;3533;1221;3322;10;38;1128;3046;1138;3084
220290;202011;6478;17972;5152;16098;361;1186;3748;12027;4109;13213
220300;202011;1932;5581;1583;5121;35;182;1326;4268;1361;4450
220310;202011;3008;8001;2368;7255;42;207;1993;6072;2035;6279
220320;202011;3017;8745;2331;7464;72;338;1829;5683;1901;6021
220323;202011;1611;4670;1275;4125;50;193;1055;3355;1105;3548
220325;202011;1235;3662;1063;3377;22;107;885;2760;907;2867
220327;202011;1521;4275;1322;3956;41;167;1098;3199;1139;3366
220330;202011;4444;10540;3777;9727;59;194;3418;8747;3477;8941
220335;202011;1633;4920;1477;4720;33;108;1316;4223;1349;4331
220340;202011;1844;4825;1424;4132;58;181;982;2753;1040;2934
220342;202011;1160;3339;1036;3150;51;181;818;2479;869;2660
220345;202011;3098;6918;2396;5922;17;49;2170;5343;2187;5392
220350;202011;3275;8300;2623;7334;134;389;1866;5247;2000;5636
220360;202011;1223;3121;973;2710;16;43;776;2158;792;2201
220370;202011;8510;24740;7760;23515;154;664;6782;20294;6936;20958
220375;202011;1577;4466;1400;4250;2;13;1329;4059;1331;4072
220380;202011;1454;3442;1185;3070;13;36;1043;2675;1056;2711
220385;202011;828;1967;676;1691;6;15;593;1471;599;1486
220390;202011;10233;26325;7823;22579;2024;5741;2741;8874;4765;14615
220400;202011;1455;3446;1126;2935;25;73;861;2165;886;2238
220410;202011;1138;3132;935;2780;51;153;751;2197;802;2350
220415;202011;786;2002;661;1812;19;53;533;1438;552;1491
220420;202011;1999;5536;1607;4789;52;165;1244;3661;1296;3826
220430;202011;2446;6534;2292;6311;71;231;1967;5359;2038;5590
220435;202011;1727;4422;1494;4082;47;160;1239;3306;1286;3466
220440;202011;2343;7286;2003;6759;80;356;1708;5657;1788;6013
220450;202011;2472;6378;2018;5812;62;207;1720;4969;1782;5176
220455;202011;1257;3886;1197;3803;9;52;1070;3396;1079;3448
220460;202011;970;2382;901;2295;34;83;777;1960;811;2043
220465;202011;2271;7058;2015;6651;176;586;1490;5027;1666;5613
220470;202011;3524;9646;3185;9111;95;239;2611;7386;2706;7625
220480;202011;2817;7169;2259;6270;222;499;1453;4104;1675;4603
220490;202011;2461;6114;2126;5692;24;123;1858;4896;1882;5019
220500;202011;2813;7096;2434;6485;60;180;1986;5173;2046;5353
220510;202011;2506;7064;1988;6128;71;198;1559;4853;1630;5051
220515;202011;1623;3911;1501;3740;41;58;1303;3255;1344;3313
220520;202011;4857;12578;4408;11942;104;291;3840;10333;3944;10624
220525;202011;1334;3330;1153;3100;8;38;1060;2817;1068;2855
220527;202011;1281;3590;1099;3326;11;51;946;2912;957;2963
220530;202011;1410;3501;1224;3258;29;89;1124;2968;1153;3057
220535;202011;797;2172;748;2108;29;86;606;1702;635;1788
220540;202011;3181;10112;2982;9731;132;441;2534;8240;2666;8681
220545;202011;1405;4206;1298;4033;68;256;1081;3319;1149;3575
220550;202011;8414;25767;7515;24206;473;1614;5734;18330;6207;19944
220551;202011;1389;3915;1232;3655;26;109;1011;2936;1037;3045
220552;202011;1553;4490;1271;3992;25;124;1031;3130;1056;3254
220553;202011;1752;4474;1448;4069;56;100;1170;3417;1226;3517
220554;202011;902;2331;654;1928;49;121;423;1234;472;1355
220555;202011;2305;6804;2053;6468;40;165;1705;5484;1745;5649
220556;202011;1179;3383;1030;3104;54;220;749;2164;803;2384
220557;202011;1613;4905;1359;4377;66;246;1009;3148;1075;3394
220558;202011;1377;3557;1083;3151;17;71;932;2688;949;2759
220559;202011;1766;4325;1507;3931;12;30;1228;3240;1240;3270
220560;202011;1713;3857;1407;3466;37;71;1280;3182;1317;3253
220570;202011;7025;20961;6409;20088;449;1411;5093;16089;5542;17500
220580;202011;6805;18584;6223;17644;79;278;5658;15940;5737;16218
220585;202011;2018;6323;1671;5682;44;147;1368;4712;1412;4859
220590;202011;1324;3538;1089;3184;70;193;773;2301;843;2494
220595;202011;2525;6843;2294;6522;21;103;2052;5771;2073;5874
220600;202011;1378;3063;1160;2793;88;108;968;2426;1056;2534
220605;202011;1563;4602;1340;4193;20;119;1099;3337;1119;3456
220610;202011;2734;7963;2565;7706;30;132;2403;7200;2433;7332
220620;202011;7727;23798;7133;22997;168;863;6512;20753;6680;21616
220630;202011;370;1079;284;918;22;76;191;611;213;687
220635;202011;1646;5106;1463;4709;48;239;1125;3515;1173;3754
220640;202011;2435;6757;2075;6236;74;299;1684;5005;1758;5304
220650;202011;2028;5597;1765;5199;35;131;1430;4205;1465;4336
220660;202011;2546;7940;2173;7310;74;362;1825;6012;1899;6374
220665;202011;1213;3657;1023;3338;30;168;849;2696;879;2864
220667;202011;1596;4919;1435;4617;57;218;1162;3719;1219;3937
220669;202011;1568;4764;1504;4667;46;222;1347;4081;1393;4303
220670;202011;2174;5607;1748;5010;15;74;1523;4357;1538;4431
220672;202011;3189;7760;2582;7019;95;313;2294;6159;2389;6472
220675;202011;1252;3415;1116;3167;30;97;924;2592;954;2689
220680;202011;2673;7214;2549;7043;99;222;2341;6514;2440;6736
220690;202011;1535;4045;1361;3781;52;152;1093;3037;1145;3189
220695;202011;886;2433;822;2325;21;62;718;2021;739;2083
220700;202011;9737;23912;7862;21347;323;898;6046;16345;6369;17243
220710;202011;898;2452;660;2002;36;109;496;1477;532;1586
220720;202011;2095;4949;1886;4671;17;70;1652;4039;1669;4109
220730;202011;1300;3615;1103;3275;12;65;935;2719;947;2784
220735;202011;959;2223;756;1909;19;67;625;1520;644;1587
220740;202011;1334;3446;1078;3117;27;70;905;2664;932;2734
220750;202011;3760;9553;3301;8899;187;452;2862;7759;3049;8211
220755;202011;1317;3192;1095;2861;20;76;899;2288;919;2364
220760;202011;3065;8378;2703;7891;62;185;2450;7209;2512;7394
220770;202011;22971;67482;19351;61268;5816;19435;6755;22364;12571;41799
220775;202011;1152;2905;1025;2745;14;46;982;2615;996;2661
220777;202011;1583;4012;1201;3427;30;77;923;2650;953;2727
220779;202011;1251;3206;1085;2965;17;59;959;2592;976;2651
220780;202011;5538;13872;4812;12775;203;642;3938;10225;4141;10867
220785;202011;1475;3240;1291;3003;10;30;1239;2860;1249;2890
220790;202011;10105;28482;9119;27060;206;932;7670;22543;7876;23475
220793;202011;918;2407;732;2081;10;29;614;1760;624;1789
220795;202011;1367;3529;1208;3306;19;70;1074;2929;1093;2999
220800;202011;17679;39002;15016;35510;632;1419;11688;27690;12320;29109
220810;202011;2986;8216;2523;7400;53;157;2081;6051;2134;6208
220820;202011;4823;12640;4212;11740;260;640;3185;8872;3445;9512
220830;202011;7181;18947;6454;17944;247;775;5369;14712;5616;15487
220840;202011;11984;36618;9994;32526;2221;6897;4665;15847;6886;22744
220850;202011;3097;9529;2797;9153;54;286;2496;8166;2550;8452
220855;202011;684;1731;598;1617;15;52;543;1459;558;1511
220860;202011;1041;2584;906;2369;17;68;818;2107;835;2175
220865;202011;2425;6382;1890;5423;89;335;1383;3832;1472;4167
220870;202011;2986;8194;2501;7550;32;162;2304;6936;2336;7098
220880;202011;5248;12310;4521;11405;87;310;4121;10281;4208;10591
220885;202011;1379;4131;1147;3739;51;182;911;3013;962;3195
220887;202011;1580;3347;1321;3011;14;31;1231;2789;1245;2820
220890;202011;1389;4214;1219;3958;45;159;1017;3348;1062;3507
220900;202011;1988;4709;1665;4289;32;74;1468;3774;1500;3848
220910;202011;1499;4091;1264;3748;55;165;1043;3126;1098;3291
220915;202011;933;2523;760;2209;4;18;581;1638;585;1656
220920;202011;1426;4384;1233;4129;54;228;1019;3434;1073;3662
220930;202011;1738;4631;1459;4230;18;58;1361;3933;1379;3991
220935;202011;1086;3114;876;2667;25;100;570;1644;595;1744
220937;202011;1441;3794;1235;3478;25;91;988;2738;1013;2829
220940;202011;1538;4244;1230;3695;34;113;956;2837;990;2950
220945;202011;434;1495;377;1367;21;124;281;977;302;1101
220950;202011;1399;3216;916;2464;17;57;731;1904;748;1961
220955;202011;1614;4064;1339;3592;24;69;1149;3042;1173;3111
220960;202011;789;1997;594;1668;19;60;419;1115;438;1175
220965;202011;1776;4815;1553;4484;21;130;1345;3798;1366;3928
220970;202011;1954;4613;1437;3843;30;84;1209;3197;1239;3281
220975;202011;676;1914;585;1798;16;87;522;1546;538;1633
220980;202011;1131;3186;1003;3013;38;140;833;2479;871;2619
220985;202011;1212;3167;1054;2935;44;123;857;2324;901;2447
220987;202011;1393;4150;1216;3836;55;206;982;3087;1037;3293
220990;202011;1691;4616;1490;4320;19;101;1263;3602;1282;3703
220995;202011;1066;3216;883;2876;38;126;631;2074;669;2200
220997;202011;2345;7085;2168;6803;47;211;1935;6005;1982;6216
221000;202011;4435;11999;3914;11222;80;362;3355;9502;3435;9864
221005;202011;1449;3786;1326;3589;18;96;1156;3029;1174;3125
221010;202011;1232;2769;983;2464;20;59;854;2098;874;2157
221020;202011;1501;4596;1396;4402;19;71;1064;3318;1083;3389
221030;202011;1609;3964;1387;3697;22;63;1200;3242;1222;3305
221035;202011;1473;3817;1298;3579;20;26;1153;3262;1173;3288
221037;202011;672;1841;557;1644;8;25;396;1120;404;1145
221038;202011;512;1443;398;1236;12;42;276;854;288;896
221039;202011;847;2301;734;2109;21;95;592;1625;613;1720
221040;202011;3975;11782;3455;10850;157;542;2727;8560;2884;9102
221050;202011;3857;10093;3413;9527;65;229;3074;8571;3139;8800
221060;202011;8342;23124;6939;20889;281;751;5666;17207;5947;17958
221062;202011;1122;3613;968;3361;37;171;789;2703;826;2874
221063;202011;1043;2856;905;2657;54;178;708;2036;762;2214
221065;202011;2581;6617;2274;6069;18;61;2012;5285;2030;5346
221070;202011;3338;10288;2698;8951;298;967;1662;5648;1960;6615
221080;202011;3442;8458;2818;7524;60;218;2320;6078;2380;6296
221090;202011;1383;3529;1138;3128;9;34;982;2646;991;2680
221093;202011;1345;3772;1223;3527;136;379;822;2335;958;2714
221095;202011;856;2228;729;2034;11;35;617;1692;628;1727
221097;202011;833;2150;638;1803;22;66;467;1256;489;1322
221100;202011;114433;303837;94998;270471;9802;29946;61796;171212;71598;201158
221110;202011;9775;29077;8990;28056;138;699;8074;24943;8212;25642
221120;202011;4701;12879;4197;12079;151;463;3663;10528;3814;10991
221130;202011;5306;13734;3978;11156;786;2102;1905;5392;2691;7494
221135;202011;1643;4277;1475;4053;48;141;1304;3593;1352;3734
221140;202011;1306;3060;1104;2806;11;37;996;2484;1007;2521
221150;202011;1100;2714;858;2293;21;96;669;1670;690;1766
221160;202011;714;1765;629;1655;15;19;516;1367;531;1386
221170;202011;965;2781;886;2633;16;56;769;2259;785;2315
230010;202011;2943;7648;2433;6798;31;112;2033;5569;2064;5681
230015;202011;3000;9590;2625;8838;163;602;1865;6247;2028;6849
230020;202011;12649;39755;11815;38473;324;1331;10099;32702;10423;34033
230030;202011;12865;31805;10779;29113;199;573;9474;25590;9673;26163
230040;202011;4427;11317;3673;10109;50;232;3080;8346;3130;8578
230050;202011;2715;8361;2055;6816;333;1059;927;3013;1260;4072
230060;202011;2295;6309;1851;5519;38;163;1459;4282;1497;4445
230070;202011;3884;10197;3114;8710;143;424;2224;6152;2367;6576
230075;202011;8730;28409;8012;27141;473;1944;6387;21381;6860;23325
230080;202011;3000;6293;2283;5422;6;18;2096;4990;2102;5008
230090;202011;4309;10525;3646;9487;166;425;2945;7615;3111;8040
230100;202011;17801;45815;15602;42838;1253;3333;11199;31073;12452;34406
230110;202011;12530;36973;10492;32965;1702;5281;5526;17577;7228;22858
230120;202011;7340;19492;6454;18057;524;1267;4775;13567;5299;14834
230125;202011;3138;8251;2546;7299;86;287;1968;5564;2054;5851
230130;202011;5621;17213;4543;14832;366;1255;2980;9603;3346;10858
230140;202011;3322;9927;2827;8921;92;378;2184;6723;2276;7101
230150;202011;1567;4701;1284;4073;202;556;747;2461;949;3017
230160;202011;6330;16394;5452;15023;180;618;4452;12064;4632;12682
230170;202011;6166;17448;5024;15119;283;844;3643;10795;3926;11639
230180;202011;1610;4433;1367;3973;19;84;1123;3168;1142;3252
230185;202011;4389;12308;3708;11167;263;871;2760;8287;3023;9158
230190;202011;12994;37567;10906;33717;1436;4608;6300;19340;7736;23948
230195;202011;5205;15280;4739;14391;393;1161;3553;10781;3946;11942
230200;202011;4922;13517;4138;12046;155;491;3183;9093;3338;9584
230205;202011;4122;12064;3614;11284;211;672;2736;8536;2947;9208
230210;202011;10089;24260;8516;22152;332;1094;6737;17191;7069;18285
230220;202011;13666;34274;11976;31832;591;1575;9915;26123;10506;27698
230230;202011;6784;20173;6047;18678;401;1220;4481;13826;4882;15046
230240;202011;12733;34111;11017;31163;268;1165;9140;25243;9408;26408
230250;202011;8836;24534;8211;23570;238;809;6675;18657;6913;19466
230260;202011;14491;42768;12525;39260;1885;5638;7019;22600;8904;28238
230270;202011;7571;20243;5768;16847;500;1419;3773;11099;4273;12518
230280;202011;20093;53433;16384;47141;459;1933;12962;35897;13421;37830
230290;202011;4894;13349;4040;11758;242;628;3086;8965;3328;9593
230300;202011;4754;12584;4298;11971;99;284;3787;10514;3886;10798
230310;202011;4468;12708;3792;11511;128;563;2756;8138;2884;8701
230320;202011;7655;21979;6444;19776;229;945;4969;14927;5198;15872
230330;202011;4513;12326;3581;10533;134;443;2712;7802;2846;8245
230340;202011;3611;11060;3085;9994;263;913;2090;6675;2353;7588
230350;202011;17704;48187;15478;44936;815;2722;10528;30759;11343;33481
230360;202011;2877;7540;2262;6462;130;375;1558;4399;1688;4774
230365;202011;3012;7398;2484;6619;53;235;2123;5564;2176;5799
230370;202011;57600;158921;48879;145904;7110;21403;29504;89287;36614;110690
230380;202011;6109;16967;4847;14662;128;508;3603;10681;3731;11189
230390;202011;3344;9797;2892;9065;88;363;2277;7043;2365;7406
230393;202011;3286;9591;2625;8221;85;428;2024;6089;2109;6517
230395;202011;5671;15406;4942;14198;313;847;3534;10174;3847;11021
230400;202011;5324;14633;4742;13672;96;488;3814;10681;3910;11169
230410;202011;13731;40413;11357;36015;865;2975;7876;24946;8741;27921
230420;202011;28565;77586;23201;68314;2816;8626;13156;38446;15972;47072
230423;202011;4648;13638;4062;12472;80;363;3357;10113;3437;10476
230425;202011;5547;16926;5058;15934;406;1361;3630;11351;4036;12712
230426;202011;2780;7211;2023;5737;28;104;1524;4225;1552;4329
230427;202011;1791;5046;1274;3947;56;187;850;2521;906;2708
230428;202011;9350;24794;7954;22688;1069;3015;4709;13407;5778;16422
230430;202011;5016;13885;3926;11972;159;525;2935;8814;3094;9339
230435;202011;5861;15278;4868;13512;626;1642;2933;8247;3559;9889
230440;202011;408508;1003573;338524;900483;32408;91431;222114;583036;254522;674467
230445;202011;4216;11127;3410;9724;175;491;2343;6529;2518;7020
230450;202011;3519;10023;3059;9352;243;918;2236;6622;2479;7540
230460;202011;2097;5810;1835;5400;53;216;1548;4522;1601;4738
230465;202011;4025;11178;3421;10018;97;378;2599;7326;2696;7704
230470;202011;11123;36653;9946;34479;870;3371;7040;24031;7910;27402
230480;202011;1434;4135;1221;3748;62;250;914;2694;976;2944
230490;202011;2495;6959;2094;6198;160;543;1323;3677;1483;4220
230495;202011;5647;16682;4981;15478;378;1373;3329;10219;3707;11592
230500;202011;9297;29406;8308;27602;253;1048;6841;22682;7094;23730
230510;202011;1582;4709;1246;3983;165;578;643;2026;808;2604
230520;202011;4523;12651;3902;11546;332;931;2720;8091;3052;9022
230523;202011;15262;44583;12084;37771;2703;8424;3168;10563;5871;18987
230526;202011;3679;10420;3135;9496;186;523;2281;6984;2467;7507
230530;202011;5381;16665;4515;14943;277;1038;3294;10720;3571;11758
230533;202011;4474;10514;3697;9280;97;264;3095;7642;3192;7906
230535;202011;5195;14389;4393;13032;266;787;3003;9008;3269;9795
230540;202011;15804;42791;13594;39556;273;1049;11286;32589;11559;33638
230550;202011;20755;54369;16671;47446;1466;4287;10824;30615;12290;34902
230560;202011;7992;19383;6507;17046;56;226;5616;14575;5672;14801
230565;202011;3004;8306;2539;7454;101;408;1954;5615;2055;6023
230570;202011;3341;8586;2858;7915;81;233;2354;6502;2435;6735
230580;202011;10877;27915;9321;25704;344;944;7719;21193;8063;22137
230590;202011;8891;24906;7387;22151;410;1421;5505;15957;5915;17378
230600;202011;3600;9257;2857;7954;76;207;1985;5566;2061;5773
230610;202011;6579;18020;5846;16791;445;1243;4627;13218;5072;14461
230620;202011;2067;5547;1583;4603;118;367;966;2708;1084;3075
230625;202011;7870;22097;6580;19735;1973;6138;1816;5888;3789;12026
230630;202011;10657;31508;9226;28677;1415;4170;5402;17161;6817;21331
230640;202011;27277;81880;24700;77816;1143;4498;19878;61694;21021;66192
230650;202011;5180;13765;4388;12398;129;492;3580;9875;3709;10367
230655;202011;9184;30841;8631;29888;646;2240;6898;24188;7544;26428
230660;202011;5932;17524;4862;15667;152;807;3955;12468;4107;13275
230670;202011;6135;14470;4485;11831;131;438;3631;9345;3762;9783
230680;202011;2611;7101;2213;6397;123;347;1597;4634;1720;4981
230690;202011;7115;20869;6108;18873;398;1402;3869;11746;4267;13148
230700;202011;10036;25696;8113;22134;309;809;6030;16181;6339;16990
230710;202011;6687;20976;5842;19178;615;1928;3919;12791;4534;14719
230720;202011;1814;5349;1480;4676;112;339;1024;3160;1136;3499
230725;202011;3977;11624;3561;10897;367;1280;2123;6396;2490;7676
230730;202011;55298;148654;43303;130402;9547;31012;14767;46917;24314;77929
230740;202011;5982;16464;5079;15014;128;442;4075;12020;4203;12462
230750;202011;8248;21773;6864;19496;159;535;5500;15249;5659;15784
230760;202011;10822;28369;9430;26297;474;1572;7201;19611;7675;21183
230763;202011;4870;12949;4100;11582;116;528;3349;9150;3465;9678
230765;202011;40222;108259;33243;96878;5039;15200;17182;49588;22221;64788
230770;202011;24840;61243;20721;55806;2072;5622;13850;37419;15922;43041
230780;202011;6371;22077;5794;20711;831;2914;3418;12568;4249;15482
230790;202011;2980;8506;2678;8007;111;450;2035;5903;2146;6353
230800;202011;8112;25524;7117;23498;909;3198;4148;13503;5057;16701
230810;202011;11021;32926;9878;31090;360;1340;7731;23905;8091;25245
230820;202011;3392;10988;2773;9607;266;1043;1631;5413;1897;6456
230830;202011;7385;20033;6318;18251;127;529;5254;14804;5381;15333
230835;202011;4235;10028;3219;8402;91;273;2601;6662;2692;6935
230837;202011;3004;9163;2668;8582;108;475;2159;6790;2267;7265
230840;202011;9091;26276;7818;24120;875;2516;5509;17200;6384;19716
230850;202011;9564;27456;8012;24387;344;1220;5829;17456;6173;18676
230860;202011;5196;12991;4294;11693;58;193;3822;10351;3880;10544
230870;202011;16270;39360;14000;35569;381;1060;11541;28798;11922;29858
230880;202011;2084;6253;1910;5968;47;243;1526;4648;1573;4891
230890;202011;4452;14183;4059;13397;327;1172;2959;9633;3286;10805
230900;202011;2908;8325;2496;7539;179;610;1699;5025;1878;5635
230910;202011;3079;8230;2498;7325;62;280;2023;5919;2085;6199
230920;202011;4526;12672;3803;11531;119;489;3038;9017;3157;9506
230930;202011;6413;17771;5362;15903;299;851;3770;11188;4069;12039
230940;202011;8192;20395;7044;18635;208;493;5897;15507;6105;16000
230945;202011;6471;18386;5532;16584;291;1022;3973;11661;4264;12683
230950;202011;6083;15320;5375;14345;95;245;4663;12459;4758;12704
230960;202011;13156;37791;11533;34726;1935;5743;5737;17467;7672;23210
230970;202011;13400;35222;11131;31675;1654;4581;6487;18731;8141;23312
230980;202011;2635;7616;2330;7090;337;962;1467;4618;1804;5580
230990;202011;1603;4481;1324;3925;62;260;959;2716;1021;2976
231000;202011;2473;6582;2019;5690;80;204;1504;4140;1584;4344
231010;202011;3574;8300;2805;6976;40;159;2441;5883;2481;6042
231020;202011;7865;24432;7009;22769;1279;3793;4024;13633;5303;17426
231025;202011;7328;19995;6373;18452;698;1964;4493;13136;5191;15100
231030;202011;7324;21527;5730;18160;982;2952;2919;9338;3901;12290
231040;202011;2898;8262;2519;7556;127;372;1977;5843;2104;6215
231050;202011;11367;29073;9192;25223;628;1689;6925;18593;7553;20282
231060;202011;2835;7900;2493;7360;56;176;2084;6153;2140;6329
231070;202011;7589;21933;6517;20064;657;2095;4333;13248;4990;15343
231080;202011;3899;11020;3314;10065;130;527;2532;7523;2662;8050
231085;202011;6648;16044;5257;14395;205;516;4121;11295;4326;11811
231090;202011;4507;11606;3297;9288;110;419;2250;6088;2360;6507
231095;202011;2242;6610;1770;5602;142;440;1191;3768;1333;4208
231100;202011;3142;8999;2587;7953;113;410;1948;5913;2061;6323
231110;202011;3605;10436;3279;9834;133;476;2478;7317;2611;7793
231120;202011;2258;6474;1865;5792;87;313;1346;4140;1433;4453
231123;202011;1867;4802;1562;4278;76;163;1148;3174;1224;3337
231126;202011;5366;14694;4378;12825;302;846;3167;9189;3469;10035
231130;202011;21174;53517;17577;49025;1014;3576;13103;35862;14117;39438
231135;202011;4005;11262;3327;9929;150;499;2410;7076;2560;7575
231140;202011;16065;44849;12860;39263;596;2385;9171;27299;9767;29684
231150;202011;5720;15396;4373;12880;658;1963;1952;5914;2610;7877
231160;202011;6163;18709;5413;17326;757;2313;3151;10322;3908;12635
231170;202011;4133;12044;3435;10731;166;600;2455;7416;2621;8016
231180;202011;14038;39497;11388;33933;3112;8938;3928;12239;7040;21177
231190;202011;3780;10587;3099;9351;72;294;2394;7081;2466;7375
231195;202011;4929;14651;4105;12954;264;926;2988;9365;3252;10291
231200;202011;7678;23762;6701;21772;184;931;5341;16802;5525;17733
231210;202011;4731;13780;4040;12647;171;632;3084;9477;3255;10109
231220;202011;11997;30901;9235;25678;406;1206;6811;18302;7217;19508
231230;202011;9057;28816;8002;26875;508;1966;5891;19810;6399;21776
231240;202011;11387;32930;10005;30312;1539;4494;6095;18749;7634;23243
231250;202011;2143;5453;1395;3795;112;316;842;2233;954;2549
231260;202011;3212;8979;2780;8299;260;754;1902;5794;2162;6548
231270;202011;6212;16212;5038;14300;138;539;3812;10554;3950;11093
231280;202011;1668;5189;1522;4919;83;276;1158;3723;1241;3999
231290;202011;37202;110175;30780;97159;5187;16150;14379;45241;19566;61391
231300;202011;4016;11029;3150;9301;185;598;2119;6115;2304;6713
231310;202011;7315;18670;5809;15887;485;1321;4021;10777;4506;12098
231320;202011;7770;21093;6081;18104;87;392;4762;13954;4849;14346
231325;202011;2367;6174;1948;5544;162;367;1346;3940;1508;4307
231330;202011;9204;27250;7606;24058;1372;4128;4083;13519;5455;17647
231335;202011;5562;14645;4751;13348;78;345;4208;11692;4286;12037
231340;202011;17391;52842;15657;49760;1283;4084;11590;37180;12873;41264
231350;202011;15485;42317;14150;40408;236;874;12760;36065;12996;36939
231355;202011;4321;12784;3900;11987;223;730;3059;9285;3282;10015
231360;202011;7306;21922;6325;20221;258;920;5045;16062;5303;16982
231370;202011;2121;5831;1694;5070;35;113;1296;3864;1331;3977
231375;202011;4257;13242;3892;12646;132;603;3261;10460;3393;11063
231380;202011;5966;16172;5407;15406;187;495;4400;12709;4587;13204
231390;202011;3245;9456;2912;8898;120;457;2168;6451;2288;6908
231395;202011;3955;11509;3274;10416;416;1320;1930;6238;2346;7558
231400;202011;9547;27243;7989;24385;264;1122;6060;18095;6324;19217
231410;202011;14488;44683;13176;42484;600;2153;10730;34279;11330;36432
240010;202011;2561;6661;1995;5641;199;564;1205;3353;1404;3917
240020;202011;12221;34168;10252;30664;612;2295;6902;20329;7514;22624
240030;202011;2805;6833;2538;6418;82;230;2205;5544;2287;5774
240040;202011;803;2313;668;2050;30;117;464;1370;494;1487
240050;202011;3230;8631;2620;7529;45;141;2014;5686;2059;5827
240060;202011;1372;3668;1128;3227;22;83;925;2591;947;2674
240070;202011;2085;6019;1878;5582;175;554;1373;3971;1548;4525
240080;202011;2862;7691;2330;6731;53;204;1791;5077;1844;5281
240090;202011;2197;5416;1798;4749;19;51;1516;3978;1535;4029
240100;202011;9999;24426;7945;20745;195;582;6262;15811;6457;16393
240110;202011;4483;12632;3773;11344;181;661;2764;8154;2945;8815
240120;202011;3233;8941;2601;8159;181;605;1853;5954;2034;6559
240130;202011;3579;7469;2979;6686;28;85;2725;6028;2753;6113
240140;202011;1700;5127;1463;4655;149;526;1006;3165;1155;3691
240145;202011;6399;17728;5204;15684;783;2405;2966;9056;3749;11461
240150;202011;902;2644;792;2411;51;180;608;1797;659;1977
240160;202011;1418;4284;1188;3855;45;204;895;2913;940;3117
240165;202011;954;2590;789;2275;25;86;651;1842;676;1928
240170;202011;2504;6726;2105;6009;190;610;1444;3991;1634;4601
240180;202011;2930;8646;2333;7425;554;1673;1040;3520;1594;5193
240185;202011;1206;3752;1109;3578;55;216;918;2930;973;3146
240190;202011;1065;3104;911;2847;19;89;777;2438;796;2527
240200;202011;10633;26977;8454;23301;848;2534;4919;13229;5767;15763
240210;202011;3226;7908;2635;6975;26;137;2227;5709;2253;5846
240220;202011;7147;21323;6407;20146;324;1421;5101;15736;5425;17157
240230;202011;5713;14526;4582;12636;209;566;3642;10087;3851;10653
240240;202011;1780;5128;1100;3522;102;344;380;1091;482;1435
240250;202011;2931;7632;2569;7139;88;270;2172;6001;2260;6271
240260;202011;13726;40372;11874;37250;1682;4936;7381;24289;9063;29225
240270;202011;2260;6702;1966;6207;106;320;1419;4652;1525;4972
240280;202011;1678;4278;1420;3854;54;146;1136;3048;1190;3194
240290;202011;1139;3312;925;2839;29;134;670;1934;699;2068
240300;202011;2292;5824;1643;4635;65;197;1036;2859;1101;3056
240310;202011;8275;21807;6509;18640;852;2589;3386;9560;4238;12149
240320;202011;2071;5578;1507;4480;34;153;1129;3198;1163;3351
240325;202011;30806;81551;24411;70270;4197;12399;11135;32192;15332;44591
240330;202011;1732;4703;1328;3936;55;191;909;2566;964;2757
240340;202011;1902;4391;1564;3886;59;145;1294;3165;1353;3310
240350;202011;2153;5462;1930;5215;32;97;1739;4716;1771;4813
240360;202011;8897;24275;7915;22734;764;2228;5655;16402;6419;18630
240370;202011;1902;4924;1478;4064;62;180;1061;2843;1123;3023
240375;202011;894;2235;747;1978;28;104;610;1561;638;1665
240380;202011;2196;6210;1623;4929;141;401;948;2855;1089;3256
240390;202011;1045;2509;737;1926;29;65;474;1160;503;1225
240400;202011;1458;3524;1130;2960;34;110;796;1963;830;2073
240410;202011;539;1620;454;1433;37;142;292;872;329;1014
240420;202011;4482;15679;3934;14442;441;1919;2359;8472;2800;10391
240430;202011;3357;8563;2785;7573;171;529;2087;5503;2258;6032
240440;202011;2476;5356;2096;4837;138;258;1707;3972;1845;4230
240450;202011;4456;12047;3462;10181;337;1018;2059;5836;2396;6854
240460;202011;2869;8143;2557;7636;217;704;2015;5987;2232;6691
240470;202011;3602;10798;2738;8996;478;1480;1417;4875;1895;6355
240480;202011;564;1546;384;1150;31;98;184;535;215;633
240485;202011;2160;6000;1747;5249;116;357;1208;3627;1324;3984
240490;202011;1577;4054;1241;3422;84;194;914;2548;998;2742
240500;202011;2137;5716;1861;5247;100;263;1499;4247;1599;4510
240510;202011;1674;4363;1458;4047;62;224;1206;3279;1268;3503
240520;202011;1470;3537;1143;3084;53;155;865;2342;918;2497
240530;202011;2144;6025;1932;5690;93;293;1618;4725;1711;5018
240540;202011;2268;5637;1976;5179;59;102;1713;4521;1772;4623
240550;202011;668;1897;605;1770;17;72;510;1446;527;1518
240560;202011;3240;8389;2732;7700;267;663;1991;5739;2258;6402
240570;202011;2776;7223;1836;5158;273;769;718;1908;991;2677
240580;202011;7914;23058;7003;21369;541;1562;5609;17278;6150;18840
240590;202011;719;1868;620;1700;11;38;474;1266;485;1304
240600;202011;1757;4776;1294;3807;44;142;859;2446;903;2588
240610;202011;4066;10885;3470;9812;122;409;2689;7471;2811;7880
240615;202011;1255;3204;1001;2750;113;295;675;1824;788;2119
240620;202011;1818;5069;1566;4639;103;265;1243;3695;1346;3960
240630;202011;2029;5735;1830;5394;134;287;1316;4043;1450;4330
240640;202011;953;2525;756;2197;31;112;565;1605;596;1717
240650;202011;3968;11068;3416;9929;233;686;2596;7435;2829;8121
240660;202011;3038;7745;2701;7311;45;146;2463;6666;2508;6812
240670;202011;2422;6825;1944;5843;140;442;1260;3694;1400;4136
240680;202011;1608;4240;1299;3707;47;143;993;2764;1040;2907
240690;202011;995;2467;786;2122;16;69;631;1635;647;1704
240700;202011;2405;6929;1954;6083;51;187;1537;4710;1588;4897
240710;202011;15887;40952;13286;36491;1683;4525;8372;22981;10055;27506
240720;202011;5043;12318;4350;11358;381;1031;3223;8328;3604;9359
240725;202011;1108;3137;847;2620;39;124;570;1705;609;1829
240730;202011;2236;6214;1801;5360;60;210;1365;3999;1425;4209
240740;202011;1794;4796;1427;4077;44;167;1059;2868;1103;3035
240750;202011;2085;6837;1763;6157;257;974;948;3331;1205;4305
240760;202011;1641;3778;1169;3051;68;97;896;2430;964;2527
240770;202011;3170;8714;2675;7994;125;447;2175;6430;2300;6877
240780;202011;4630;12797;3802;11415;522;1540;2349;7251;2871;8791
240790;202011;858;2421;716;2139;19;85;548;1584;567;1669
240800;202011;46710;111111;36220;95276;4966;13289;18889;49799;23855;63088
240810;202011;88712;227631;74933;204774;8666;24384;48851;131339;57517;155723
240820;202011;5773;17077;4998;15693;680;2101;3103;9932;3783;12033
240830;202011;8608;24316;7646;22868;263;1067;6328;18677;6591;19744
240840;202011;1102;2711;872;2341;29;74;628;1620;657;1694
240850;202011;1341;3618;964;2830;48;150;541;1537;589;1687
240860;202011;1300;3452;980;2875;16;76;733;2048;749;2124
240870;202011;1073;2708;807;2249;129;371;439;1255;568;1626
240880;202011;1246;3921;1097;3630;79;335;854;2752;933;3087
240890;202011;4285;11621;3250;9652;434;1413;1689;4829;2123;6242
240895;202011;2794;8499;2571;8140;156;474;2205;7073;2361;7547
240910;202011;3357;9015;2870;8123;55;198;2353;6530;2408;6728
240920;202011;900;2431;741;2173;67;177;420;1288;487;1465
240930;202011;3633;8221;3001;7452;196;287;2252;5914;2448;6201
240933;202011;1669;4056;1398;3673;37;148;1236;3198;1273;3346
240940;202011;5862;14503;4588;12312;530;1440;2750;7206;3280;8646
240950;202011;1006;2995;879;2760;28;118;715;2192;743;2310
240960;202011;678;2069;608;1928;27;97;468;1455;495;1552
240970;202011;1852;4755;1491;4144;59;215;1214;3272;1273;3487
240980;202011;3266;9705;2883;9011;104;462;2346;7209;2450;7671
240990;202011;2534;7094;2222;6477;251;804;1573;4423;1824;5227
241000;202011;933;2447;739;2098;26;66;550;1537;576;1603
241010;202011;2782;8777;2534;8235;165;619;1868;5992;2033;6611
241020;202011;2095;5540;1561;4473;134;389;1017;2863;1151;3252
241025;202011;1773;5027;1407;4340;49;202;1026;3117;1075;3319
241030;202011;2449;7610;1958;6558;221;758;1265;4245;1486;5003
241040;202011;2273;7136;2000;6658;91;428;1609;5283;1700;5711
241050;202011;1338;3729;1107;3309;35;131;810;2356;845;2487
241060;202011;733;2056;645;1876;27;87;458;1283;485;1370
241070;202011;654;1779;559;1614;13;40;437;1222;450;1262
241080;202011;1118;3162;859;2633;8;35;626;1890;634;1925
241090;202011;1957;5700;1598;5081;44;217;1272;3979;1316;4196
241100;202011;1184;3277;914;2733;70;214;591;1718;661;1932
241105;202011;947;2862;772;2530;241;768;255;871;496;1639
241110;202011;970;2702;733;2209;34;97;489;1423;523;1520
241120;202011;7501;21094;6351;19058;942;2753;3776;11663;4718;14416
241140;202011;3255;8549;2558;7168;138;400;1853;5077;1991;5477
241142;202011;773;2056;564;1657;27;93;338;939;365;1032
241150;202011;5873;15196;5187;14073;140;465;4278;11412;4418;11877
241160;202011;1122;3007;898;2589;129;380;589;1656;718;2036
241170;202011;1325;3336;1120;2984;29;109;944;2419;973;2528
241180;202011;1017;2580;750;2059;90;255;379;1038;469;1293
241190;202011;1099;2878;921;2524;17;69;681;1801;698;1870
241200;202011;19246;49935;16577;45510;2625;7195;9709;26680;12334;33875
241210;202011;1395;3683;1008;2917;113;356;575;1629;688;1985
241220;202011;8803;25558;7664;23632;1715;5246;3717;11908;5432;17154
241230;202011;2924;7637;2573;7082;105;313;2147;5843;2252;6156
241240;202011;1203;3334;755;2341;65;204;336;1047;401;1251
241250;202011;5467;15711;4360;13628;158;713;3170;9538;3328;10251
241255;202011;2214;6884;1959;6339;108;433;1505;4773;1613;5206
241260;202011;4889;12628;3865;10915;81;316;3065;8468;3146;8784
241270;202011;1663;4797;1386;4271;103;348;1002;3091;1105;3439
241280;202011;2160;5383;1852;4825;59;148;1583;4069;1642;4217
241290;202011;3357;8189;2484;6771;73;238;1959;5201;2032;5439
241300;202011;1473;3909;1180;3391;36;124;803;2246;839;2370
241310;202011;2122;5205;1833;4798;13;51;1572;4162;1585;4213
241320;202011;915;2958;785;2716;84;354;514;1756;598;2110
241330;202011;1740;4451;1365;3948;17;91;1191;3408;1208;3499
241335;202011;3281;9050;2882;8312;110;356;2350;6691;2460;7047
241340;202011;1523;4234;1178;3521;246;783;488;1423;734;2206
241350;202011;2074;5874;1812;5408;94;320;1415;4159;1509;4479
241355;202011;1285;3473;1059;3032;14;42;825;2345;839;2387
241360;202011;2007;5185;1522;4207;40;118;1090;2902;1130;3020
241370;202011;1332;3677;1037;3063;48;155;724;2053;772;2208
241380;202011;633;1766;481;1471;73;189;240;764;313;953
241390;202011;2724;7914;2425;7463;193;526;1873;5879;2066;6405
241400;202011;3533;9728;3149;9132;139;464;2572;7393;2711;7857
241410;202011;2406;7104;1950;6167;340;1095;994;3156;1334;4251
241415;202011;1623;4800;1326;4221;59;214;933;2926;992;3140
241420;202011;2305;7142;1975;6579;464;1721;961;3198;1425;4919
241430;202011;593;1620;412;1221;18;60;260;735;278;795
241440;202011;7594;23065;6781;21622;369;1279;5351;17045;5720;18324
241445;202011;1102;2787;975;2622;21;55;865;2386;886;2441
241450;202011;2647;6497;2258;5868;389;854;1457;3962;1846;4816
241460;202011;3761;10119;3053;8636;190;562;2134;5901;2324;6463
241470;202011;1355;3592;1112;3230;28;101;926;2687;954;2788
241475;202011;1207;3353;951;2853;21;97;692;1983;713;2080
241480;202011;2920;9056;2391;7888;716;2338;795;2921;1511;5259
241490;202011;626;1474;512;1321;26;62;371;940;397;1002
241500;202011;786;2178;702;2071;3;10;652;1942;655;1952
250010;202011;2463;7392;2055;6547;57;227;1509;4703;1566;4930
250020;202011;1653;4342;1191;3444;47;88;837;2444;884;2532
250030;202011;6845;18651;6064;17405;543;1567;4513;12836;5056;14403
250040;202011;3960;12056;3421;11069;226;816;2498;7961;2724;8777
250050;202011;3583;9547;3246;9100;120;420;2678;7503;2798;7923
250053;202011;1157;3233;1056;3070;74;210;763;2238;837;2448
250057;202011;643;2292;601;2227;10;44;543;2038;553;2082
250060;202011;5418;14008;4862;13321;265;709;4065;11206;4330;11915
250070;202011;3949;10894;3332;9808;37;151;2693;7747;2730;7898
250073;202011;753;1989;613;1780;8;19;501;1421;509;1440
250077;202011;2172;5834;1634;4948;55;196;1245;3746;1300;3942
250080;202011;4852;12036;4103;11081;61;284;3594;9563;3655;9847
250090;202011;3326;8061;2892;7486;56;163;2481;6303;2537;6466
250100;202011;3617;10908;3254;10244;158;566;2567;7928;2725;8494
250110;202011;4853;13577;4371;12874;244;906;3440;9920;3684;10826
250115;202011;694;1794;502;1500;9;41;349;1037;358;1078
250120;202011;1851;5337;1550;4837;32;153;1225;3788;1257;3941
250130;202011;5491;14997;4646;13801;72;385;3950;11570;4022;11955
250135;202011;1165;3224;1019;2968;25;93;879;2546;904;2639
250140;202011;2241;6507;2084;6311;106;423;1799;5409;1905;5832
250150;202011;4685;14466;4193;13628;151;641;3352;10722;3503;11363
250153;202011;1374;3632;1150;3290;29;86;924;2619;953;2705
250157;202011;1779;5138;1610;4820;59;233;1303;3830;1362;4063
250160;202011;3874;9594;3089;8530;41;149;2720;7518;2761;7667
250170;202011;1805;4649;1621;4388;23;88;1418;3793;1441;3881
250180;202011;19941;47654;17014;43936;722;2198;13430;33870;14152;36068
250190;202011;3957;10538;3307;9570;311;932;2304;6516;2615;7448
250200;202011;1898;5063;1646;4720;58;180;1390;3992;1448;4172
250205;202011;851;2602;736;2428;13;65;611;1990;624;2055
250210;202011;1522;4590;1373;4354;70;302;1083;3379;1153;3681
250215;202011;1553;4225;1298;3875;79;262;775;2329;854;2591
250220;202011;656;1805;523;1606;24;91;346;1043;370;1134
250230;202011;1647;3688;1104;2850;16;55;923;2301;939;2356
250240;202011;2243;6834;1972;6335;37;185;1648;5219;1685;5404
250250;202011;4517;12508;3953;11684;84;279;3379;10006;3463;10285
250260;202011;1661;4617;1402;4169;50;123;1112;3284;1162;3407
250270;202011;1170;3540;1063;3406;53;196;803;2655;856;2851
250280;202011;3303;9122;2969;8633;106;295;2363;6898;2469;7193
250290;202011;1523;4022;1314;3719;20;65;1052;2969;1072;3034
250300;202011;5413;14389;4864;13744;181;809;4079;11120;4260;11929
250310;202011;1153;3170;966;2859;38;128;735;2151;773;2279
250320;202011;12021;26712;10340;24773;241;664;9293;21989;9534;22653
250330;202011;2351;6451;1974;5934;102;310;1599;4811;1701;5121
250340;202011;1090;2752;977;2610;13;35;904;2411;917;2446
250350;202011;4106;11418;3616;10589;200;470;2838;8586;3038;9056
250355;202011;1938;5890;1743;5621;30;166;1551;4965;1581;5131
250360;202011;1735;4784;1561;4549;37;140;1317;3797;1354;3937
250370;202011;13397;34198;11095;30692;237;862;9387;25600;9624;26462
250375;202011;1162;2998;936;2728;5;22;888;2602;893;2624
250380;202011;1595;4079;1460;3907;28;105;1286;3344;1314;3449
250390;202011;1799;4592;1516;4141;81;228;1219;3292;1300;3520
250400;202011;67901;165697;49833;137666;13971;41520;13995;41076;27966;82596
250403;202011;1739;4796;1548;4565;71;360;1211;3400;1282;3760
250407;202011;1243;3061;985;2679;74;161;681;1927;755;2088
250410;202011;641;1712;554;1565;4;9;462;1276;466;1285
250415;202011;1835;5132;1607;4768;29;136;1376;4061;1405;4197
250420;202011;1160;3248;1053;3093;29;101;934;2727;963;2828
250430;202011;6067;14949;5139;13718;129;399;4276;11193;4405;11592
250435;202011;1526;4247;1224;3728;14;73;942;2810;956;2883
250440;202011;4501;11900;3883;11121;68;190;3454;9895;3522;10085
250450;202011;1792;4717;1477;4282;28;97;1227;3575;1255;3672
250460;202011;7170;19378;6364;18186;337;1018;5106;14550;5443;15568
250470;202011;1523;3919;1265;3521;49;156;1002;2737;1051;2893
250480;202011;3937;10636;3347;9926;39;136;2956;8832;2995;8968
250485;202011;720;1612;529;1334;42;73;385;942;427;1015
250490;202011;5089;12048;4525;11403;165;488;4023;9951;4188;10439
250500;202011;1951;5351;1741;4986;71;224;1416;4059;1487;4283
250510;202011;5356;13460;4612;12472;74;193;4043;11016;4117;11209
250520;202011;1791;4809;1523;4419;122;390;1094;3155;1216;3545
250523;202011;2201;5425;1948;5104;72;289;1620;4084;1692;4373
250527;202011;1662;4244;1495;4053;25;72;1325;3618;1350;3690
250530;202011;621;1584;536;1465;5;11;476;1300;481;1311
250535;202011;1320;3897;1194;3657;25;110;973;2900;998;3010
250540;202011;2956;6724;2458;6168;77;137;2163;5531;2240;5668
250550;202011;750;2398;658;2217;22;86;495;1641;517;1727
250560;202011;1751;4772;1546;4477;37;137;1304;3698;1341;3835
250570;202011;2633;7828;2251;7129;78;289;1769;5526;1847;5815
250580;202011;1042;2713;917;2537;45;172;774;2092;819;2264
250590;202011;799;2238;717;2122;19;65;587;1748;606;1813
250600;202011;8059;20586;6715;18851;235;740;5551;15453;5786;16193
250610;202011;2920;8224;2615;7777;116;438;2173;6382;2289;6820
250620;202011;791;2040;680;1857;9;21;500;1343;509;1364
250625;202011;2440;7004;2182;6577;41;211;1864;5461;1905;5672
250630;202011;10091;27624;8154;24247;859;2569;5226;15251;6085;17820
250640;202011;3451;9393;3094;8925;101;383;2634;7494;2735;7877
250650;202011;944;2267;800;2070;13;36;699;1786;712;1822
250660;202011;1597;3961;1274;3517;38;107;1051;2834;1089;2941
250670;202011;2283;7113;2077;6750;43;190;1814;5795;1857;5985
250680;202011;5725;13254;5119;12569;55;210;4756;11529;4811;11739
250690;202011;6711;15047;5654;13724;98;235;5023;12102;5121;12337
250700;202011;4163;11692;3637;10896;437;1297;2516;7522;2953;8819
250710;202011;4265;12291;3741;11558;275;934;2736;8450;3011;9384
250720;202011;2703;7231;2414;6815;36;180;2115;5902;2151;6082
250730;202011;4066;10799;3554;10116;101;419;2983;8253;3084;8672
250740;202011;1879;4671;1576;4276;94;205;1231;3378;1325;3583
250750;202011;102678;250318;86851;228065;6824;19343;63886;164583;70710;183926
250760;202011;2326;5997;2028;5513;85;249;1618;4276;1703;4525
250770;202011;3947;11898;3537;11347;381;1183;2551;8298;2932;9481
250780;202011;1731;4641;1450;4131;48;173;1123;3110;1171;3283
250790;202011;2439;7147;2103;6642;130;511;1440;4435;1570;4946
250800;202011;2381;6314;2086;5833;83;169;1710;4826;1793;4995
250810;202011;1252;3282;1048;2995;30;61;887;2576;917;2637
250820;202011;1968;5401;1810;5228;30;129;1644;4719;1674;4848
250830;202011;5784;17222;4757;15142;273;1031;3264;10095;3537;11126
250840;202011;748;2367;643;2158;14;56;490;1655;504;1711
250850;202011;1763;5213;1584;4885;32;144;1314;3962;1346;4106
250855;202011;970;2822;826;2578;52;203;605;1868;657;2071
250860;202011;3105;9181;2583;8298;430;1461;1517;4879;1947;6340
250870;202011;993;2736;852;2502;34;125;702;2032;736;2157
250880;202011;1589;4059;1317;3665;72;210;1021;2840;1093;3050
250890;202011;10119;25920;8933;24330;416;1602;7151;18616;7567;20218
250900;202011;2860;7769;2476;7098;89;252;2077;5870;2166;6122
250905;202011;2422;6773;2229;6502;42;164;2036;5932;2078;6096
250910;202011;5925;14504;4893;13329;81;281;4290;11720;4371;12001
250915;202011;2141;4937;1486;4230;26;56;1297;3778;1323;3834
250920;202011;3469;8754;3034;8095;327;744;2238;6026;2565;6770
250930;202011;2235;5952;2022;5674;55;228;1754;4817;1809;5045
250933;202011;1145;3389;1010;3142;19;94;781;2367;800;2461
250937;202011;678;1816;558;1621;21;70;429;1266;450;1336
250939;202011;1763;4671;1530;4364;64;204;1194;3383;1258;3587
250940;202011;4013;10571;3532;9939;16;63;3161;8898;3177;8961
250950;202011;1720;4352;1380;3916;25;95;1126;3132;1151;3227
250960;202011;1096;3214;963;3003;27;139;788;2370;815;2509
250970;202011;8116;20807;7144;19247;208;661;5991;15850;6199;16511
250980;202011;2352;6254;2124;5919;30;134;1849;5029;1879;5163
250990;202011;2035;6113;1705;5543;55;251;1271;4080;1326;4331
251000;202011;2004;5649;1628;4995;36;161;1339;4074;1375;4235
251010;202011;2619;7300;2384;6946;20;78;2149;6264;2169;6342
251020;202011;1610;4387;1440;4110;33;149;1247;3487;1280;3636
251030;202011;996;2639;818;2319;34;93;571;1606;605;1699
251040;202011;1797;5039;1506;4546;33;163;1235;3710;1268;3873
251050;202011;1023;2799;857;2473;44;150;620;1714;664;1864
251060;202011;1061;2265;797;1930;8;26;624;1485;632;1511
251065;202011;475;1285;363;1076;11;32;251;729;262;761
251070;202011;720;1846;606;1680;10;41;521;1413;531;1454
251080;202011;18194;46331;14733;41116;1906;5447;9400;26393;11306;31840
251090;202011;2808;8032;2359;7230;57;204;1877;5712;1934;5916
251100;202011;779;2480;697;2328;23;88;545;1756;568;1844
251110;202011;1656;4423;1410;3998;49;128;1077;3051;1126;3179
251120;202011;7279;20093;6116;18679;260;931;4858;14872;5118;15803
251130;202011;3828;8502;3387;8002;51;152;3086;7239;3137;7391
251140;202011;4218;11709;3769;11089;72;300;3159;9185;3231;9485
251150;202011;2542;7468;2314;7091;93;400;1930;5781;2023;6181
251160;202011;2106;6172;1822;5759;38;186;1571;4872;1609;5058
251170;202011;1527;4150;1330;3896;31;110;1152;3355;1183;3465
251180;202011;2571;6849;2103;6189;157;467;1450;4249;1607;4716
251190;202011;4362;11333;3964;10882;44;244;3603;9690;3647;9934
251200;202011;4279;12518;3765;11859;71;311;3323;10481;3394;10792
251203;202011;924;3029;850;2859;22;112;640;2094;662;2206
251207;202011;1051;2890;824;2511;19;97;583;1735;602;1832
251210;202011;7494;18875;6137;17030;263;612;4736;13406;4999;14018
251220;202011;1149;2795;913;2482;52;117;700;1946;752;2063
251230;202011;4543;12562;3918;11477;107;389;3118;8898;3225;9287
251240;202011;3599;9770;3037;8837;164;438;2290;6577;2454;7015
251250;202011;10162;27160;8918;25074;725;2101;6596;18041;7321;20142
251260;202011;473;1351;429;1280;14;67;341;984;355;1051
251270;202011;4177;13020;3762;12461;106;429;3080;10426;3186;10855
251272;202011;1317;3577;1196;3414;47;176;1004;2793;1051;2969
251274;202011;884;2459;705;2128;59;200;470;1356;529;1556
251275;202011;1187;3346;1012;3056;26;121;806;2368;832;2489
251276;202011;1303;3534;1134;3311;29;149;920;2591;949;2740
251278;202011;568;1573;508;1484;44;108;375;1123;419;1231
251280;202011;2171;5901;1966;5599;47;142;1661;4685;1708;4827
251290;202011;5770;13558;5215;12882;140;457;4584;10969;4724;11426
251300;202011;851;2484;770;2360;7;36;659;2012;666;2048
251310;202011;2650;7606;2302;7070;45;252;1880;5632;1925;5884
251315;202011;1682;5236;1536;4963;84;262;1165;3725;1249;3987
251320;202011;1588;4232;1162;3491;33;116;867;2551;900;2667
251330;202011;2051;4765;1691;4344;21;77;1529;3959;1550;4036
251335;202011;1077;3075;964;2896;23;105;849;2491;872;2596
251340;202011;3643;8751;2920;7789;120;357;2255;5997;2375;6354
251350;202011;1017;2942;919;2779;27;102;758;2258;785;2360
251360;202011;1789;5033;1449;4544;19;106;1220;3816;1239;3922
251365;202011;714;1931;569;1644;5;20;447;1276;452;1296
251370;202011;24152;63088;20624;58010;2832;7995;12477;36025;15309;44020
251380;202011;1171;3308;1018;3047;18;102;851;2483;869;2585
251385;202011;735;1880;565;1569;22;65;415;1109;437;1174
251390;202011;6227;17972;5516;16871;457;1429;3739;11505;4196;12934
251392;202011;953;2578;804;2350;27;109;626;1793;653;1902
251394;202011;599;1719;493;1539;18;77;368;1135;386;1212
251396;202011;638;1724;552;1570;13;39;397;1107;410;1146
251398;202011;952;2389;655;1879;19;71;480;1341;499;1412
251400;202011;1214;2933;962;2595;22;91;766;1997;788;2088
251410;202011;1526;3560;1240;3156;20;80;1054;2574;1074;2654
251420;202011;1870;4943;1535;4551;39;147;1224;3591;1263;3738
251430;202011;1547;4661;1394;4392;32;150;1204;3782;1236;3932
251440;202011;1084;3001;876;2610;38;88;697;2108;735;2196
251445;202011;1524;4203;1403;4034;35;120;1196;3391;1231;3511
251450;202011;4358;12789;3900;12087;81;315;3256;10004;3337;10319
251455;202011;850;2562;776;2426;21;90;619;1886;640;1976
251460;202011;877;2541;763;2366;15;53;629;1961;644;2014
251465;202011;439;1277;378;1169;6;26;285;857;291;883
251470;202011;1170;3202;873;2585;74;240;510;1437;584;1677
251480;202011;972;2561;795;2246;18;75;616;1665;634;1740
251490;202011;1835;4827;1456;4292;56;178;1091;3236;1147;3414
251500;202011;1914;5365;1761;5171;32;120;1593;4675;1625;4795
251510;202011;2572;7701;2132;6819;106;394;1465;4577;1571;4971
251520;202011;978;2555;747;2126;68;186;471;1312;539;1498
251530;202011;14524;34762;11669;31216;100;560;10330;27154;10430;27714
251540;202011;2949;8363;2670;7838;64;222;2233;6456;2297;6678
251550;202011;3717;8771;2989;7871;105;200;2500;6646;2605;6846
251560;202011;525;1601;464;1502;56;195;324;1016;380;1211
251570;202011;933;2633;762;2295;19;84;602;1764;621;1848
251580;202011;1851;4402;1655;4115;34;149;1445;3452;1479;3601
251590;202011;1538;3831;1295;3545;48;134;1090;2929;1138;3063
251593;202011;892;2618;798;2464;86;268;516;1580;602;1848
251597;202011;2085;5854;1874;5574;20;104;1674;4902;1694;5006
251600;202011;6294;16937;5487;15703;171;524;4543;12828;4714;13352
251610;202011;3118;8904;2691;8107;237;646;1847;5675;2084;6321
251615;202011;1242;3065;1007;2717;25;66;807;2126;832;2192
251620;202011;18892;43054;14539;37701;95;333;12568;32920;12663;33253
251630;202011;4604;10790;3718;9562;197;499;2813;7178;3010;7677
251640;202011;2101;5718;1866;5353;28;134;1630;4569;1658;4703
251650;202011;3915;10505;3424;9852;128;394;2906;8364;3034;8758
251660;202011;3409;10215;3007;9509;71;331;2503;7776;2574;8107
251670;202011;3939;11129;3514;10519;47;237;3127;9291;3174;9528
251675;202011;615;1764;553;1688;75;221;368;1149;443;1370
251680;202011;2457;6479;2053;5945;43;137;1672;4892;1715;5029
251690;202011;2994;8409;2536;7618;84;267;1925;5727;2009;5994
251700;202011;2085;5856;1739;5419;43;192;1472;4503;1515;4695
251710;202011;770;1992;533;1506;38;130;316;843;354;973
251720;202011;1284;3626;1033;3184;23;103;801;2400;824;2503
251740;202011;600;1672;482;1448;41;152;323;928;364;1080
260005;202011;29495;62203;24244;55405;1654;3693;18665;41887;20319;45580
260010;202011;10026;26175;8311;23434;446;1324;4961;14087;5407;15411
260020;202011;6712;15676;5738;14282;92;419;4885;11938;4977;12357
260030;202011;6784;17224;5738;15702;134;401;4686;12762;4820;13163
260040;202011;7477;19141;6243;17348;409;1120;4463;12597;4872;13717
260050;202011;13854;35767;11546;33214;173;687;10650;30659;10823;31346
260060;202011;4037;9942;3468;9035;218;495;2717;7132;2935;7627
260070;202011;10439;26114;8950;23964;308;1085;7292;19006;7600;20091
260080;202011;6421;14649;5610;13569;106;354;4737;11257;4843;11611
260090;202011;4495;11656;4004;10978;447;1252;2864;7853;3311;9105
260100;202011;2888;7855;2437;7182;49;250;2020;5851;2069;6101
260105;202011;4945;13512;4421;12800;127;454;3722;10627;3849;11081
260110;202011;21887;60378;19500;56898;901;3056;16178;46551;17079;49607
260120;202011;14298;37895;12065;34548;1404;3923;7788;22667;9192;26590
260130;202011;3056;7858;2710;7341;255;678;1963;5258;2218;5936
260140;202011;12776;28650;11018;26572;525;1409;9315;22136;9840;23545
260150;202011;3532;8190;3045;7587;88;253;2685;6626;2773;6879
260160;202011;6404;16649;5441;15487;91;314;4926;14141;5017;14455
260170;202011;20135;47191;17075;43050;892;2269;13670;34078;14562;36347
260180;202011;3433;9120;2976;8497;70;265;2576;7242;2646;7507
260190;202011;17819;35861;15032;32577;162;432;13403;28518;13565;28950
260200;202011;10902;26233;9382;24289;435;989;7842;20624;8277;21613
260210;202011;11589;32627;9865;29787;306;1113;7879;23645;8185;24758
260220;202011;10191;24386;9420;23401;163;523;8306;20332;8469;20855
260230;202011;10517;25745;9182;23976;181;625;7809;20023;7990;20648
260240;202011;2679;7991;2354;7363;97;321;1826;5679;1923;6000
260250;202011;2170;5674;1889;5222;121;272;1447;4011;1568;4283
260260;202011;12767;32915;11373;30790;351;1164;9068;24069;9419;25233
260270;202011;4241;10146;3740;9545;123;447;3154;7892;3277;8339
260280;202011;12615;37728;11382;35983;420;1784;9733;30327;10153;32111
260290;202011;40323;101088;34590;92807;3694;10100;23640;63192;27334;73292
260300;202011;9391;25319;8219;23719;178;804;7016;20138;7194;20942
260310;202011;5152;13028;4543;12263;323;790;3518;9644;3841;10434
260320;202011;7527;21733;6368;19761;251;818;5192;16104;5443;16922
260330;202011;2544;7789;2227;7138;73;275;1763;5511;1836;5786
260340;202011;2009;5380;1744;4986;24;110;1502;4194;1526;4304
260345;202011;24862;63831;20651;57713;3061;9063;10991;30235;14052;39298
260350;202011;5566;12906;4830;12067;61;178;4316;10726;4377;10904
260360;202011;2467;6449;2237;6022;46;200;1583;4158;1629;4358
260370;202011;5479;15630;4723;14372;223;735;3666;11113;3889;11848
260380;202011;4967;14462;4261;13302;170;535;3228;9998;3398;10533
260390;202011;4450;13277;3694;11724;228;704;2479;7740;2707;8444
260392;202011;3279;10563;2952;10149;112;677;2389;8195;2501;8872
260400;202011;18118;41541;15624;38281;451;1265;12380;29215;12831;30480
260410;202011;71291;172467;54968;149642;9662;27548;24923;70128;34585;97676
260415;202011;4322;11457;3740;10501;57;242;3070;8460;3127;8702
260420;202011;12422;25840;10555;23761;97;274;9803;21869;9900;22143
260430;202011;2671;8306;2308;7583;105;423;1642;5309;1747;5732
260440;202011;3625;9345;3222;8748;65;237;2727;7272;2792;7509
260450;202011;5680;14233;5079;13465;276;554;4220;11393;4496;11947
260460;202011;5100;15110;4335;13767;462;1628;2602;8127;3064;9755
260470;202011;4780;12717;4072;11890;76;190;3750;11088;3826;11278
260480;202011;3894;10362;3275;9486;215;760;2276;6601;2491;7361
260490;202011;5274;12089;4694;11246;32;138;4290;10104;4322;10242
260500;202011;5942;14870;5071;13657;438;1105;3581;9799;4019;10904
260510;202011;9760;23929;8196;21749;109;425;7254;19080;7363;19505
260515;202011;4311;11472;3352;9691;153;418;2272;6397;2425;6815
260520;202011;16776;38677;14592;35887;697;1663;11968;29070;12665;30733
260530;202011;9673;27555;8270;25388;140;656;7137;21609;7277;22265
260540;202011;7112;15409;6284;14360;137;331;5673;12861;5810;13192
260545;202011;67;204;41;143;3;12;17;57;20;69
260550;202011;3036;8285;2504;7432;110;417;1733;5026;1843;5443
260560;202011;5878;14961;4936;13591;122;461;4159;11224;4281;11685
260570;202011;7632;20684;6720;19450;355;1131;5327;15474;5682;16605
260580;202011;4424;10453;3984;9866;27;95;3632;8929;3659;9024
260590;202011;6610;15348;5535;14140;224;541;4596;11920;4820;12461
260600;202011;30227;77759;24572;69121;1071;3343;18743;51786;19814;55129
260610;202011;7219;18568;6439;17545;385;1113;4856;13173;5241;14286
260620;202011;16296;41785;14191;38756;1217;3731;10407;27844;11624;31575
260630;202011;2343;6312;1921;5651;36;150;1561;4486;1597;4636
260640;202011;21880;48848;18240;44659;821;1996;14797;36038;15618;38034
260650;202011;6190;15851;4964;14358;429;871;4004;11967;4433;12838
260660;202011;6905;18085;5976;16858;163;663;5125;14142;5288;14805
260670;202011;2206;5744;1856;5212;73;185;1354;3736;1427;3921
260680;202011;28484;67316;23973;60936;1633;4411;17079;42571;18712;46982
260690;202011;3450;8921;2901;8069;79;310;2292;6307;2371;6617
260700;202011;6075;16979;5673;16520;18;68;5504;16118;5522;16186
260710;202011;1336;3471;1150;3206;31;116;915;2546;946;2662
260720;202011;23326;57162;20002;52819;1865;4989;14723;38765;16588;43754
260730;202011;7729;21839;6754;20483;239;860;5687;17020;5926;17880
260740;202011;1312;3710;1112;3385;14;73;870;2707;884;2780
260750;202011;7082;19320;5957;17915;257;519;5202;16151;5459;16670
260760;202011;5639;13223;4839;12288;197;521;3984;10168;4181;10689
260765;202011;7988;22832;6930;21378;401;1640;4915;14881;5316;16521
260770;202011;3840;9737;3193;8662;124;389;2502;6698;2626;7087
260775;202011;5160;13643;4526;12685;185;685;3557;9628;3742;10313
260780;202011;3617;10678;3226;10047;291;1052;2047;6158;2338;7210
260790;202011;118074;261995;97241;234883;14622;34097;60442;146689;75064;180786
260795;202011;2928;7457;2511;6924;77;268;1974;5484;2051;5752
260800;202011;5322;12303;4750;11498;125;402;4177;9781;4302;10183
260805;202011;3620;10116;3057;9124;158;555;2307;6746;2465;7301
260810;202011;6388;17306;5602;15796;473;1234;4019;11153;4492;12387
260820;202011;4496;10323;3959;9680;94;348;3307;7894;3401;8242
260825;202011;2886;8502;2525;7856;107;374;1904;5858;2011;6232
260830;202011;4124;11985;3431;10748;451;1240;2189;7096;2640;8336
260840;202011;4146;10723;3707;10116;198;507;3090;8463;3288;8970
260845;202011;4368;11416;3867;10571;221;636;2907;7826;3128;8462
260850;202011;5108;13861;4245;12222;345;1059;2726;7596;3071;8655
260860;202011;3335;9467;2869;8672;95;340;2315;6834;2410;7174
260870;202011;4485;10738;3840;9958;65;250;3444;8806;3509;9056
260875;202011;7022;16985;5746;15130;536;1401;3960;10512;4496;11913
260880;202011;9517;26637;8278;24496;482;1445;6490;19205;6972;20650
260890;202011;12822;32626;11089;29997;569;1646;8132;21478;8701;23124
260900;202011;5297;14613;4365;13311;320;1011;2913;8889;3233;9900
260910;202011;3211;8594;2788;7959;100;311;2202;6251;2302;6562
260915;202011;5103;14924;4474;14193;55;251;4098;13012;4153;13263
260920;202011;3261;8007;2748;7454;94;231;2359;6469;2453;6700
260930;202011;3705;11612;3169;10645;190;754;2363;7752;2553;8506
260940;202011;14691;34617;12784;31977;1004;2437;9642;23810;10646;26247
260950;202011;7020;18518;5670;16187;364;1214;3716;10129;4080;11343
260960;202011;69691;153892;55798;136124;6007;14989;35809;86336;41816;101325
260970;202011;5632;14616;5025;13808;263;581;3765;10568;4028;11149
260980;202011;4515;12998;3984;12332;51;185;3652;11379;3703;11564
260990;202011;18001;48706;15285;44993;846;2691;12005;34919;12851;37610
261000;202011;16160;37763;13588;34522;361;1250;11008;27309;11369;28559
261010;202011;2346;6125;2058;5746;72;187;1795;5027;1867;5214
261020;202011;5914;16028;5111;14689;171;653;4225;11681;4396;12334
261030;202011;3925;11387;3454;10564;123;501;2751;8199;2874;8700
261040;202011;5230;15077;4254;13232;151;585;3210;9711;3361;10296
261050;202011;7736;19962;7035;18871;439;846;5435;14716;5874;15562
261060;202011;14132;34968;12305;32778;258;838;10346;27268;10604;28106
261070;202011;64938;139867;53916;125377;2906;6473;41406;94279;44312;100752
261080;202011;6681;15863;6104;15153;132;323;5659;14018;5791;14341
261090;202011;19383;45094;17243;42313;274;925;15199;36610;15473;37535
261100;202011;8298;22691;7227;21100;503;1546;5306;15533;5809;17079
261110;202011;65840;181268;55196;162127;7670;23714;32721;94859;40391;118573
261120;202011;3572;8998;3126;8383;86;221;2698;7246;2784;7467
261130;202011;7215;17502;6352;16329;116;341;5642;14381;5758;14722
261140;202011;3680;8370;3272;7829;179;448;2616;6172;2795;6620
261150;202011;5180;13496;4599;12622;70;264;4006;10880;4076;11144
261153;202011;1878;5634;1583;5058;58;192;1061;3424;1119;3616
261160;202011;209724;480745;169073;424668;41050;106319;70542;180379;111592;286698
261170;202011;5970;14845;5323;13881;312;738;4255;11040;4567;11778
261180;202011;9409;23301;8211;21727;450;1132;6006;16005;6456;17137
261190;202011;4547;13107;4062;12314;162;705;3239;9496;3401;10201
261200;202011;3356;7712;2984;7214;114;308;2533;6008;2647;6316
261210;202011;1885;4541;1611;4146;64;183;1357;3431;1421;3614
261220;202011;13569;38082;11304;33906;1433;4640;6483;19181;7916;23821
261230;202011;3947;11264;3310;10377;45;181;2766;8761;2811;8942
261240;202011;5333;13222;4698;12215;276;691;3844;9902;4120;10593
261245;202011;3671;10196;3079;9160;80;377;2474;7096;2554;7473
261247;202011;2931;8697;2429;7792;159;539;1648;5262;1807;5801
261250;202011;22036;49984;19118;46583;1661;3607;14658;36649;16319;40256
261255;202011;4061;11830;3295;10332;135;584;2436;7408;2571;7992
261260;202011;12570;33877;10933;31736;337;1385;9424;26973;9761;28358
261270;202011;4441;10771;3878;10055;193;524;3215;8237;3408;8761
261280;202011;2525;6982;2226;6465;65;234;1778;5024;1843;5258
261290;202011;2929;7508;2456;6976;69;263;1991;5694;2060;5957
261300;202011;12396;34146;10560;31045;573;2006;7766;22331;8339;24337
261310;202011;8776;22076;7493;20339;602;1802;5549;14731;6151;16533
261320;202011;5875;16502;5141;15305;78;332;4362;12796;4440;13128
261330;202011;5734;14038;5164;13295;120;429;4511;11404;4631;11833
261340;202011;4213;11659;3651;10943;139;504;3042;9017;3181;9521
261350;202011;8732;25361;7714;23643;126;561;6274;18971;6400;19532
261360;202011;7947;19089;6744;17390;228;639;5434;13669;5662;14308
261370;202011;23997;59061;20052;53607;2085;5405;13014;35133;15099;40538
261380;202011;4072;12152;3597;11321;443;1463;2376;7370;2819;8833
261390;202011;16668;46865;14071;42644;1192;3952;9432;28266;10624;32218
261400;202011;4568;14377;3997;13124;162;722;3010;9598;3172;10320
261410;202011;9513;23498;7826;20913;422;1236;6238;16268;6660;17504
261420;202011;7230;21322;6500;20425;749;2653;4595;14393;5344;17046
261430;202011;3390;9570;2873;8744;57;262;2406;7214;2463;7476
261440;202011;1473;4347;1234;3894;41;190;890;2690;931;2880
261450;202011;14751;39571;13038;36911;172;628;10819;30703;10991;31331
261460;202011;7485;20383;6615;19023;296;911;5272;15120;5568;16031
261470;202011;4086;10108;3580;9441;23;115;3118;8199;3141;8314
261480;202011;5042;15317;4350;14154;196;780;3383;10784;3579;11564
261485;202011;4831;13640;4173;12620;319;1049;3045;9082;3364;10131
261500;202011;5841;14825;5106;13825;373;888;3592;10111;3965;10999
261510;202011;1862;5465;1622;5076;58;214;1240;3908;1298;4122
261520;202011;2329;7087;2093;6604;66;241;1544;4825;1610;5066
261530;202011;12008;34828;9682;30573;879;3324;4956;15042;5835;18366
261540;202011;7996;22798;7178;21616;1043;3085;4084;13010;5127;16095
261550;202011;3664;9659;3161;8875;228;688;2266;6230;2494;6918
261560;202011;7673;22743;6658;21222;272;1044;5157;16436;5429;17480
261570;202011;3459;9252;2764;8148;183;638;1926;5577;2109;6215
261580;202011;6780;17594;5850;16333;109;498;5264;14484;5373;14982
261590;202011;2677;6859;2173;6141;72;245;1643;4621;1715;4866
261600;202011;5122;12751;4345;11608;295;663;3076;8432;3371;9095
261610;202011;2143;6074;1721;5296;94;349;1167;3557;1261;3906
261618;202011;2515;6219;2196;5745;86;210;1752;4575;1838;4785
261620;202011;4150;11586;3785;11050;745;1902;2481;7605;3226;9507
261630;202011;6129;17150;5226;15461;353;1246;3550;10092;3903;11338
261640;202011;37151;82697;31562;75804;1856;3509;23805;59016;25661;62525
261650;202011;4099;10125;3480;9311;157;494;2599;6894;2756;7388
270010;202011;4282;14196;3720;13242;160;918;2976;10252;3136;11170
270020;202011;3782;9444;3300;8822;124;422;2840;7415;2964;7837
270030;202011;33575;90089;27887;80925;3407;9712;18855;54690;22262;64402
270040;202011;10655;28381;9137;26586;363;1305;7590;21939;7953;23244
270050;202011;5419;12591;4626;11686;228;533;4036;10258;4264;10791
270060;202011;2154;5397;1802;4994;147;354;1432;4030;1579;4384
270070;202011;4636;12919;4026;12072;138;518;3347;9856;3485;10374
270080;202011;1434;3865;1210;3477;44;136;936;2589;980;2725
270090;202011;1731;5284;1558;4943;62;252;1283;3974;1345;4226
270100;202011;5387;14105;4640;13001;152;567;3883;10683;4035;11250
270110;202011;3206;7444;2584;6731;138;297;2051;5609;2189;5906
270120;202011;2674;7321;2329;6863;70;304;1971;5702;2041;6006
270130;202011;5029;12766;4368;11973;121;370;3791;10409;3912;10779
270135;202011;1977;4751;1684;4428;35;125;1543;4020;1578;4145
270140;202011;9464;22012;7570;19377;309;1027;5963;14553;6272;15580
270150;202011;2675;7990;2448;7657;3;19;2313;7214;2316;7233
270160;202011;6182;16480;5245;15423;89;335;4856;14295;4945;14630
270170;202011;3314;9670;2788;8936;173;825;2131;6537;2304;7362
270180;202011;2201;6787;2021;6557;34;167;1837;5903;1871;6070
270190;202011;1604;4793;1424;4569;34;177;1255;3999;1289;4176
270200;202011;2343;7100;2039;6682;108;405;1498;4906;1606;5311
270210;202011;5631;13212;4791;12274;72;300;4416;11124;4488;11424
270220;202011;1522;3941;1216;3509;207;618;687;1969;894;2587
270230;202011;9106;25017;7541;22601;623;2029;5422;16137;6045;18166
270235;202011;5575;17146;4787;15884;115;532;3971;13036;4086;13568
270240;202011;10398;28552;8422;25752;954;3098;5816;17908;6770;21006
270250;202011;2748;6891;2405;6396;182;476;1911;5073;2093;5549
270255;202011;4286;12326;3354;10625;108;453;2582;8039;2690;8492
270260;202011;5500;16173;4980;15309;98;492;4374;13145;4472;13637
270270;202011;1025;2656;848;2438;93;276;631;1798;724;2074
270280;202011;3738;9013;2987;8071;461;758;2124;6182;2585;6940
270290;202011;7263;23098;6534;21886;167;804;5731;18970;5898;19774
270300;202011;4196;10793;3266;9788;158;420;2555;7841;2713;8261
270310;202011;6924;19216;5940;17674;86;463;5105;14814;5191;15277
270320;202011;5400;15852;4681;14462;393;1267;3348;10080;3741;11347
270330;202011;3833;12440;3414;11798;256;1017;2631;9035;2887;10052
270340;202011;1557;4206;1347;3936;43;143;1151;3318;1194;3461
270350;202011;1848;4325;1522;3942;141;393;1091;2849;1232;3242
270360;202011;2577;6424;2292;6103;75;155;2116;5681;2191;5836
270370;202011;1362;4170;1243;3957;34;160;1049;3280;1083;3440
270375;202011;3083;7144;2547;6552;18;57;2390;6164;2408;6221
270380;202011;5362;15027;4498;13897;603;1776;2970;9550;3573;11326
270390;202011;1184;2963;960;2709;23;93;795;2242;818;2335
270400;202011;6143;16128;5147;14625;263;732;4001;11325;4264;12057
270410;202011;4515;12912;3910;11994;142;508;3275;10001;3417;10509
270420;202011;5421;15964;4875;15161;119;562;4244;12947;4363;13509
270430;202011;130321;307762;102366;271974;20001;55174;49456;133396;69457;188570
270440;202011;4584;12394;3963;11639;78;349;3481;10093;3559;10442
270450;202011;6933;18471;6059;17410;256;827;5089;14794;5345;15621
270460;202011;3703;8185;3181;7564;155;311;2860;6828;3015;7139
270470;202011;10797;29950;9377;27940;607;2021;7325;21787;7932;23808
270480;202011;2921;7660;2456;6990;88;346;2019;5605;2107;5951
270490;202011;929;2547;812;2404;49;155;655;1928;704;2083
270500;202011;4854;14740;4302;13823;289;1057;3368;10693;3657;11750
270510;202011;5439;14375;4572;13273;323;1275;3431;9501;3754;10776
270520;202011;3936;11130;3103;9702;646;2106;1275;4145;1921;6251
270530;202011;1268;3574;1070;3271;53;150;761;2363;814;2513
270540;202011;2228;6269;1917;5864;60;266;1678;5049;1738;5315
270550;202011;6635;17047;5273;15546;581;1383;3944;12108;4525;13491
270560;202011;2916;7524;2508;6980;121;394;2062;5681;2183;6075
270570;202011;4065;11346;3443;10417;116;372;2823;8489;2939;8861
270580;202011;2235;6271;2020;5955;99;305;1749;5111;1848;5416
270590;202011;1565;4712;1442;4547;15;78;1359;4261;1374;4339
270600;202011;2698;8289;2442;7902;45;234;2182;6982;2227;7216
270610;202011;3643;9394;3156;8761;100;269;2811;7790;2911;8059
270620;202011;1188;3605;1089;3416;32;141;947;2887;979;3028
270630;202011;17287;42030;14840;38653;595;1859;12449;31743;13044;33602
270640;202011;5239;15062;4558;13960;163;666;3753;11264;3916;11930
270642;202011;2475;7919;2193;7462;144;623;1692;5633;1836;6256
270644;202011;3544;8791;2916;7980;297;710;2173;6132;2470;6842
270650;202011;3041;8918;2669;8397;351;1172;1914;6003;2265;7175
270660;202011;1960;4982;1679;4573;83;288;1260;3376;1343;3664
270670;202011;15945;36393;13231;33060;353;1057;11363;27733;11716;28790
270680;202011;5526;13022;4927;12366;119;173;4612;11720;4731;11893
270690;202011;8933;21836;7488;20012;430;1160;5953;15833;6383;16993
270700;202011;499;1510;434;1404;28;115;314;993;342;1108
270710;202011;5296;16002;4699;15069;212;914;3797;11960;4009;12874
270720;202011;3555;10315;3161;9653;58;318;2807;8392;2865;8710
270730;202011;8017;17775;7029;16718;237;456;5530;14620;5767;15076
270740;202011;2347;6114;2069;5793;86;292;1732;4777;1818;5069
270750;202011;5643;14756;4938;13860;77;372;4431;12333;4508;12705
270760;202011;3210;8980;2777;8403;44;231;2376;7097;2420;7328
270770;202011;20499;49763;16387;44734;2557;6236;10224;29477;12781;35713
270780;202011;1769;4861;1626;4659;78;267;1399;3950;1477;4217
270790;202011;1601;4359;1334;3994;103;329;991;2941;1094;3270
270800;202011;10790;29108;9726;27586;327;1161;8407;23496;8734;24657
270810;202011;3278;9300;2573;8106;168;643;1812;5603;1980;6246
270820;202011;1567;4716;1333;4344;51;252;1057;3355;1108;3607
270830;202011;5025;12027;4067;10846;152;524;3324;8707;3476;9231
270840;202011;8166;24204;7282;22944;166;895;6400;19657;6566;20552
270850;202011;8900;20939;7846;19691;634;1801;6514;16084;7148;17885
270860;202011;14224;31295;11235;27901;588;1324;9089;22589;9677;23913
270870;202011;2134;5985;1760;5393;232;680;1154;3659;1386;4339
270880;202011;7957;23724;7106;22451;208;886;5943;18442;6151;19328
270890;202011;2784;7467;2322;6804;170;518;1629;4774;1799;5292
270895;202011;3076;9312;2789;8937;71;380;2480;7787;2551;8167
270900;202011;1793;4614;1344;3884;36;105;1051;3006;1087;3111
270910;202011;3819;10976;3287;10145;88;291;2702;8238;2790;8529
270915;202011;9270;26356;7454;23370;630;2299;5098;15643;5728;17942
270920;202011;4994;15482;4537;14707;142;705;3778;11838;3920;12543
270930;202011;16887;38971;13022;34475;1766;4258;8781;24449;10547;28707
270940;202011;6591;16950;5582;15748;199;825;4570;12548;4769;13373
280010;202011;683;1861;538;1551;15;59;381;997;396;1056
280020;202011;4811;12101;4074;10925;449;1148;2788;7537;3237;8685
280030;202011;73922;172798;58348;150703;12099;31512;26503;71264;38602;102776
280040;202011;2857;7972;2487;7402;247;760;1673;4955;1920;5715
280050;202011;3762;10683;3228;9861;548;1721;1921;5867;2469;7588
280060;202011;5672;14817;4519;13013;864;2628;2127;6385;2991;9013
280067;202011;6827;16755;5801;15189;299;801;4291;11099;4590;11900
280070;202011;1886;5542;1754;5335;121;381;1455;4392;1576;4773
280100;202011;3893;10305;3289;9355;310;917;2275;6457;2585;7374
280110;202011;1364;3677;1199;3427;17;85;1058;2946;1075;3031
280120;202011;7511;21544;6691;20230;749;2081;4874;15139;5623;17220
280130;202011;8955;20903;7848;19335;396;1073;6403;15602;6799;16675
280140;202011;5340;12736;4719;11920;185;560;4045;10072;4230;10632
280150;202011;4124;10325;3573;9572;356;876;2729;7360;3085;8236
280160;202011;1191;3369;1002;3060;94;314;691;2060;785;2374
280170;202011;5051;13355;4525;12679;227;617;3670;10314;3897;10931
280190;202011;1260;2762;1126;2584;55;127;927;2083;982;2210
280200;202011;1216;3188;1003;2891;68;252;755;2129;823;2381
280210;202011;16438;40812;14277;37740;1519;4166;9189;24303;10708;28469
280220;202011;1730;4594;1484;4269;48;213;1227;3492;1275;3705
280230;202011;4378;10859;3677;9830;316;682;2573;7021;2889;7703
280240;202011;3272;8720;2918;8176;52;270;2506;6810;2558;7080
280250;202011;876;2136;715;1891;79;218;473;1224;552;1442
280260;202011;2219;5282;1959;4951;38;93;1778;4536;1816;4629
280270;202011;2408;6433;2133;6004;137;382;1744;4883;1881;5265
280280;202011;4149;12205;3689;11518;492;1316;2585;8448;3077;9764
280290;202011;17666;46280;15154;42794;1287;3859;10266;29252;11553;33111
280300;202011;11972;28490;10476;26881;296;812;7807;21949;8103;22761
280310;202011;1378;3518;1137;3108;38;131;859;2276;897;2407
280320;202011;8434;22708;7327;21050;870;2517;4936;14062;5806;16579
280330;202011;4622;11386;3933;10443;249;699;2895;7669;3144;8368
280340;202011;5373;11294;4469;10312;221;390;3878;9110;4099;9500
280350;202011;25761;60018;22657;55895;1090;2877;18042;43700;19132;46577
280360;202011;5592;15348;4892;14177;727;2124;2890;8526;3617;10650
280370;202011;2095;5178;1761;4628;55;156;1411;3641;1466;3797
280380;202011;986;2605;844;2412;76;212;575;1665;651;1877
280390;202011;3590;8791;3039;7946;156;373;2418;6318;2574;6691
280400;202011;3817;9603;3306;8901;516;1199;2029;5777;2545;6976
280410;202011;2211;6103;1763;5363;189;592;1027;3072;1216;3664
280420;202011;4247;11210;3915;10789;68;260;3610;9876;3678;10136
280430;202011;2031;4881;1778;4548;65;232;1454;3595;1519;3827
280440;202011;4189;11130;3703;10409;146;496;3135;8595;3281;9091
280445;202011;2325;5910;2075;5472;49;159;1553;3917;1602;4076
280450;202011;10127;23399;8759;21532;1005;2101;5829;14945;6834;17046
280460;202011;6813;16039;6166;15154;329;783;5288;12842;5617;13625
280470;202011;1661;4657;1427;4241;65;229;1069;3092;1134;3321
280480;202011;42507;102393;36628;94066;2976;8176;26190;65872;29166;74048
280490;202011;3753;10624;3220;9694;89;384;2497;7271;2586;7655
280500;202011;994;2363;849;2165;35;110;712;1777;747;1887
280510;202011;2524;6312;2183;5830;80;288;1697;4436;1777;4724
280520;202011;1562;4009;1371;3742;53;153;1100;2955;1153;3108
280530;202011;2404;5978;2077;5514;290;649;1442;3975;1732;4624
280540;202011;8781;23435;8024;22342;254;869;7042;19352;7296;20221
280550;202011;6523;15073;5409;13503;161;591;4524;10873;4685;11464
280560;202011;7117;19562;6695;18933;142;530;5919;16507;6061;17037
280570;202011;6370;15410;5197;13925;222;686;3905;10420;4127;11106
280580;202011;5629;14752;4907;13692;574;1399;3478;9893;4052;11292
280590;202011;2840;6424;2433;5954;103;394;1935;4540;2038;4934
280600;202011;3502;9242;3095;8674;167;514;2227;6247;2394;6761
280610;202011;2446;5999;2204;5634;135;339;1807;4582;1942;4921
280620;202011;5458;13168;4686;12157;417;902;3303;8956;3720;9858
280630;202011;3803;10563;3493;10131;158;587;2887;8254;3045;8841
280640;202011;2320;6235;2047;5924;51;160;1825;5287;1876;5447
280650;202011;1173;3054;948;2722;86;286;702;1923;788;2209
280660;202011;3648;7983;3129;7372;216;402;2599;6241;2815;6643
280670;202011;19408;43652;16707;40186;1114;2681;13072;31374;14186;34055
280680;202011;2700;6444;2329;5916;218;413;1696;4388;1914;4801
280690;202011;955;2300;806;2104;52;119;637;1643;689;1762
280700;202011;1158;2894;1005;2668;25;95;802;2092;827;2187
280710;202011;15157;33889;12845;31247;519;985;10847;27107;11366;28092
280720;202011;2631;5995;2179;5458;58;191;1606;4134;1664;4325
280730;202011;1070;2721;952;2531;52;155;724;1857;776;2012
280740;202011;13857;33741;11851;30694;717;2017;8580;21625;9297;23642
280750;202011;3604;9972;3133;9162;190;601;2264;6525;2454;7126
280760;202011;6350;16691;5520;15415;588;1503;3642;10490;4230;11993
290010;202011;3177;6637;2078;4928;5;16;1713;3890;1718;3906
290020;202011;5326;14026;4847;13409;342;627;4078;11704;4420;12331
290030;202011;4593;10388;3693;9401;170;392;3138;8086;3308;8478
290035;202011;5127;11057;4247;9922;351;530;3387;8239;3738;8769
290040;202011;4123;10073;3532;9361;103;275;2799;7824;2902;8099
290050;202011;2000;6436;1669;5706;114;476;1115;3713;1229;4189
290060;202011;1312;3082;973;2561;96;262;634;1666;730;1928
290070;202011;36442;79425;31310;73071;1682;4156;24612;56712;26294;60868
290080;202011;5166;15103;4464;14039;450;1528;3123;9909;3573;11437
290090;202011;2144;4099;1507;3419;17;53;1377;3101;1394;3154
290100;202011;9614;24951;7753;22165;1257;3386;4236;12712;5493;16098
290110;202011;5117;13444;4545;12560;316;888;3299;9023;3615;9911
290115;202011;3896;11194;3266;10064;222;743;2420;7394;2642;8137
290120;202011;6446;15757;5445;14367;131;423;4704;12220;4835;12643
290130;202011;4656;11276;3626;9938;157;443;2824;7743;2981;8186
290135;202011;4193;9782;3460;8597;171;451;2742;6594;2913;7045
290140;202011;4410;11453;3404;10121;95;347;2876;8510;2971;8857
290150;202011;2439;6272;2097;5845;140;382;1619;4551;1759;4933
290160;202011;3362;7587;2973;7050;261;543;2371;5631;2632;6174
290170;202011;3346;8439;2957;8012;111;293;2643;7236;2754;7529
290180;202011;2941;7972;2430;7134;79;284;1995;5808;2074;6092
290190;202011;4205;11679;3692;10975;139;533;3048;8937;3187;9470
290195;202011;2273;5655;1821;5063;26;135;1551;4272;1577;4407
290200;202011;4007;11155;3257;9895;173;589;2482;7464;2655;8053
290205;202011;3397;8729;2984;8103;138;484;2324;6108;2462;6592
290210;202011;12584;35306;11167;33149;812;2261;8696;26212;9508;28473
290220;202011;2855;6999;2502;6545;115;305;2060;5378;2175;5683
290225;202011;3109;6675;2388;5914;150;268;1983;5017;2133;5285
290230;202011;2424;6396;2210;6139;32;95;1989;5519;2021;5614
290240;202011;3671;9199;2919;8258;71;245;2467;6978;2538;7223
290250;202011;3901;11345;3262;10379;101;351;2691;8677;2792;9028
290260;202011;5412;13090;4546;11840;156;515;3822;9705;3978;10220
290265;202011;3503;10097;2839;8822;217;643;1991;6219;2208;6862
290270;202011;10706;36402;10012;35214;523;2297;8142;28350;8665;30647
290280;202011;6017;17866;5208;16270;292;1024;3777;11655;4069;12679
290290;202011;9794;28281;7938;24890;773;2620;5236;16195;6009;18815
290300;202011;4109;11166;3034;9129;148;491;2197;6574;2345;7065
290310;202011;1558;3816;1229;3418;46;211;965;2588;1011;2799
290320;202011;23602;61179;18667;53646;4122;11586;8926;27167;13048;38753
290323;202011;3706;10048;3226;9303;102;317;2567;7393;2669;7710
290327;202011;4006;11590;3438;10492;247;703;2496;7577;2743;8280
290330;202011;2181;4544;1691;4018;40;63;1504;3638;1544;3701
290340;202011;5605;13854;4299;12254;415;1209;3117;9031;3532;10240
290350;202011;4702;12967;3921;11642;279;831;2792;8337;3071;9168
290360;202011;5026;13087;4405;12272;131;333;3788;10658;3919;10991
290370;202011;5226;12670;3819;10805;166;429;2744;7932;2910;8361
290380;202011;5554;14667;4645;13427;116;282;3980;11712;4096;11994
290390;202011;14293;40600;11881;36763;1286;3897;7743;24405;9029;28302
290395;202011;2833;8121;2277;7177;62;293;1741;5407;1803;5700
290400;202011;3699;9949;2993;8774;79;337;2296;6573;2375;6910
290405;202011;4608;13318;3961;12200;293;928;2734;8608;3027;9536
290410;202011;5676;15262;4361;13155;118;514;3293;9684;3411;10198
290420;202011;2956;8116;2445;7324;67;229;1903;5660;1970;5889
290430;202011;3154;8559;2588;7678;225;703;1771;5168;1996;5871
290440;202011;2858;6971;2047;5702;51;123;1443;4099;1494;4222
290450;202011;3492;8787;2739;7632;155;395;1993;5634;2148;6029
290460;202011;11589;32495;9709;28907;1958;5930;4308;12849;6266;18779
290470;202011;4471;10951;3289;9323;385;1201;1888;5442;2273;6643
290475;202011;6396;18486;5433;16787;82;463;4487;13565;4569;14028
290480;202011;1741;4399;1424;3951;75;266;1006;2654;1081;2920
290485;202011;4444;12887;3929;12166;99;508;3373;10262;3472;10770
290490;202011;8979;21090;8052;19818;482;1069;6341;15865;6823;16934
290500;202011;4000;11893;3077;9884;533;1801;1359;4261;1892;6062
290510;202011;3419;8502;2845;7753;69;219;2470;6698;2539;6917
290515;202011;3606;9972;3143;9338;37;122;2844;8584;2881;8706
290520;202011;11425;32317;8834;27315;604;1989;5343;16330;5947;18319
290530;202011;4924;14025;4152;12762;124;501;3528;10761;3652;11262
290540;202011;3321;8667;2974;8285;48;156;2756;7661;2804;7817
290550;202011;4223;11031;3701;10410;10;58;3417;9707;3427;9765
290560;202011;6222;16072;4723;13871;386;1431;3124;8863;3510;10294
290570;202011;43961;107466;38916;100997;2432;6433;31404;81074;33836;87507
290580;202011;7727;22438;6642;20857;588;1790;4889;15742;5477;17532
290590;202011;7027;21436;5927;19467;148;578;4777;15761;4925;16339
290600;202011;18990;51901;16731;48225;661;2032;13594;39002;14255;41034
290610;202011;2555;7849;2008;6730;94;373;1413;4683;1507;5056
290620;202011;6200;17409;5366;16035;190;545;4544;13564;4734;14109
290630;202011;9113;21853;7253;19450;576;1504;5583;15133;6159;16637
290640;202011;2754;7062;2127;6151;84;245;1544;4571;1628;4816
290650;202011;12863;31638;11335;29918;2479;6235;7118;19654;9597;25889
290660;202011;3557;9138;2986;8310;52;154;2254;6454;2306;6608
290670;202011;6595;18115;5586;16453;358;1011;4274;12778;4632;13789
290680;202011;10720;29615;8965;27014;203;1050;7424;21898;7627;22948
290682;202011;4710;12064;4085;11228;123;282;3460;9592;3583;9874
290685;202011;3423;7705;2463;6334;200;472;1517;4187;1717;4659
290687;202011;6384;17238;5214;15316;677;1903;3387;10218;4064;12121
290689;202011;2830;7797;2142;6519;194;643;1461;4422;1655;5065
290690;202011;5294;13761;4294;12358;286;900;3145;8900;3431;9800
290700;202011;2587;7068;2272;6667;60;221;1923;5656;1983;5877
290710;202011;8120;22896;6969;21297;158;637;5896;18029;6054;18666
290720;202011;18155;49594;16549;47130;905;2865;13343;37517;14248;40382
290730;202011;6998;16532;5963;15328;287;570;4706;12327;4993;12897
290740;202011;994;2693;781;2348;34;111;646;1943;680;2054
290750;202011;10747;26632;9310;24366;596;1669;6988;17796;7584;19465
290755;202011;1993;5630;1619;4952;87;275;1145;3536;1232;3811
290760;202011;3648;10626;2967;9331;173;508;2032;6591;2205;7099
290770;202011;2640;8288;2431;8024;48;244;2055;6838;2103;7082
290780;202011;8110;20078;7027;18656;262;584;5520;14998;5782;15582
290790;202011;4611;12723;4014;11861;165;477;3294;9873;3459;10350
290800;202011;6950;14404;4916;12022;290;659;3657;9039;3947;9698
290810;202011;5201;13663;4201;12198;111;349;3215;9542;3326;9891
290820;202011;4742;12854;4272;12188;174;507;3258;9418;3432;9925
290830;202011;4426;10027;3919;9390;26;73;3461;8194;3487;8267
290840;202011;17059;44623;14571;40760;1952;4496;9302;27764;11254;32260
290850;202011;6612;15792;5906;15034;203;508;5078;13051;5281;13559
290860;202011;6121;17371;5330;16467;211;689;4508;14206;4719;14895
290870;202011;4703;12884;3570;10721;155;478;2508;7475;2663;7953
290880;202011;1371;3402;1099;3047;69;179;755;2181;824;2360
290890;202011;9151;18440;8235;17418;142;311;7757;16343;7899;16654
290900;202011;2376;6144;1828;5177;103;239;1145;3238;1248;3477
290910;202011;5066;12089;3892;10302;48;154;3325;8710;3373;8864
290920;202011;5071;12675;4609;12137;77;119;4323;11557;4400;11676
290930;202011;7453;20757;6032;18262;214;884;4706;13876;4920;14760
290940;202011;3530;9968;2968;9163;156;556;2416;7426;2572;7982
290950;202011;1441;3606;1174;3206;68;191;821;2250;889;2441
290960;202011;5416;14045;4860;13352;173;441;4134;11407;4307;11848
290970;202011;3232;9505;2654;8441;102;378;2059;6545;2161;6923
290980;202011;11955;28428;10001;25471;765;2110;6322;15643;7087;17753
290990;202011;9528;25111;8467;23383;260;1025;7152;19103;7412;20128
291000;202011;3335;8556;2584;7602;107;330;2121;6298;2228;6628
291005;202011;15094;37037;13289;34681;1228;2912;10325;27211;11553;30123
291010;202011;3027;9103;2473;7921;118;422;1643;5128;1761;5550
291020;202011;1217;2993;976;2569;21;74;714;1777;735;1851
291030;202011;2500;6036;1739;4728;107;261;1083;2871;1190;3132
291040;202011;5339;14506;4470;13288;153;569;3545;10504;3698;11073
291050;202011;7475;19345;6357;17816;588;1840;4678;12892;5266;14732
291060;202011;5922;17966;5010;16747;308;1326;3803;12652;4111;13978
291070;202011;15794;42204;13227;38099;413;1403;10817;30990;11230;32393
291072;202011;23880;60506;17178;49205;3126;9293;7478;21609;10604;30902
291075;202011;5328;13066;4791;12254;99;269;4029;10124;4128;10393
291077;202011;1588;4129;1237;3523;53;114;875;2496;928;2610
291080;202011;108224;263583;84503;230242;24899;69587;23431;69314;48330;138901
291085;202011;5549;13953;4672;12595;170;508;3911;10524;4081;11032
291090;202011;1981;3755;1425;3129;47;100;1146;2470;1193;2570
291100;202011;3168;6876;2180;5694;99;259;1668;4325;1767;4584
291110;202011;5906;17436;5030;15953;319;1264;3838;11757;4157;13021
291120;202011;7410;18081;6234;16597;284;816;4837;12854;5121;13670
291125;202011;2167;3797;1641;3212;90;131;1328;2644;1418;2775
291130;202011;3270;9193;2398;7485;66;294;1795;5415;1861;5709
291140;202011;4876;13013;3524;10562;450;1203;2179;6559;2629;7762
291150;202011;2461;5325;1893;4685;4;12;1786;4416;1790;4428
291160;202011;4972;13534;4119;12309;358;1140;2790;8280;3148;9420
291165;202011;2123;5745;1603;4720;28;123;1190;3406;1218;3529
291170;202011;20602;51887;17204;46180;905;2668;11472;30260;12377;32928
291180;202011;6298;14353;4609;12135;245;633;3608;9489;3853;10122
291185;202011;3013;8059;2648;7485;88;267;2042;5799;2130;6066
291190;202011;7619;18533;6272;16806;278;846;4979;13300;5257;14146
291200;202011;2778;7532;2044;6139;82;260;1281;3690;1363;3950
291210;202011;6993;14895;5219;12861;134;435;3864;9583;3998;10018
291220;202011;3993;11309;3593;10718;167;613;2884;8490;3051;9103
291230;202011;4402;9416;3311;8224;33;87;2992;7504;3025;7591
291240;202011;4134;10559;3533;9549;59;207;3047;8124;3106;8331
291250;202011;3297;9682;2581;8368;147;461;1688;5513;1835;5974
291260;202011;1430;3344;1173;3008;27;90;964;2486;991;2576
291270;202011;5347;13753;4143;12001;629;1830;2587;7681;3216;9511
291280;202011;2610;6252;1939;5268;149;416;1254;3372;1403;3788
291290;202011;5715;14934;4394;12886;323;1022;3048;8870;3371;9892
291300;202011;3736;10137;2940;8820;111;408;2260;6667;2371;7075
291310;202011;5005;13259;4291;11967;115;362;3651;10056;3766;10418
291320;202011;5939;16394;4612;13946;1023;2895;2311;7420;3334;10315
291330;202011;1745;4451;1446;3956;75;202;1086;2934;1161;3136
291340;202011;4237;10874;3419;9453;80;265;2608;7111;2688;7376
291345;202011;2873;8601;2608;8190;101;354;2204;6921;2305;7275
291350;202011;6762;16630;5248;14814;45;151;4583;13170;4628;13321
291360;202011;36254;82657;28490;73322;2655;6813;18901;49807;21556;56620
291370;202011;7997;21601;7058;20160;520;1578;5259;14742;5779;16320
291380;202011;3374;9165;2963;8601;100;407;2480;7137;2580;7544
291390;202011;13087;27866;10092;24553;426;1000;8370;20387;8796;21387
291400;202011;13581;34692;11171;31063;1502;3676;6651;19960;8153;23636
291410;202011;2937;7662;2301;6577;36;149;1691;4753;1727;4902
291420;202011;1954;4705;1531;4186;24;102;1350;3668;1374;3770
291430;202011;2701;7615;2340;7019;64;287;1900;5524;1964;5811
291440;202011;6277;17920;5450;16557;335;1058;4238;12907;4573;13965
291450;202011;9614;22612;7924;20662;77;130;6982;18729;7059;18859
291460;202011;15532;40855;13619;37993;675;2086;10309;28566;10984;30652
291465;202011;9245;22495;7276;20250;124;556;6332;17501;6456;18057
291470;202011;16817;37258;14035;34112;775;1668;10456;26184;11231;27852
291480;202011;41086;90609;30359;76051;3559;9173;16190;40629;19749;49802
291490;202011;5513;13627;4737;12747;130;422;4285;11473;4415;11895
291500;202011;4918;12035;4115;10961;67;292;3753;9934;3820;10226
291510;202011;4270;10513;3169;9129;49;286;2654;7576;2703;7862
291520;202011;4473;10105;3361;8639;186;502;2597;6626;2783;7128
291530;202011;2312;5216;1627;4326;324;788;899;2647;1223;3435
291535;202011;3345;9737;2952;9047;158;442;2299;7243;2457;7685
291540;202011;2230;4918;1528;4091;68;220;1262;3338;1330;3558
291550;202011;5582;12741;4340;11176;381;806;2977;7861;3358;8667
291560;202011;17970;42403;13010;35878;1295;3416;7809;22447;9104;25863
291570;202011;2391;5663;1885;5044;53;153;1562;4327;1615;4480
291580;202011;6244;15957;4915;14191;233;735;3642;10446;3875;11181
291590;202011;2182;5232;1893;4896;70;244;1687;4267;1757;4511
291600;202011;5411;12435;4162;10536;364;974;2874;7045;3238;8019
291610;202011;5573;14440;4992;13804;73;271;4593;12667;4666;12938
291620;202011;3073;6888;2298;6041;103;260;1798;4824;1901;5084
291630;202011;3305;7353;2468;6255;291;798;1759;4379;2050;5177
291640;202011;15758;38499;11904;32939;1719;4598;5408;15557;7127;20155
291650;202011;9374;23234;8330;22004;555;1024;7020;19063;7575;20087
291660;202011;2018;4914;1480;4093;129;417;970;2529;1099;2946
291670;202011;2031;5335;1708;4868;96;242;1307;3774;1403;4016
291680;202011;4032;9812;3270;8730;290;794;2347;6248;2637;7042
291685;202011;4672;11088;3738;9896;220;460;2832;7769;3052;8229
291690;202011;4107;9000;2846;7178;252;505;2149;5493;2401;5998
291700;202011;8541;24554;7504;22740;320;1162;6134;18241;6454;19403
291710;202011;5186;12243;3849;10381;208;646;2824;7483;3032;8129
291720;202011;4438;13315;3720;11871;521;1727;2303;7237;2824;8964
291730;202011;6205;15789;5345;14668;253;772;4453;12150;4706;12922
291733;202011;2778;7104;2375;6575;55;160;1747;5076;1802;5236
291735;202011;2891;7622;2311;6591;70;162;1761;4989;1831;5151
291740;202011;3920;10059;2907;8162;95;235;2044;5689;2139;5924
291750;202011;19254;45729;15700;40526;1526;3822;10621;27844;12147;31666
291760;202011;10054;28827;7844;25281;2392;8713;2191;7033;4583;15746
291770;202011;7017;18629;5875;16678;328;1013;4491;12426;4819;13439
291780;202011;5136;13490;4617;12765;84;299;4071;11143;4155;11442
291790;202011;2750;7477;2495;7148;231;552;1884;5581;2115;6133
291800;202011;28654;71606;21292;60652;3430;9464;10361;30783;13791;40247
291810;202011;10477;24659;8781;22579;297;726;7440;19323;7737;20049
291820;202011;3775;9866;3294;9252;84;286;2673;7517;2757;7803
291830;202011;4445;10373;3627;9277;190;387;2866;7365;3056;7752
291835;202011;6473;19258;5090;16618;528;1833;3255;10777;3783;12610
291840;202011;46630;127517;40533;117989;4177;12979;28725;83029;32902;96008
291845;202011;2512;6453;1967;5780;115;346;1589;4728;1704;5074
291850;202011;3786;10839;3114;9722;241;729;2251;7200;2492;7929
291855;202011;2209;4263;1713;3715;39;91;1544;3355;1583;3446
291860;202011;2245;5813;1563;4501;47;129;1060;2939;1107;3068
291870;202011;1262;3164;845;2442;44;126;574;1633;618;1759
291875;202011;2900;8632;2504;7802;63;259;1851;5610;1914;5869
291880;202011;5662;15900;4779;14399;221;643;3562;10810;3783;11453
291890;202011;1629;3292;1051;2624;130;293;703;1776;833;2069
291900;202011;1268;2979;979;2535;20;73;770;1940;790;2013
291905;202011;2400;6116;1978;5451;79;281;1520;4042;1599;4323
291910;202011;2989;7359;2532;6808;56;196;2174;5983;2230;6179
291915;202011;7272;20497;5933;18248;212;746;4499;14007;4711;14753
291920;202011;26012;66902;21913;61202;2020;6168;15462;42343;17482;48511
291930;202011;2471;6601;2117;6117;227;658;1448;4228;1675;4886
291940;202011;3882;9842;2582;7630;190;558;1521;4473;1711;5031
291950;202011;9000;27014;7655;24413;270;1002;5372;16938;5642;17940
291955;202011;15174;38161;13479;35975;1103;3106;10620;28365;11723;31471
291960;202011;2977;7854;2497;7207;125;363;1947;5760;2072;6123
291970;202011;4444;11133;3717;10242;128;441;2835;7828;2963;8269
291980;202011;9402;26836;7475;23450;1037;3006;4479;14462;5516;17468
291990;202011;2315;5926;1899;5428;30;124;1754;5020;1784;5144
291992;202011;3844;9256;3095;8291;233;521;2464;6749;2697;7270
291995;202011;2076;5693;1705;5078;53;233;1297;3771;1350;4004
292000;202011;2606;6028;2126;5460;89;330;1683;4264;1772;4594
292010;202011;5593;13033;4570;11593;159;491;3829;9496;3988;9987
292020;202011;4538;13033;3763;11661;207;748;2712;8136;2919;8884
292030;202011;1788;5453;1629;5159;73;262;1052;3272;1125;3534
292040;202011;4419;11192;3444;9729;228;597;2634;7579;2862;8176
292045;202011;4016;10379;2963;8827;31;84;2622;7954;2653;8038
292050;202011;6417;17782;5205;15666;242;839;3375;10024;3617;10863
292060;202011;11091;25588;10231;24509;451;1017;9011;21401;9462;22418
292070;202011;5661;14731;4938;13868;279;806;4257;11866;4536;12672
292080;202011;3026;7666;2528;7022;75;258;2251;6196;2326;6454
292090;202011;4536;9803;3202;8194;241;658;2409;6190;2650;6848
292100;202011;10906;26291;9355;24366;935;2518;6545;17074;7480;19592
292105;202011;3571;8661;3114;8046;94;212;2591;6713;2685;6925
292110;202011;5932;14261;4163;11467;908;2549;1993;5492;2901;8041
292120;202011;6808;17341;5645;15414;343;986;4314;11578;4657;12564
292130;202011;3389;8068;2803;7345;106;325;2193;5666;2299;5991
292140;202011;4966;11697;4191;10530;312;784;3350;8392;3662;9176
292145;202011;2322;6708;1972;6109;62;160;1532;4808;1594;4968
292150;202011;14391;38517;12478;35409;296;1134;10189;28421;10485;29555
292160;202011;2937;7099;2210;6159;37;104;1804;5274;1841;5378
292170;202011;8315;22033;6938;19794;327;1108;5280;14740;5607;15848
292180;202011;2808;7659;2060;6249;158;478;1284;3838;1442;4316
292190;202011;2902;7609;2478;6965;89;309;1960;5451;2049;5760
292200;202011;8480;20734;6287;17637;1051;3086;3223;9346;4274;12432
292205;202011;3810;10483;3305;9738;55;253;2895;8487;2950;8740
292210;202011;6443;14957;5195;13389;87;378;4673;11911;4760;12289
292220;202011;2203;5103;1932;4692;49;124;1542;3624;1591;3748
292225;202011;3132;9122;2764;8561;72;336;2363;7179;2435;7515
292230;202011;8470;20198;7596;19092;155;511;6564;16229;6719;16740
292240;202011;4628;13353;4063;12332;303;892;2883;8775;3186;9667
292250;202011;5781;14760;5202;13904;400;1051;3955;10521;4355;11572
292260;202011;3367;8731;2991;8246;92;248;2609;7205;2701;7453
292265;202011;3328;8997;2786;8177;68;289;2221;6403;2289;6692
292270;202011;4325;9876;3447;8833;107;270;2879;7389;2986;7659
292273;202011;2755;5813;2200;5138;48;80;1614;4046;1662;4126
292275;202011;1590;4133;1242;3664;54;157;947;2844;1001;3001
292280;202011;2621;6142;2104;5550;79;157;1782;4835;1861;4992
292285;202011;2522;6059;2025;5388;72;152;1661;4458;1733;4610
292290;202011;7450;19375;5889;17204;164;603;4837;14085;5001;14688
292300;202011;10449;25709;8219;22724;786;2293;5715;15870;6501;18163
292303;202011;2911;8270;2540;7673;80;191;2129;6489;2209;6680
292305;202011;2252;6025;2081;5795;43;189;1891;5179;1934;5368
292310;202011;6635;16556;5727;15452;136;449;5022;13413;5158;13862
292320;202011;6074;16491;4826;14169;273;887;3508;10037;3781;10924
292330;202011;2686;5921;2176;5350;99;193;1699;4359;1798;4552
292335;202011;4619;11977;4122;11261;206;491;3495;9632;3701;10123
292340;202011;5439;15172;4506;13378;213;615;3370;9943;3583;10558
292350;202011;2455;6651;2052;6094;73;270;1674;4990;1747;5260
292360;202011;4888;12937;4075;11564;235;736;2874;8040;3109;8776
292370;202011;10213;23785;8837;22004;114;392;8236;20253;8350;20645
292380;202011;6601;18429;5930;17234;374;1107;4558;13121;4932;14228
292390;202011;4517;8566;3322;7172;120;223;2911;6296;3031;6519
292400;202011;22037;62110;19045;57373;1847;5633;13157;39892;15004;45525
292405;202011;4469;10727;3769;9631;89;228;3136;7895;3225;8123
292410;202011;2222;5249;1843;4770;66;146;1624;4232;1690;4378
292420;202011;3338;10128;3063;9715;100;514;2672;8243;2772;8757
292430;202011;4732;14117;3588;12015;268;926;2363;7922;2631;8848
292440;202011;8440;26541;7839;25625;128;629;7042;22894;7170;23523
292450;202011;3987;11323;3125;9648;85;315;2454;7537;2539;7852
292460;202011;4855;13169;3967;11680;325;904;2885;8522;3210;9426
292465;202011;2648;6750;2271;6274;90;193;1516;4616;1606;4809
292467;202011;1861;5231;1635;4923;230;618;1144;3583;1374;4201
292470;202011;2895;7329;2257;6357;54;113;1776;5013;1830;5126
292480;202011;6209;14593;5055;13184;73;280;4596;11866;4669;12146
292490;202011;2053;5258;1736;4790;121;266;1318;3731;1439;3997
292500;202011;6504;17674;5189;15364;488;1517;3377;9877;3865;11394
292510;202011;13091;35002;10209;30428;519;1778;7167;21306;7686;23084
292520;202011;6881;17061;6108;15953;437;1172;4815;12467;5252;13639
292525;202011;5864;13847;4807;12663;115;259;4179;11195;4294;11454
292530;202011;27861;72974;21367;62038;4999;14648;8651;25714;13650;40362
292540;202011;4353;7945;3405;6933;117;203;3078;6287;3195;6490
292550;202011;8338;21411;6397;19078;496;1397;4488;14378;4984;15775
292560;202011;4337;10748;3782;10016;87;233;3147;8414;3234;8647
292570;202011;3531;9309;2961;8239;84;306;2487;6747;2571;7053
292575;202011;6803;19365;6246;18623;374;1079;5048;15211;5422;16290
292580;202011;7562;18858;6262;16947;131;430;5305;14206;5436;14636
292590;202011;7290;19350;6209;17469;272;861;5102;14121;5374;14982
292593;202011;2792;6921;2315;6127;65;168;1966;5153;2031;5321
292595;202011;5354;14123;4569;13161;145;494;3863;11058;4008;11552
292600;202011;10688;29011;9258;26819;315;914;7413;21535;7728;22449
292610;202011;4108;10638;3506;9569;192;433;2647;7326;2839;7759
292620;202011;6317;17194;5272;15928;125;280;4803;14804;4928;15084
292630;202011;8414;20368;6772;17779;713;1854;4362;11557;5075;13411
292640;202011;8176;23762;7098;21966;196;754;5073;15834;5269;16588
292650;202011;4396;10814;3966;10256;104;285;3621;9269;3725;9554
292660;202011;11264;30018;9556;27532;437;1385;7353;21219;7790;22604
292665;202011;2169;6350;1877;5963;66;198;1582;5099;1648;5297
292670;202011;3497;9386;2706;7909;115;364;1844;5276;1959;5640
292680;202011;3909;10236;3094;8809;179;469;2287;6401;2466;6870
292690;202011;2582;6602;1789;5305;195;533;1074;3335;1269;3868
292700;202011;9770;26370;8550;24498;733;1847;5923;17555;6656;19402
292710;202011;2497;7582;2322;7340;39;133;2123;6734;2162;6867
292720;202011;8923;21101;7542;19509;204;554;6028;15864;6232;16418
292730;202011;4579;10319;4275;9951;291;467;3636;8690;3927;9157
292740;202011;312621;747592;267993;683713;36425;92686;169519;430957;205944;523643
292750;202011;6047;16132;5322;15092;220;642;4157;11978;4377;12620
292760;202011;3829;10983;3340;10116;214;727;2466;7409;2680;8136
292770;202011;6196;15925;5001;14274;733;2157;3257;9549;3990;11706
292780;202011;2048;4035;1519;3402;45;130;1240;2643;1285;2773
292790;202011;4065;8512;3097;7463;160;391;2571;6236;2731;6627
292800;202011;11142;27774;9531;25341;288;819;8013;21038;8301;21857
292805;202011;3609;8556;2830;7545;105;313;2249;5949;2354;6262
292810;202011;10462;27267;8330;23906;206;861;6325;17594;6531;18455
292820;202011;7220;19946;5301;16706;419;1403;3711;11511;4130;12914
292830;202011;2859;6713;2450;6207;89;253;2085;5310;2174;5563
292840;202011;8560;22339;7245;20554;141;527;6354;17759;6495;18286
292850;202011;2443;6458;2054;5878;148;443;1453;4135;1601;4578
292860;202011;16905;37010;15176;34975;386;974;13217;30080;13603;31054
292870;202011;17700;43527;15200;40035;970;2563;10430;27253;11400;29816
292880;202011;10765;29224;9173;26836;248;1027;7285;20608;7533;21635
292890;202011;7049;19221;6248;18081;172;695;5498;15778;5670;16473
292895;202011;3024;6396;2214;5198;106;248;1782;4143;1888;4391
292900;202011;2550;6814;2311;6451;58;230;1917;5201;1975;5431
292905;202011;4171;10732;3326;9494;120;402;2494;7053;2614;7455
292910;202011;4744;12865;4331;12277;202;568;3373;9501;3575;10069
292920;202011;9618;26260;8861;25177;264;975;7665;21379;7929;22354
292925;202011;5342;15015;4457;13426;214;629;3237;9682;3451;10311
292930;202011;6272;18321;5420;16765;452;1556;3512;10628;3964;12184
292935;202011;2456;6051;1907;5444;20;110;1719;4921;1739;5031
292937;202011;2739;6836;2354;6327;62;170;1973;5326;2035;5496
292940;202011;2800;7056;2227;6212;173;395;1632;4741;1805;5136
292950;202011;9244;23297;8086;21616;506;1156;6151;16436;6657;17592
292960;202011;5108;12330;4278;11155;123;317;3439;8895;3562;9212
292970;202011;3759;10678;3333;10034;78;352;2805;8459;2883;8811
292975;202011;4419;9358;3923;8803;113;186;3599;8164;3712;8350
292980;202011;3190;7658;2582;6767;77;247;2142;5533;2219;5780
292990;202011;11129;30609;9331;27376;632;1939;6855;19815;7487;21754
293000;202011;2661;6189;2284;5623;37;133;1842;4536;1879;4669
293010;202011;17795;45298;14371;39979;1913;5498;8789;24445;10702;29943
293015;202011;8176;24881;6481;21600;438;1567;4319;14690;4757;16257
293020;202011;9646;27823;8702;26477;135;567;7879;23986;8014;24553
293030;202011;5120;13453;3927;11586;98;320;2731;8253;2829;8573
293040;202011;4356;11338;3659;10349;72;269;3208;9043;3280;9312
293050;202011;22362;53986;19779;50157;1121;2808;15006;37565;16127;40373
293060;202011;3409;9030;2759;7828;223;657;1935;5409;2158;6066
293070;202011;24172;58300;21129;54422;1865;5025;15761;40426;17626;45451
293075;202011;3538;11025;3074;10227;143;633;2474;8207;2617;8840
293076;202011;3466;8481;3165;8126;50;140;2849;7368;2899;7508
293077;202011;5987;16652;4904;14887;424;1401;3208;9975;3632;11376
293080;202011;4727;13761;4068;12626;86;392;3322;10100;3408;10492
293090;202011;3189;9190;2456;7966;207;660;1589;5233;1796;5893
293100;202011;5786;15188;4791;13414;207;580;3785;10498;3992;11078
293105;202011;3716;11770;3251;10798;237;823;2278;7504;2515;8327
293110;202011;2370;5885;1959;5279;68;241;1606;4223;1674;4464
293120;202011;4347;11743;3868;10997;107;269;3232;9212;3339;9481
293130;202011;3635;9992;3170;9381;73;278;2730;8007;2803;8285
293135;202011;29698;68927;22025;58862;3314;9632;10665;28838;13979;38470
293140;202011;2357;5199;2043;4813;58;132;1726;4064;1784;4196
293150;202011;5451;16093;4467;14224;324;1041;3078;9855;3402;10896
293160;202011;3747;9146;3196;8549;238;383;2696;7563;2934;7946
293170;202011;4872;10166;4254;9405;116;248;3730;8212;3846;8460
293180;202011;4298;12047;3591;10754;80;323;2865;8375;2945;8698
293190;202011;13857;37452;12277;35182;132;606;10974;31207;11106;31813
293200;202011;8331;20564;6714;17995;195;675;5408;14191;5603;14866
293210;202011;5093;13458;4379;12347;270;764;3403;9568;3673;10332
293220;202011;4761;12165;3491;10065;811;2353;1436;4245;2247;6598
293230;202011;3735;9573;2740;8157;197;671;1889;5670;2086;6341
293240;202011;4463;11780;3582;10338;66;155;2725;8201;2791;8356
293245;202011;3709;10048;3366;9543;142;470;2888;8069;3030;8539
293250;202011;5833;13445;4746;12056;148;375;3985;10121;4133;10496
293260;202011;4582;12052;3795;10820;167;480;2608;7496;2775;7976
293270;202011;7095;15617;5606;14023;394;579;4397;11859;4791;12438
293280;202011;4304;11384;3778;10639;232;575;2967;8480;3199;9055
293290;202011;14306;41012;12580;38314;1579;4878;8463;26002;10042;30880
293300;202011;5617;13592;4835;12449;269;688;3567;9242;3836;9930
293305;202011;4020;9459;3517;8843;52;122;3196;8034;3248;8156
293310;202011;2043;5240;1728;4754;48;145;1388;3769;1436;3914
293315;202011;4047;9497;3355;8446;193;423;2779;7012;2972;7435
293317;202011;2613;6100;2329;5712;144;270;1850;4557;1994;4827
293320;202011;12127;28762;10745;27224;234;664;9679;24363;9913;25027
293325;202011;1738;4248;1344;3730;203;550;817;2316;1020;2866
293330;202011;58283;162614;47267;143155;8541;26856;22243;67286;30784;94142
293340;202011;2149;6030;1785;5389;77;254;1282;3820;1359;4074
293345;202011;3484;9351;2803;8345;363;837;1815;5935;2178;6772
293350;202011;6471;18597;5582;17534;60;309;5118;16254;5178;16563
293360;202011;15127;37789;12895;34798;283;1181;11405;30233;11688;31414
310010;202011;916;2065;593;1610;46;166;225;562;271;728
310020;202011;2680;7145;1990;5919;439;1415;438;1234;877;2649
310030;202011;1853;5172;1423;4420;204;695;927;2782;1131;3477
310040;202011;863;2243;682;1932;29;125;470;1241;499;1366
310050;202011;1451;4329;1212;3945;117;490;807;2521;924;3011
310060;202011;3077;8675;2680;8140;73;300;2240;6727;2313;7027
310070;202011;332;747;233;609;9;20;175;456;184;476
310080;202011;660;1745;472;1409;68;223;222;626;290;849
310090;202011;4644;12147;3816;10803;283;846;2815;7849;3098;8695
310100;202011;3456;9448;2907;8537;76;344;2378;6784;2454;7128
310110;202011;4508;11774;3494;10016;745;2328;1554;4289;2299;6617
310120;202011;621;1503;392;1139;41;143;235;638;276;781
310130;202011;355;914;300;835;26;101;225;597;251;698
310140;202011;261;754;183;616;40;157;69;202;109;359
310150;202011;5383;14036;3976;11461;515;1703;1921;5218;2436;6921
310160;202011;7675;18929;5440;15240;1017;3123;1970;5575;2987;8698
310163;202011;983;2915;784;2535;174;650;265;785;439;1435
310170;202011;9150;23064;7291;20165;634;1815;5156;14248;5790;16063
310180;202011;1725;4247;1262;3488;152;456;743;2001;895;2457
310190;202011;2605;7474;2104;6560;471;1641;343;998;814;2639
310200;202011;1836;5383;1338;4419;167;630;643;2087;810;2717
310205;202011;1087;2987;855;2620;145;500;439;1320;584;1820
310210;202011;2525;6741;2085;5969;103;305;1518;4251;1621;4556
310220;202011;1254;3376;963;2807;78;242;641;1793;719;2035
310230;202011;2184;5966;1750;5145;218;707;1117;3064;1335;3771
310240;202011;973;2941;821;2668;50;192;584;1850;634;2042
310250;202011;1048;2766;841;2426;17;72;589;1687;606;1759
310260;202011;3080;7852;2015;5975;593;2060;619;1447;1212;3507
310270;202011;2683;6527;2142;5795;93;294;1767;4770;1860;5064
310280;202011;2422;5579;1881;4802;260;696;1108;2720;1368;3416
310285;202011;1805;5722;1496;5169;163;630;922;3164;1085;3794
310290;202011;1097;2856;891;2491;194;622;466;1172;660;1794
310300;202011;1502;4303;1276;3924;134;503;752;2159;886;2662
310310;202011;298;715;193;531;33;96;94;251;127;347
310320;202011;525;1314;360;1054;23;83;201;559;224;642
310330;202011;468;1103;281;775;42;133;115;286;157;419
310340;202011;7776;20517;6264;18000;840;2380;3238;9473;4078;11853
310350;202011;12460;29685;8518;23331;1454;4272;4027;10629;5481;14901
310360;202011;488;1100;370;947;10;30;252;650;262;680
310370;202011;1264;3858;1075;3501;202;721;354;1214;556;1935
310375;202011;848;2088;590;1697;93;273;321;925;414;1198
310380;202011;390;876;213;597;32;95;98;258;130;353
310390;202011;433;1269;339;1086;71;241;98;273;169;514
310400;202011;9927;23965;7172;19822;656;2111;4492;12098;5148;14209
310410;202011;849;2450;552;1886;84;316;215;691;299;1007
310420;202011;4317;11106;2955;8533;393;1274;1260;3364;1653;4638
310430;202011;1452;3908;958;2988;206;706;355;989;561;1695
310440;202011;651;1684;452;1325;41;144;240;665;281;809
310445;202011;1361;3823;991;3080;60;192;714;2177;774;2369
310450;202011;4529;11310;3429;9576;134;499;2639;7167;2773;7666
310460;202011;1681;4430;1252;3635;199;628;461;1242;660;1870
310470;202011;3611;7955;2813;6901;290;687;1957;4953;2247;5640
310480;202011;955;2444;743;2101;83;250;472;1296;555;1546
310490;202011;2734;7401;2156;6455;219;806;1239;3495;1458;4301
310500;202011;1319;3681;991;3126;176;635;533;1610;709;2245
310510;202011;2026;5213;1326;3933;233;767;506;1495;739;2262
310520;202011;1142;2959;828;2392;131;371;444;1291;575;1662
310530;202011;712;1784;465;1344;68;238;159;376;227;614
310540;202011;2873;8089;2372;7221;505;1632;1099;3200;1604;4832
310550;202011;1241;3126;876;2517;77;278;497;1324;574;1602
310560;202011;14520;37453;10340;30119;1416;4708;4551;11967;5967;16675
310570;202011;1003;2618;793;2325;54;193;589;1697;643;1890
310590;202011;4019;10617;3213;9108;198;640;1871;4992;2069;5632
310600;202011;1272;3737;1035;3241;138;491;541;1597;679;2088
310610;202011;468;1250;296;972;108;364;39;112;147;476
310620;202011;166848;419012;120308;335575;16615;53895;60339;153148;76954;207043
310630;202011;4398;11963;3441;10073;330;1024;2146;6064;2476;7088
310640;202011;1081;3179;882;2798;181;618;360;1093;541;1711
310650;202011;2356;6621;1720;5388;172;565;1005;3048;1177;3613
310660;202011;1285;3415;1050;3098;30;103;892;2616;922;2719
310665;202011;1400;3543;1130;3158;28;104;923;2609;951;2713
310670;202011;57358;145683;48301;130251;4357;13386;33630;86396;37987;99782
310680;202011;758;1767;628;1587;18;64;540;1313;558;1377
310690;202011;1930;4992;1380;4064;107;355;791;2210;898;2565
310700;202011;469;1035;374;921;21;68;298;709;319;777
310710;202011;5438;15330;3989;13181;833;3273;753;2203;1586;5476
310720;202011;1016;2323;790;2038;29;93;601;1505;630;1598
310730;202011;9989;26236;8531;23927;375;1305;6400;17570;6775;18875
310740;202011;6198;16734;4388;13014;647;2150;1708;4571;2355;6721
310750;202011;1204;2892;907;2460;102;309;490;1241;592;1550
310760;202011;638;1613;443;1308;38;116;234;705;272;821
310770;202011;1078;2855;735;2334;78;305;385;1115;463;1420
310780;202011;4219;10061;3519;9140;71;195;2877;7498;2948;7693
310790;202011;1746;5476;1488;4922;339;1194;248;733;587;1927
310800;202011;2301;6749;1684;5490;347;1370;105;272;452;1642
310810;202011;1260;3079;1031;2702;44;124;746;1878;790;2002
310820;202011;1187;3004;726;2237;169;540;159;505;328;1045
310825;202011;2554;7605;2048;6766;68;394;1661;5288;1729;5682
310830;202011;1844;5128;1301;4065;237;851;550;1612;787;2463
310840;202011;2019;5441;1484;4533;342;1210;379;990;721;2200
310850;202011;1430;3935;1201;3610;43;218;941;2698;984;2916
310855;202011;3003;7909;2326;6815;163;573;1674;4763;1837;5336
310860;202011;6767;19531;5430;16919;538;1765;3359;10559;3897;12324
310870;202011;937;2243;739;1956;54;131;549;1460;603;1591
310880;202011;974;2907;765;2475;111;380;433;1357;544;1737
310890;202011;2153;6121;1384;4562;255;915;216;613;471;1528
310900;202011;3707;10226;2507;7566;364;1130;1073;3030;1437;4160
310910;202011;2135;5148;1491;4127;138;438;309;793;447;1231
310920;202011;1872;4844;1426;4175;195;617;817;2348;1012;2965
310925;202011;915;2484;740;2198;65;232;507;1421;572;1653
310930;202011;5696;14733;3964;11896;769;2360;1792;5607;2561;7967
310940;202011;6639;15561;5351;13698;186;572;4135;10305;4321;10877
310945;202011;1257;3272;982;2830;174;525;473;1326;647;1851
310950;202011;1837;5421;1213;4007;220;799;375;1050;595;1849
310960;202011;723;1926;394;1223;67;246;77;217;144;463
310970;202011;1115;3262;772;2527;195;708;143;430;338;1138
310980;202011;254;607;168;480;19;64;107;299;126;363
310990;202011;1262;3457;986;2980;157;516;521;1556;678;2072
311000;202011;3845;10610;2800;8858;678;2296;1162;3579;1840;5875
311010;202011;893;2542;716;2190;213;724;302;898;515;1622
311020;202011;1097;2776;691;2040;39;122;377;1087;416;1209
311030;202011;1614;3942;1129;3158;214;676;521;1392;735;2068
311040;202011;264;820;218;721;67;234;74;231;141;465
311050;202011;2837;6876;2102;5804;351;1128;1077;2797;1428;3925
311060;202011;3109;7860;2296;6352;316;1001;951;2398;1267;3399
311070;202011;2250;5568;1625;4590;163;605;919;2407;1082;3012
311080;202011;1130;2540;909;2196;63;180;707;1625;770;1805
311090;202011;1993;6326;1560;5502;357;1388;483;1655;840;3043
311100;202011;2354;6639;1369;4590;259;985;245;734;504;1719
311110;202011;3579;7319;1989;5086;355;965;717;1889;1072;2854
311115;202011;1362;2992;1151;2715;60;152;933;2156;993;2308
311120;202011;6514;16972;4971;14169;686;2188;1904;4827;2590;7015
311130;202011;1805;4686;1380;4110;95;359;820;2352;915;2711
311140;202011;1379;3372;1093;2986;69;227;775;2072;844;2299
311150;202011;1422;4520;1096;3882;172;672;596;2058;768;2730
311160;202011;3720;10620;2617;8527;657;2366;790;2454;1447;4820
311170;202011;879;2207;697;1969;39;113;440;1313;479;1426
311180;202011;1333;2979;829;2233;153;454;372;992;525;1446
311190;202011;836;2293;631;1903;109;379;260;687;369;1066
311200;202011;1961;5243;1409;4195;266;870;525;1422;791;2292
311205;202011;844;2516;686;2207;48;212;436;1325;484;1537
311210;202011;963;2807;834;2629;104;296;606;1962;710;2258
311220;202011;717;1982;599;1771;45;158;391;1092;436;1250
311230;202011;7718;23001;5830;19138;1090;3714;2163;7242;3253;10956
311240;202011;1029;2659;792;2318;171;528;329;971;500;1499
311250;202011;1102;3180;846;2685;179;540;326;993;505;1533
311260;202011;2633;6415;1685;4768;257;821;733;1884;990;2705
311265;202011;1284;3302;945;2734;40;152;649;1837;689;1989
311270;202011;2898;8626;2520;7999;137;605;1851;5633;1988;6238
311280;202011;1013;2601;461;1469;76;275;33;84;109;359
311290;202011;1813;5472;1655;5149;136;422;1121;3491;1257;3913
311300;202011;4626;12737;3798;11372;192;761;3026;8851;3218;9612
311310;202011;547;1517;467;1379;44;137;291;826;335;963
311320;202011;3166;9540;2704;8550;359;1355;1318;3769;1677;5124
311330;202011;5068;13161;3987;11397;431;1329;2244;6554;2675;7883
311340;202011;10129;28053;8019;24301;2027;6685;2321;6629;4348;13314
311350;202011;2405;5862;1720;4621;161;446;919;2241;1080;2687
311360;202011;1084;2632;691;2037;190;632;241;680;431;1312
311370;202011;4591;10997;3357;9063;137;536;2266;5749;2403;6285
311380;202011;348;1044;248;835;61;204;109;392;170;596
311390;202011;1716;5159;1361;4659;587;2241;351;1089;938;3330
311400;202011;1477;4029;1073;3240;174;556;382;1021;556;1577
311410;202011;1681;4876;1340;4364;213;790;761;2397;974;3187
311420;202011;1479;4287;1014;3321;188;692;272;739;460;1431
311430;202011;4016;10457;2673;7820;491;1482;890;2564;1381;4046
311440;202011;2792;7747;2096;6563;522;1929;487;1420;1009;3349
311450;202011;1642;4863;1180;4002;309;1195;321;944;630;2139
311455;202011;980;2156;647;1663;167;435;253;694;420;1129
311460;202011;469;1428;310;1088;61;279;84;241;145;520
311470;202011;502;1531;331;1133;80;319;52;166;132;485
311480;202011;1011;2585;822;2286;45;132;633;1751;678;1883
311490;202011;246;723;183;598;33;131;84;242;117;373
311500;202011;435;1057;343;927;19;59;235;622;254;681
311510;202011;3147;8138;2160;6444;290;969;934;2627;1224;3596
311520;202011;631;1747;552;1595;72;264;308;867;380;1131
311530;202011;8382;19447;5267;14442;1284;3881;1403;3659;2687;7540
311535;202011;777;2127;514;1563;83;258;183;515;266;773
311540;202011;476;1497;422;1394;77;292;283;896;360;1188
311545;202011;1964;5569;1674;5117;91;321;1302;3929;1393;4250
311547;202011;1434;3653;1245;3361;48;120;848;2321;896;2441
311550;202011;2671;7396;2107;6369;292;1009;924;2648;1216;3657
311560;202011;294;631;189;478;75;183;40;91;115;274
311570;202011;1601;3670;1138;3031;33;93;903;2441;936;2534
311580;202011;2051;3820;1363;3004;138;275;925;2046;1063;2321
311590;202011;470;1245;373;1095;63;211;214;618;277;829
311600;202011;1708;3839;1428;3469;68;159;1216;2923;1284;3082
311610;202011;2207;7057;1831;6273;186;724;1063;3564;1249;4288
311615;202011;3152;8783;2581;7830;110;404;2044;6087;2154;6491
311620;202011;430;1095;374;1033;9;34;325;888;334;922
311630;202011;1325;3611;1084;3111;96;320;718;1971;814;2291
311640;202011;643;1719;509;1490;64;217;244;652;308;869
311650;202011;1904;4844;1561;4309;169;505;984;2631;1153;3136
311660;202011;2821;7977;2087;6527;373;1309;599;1582;972;2891
311670;202011;1517;3946;1102;3196;164;536;439;1269;603;1805
311680;202011;2077;5881;1573;4958;159;490;1074;3387;1233;3877
311690;202011;592;1270;464;1112;35;68;345;876;380;944
311700;202011;2146;5141;1706;4534;24;122;1455;3745;1479;3867
311710;202011;1477;4213;1073;3498;263;930;386;1248;649;2178
311720;202011;413;1209;326;1054;34;123;165;538;199;661
311730;202011;3395;8812;2205;6441;641;2013;454;1365;1095;3378
311740;202011;877;2269;734;2098;67;189;599;1760;666;1949
311750;202011;3749;11161;2999;9782;413;1457;1730;5444;2143;6901
311760;202011;618;1716;506;1515;66;241;259;669;325;910
311770;202011;2052;5840;1594;5026;244;801;743;2267;987;3068
311780;202011;1304;3709;913;2928;154;559;296;812;450;1371
311783;202011;2225;5958;1801;5230;37;171;1461;4073;1498;4244
311787;202011;778;2224;589;1772;81;273;255;647;336;920
311790;202011;1439;3865;929;2935;233;816;249;728;482;1544
311800;202011;4717;14065;3783;12045;768;2612;614;1697;1382;4309
311810;202011;922;2760;729;2417;49;175;494;1616;543;1791
311820;202011;762;1837;561;1529;62;204;352;900;414;1104
311830;202011;7856;22297;5340;16856;1527;5234;675;2078;2202;7312
311840;202011;3559;8872;2855;7863;230;683;2119;5782;2349;6465
311850;202011;359;944;290;812;13;41;194;522;207;563
311860;202011;57736;144226;44073;120906;6194;18430;25039;65517;31233;83947
311870;202011;1823;4806;1243;3756;225;793;474;1270;699;2063
311880;202011;6161;15951;5159;14568;273;685;3891;11215;4164;11900
311890;202011;1675;3979;1288;3425;83;258;921;2320;1004;2578
311900;202011;726;1859;545;1616;58;210;350;1002;408;1212
311910;202011;3985;10236;2998;8950;514;1521;1540;4740;2054;6261
311920;202011;2082;5454;1675;4865;114;297;1052;3167;1166;3464
311930;202011;3725;8595;2660;7104;800;2317;801;1980;1601;4297
311940;202011;15170;39442;11151;31754;1560;4881;5146;13669;6706;18550
311950;202011;2292;6092;1730;5146;118;412;1032;3121;1150;3533
311960;202011;470;1136;370;987;23;84;241;586;264;670
311970;202011;405;1299;298;1023;54;223;70;201;124;424
311980;202011;447;1200;232;771;21;67;83;272;104;339
311990;202011;519;1196;324;905;60;211;141;348;201;559
311995;202011;946;2589;473;1503;19;63;70;147;89;210
312000;202011;762;1882;562;1583;53;139;347;1007;400;1146
312010;202011;949;2560;729;2204;46;157;475;1364;521;1521
312015;202011;1341;3885;1183;3626;46;203;969;2902;1015;3105
312020;202011;1571;4807;1185;3970;234;836;296;916;530;1752
312030;202011;1992;4874;1735;4590;17;56;1632;4317;1649;4373
312040;202011;831;2410;581;1924;68;234;262;836;330;1070
312050;202011;1158;3549;926;3108;208;836;297;874;505;1710
312060;202011;836;2015;537;1641;133;411;261;810;394;1221
312070;202011;898;2547;630;1995;39;139;356;1068;395;1207
312080;202011;2544;6234;1896;5276;103;325;1253;3348;1356;3673
312083;202011;844;2191;622;1842;49;182;425;1214;474;1396
312087;202011;2459;6384;1984;5646;43;136;1547;4440;1590;4576
312090;202011;9957;25760;7761;22303;1098;3479;4054;11305;5152;14784
312100;202011;1524;4362;1213;3780;105;404;730;2160;835;2564
312110;202011;1026;3145;850;2789;179;684;317;936;496;1620
312120;202011;979;2619;653;2030;162;589;201;506;363;1095
312125;202011;1658;4230;1378;3832;106;346;1033;2756;1139;3102
312130;202011;1019;2474;768;2055;61;185;348;850;409;1035
312140;202011;682;1948;555;1699;112;382;241;675;353;1057
312150;202011;441;1219;374;1082;14;56;271;736;285;792
312160;202011;8630;23324;6551;19646;800;2742;3267;9323;4067;12065
312170;202011;872;2368;670;1981;37;136;442;1269;479;1405
312180;202011;1366;3634;1083;3095;159;466;553;1534;712;2000
312190;202011;646;1763;471;1433;76;259;169;472;245;731
312200;202011;4369;11973;3443;10468;1062;3204;1185;3740;2247;6944
312210;202011;1338;2959;968;2429;34;103;738;1810;772;1913
312220;202011;1564;4830;1354;4430;102;361;859;2817;961;3178
312230;202011;12868;32920;8509;25025;1986;6640;1750;4369;3736;11009
312235;202011;1911;4807;1514;4246;90;298;1084;2954;1174;3252
312240;202011;669;2162;505;1815;109;423;149;521;258;944
312245;202011;2614;6734;2139;5998;64;180;1754;4888;1818;5068
312247;202011;935;2268;680;1900;122;357;360;1016;482;1373
312250;202011;947;2501;606;1813;82;261;226;654;308;915
312260;202011;902;2408;717;2127;38;153;554;1579;592;1732
312270;202011;711;1950;538;1605;30;118;307;839;337;957
312280;202011;415;1214;323;1049;91;305;46;138;137;443
312290;202011;754;2208;604;1937;100;356;208;651;308;1007
312300;202011;939;2815;622;2037;155;552;118;319;273;871
312310;202011;951;2818;757;2419;119;411;353;1072;472;1483
312320;202011;1942;4958;1411;4029;324;982;326;891;650;1873
312330;202011;808;2396;652;2053;59;214;406;1246;465;1460
312340;202011;244;631;173;512;43;155;75;196;118;351
312350;202011;238;475;168;402;17;48;116;265;133;313
312352;202011;1542;4614;1368;4299;85;270;844;2832;929;3102
312360;202011;2661;7615;1940;6235;373;1331;659;1983;1032;3314
312370;202011;1834;4697;1489;4113;167;515;908;2389;1075;2904
312380;202011;2095;4719;1729;4253;4;12;1553;3777;1557;3789
312385;202011;1208;3273;942;2789;143;450;433;1292;576;1742
312390;202011;1850;5282;1385;4413;191;704;520;1519;711;2223
312400;202011;2712;7734;2246;6927;667;2233;728;2219;1395;4452
312410;202011;11246;30810;9079;27163;1569;4856;5064;14977;6633;19833
312420;202011;3644;9766;3017;8751;560;1776;1606;4536;2166;6312
312430;202011;7612;20235;6239;17756;382;1276;4472;12397;4854;13673
312440;202011;894;2865;719;2455;354;1294;105;314;459;1608
312450;202011;1153;3357;872;2864;239;833;288;988;527;1821
312460;202011;431;1123;296;915;46;142;148;481;194;623
312470;202011;464;1101;289;795;30;87;108;267;138;354
312480;202011;1015;2500;707;2042;96;311;348;956;444;1267
312490;202011;2049;4997;1592;4324;203;584;867;2295;1070;2879
312500;202011;1004;2448;822;2191;47;164;582;1524;629;1688
312510;202011;3628;9552;2546;7498;626;1789;642;1938;1268;3727
312520;202011;155;414;121;364;31;102;53;158;84;260
312530;202011;564;1387;484;1291;15;54;426;1139;441;1193
312540;202011;1555;4295;1045;3272;141;467;590;1793;731;2260
312550;202011;765;1997;588;1655;46;145;382;985;428;1130
312560;202011;1906;4938;1528;4335;72;220;1156;3277;1228;3497
312570;202011;2155;5208;1607;4515;445;1293;612;1812;1057;3105
312580;202011;585;1588;406;1216;53;185;188;528;241;713
312590;202011;1576;4561;1251;3909;76;345;794;2291;870;2636
312595;202011;1935;5624;1616;5084;252;740;972;3220;1224;3960
312600;202011;1158;2747;656;1803;110;378;126;391;236;769
312610;202011;6534;16409;4275;12187;641;2004;1503;3908;2144;5912
312620;202011;2475;6375;1838;5478;56;242;1466;4453;1522;4695
312630;202011;275;792;192;636;36;138;74;236;110;374
312640;202011;506;1376;353;1112;37;126;141;449;178;575
312650;202011;1986;5074;1367;3912;64;209;972;2657;1036;2866
312660;202011;1291;3123;982;2608;98;275;663;1702;761;1977
312670;202011;4803;12679;4008;11409;174;705;2940;8013;3114;8718
312675;202011;1257;3263;1028;2931;54;173;843;2371;897;2544
312680;202011;1350;3804;1169;3526;51;211;963;2823;1014;3034
312690;202011;2903;6091;2264;5326;43;118;1902;4479;1945;4597
312695;202011;940;2531;786;2274;39;91;623;1804;662;1895
312700;202011;2022;5282;1454;4248;143;494;817;2257;960;2751
312705;202011;1376;3237;1186;2960;14;50;1088;2692;1102;2742
312707;202011;1315;3811;1018;3288;66;307;669;2043;735;2350
312710;202011;6274;14323;3676;10252;903;2706;1057;3078;1960;5784
312720;202011;1042;2763;783;2343;98;314;481;1396;579;1710
312730;202011;1601;3752;1129;3098;94;285;657;1738;751;2023
312733;202011;1339;3517;1012;2895;35;140;708;1918;743;2058
312735;202011;692;1864;580;1644;72;226;334;853;406;1079
312737;202011;763;1696;538;1377;65;185;350;864;415;1049
312738;202011;678;1717;483;1392;42;136;275;757;317;893
312740;202011;410;1022;239;728;44;148;61;139;105;287
312750;202011;1551;4464;1148;3699;203;689;491;1504;694;2193
312760;202011;1685;4944;1193;3919;215;760;445;1396;660;2156
312770;202011;43314;103193;27104;75335;5438;16251;9261;25029;14699;41280
312780;202011;2367;7022;1996;6424;235;788;1284;4136;1519;4924
312790;202011;235;547;122;371;6;27;36;95;42;122
312800;202011;4729;13241;3571;11029;864;2820;1279;3832;2143;6652
312810;202011;1520;4010;1010;3189;254;887;370;1071;624;1958
312820;202011;1687;4476;1355;3899;50;180;1028;2880;1078;3060
312825;202011;1326;3090;1155;2867;18;62;999;2430;1017;2492
312830;202011;2694;7546;1640;5361;320;1187;429;1320;749;2507
312840;202011;1293;3466;1030;3021;87;330;574;1552;661;1882
312850;202011;922;2234;646;1822;22;92;398;1032;420;1124
312860;202011;1069;2762;720;2213;180;588;177;493;357;1081
312870;202011;5921;15823;3581;11305;579;1968;834;2439;1413;4407
312880;202011;1410;3498;1087;2942;37;123;649;1758;686;1881
312890;202011;2186;5407;1601;4445;110;291;824;2332;934;2623
312900;202011;1194;3018;975;2740;151;472;456;1393;607;1865
312910;202011;1543;2827;819;1873;166;315;315;755;481;1070
312920;202011;979;2567;671;2057;115;409;280;783;395;1192
312930;202011;2314;5655;1786;4868;401;1115;786;2182;1187;3297
312940;202011;943;2561;735;2255;68;258;386;1117;454;1375
312950;202011;2943;7270;1911;5597;491;1574;616;1744;1107;3318
312960;202011;1787;4692;1508;4264;74;192;1171;3399;1245;3591
312965;202011;1588;4385;1324;3978;114;351;924;2732;1038;3083
312970;202011;1342;3725;1060;3262;144;536;627;1801;771;2337
312980;202011;23337;63406;18712;55073;3630;11599;8878;24528;12508;36127
312990;202011;474;1182;301;880;52;172;147;393;199;565
313000;202011;470;1330;352;1113;29;123;213;634;242;757
313005;202011;2460;7070;2065;6369;163;478;1465;4500;1628;4978
313010;202011;4921;13347;3921;11748;674;2197;2331;6871;3005;9068
313020;202011;1043;3092;731;2380;127;445;145;393;272;838
313030;202011;1099;2512;741;1987;87;283;478;1205;565;1488
313040;202011;783;2391;643;2110;43;183;383;1190;426;1373
313050;202011;1722;4705;1196;3903;201;793;392;1137;593;1930
313055;202011;1867;5001;1657;4701;54;177;1438;4051;1492;4228
313060;202011;957;2285;690;1833;175;565;133;313;308;878
313065;202011;1607;4748;1412;4428;47;169;1105;3384;1152;3553
313070;202011;925;2422;697;2031;66;209;416;1184;482;1393
313080;202011;378;1046;279;853;49;171;108;279;157;450
313090;202011;4999;13192;4240;11967;325;1058;2864;7986;3189;9044
313100;202011;1326;3416;1026;2980;26;109;786;2224;812;2333
313110;202011;1419;3735;1037;3063;97;352;585;1624;682;1976
313115;202011;2555;7308;2046;6307;267;942;1081;3103;1348;4045
313120;202011;3654;8637;2658;7325;218;693;1728;4724;1946;5417
313130;202011;30605;77928;23175;64334;2445;7693;13296;34840;15741;42533
313140;202011;620;1312;364;952;29;70;243;642;272;712
313150;202011;1318;3659;968;3019;292;994;174;469;466;1463
313160;202011;1162;2863;905;2476;21;76;691;1835;712;1911
313170;202011;10835;30567;7845;25006;1332;4653;3215;9619;4547;14272
313180;202011;1996;5234;1419;4082;190;566;823;2331;1013;2897
313190;202011;4159;11867;3015;9535;548;1876;1068;3139;1616;5015
313200;202011;1084;2984;946;2741;16;53;797;2240;813;2293
313210;202011;3705;10670;3025;9433;369;1265;1826;5517;2195;6782
313220;202011;1690;4412;1123;3284;161;526;456;1182;617;1708
313230;202011;2951;8186;2431;7540;44;162;2036;6455;2080;6617
313240;202011;9437;22910;5881;17194;965;3237;2553;6948;3518;10185
313250;202011;5851;17264;4434;14165;818;2656;1973;6134;2791;8790
313260;202011;633;1639;454;1324;62;235;221;585;283;820
313270;202011;5688;13967;4569;12427;556;1446;3120;8667;3676;10113
313280;202011;456;1274;289;927;37;133;129;392;166;525
313290;202011;929;2867;679;2418;208;799;214;765;422;1564
313300;202011;1551;4097;1118;3326;278;908;276;702;554;1610
313310;202011;1166;3409;896;2847;145;553;262;706;407;1259
313320;202011;2056;5474;1495;4554;259;912;609;1864;868;2776
313330;202011;4082;10600;3076;9075;170;599;1988;5839;2158;6438
313340;202011;1359;3026;960;2474;81;220;673;1721;754;1941
313350;202011;2869;7938;1822;5542;227;766;649;1727;876;2493
313360;202011;1468;3538;1008;2803;147;499;533;1354;680;1853
313370;202011;1432;3978;1177;3466;139;482;651;1761;790;2243
313375;202011;1740;4525;1092;3288;198;641;232;645;430;1286
313380;202011;6106;15130;4339;11922;737;2279;2088;5108;2825;7387
313390;202011;789;2530;686;2360;50;231;459;1515;509;1746
313400;202011;3580;8842;2770;7730;139;432;2142;5881;2281;6313
313410;202011;1292;3322;1001;2815;48;170;757;2070;805;2240
313420;202011;15289;33713;7797;21155;1773;5355;1118;3001;2891;8356
313430;202011;949;2772;728;2309;125;491;313;855;438;1346
313440;202011;5943;12980;3920;10306;383;1039;2417;6378;2800;7417
313450;202011;741;1953;520;1525;86;273;181;454;267;727
313460;202011;2037;5734;1605;5058;322;1153;759;2267;1081;3420
313470;202011;2809;7140;2218;6275;234;670;1466;4190;1700;4860
313480;202011;987;2799;553;1821;64;238;173;510;237;748
313490;202011;2654;6371;1314;3964;323;1077;274;802;597;1879
313500;202011;518;1443;379;1142;39;119;146;405;185;524
313505;202011;10033;26289;8555;24290;336;1170;6907;19577;7243;20747
313507;202011;1433;3709;1175;3309;33;136;942;2568;975;2704
313510;202011;13313;36504;10443;30993;1249;3837;4924;14323;6173;18160
313520;202011;13958;39150;11170;34350;562;2114;8427;25281;8989;27395
313530;202011;512;1514;382;1231;43;151;155;451;198;602
313535;202011;2282;6316;1884;5546;255;688;1157;3421;1412;4109
313540;202011;749;2200;601;1845;105;332;257;722;362;1054
313545;202011;1106;3642;933;3286;150;559;500;1708;650;2267
313550;202011;1720;5206;1413;4486;287;1007;728;2208;1015;3215
313560;202011;2648;5178;1989;4376;51;81;1690;3741;1741;3822
313570;202011;972;2800;793;2475;190;625;318;966;508;1591
313580;202011;5657;14499;4369;12344;488;1433;2576;7323;3064;8756
313590;202011;1021;2860;829;2584;204;673;385;1274;589;1947
313600;202011;4017;10565;3335;9504;91;366;2806;7836;2897;8202
313610;202011;1047;2623;845;2287;89;273;539;1376;628;1649
313620;202011;5345;14008;4150;11834;497;1604;2442;6715;2939;8319
313630;202011;8446;20231;5981;16523;568;1836;3695;9967;4263;11803
313640;202011;1168;2527;702;1932;137;415;333;908;470;1323
313650;202011;1693;5026;1338;4425;102;382;876;2931;978;3313
313652;202011;735;2287;656;2126;106;361;413;1306;519;1667
313655;202011;1120;2800;880;2501;46;130;681;1939;727;2069
313657;202011;1114;2992;890;2636;37;143;659;1856;696;1999
313660;202011;893;2500;728;2203;76;275;454;1306;530;1581
313665;202011;4767;12589;3726;10739;390;1260;2360;6478;2750;7738
313670;202011;48058;116591;30656;87095;4356;13592;13965;37482;18321;51074
313680;202011;1005;2681;829;2394;60;204;558;1557;618;1761
313690;202011;758;2332;587;2022;142;545;150;493;292;1038
313695;202011;1802;4795;1356;4055;86;260;911;2777;997;3037
313700;202011;2826;9031;2447;8514;238;838;1845;6463;2083;7301
313710;202011;1447;3258;1024;2699;75;205;679;1820;754;2025
313720;202011;5421;14897;3773;11397;521;1680;1577;4398;2098;6078
313730;202011;1325;2945;1000;2505;87;182;654;1660;741;1842
313740;202011;1644;5808;1371;5083;310;1332;259;809;569;2141
313750;202011;1967;5180;1507;4373;265;864;731;1980;996;2844
313753;202011;2158;5116;1444;3966;142;422;803;2138;945;2560
313760;202011;5233;14278;3954;11808;769;2566;1815;5027;2584;7593
313770;202011;3929;10965;3138;9688;200;642;2345;7335;2545;7977
313780;202011;3837;10189;2794;8458;212;763;821;2534;1033;3297
313790;202011;482;1471;429;1377;46;170;244;762;290;932
313800;202011;1356;3082;988;2565;121;362;517;1271;638;1633
313810;202011;1566;3973;1255;3529;51;186;973;2656;1024;2842
313820;202011;17101;43337;10635;29634;1711;4997;2917;7905;4628;12902
313830;202011;376;1062;265;812;47;169;90;248;137;417
313835;202011;899;2621;746;2340;57;230;420;1231;477;1461
313840;202011;7013;18153;5319;15309;1270;3880;1124;3354;2394;7234
313850;202011;973;2357;768;2082;142;467;359;866;501;1333
313860;202011;2502;6665;1875;5489;297;986;789;2117;1086;3103
313862;202011;1308;2747;618;1732;39;113;298;834;337;947
313865;202011;2544;6710;2095;5970;77;220;1586;4448;1663;4668
313867;202011;1343;4018;1110;3589;178;550;645;2164;823;2714
313868;202011;1660;5085;1370;4517;44;221;1052;3344;1096;3565
313870;202011;769;2055;552;1658;87;272;215;590;302;862
313880;202011;1691;4353;1211;3523;155;518;581;1519;736;2037
313890;202011;1977;4292;1474;3637;45;156;1101;2632;1146;2788
313900;202011;4025;11533;2850;9125;723;2543;701;2033;1424;4576
313910;202011;645;1858;492;1576;100;342;107;336;207;678
313920;202011;2878;8836;2386;7806;495;1573;1185;3938;1680;5511
313925;202011;1540;3875;1238;3346;182;476;807;2172;989;2648
313930;202011;4490;13551;3656;12025;278;1051;2363;7643;2641;8694
313940;202011;8581;24620;6292;20597;704;2867;1493;5508;2197;8375
313950;202011;5042;11108;3744;9511;400;1269;2241;5695;2641;6964
313960;202011;5619;13475;3758;10349;706;2209;1273;3215;1979;5424
313970;202011;1459;3915;1223;3522;21;70;784;2208;805;2278
313980;202011;1262;3245;814;2545;121;434;334;984;455;1418
313990;202011;1874;5875;1340;4668;327;1327;436;1324;763;2651
314000;202011;9400;23903;7861;21270;559;1946;5301;14160;5860;16106
314010;202011;1443;3459;1136;3042;42;140;872;2259;914;2399
314015;202011;1889;5203;1445;4432;187;665;794;2387;981;3052
314020;202011;472;1285;321;1022;72;275;66;222;138;497
314030;202011;780;2212;618;1908;61;187;332;1004;393;1191
314040;202011;596;1604;483;1398;72;237;264;732;336;969
314050;202011;1821;4796;1325;3890;145;509;725;1970;870;2479
314053;202011;1744;5210;1427;4583;300;960;744;2467;1044;3427
314055;202011;2191;5871;1849;5335;43;162;1518;4371;1561;4533
314060;202011;1264;3308;948;2809;34;128;676;1976;710;2104
314070;202011;4646;12607;3602;10720;707;2103;1607;4724;2314;6827
314080;202011;2103;5401;1442;4270;182;616;620;1657;802;2273
314085;202011;2149;5930;1760;5329;216;680;1002;3081;1218;3761
314090;202011;4658;12370;3978;11375;251;894;2475;7233;2726;8127
314100;202011;3022;7229;2335;6275;37;113;1757;4744;1794;4857
314110;202011;4775;13249;3876;11521;418;1432;2201;6115;2619;7547
314120;202011;704;1648;299;899;56;204;72;201;128;405
314130;202011;609;1586;390;1194;25;105;235;700;260;805
314140;202011;4415;12426;3520;10753;477;1498;1791;5388;2268;6886
314150;202011;1488;3679;1087;2987;80;233;735;1963;815;2196
314160;202011;2130;5580;1564;4524;223;711;663;1910;886;2621
314170;202011;882;2466;714;2135;37;142;477;1334;514;1476
314180;202011;5305;14657;4259;12960;352;1162;2585;7853;2937;9015
314190;202011;588;1452;419;1207;75;250;203;525;278;775
314200;202011;2951;8182;2424;7281;161;530;1704;4997;1865;5527
314210;202011;1982;5136;1576;4403;196;548;773;2122;969;2670
314220;202011;1369;3707;995;3043;221;757;357;1001;578;1758
314225;202011;1020;2883;849;2603;70;175;629;1980;699;2155
314230;202011;772;1990;625;1803;86;273;396;1170;482;1443
314240;202011;1032;2767;786;2374;186;596;296;896;482;1492
314250;202011;492;1369;300;964;48;146;103;304;151;450
314260;202011;937;2506;716;2205;162;540;392;1177;554;1717
314270;202011;3227;9093;2658;8217;73;312;1973;6050;2046;6362
314280;202011;3345;7720;2237;6013;239;716;1267;3229;1506;3945
314290;202011;4364;11267;3602;9907;305;853;2477;6675;2782;7528
314300;202011;1979;5539;1289;4075;222;762;463;1361;685;2123
314310;202011;3859;9958;2535;7663;787;2652;387;1008;1174;3660
314315;202011;925;3120;793;2836;51;233;557;1922;608;2155
314320;202011;2964;8015;1942;6088;350;1203;703;2108;1053;3311
314330;202011;47355;132479;35585;111368;9375;30700;7426;24531;16801;55231
314340;202011;2396;5907;1482;4263;271;898;384;950;655;1848
314345;202011;1447;4192;1159;3672;142;460;700;2198;842;2658
314350;202011;781;2110;499;1594;112;366;116;321;228;687
314360;202011;532;1546;327;1097;55;201;104;313;159;514
314370;202011;731;1933;588;1720;44;150;397;1113;441;1263
314380;202011;1096;2950;717;2277;162;582;154;463;316;1045
314390;202011;13648;34261;8830;25446;1493;4639;2846;7297;4339;11936
314400;202011;3779;11357;2876;9554;734;2523;1081;3713;1815;6236
314410;202011;2605;7277;1808;5788;243;900;606;2028;849;2928
314420;202011;830;2031;596;1640;39;149;400;1031;439;1180
314430;202011;7721;18727;5382;14805;779;2257;2560;6701;3339;8958
314435;202011;1816;4796;1430;4157;99;349;978;2737;1077;3086
314437;202011;891;2258;644;1851;71;217;322;923;393;1140
314440;202011;604;1713;423;1350;122;427;85;224;207;651
314450;202011;1357;3619;1137;3262;109;368;663;1828;772;2196
314460;202011;3100;9352;2251;7592;576;2066;545;1766;1121;3832
314465;202011;2182;6272;1847;5640;59;220;1416;4186;1475;4406
314467;202011;908;2370;749;2109;23;69;614;1675;637;1744
314470;202011;2292;6478;1879;5647;322;1048;884;2489;1206;3537
314480;202011;6342;17803;4573;14074;752;2612;1750;4752;2502;7364
314490;202011;1074;2811;784;2212;66;194;496;1354;562;1548
314500;202011;1627;3881;1161;3235;300;825;401;1168;701;1993
314505;202011;2002;4889;1635;4362;97;273;1200;3112;1297;3385
314510;202011;1887;4902;1324;4028;262;895;591;1775;853;2670
314520;202011;4755;14437;3497;11798;708;2622;444;1336;1152;3958
314530;202011;5259;16901;4740;15898;292;1224;3520;11509;3812;12733
314535;202011;2432;6350;1980;5699;73;284;1533;4366;1606;4650
314537;202011;1075;3028;825;2629;40;165;599;1863;639;2028
314540;202011;383;943;256;728;18;57;151;410;169;467
314545;202011;1904;4514;1700;4275;27;78;1493;3840;1520;3918
314550;202011;660;1597;485;1347;37;133;282;714;319;847
314560;202011;4398;13050;3217;10391;476;1720;1114;3210;1590;4930
314570;202011;294;812;212;655;28;95;90;280;118;375
314580;202011;444;1317;355;1144;95;304;118;372;213;676
314585;202011;641;1981;485;1635;60;250;206;676;266;926
314587;202011;1994;5407;1500;4612;206;603;849;2688;1055;3291
314590;202011;3981;10698;2880;8612;369;1237;1318;3631;1687;4868
314600;202011;1881;5078;1100;3580;225;776;129;402;354;1178
314610;202011;8727;21435;6105;17587;953;3289;2690;7884;3643;11173
314620;202011;2215;5181;1751;4594;44;142;1454;3799;1498;3941
314625;202011;1525;4132;1314;3841;29;173;1139;3247;1168;3420
314630;202011;5311;13298;4367;12046;107;445;3648;9975;3755;10420
314640;202011;677;1580;495;1301;73;220;279;675;352;895
314650;202011;802;1840;493;1359;52;168;276;681;328;849
314655;202011;1571;4307;1118;3497;170;525;554;1736;724;2261
314660;202011;310;699;203;508;13;27;135;326;148;353
314670;202011;1576;3580;1101;2911;20;62;735;1913;755;1975
314675;202011;1666;4389;1418;3974;69;218;1114;3040;1183;3258
314690;202011;1991;5481;1514;4779;393;1385;540;1660;933;3045
314700;202011;9909;27396;6453;20704;1241;4428;2113;6543;3354;10971
314710;202011;7603;21181;5510;16725;896;3000;2036;5430;2932;8430
314720;202011;2070;6081;1434;4768;285;1038;367;1144;652;2182
314730;202011;2234;5749;1607;4633;243;781;696;1836;939;2617
314740;202011;2865;8050;2208;6855;295;966;1116;3388;1411;4354
314750;202011;276;748;210;614;24;82;129;340;153;422
314760;202011;1950;5764;1268;4205;207;787;327;836;534;1623
314770;202011;1095;3163;593;1887;47;165;188;554;235;719
314780;202011;342;809;232;643;39;131;125;302;164;433
314790;202011;11127;29434;7686;23014;1508;5184;2800;7668;4308;12852
314795;202011;1480;3871;1255;3481;28;117;1011;2703;1039;2820
314800;202011;10367;26341;6363;18898;1150;3714;1740;4612;2890;8326
314810;202011;8377;22240;6054;18169;1550;4952;1980;5826;3530;10778
314820;202011;1237;2963;970;2555;65;223;611;1535;676;1758
314830;202011;1504;4553;1270;4113;212;782;625;1943;837;2725
314840;202011;825;2553;655;2269;48;215;458;1509;506;1724
314850;202011;2115;4826;1713;4316;43;136;1491;3759;1534;3895
314860;202011;3113;9138;2583;8178;192;778;1788;5508;1980;6286
314870;202011;6248;15629;4735;13634;273;879;3525;10243;3798;11122
314875;202011;1726;5149;1506;4853;124;319;1195;3951;1319;4270
314880;202011;792;1950;610;1669;29;87;368;1008;397;1095
314890;202011;398;1184;306;996;48;177;126;384;174;561
314900;202011;718;1924;559;1640;80;272;255;697;335;969
314910;202011;1632;4573;1212;3887;194;726;618;1866;812;2592
314915;202011;2150;6371;1802;5751;117;375;1188;3735;1305;4110
314920;202011;453;1184;291;937;5;14;197;650;202;664
314930;202011;5400;15049;4042;12483;668;2314;1667;4753;2335;7067
314940;202011;387;969;314;844;36;92;198;505;234;597
314950;202011;527;1317;353;1027;27;101;189;489;216;590
314960;202011;824;1953;630;1632;26;88;454;1102;480;1190
314970;202011;950;2758;720;2273;139;473;321;924;460;1397
314980;202011;1441;3694;1069;3153;193;654;519;1488;712;2142
314990;202011;2344;6728;1666;5186;334;1109;359;1005;693;2114
314995;202011;1539;4256;1221;3688;37;162;823;2347;860;2509
315000;202011;1086;2738;774;2257;59;181;520;1499;579;1680
315010;202011;368;1009;277;853;45;163;136;398;181;561
315015;202011;2257;6294;1956;5784;188;628;1305;3786;1493;4414
315020;202011;782;2272;546;1736;69;272;235;684;304;956
315030;202011;575;1531;388;1178;86;266;78;212;164;478
315040;202011;810;2255;652;1969;84;280;402;1196;486;1476
315050;202011;1186;3085;864;2559;54;198;463;1325;517;1523
315053;202011;1050;2731;809;2316;48;149;483;1313;531;1462
315057;202011;1698;5080;1378;4535;132;433;929;3107;1061;3540
315060;202011;571;1711;415;1406;86;301;108;354;194;655
315070;202011;504;1316;341;1031;80;268;89;252;169;520
315080;202011;2903;8059;2236;6781;225;769;1447;4157;1672;4926
315090;202011;768;2294;562;1894;82;295;229;748;311;1043
315100;202011;1302;3781;853;2769;142;547;378;1080;520;1627
315110;202011;1892;4504;1362;3691;132;353;687;1916;819;2269
315120;202011;12149;28061;8978;23284;1150;2742;4950;13294;6100;16036
315130;202011;1600;4342;1328;3863;142;469;550;1503;692;1972
315140;202011;2840;7841;2213;6704;375;1234;1140;3284;1515;4518
315150;202011;4207;10061;2957;8057;444;1422;1410;3727;1854;5149
315160;202011;1735;4187;1134;3217;238;730;525;1467;763;2197
315170;202011;1277;4049;884;3083;210;801;231;765;441;1566
315180;202011;16609;39979;8994;25966;1202;3936;3012;7654;4214;11590
315190;202011;2172;4749;1692;4119;197;472;1232;3039;1429;3511
315200;202011;3810;10736;2745;8825;777;2708;743;2297;1520;5005
315210;202011;8420;21742;5710;16032;662;2030;2857;7266;3519;9296
315213;202011;1100;2880;957;2685;22;75;796;2186;818;2261
315217;202011;2788;8026;2127;6913;90;420;1470;4569;1560;4989
315220;202011;8405;22729;6594;19510;1070;3357;2866;8508;3936;11865
315230;202011;2995;7035;2533;6424;191;265;1931;5245;2122;5510
315240;202011;2344;6882;1963;6215;428;1399;953;3044;1381;4443
315250;202011;12778;34216;9193;27436;1418;4542;3954;11260;5372;15802
315260;202011;860;2351;454;1492;71;235;39;105;110;340
315270;202011;817;2330;579;1875;80;278;206;568;286;846
315280;202011;2714;6742;1633;4810;409;1309;272;773;681;2082
315290;202011;1119;2723;653;1974;181;613;200;576;381;1189
315300;202011;615;1496;421;1221;77;247;219;647;296;894
315310;202011;1201;3367;906;2793;81;280;505;1469;586;1749
315320;202011;639;1865;449;1487;66;237;187;573;253;810
315330;202011;741;2507;408;1599;66;304;126;440;192;744
315340;202011;2861;6899;2054;5740;283;820;1092;3035;1375;3855
315350;202011;1523;4179;1219;3696;172;617;687;2031;859;2648
315360;202011;1659;4884;1247;4009;187;634;530;1587;717;2221
315370;202011;469;1337;371;1142;71;218;146;439;217;657
315380;202011;196;574;142;458;39;137;31;72;70;209
315390;202011;1091;3070;860;2626;138;503;419;1166;557;1669
315400;202011;3912;10622;3076;9112;436;1364;1687;4780;2123;6144
315410;202011;2374;5453;1781;4580;468;1319;266;698;734;2017
315415;202011;1371;3715;1110;3307;240;843;416;1257;656;2100
315420;202011;1419;3977;966;3101;178;607;190;588;368;1195
315430;202011;3496;8511;2452;6918;438;1455;1071;2825;1509;4280
315440;202011;1015;2688;808;2345;61;210;487;1330;548;1540
315445;202011;1863;4505;1340;3762;83;279;989;2734;1072;3013
315450;202011;2208;6089;1808;5435;223;632;1130;3400;1353;4032
315460;202011;36445;100092;29918;88308;4263;14304;16802;46549;21065;60853
315470;202011;632;1750;446;1292;29;93;261;716;290;809
315480;202011;1076;3104;749;2384;142;486;251;769;393;1255
315490;202011;2832;7169;1994;5796;286;873;756;2094;1042;2967
315500;202011;514;1371;319;948;41;142;161;421;202;563
315510;202011;1200;3117;1019;2866;20;87;896;2477;916;2564
315520;202011;959;2633;783;2341;49;174;603;1753;652;1927
315530;202011;584;1625;463;1413;122;425;230;654;352;1079
315540;202011;1458;3885;1017;3066;99;361;472;1379;571;1740
315550;202011;1841;4789;1178;3566;240;841;299;892;539;1733
315560;202011;6150;18606;5181;16823;294;903;3437;11416;3731;12319
315570;202011;2031;5427;1612;4722;102;338;917;2636;1019;2974
315580;202011;2897;6799;2181;5662;308;920;843;2057;1151;2977
315590;202011;871;2190;663;1860;71;251;385;995;456;1246
315600;202011;2458;7648;1770;6272;286;942;890;3339;1176;4281
315610;202011;946;2387;695;1935;105;365;317;767;422;1132
315620;202011;504;1335;382;1157;40;136;220;680;260;816
315630;202011;1003;2656;754;2193;124;383;359;953;483;1336
315640;202011;339;830;251;720;28;105;154;413;182;518
315645;202011;963;2469;656;1964;156;506;172;485;328;991
315650;202011;1658;4010;1336;3562;33;106;1091;2823;1124;2929
315660;202011;2423;5975;1821;4933;102;321;1305;3407;1407;3728
315670;202011;13259;35839;10049;30017;1918;6020;4625;13241;6543;19261
315680;202011;3112;8869;2281;7275;297;1094;1201;3616;1498;4710
315690;202011;3270;7877;1955;5622;438;1256;575;1800;1013;3056
315700;202011;7852;21514;5905;17658;962;3054;2631;7534;3593;10588
315710;202011;1801;4452;1269;3642;46;197;896;2453;942;2650
315720;202011;4358;12023;3609;10635;192;732;2540;7181;2732;7913
315725;202011;2158;5573;1650;4739;194;537;1015;3055;1209;3592
315727;202011;547;1408;413;1186;56;198;175;470;231;668
315730;202011;552;1722;485;1578;97;350;151;440;248;790
315733;202011;1089;2754;773;2216;115;389;303;833;418;1222
315737;202011;1134;3171;892;2701;25;101;647;1880;672;1981
315740;202011;773;2155;622;1857;66;231;414;1155;480;1386
315750;202011;1219;3225;968;2824;91;284;590;1745;681;2029
315760;202011;1096;2596;965;2425;41;121;808;1987;849;2108
315765;202011;1924;5039;1583;4590;29;120;1399;4031;1428;4151
315770;202011;965;2648;735;2322;296;1029;151;396;447;1425
315780;202011;29220;78924;24303;70179;1260;4550;17112;47148;18372;51698
315790;202011;3505;10823;2986;9816;342;1185;1827;6105;2169;7290
315800;202011;1267;4344;934;3485;129;562;317;1025;446;1587
315810;202011;1263;3143;1033;2744;56;195;802;2029;858;2224
315820;202011;2533;6776;2058;6100;188;611;1426;4235;1614;4846
315830;202011;1156;3428;789;2630;76;269;276;841;352;1110
315840;202011;832;1990;580;1553;42;131;289;700;331;831
315850;202011;1144;3351;889;2891;181;627;432;1317;613;1944
315860;202011;459;1318;325;1072;61;216;110;323;171;539
315870;202011;461;1211;371;1075;17;60;269;745;286;805
315880;202011;1081;2794;716;2138;102;366;167;466;269;832
315890;202011;1649;4685;1328;4235;326;1142;661;2087;987;3229
315895;202011;6104;16317;4550;13282;431;1406;2416;6566;2847;7972
315900;202011;801;2040;690;1882;58;164;525;1396;583;1560
315910;202011;482;1336;403;1212;53;165;285;851;338;1016
315920;202011;1399;3537;769;2342;122;455;250;689;372;1144
315930;202011;1052;2333;707;1847;136;329;309;840;445;1169
315935;202011;784;2359;614;2029;123;433;219;713;342;1146
315940;202011;588;1611;465;1418;51;162;246;729;297;891
315950;202011;1117;3091;923;2774;79;230;717;2150;796;2380
315960;202011;5202;14649;3452;11063;973;3521;315;649;1288;4170
315970;202011;582;1532;462;1372;58;183;309;929;367;1112
315980;202011;4071;8704;2208;5697;396;1093;840;1991;1236;3084
315990;202011;3529;8976;2758;7658;265;787;1583;4253;1848;5040
316000;202011;568;1439;431;1240;51;185;211;569;262;754
316010;202011;805;2152;599;1796;43;145;370;1034;413;1179
316020;202011;916;2780;725;2396;101;379;399;1240;500;1619
316030;202011;2613;7373;2003;6269;233;751;1278;4066;1511;4817
316040;202011;2261;6430;1681;5332;296;1060;441;1224;737;2284
316045;202011;2064;5312;1899;5115;76;143;1652;4571;1728;4714
316050;202011;378;1037;293;893;32;100;162;455;194;555
316060;202011;643;1611;474;1372;17;75;337;933;354;1008
316070;202011;5126;14196;4161;12365;720;2208;1953;5684;2673;7892
316080;202011;710;2225;546;1888;139;503;83;255;222;758
316090;202011;381;1101;286;907;41;139;143;430;184;569
316095;202011;1258;3883;998;3228;277;945;327;1013;604;1958
316100;202011;2423;7026;1754;5614;311;1093;664;1937;975;3030
316105;202011;786;2069;645;1836;32;106;448;1315;480;1421
316110;202011;13514;38773;11310;35042;806;2885;7709;23544;8515;26429
316120;202011;1186;3365;764;2364;124;400;231;579;355;979
316130;202011;1211;2743;793;2051;61;175;469;1185;530;1360
316140;202011;1197;3160;767;2360;97;328;371;1115;468;1443
316150;202011;1892;4122;1512;3605;187;577;635;1426;822;2003
316160;202011;925;2513;768;2240;35;121;546;1558;581;1679
316165;202011;819;2034;629;1731;90;289;339;873;429;1162
316170;202011;1148;2822;861;2389;45;154;604;1606;649;1760
316180;202011;1361;3835;922;2930;139;532;164;481;303;1013
316190;202011;2634;7412;1543;4797;226;732;598;1639;824;2371
316200;202011;3103;8922;2338;7585;565;1948;593;1850;1158;3798
316210;202011;4269;12484;3069;9770;1116;3864;176;479;1292;4343
316220;202011;591;1775;395;1329;89;341;42;163;131;504
316225;202011;1575;3549;1176;2910;54;195;888;2040;942;2235
316230;202011;401;1080;306;916;36;112;172;529;208;641
316240;202011;5454;15743;4778;14561;357;1178;3635;10908;3992;12086
316245;202011;2956;9536;2676;9047;120;683;2080;6697;2200;7380
316250;202011;10049;23891;7348;19673;1544;4530;2770;7310;4314;11840
316255;202011;2844;7874;2500;7327;110;338;1897;5624;2007;5962
316257;202011;1357;3270;984;2614;119;316;587;1482;706;1798
316260;202011;2109;5292;1645;4522;221;585;851;2413;1072;2998
316265;202011;1091;2920;846;2507;22;83;630;1823;652;1906
316270;202011;3600;11003;3077;9859;468;1601;1533;4700;2001;6301
316280;202011;2787;7891;2373;7113;302;996;1349;3931;1651;4927
316290;202011;3237;8917;2611;7775;282;992;1150;3292;1432;4284
316292;202011;4907;12977;3933;11358;487;1511;2547;7067;3034;8578
316294;202011;796;2352;597;2003;113;426;165;513;278;939
316295;202011;3141;8722;2545;7677;139;511;1795;5160;1934;5671
316300;202011;990;2806;795;2486;43;151;594;1830;637;1981
316310;202011;775;2063;503;1576;105;389;92;238;197;627
316320;202011;653;1816;511;1597;56;212;229;688;285;900
316330;202011;1066;2755;813;2322;55;193;614;1685;669;1878
316340;202011;987;2637;734;2181;70;270;427;1205;497;1475
316350;202011;1251;3500;1032;3148;88;295;728;2197;816;2492
316360;202011;610;1615;494;1422;50;153;359;1018;409;1171
316370;202011;4895;12910;3622;10610;620;2110;1481;3866;2101;5976
316380;202011;1696;4082;1339;3567;52;117;925;2486;977;2603
316390;202011;773;2081;545;1672;224;772;86;240;310;1012
316400;202011;1134;3179;740;2379;109;386;248;732;357;1118
316410;202011;1101;3058;923;2792;58;189;724;2141;782;2330
316420;202011;1946;5261;1686;4919;37;135;1407;4020;1444;4155
316430;202011;801;2096;507;1579;92;313;162;475;254;788
316440;202011;806;2452;633;2137;110;427;168;510;278;937
316443;202011;515;1427;377;1159;96;347;79;225;175;572
316447;202011;1942;5202;1704;4802;27;105;1479;4093;1506;4198
316450;202011;2091;6379;1604;5367;224;805;947;3092;1171;3897
316460;202011;1188;2977;954;2608;122;371;614;1585;736;1956
316470;202011;6603;18845;4687;14785;747;2672;1842;5301;2589;7973
316480;202011;186;508;156;466;45;132;74;219;119;351
316490;202011;316;844;219;665;36;113;78;202;114;315
316500;202011;1148;3547;763;2618;159;599;177;574;336;1173
316510;202011;734;2365;585;2071;104;385;294;1028;398;1413
316520;202011;1299;3114;1009;2639;119;389;531;1251;650;1640
316530;202011;1110;2879;805;2325;85;324;418;1062;503;1386
316540;202011;843;2178;658;1891;106;345;322;837;428;1182
316550;202011;1315;3830;1126;3474;50;177;879;2690;929;2867
316553;202011;4231;12398;2990;9402;447;1558;1154;3200;1601;4758
316555;202011;2474;7831;2240;7507;105;388;1862;6265;1967;6653
316556;202011;495;1247;374;1026;31;86;212;524;243;610
316557;202011;1021;3139;883;2910;277;989;319;1015;596;2004
316560;202011;316;875;216;723;46;186;68;198;114;384
316570;202011;1228;3548;1012;3146;251;797;350;1133;601;1930
316580;202011;376;792;215;525;34;101;106;239;140;340
316590;202011;1323;3401;927;2621;194;486;444;1235;638;1721
316600;202011;934;2837;801;2570;120;398;423;1348;543;1746
316610;202011;593;1859;484;1681;61;271;284;952;345;1223
316620;202011;2060;5398;1809;5047;86;257;1441;3999;1527;4256
316630;202011;1499;4489;1225;3968;316;1041;493;1737;809;2778
316640;202011;136;356;108;316;16;57;50;118;66;175
316650;202011;1028;3217;824;2892;80;301;512;1827;592;2128
316660;202011;180;448;78;239;7;26;14;37;21;63
316670;202011;1729;4394;1283;3668;307;954;470;1314;777;2268
316680;202011;2240;5693;1655;4581;100;296;1246;3352;1346;3648
316690;202011;1369;3856;1034;3246;173;585;477;1450;650;2035
316695;202011;1012;2930;831;2607;25;99;586;1822;611;1921
316700;202011;396;925;322;832;16;48;248;615;264;663
316710;202011;3009;9847;2311;8371;452;1747;950;3409;1402;5156
316720;202011;19898;54000;14561;43775;2501;8028;6360;18161;8861;26189
316730;202011;440;1171;355;1011;47;159;173;461;220;620
316740;202011;735;2139;631;1969;71;254;396;1238;467;1492
316750;202011;378;1143;292;978;63;238;129;404;192;642
316760;202011;3318;10661;2737;9469;1092;4088;594;1937;1686;6025
316770;202011;1565;3550;1205;3047;24;71;988;2567;1012;2638
316780;202011;540;1599;420;1359;161;576;69;193;230;769
316790;202011;695;1877;490;1464;93;305;144;390;237;695
316800;202011;6162;17191;4921;14931;565;1894;2466;7239;3031;9133
316805;202011;985;2186;793;1977;57;160;609;1530;666;1690
316810;202011;589;1640;407;1275;78;286;217;636;295;922
316820;202011;294;716;165;480;19;73;61;153;80;226
316830;202011;755;1975;600;1734;81;260;363;1016;444;1276
316840;202011;2716;6953;2146;5994;181;635;1497;3973;1678;4608
316850;202011;1850;4885;1335;3932;226;715;577;1632;803;2347
316860;202011;18406;47040;13413;39615;2140;7365;6162;17746;8302;25111
316870;202011;7574;20540;5591;16700;830;2725;2559;7158;3389;9883
316880;202011;865;2322;704;2095;139;459;337;958;476;1417
316890;202011;1116;2449;655;1834;89;320;403;1032;492;1352
316900;202011;2219;5963;1707;4935;333;1059;531;1438;864;2497
316905;202011;510;1521;411;1325;108;377;162;531;270;908
316910;202011;850;2213;506;1594;134;457;41;121;175;578
316920;202011;1724;4225;1214;3462;226;692;557;1541;783;2233
316930;202011;7405;21230;5451;17659;1250;4363;1484;4519;2734;8882
316935;202011;3942;10666;2846;8599;508;1666;1153;3319;1661;4985
316940;202011;6287;18388;4811;15329;727;2553;1951;5764;2678;8317
316950;202011;1845;4315;1443;3763;39;126;1207;3098;1246;3224
316960;202011;4964;11157;3568;9264;319;925;2468;6248;2787;7173
316970;202011;3702;10462;3198;9518;499;1553;1342;3824;1841;5377
316980;202011;633;1909;485;1614;165;616;55;197;220;813
316990;202011;11629;30937;8470;24538;2131;6744;1325;3455;3456;10199
317000;202011;2460;7249;2166;6816;166;470;1606;5107;1772;5577
317005;202011;2484;6970;1986;5966;323;1026;1062;3116;1385;4142
317010;202011;23159;53954;14236;40240;2800;8767;5579;16158;8379;24925
317020;202011;58807;139101;34124;96403;6263;19421;11048;28884;17311;48305
317030;202011;682;1791;528;1578;12;53;411;1213;423;1266
317040;202011;10580;26588;7369;21050;1619;5012;2642;7744;4261;12756
317043;202011;845;1889;600;1543;48;124;440;1122;488;1246
317047;202011;1162;2777;803;2207;75;222;508;1334;583;1556
317050;202011;1119;3449;796;2676;107;387;339;997;446;1384
317052;202011;2300;6391;1855;5678;266;802;1151;3557;1417;4359
317057;202011;1781;4247;1315;3497;33;117;859;2270;892;2387
317060;202011;512;1330;322;949;39;122;138;357;177;479
317065;202011;1129;3315;923;2909;53;169;580;1730;633;1899
317070;202011;7170;19784;5080;15734;921;3205;1536;4486;2457;7691
317075;202011;884;2279;639;1864;101;325;300;800;401;1125
317080;202011;5842;13622;4298;11162;1159;3256;1430;3576;2589;6832
317090;202011;4633;13455;4117;12610;292;863;3084;9502;3376;10365
317100;202011;2582;6127;1653;4586;379;1082;593;1632;972;2714
317103;202011;2171;5718;1852;5236;81;361;1453;3932;1534;4293
317107;202011;1433;3777;1088;3119;78;268;653;1670;731;1938
317110;202011;660;1552;335;1034;52;187;116;373;168;560
317115;202011;1042;2994;903;2740;53;141;613;1871;666;2012
317120;202011;14348;38314;11502;33702;1076;3767;7122;19895;8198;23662
317130;202011;11123;25665;7050;18991;1115;3326;2402;6399;3517;9725
317140;202011;844;2010;654;1725;40;112;439;1198;479;1310
317150;202011;985;2342;740;2037;32;96;581;1572;613;1668
317160;202011;3451;8310;2282;6436;170;505;1263;3665;1433;4170
317170;202011;1739;4318;1265;3507;183;611;561;1362;744;1973
317180;202011;1929;5970;1418;4747;273;977;379;1181;652;2158
317190;202011;1146;3091;854;2634;145;444;446;1369;591;1813
317200;202011;5374;14084;4087;11776;1022;3180;892;2366;1914;5546
317210;202011;1155;2806;903;2461;25;98;672;1857;697;1955
317220;202011;233;728;197;658;47;160;76;266;123;426
320010;202011;4463;12896;3565;11081;366;1269;2301;6950;2667;8219
320013;202011;2022;5432;1379;4148;231;708;615;1934;846;2642
320016;202011;2950;7564;2329;6612;170;452;1745;4968;1915;5420
320020;202011;3777;9706;2736;7898;588;1881;987;2954;1575;4835
320030;202011;1699;4716;1113;3515;210;713;401;1210;611;1923
320035;202011;1887;5158;1537;4549;381;1236;668;1922;1049;3158
320040;202011;4015;11299;3314;10022;459;1470;1882;5466;2341;6936
320050;202011;1739;3957;1496;3606;183;526;892;2074;1075;2600
320060;202011;12538;34063;9304;27676;1413;4573;4439;12406;5852;16979
320070;202011;1502;4197;1054;3276;181;631;394;1162;575;1793
320080;202011;5651;14439;3912;10973;794;2369;1442;3817;2236;6186
320090;202011;8397;22202;5484;16156;1197;3769;2001;5491;3198;9260
320100;202011;3014;8169;2457;7199;433;1391;1246;3645;1679;5036
320110;202011;2029;4706;1355;3617;190;533;671;1720;861;2253
320115;202011;1779;5707;1508;5250;648;2392;402;1450;1050;3842
320120;202011;23378;59483;16138;46261;2293;7107;7580;20545;9873;27652
320130;202011;45134;124698;36923;109746;4724;15489;21861;63015;26585;78504
320140;202011;3471;9433;2282;7082;336;1210;936;2873;1272;4083
320150;202011;13324;34419;9486;27019;2377;7487;1597;4045;3974;11532
320160;202011;5939;16497;4347;13398;699;2384;2002;6060;2701;8444
320170;202011;1668;4791;1193;3822;327;1023;437;1488;764;2511
320180;202011;678;2139;541;1871;205;752;144;454;349;1206
320190;202011;2744;8675;2077;7184;511;1896;549;1791;1060;3687
320200;202011;1315;3498;881;2710;195;657;337;1030;532;1687
320210;202011;4210;10687;3239;9012;517;1544;1731;4613;2248;6157
320220;202011;2836;7378;2137;6240;340;1078;1129;3110;1469;4188
320225;202011;1327;4117;932;3186;323;1210;193;648;516;1858
320230;202011;4903;13493;3745;11535;816;2760;1491;4413;2307;7173
320240;202011;15713;39625;11572;32901;2794;8673;3767;10480;6561;19153
320245;202011;3011;8847;2344;7502;855;2887;429;1342;1284;4229
320250;202011;2306;6436;1553;4655;354;1165;460;1198;814;2363
320255;202011;1850;5757;1575;5243;415;1425;713;2435;1128;3860
320260;202011;1424;3979;842;2672;176;614;202;538;378;1152
320265;202011;2449;7491;1967;6503;869;3084;330;1082;1199;4166
320270;202011;2146;6170;1642;5172;418;1428;586;1858;1004;3286
320280;202011;6938;18394;5602;16086;1135;3540;2715;7489;3850;11029
320290;202011;1331;3938;856;2793;236;846;223;665;459;1511
320300;202011;3565;10711;2809;9146;811;2853;702;2153;1513;5006
320305;202011;5038;14236;3894;11964;731;2460;1912;5684;2643;8144
320310;202011;2170;5972;1495;4537;263;842;681;1941;944;2783
320313;202011;2378;5925;1550;4392;307;989;410;1052;717;2041
320316;202011;1460;4099;1176;3607;182;568;703;2159;885;2727
320320;202011;21638;56509;15336;45442;3534;10962;5654;16755;9188;27717
320330;202011;2863;7773;2214;6584;401;1203;1183;3588;1584;4791
320332;202011;7326;19586;5804;16832;1324;4122;2638;7568;3962;11690
320334;202011;1701;4792;1182;3726;258;984;293;693;551;1677
320335;202011;1395;4134;979;3157;233;843;248;730;481;1573
320340;202011;4698;11742;3885;10546;485;1448;2280;6250;2765;7698
320350;202011;5330;13165;3754;10309;447;1351;2002;5171;2449;6522
320360;202011;1398;3565;1029;2865;124;346;517;1381;641;1727
320370;202011;2506;7662;1824;6176;546;1949;588;1973;1134;3922
320380;202011;2564;6835;2123;6107;244;752;1347;3767;1591;4519
320390;202011;7052;18912;5183;15182;1061;3331;2101;5777;3162;9108
320400;202011;3252;9141;2439;7386;684;2210;797;2298;1481;4508
320405;202011;4816;12605;3651;10587;544;1727;1800;5072;2344;6799
320410;202011;4700;12145;3533;10252;642;1812;1774;5378;2416;7190
320420;202011;3024;7770;2219;6382;565;1784;346;1006;911;2790
320425;202011;2075;5014;1585;4175;102;303;1035;2632;1137;2935
320430;202011;3096;7712;2414;6480;327;953;1509;3886;1836;4839
320435;202011;2075;6469;1638;5603;583;2122;524;1796;1107;3918
320440;202011;1496;4125;1085;3321;172;569;493;1434;665;2003
320450;202011;1697;4830;1320;4107;259;917;600;1737;859;2654
320455;202011;4267;12815;2850;9436;706;2511;708;2134;1414;4645
320460;202011;2022;5948;1426;4681;337;1174;396;1212;733;2386
320465;202011;1268;3555;947;2940;136;426;505;1576;641;2002
320470;202011;3609;9895;2558;7691;573;1826;640;1715;1213;3541
320480;202011;1634;4484;1334;3978;181;610;798;2321;979;2931
320490;202011;20874;54623;15383;44935;2578;8214;6468;18720;9046;26934
320495;202011;1213;3341;857;2633;188;664;317;928;505;1592
320500;202011;50820;134614;40343;116492;5449;17095;23701;65565;29150;82660
320501;202011;4215;12267;3115;10226;854;3143;1033;3336;1887;6479
320503;202011;2270;6539;1469;4840;396;1427;423;1326;819;2753
320506;202011;2571;7642;1860;6049;551;1938;166;531;717;2469
320510;202011;9997;26889;8041;23478;848;2861;5042;14247;5890;17108
320515;202011;1748;4797;1340;3955;361;1179;457;1268;818;2447
320517;202011;2131;6361;1697;5422;537;1872;520;1635;1057;3507
320520;202011;35409;91031;26213;75455;4445;14052;11410;31688;15855;45740
320530;202011;32133;84432;25246;72111;2283;7725;16154;43561;18437;51286
330010;202011;22338;58721;18344;52097;2335;7270;12071;33259;14406;40529
330015;202011;1436;3501;1111;3005;189;571;605;1561;794;2132
330020;202011;19445;48390;16287;43809;2300;6898;11286;29696;13586;36594
330022;202011;1833;4898;1414;4184;246;738;821;2413;1067;3151
330023;202011;4954;11650;3556;9688;569;1733;2018;5380;2587;7113
330025;202011;6801;15702;3906;10835;894;2752;781;2067;1675;4819
330030;202011;10166;26926;7655;22827;803;2777;4728;13468;5531;16245
330040;202011;14180;36598;11199;31558;1008;3198;7627;20676;8635;23874
330045;202011;83469;196026;68495;176930;5152;13094;54433;140203;59585;153297
330050;202011;2436;6416;1792;5318;337;1070;901;2561;1238;3631
330060;202011;5062;13188;3931;11147;764;2443;1667;4344;2431;6787
330070;202011;21915;54977;17522;48624;2706;8028;10479;28838;13185;36866
330080;202011;8607;21627;7299;19780;895;2582;5094;13631;5989;16213
330090;202011;3311;6950;2294;5538;155;402;1598;3862;1753;4264
330093;202011;2655;6321;1982;5375;110;324;1532;4131;1642;4455
330095;202011;1255;3506;973;2975;75;276;606;1724;681;2000
330100;202011;70025;183992;59512;168400;3476;11706;45879;127870;49355;139576
330110;202011;2052;5680;1636;4972;263;877;936;2743;1199;3620
330115;202011;2504;6004;1751;4832;240;757;993;2632;1233;3389
330120;202011;3466;7731;2581;6597;207;589;1829;4512;2036;5101
330130;202011;4338;11637;3516;10385;477;1470;2216;6503;2693;7973
330140;202011;3755;9673;2959;8529;419;1347;1902;5343;2321;6690
330150;202011;2096;5541;1582;4721;276;868;802;2336;1078;3204
330160;202011;1308;3521;963;2907;168;550;521;1502;689;2052
330170;202011;108020;264809;86089;235061;11391;30674;58373;161377;69764;192051
330180;202011;1925;4602;1470;3961;92;282;1017;2670;1109;2952
330185;202011;9607;23965;7983;21722;472;1584;6418;17024;6890;18608
330187;202011;4273;10739;3311;9164;450;1348;1976;5420;2426;6768
330190;202011;33432;80040;28024;72591;1847;5198;22292;57029;24139;62227
330200;202011;15634;39220;12573;35447;2427;6451;7885;23025;10312;29476
330205;202011;2074;5094;1560;4271;96;322;1092;2864;1188;3186
330210;202011;3504;8630;2520;6910;365;1090;1255;3199;1620;4289
330220;202011;11760;28799;8179;22819;1645;5175;3030;7794;4675;12969
330225;202011;3861;9598;2925;8168;181;615;2155;5860;2336;6475
330227;202011;16840;40303;14009;36877;516;1491;12038;31367;12554;32858
330230;202011;2109;4542;1352;3592;119;345;804;2145;923;2490
330240;202011;22988;59377;18820;52900;2208;6840;12715;34882;14923;41722
330245;202011;1734;4222;1021;2964;197;574;395;1139;592;1713
330250;202011;37862;95799;31017;85660;5197;14777;19171;52712;24368;67489
330260;202011;4777;11433;3586;9809;316;1009;2589;6840;2905;7849
330270;202011;29865;66292;18134;47204;2872;7985;7576;18943;10448;26928
330280;202011;2306;6006;1717;5004;184;575;1013;2860;1197;3435
330285;202011;24199;57164;18945;49614;1374;4267;14134;35721;15508;39988
330290;202011;3847;9225;3080;8220;324;957;2206;5697;2530;6654
330300;202011;5724;13345;4151;11098;313;959;2926;7666;3239;8625
330310;202011;2677;6524;1890;5209;133;312;1258;3486;1391;3798
330320;202011;16485;38380;12479;33389;1441;3697;8955;24258;10396;27955
330330;202011;39862;85913;30558;73356;2637;7028;22080;51788;24717;58816
330340;202011;17049;39714;12080;32059;1724;5299;6496;16030;8220;21329
330350;202011;141418;323251;116103;292278;7178;18770;95863;239755;103041;258525
330360;202011;7327;17719;6250;16396;197;515;5327;13918;5524;14433
330370;202011;4833;13714;3700;11797;877;2864;1531;5095;2408;7959
330380;202011;5209;13708;3919;11449;644;2200;2040;5680;2684;7880
330385;202011;3975;11263;3218;10152;731;2544;1555;4821;2286;7365
330390;202011;26063;69276;19707;58379;2603;8947;11705;32680;14308;41627
330395;202011;3160;7748;2596;7018;151;472;1898;5009;2049;5481
330400;202011;3330;8664;2812;7841;145;515;2124;5594;2269;6109
330410;202011;3283;8681;2303;6954;464;1527;999;2847;1463;4374
330411;202011;2711;7272;2085;6118;137;486;1459;4115;1596;4601
330412;202011;1498;4209;1201;3709;127;460;759;2203;886;2663
330414;202011;23653;59052;19124;52830;1444;4247;14387;39224;15831;43471
330415;202011;4239;11498;3261;9791;331;1060;1945;5779;2276;6839
330420;202011;11490;28143;8045;22524;940;3025;4287;11159;5227;14184
330430;202011;9445;22574;7861;20389;301;998;6230;15680;6531;16678
330440;202011;2474;6565;1854;5528;283;979;1080;3080;1363;4059
330450;202011;1381;3870;1073;3335;144;483;586;1793;730;2276
330452;202011;17188;43099;13716;37780;1609;5073;8992;23842;10601;28915
330455;202011;539479;1269409;414686;1090230;56587;158822;268712;694018;325299;852840
330460;202011;1152;3107;850;2663;140;480;471;1432;611;1912
330470;202011;4730;11703;3353;9583;1119;3304;906;2695;2025;5999
330475;202011;9547;24460;7692;22069;1175;3872;4981;13951;6156;17823
330480;202011;5885;15127;4936;13738;401;1262;3443;9277;3844;10539
330490;202011;109944;250699;88670;221997;9698;25223;63830;158331;73528;183554
330500;202011;7318;17926;6052;16190;604;1818;4387;11546;4991;13364
330510;202011;39496;96281;28902;81306;4450;13500;18034;49914;22484;63414
330513;202011;1203;3081;944;2724;203;628;453;1323;656;1951
330515;202011;2446;6420;1939;5712;362;1163;1087;3113;1449;4276
330520;202011;10969;28678;8850;25368;1111;3545;5543;15480;6654;19025
330530;202011;1695;4050;1233;3359;247;730;561;1512;808;2242
330540;202011;2763;7287;2140;6212;514;1543;928;2622;1442;4165
330550;202011;8813;22371;6660;19547;1793;5785;2859;8259;4652;14044
330555;202011;18128;37758;14950;34022;774;1960;12261;28127;13035;30087
330560;202011;4052;10762;3256;9439;486;1443;1950;5519;2436;6962
330570;202011;2627;7197;2225;6581;339;1093;1475;4311;1814;5404
330575;202011;5294;13627;4519;12306;270;840;3642;9629;3912;10469
330580;202011;17135;45221;13218;38187;2330;7258;6557;18179;8887;25437
330590;202011;1421;3812;1163;3479;214;639;724;2194;938;2833
330600;202011;11848;30759;9597;27157;863;2852;6226;17091;7089;19943
330610;202011;8994;23922;7173;21023;535;1841;5033;14414;5568;16255
330615;202011;2051;5612;1615;5017;306;969;998;3170;1304;4139
330620;202011;3923;11136;3045;9616;670;2297;1317;3912;1987;6209
330630;202011;23805;59123;18629;51086;1252;4095;13422;35578;14674;39673
350010;202011;1961;5003;1026;3049;221;703;197;429;418;1132
350020;202011;689;1752;395;1188;49;155;158;444;207;599
350030;202011;3402;9479;2520;7939;626;2171;1084;3223;1710;5394
350040;202011;702;1994;393;1318;47;186;135;346;182;532
350050;202011;1292;3173;832;2365;179;587;289;674;468;1261
350055;202011;885;2303;687;1989;77;240;403;1105;480;1345
350060;202011;194;494;114;333;14;47;51;149;65;196
350070;202011;3100;8138;1980;6115;397;1383;660;1807;1057;3190
350075;202011;581;1687;424;1378;169;577;49;170;218;747
350080;202011;642;1661;413;1255;58;201;165;449;223;650
350090;202011;581;1356;346;952;66;196;153;389;219;585
350100;202011;2270;5981;1578;4755;120;447;991;2798;1111;3245
350110;202011;472;1182;320;915;16;54;185;519;201;573
350115;202011;1205;3462;982;3003;171;583;508;1410;679;1993
350120;202011;660;1520;364;979;32;110;200;469;232;579
350130;202011;3020;7916;2337;6667;402;1163;1165;3182;1567;4345
350140;202011;760;2138;516;1667;46;199;274;825;320;1024
350150;202011;534;1629;427;1418;98;321;122;371;220;692
350160;202011;10622;26502;7051;19966;878;2803;4280;11502;5158;14305
350170;202011;2247;6355;1800;5370;308;1000;837;2288;1145;3288
350180;202011;1001;2458;523;1556;103;321;123;331;226;652
350190;202011;2753;7750;1865;5856;328;1165;788;2126;1116;3291
350200;202011;443;1242;340;1045;16;54;220;633;236;687
350210;202011;5682;13005;3841;10150;479;1381;2390;6086;2869;7467
350220;202011;2810;7639;1868;5761;394;1285;610;1698;1004;2983
350230;202011;959;2449;782;2203;142;429;443;1214;585;1643
350240;202011;620;1774;388;1235;86;270;95;282;181;552
350250;202011;2447;6867;1814;5812;595;2099;414;1311;1009;3410
350260;202011;809;1903;519;1408;53;165;323;839;376;1004
350270;202011;4424;11817;3499;10058;526;1670;1870;4992;2396;6662
350275;202011;2293;6123;1776;5318;293;964;1039;2972;1332;3936
350280;202011;18013;40600;10653;28547;1768;4978;4324;11079;6092;16057
350290;202011;3110;8573;2065;6372;362;1229;837;2413;1199;3642
350300;202011;611;1639;451;1345;58;175;245;683;303;858
350310;202011;877;2515;638;2038;108;394;252;715;360;1109
350315;202011;579;1438;381;1104;24;86;202;538;226;624
350320;202011;14767;37461;10617;30105;2193;6878;4127;10832;6320;17710
350330;202011;13458;32905;9528;25406;1011;2990;6049;15172;7060;18162
350335;202011;362;1020;280;866;36;126;129;372;165;498
350340;202011;1122;2847;681;2048;116;408;282;754;398;1162
350350;202011;741;1857;566;1664;65;220;343;994;408;1214
350360;202011;1046;3069;789;2533;209;684;243;795;452;1479
350370;202011;604;1499;420;1165;144;375;130;372;274;747
350380;202011;4262;11620;3012;9084;865;2564;783;2429;1648;4993
350390;202011;10449;27353;8163;23426;1606;4807;3935;10875;5541;15682
350395;202011;416;1062;212;668;23;67;81;233;104;300
350400;202011;7775;18926;5339;14937;1306;3952;1494;4130;2800;8082
350410;202011;9644;26609;6935;21349;1391;4786;2756;7843;4147;12629
350420;202011;750;2004;515;1491;78;252;127;318;205;570
350430;202011;642;1705;519;1514;65;225;323;865;388;1090
350440;202011;2027;5047;1635;4455;126;366;1067;2841;1193;3207
350450;202011;6290;17199;4848;14711;1060;3521;2045;5839;3105;9360
350460;202011;1682;4312;868;2655;144;477;242;650;386;1127
350470;202011;242;613;188;521;12;38;132;353;144;391
350480;202011;968;2382;614;1772;124;435;159;358;283;793
350490;202011;1914;4968;1357;4068;316;972;420;1170;736;2142
350500;202011;662;1742;494;1434;63;197;246;672;309;869
350510;202011;1149;2977;853;2441;93;298;511;1396;604;1694
350520;202011;2089;6307;1591;5315;250;929;728;2198;978;3127
350530;202011;2739;6849;2027;5501;222;678;1234;3122;1456;3800
350535;202011;1419;3858;1223;3579;176;560;762;2164;938;2724
350540;202011;1948;4576;1433;3803;168;463;917;2336;1085;2799
350550;202011;8062;19725;5528;15540;585;1979;3249;8463;3834;10442
350560;202011;3832;10698;3038;9286;293;950;1929;5703;2222;6653
350570;202011;23435;64775;18796;55812;3395;11113;9736;27689;13131;38802
350580;202011;2003;5315;1186;3634;318;1061;222;550;540;1611
350590;202011;4937;13222;3617;10286;464;1519;2153;5650;2617;7169
350600;202011;34185;78429;20974;55512;3043;9150;10019;24389;13062;33539
350610;202011;6626;18017;4703;14176;818;2722;2209;6255;3027;8977
350620;202011;403;1022;250;787;27;89;143;436;170;525
350630;202011;1403;3628;1025;2952;67;247;675;1815;742;2062
350635;202011;9106;22273;6784;18634;915;2752;4161;10968;5076;13720
350640;202011;886;2353;464;1437;70;215;139;377;209;592
350650;202011;8239;21825;5602;16632;1080;3466;2142;5920;3222;9386
350660;202011;4377;11418;3349;9723;550;1614;1776;5170;2326;6784
350670;202011;1773;4685;1443;4204;143;426;982;2872;1125;3298
350680;202011;1071;2865;714;2208;132;424;292;851;424;1275
350690;202011;1245;3198;875;2578;152;479;466;1343;618;1822
350700;202011;4690;11826;3322;9688;671;2237;1440;4010;2111;6247
350710;202011;2721;7449;2304;6704;393;1347;1267;3398;1660;4745
350715;202011;778;2207;637;1956;69;267;356;1016;425;1283
350720;202011;150;399;106;324;15;46;30;78;45;124
350730;202011;615;1645;517;1479;30;117;389;1045;419;1162
350740;202011;1640;4338;1123;3291;198;629;386;1035;584;1664
350745;202011;562;1417;315;966;38;143;130;364;168;507
350750;202011;9455;24336;7108;20326;1206;4028;3303;8465;4509;12493
350760;202011;14355;35392;10269;28336;2135;6510;4362;10890;6497;17400
350770;202011;981;2433;608;1770;36;114;400;1133;436;1247
350775;202011;646;1507;437;1193;53;148;210;571;263;719
350780;202011;2234;5372;1572;4424;257;851;564;1813;821;2664
350790;202011;1855;4879;1151;3550;235;802;337;839;572;1641
350800;202011;3445;9864;2937;8956;239;825;2044;6036;2283;6861
350810;202011;2756;6704;2134;5785;320;826;1170;3245;1490;4071
350820;202011;929;2152;528;1440;52;173;260;641;312;814
350830;202011;855;2368;484;1533;73;241;154;413;227;654
350840;202011;3164;9131;2344;7589;524;1886;1063;3179;1587;5065
350850;202011;7149;19644;5551;16791;1047;3453;2707;7785;3754;11238
350860;202011;3534;9406;3022;8718;107;396;2336;6683;2443;7079
350870;202011;2523;7079;1858;5996;256;932;1044;3273;1300;4205
350880;202011;1260;3584;978;3016;260;830;267;796;527;1626
350890;202011;526;1354;327;934;53;161;128;333;181;494
350900;202011;6964;18663;4396;13299;923;3060;1570;4366;2493;7426
350910;202011;873;2127;747;1935;88;229;542;1390;630;1619
350920;202011;11852;28997;10007;26024;398;1277;8247;20655;8645;21932
350925;202011;4073;11031;2880;8878;547;1820;1381;3940;1928;5760
350930;202011;1458;3771;1007;2892;78;230;639;1806;717;2036
350940;202011;2198;5731;1675;4887;167;550;1073;3000;1240;3550
350945;202011;804;2266;597;1855;94;326;307;879;401;1205
350950;202011;85725;218540;65687;181300;8321;25269;40986;108011;49307;133280
350960;202011;6296;16947;4850;14225;566;1910;2928;8132;3494;10042
350970;202011;3432;9503;2420;7593;699;2456;516;1385;1215;3841
350980;202011;618;1683;501;1473;129;397;234;684;363;1081
350990;202011;1704;4734;1255;4002;305;1083;444;1336;749;2419
350995;202011;766;2374;682;2206;50;202;479;1482;529;1684
351000;202011;2801;7262;1935;5714;353;1089;713;2059;1066;3148
351010;202011;335;824;223;632;29;93;115;311;144;404
351015;202011;806;2425;639;2062;107;379;288;830;395;1209
351020;202011;8569;23168;6479;19578;1388;4249;3034;8965;4422;13214
351030;202011;2742;8124;2181;7004;308;1100;1191;3728;1499;4828
351040;202011;4853;12009;4041;10785;203;656;3328;8654;3531;9310
351050;202011;16281;39597;11690;32435;2284;6682;5266;14488;7550;21170
351060;202011;46620;117013;35388;97761;3596;10979;23918;63956;27514;74935
351070;202011;1360;3347;718;2220;173;590;126;380;299;970
351080;202011;2708;6462;1914;5517;197;672;1292;3552;1489;4224
351090;202011;316;918;226;749;48;161;66;215;114;376
351100;202011;2515;6776;1620;4980;364;1182;476;1523;840;2705
351110;202011;5926;14974;3792;11048;626;2019;1668;4566;2294;6585
351120;202011;752;1896;494;1463;61;189;192;559;253;748
351130;202011;1162;2998;519;1627;100;319;138;407;238;726
351140;202011;2098;5877;1532;4796;299;1035;659;1858;958;2893
351150;202011;2552;7269;1697;5370;283;987;675;1910;958;2897
351160;202011;1058;3271;772;2600;161;588;200;566;361;1154
351170;202011;1328;3612;1134;3263;85;268;818;2276;903;2544
351190;202011;991;2729;645;2010;118;370;237;682;355;1052
351200;202011;1550;3677;1134;3058;86;267;804;2031;890;2298
351210;202011;1530;3755;937;2619;82;267;550;1425;632;1692
351220;202011;3229;9029;2742;8215;296;914;1839;5467;2135;6381
351230;202011;1700;4574;1252;3776;214;768;582;1586;796;2354
351240;202011;2334;5905;1416;3977;310;939;517;1303;827;2242
351250;202011;1034;2750;617;1917;87;292;221;674;308;966
351260;202011;883;2226;631;1762;124;356;242;634;366;990
351270;202011;432;1150;347;1001;37;134;209;525;246;659
351280;202011;3637;9511;2759;7853;547;1572;1281;3501;1828;5073
351290;202011;1196;2949;840;2337;115;348;500;1337;615;1685
351300;202011;17716;47633;11978;36529;2104;6970;5244;15281;7348;22251
351310;202011;3366;8148;2533;6858;170;586;1890;4855;2060;5441
351320;202011;933;2678;692;2169;128;424;246;703;374;1127
351330;202011;490;1171;401;1004;23;67;284;641;307;708
351340;202011;6003;17051;4819;14933;1165;3766;2136;6610;3301;10376
351350;202011;11086;27519;9096;24406;931;2666;6669;17414;7600;20080
351360;202011;3677;9780;2999;8761;721;2255;1194;3224;1915;5479
351370;202011;1988;5482;1317;4088;311;1038;419;1197;730;2235
351380;202011;47350;113359;33214;88746;4116;11834;19399;49510;23515;61344
351385;202011;322;854;142;442;27;82;40;115;67;197
351390;202011;1313;3197;804;2436;109;395;477;1349;586;1744
351400;202011;884;2467;726;2137;109;326;462;1327;571;1653
351410;202011;2532;6993;1794;5529;304;980;741;2209;1045;3189
351420;202011;418;976;231;644;27;72;136;349;163;421
351430;202011;918;2468;714;2130;56;168;496;1424;552;1592
351440;202011;3300;8536;2136;6195;395;1208;613;1529;1008;2737
351450;202011;1676;4430;1089;3330;215;710;182;430;397;1140
351460;202011;820;2119;630;1818;145;403;345;1000;490;1403
351470;202011;1176;2974;912;2532;83;288;601;1566;684;1854
351480;202011;2447;7192;1923;6264;363;1306;838;2566;1201;3872
351490;202011;1965;5495;1671;4967;68;277;1359;3901;1427;4178
351492;202011;338;908;275;773;7;21;211;582;218;603
351495;202011;168;434;127;354;17;43;70;195;87;238
351500;202011;36907;90066;27799;74749;3999;11553;17030;43759;21029;55312
351510;202011;12422;30738;8942;24774;1070;3398;5626;14881;6696;18279
351512;202011;472;1271;340;986;60;180;119;313;179;493
351515;202011;3130;6947;1926;5084;344;1024;574;1620;918;2644
351518;202011;2265;5666;1429;4182;189;622;800;2128;989;2750
351519;202011;689;1891;421;1362;85;274;69;206;154;480
351520;202011;1278;3145;531;1600;51;173;228;610;279;783
351530;202011;341;895;199;595;29;90;83;200;112;290
351535;202011;1824;4482;1320;3609;206;618;690;1761;896;2379
351540;202011;2479;6130;1635;4639;281;919;616;1544;897;2463
351550;202011;6971;17146;4639;12918;464;1482;2662;6883;3126;8365
351560;202011;435;1239;335;1040;80;271;104;299;184;570
351565;202011;224;625;179;542;41;144;49;126;90;270
351570;202011;20717;54948;15672;44814;1608;4993;9892;27141;11500;32134
351580;202011;234;599;130;399;10;33;59;190;69;223
351590;202011;515;1178;273;749;21;82;160;397;181;479
351600;202011;1318;3470;999;2867;99;308;600;1618;699;1926
351610;202011;763;1796;479;1300;23;65;282;719;305;784
351620;202011;22182;57852;15847;46942;2553;8600;7354;19738;9907;28338
351630;202011;27729;72264;22134;62593;3069;9237;13932;38052;17001;47289
351640;202011;17291;45139;13455;38179;1305;4245;9133;24791;10438;29036
351650;202011;358;941;168;539;24;79;51;142;75;221
351660;202011;725;2015;455;1411;76;252;74;187;150;439
351670;202011;5710;15230;3667;10823;789;2318;1573;4369;2362;6687
351680;202011;411;1162;255;820;41;132;64;167;105;299
351685;202011;390;1110;308;972;82;264;100;294;182;558
351690;202011;1077;2679;587;1718;81;265;258;674;339;939
351700;202011;1273;3150;922;2555;155;438;509;1329;664;1767
351710;202011;736;1976;522;1566;53;179;284;770;337;949
351720;202011;1336;3436;861;2607;136;435;360;1032;496;1467
351730;202011;922;2424;764;2177;58;207;491;1317;549;1524
351740;202011;3385;8476;2646;7050;466;1350;1336;3280;1802;4630
351750;202011;1271;3278;774;2403;143;465;303;908;446;1373
351760;202011;3203;8986;2333;7237;485;1697;868;2426;1353;4123
351770;202011;1691;4945;1371;4335;251;836;732;2256;983;3092
351780;202011;1165;2931;702;2080;93;316;257;718;350;1034
351790;202011;1306;3109;1024;2728;158;431;620;1661;778;2092
351800;202011;519;1199;249;685;29;85;95;216;124;301
351810;202011;1021;2667;839;2387;49;139;599;1625;648;1764
351820;202011;2535;7092;1745;5540;457;1569;410;1203;867;2772
351830;202011;4415;11760;3387;9965;319;1134;2154;6009;2473;7143
351840;202011;8300;22639;6139;18634;869;2983;3272;9260;4141;12243
351850;202011;1501;4082;982;3061;169;605;344;913;513;1518
351860;202011;2632;7543;2011;6378;334;1165;1081;3467;1415;4632
351870;202011;22992;58123;16897;48066;4135;12180;7077;20396;11212;32576
351880;202011;128580;328262;95549;271480;20959;65967;45620;122918;66579;188885
351885;202011;891;2356;696;2027;55;194;472;1315;527;1509
351890;202011;826;2117;513;1589;108;348;92;243;200;591
351900;202011;1091;2875;833;2492;117;347;483;1435;600;1782
351905;202011;410;1101;285;861;23;78;142;375;165;453
351907;202011;20252;52658;15619;44441;1758;5542;10146;27798;11904;33340
351910;202011;1588;4126;1086;3024;73;221;638;1605;711;1826
351920;202011;834;2201;630;1809;97;324;277;715;374;1039
351925;202011;875;2295;670;1919;83;279;360;946;443;1225
351930;202011;3146;8758;2805;8134;582;1675;1840;5271;2422;6946
351940;202011;1068;2728;758;2185;124;381;376;1068;500;1449
351950;202011;1660;3750;1232;3111;57;168;873;2115;930;2283
351960;202011;4941;12404;3546;9906;774;2335;1627;4226;2401;6561
351970;202011;6928;20325;5413;17659;832;3051;3017;9547;3849;12598
351980;202011;956;2222;603;1654;79;248;355;903;434;1151
351990;202011;1409;3329;1011;2740;53;196;508;1236;561;1432
352000;202011;2569;7272;2201;6505;237;803;1471;4075;1708;4878
352010;202011;2213;5867;1763;5123;465;1482;386;1143;851;2625
352020;202011;1329;3625;1011;3099;148;502;505;1470;653;1972
352030;202011;5641;14789;4318;12586;806;2559;2136;6020;2942;8579
352040;202011;2820;7414;1906;5572;267;888;735;1835;1002;2723
352042;202011;2888;6967;1888;5380;355;1153;849;2314;1204;3467
352044;202011;2012;5271;1140;3611;185;660;228;679;413;1339
352050;202011;12222;32206;7888;23648;1956;6709;1567;3933;3523;10642
352060;202011;657;1771;481;1443;71;232;213;584;284;816
352070;202011;916;1832;586;1395;63;163;291;610;354;773
352080;202011;473;1165;265;749;27;96;98;241;125;337
352090;202011;1446;4228;1185;3701;134;488;585;1648;719;2136
352100;202011;3314;9277;2669;8061;573;1904;1183;3440;1756;5344
352110;202011;581;1657;434;1362;95;311;177;514;272;825
352115;202011;485;1293;395;1155;53;181;235;669;288;850
352120;202011;871;2573;713;2250;80;248;428;1264;508;1512
352130;202011;1978;5478;1320;3895;200;634;544;1477;744;2111
352140;202011;1120;3054;789;2407;138;449;370;1090;508;1539
352150;202011;857;2251;661;1926;73;230;471;1334;544;1564
352160;202011;987;2416;713;1978;77;267;408;1075;485;1342
352170;202011;2944;7804;2315;6570;304;983;1435;3785;1739;4768
352180;202011;2335;6249;1770;5222;400;1340;555;1461;955;2801
352190;202011;1221;3275;955;2861;184;510;465;1463;649;1973
352200;202011;315;947;216;742;33;128;79;257;112;385
352210;202011;19381;45402;15183;39859;922;2734;11913;30655;12835;33389
352215;202011;648;1661;551;1517;72;223;348;923;420;1146
352220;202011;20630;50653;14095;39007;2594;7840;6470;16554;9064;24394
352230;202011;13918;39811;10672;33685;2531;8897;3909;11375;6440;20272
352240;202011;10013;25632;7590;21607;1630;5243;3366;8861;4996;14104
352250;202011;22000;61180;17499;53438;2796;9129;10536;31673;13332;40802
352260;202011;4630;11495;3069;8474;427;1370;1768;4395;2195;5765
352265;202011;901;2479;792;2327;49;166;602;1723;651;1889
352270;202011;1406;4156;1031;3345;214;751;371;1127;585;1878
352280;202011;2426;6060;1826;5189;196;672;1096;2880;1292;3552
352290;202011;1096;3142;878;2719;117;407;480;1347;597;1754
352300;202011;843;2295;566;1707;75;261;304;852;379;1113
352310;202011;42753;113283;31716;93887;7656;23297;13934;41507;21590;64804
352320;202011;6423;16792;4933;13926;734;2362;2674;6820;3408;9182
352330;202011;2132;5647;1614;4923;275;985;889;2542;1164;3527
352340;202011;5758;15095;4214;12265;645;2159;2177;5820;2822;7979
352350;202011;2070;5834;1593;4781;166;615;899;2435;1065;3050
352360;202011;1205;3190;986;2807;78;276;745;2043;823;2319
352370;202011;1059;2973;916;2739;20;80;750;2202;770;2282
352380;202011;812;2189;604;1819;124;374;214;620;338;994
352390;202011;14022;34393;9471;26380;1520;4630;5268;13887;6788;18517
352400;202011;3348;9179;2717;8017;586;2021;1388;3807;1974;5828
352410;202011;3193;8152;2402;6833;203;688;1507;4105;1710;4793
352420;202011;798;1911;562;1569;108;314;215;564;323;878
352430;202011;7872;19444;5597;15468;1139;3566;2652;6898;3791;10464
352440;202011;17455;46868;12920;38159;3147;9578;4837;13944;7984;23522
352450;202011;731;1733;355;1099;52;179;122;361;174;540
352460;202011;2882;7964;1981;6310;397;1387;816;2450;1213;3837
352470;202011;3233;8146;2423;6837;276;897;1502;4004;1778;4901
352480;202011;3850;9082;2552;6746;393;1174;1251;2971;1644;4145
352490;202011;723;2072;576;1811;94;328;287;855;381;1183
352500;202011;9790;25088;6523;18977;2678;8565;684;1115;3362;9680
352510;202011;3667;9865;2705;8186;544;1791;1291;3712;1835;5503
352520;202011;2836;7294;2179;6181;381;1232;1263;3254;1644;4486
352530;202011;10165;26044;6735;19474;1141;3811;2441;6078;3582;9889
352540;202011;571;1668;411;1306;60;214;145;402;205;616
352550;202011;993;2754;681;2145;126;445;242;690;368;1135
352560;202011;557;1539;421;1274;78;252;204;575;282;827
352570;202011;2272;6452;1403;4535;329;1151;141;367;470;1518
352580;202011;639;1657;532;1463;42;140;372;971;414;1111
352585;202011;309;813;222;665;18;70;134;363;152;433
352590;202011;12581;32859;8691;25411;2150;6871;3877;10529;6027;17400
352600;202011;1871;5028;1463;4278;151;484;932;2578;1083;3062
352610;202011;2752;7704;2067;6499;402;1429;870;2575;1272;4004
352620;202011;5462;13893;4136;11981;1174;3462;1634;4786;2808;8248
352630;202011;814;2005;599;1694;112;359;278;723;390;1082
352640;202011;2887;7379;2066;5919;198;596;1197;3290;1395;3886
352650;202011;572;1617;391;1224;56;200;142;427;198;627
352660;202011;1053;3078;872;2712;99;327;521;1579;620;1906
352670;202011;9252;24734;6089;18446;1540;5037;1633;4590;3173;9627
352680;202011;3294;9702;2284;7380;345;1338;1096;3153;1441;4491
352690;202011;26483;66013;20557;55970;1295;4231;14762;38533;16057;42764
352700;202011;558;1389;412;1193;146;485;96;269;242;754
352710;202011;5057;12935;3551;10188;832;2641;1502;3946;2334;6587
352720;202011;7588;20393;5857;17181;2342;7062;1445;3940;3787;11002
352725;202011;572;1363;323;919;22;56;161;440;183;496
352730;202011;5043;14573;4531;13381;522;1692;2106;5457;2628;7149
352740;202011;2233;5285;1672;4452;170;537;1026;2567;1196;3104
352750;202011;415;1028;249;724;41;136;108;273;149;409
352760;202011;1583;4366;1230;3666;96;270;733;2212;829;2482
352770;202011;851;2296;578;1767;120;375;227;667;347;1042
352780;202011;598;1672;432;1349;95;278;117;373;212;651
352790;202011;450;1199;311;920;35;119;121;314;156;433
352800;202011;1237;3764;865;2868;233;797;117;333;350;1130
352810;202011;1142;2672;722;1935;109;316;439;1100;548;1416
352820;202011;459;1302;336;1080;69;215;73;247;142;462
352830;202011;569;1431;256;771;21;65;63;154;84;219
352840;202011;3868;11025;3148;9717;1035;3438;1058;3162;2093;6600
352850;202011;10384;25349;7112;19990;1898;5802;2306;5863;4204;11665
352860;202011;1002;2754;742;2276;140;464;282;827;422;1291
352870;202011;825;2052;581;1559;47;157;370;936;417;1093
352880;202011;1686;3954;1178;3080;197;546;645;1614;842;2160
352885;202011;291;793;214;659;20;69;131;379;151;448
352890;202011;680;1632;434;1117;39;114;268;614;307;728
352900;202011;17414;45225;11416;33353;1867;5842;5106;14012;6973;19854
352910;202011;430;1132;233;713;27;88;68;182;95;270
352920;202011;2571;6519;1862;5313;119;369;1295;3600;1414;3969
352930;202011;5531;14815;4069;11978;719;2346;1949;5326;2668;7672
352940;202011;21046;56469;15131;44192;2993;9594;6741;18515;9734;28109
352950;202011;521;1373;314;991;88;277;62;177;150;454
352960;202011;711;1871;395;1206;70;233;116;305;186;538
352965;202011;221;622;138;453;42;136;34;102;76;238
352970;202011;2833;6762;2163;5659;232;656;1417;3648;1649;4304
352980;202011;1325;3530;1056;3126;249;807;542;1560;791;2367
352990;202011;3981;11167;3102;9704;612;2098;1551;4668;2163;6766
353000;202011;465;1270;253;782;36;118;60;154;96;272
353010;202011;2489;6132;1640;4611;326;1056;706;1789;1032;2845
353020;202011;3469;8924;2054;5987;290;947;713;1928;1003;2875
353030;202011;4310;10760;2916;8341;658;2059;870;2372;1528;4431
353040;202011;637;1437;437;1147;82;207;225;580;307;787
353050;202011;5014;14263;3523;11234;668;2305;1623;4968;2291;7273
353060;202011;46584;118668;38481;105702;2602;8598;29128;77258;31730;85856
353070;202011;8993;25506;6513;20253;1232;4220;2813;8067;4045;12287
353080;202011;3889;10604;2530;7983;464;1672;1019;2839;1483;4511
353090;202011;572;1705;442;1427;32;108;286;897;318;1005
353100;202011;290;781;136;432;26;91;38;97;64;188
353110;202011;7301;19305;5839;17209;1242;3769;2986;9136;4228;12905
353120;202011;373;920;274;761;40;134;130;316;170;450
353130;202011;2355;5441;1461;3958;367;1118;496;1196;863;2314
353140;202011;2651;6546;1904;5285;106;357;1348;3589;1454;3946
353150;202011;1566;3817;1101;3055;217;615;482;1278;699;1893
353160;202011;600;1541;436;1268;72;214;182;480;254;694
353170;202011;510;1356;380;1174;77;259;170;519;247;778
353180;202011;9511;23066;7483;19878;632;1853;5648;14602;6280;16455
353190;202011;3262;8749;2582;7377;322;983;1545;4152;1867;5135
353200;202011;1767;4672;934;2950;150;525;244;696;394;1221
353205;202011;359;1081;309;978;55;190;151;454;206;644
353210;202011;874;2025;559;1514;28;87;381;1009;409;1096
353215;202011;376;1035;294;888;43;143;142;395;185;538
353220;202011;711;1893;453;1356;91;261;74;210;165;471
353230;202011;813;2241;628;1946;181;612;241;687;422;1299
353240;202011;2261;6122;1839;5429;261;885;1099;3138;1360;4023
353250;202011;1264;2837;780;2032;102;307;450;1096;552;1403
353260;202011;1158;2640;627;1779;86;270;301;820;387;1090
353270;202011;661;1710;557;1521;49;153;385;984;434;1137
353280;202011;649;1737;449;1376;124;391;116;345;240;736
353282;202011;1747;4883;1463;4366;171;561;905;2552;1076;3113
353284;202011;343;777;181;477;20;75;83;185;103;260
353286;202011;169;424;103;316;14;46;34;99;48;145
353290;202011;1445;3810;894;2685;151;461;292;805;443;1266
353300;202011;1924;5103;1392;4061;231;772;638;1665;869;2437
353310;202011;381;930;274;731;22;79;184;458;206;537
353320;202011;630;1544;531;1410;7;31;465;1220;472;1251
353325;202011;645;1855;446;1428;96;298;159;492;255;790
353330;202011;521;1326;357;1022;42;125;201;533;243;658
353340;202011;2639;7167;1854;5600;368;1241;871;2435;1239;3676
353350;202011;3439;8718;2362;6595;516;1540;701;1746;1217;3286
353360;202011;638;1778;489;1494;51;160;288;857;339;1017
353370;202011;546;1571;453;1426;36;114;325;992;361;1106
353380;202011;270;811;223;715;19;66;125;372;144;438
353390;202011;6131;15098;4584;12493;453;1404;2772;7134;3225;8538
353400;202011;430;1148;318;934;54;191;126;311;180;502
353410;202011;502;1366;375;1135;68;203;216;664;284;867
353420;202011;380;989;227;659;59;160;17;39;76;199
353430;202011;2137;5881;1639;4958;334;1091;748;2150;1082;3241
353440;202011;62769;168036;45527;134972;7186;23328;25001;70001;32187;93329
353450;202011;359;899;242;696;33;113;122;318;155;431
353460;202011;3124;8444;2233;6756;164;573;1024;2995;1188;3568
353470;202011;7489;19499;5325;15524;859;2909;2398;6373;3257;9282
353475;202011;1471;3815;1020;2894;154;475;517;1363;671;1838
353480;202011;1569;4185;1250;3640;52;194;888;2499;940;2693
353490;202011;1071;2822;715;2134;102;341;328;916;430;1257
353500;202011;1033;2416;761;2006;156;419;426;1111;582;1530
353510;202011;726;2181;527;1696;132;470;136;366;268;836
353520;202011;1025;2675;646;1982;77;264;304;869;381;1133
353530;202011;2346;6180;1823;5232;255;829;971;2577;1226;3406
353540;202011;2021;5405;1642;4801;264;809;969;2760;1233;3569
353550;202011;5601;14363;4532;12630;732;2128;2605;7000;3337;9128
353560;202011;2218;5966;1644;5055;447;1499;478;1322;925;2821
353570;202011;573;1476;421;1233;45;138;254;703;299;841
353580;202011;1992;5251;1495;4277;333;962;705;1976;1038;2938
353590;202011;669;1739;440;1310;88;276;188;556;276;832
353600;202011;1679;4129;1260;3399;154;415;696;1827;850;2242
353610;202011;562;1672;401;1343;83;343;121;367;204;710
353620;202011;2574;6829;1801;5495;355;1213;588;1648;943;2861
353625;202011;487;1200;323;906;22;74;208;566;230;640
353630;202011;1267;3875;1051;3390;231;838;385;1131;616;1969
353640;202011;1349;3481;1076;3055;156;441;592;1667;748;2108
353650;202011;7266;19206;5423;15752;561;1826;3354;9228;3915;11054
353657;202011;383;986;275;800;27;87;136;365;163;452
353660;202011;1257;2651;851;2108;390;967;193;467;583;1434
353670;202011;3903;10764;2992;8975;571;1943;1492;4143;2063;6086
353680;202011;663;1732;488;1482;73;251;278;786;351;1037
353690;202011;393;1017;177;547;21;66;36;98;57;164
353700;202011;1988;5177;1635;4583;111;363;1225;3292;1336;3655
353710;202011;5230;11615;3092;7853;325;863;1766;4017;2091;4880
353715;202011;406;1073;241;762;11;45;82;245;93;290
353720;202011;1952;5112;1507;4448;221;699;856;2484;1077;3183
353730;202011;4249;11002;3196;9161;467;1571;1697;4446;2164;6017
353740;202011;1943;5123;1350;4078;327;1076;456;1235;783;2311
353750;202011;820;2450;575;1959;136;515;109;364;245;879
353760;202011;12227;28308;9238;24260;1805;4872;5057;13042;6862;17914
353770;202011;735;2194;419;1405;73;270;56;163;129;433
353780;202011;5025;13894;3984;11918;826;2765;1979;5493;2805;8258
353790;202011;2576;7709;1851;6172;508;1875;399;1160;907;3035
353800;202011;17666;45860;13678;39390;1941;5922;7761;22266;9702;28188
353810;202011;1118;2974;709;2120;106;356;308;880;414;1236
353820;202011;1683;4499;1165;3455;246;792;381;1061;627;1853
353830;202011;612;1545;450;1266;79;235;202;545;281;780
353850;202011;1585;4380;1205;3645;248;742;453;1330;701;2072
353860;202011;2541;6955;1919;5891;446;1565;878;2453;1324;4018
353870;202011;28516;74292;20082;57835;2565;8332;10715;28145;13280;36477
353880;202011;3064;8394;2411;7152;203;704;1507;4303;1710;5007
353890;202011;2607;5590;1779;4438;122;337;1283;3014;1405;3351
353900;202011;718;2000;515;1592;80;274;210;602;290;876
353910;202011;2300;6315;1894;5675;194;685;1308;3832;1502;4517
353920;202011;1821;5012;1281;3946;298;1041;322;817;620;1858
353930;202011;4151;10908;2782;8382;469;1636;1190;3156;1659;4792
353940;202011;1016;2858;687;2206;118;401;253;753;371;1154
353950;202011;3142;8474;2397;7101;448;1444;1310;3634;1758;5078
353960;202011;695;1800;471;1365;86;261;211;585;297;846
353970;202011;634;1504;474;1265;43;130;326;848;369;978
353980;202011;16118;40321;12515;34039;789;2531;9157;23802;9946;26333
353990;202011;908;2198;538;1515;93;285;247;655;340;940
354000;202011;2368;5678;1317;3701;299;886;234;635;533;1521
354010;202011;343;894;240;725;48;157;127;366;175;523
354020;202011;3378;9190;2631;7645;594;1862;1113;2952;1707;4814
354025;202011;705;1960;466;1479;70;249;128;385;198;634
354030;202011;501;1102;273;720;65;184;131;321;196;505
354040;202011;784;1824;502;1356;22;74;375;980;397;1054
354050;202011;902;2545;621;2037;141;485;198;650;339;1135
354060;202011;3143;8882;2167;6823;477;1627;829;2394;1306;4021
354070;202011;3458;9052;2298;6794;400;1382;1019;2587;1419;3969
354075;202011;2566;7361;1998;6325;261;934;1147;3546;1408;4480
354080;202011;1330;3596;861;2674;178;573;235;673;413;1246
354085;202011;421;872;326;745;0;0;251;528;251;528
354090;202011;1620;4489;1383;3996;78;233;1081;3067;1159;3300
354100;202011;18737;50372;12721;39916;2781;9459;4881;15194;7662;24653
354105;202011;1412;3562;962;2737;124;356;450;1208;574;1564
354110;202011;440;1242;309;987;53;172;106;327;159;499
354120;202011;1306;3511;868;2569;179;581;306;796;485;1377
354130;202011;5185;13596;3393;10169;835;2660;199;394;1034;3054
354140;202011;18523;45250;12435;34042;2096;6373;5471;13773;7567;20146
354150;202011;2851;6748;2147;5624;478;1295;859;2222;1337;3517
354160;202011;2708;7843;1987;6411;565;1967;549;1599;1114;3566
354165;202011;656;1953;492;1617;81;310;256;782;337;1092
354170;202011;1774;4923;1488;4377;88;297;951;2672;1039;2969
354180;202011;372;1032;266;798;48;152;110;297;158;449
354190;202011;1432;3989;1002;3114;74;262;478;1405;552;1667
354200;202011;850;2062;657;1771;65;196;435;1107;500;1303
354210;202011;788;2065;624;1784;36;123;463;1251;499;1374
354220;202011;3049;8141;2276;6601;354;1100;1212;3331;1566;4431
354230;202011;741;1810;587;1628;43;145;435;1166;478;1311
354240;202011;1622;4463;1074;3356;183;617;338;931;521;1548
354250;202011;520;1243;318;927;88;261;77;239;165;500
354260;202011;7879;20834;5939;17418;1202;3788;2557;7188;3759;10976
354270;202011;979;2929;788;2553;173;549;313;991;486;1540
354280;202011;780;1954;660;1782;58;194;426;1057;484;1251
354290;202011;898;2834;754;2535;123;412;385;1326;508;1738
354300;202011;3471;10153;2928;9144;777;2415;1197;3723;1974;6138
354310;202011;711;2081;575;1798;130;433;225;658;355;1091
354320;202011;980;2370;635;1781;103;323;242;594;345;917
354323;202011;439;1053;292;788;37;83;134;355;171;438
354325;202011;1452;4337;992;3250;164;528;337;1061;501;1589
354330;202011;9206;23187;6149;16971;731;2312;3656;9405;4387;11717
354340;202011;31546;78686;21090;60409;3210;10398;11211;30601;14421;40999
354350;202011;1156;2956;915;2553;99;295;612;1643;711;1938
354360;202011;592;1518;346;1111;66;216;77;246;143;462
354370;202011;971;2767;772;2445;124;424;453;1399;577;1823
354380;202011;685;1797;488;1473;89;359;122;279;211;638
354390;202011;13160;31563;8531;23444;1555;4577;3789;9860;5344;14437
354400;202011;1493;4766;1128;3905;194;738;424;1446;618;2184
354410;202011;5731;15360;4308;12507;884;2771;1974;5429;2858;8200
354420;202011;1440;3731;1051;3025;143;447;642;1768;785;2215
354425;202011;2610;6305;1835;4970;428;1158;804;2174;1232;3332
354430;202011;1463;3895;1131;3363;110;377;691;1936;801;2313
354440;202011;542;1447;355;1060;57;192;157;432;214;624
354450;202011;409;1065;223;707;34;108;72;203;106;311
354460;202011;827;2077;543;1572;70;222;299;843;369;1065
354470;202011;453;1148;298;845;21;68;153;383;174;451
354480;202011;1178;2662;759;1994;66;170;518;1312;584;1482
354490;202011;803;2364;581;1868;90;299;273;815;363;1114
354500;202011;2065;5738;1666;5125;508;1639;398;1258;906;2897
354510;202011;691;1917;550;1639;54;175;296;802;350;977
354515;202011;329;936;237;746;37;138;103;312;140;450
354520;202011;6736;18263;4694;13889;650;2228;2648;7270;3298;9498
354530;202011;4132;11720;3142;9758;754;2387;1200;3780;1954;6167
354540;202011;1297;3415;932;2767;217;678;347;1022;564;1700
354550;202011;542;1399;423;1173;63;198;245;648;308;846
354560;202011;2255;5418;1195;3359;149;431;598;1573;747;2004
354570;202011;1187;2959;475;1350;81;239;59;159;140;398
354580;202011;8155;21224;5214;15629;772;2527;2665;7660;3437;10187
354600;202011;1826;4823;1409;4042;143;486;942;2550;1085;3036
354610;202011;432;1101;242;714;24;70;117;327;141;397
354620;202011;440;1220;268;879;52;198;102;297;154;495
354625;202011;287;757;156;498;30;100;23;45;53;145
354630;202011;1998;5927;1593;5080;555;1868;294;858;849;2726
354640;202011;3141;8944;2281;7212;391;1353;868;2550;1259;3903
354650;202011;869;2252;692;1959;56;160;436;1212;492;1372
354660;202011;3545;8263;1814;5344;160;575;857;2313;1017;2888
354670;202011;1029;2860;687;2158;146;488;253;727;399;1215
354680;202011;5150;13356;3825;11186;871;2661;1882;5626;2753;8287
354690;202011;472;1493;337;1194;73;268;90;312;163;580
354700;202011;875;2361;625;1863;77;251;317;886;394;1137
354710;202011;466;1242;330;973;40;131;133;329;173;460
354720;202011;268;640;117;348;40;131;27;81;67;212
354730;202011;9298;26158;7003;21675;983;3352;4001;11897;4984;15249
354740;202011;305;820;127;421;18;74;23;66;41;140
354750;202011;2540;6475;1634;4778;262;840;748;1956;1010;2796
354760;202011;2063;5465;1407;4217;343;1124;465;1218;808;2342
354765;202011;335;880;133;421;21;69;31;82;52;151
354770;202011;2298;5670;1687;4621;314;936;800;2061;1114;2997
354780;202011;52226;132024;39262;106494;4065;12447;25117;63947;29182;76394
354790;202011;951;2613;731;2238;70;242;450;1317;520;1559
354800;202011;2498;6373;1941;5519;478;1367;875;2350;1353;3717
354805;202011;1289;2940;872;2331;95;261;522;1302;617;1563
354810;202011;621;1833;357;1261;45;187;87;288;132;475
354820;202011;924;2614;648;2077;118;423;187;475;305;898
354830;202011;451;1100;287;805;48;139;100;270;148;409
354840;202011;911;2245;549;1523;51;151;315;816;366;967
354850;202011;20480;52831;14074;41313;1583;5380;8490;23617;10073;28997
354860;202011;1707;4763;1024;3301;170;616;305;886;475;1502
354870;202011;56076;141285;42991;117032;4499;13511;27280;70252;31779;83763
354880;202011;5637;13721;2718;7560;313;1005;1108;2519;1421;3524
354890;202011;15609;38873;11970;32731;1598;4948;7171;18973;8769;23921
354900;202011;381;952;232;687;45;145;64;164;109;309
354910;202011;5390;14042;3204;10053;760;2526;559;1676;1319;4202
354920;202011;496;1353;253;850;30;108;55;169;85;277
354925;202011;296;835;177;561;20;70;48;133;68;203
354930;202011;353;848;225;628;17;55;114;290;131;345
354940;202011;2287;6792;1600;5245;560;1955;305;925;865;2880
354950;202011;1471;3788;1169;3369;59;241;876;2381;935;2622
354960;202011;908;2430;684;2088;53;191;403;1161;456;1352
354970;202011;4080;11232;3169;9692;329;1137;2090;6183;2419;7320
354980;202011;32133;75544;21433;57152;2231;7122;13340;33147;15571;40269
354990;202011;64604;162484;48342;132497;3866;12355;32145;82984;36011;95339
354995;202011;2796;6253;2091;5322;137;415;1570;3831;1707;4246
355000;202011;1518;3759;1131;3197;183;601;555;1441;738;2042
355010;202011;3668;9902;2171;6725;724;2309;250;814;974;3123
355020;202011;3572;9946;2607;8234;538;1866;1026;3071;1564;4937
355030;202011;1317157;3219541;942991;2496173;141008;410597;482733;1177567;623741;1588164
355040;202011;2870;7039;2203;6162;291;811;1562;4378;1853;5189
355050;202011;960;2239;690;1844;168;513;271;654;439;1167
355060;202011;5901;15843;4235;12734;698;2438;2077;5679;2775;8117
355070;202011;8624;22121;6924;19396;804;2583;4473;11819;5277;14402
355080;202011;891;2532;553;1887;106;394;79;217;185;611
355090;202011;1113;3183;838;2705;211;681;272;890;483;1571
355100;202011;21193;55204;16250;47813;2582;8031;9786;28574;12368;36605
355110;202011;786;2159;556;1799;164;611;96;279;260;890
355120;202011;678;1751;478;1456;38;135;214;608;252;743
355130;202011;822;1831;409;1081;24;81;254;627;278;708
355140;202011;1914;4321;1600;3886;95;263;1315;3100;1410;3363
355150;202011;4030;10626;3187;9135;357;1148;2068;5678;2425;6826
355160;202011;1944;5277;1381;4264;354;1200;343;1006;697;2206
355170;202011;10200;25552;7861;21588;1411;4218;4270;11345;5681;15563
355180;202011;2815;7492;1972;6068;400;1347;723;2043;1123;3390
355190;202011;1791;4731;1392;4091;336;962;745;2314;1081;3276
355200;202011;781;2419;654;2211;177;660;273;880;450;1540
355210;202011;2821;7674;2174;6331;410;1353;1112;3027;1522;4380
355220;202011;42462;112421;33264;94652;7570;22855;14118;37316;21688;60171
355230;202011;1111;2789;600;1774;104;292;217;599;321;891
355240;202011;23953;63063;16567;48133;2177;6908;9114;24910;11291;31818
355250;202011;35987;95864;26425;77172;6618;20417;10160;28368;16778;48785
355255;202011;659;1646;346;1067;55;193;134;399;189;592
355260;202011;1434;3493;1028;2811;131;442;593;1483;724;1925
355270;202011;1122;3318;850;2751;196;652;299;900;495;1552
355280;202011;30193;76672;21184;59619;2856;8747;10770;28399;13626;37146
355290;202011;843;2290;640;1929;130;383;277;809;407;1192
355300;202011;1229;3610;945;3023;171;612;332;989;503;1601
355310;202011;929;2569;691;2166;93;281;387;1228;480;1509
355320;202011;507;1335;375;1095;74;248;151;358;225;606
355330;202011;2828;7066;2151;5938;126;453;1647;4324;1773;4777
355340;202011;4050;8926;3088;7633;388;875;1908;4814;2296;5689
355350;202011;1261;3601;928;2955;193;637;356;1115;549;1752
355360;202011;1151;2931;874;2521;116;369;527;1486;643;1855
355365;202011;336;893;175;599;38;121;27;96;65;217
355370;202011;5175;13257;3958;11304;963;2567;1728;5431;2691;7998
355380;202011;2807;7477;2081;6114;361;1164;774;1973;1135;3137
355385;202011;1417;3720;1159;3329;105;370;741;1944;846;2314
355390;202011;818;2218;584;1703;135;421;231;614;366;1035
355395;202011;1931;5283;1314;4014;225;728;474;1290;699;2018
355400;202011;8714;24777;6827;21034;1658;5837;2490;6861;4148;12698
355410;202011;21474;58586;13065;41246;2682;9317;3527;10874;6209;20191
355420;202011;598;1908;489;1696;140;527;123;414;263;941
355430;202011;3662;9238;2731;7553;607;1678;1304;3548;1911;5226
355440;202011;758;2056;453;1413;77;252;134;391;211;643
355450;202011;2891;7388;1855;5354;326;1017;789;2078;1115;3095
355460;202011;486;1175;299;865;43;156;136;349;179;505
355465;202011;406;1062;314;910;44;141;170;475;214;616
355470;202011;1027;2636;579;1739;155;521;186;492;341;1013
355475;202011;337;801;266;698;16;35;198;511;214;546
355480;202011;3790;10433;3073;9370;399;1398;2055;6122;2454;7520
355490;202011;915;2440;506;1568;39;133;272;780;311;913
355495;202011;782;2197;560;1793;70;269;203;574;273;843
355500;202011;6372;16413;3715;11175;581;1948;1285;3567;1866;5515
355510;202011;1296;3151;806;2302;111;372;351;897;462;1269
355520;202011;351;773;160;466;27;73;49;138;76;211
355530;202011;392;912;138;409;19;64;48;128;67;192
355535;202011;491;1332;367;1128;74;281;169;467;243;748
355540;202011;10490;26069;8524;23277;1238;3690;5640;14901;6878;18591
355550;202011;580;1706;471;1503;63;230;256;756;319;986
355560;202011;1084;2736;588;1805;127;458;30;88;157;546
355570;202011;238;673;126;415;24;81;31;97;55;178
355580;202011;1165;2832;740;2113;138;434;296;788;434;1222
355590;202011;170;425;131;361;20;61;80;211;100;272
355600;202011;1462;3554;965;2725;164;499;375;1048;539;1547
355610;202011;1703;4188;1118;3167;127;397;603;1621;730;2018
355620;202011;4549;12032;3351;9700;369;1298;1915;5121;2284;6419
355630;202011;2245;6170;1567;4875;251;821;781;2385;1032;3206
355635;202011;840;2463;605;1995;108;393;177;522;285;915
355640;202011;2884;8022;1895;6013;367;1254;579;1781;946;3035
355645;202011;4092;11468;2965;9485;438;1548;1596;4960;2034;6508
355650;202011;6107;16490;4679;13836;1281;3909;1437;3844;2718;7753
355660;202011;1278;3308;887;2593;126;402;311;905;437;1307
355670;202011;3499;9351;2276;6595;280;962;1146;2900;1426;3862
355680;202011;2630;7189;1139;3698;301;1025;117;411;418;1436
355690;202011;778;2285;491;1694;119;447;17;40;136;487
355695;202011;239;673;142;457;12;62;28;62;40;124
355700;202011;7068;20098;5693;17037;941;3025;3105;8751;4046;11776
355710;202011;8581;20207;5550;14676;826;2453;2645;6245;3471;8698
355715;202011;451;1205;235;722;51;168;49;131;100;299
355720;202011;1428;3971;1124;3439;186;615;613;1748;799;2363
355730;202011;868;2389;704;2077;118;384;338;917;456;1301
410010;202011;1229;3423;926;2773;190;618;205;591;395;1209
410020;202011;1009;3043;773;2498;277;844;170;580;447;1424
410030;202011;1502;4118;1284;3783;175;557;709;2114;884;2671
410040;202011;11990;33039;8665;26719;1911;6283;2774;7950;4685;14233
410045;202011;851;2256;597;1768;86;287;219;599;305;886
410050;202011;2208;5510;1511;4274;286;889;513;1364;799;2253
410060;202011;2033;5714;1557;4754;354;1148;482;1426;836;2574
410070;202011;1923;4860;1421;3941;233;712;567;1438;800;2150
410080;202011;1321;3529;943;2821;230;722;269;817;499;1539
410090;202011;1078;2771;911;2499;95;249;541;1558;636;1807
410100;202011;1688;4876;1092;3428;167;593;148;446;315;1039
410105;202011;474;1190;265;781;31;93;96;267;127;360
410110;202011;3166;7942;2199;6096;272;825;1038;2666;1310;3491
410115;202011;562;1457;408;1182;57;180;163;450;220;630
410120;202011;2527;7105;2182;6569;481;1596;1128;3281;1609;4877
410130;202011;1211;3244;1050;2941;186;608;559;1448;745;2056
410140;202011;15487;37421;9966;27463;1853;5636;2675;6698;4528;12334
410150;202011;16068;37535;7990;21767;1358;4131;1965;4819;3323;8950
410160;202011;2736;7571;2180;6600;502;1648;744;2283;1246;3931
410165;202011;727;1933;596;1666;55;188;356;928;411;1116
410170;202011;2716;7051;1802;5081;409;1269;117;349;526;1618
410180;202011;13699;37895;10416;31214;1414;4648;5527;15495;6941;20143
410185;202011;409;1199;292;893;56;181;90;252;146;433
410190;202011;2128;5273;1513;4173;316;889;416;1102;732;1991
410200;202011;5287;12124;2902;8020;454;1435;433;1154;887;2589
410210;202011;3022;7543;1858;5426;290;962;647;1626;937;2588
410220;202011;506;1313;327;975;59;185;79;232;138;417
410230;202011;1661;4379;1262;3590;180;566;633;1679;813;2245
410240;202011;4962;13039;3382;9971;796;2601;343;916;1139;3517
410250;202011;2639;6247;1948;5133;154;507;944;2409;1098;2916
410260;202011;1721;4326;1060;3059;176;525;473;1349;649;1874
410270;202011;444;1181;316;953;47;164;115;332;162;496
410275;202011;604;1717;443;1396;67;228;188;551;255;779
410280;202011;2242;5976;1457;4373;215;717;583;1622;798;2339
410290;202011;3284;9188;2217;6882;608;1854;576;1783;1184;3637
410300;202011;622;1583;494;1378;41;127;257;676;298;803
410302;202011;350;874;197;588;24;80;98;282;122;362
410304;202011;1225;3156;1014;2769;113;314;618;1640;731;1954
410305;202011;1700;4045;1174;3286;123;395;747;2003;870;2398
410310;202011;2459;6930;1954;5953;304;1013;973;2925;1277;3938
410315;202011;603;1445;357;1047;126;371;85;264;211;635
410320;202011;1057;2938;710;2219;113;398;125;363;238;761
410322;202011;549;1428;309;898;31;105;162;430;193;535
410330;202011;1477;3596;1020;2743;173;506;294;776;467;1282
410335;202011;842;2249;642;1871;95;297;282;764;377;1061
410337;202011;835;2026;586;1541;61;165;246;614;307;779
410340;202011;498;1413;332;996;23;76;165;418;188;494
410345;202011;2393;6191;1229;3636;252;781;330;846;582;1627
410347;202011;728;1844;529;1466;50;161;175;495;225;656
410350;202011;1458;3622;1022;2872;149;446;428;1139;577;1585
410360;202011;4257;10407;3277;8692;421;1213;1695;4330;2116;5543
410370;202011;13098;34911;8455;24000;988;3075;3642;9159;4630;12234
410380;202011;1570;3937;1152;3185;160;447;388;989;548;1436
410390;202011;2576;6511;1677;4872;382;1237;528;1390;910;2627
410395;202011;903;2573;735;2217;150;477;289;875;439;1352
410400;202011;6345;16527;4706;13341;659;2003;2407;6425;3066;8428
410405;202011;870;2057;615;1674;105;326;281;718;386;1044
410410;202011;1251;3337;1167;3204;165;534;729;2067;894;2601
410420;202011;10263;27966;7773;23004;1210;4037;3239;8611;4449;12648
410425;202011;3121;8697;2101;6578;348;1183;772;2186;1120;3369
410430;202011;12708;31765;8839;24631;1365;4170;3216;8350;4581;12520
410440;202011;2215;6633;1887;6012;274;991;1012;3171;1286;4162
410442;202011;2142;6514;1749;5663;454;1492;476;1449;930;2941
410445;202011;2207;6382;1600;5192;309;1165;329;1123;638;2288
410450;202011;1390;3433;1012;2823;193;603;382;995;575;1598
410460;202011;2041;5025;1544;4222;161;449;771;2031;932;2480
410465;202011;2623;7564;2055;6486;378;1254;731;2154;1109;3408
410470;202011;1923;5313;1346;4246;347;1258;213;728;560;1986
410480;202011;35336;83872;18637;54012;2989;9692;4168;10406;7157;20098
410490;202011;10679;29646;7672;23402;1402;4634;3125;8922;4527;13556
410500;202011;1836;4741;1285;3697;266;875;391;1000;657;1875
410510;202011;1747;4361;1149;3236;227;628;326;912;553;1540
410520;202011;2967;9346;2626;8658;911;3075;896;3045;1807;6120
410530;202011;1591;3869;753;2133;96;276;196;450;292;726
410540;202011;2728;7307;1878;5584;286;940;860;2445;1146;3385
410550;202011;7162;19060;4685;13606;774;2453;1326;3326;2100;5779
410560;202011;1425;3751;1047;2961;229;715;366;920;595;1635
410570;202011;2412;6594;1740;5386;475;1751;199;643;674;2394
410580;202011;24466;63244;17475;50377;3294;10213;7529;20335;10823;30548
410590;202011;1535;4353;1013;3107;147;470;288;745;435;1215
410600;202011;1743;4637;1345;3870;299;829;436;1314;735;2143
410610;202011;690;1801;517;1478;57;193;231;615;288;808
410620;202011;2390;6883;1606;5032;348;1204;241;701;589;1905
410630;202011;2372;6212;1545;4535;287;964;324;812;611;1776
410640;202011;4580;10628;3064;8000;661;2024;386;1017;1047;3041
410645;202011;1046;2951;847;2690;264;869;365;1179;629;2048
410650;202011;2238;6041;1526;4584;311;999;530;1473;841;2472
410655;202011;898;2132;631;1664;25;78;328;821;353;899
410657;202011;610;1640;376;1131;51;178;132;338;183;516
410660;202011;3259;8323;1849;5236;336;984;520;1360;856;2344
410670;202011;1017;2523;615;1749;119;348;225;578;344;926
410680;202011;2567;7720;1782;5712;430;1411;301;992;731;2403
410685;202011;499;1274;370;1052;85;283;148;371;233;654
410690;202011;126747;307113;83310;226603;12885;40214;32950;79098;45835;119312
410700;202011;2451;6160;2020;5487;313;866;1016;2693;1329;3559
410710;202011;858;2151;560;1586;98;287;219;567;317;854
410712;202011;626;1774;511;1554;126;427;200;574;326;1001
410715;202011;760;2197;470;1555;65;227;171;534;236;761
410720;202011;3025;7680;2378;6434;330;1048;526;1405;856;2453
410725;202011;1068;2642;601;1759;115;369;84;207;199;576
410730;202011;663;1754;507;1470;118;392;101;289;219;681
410740;202011;925;2586;669;2083;90;309;266;814;356;1123
410750;202011;1692;4263;1342;3616;187;573;626;1605;813;2178
410752;202011;359;890;185;545;29;84;86;244;115;328
410753;202011;297;912;202;692;38;149;38;113;76;262
410754;202011;1040;2686;864;2425;54;115;596;1771;650;1886
410755;202011;537;1396;376;1076;55;173;166;421;221;594
410760;202011;3585;9173;2562;7320;664;2186;573;1492;1237;3678
410765;202011;13150;36503;10140;30516;1734;5661;2299;6149;4033;11810
410770;202011;1044;2473;736;1955;67;187;378;1016;445;1203
410773;202011;1236;3298;1080;3062;105;340;688;1885;793;2225
410775;202011;1461;3626;1273;3349;62;193;855;2193;917;2386
410780;202011;622;1537;411;1132;65;190;109;273;174;463
410785;202011;683;1798;523;1527;90;290;186;563;276;853
410790;202011;764;2148;614;1853;158;517;61;137;219;654
410800;202011;3348;7402;2719;6502;52;162;1782;4143;1834;4305
410810;202011;415;1103;324;924;21;64;173;445;194;509
410820;202011;858;2396;440;1347;92;295;83;215;175;510
410830;202011;36526;88278;25072;69062;4808;15312;9574;24557;14382;39869
410832;202011;1011;2630;807;2264;88;275;485;1282;573;1557
410840;202011;8256;20874;4831;14256;913;2936;1250;3463;2163;6399
410845;202011;1130;2797;879;2426;173;497;363;987;536;1484
410850;202011;2177;6270;1896;5744;301;993;944;2774;1245;3767
410855;202011;763;1904;497;1394;48;128;237;621;285;749
410860;202011;4149;10161;3242;8697;320;1001;1862;4707;2182;5708
410865;202011;1388;4037;1192;3650;141;475;700;2178;841;2653
410870;202011;1214;3289;1001;2925;82;262;673;1953;755;2215
410880;202011;4481;11946;3137;9465;533;1672;467;1522;1000;3194
410890;202011;943;2675;695;2181;155;539;174;532;329;1071
410895;202011;968;3068;821;2743;245;910;188;587;433;1497
410900;202011;822;2181;570;1680;97;308;116;278;213;586
410910;202011;389;931;230;625;14;50;131;317;145;367
410920;202011;833;1993;591;1592;75;225;300;780;375;1005
410930;202011;1613;4123;1106;3235;260;892;218;615;478;1507
410940;202011;21704;59008;15534;47814;3178;10856;4875;14674;8053;25530
410950;202011;1867;5472;1663;5156;50;190;1379;4225;1429;4415
410960;202011;7278;18091;4983;14205;1148;3619;1935;5468;3083;9087
410965;202011;1083;2748;750;2120;79;245;429;1192;508;1437
410970;202011;3864;10317;2705;8076;613;2180;368;916;981;3096
410975;202011;1309;3243;996;2743;109;328;494;1344;603;1672
410980;202011;7378;18343;4700;13468;522;1650;2052;5352;2574;7002
410990;202011;1338;3268;911;2592;214;716;315;864;529;1580
411000;202011;625;1639;412;1233;57;198;126;318;183;516
411005;202011;449;1148;272;773;48;154;84;206;132;360
411007;202011;2183;6096;1768;5383;421;1362;632;1911;1053;3273
411010;202011;4049;12110;3163;10286;802;2854;343;1008;1145;3862
411020;202011;2262;6379;1818;5574;521;1648;496;1479;1017;3127
411030;202011;756;1853;540;1416;35;127;308;706;343;833
411040;202011;959;2381;499;1376;69;220;166;387;235;607
411050;202011;1874;5835;1513;5029;391;1411;224;652;615;2063
411060;202011;1893;5006;1192;3535;263;909;202;540;465;1449
411065;202011;381;979;258;742;35;102;116;313;151;415
411070;202011;7116;18084;5585;15493;746;2311;2764;7411;3510;9722
411080;202011;2041;5364;1610;4619;416;1372;318;885;734;2257
411090;202011;807;2131;530;1586;47;169;154;438;201;607
411095;202011;2745;6331;1409;3823;166;468;358;874;524;1342
411100;202011;1179;3023;816;2377;85;284;273;811;358;1095
411110;202011;595;1545;272;851;37;119;16;36;53;155
411120;202011;1252;3453;1034;3033;309;1053;221;590;530;1643
411125;202011;5004;14557;4481;13625;988;2949;2165;6949;3153;9898
411130;202011;705;1873;498;1486;102;270;176;576;278;846
411140;202011;2216;6846;1889;6152;561;1964;491;1573;1052;3537
411150;202011;3699;9363;2465;6892;499;1637;248;505;747;2142
411155;202011;943;2404;550;1654;80;223;228;653;308;876
411160;202011;351;813;239;651;29;85;58;159;87;244
411170;202011;705;2085;551;1736;138;434;184;568;322;1002
411180;202011;5318;14052;4110;11909;592;1917;2017;5461;2609;7378
411190;202011;1651;4225;1220;3448;208;627;480;1226;688;1853
411200;202011;4693;12725;3293;10074;821;2805;659;1727;1480;4532
411210;202011;3140;6970;2058;5199;348;983;702;1670;1050;2653
411220;202011;851;2185;587;1663;141;444;161;427;302;871
411230;202011;825;2187;590;1737;118;378;222;633;340;1011
411240;202011;1543;3696;1028;2761;107;336;505;1246;612;1582
411250;202011;2171;5754;1573;4663;307;1053;491;1403;798;2456
411260;202011;317;831;211;614;25;75;86;223;111;298
411270;202011;2002;5325;1475;4260;204;626;744;1964;948;2590
411275;202011;1403;3220;972;2516;139;436;451;1070;590;1506
411280;202011;1247;3377;830;2566;218;694;121;351;339;1045
411290;202011;804;2117;514;1540;50;140;272;833;322;973
411295;202011;1226;3075;863;2354;101;298;378;960;479;1258
411300;202011;994;2478;631;1766;60;180;300;722;360;902
411310;202011;860;1975;651;1678;54;139;282;722;336;861
411320;202011;5336;13712;3863;11040;621;1905;1685;4333;2306;6238
411325;202011;1317;3796;1121;3458;182;552;644;2060;826;2612
411330;202011;3257;8792;2338;7099;508;1666;738;2275;1246;3941
411340;202011;822;2239;486;1490;73;238;153;446;226;684
411342;202011;1027;2473;592;1622;98;295;223;569;321;864
411345;202011;1044;2689;782;2251;54;171;566;1640;620;1811
411350;202011;2625;7076;1670;5115;428;1406;262;748;690;2154
411360;202011;692;1663;482;1325;68;190;156;418;224;608
411370;202011;56342;137266;40492;110334;2869;9457;24612;62583;27481;72040
411373;202011;1346;3415;1093;3033;96;321;595;1662;691;1983
411375;202011;1078;2711;785;2156;128;365;308;816;436;1181
411380;202011;1131;2586;760;1902;38;109;482;1117;520;1226
411390;202011;1444;3996;1137;3319;186;600;478;1236;664;1836
411400;202011;2231;5505;1662;4432;160;508;863;2176;1023;2684
411410;202011;2512;6893;1827;5414;391;1265;434;1216;825;2481
411420;202011;4202;10234;2231;6420;309;1023;433;949;742;1972
411430;202011;3333;9025;2518;7469;526;1697;895;2460;1421;4157
411435;202011;400;1115;245;784;50;158;74;194;124;352
411440;202011;2423;6761;1965;5900;401;1293;700;2052;1101;3345
411450;202011;2384;6447;1800;5467;235;716;969;3007;1204;3723
411460;202011;4071;10447;2555;7567;418;1474;476;1256;894;2730
411470;202011;749;1910;552;1528;103;305;211;523;314;828
411480;202011;4769;12586;3479;10175;676;2380;1302;3379;1978;5759
411490;202011;1600;4136;1216;3490;160;537;511;1312;671;1849
411500;202011;1256;3366;838;2471;152;477;158;383;310;860
411510;202011;2267;5775;1813;4993;387;1239;440;1220;827;2459
411520;202011;29250;70804;16700;46528;1936;6335;6533;16371;8469;22706
411530;202011;911;2390;537;1650;81;280;93;260;174;540
411535;202011;485;1394;297;945;34;118;87;228;121;346
411540;202011;2584;6302;1760;4802;153;487;906;2392;1059;2879
411545;202011;889;2561;746;2311;74;231;483;1501;557;1732
411550;202011;700;1757;501;1383;76;225;85;256;161;481
411560;202011;1906;5159;1073;3341;156;544;70;200;226;744
411570;202011;7158;16516;4760;12856;1070;3156;858;2337;1928;5493
411573;202011;739;2005;629;1830;100;296;316;907;416;1203
411575;202011;1975;5379;1462;4307;272;879;354;1015;626;1894
411580;202011;4663;10640;2782;7754;408;1396;501;1275;909;2671
411585;202011;590;1781;269;885;64;231;49;144;113;375
411590;202011;371;1018;264;799;40;119;130;368;170;487
411600;202011;293;751;185;581;39;123;55;163;94;286
411605;202011;1514;3482;964;2617;135;466;500;1319;635;1785
411610;202011;2475;5831;1743;4561;70;232;1175;2863;1245;3095
411620;202011;2682;7172;2285;6543;385;1168;1246;3564;1631;4732
411630;202011;735;1920;489;1447;75;273;184;489;259;762
411640;202011;450;1162;312;865;40;125;112;277;152;402
411650;202011;200;584;127;419;24;85;30;75;54;160
411660;202011;907;2319;661;1862;53;152;280;746;333;898
411670;202011;1318;3181;891;2365;99;280;434;1074;533;1354
411680;202011;1375;3698;1014;2980;134;451;452;1278;586;1729
411690;202011;3758;9512;2822;7895;620;1769;803;2390;1423;4159
411695;202011;606;1849;406;1326;46;167;174;526;220;693
411700;202011;1653;4268;1095;3191;227;704;186;511;413;1215
411705;202011;1861;5718;1569;5219;283;908;936;3313;1219;4221
411710;202011;1906;4813;1302;3697;292;849;263;733;555;1582
411720;202011;1016;2324;731;1849;152;396;273;662;425;1058
411721;202011;956;2392;716;1952;138;363;208;564;346;927
411722;202011;827;2140;472;1351;79;262;185;436;264;698
411725;202011;1144;3187;782;2479;190;652;171;536;361;1188
411727;202011;1460;4037;932;2888;212;678;156;441;368;1119
411729;202011;672;1630;419;1156;51;188;159;385;210;573
411730;202011;5118;13586;3978;11350;796;2443;1739;4864;2535;7307
411740;202011;508;1317;260;782;53;145;59;159;112;304
411745;202011;747;2128;505;1572;73;247;90;217;163;464
411750;202011;5278;13862;3835;11030;523;1612;1891;5137;2414;6749
411760;202011;6323;16907;4832;14300;1581;4882;938;3120;2519;8002
411770;202011;2948;8514;2124;6680;502;1690;337;971;839;2661
411780;202011;2610;7369;2250;6691;631;1957;767;2315;1398;4272
411790;202011;2660;6408;1451;4241;291;999;269;684;560;1683
411800;202011;968;2734;723;2181;128;403;149;428;277;831
411810;202011;1554;4003;1148;3173;188;530;541;1405;729;1935
411820;202011;10569;30319;8518;26712;2052;6948;3704;11311;5756;18259
411830;202011;553;1385;422;1168;80;241;96;280;176;521
411840;202011;11688;30998;7857;23056;1333;4219;2144;5760;3477;9979
411845;202011;540;1542;306;979;40;155;69;186;109;341
411850;202011;6973;17754;4688;13722;1158;3858;761;2030;1919;5888
411860;202011;662;1841;474;1443;75;236;120;333;195;569
411870;202011;567;1663;389;1252;91;325;95;272;186;597
411880;202011;2211;5515;1611;4538;221;708;573;1541;794;2249
411885;202011;1050;2715;744;2159;111;381;230;607;341;988
411890;202011;1327;3515;932;2777;151;511;101;294;252;805
411900;202011;749;2060;472;1471;111;374;81;227;192;601
411910;202011;929;2737;674;2189;158;595;262;780;420;1375
411915;202011;14340;35251;9647;26640;1384;4304;4029;9959;5413;14263
411920;202011;1076;3151;896;2757;194;696;329;931;523;1627
411925;202011;457;1206;324;963;69;229;128;362;197;591
411930;202011;4804;14612;4031;13164;1763;6253;271;1070;2034;7323
411940;202011;3193;9403;2446;7754;601;1984;775;2220;1376;4204
411950;202011;13694;36789;11222;32678;1494;4942;6697;18684;8191;23626
411960;202011;5748;15430;4519;12905;836;2626;1744;4731;2580;7357
411965;202011;457;1260;325;993;46;154;145;414;191;568
411970;202011;1082;2487;835;2159;165;405;366;1075;531;1480
411980;202011;1419;3521;1013;2842;251;703;380;1053;631;1756
411990;202011;36569;95377;23059;70397;4223;14231;8066;23537;12289;37768
411995;202011;3329;8118;2502;6845;739;2250;675;1778;1414;4028
412000;202011;1814;4217;1281;3298;31;100;909;2194;940;2294
412010;202011;578;1801;427;1471;72;267;124;365;196;632
412015;202011;529;1489;432;1315;61;199;261;788;322;987
412020;202011;425;1176;265;830;44;161;103;289;147;450
412030;202011;586;1648;427;1350;74;240;127;388;201;628
412033;202011;919;2421;655;1879;80;238;251;630;331;868
412035;202011;745;2026;470;1505;49;189;263;805;312;994
412040;202011;578;1546;353;1077;56;160;59;176;115;336
412050;202011;1587;3957;1078;3007;224;704;260;721;484;1425
412060;202011;7095;20615;5888;18185;1535;5360;1687;5008;3222;10368
412065;202011;593;1634;440;1331;100;323;104;313;204;636
412070;202011;1155;2980;908;2500;113;340;374;949;487;1289
412080;202011;2103;5879;1409;4453;210;701;352;999;562;1700
412085;202011;290;696;103;317;9;30;22;55;31;85
412090;202011;5580;14587;4116;11813;1056;3194;1482;4292;2538;7486
412100;202011;1561;4261;1181;3536;359;1178;250;824;609;2002
412110;202011;801;2113;544;1582;78;233;176;481;254;714
412120;202011;1916;5512;1459;4607;289;1013;400;1088;689;2101
412125;202011;613;1745;427;1360;84;276;115;351;199;627
412130;202011;803;2036;549;1555;91;272;143;413;234;685
412135;202011;617;1646;280;849;46;149;92;245;138;394
412140;202011;1603;3867;1052;2910;185;637;215;558;400;1195
412150;202011;2687;7019;2287;6320;330;1058;1413;3671;1743;4729
412160;202011;876;2712;489;1649;84;305;79;237;163;542
412170;202011;4214;11508;3524;10399;708;2314;1459;3965;2167;6279
412175;202011;1270;3617;1062;3261;214;673;479;1471;693;2144
412180;202011;1582;4358;1149;3538;139;491;530;1514;669;2005
412190;202011;3285;8236;2428;6734;322;979;1058;2911;1380;3890
412200;202011;1625;4817;1161;3747;307;1099;192;579;499;1678
412210;202011;609;1443;373;1035;49;152;146;363;195;515
412215;202011;3216;8755;2515;7370;613;1745;1078;3487;1691;5232
412217;202011;961;2486;812;2222;55;165;558;1476;613;1641
412220;202011;5458;15222;4418;13300;1286;3746;1400;4567;2686;8313
412230;202011;2605;7622;2043;6514;334;1208;543;1494;877;2702
412240;202011;7053;18064;4401;12780;751;2345;1325;3480;2076;5825
412250;202011;1974;5081;1462;4095;347;1024;320;827;667;1851
412260;202011;1180;3172;858;2471;141;422;263;712;404;1134
412265;202011;874;2378;686;2052;150;468;278;794;428;1262
412270;202011;964;2628;612;1888;81;277;236;653;317;930
412280;202011;375;1055;292;915;63;207;90;261;153;468
412290;202011;999;2549;686;1979;108;337;223;593;331;930
412300;202011;1618;4182;1111;3279;241;753;253;771;494;1524
412310;202011;734;2049;585;1750;97;339;210;581;307;920
412320;202011;807;2071;519;1479;50;168;162;461;212;629
412330;202011;1548;4136;1048;3173;201;673;346;1075;547;1748
412340;202011;1079;2975;674;2093;99;368;121;336;220;704
412350;202011;2745;7092;1730;5090;340;1071;306;829;646;1900
412360;202011;252;693;179;533;5;26;109;301;114;327
412370;202011;835;2396;563;1809;116;415;53;184;169;599
412380;202011;1464;3976;1025;3088;269;834;128;447;397;1281
412382;202011;475;1173;311;908;40;151;139;338;179;489
412385;202011;2140;5840;1744;5068;561;1532;549;1793;1110;3325
412390;202011;2410;5771;1932;5032;314;817;715;1876;1029;2693
412395;202011;635;1823;446;1391;53;144;194;622;247;766
412400;202011;897;2373;635;1872;120;388;175;507;295;895
412402;202011;2023;4968;1383;3901;339;992;174;507;513;1499
412405;202011;2925;7724;1895;5775;488;1756;90;246;578;2002
412410;202011;5872;15143;4330;12613;759;2577;1470;4034;2229;6611
412420;202011;521;1319;344;966;24;82;172;424;196;506
412430;202011;573;1437;298;861;34;114;120;323;154;437
412440;202011;2613;7113;1713;5338;417;1424;264;874;681;2298
412450;202011;445;1273;296;898;46;134;27;64;73;198
412460;202011;1005;2611;777;2222;139;436;358;1006;497;1442
412470;202011;1472;4703;1198;4071;298;1063;265;903;563;1966
412480;202011;996;2632;671;1924;118;361;214;540;332;901
412490;202011;1272;3153;1018;2678;120;315;509;1264;629;1579
412500;202011;1877;4725;1410;3850;308;850;385;977;693;1827
412510;202011;1810;5522;1245;4075;284;997;132;359;416;1356
412520;202011;1121;2938;617;1838;145;415;59;191;204;606
412530;202011;699;1838;510;1449;78;243;107;305;185;548
412535;202011;767;1970;506;1462;87;273;111;268;198;541
412540;202011;1164;2949;834;2344;94;330;277;816;371;1146
412545;202011;659;1685;459;1282;69;195;168;459;237;654
412550;202011;31582;84073;22181;65022;3616;11583;9089;24276;12705;35859
412555;202011;284;736;190;534;19;55;58;130;77;185
412560;202011;4350;12682;3210;10009;557;1905;966;3027;1523;4932
412570;202011;4316;10827;2468;7259;511;1693;310;990;821;2683
412575;202011;1011;2539;804;2179;103;310;433;1093;536;1403
412580;202011;1386;3615;978;2826;84;294;527;1460;611;1754
412590;202011;398;1040;222;684;34;110;22;58;56;168
412600;202011;1584;4270;1191;3469;169;563;553;1493;722;2056
412610;202011;784;2055;548;1541;55;161;279;699;334;860
412620;202011;1252;3279;949;2809;192;651;272;750;464;1401
412625;202011;8369;21895;4967;15059;698;2394;326;902;1024;3296
412627;202011;1128;3167;725;2323;132;460;199;638;331;1098
412630;202011;2759;8088;1966;6356;381;1254;579;1718;960;2972
412635;202011;378;1038;258;768;35;127;92;224;127;351
412640;202011;1030;2699;576;1740;73;226;181;498;254;724
412650;202011;1633;4434;1297;3742;213;682;516;1306;729;1988
412660;202011;2343;5998;1632;4624;268;810;490;1252;758;2062
412665;202011;379;967;301;827;47;137;154;409;201;546
412667;202011;1721;4545;1275;3673;179;559;525;1443;704;2002
412670;202011;825;1930;536;1462;101;312;162;408;263;720
412680;202011;1945;5163;1342;3992;176;606;494;1305;670;1911
412690;202011;1090;2879;784;2274;130;408;304;828;434;1236
412700;202011;1907;5054;1579;4538;189;637;868;2423;1057;3060
412710;202011;5743;16653;4269;13437;827;2952;1235;3434;2062;6386
412720;202011;1111;3280;845;2684;140;477;173;468;313;945
412730;202011;2348;6229;1634;4785;315;1033;578;1589;893;2622
412740;202011;1820;5042;1230;3821;213;777;177;533;390;1310
412750;202011;3759;9868;3065;8867;287;1012;2037;5547;2324;6559
412760;202011;2828;7666;2342;6840;430;1413;1236;3382;1666;4795
412770;202011;9783;24670;5134;15418;709;2268;1238;3192;1947;5460
412780;202011;1135;3031;851;2499;189;603;329;940;518;1543
412785;202011;1996;4812;1399;3796;135;380;939;2484;1074;2864
412788;202011;1298;3638;1060;3220;288;878;449;1340;737;2218
412790;202011;1302;3431;733;2252;112;396;225;605;337;1001
412795;202011;1209;3109;639;1947;93;313;128;350;221;663
412796;202011;2096;6014;1719;5289;360;1167;574;1638;934;2805
412800;202011;3561;8621;2442;6561;278;869;1142;2717;1420;3586
412810;202011;11348;28708;7246;20384;865;2850;2876;7197;3741;10047
412820;202011;6013;16496;4215;12821;1027;3302;1237;3774;2264;7076
412830;202011;328;925;232;716;34;100;59;173;93;273
412840;202011;1811;4498;1282;3456;139;423;578;1420;717;1843
412850;202011;2720;7125;1958;5773;320;1010;831;2416;1151;3426
412853;202011;1435;3628;1194;3200;179;527;608;1452;787;1979
412855;202011;1175;3088;765;2238;124;424;221;608;345;1032
412860;202011;728;1792;493;1420;69;220;273;745;342;965
412862;202011;675;1654;456;1284;83;239;194;512;277;751
412863;202011;1233;3697;1095;3442;227;746;581;1804;808;2550
412865;202011;690;1888;503;1500;143;434;129;407;272;841
412870;202011;811;2096;582;1712;161;531;124;398;285;929
412880;202011;824;2202;540;1617;91;321;97;257;188;578
420005;202011;384;1127;234;796;33;111;109;379;142;490
420010;202011;3172;7764;2107;5965;127;399;1554;4421;1681;4820
420020;202011;386;1218;249;862;42;172;59;167;101;339
420030;202011;61;198;43;163;12;53;17;55;29;108
420040;202011;485;1463;289;1018;61;240;18;47;79;287
420050;202011;700;1597;466;1181;67;201;298;681;365;882
420055;202011;152;460;81;288;15;70;23;69;38;139
420060;202011;91;242;48;139;8;25;12;28;20;53
420070;202011;644;1946;482;1613;101;353;195;630;296;983
420075;202011;77;192;42;121;5;17;16;30;21;47
420080;202011;335;961;261;795;69;236;107;319;176;555
420090;202011;394;1223;246;863;55;205;42;118;97;323
420100;202011;1204;3154;1003;2845;48;166;816;2280;864;2446
420110;202011;226;724;205;680;40;160;104;317;144;477
420120;202011;542;1457;356;1047;65;220;170;422;235;642
420125;202011;323;998;222;771;56;199;88;299;144;498
420127;202011;265;710;96;308;14;51;26;78;40;129
420130;202011;3118;8606;2351;7292;339;1267;1149;3259;1488;4526
420140;202011;3313;8921;2327;7187;665;2324;323;1021;988;3345
420150;202011;655;1646;451;1295;39;128;278;774;317;902
420160;202011;190;461;69;224;8;28;21;66;29;94
420165;202011;148;417;82;266;20;68;26;75;46;143
420170;202011;269;846;178;611;24;82;57;163;81;245
420180;202011;160;513;99;352;13;48;31;95;44;143
420190;202011;189;592;114;398;35;134;31;101;66;235
420195;202011;1285;3280;924;2698;285;989;97;196;382;1185
420200;202011;4217;10123;2477;6868;327;1115;1028;2470;1355;3585
420205;202011;1646;4395;1101;3319;156;501;614;1843;770;2344
420207;202011;1614;4234;985;3035;188;664;411;1182;599;1846
420208;202011;302;863;175;620;54;211;45;149;99;360
420209;202011;146;477;92;304;17;58;34;103;51;161
420210;202011;2939;7518;1966;5923;324;1109;988;2885;1312;3994
420213;202011;738;2267;623;2038;141;500;317;1020;458;1520
420215;202011;182;548;128;428;32;118;27;85;59;203
420220;202011;242;698;143;483;24;98;67;203;91;301
420230;202011;4818;13016;3619;10740;544;1760;1947;5549;2491;7309
420240;202011;12800;35187;8063;24354;1015;3495;4013;10630;5028;14125
420243;202011;348;996;274;849;43;156;168;495;211;651
420245;202011;1147;2980;818;2421;56;198;521;1478;577;1676
420250;202011;411;1147;338;1022;51;175;198;557;249;732
420253;202011;458;1133;323;938;32;108;187;536;219;644
420257;202011;151;395;94;293;17;65;48;147;65;212
420260;202011;1027;2698;747;2306;121;436;481;1447;602;1883
420270;202011;489;1275;240;701;31;103;113;320;144;423
420280;202011;1075;3241;826;2708;147;544;301;952;448;1496
420285;202011;119;243;50;143;11;45;11;23;22;68
420287;202011;425;975;305;812;85;232;112;300;197;532
420290;202011;4409;12479;3355;10087;448;1562;1998;5546;2446;7108
420300;202011;6744;18989;3902;12280;715;2495;1232;3384;1947;5879
420310;202011;745;1701;369;1017;32;104;215;550;247;654
420315;202011;726;2034;497;1630;100;348;202;660;302;1008
420320;202011;4828;13012;3405;10598;949;3269;888;2558;1837;5827
420325;202011;293;818;202;630;29;91;98;284;127;375
420330;202011;939;2704;586;1954;104;413;179;526;283;939
420340;202011;883;2452;659;2045;154;502;106;292;260;794
420350;202011;1091;2900;802;2380;67;232;569;1655;636;1887
420360;202011;2681;7319;1422;4559;275;966;120;386;395;1352
420370;202011;1034;2788;845;2482;78;264;586;1663;664;1927
420380;202011;4041;10640;2681;8173;566;1847;1030;3001;1596;4848
420390;202011;1022;2458;699;1799;122;376;290;510;412;886
420395;202011;1019;2873;685;2208;106;408;97;224;203;632
420400;202011;931;2624;638;2000;110;404;255;742;365;1146
420410;202011;529;1433;405;1173;39;117;277;788;316;905
420415;202011;268;786;203;645;53;192;77;241;130;433
420417;202011;554;1650;448;1428;124;407;163;540;287;947
420419;202011;129;458;98;382;37;151;7;30;44;181
420420;202011;10443;26909;6836;20315;1898;6444;1927;5201;3825;11645
420425;202011;587;1571;388;1164;36;126;195;570;231;696
420430;202011;2944;7907;1710;5192;403;1244;561;1601;964;2845
420435;202011;236;609;114;371;14;47;57;177;71;224
420440;202011;686;1863;418;1285;109;373;157;452;266;825
420445;202011;244;590;154;424;31;86;75;193;106;279
420450;202011;667;1961;482;1552;90;346;177;499;267;845
420455;202011;1908;4674;1367;3849;185;605;666;1752;851;2357
420460;202011;8565;22805;6313;18594;900;2983;3292;9306;4192;12289
420470;202011;559;1456;298;941;52;192;62;169;114;361
420475;202011;64;166;21;69;6;21;2;7;8;28
420480;202011;5025;12414;3040;9099;627;2067;1043;3113;1670;5180
420490;202011;336;934;239;739;51;176;95;284;146;460
420500;202011;1318;3653;834;2730;148;532;365;1192;513;1724
420510;202011;147;409;78;244;9;36;23;65;32;101
420515;202011;59;155;33;97;3;18;15;36;18;54
420517;202011;732;2024;624;1815;52;157;447;1301;499;1458
420519;202011;274;673;199;563;22;70;120;352;142;422
420520;202011;268;728;138;467;26;91;9;32;35;123
420530;202011;758;2237;520;1719;79;311;210;597;289;908
420535;202011;233;688;95;328;13;51;45;149;58;200
420540;202011;33831;80248;21477;59505;3127;9900;7719;18411;10846;28311
420543;202011;189;565;149;479;14;49;85;257;99;306
420545;202011;1074;3181;799;2572;143;521;317;891;460;1412
420550;202011;3197;8519;2018;6506;320;1214;838;2747;1158;3961
420555;202011;268;771;183;591;22;86;111;335;133;421
420560;202011;366;911;240;720;47;154;141;417;188;571
420570;202011;2120;5778;1662;4918;284;970;760;2140;1044;3110
420580;202011;1727;4413;1238;3665;280;892;422;1292;702;2184
420590;202011;2552;6764;1462;4382;269;968;415;954;684;1922
420600;202011;944;2726;716;2296;94;357;415;1266;509;1623
420610;202011;308;895;177;592;41;146;63;223;104;369
420620;202011;700;1699;462;1313;99;296;189;538;288;834
420630;202011;874;2623;627;2018;76;270;378;1151;454;1421
420640;202011;462;1249;219;747;69;229;24;82;93;311
420650;202011;3377;8819;2027;6006;284;918;811;2080;1095;2998
420660;202011;403;1041;262;742;50;149;71;179;121;328
420665;202011;571;1479;363;1119;66;234;159;432;225;666
420670;202011;1183;3276;752;2378;129;498;289;796;418;1294
420675;202011;165;466;95;322;16;74;46;136;62;210
420680;202011;304;711;154;501;29;103;78;244;107;347
420690;202011;807;2379;485;1613;66;272;135;376;201;648
420700;202011;2340;6121;1734;5102;215;692;1007;2874;1222;3566
420710;202011;872;2505;659;2041;64;257;408;1155;472;1412
420720;202011;1106;3094;794;2538;142;493;407;1228;549;1721
420730;202011;2847;7384;2088;6114;331;1073;1134;3204;1465;4277
420740;202011;463;1369;263;931;72;286;22;93;94;379
420750;202011;1798;5205;1148;3687;202;759;482;1416;684;2175
420757;202011;75;182;36;115;3;5;17;53;20;58
420760;202011;295;863;149;462;32;112;43;116;75;228
420765;202011;413;1205;178;618;25;101;75;248;100;349
420768;202011;1288;3620;1112;3323;143;428;816;2421;959;2849
420770;202011;442;1189;216;732;39;152;88;274;127;426
420775;202011;247;742;167;556;36;132;53;149;89;281
420780;202011;869;2418;522;1637;108;375;96;261;204;636
420785;202011;190;493;132;369;14;48;66;151;80;199
420790;202011;961;2901;707;2386;118;468;388;1231;506;1699
420800;202011;608;1533;291;887;80;277;76;218;156;495
420810;202011;1328;4122;1069;3605;303;1174;376;1087;679;2261
420820;202011;11357;28152;8070;22768;1506;4770;3786;9843;5292;14613
420830;202011;3789;9920;2792;8082;497;1554;1230;3462;1727;5016
420840;202011;445;1299;209;756;59;234;24;72;83;306
420845;202011;2283;5810;1383;4171;255;941;567;1622;822;2563
420850;202011;997;3217;611;2194;121;472;118;367;239;839
420860;202011;295;740;162;508;28;99;49;132;77;231
420870;202011;723;2014;536;1665;145;519;227;643;372;1162
420880;202011;965;2956;742;2485;153;602;292;900;445;1502
420890;202011;7709;20855;4722;14640;692;2391;1697;4633;2389;7024
420895;202011;165;479;105;324;29;86;31;100;60;186
420900;202011;1445;3559;859;2526;118;423;408;1043;526;1466
420910;202011;27808;72959;17080;52078;2560;8895;6921;18773;9481;27668
420915;202011;484;1749;353;1369;53;199;195;777;248;976
420917;202011;322;778;174;482;29;85;88;242;117;327
420920;202011;70;195;29;106;1;2;5;20;6;22
420930;202011;15060;39416;10541;31388;1925;6395;4666;13224;6591;19619
420940;202011;2795;6826;1607;4759;392;1326;321;786;713;2112
420945;202011;128;367;101;308;24;83;40;113;64;196
420950;202011;322;934;176;581;27;109;45;136;72;245
420960;202011;954;2335;691;1889;118;380;309;743;427;1123
420970;202011;2223;6088;1562;4864;449;1455;444;1366;893;2821
420980;202011;258;852;222;777;107;383;61;224;168;607
420985;202011;276;800;136;489;33;133;44;140;77;273
420990;202011;275;861;155;555;26;96;34;114;60;210
421000;202011;513;1538;364;1205;77;277;98;292;175;569
421003;202011;455;1075;149;436;8;23;22;52;30;75
421005;202011;51;134;36;112;8;24;17;57;25;81
421010;202011;3047;8352;2189;6758;452;1579;630;1705;1082;3284
421020;202011;344;1073;269;939;43;179;139;460;182;639
421030;202011;681;2054;523;1727;167;621;172;515;339;1136
421040;202011;600;1425;374;1078;23;81;239;675;262;756
421050;202011;936;2503;603;1760;126;408;237;601;363;1009
421055;202011;168;457;92;279;15;50;57;154;72;204
421060;202011;602;1742;426;1357;74;284;212;603;286;887
421070;202011;608;1822;360;1189;69;260;118;359;187;619
421080;202011;479;1376;399;1225;40;144;245;748;285;892
421085;202011;343;984;118;423;16;51;12;35;28;86
421090;202011;251;654;136;395;9;35;43;113;52;148
421100;202011;735;1637;315;941;90;315;91;222;181;537
421105;202011;1451;3965;983;3016;174;554;453;1326;627;1880
421110;202011;1031;2677;847;2442;16;48;629;1921;645;1969
421120;202011;943;2846;698;2292;110;387;220;645;330;1032
421125;202011;285;746;205;599;74;239;73;181;147;420
421130;202011;4544;13227;3728;11624;851;3058;1921;5579;2772;8637
421140;202011;331;893;192;587;34;108;63;174;97;282
421145;202011;426;1175;276;852;68;221;97;273;165;494
421150;202011;573;1550;368;1141;61;223;196;570;257;793
421160;202011;478;1301;344;1042;49;167;223;641;272;808
421165;202011;205;601;127;420;25;85;57;181;82;266
421170;202011;938;2566;797;2334;133;377;487;1470;620;1847
421175;202011;942;2356;570;1777;114;395;248;747;362;1142
421180;202011;358;932;197;603;35;138;89;237;124;375
421185;202011;309;826;208;616;24;80;125;367;149;447
421187;202011;259;787;164;543;28;93;55;171;83;264
421189;202011;312;914;245;785;41;142;97;290;138;432
421190;202011;10401;28110;7014;21583;1291;4275;2646;7544;3937;11819
421200;202011;605;1748;498;1553;58;205;320;965;378;1170
421205;202011;177;467;129;388;24;93;60;156;84;249
421210;202011;996;2534;572;1808;122;399;220;702;342;1101
421220;202011;1265;3768;965;3133;219;792;306;899;525;1691
421223;202011;290;808;178;598;41;134;86;291;127;425
421225;202011;772;2270;643;2048;108;394;395;1230;503;1624
421227;202011;550;1604;359;1187;70;251;160;542;230;793
421230;202011;539;1393;341;1022;55;198;141;418;196;616
421240;202011;266;785;124;440;11;44;21;67;32;111
421250;202011;1877;4762;1336;3883;137;468;821;2285;958;2753
421260;202011;163;479;48;178;15;67;9;28;24;95
421265;202011;601;1599;534;1504;9;30;477;1328;486;1358
421270;202011;325;854;131;462;19;63;48;162;67;225
421280;202011;1714;4587;1284;3867;173;662;743;2102;916;2764
421290;202011;917;2448;470;1419;87;276;112;313;199;589
421300;202011;264;688;131;421;12;48;22;63;34;111
421310;202011;167;468;112;359;24;80;59;191;83;271
421315;202011;199;537;125;379;42;116;24;85;66;201
421320;202011;595;1870;315;1059;33;94;39;95;72;189
421330;202011;556;1654;398;1323;79;303;113;354;192;657
421335;202011;324;988;267;891;67;252;109;350;176;602
421340;202011;1291;3553;916;2846;169;612;401;1131;570;1743
421350;202011;1361;3514;904;2711;173;584;378;1063;551;1647
421360;202011;2151;5793;1243;3892;217;805;486;1332;703;2137
421370;202011;635;2068;378;1366;70;257;118;376;188;633
421380;202011;770;2040;656;1860;86;276;391;1065;477;1341
421390;202011;154;424;53;193;13;40;18;63;31;103
421400;202011;298;944;214;749;36;142;109;364;145;506
421410;202011;179;504;84;299;21;82;25;76;46;158
421415;202011;162;479;96;300;19;64;20;53;39;117
421420;202011;528;1432;430;1251;46;155;274;772;320;927
421430;202011;91;277;67;215;7;27;17;48;24;75
421440;202011;554;1499;333;1097;65;206;146;473;211;679
421450;202011;415;1228;235;816;30;125;40;141;70;266
421460;202011;350;1035;187;679;22;87;34;101;56;188
421470;202011;238;674;140;465;31;105;50;179;81;284
421480;202011;2549;6808;1659;5011;339;1213;661;1790;1000;3003
421490;202011;116;400;66;255;7;29;17;48;24;77
421500;202011;1950;5723;1346;4476;349;1371;332;962;681;2333
421505;202011;262;743;217;679;33;123;141;424;174;547
421507;202011;394;1108;207;695;46;172;76;235;122;407
421510;202011;291;821;178;543;26;86;98;272;124;358
421520;202011;471;1234;308;872;26;80;186;478;212;558
421530;202011;265;773;157;530;28;123;46;124;74;247
421535;202011;353;933;220;699;34;130;121;369;155;499
421540;202011;268;629;132;401;17;55;46;122;63;177
421545;202011;604;1786;454;1516;100;402;225;692;325;1094
421550;202011;1918;5107;1540;4539;289;879;893;2620;1182;3499
421555;202011;158;477;69;243;8;34;9;20;17;54
421560;202011;84;276;56;209;10;38;19;66;29;104
421565;202011;846;2187;549;1721;145;501;148;461;293;962
421567;202011;400;1269;256;871;85;309;71;218;156;527
421568;202011;314;935;233;747;32;113;107;339;139;452
421569;202011;145;411;68;218;13;46;35;109;48;155
421570;202011;1070;2853;750;2256;166;568;219;604;385;1172
421575;202011;266;766;192;575;27;89;86;228;113;317
421580;202011;3835;10433;2452;7532;370;1338;973;2544;1343;3882
421590;202011;130;408;103;343;30;108;35;107;65;215
421600;202011;539;1459;366;1095;72;252;117;294;189;546
421605;202011;695;1801;494;1473;85;223;270;857;355;1080
421610;202011;973;2663;653;2041;115;394;213;640;328;1034
421620;202011;3540;9323;2065;6607;428;1578;609;1849;1037;3427
421625;202011;119;335;53;170;13;44;12;38;25;82
421630;202011;2274;5917;1440;4293;250;909;531;1298;781;2207
421635;202011;238;646;173;508;15;49;111;305;126;354
421640;202011;650;1738;462;1451;93;335;208;636;301;971
421650;202011;2235;6109;1478;4694;344;1279;479;1305;823;2584
421660;202011;9416;26022;6516;20423;994;3476;2919;8372;3913;11848
421670;202011;707;2022;495;1515;86;294;242;715;328;1009
421680;202011;969;2622;723;2181;188;616;368;1017;556;1633
421690;202011;1213;3453;807;2590;156;565;292;922;448;1487
421700;202011;468;1375;312;1030;61;225;102;318;163;543
421710;202011;183;583;86;292;17;62;21;64;38;126
421715;202011;103;280;79;227;17;47;46;132;63;179
421720;202011;1769;4805;1040;3237;277;923;275;753;552;1676
421725;202011;236;565;120;362;19;61;55;136;74;197
421730;202011;361;1020;190;563;27;87;99;276;126;363
421740;202011;681;1925;464;1448;106;349;140;396;246;745
421750;202011;804;1896;368;1083;87;276;132;355;219;631
421755;202011;145;407;86;264;15;59;45;122;60;181
421760;202011;897;2334;601;1797;99;339;237;591;336;930
421770;202011;2173;5802;1567;4733;402;1209;567;1840;969;3049
421775;202011;193;496;118;353;14;45;57;159;71;204
421780;202011;753;2199;476;1617;100;386;206;645;306;1031
421790;202011;818;2228;479;1587;108;366;225;727;333;1093
421795;202011;166;460;121;351;23;79;45;118;68;197
421800;202011;2316;6254;1660;5024;201;715;988;2839;1189;3554
421810;202011;571;1561;390;1224;45;170;232;710;277;880
421820;202011;852;2478;488;1571;101;377;160;409;261;786
421825;202011;1253;3542;1110;3322;120;382;785;2301;905;2683
421830;202011;1864;5514;1508;4838;312;1070;643;2015;955;3085
421835;202011;193;474;118;353;26;87;30;80;56;167
421840;202011;186;598;123;451;27;105;33;113;60;218
421850;202011;341;959;187;639;40;157;54;141;94;298
421860;202011;283;786;155;523;25;98;54;159;79;257
421870;202011;3950;9895;2875;7911;452;1488;1500;3676;1952;5164
421875;202011;269;785;114;354;18;63;36;91;54;154
421880;202011;560;1587;364;1143;82;306;93;277;175;583
421885;202011;192;555;119;386;28;90;29;84;57;174
421890;202011;781;2366;579;1955;107;434;312;979;419;1413
421895;202011;381;971;323;895;38;113;219;633;257;746
421900;202011;974;2568;716;2026;90;293;346;894;436;1187
421910;202011;278;804;185;587;29;119;55;142;84;261
421915;202011;353;986;194;613;43;135;37;110;80;245
421917;202011;535;1252;302;952;106;361;74;245;180;606
421920;202011;336;1026;237;827;93;340;64;220;157;560
421930;202011;2368;5962;1224;3784;275;972;425;1149;700;2121
421935;202011;372;1169;296;1004;58;207;167;551;225;758
421940;202011;340;991;163;527;24;84;45;130;69;214
421950;202011;2734;6843;1553;4614;308;997;405;1078;713;2075
421960;202011;169;440;87;282;18;77;18;47;36;124
421970;202011;1742;4484;1069;3102;209;719;418;1032;627;1751
421985;202011;268;717;156;490;13;44;66;195;79;239
422000;202011;1836;4725;1488;4176;147;499;1030;2838;1177;3337
430003;202011;549;1490;359;1144;65;220;156;500;221;720
430005;202011;249;649;156;483;32;105;73;215;105;320
430010;202011;1603;3870;1268;3357;127;377;914;2341;1041;2718
430020;202011;568;1293;422;1095;44;139;280;700;324;839
430030;202011;933;2213;505;1437;120;391;166;436;286;827
430040;202011;9925;23524;5833;16332;1553;4665;721;2162;2274;6827
430045;202011;465;1169;326;909;28;90;222;607;250;697
430047;202011;229;500;90;249;26;77;27;73;53;150
430050;202011;840;2129;485;1410;106;323;122;332;228;655
430055;202011;244;614;124;362;16;60;70;183;86;243
430057;202011;79;166;31;81;6;21;11;23;17;44
430060;202011;16124;42762;12356;36829;2517;7962;5846;17281;8363;25243
430063;202011;794;2219;639;1902;127;376;350;1044;477;1420
430064;202011;990;2693;730;2158;223;680;277;809;500;1489
430066;202011;93;198;66;157;6;13;50;113;56;126
430070;202011;715;1808;95;313;7;26;16;44;23;70
430080;202011;818;2006;500;1387;77;255;269;646;346;901
430085;202011;828;1855;496;1324;95;265;215;568;310;833
430087;202011;732;1777;615;1622;63;161;428;1124;491;1285
430090;202011;489;1287;185;598;11;43;61;194;72;237
430100;202011;725;1726;446;1200;90;286;183;416;273;702
430105;202011;1103;2918;719;2256;116;413;347;1048;463;1461
430107;202011;165;483;96;304;20;72;28;75;48;147
430110;202011;2173;5371;1610;4531;283;847;843;2338;1126;3185
430120;202011;1104;3256;726;2305;137;457;325;1031;462;1488
430130;202011;3305;7559;2397;6285;853;2273;412;1325;1265;3598
430140;202011;929;2398;661;1904;171;448;336;957;507;1405
430150;202011;525;1345;278;845;61;205;95;274;156;479
430155;202011;235;594;110;330;19;53;22;61;41;114
430160;202011;19001;44104;14704;38043;1723;4826;8784;22476;10507;27302
430163;202011;2954;6970;2070;5566;83;292;1520;3988;1603;4280
430165;202011;277;677;81;258;13;27;14;39;27;66
430170;202011;938;2471;318;1088;52;185;43;125;95;310
430175;202011;629;1866;523;1633;137;434;243;754;380;1188
430180;202011;600;1440;471;1231;50;126;331;869;381;995
430185;202011;613;1522;316;913;81;213;65;176;146;389
430187;202011;663;1463;469;1224;73;201;247;683;320;884
430190;202011;1337;3491;1054;3043;220;682;496;1367;716;2049
430192;202011;121;323;40;120;5;15;9;22;14;37
430195;202011;404;1195;60;216;6;21;9;26;15;47
430200;202011;1002;2990;794;2612;273;916;223;754;496;1670
430205;202011;438;1156;392;1072;13;48;343;911;356;959
430210;202011;5310;13564;3538;9770;599;1765;1200;2730;1799;4495
430215;202011;291;744;183;531;38;115;67;198;105;313
430220;202011;629;1563;183;607;24;88;42;108;66;196
430222;202011;177;492;129;394;15;54;44;124;59;178
430223;202011;234;602;185;520;14;41;122;339;136;380
430225;202011;16;32;10;23;0;0;7;16;7;16
430230;202011;1884;5092;1562;4593;131;432;1163;3348;1294;3780
430235;202011;331;932;211;665;49;181;66;176;115;357
430237;202011;486;1133;362;932;18;51;271;681;289;732
430240;202011;1232;2845;693;1897;77;255;369;920;446;1175
430245;202011;695;1952;541;1658;150;478;250;792;400;1270
430250;202011;886;2169;640;1783;219;656;40;101;259;757
430258;202011;134;353;94;271;8;16;51;150;59;166
430260;202011;634;1670;439;1298;57;192;248;729;305;921
430265;202011;214;606;137;449;30;92;44;149;74;241
430270;202011;2823;6950;2215;6001;379;1133;1333;3482;1712;4615
430280;202011;4924;11506;3394;8883;660;1743;1476;3813;2136;5556
430290;202011;2163;4934;1759;4464;47;154;1522;3770;1569;3924
430300;202011;9686;24296;7195;19950;1123;3432;3847;10351;4970;13783
430310;202011;11280;27730;7532;20804;973;2982;3714;9579;4687;12561
430320;202011;983;2502;536;1616;58;176;303;918;361;1094
430330;202011;671;1625;392;1063;67;189;163;396;230;585
430340;202011;562;1311;375;1006;63;171;225;584;288;755
430350;202011;7511;18829;5622;15475;734;2206;3368;8817;4102;11023
430355;202011;301;796;104;334;18;61;14;35;32;96
430360;202011;800;1898;526;1416;99;302;222;558;321;860
430367;202011;295;672;166;445;30;95;96;244;126;339
430370;202011;420;1154;207;632;32;104;60;153;92;257
430380;202011;685;1680;332;1026;78;281;98;284;176;565
430390;202011;3026;7213;1768;4897;335;1066;283;571;618;1637
430400;202011;996;2126;769;1815;58;151;501;1141;559;1292
430410;202011;515;1229;354;968;61;175;215;573;276;748
430420;202011;2471;6714;1876;5427;464;1420;865;2380;1329;3800
430430;202011;554;1400;248;760;63;186;57;192;120;378
430435;202011;1434;3613;1106;3084;197;596;581;1613;778;2209
430440;202011;3592;9766;2791;8389;290;972;1723;5137;2013;6109
430450;202011;6485;16157;5128;13753;851;2529;2691;6889;3542;9418
430460;202011;31034;78048;22878;64599;3864;12052;11875;32040;15739;44092
430461;202011;233;613;75;231;13;43;32;85;45;128
430462;202011;239;655;142;454;25;90;53;164;78;254
430463;202011;5708;14789;4154;12011;829;2681;1931;5309;2760;7990
430465;202011;424;1077;343;932;56;175;213;558;269;733
430466;202011;3959;9938;3057;8476;732;2095;1413;3736;2145;5831
430467;202011;487;1154;347;933;49;156;191;474;240;630
430468;202011;1205;2950;939;2548;80;246;634;1668;714;1914
430469;202011;511;1350;65;210;8;25;12;23;20;48
430470;202011;5230;13411;3414;10105;1011;3271;897;2471;1908;5742
430471;202011;521;1464;423;1286;61;198;253;732;314;930
430480;202011;670;1844;408;1253;48;170;97;259;145;429
430485;202011;169;441;65;198;19;49;6;24;25;73
430490;202011;333;867;183;551;24;88;94;255;118;343
430495;202011;376;988;241;724;33;104;120;343;153;447
430500;202011;956;2459;656;1953;220;715;169;458;389;1173
430510;202011;24613;63709;17796;50370;2891;9287;8448;21932;11339;31219
430511;202011;319;914;130;420;18;61;19;58;37;119
430512;202011;936;2088;724;1769;165;408;268;676;433;1084
430513;202011;753;1877;348;1004;50;151;174;476;224;627
430515;202011;349;985;251;782;29;86;135;417;164;503
430517;202011;1131;3379;832;2693;161;525;388;1303;549;1828
430520;202011;1228;3097;638;1835;123;370;146;375;269;745
430530;202011;947;2346;374;1125;67;195;108;309;175;504
430535;202011;3360;8602;2417;6863;345;1016;1236;3370;1581;4386
430537;202011;330;1122;304;1053;18;55;247;853;265;908
430540;202011;603;1427;334;957;57;162;160;462;217;624
430543;202011;795;1372;441;970;55;114;190;478;245;592
430544;202011;726;2039;503;1534;123;394;169;498;292;892
430545;202011;2201;5628;1615;4722;312;922;831;2491;1143;3413
430550;202011;332;903;240;709;45;146;93;249;138;395
430558;202011;112;261;52;143;8;15;19;56;27;71
430560;202011;267;627;127;383;21;74;49;137;70;211
430570;202011;828;2016;581;1554;99;301;304;755;403;1056
430580;202011;815;2019;572;1642;149;458;245;702;394;1160
430583;202011;197;489;34;104;2;7;12;28;14;35
430585;202011;224;544;114;306;19;60;52;120;71;180
430587;202011;191;519;142;423;21;68;59;169;80;237
430590;202011;1356;3241;1123;2899;58;173;928;2345;986;2518
430593;202011;16;48;12;37;1;3;5;15;6;18
430595;202011;422;1048;115;374;7;27;24;60;31;87
430597;202011;447;1128;227;678;22;63;74;178;96;241
430600;202011;1918;4872;862;2447;164;497;234;598;398;1095
430605;202011;1230;3217;867;2524;105;356;417;1154;522;1510
430607;202011;512;1197;424;1056;27;70;314;771;341;841
430610;202011;5636;13044;3766;10213;1063;3289;841;2204;1904;5493
430613;202011;267;620;75;215;14;38;18;35;32;73
430620;202011;598;1430;435;1125;63;190;263;608;326;798
430630;202011;387;1051;107;343;19;59;22;63;41;122
430632;202011;446;1166;194;592;27;86;87;252;114;338
430635;202011;521;1219;389;999;44;116;286;737;330;853
430637;202011;442;1076;344;929;42;133;220;561;262;694
430640;202011;997;2625;637;1893;95;297;250;683;345;980
430642;202011;342;932;253;729;42;116;137;375;179;491
430645;202011;151;351;56;152;8;21;19;45;27;66
430650;202011;1567;4464;1243;3916;361;1142;553;1861;914;3003
430655;202011;269;674;165;463;28;92;80;192;108;284
430660;202011;5083;12902;3862;10859;834;2447;1698;4728;2532;7175
430670;202011;638;1551;483;1281;33;93;285;769;318;862
430673;202011;509;1156;213;604;36;104;83;215;119;319
430675;202011;236;671;53;186;6;20;21;75;27;95
430676;202011;4896;12036;3863;10439;454;1356;2491;6557;2945;7913
430680;202011;1012;2690;590;1819;153;487;138;414;291;901
430690;202011;2664;7230;2080;6170;713;2218;584;1656;1297;3874
430692;202011;216;663;164;568;12;39;123;436;135;475
430693;202011;902;2352;540;1640;105;377;143;398;248;775
430695;202011;394;1001;234;680;28;70;126;350;154;420
430697;202011;383;962;293;817;75;191;144;438;219;629
430700;202011;6814;16672;3986;11356;806;2525;926;2366;1732;4891
430705;202011;386;919;186;544;18;54;81;214;99;268
430710;202011;1603;3432;1124;2792;149;417;682;1666;831;2083
430720;202011;651;1563;335;1008;40;119;177;536;217;655
430730;202011;960;2605;663;2044;99;293;352;1079;451;1372
430740;202011;595;1602;304;991;49;160;82;273;131;433
430745;202011;331;900;212;649;44;154;68;178;112;332
430750;202011;1321;3336;918;2654;206;625;436;1237;642;1862
430755;202011;430;1053;265;716;22;62;151;381;173;443
430760;202011;1906;4659;1432;3919;322;958;652;1693;974;2651
430770;202011;5955;14793;4572;12708;562;1813;2940;7883;3502;9696
430780;202011;1755;4267;1014;2993;191;635;395;1115;586;1750
430781;202011;453;1253;247;766;32;96;76;201;108;297
430783;202011;340;779;205;569;19;60;130;337;149;397
430786;202011;31;110;21;78;3;13;2;9;5;22
430790;202011;4210;10164;2929;7977;320;1031;1821;4623;2141;5654
430800;202011;707;1640;522;1363;30;86;354;921;384;1007
430805;202011;325;851;210;608;13;48;139;381;152;429
430807;202011;480;1192;252;755;35;111;96;261;131;372
430810;202011;657;1554;278;819;30;107;134;368;164;475
430820;202011;1114;2986;662;2104;123;419;218;658;341;1077
430825;202011;225;562;84;222;12;31;26;64;38;95
430830;202011;1632;4625;1312;4013;65;213;948;2863;1013;3076
430840;202011;1020;2480;691;1930;97;271;465;1297;562;1568
430843;202011;160;369;70;181;4;13;33;80;37;93
430845;202011;453;1060;299;812;51;152;136;347;187;499
430850;202011;2171;5593;1450;4207;228;720;563;1648;791;2368
430860;202011;815;1888;360;1016;50;169;170;401;220;570
430865;202011;493;1230;364;1008;73;206;162;448;235;654
430870;202011;578;1517;244;763;40;146;80;209;120;355
430880;202011;1457;3294;981;2554;159;416;534;1360;693;1776
430885;202011;170;450;90;295;6;22;57;181;63;203
430890;202011;930;2290;616;1764;57;243;136;364;193;607
430900;202011;3011;6551;2080;5215;173;520;1398;3284;1571;3804
430905;202011;779;1939;494;1403;88;284;203;530;291;814
430910;202011;1614;4314;1167;3403;187;626;577;1511;764;2137
430912;202011;491;1372;330;1046;24;73;225;720;249;793
430915;202011;475;1417;361;1200;137;434;93;330;230;764
430920;202011;21757;54962;16423;46096;2159;6684;9968;27310;12127;33994
430925;202011;87;196;35;106;5;13;17;53;22;66
430930;202011;9840;23169;6175;17491;1174;3380;2554;7564;3728;10944
430940;202011;869;2227;516;1490;122;369;156;397;278;766
430950;202011;757;1737;481;1256;35;124;314;747;349;871
430955;202011;361;934;81;240;21;64;23;57;44;121
430957;202011;160;546;146;513;21;79;100;345;121;424
430960;202011;1241;2956;687;1936;143;429;301;817;444;1246
430965;202011;1572;3719;1214;3159;71;183;917;2452;988;2635
430970;202011;324;771;161;454;22;72;80;199;102;271
430975;202011;478;1421;362;1150;79;270;197;590;276;860
430980;202011;377;856;221;590;26;84;106;254;132;338
430990;202011;492;1425;312;985;41;130;152;479;193;609
430995;202011;533;1355;402;1143;44;135;233;641;277;776
431000;202011;1289;3039;521;1512;90;284;43;111;133;395
431010;202011;2041;5352;1305;4062;254;877;322;868;576;1745
431020;202011;7465;16173;4369;11514;991;2952;1505;3452;2496;6404
431030;202011;355;956;164;551;33;116;21;69;54;185
431033;202011;3630;8393;2319;6332;494;1384;849;2324;1343;3708
431036;202011;329;724;62;179;7;24;22;51;29;75
431040;202011;848;2161;545;1624;78;260;256;706;334;966
431041;202011;431;996;317;822;24;54;194;505;218;559
431043;202011;300;777;171;537;40;138;84;265;124;403
431046;202011;99;262;41;127;4;9;7;21;11;30
431050;202011;1312;3180;929;2549;168;510;446;1261;614;1771
431053;202011;623;1660;348;1063;78;279;114;300;192;579
431055;202011;559;1362;470;1225;51;122;337;873;388;995
431057;202011;213;608;113;371;26;85;32;95;58;180
431060;202011;5235;13217;3457;10163;798;2568;998;2828;1796;5396
431065;202011;391;966;278;773;44;132;138;378;182;510
431070;202011;400;1102;232;724;52;177;62;183;114;360
431075;202011;208;603;129;421;30;106;33;109;63;215
431080;202011;546;1476;373;1103;59;210;145;398;204;608
431085;202011;767;1977;482;1328;60;167;249;665;309;832
431087;202011;384;1088;310;936;20;58;220;685;240;743
431090;202011;395;931;156;479;27;91;45;145;72;236
431100;202011;3218;7007;2176;5632;309;817;1126;2971;1435;3788
431110;202011;1349;3097;906;2329;250;669;365;855;615;1524
431112;202011;574;1582;481;1404;63;209;305;856;368;1065
431113;202011;360;976;309;876;48;155;195;535;243;690
431115;202011;922;2590;714;2208;89;351;428;1225;517;1576
431120;202011;2455;6558;1672;5010;483;1628;368;1012;851;2640
431123;202011;390;1051;249;748;44;115;138;435;182;550
431125;202011;934;2660;747;2297;276;818;254;853;530;1671
431127;202011;195;511;58;191;7;24;12;35;19;59
431130;202011;2794;7093;2047;5846;292;958;1169;3239;1461;4197
431140;202011;5330;12417;3218;8469;393;1151;1502;3402;1895;4553
431142;202011;479;1263;354;1041;45;139;222;655;267;794
431150;202011;1019;2694;723;2146;133;433;327;934;460;1367
431160;202011;623;1788;412;1315;71;244;123;387;194;631
431162;202011;479;1151;277;790;32;104;156;409;188;513
431164;202011;168;381;41;125;8;27;5;11;13;38
431170;202011;430;1177;301;913;91;282;84;242;175;524
431171;202011;648;1512;526;1347;116;261;304;809;420;1070
431173;202011;348;933;262;809;69;245;117;336;186;581
431175;202011;1243;2870;771;2060;130;352;294;744;424;1096
431177;202011;756;2043;594;1782;127;448;366;1041;493;1489
431179;202011;327;715;95;283;18;53;23;66;41;119
431180;202011;2042;5154;1250;3580;294;872;395;1078;689;1950
431190;202011;490;1280;244;720;28;89;96;236;124;325
431198;202011;358;1022;277;868;90;294;88;300;178;594
431200;202011;354;877;79;217;16;45;10;28;26;73
431205;202011;188;522;95;310;28;92;34;111;62;203
431210;202011;590;1436;474;1275;124;334;214;608;338;942
431213;202011;259;675;192;551;13;46;101;289;114;335
431215;202011;562;1322;249;717;20;59;131;357;151;416
431217;202011;142;372;98;292;11;35;55;153;66;188
431220;202011;510;1326;310;934;29;102;180;502;209;604
431225;202011;1439;3383;1099;2810;113;304;752;1925;865;2229
431230;202011;658;1878;526;1593;72;227;329;962;401;1189
431235;202011;146;371;21;77;3;8;4;20;7;28
431237;202011;294;924;239;794;48;172;127;403;175;575
431238;202011;27;70;22;60;5;16;9;16;14;32
431240;202011;4270;10485;3352;9027;438;1343;2062;5243;2500;6586
431242;202011;234;612;203;560;38;110;112;296;150;406
431244;202011;302;728;158;445;22;78;60;140;82;218
431245;202011;1198;2793;756;2026;73;210;404;1034;477;1244
431247;202011;266;673;159;455;28;89;69;173;97;262
431250;202011;1627;4019;1191;3429;258;767;621;1893;879;2660
431260;202011;240;659;159;505;22;82;56;167;78;249
431261;202011;231;692;184;615;12;46;103;329;115;375
431262;202011;330;918;165;537;10;27;114;378;124;405
431265;202011;1533;3604;600;1745;77;263;207;524;284;787
431267;202011;254;639;166;454;8;35;126;314;134;349
431270;202011;2731;6104;1450;3944;330;910;487;1342;817;2252
431275;202011;111;316;58;188;23;70;12;42;35;112
431280;202011;233;624;70;224;5;16;8;14;13;30
431290;202011;306;891;193;602;38;137;37;81;75;218
431295;202011;67;167;19;58;3;8;6;18;9;26
431300;202011;276;711;54;165;6;17;15;31;21;48
431301;202011;302;842;65;200;8;20;7;22;15;42
431303;202011;539;1420;324;962;24;88;150;415;174;503
431306;202011;2226;5222;1332;3716;172;547;589;1457;761;2004
431308;202011;25;76;22;70;10;34;10;31;20;65
431310;202011;514;1433;359;1086;50;152;160;452;210;604
431320;202011;593;1625;309;1003;45;136;67;186;112;322
431330;202011;1644;3863;798;2279;140;456;329;850;469;1306
431333;202011;203;529;112;324;20;56;41;109;61;165
431335;202011;35;100;18;59;4;8;2;6;6;14
431337;202011;2414;6367;1758;5274;321;1084;949;2745;1270;3829
431339;202011;404;1041;297;843;83;244;116;326;199;570
431340;202011;17526;42394;12106;33290;2038;6241;5562;14302;7600;20543
431342;202011;410;896;303;734;25;47;253;613;278;660
431344;202011;384;968;225;665;9;30;121;345;130;375
431346;202011;227;559;86;277;15;53;25;76;40;129
431349;202011;600;1580;325;955;83;230;117;349;200;579
431350;202011;3866;9899;2851;8159;393;1296;1550;4258;1943;5554
431360;202011;542;1292;264;749;83;239;69;198;152;437
431365;202011;1991;4651;1576;4088;123;362;1194;3061;1317;3423
431370;202011;4240;10250;3019;8246;619;1771;1509;4219;2128;5990
431380;202011;779;2058;625;1811;43;132;445;1291;488;1423
431390;202011;2538;6143;1544;4389;152;517;776;1935;928;2452
431395;202011;1245;3064;866;2475;192;580;396;1171;588;1751
431400;202011;303;850;163;517;33;99;37;116;70;215
431402;202011;843;1868;609;1510;72;192;417;1004;489;1196
431403;202011;198;544;153;451;23;70;70;193;93;263
431405;202011;4373;11439;3333;9677;583;1888;1633;4483;2216;6371
431406;202011;512;1455;370;1151;73;220;197;630;270;850
431407;202011;425;1182;296;910;64;216;150;442;214;658
431410;202011;15741;39214;10397;29773;1489;4954;5404;14368;6893;19322
431413;202011;197;516;52;170;7;25;8;28;15;53
431415;202011;630;1533;391;1129;64;223;200;517;264;740
431417;202011;529;1169;356;906;55;158;201;504;256;662
431420;202011;1578;3514;1180;2962;162;420;674;1661;836;2081
431430;202011;543;1384;256;792;40;135;85;237;125;372
431440;202011;28485;66192;19550;52158;3265;9456;7841;19632;11106;29088
431442;202011;114;324;52;180;12;41;8;25;20;66
431445;202011;385;1070;117;370;16;42;8;21;24;63
431446;202011;244;720;187;605;34;125;94;294;128;419
431447;202011;706;1862;402;1205;82;271;143;429;225;700
431449;202011;769;1992;455;1337;89;238;180;546;269;784
431450;202011;2226;4571;1735;3878;81;195;1359;2961;1440;3156
431454;202011;34;109;29;95;8;23;9;28;17;51
431455;202011;586;1377;286;765;37;109;146;350;183;459
431460;202011;2787;6729;1930;5207;499;1407;508;1396;1007;2803
431470;202011;1344;3780;971;2974;180;554;435;1356;615;1910
431475;202011;235;631;48;166;5;18;7;14;12;32
431477;202011;373;978;224;663;36;103;96;259;132;362
431478;202011;217;574;49;153;11;30;7;17;18;47
431480;202011;3101;7640;2449;6618;581;1555;1252;3444;1833;4999
431490;202011;102745;240699;77089;201458;5464;16903;56251;141475;61715;158378
431500;202011;460;1166;338;934;55;155;181;481;236;636
431505;202011;243;586;165;469;10;33;119;338;129;371
431507;202011;331;777;132;388;42;136;36;94;78;230
431510;202011;1517;3888;1013;2901;232;726;338;965;570;1691
431513;202011;200;447;113;300;9;19;79;212;88;231
431514;202011;106;263;73;204;3;10;51;133;54;143
431515;202011;444;1114;319;881;78;214;169;448;247;662
431517;202011;53;163;44;139;6;17;22;65;28;82
431520;202011;385;962;151;468;21;74;67;178;88;252
431530;202011;4099;8621;2293;5919;533;1384;587;1541;1120;2925
431531;202011;199;491;120;338;14;38;53;135;67;173
431532;202011;524;1203;316;837;66;200;132;339;198;539
431535;202011;234;609;104;320;18;56;26;71;44;127
431540;202011;1735;5579;1611;5404;56;224;1315;4428;1371;4652
431545;202011;340;882;61;203;5;17;13;40;18;57
431550;202011;2031;5132;1475;4089;239;720;755;2009;994;2729
431555;202011;630;1417;380;996;23;67;232;601;255;668
431560;202011;21657;52304;14674;41271;3065;8955;4983;14828;8048;23783
431570;202011;4173;10194;3471;9136;428;1240;2473;6253;2901;7493
431575;202011;236;581;183;489;69;162;45;132;114;294
431580;202011;548;1417;339;995;37;131;195;544;232;675
431590;202011;542;1513;403;1218;89;282;164;511;253;793
431595;202011;353;950;230;688;52;152;90;241;142;393
431600;202011;1328;3073;922;2483;213;622;374;998;587;1620
431610;202011;1348;3435;906;2615;133;367;470;1386;603;1753
431620;202011;475;1212;217;625;34;99;86;236;120;335
431630;202011;1279;3145;587;1719;98;311;221;596;319;907
431640;202011;6096;14375;5129;13161;495;1304;3868;9981;4363;11285
431642;202011;541;1309;337;894;28;71;159;390;187;461
431643;202011;379;917;177;498;17;44;55;158;72;202
431645;202011;1752;3903;1367;3390;60;190;1111;2711;1171;2901
431647;202011;282;685;90;256;10;25;27;66;37;91
431650;202011;114;316;76;254;6;23;42;124;48;147
431660;202011;817;2156;397;1271;67;251;116;318;183;569
431670;202011;1112;2639;681;1844;106;302;348;895;454;1197
431673;202011;232;581;82;270;10;35;21;65;31;100
431675;202011;408;1063;104;351;10;38;23;65;33;103
431680;202011;7276;18502;5235;14682;1220;3555;2223;6072;3443;9627
431690;202011;22840;55470;15023;41389;2972;8741;6191;16894;9163;25635
431695;202011;165;400;100;295;22;77;50;125;72;202
431697;202011;446;1039;346;882;49;118;203;525;252;643
431700;202011;1255;3255;1047;2869;155;392;642;1761;797;2153
431710;202011;12617;29903;8698;24234;1439;4325;4494;12604;5933;16929
431720;202011;6127;15049;3580;10126;878;2627;728;1849;1606;4476
431725;202011;28;81;22;71;3;10;10;30;13;40
431730;202011;3829;9025;2347;6691;534;1609;740;2263;1274;3872
431740;202011;4942;11573;3218;8674;851;2665;835;1910;1686;4575
431750;202011;7150;18295;5374;15433;1177;3622;2242;6336;3419;9958
431755;202011;311;842;68;236;10;36;9;32;19;68
431760;202011;5189;11572;3483;8859;388;1119;2130;5129;2518;6248
431770;202011;1863;4336;1437;3765;98;289;1083;2760;1181;3049
431775;202011;194;497;98;302;19;57;14;39;33;96
431780;202011;2032;4985;1294;3606;205;632;553;1471;758;2103
431790;202011;743;1987;517;1545;91;265;248;734;339;999
431795;202011;224;571;112;337;27;73;28;77;55;150
431800;202011;7948;18745;4799;13704;1221;4117;489;1491;1710;5608
431805;202011;285;664;86;276;11;37;22;67;33;104
431810;202011;3212;7545;1996;5323;373;1025;859;2193;1232;3218
431820;202011;2013;5394;1568;4679;445;1386;548;1727;993;3113
431830;202011;8694;18669;6334;15537;1621;4701;1815;4428;3436;9129
431840;202011;2488;6435;1971;5600;298;849;1249;3564;1547;4413
431842;202011;532;1328;175;532;22;72;65;166;87;238
431843;202011;327;870;241;690;32;99;118;318;150;417
431844;202011;196;508;65;204;13;46;24;73;37;119
431845;202011;495;1306;350;1019;39;114;202;584;241;698
431846;202011;261;684;222;623;10;30;200;563;210;593
431848;202011;90;233;57;168;9;29;11;25;20;54
431849;202011;402;970;65;185;8;19;7;15;15;34
431850;202011;4005;10760;3047;8843;712;2234;1014;2896;1726;5130
431860;202011;621;1477;332;925;56;167;191;511;247;678
431861;202011;87;241;49;153;10;35;14;41;24;76
431862;202011;429;1353;353;1221;65;244;175;581;240;825
431870;202011;19319;48659;15523;42662;1755;5504;9789;25839;11544;31343
431880;202011;3781;9637;2646;7616;415;1384;1237;3367;1652;4751
431890;202011;4237;10593;2615;7524;740;2347;463;1479;1203;3826
431900;202011;915;2273;581;1671;90;286;301;820;391;1106
431910;202011;729;1739;265;737;39;111;87;199;126;310
431912;202011;460;1235;357;1054;72;218;202;602;274;820
431915;202011;1000;2466;788;2116;22;78;621;1627;643;1705
431920;202011;1211;2773;999;2500;29;69;858;2137;887;2206
431930;202011;637;1706;428;1304;154;431;163;533;317;964
431935;202011;83;223;60;177;14;45;14;40;28;85
431936;202011;297;844;154;486;35;113;65;192;100;305
431937;202011;141;347;89;239;12;33;43;98;55;131
431940;202011;2963;6965;1683;4628;185;552;849;2242;1034;2794
431950;202011;1745;4595;1383;3995;422;1261;512;1439;934;2700
431960;202011;2814;6831;2069;5488;553;1559;563;1493;1116;3052
431970;202011;387;966;158;456;35;99;46;115;81;214
431971;202011;77;189;28;90;2;8;4;8;6;16
431973;202011;463;1487;383;1329;38;136;279;968;317;1104
431975;202011;106;212;20;60;2;7;1;3;3;10
431980;202011;943;2450;724;2091;146;447;351;977;497;1424
431990;202011;5259;12573;3579;10140;422;1458;1840;5007;2262;6465
432000;202011;10780;25523;7797;20909;1904;5119;3295;9026;5199;14145
432010;202011;2117;5145;1551;4164;237;690;907;2307;1144;2997
432020;202011;1684;4356;1030;2967;217;659;419;1161;636;1820
432023;202011;476;1135;249;703;31;99;124;317;155;416
432026;202011;915;2557;673;2090;176;553;228;708;404;1261
432030;202011;349;859;194;544;19;54;111;303;130;357
432032;202011;321;828;220;626;23;76;125;331;148;407
432035;202011;614;1754;531;1610;166;498;229;718;395;1216
432040;202011;1002;2318;365;1121;56;179;130;362;186;541
432045;202011;150;429;97;316;24;70;35;123;59;193
432050;202011;498;1231;366;1006;79;214;151;436;230;650
432055;202011;549;1471;355;1105;126;396;72;213;198;609
432057;202011;217;579;160;440;17;44;66;166;83;210
432060;202011;414;981;126;387;32;105;41;114;73;219
432065;202011;196;541;139;415;30;94;57;169;87;263
432067;202011;699;2011;587;1762;54;182;445;1288;499;1470
432070;202011;1590;4153;1035;3067;231;750;343;904;574;1654
432080;202011;4558;10676;3465;8956;592;1790;1633;3969;2225;5759
432085;202011;323;826;222;671;54;168;91;290;145;458
432090;202011;1693;4164;1035;2918;187;572;510;1316;697;1888
432100;202011;929;2322;457;1394;98;319;79;202;177;521
432110;202011;1922;5077;1296;3948;311;1072;129;354;440;1426
432120;202011;2562;6932;1961;5893;367;1231;801;2273;1168;3504
432130;202011;2435;6189;2003;5547;570;1601;900;2553;1470;4154
432132;202011;173;495;107;351;22;71;49;139;71;210
432135;202011;965;2268;643;1719;35;112;476;1258;511;1370
432140;202011;1539;4609;1164;3839;175;599;695;2288;870;2887
432143;202011;1329;3453;1008;2952;60;188;675;1966;735;2154
432145;202011;1616;4220;1009;2956;147;464;357;895;504;1359
432146;202011;100;279;66;218;23;84;22;64;45;148
432147;202011;444;1242;262;862;88;310;69;194;157;504
432149;202011;426;1030;216;604;19;59;106;259;125;318
432150;202011;2947;7382;2142;5945;432;1289;894;2433;1326;3722
432160;202011;4786;12449;3466;10340;827;2764;1285;3654;2112;6418
432162;202011;228;487;32;91;7;19;6;15;13;34
432163;202011;99;246;19;49;0;0;3;4;3;4
432166;202011;583;1630;449;1352;91;300;150;407;241;707
432170;202011;1395;3722;906;2794;162;552;371;1065;533;1617
432180;202011;2988;7014;1601;4409;297;857;608;1473;905;2330
432183;202011;343;1004;236;756;55;198;71;207;126;405
432185;202011;798;2045;454;1361;38;129;228;641;266;770
432190;202011;1833;4387;1216;3403;181;576;675;1755;856;2331
432195;202011;795;2048;533;1563;157;425;183;574;340;999
432200;202011;3121;7857;2247;6471;354;1034;1284;3734;1638;4768
432210;202011;362;948;223;674;42;164;105;266;147;430
432215;202011;592;1749;539;1668;50;132;407;1282;457;1414
432218;202011;240;598;106;305;14;51;51;132;65;183
432220;202011;3382;7912;2495;6499;456;1244;1325;3398;1781;4642
432225;202011;81;233;62;193;10;26;35;116;45;142
432230;202011;696;1613;366;991;40;110;167;403;207;513
432232;202011;469;1157;291;850;61;186;103;273;164;459
432234;202011;251;628;116;342;19;52;16;43;35;95
432235;202011;44;125;16;51;5;17;4;13;9;30
432237;202011;303;781;271;730;10;19;227;603;237;622
432240;202011;15178;37308;10911;31550;822;2461;6974;21130;7796;23591
432250;202011;5101;14463;3801;11854;976;3172;1611;4956;2587;8128
432252;202011;405;976;254;701;30;89;136;357;166;446
432253;202011;829;2541;543;1802;126;451;50;149;176;600
432254;202011;678;1579;180;522;32;92;36;99;68;191
432255;202011;98;251;55;168;3;9;28;78;31;87
432260;202011;4660;11870;3442;9544;981;2803;1144;3033;2125;5836
432270;202011;1727;4794;1376;4115;404;1315;311;862;715;2177
432280;202011;1343;3334;701;2071;101;317;259;639;360;956
432285;202011;142;427;20;60;2;6;3;7;5;13
432290;202011;324;893;176;552;59;189;33;76;92;265
432300;202011;24395;61082;17986;50714;2550;8114;10543;28680;13093;36794
432310;202011;821;2191;590;1769;61;191;408;1217;469;1408
432320;202011;196;453;75;229;8;29;28;75;36;104
432330;202011;225;507;71;230;9;20;13;42;22;62
432335;202011;158;455;59;210;5;21;17;58;22;79
432340;202011;298;711;131;406;10;30;49;142;59;172
432345;202011;677;1526;593;1423;16;42;494;1169;510;1211
432350;202011;338;860;178;553;27;89;70;220;97;309
432360;202011;232;680;44;145;4;7;16;54;20;61
432370;202011;285;696;189;536;14;49;131;360;145;409
432375;202011;443;1115;328;883;60;161;174;469;234;630
432377;202011;164;522;27;92;6;27;3;8;9;35
432380;202011;1560;4092;1001;3067;168;597;517;1524;685;2121
500020;202011;2415;6269;1755;5156;150;527;1125;3201;1275;3728
500025;202011;1160;2813;720;1987;71;207;393;1031;464;1238
500060;202011;7680;21604;5217;16456;653;2141;3045;9868;3698;12009
500070;202011;4059;10504;2832;8399;536;1625;1222;3704;1758;5329
500080;202011;1582;3880;952;2701;173;538;379;951;552;1489
500085;202011;1932;4818;1340;3805;309;924;628;1711;937;2635
500090;202011;2102;5544;1406;4310;233;761;485;1594;718;2355
500100;202011;3413;8702;2584;7343;422;1352;1297;3488;1719;4840
500110;202011;7568;19233;4810;14879;1022;3489;1436;5252;2458;8741
500124;202011;1968;5758;1558;5073;255;771;829;2849;1084;3620
500150;202011;1286;2879;801;2177;135;392;330;878;465;1270
500190;202011;4636;12021;2908;8611;628;1901;682;1921;1310;3822
500200;202011;2248;5327;1634;4303;179;482;994;2540;1173;3022
500210;202011;4445;10628;3133;8907;845;2350;1385;4072;2230;6422
500215;202011;1345;3705;971;3026;98;329;545;1686;643;2015
500220;202011;2664;7447;1699;5529;277;967;469;1453;746;2420
500230;202011;1920;4482;1459;3844;166;409;995;2602;1161;3011
500240;202011;3831;11223;2684;8810;403;1462;1111;3725;1514;5187
500260;202011;3179;6745;2022;5160;273;705;1080;2655;1353;3360
500270;202011;130431;304660;78052;216186;12681;38785;29992;77781;42673;116566
500280;202011;1272;3201;869;2575;135;414;450;1322;585;1736
500290;202011;3406;8169;1998;5724;297;997;657;1650;954;2647
500295;202011;3388;8127;2120;5876;329;1013;851;2027;1180;3040
500310;202011;940;1958;632;1568;95;209;326;839;421;1048
500315;202011;3701;10125;2938;8981;243;765;2128;6619;2371;7384
500320;202011;18650;49921;12876;40351;3264;10750;4478;14946;7742;25696
500325;202011;4148;9247;2848;7534;214;591;1937;5174;2151;5765
500330;202011;6391;14520;4202;11357;360;1054;2270;6319;2630;7373
500345;202011;2016;4938;1333;3863;305;922;451;1300;756;2222
500348;202011;2286;5954;1716;4961;243;740;982;2872;1225;3612
500350;202011;1293;3524;708;2231;89;280;292;878;381;1158
500370;202011;25554;65034;17983;52643;2293;7695;9741;28075;12034;35770
500375;202011;2323;6107;1529;4489;273;873;529;1448;802;2321
500380;202011;3190;8001;2186;6266;607;1893;481;1406;1088;3299
500390;202011;603;1242;358;941;51;164;220;544;271;708
500400;202011;1486;3750;980;2769;172;549;350;881;522;1430
500410;202011;2328;5721;1635;4687;173;487;936;2806;1109;3293
500430;202011;2470;6098;1694;4922;219;767;745;2263;964;3030
500440;202011;1170;2845;730;2163;113;369;268;853;381;1222
500450;202011;1435;3504;808;2378;133;430;219;595;352;1025
500460;202011;3384;9139;2052;6485;340;1227;663;2036;1003;3263
500470;202011;2325;6238;1397;4324;390;1350;306;815;696;2165
500480;202011;2027;6203;1716;5704;168;576;1280;4316;1448;4892
500490;202011;1005;2319;592;1703;120;423;166;482;286;905
500500;202011;4025;10741;2554;8307;871;3297;383;1280;1254;4577
500510;202011;661;1669;432;1237;29;91;271;758;300;849
500515;202011;1646;4229;1264;3615;136;428;797;2179;933;2607
500520;202011;3099;9428;2399;8151;621;2107;986;3633;1607;5740
500525;202011;875;2560;698;2296;54;195;455;1497;509;1692
500540;202011;4190;10901;2534;7962;670;2656;234;667;904;3323
500560;202011;5264;14333;4206;13002;274;862;3385;10663;3659;11525
500568;202011;4143;9113;2543;6745;641;1763;886;2382;1527;4145
500570;202011;7375;17116;4558;12340;797;2353;1797;4544;2594;6897
500580;202011;2916;7761;2102;6321;486;1504;958;2919;1444;4423
500600;202011;3281;8166;2331;6640;526;1557;974;2838;1500;4395
500620;202011;7593;19776;5120;15103;1033;3210;1957;5555;2990;8765
500625;202011;535;1465;342;1054;63;195;91;266;154;461
500627;202011;709;1858;434;1357;80;273;145;430;225;703
500630;202011;6460;14785;3702;10232;733;2226;1098;3030;1831;5256
500635;202011;2883;8987;2224;8127;168;642;1539;6180;1707;6822
500640;202011;1654;3607;1090;2857;36;110;744;1924;780;2034
500660;202011;16834;43017;11533;35402;3617;12668;2914;9168;6531;21836
500690;202011;2248;6208;1450;4829;499;1931;76;202;575;2133
500710;202011;2681;7179;2060;6128;583;1838;664;1860;1247;3698
500720;202011;4548;11457;2977;8831;684;2135;921;2842;1605;4977
500730;202011;1060;2622;567;1709;111;319;137;452;248;771
500740;202011;4384;10452;2991;8268;386;1120;1563;4289;1949;5409
500750;202011;940;2389;632;1844;80;214;242;660;322;874
500755;202011;877;2264;482;1509;89;300;103;291;192;591
500769;202011;4868;11864;2656;7700;509;1654;354;851;863;2505
500770;202011;1375;3728;903;2896;159;588;307;972;466;1560
500780;202011;1149;2776;735;2087;147;476;199;522;346;998
500790;202011;6530;17553;5067;15079;1047;3349;2500;7487;3547;10836
500793;202011;1993;5110;1422;4122;348;1070;475;1276;823;2346
500795;202011;2649;6558;2142;5919;107;274;1716;4985;1823;5259
500797;202011;648;1644;424;1237;130;389;128;379;258;768
500800;202011;3087;6973;1858;5156;595;1940;193;577;788;2517
500830;202011;17171;42771;11751;32805;2450;7333;4310;11365;6760;18698
500840;202011;1325;3233;827;2291;103;288;330;858;433;1146
510010;202011;1746;3941;1168;3205;110;264;832;2327;942;2591
510020;202011;3175;8001;1692;5112;356;1186;417;1119;773;2305
510025;202011;6192;14980;3713;10985;542;1811;1591;4580;2133;6391
510030;202011;2471;5512;1632;4251;333;879;645;1639;978;2518
510035;202011;1194;3105;757;2417;85;289;453;1540;538;1829
510040;202011;2255;5015;1664;4252;179;441;1030;2759;1209;3200
510050;202011;2045;4266;1357;3393;158;421;949;2344;1107;2765
510060;202011;1307;3283;852;2482;178;568;213;580;391;1148
510080;202011;1187;3110;746;2380;243;803;215;602;458;1405
510100;202011;606;1423;423;1137;54;151;224;586;278;737
510120;202011;268;487;145;340;10;22;107;254;117;276
510125;202011;1866;4618;1463;4056;145;532;798;2076;943;2608
510130;202011;1393;3470;968;2794;202;644;306;912;508;1556
510140;202011;2927;7468;1973;6265;691;2580;732;2207;1423;4787
510160;202011;1665;4283;1224;3714;159;468;880;2736;1039;3204
510170;202011;4176;11057;3057;9247;754;2402;1202;3735;1956;6137
510180;202011;14159;31583;9013;24135;1954;5725;2772;8371;4726;14096
510185;202011;1685;4333;1079;3466;429;1402;266;1118;695;2520
510190;202011;1945;5544;1237;4362;353;1368;212;841;565;2209
510250;202011;16415;41297;12051;34718;2350;7061;5975;17899;8325;24960
510260;202011;1796;7662;1497;7128;244;1261;933;4813;1177;6074
510263;202011;2963;8260;1793;5843;296;1078;305;857;601;1935
510267;202011;4675;13229;2619;8647;474;1669;378;1127;852;2796
510268;202011;1172;2883;902;2475;101;257;609;1680;710;1937
510269;202011;967;2608;584;1878;138;493;185;553;323;1046
510270;202011;2887;8176;1970;6514;339;1271;821;2671;1160;3942
510279;202011;1660;4263;1011;3139;185;650;429;1279;614;1929
510285;202011;1089;2857;735;2242;235;800;162;444;397;1244
510300;202011;3478;8819;2553;7566;360;1101;1501;4669;1861;5770
510305;202011;1363;3751;826;2701;178;614;191;706;369;1320
510310;202011;837;2039;563;1589;155;452;163;488;318;940
510320;202011;3440;8529;2356;6673;521;1634;588;1652;1109;3286
510325;202011;4068;11958;2983;9936;849;2998;851;2931;1700;5929
510330;202011;2515;7642;1679;6144;313;1149;631;2707;944;3856
510335;202011;4703;13459;3544;11600;542;1919;1997;6690;2539;8609
510336;202011;423;1188;304;1002;51;164;158;579;209;743
510337;202011;1411;4063;891;3112;347;1339;184;645;531;1984
510340;202011;87451;193719;55454;147561;13552;42524;16612;41775;30164;84299
510343;202011;930;2574;644;2043;115;416;281;845;396;1261
510345;202011;1215;3468;916;2880;151;482;415;1277;566;1759
510350;202011;2721;6982;1779;5384;373;1219;732;2135;1105;3354
510360;202011;1819;3778;1173;3024;69;129;817;2281;886;2410
510370;202011;1673;4720;1238;4014;176;629;736;2496;912;3125
510380;202011;520;1285;298;909;49;177;118;359;167;536
510385;202011;1167;3923;868;3359;88;402;563;2240;651;2642
510390;202011;1215;3178;819;2679;247;821;271;1040;518;1861
510395;202011;702;1585;472;1244;26;72;295;830;321;902
510410;202011;4516;12491;3274;10303;626;2063;1712;5595;2338;7658
510420;202011;2357;4931;1600;3933;125;317;1050;2570;1175;2887
510450;202011;388;980;225;661;57;165;32;113;89;278
510452;202011;766;2115;552;1721;76;248;320;973;396;1221
510454;202011;891;2444;691;2099;72;220;434;1374;506;1594
510455;202011;918;2509;659;1993;109;354;276;778;385;1132
510460;202011;1666;4141;1199;3447;93;322;787;2190;880;2512
510480;202011;4446;10622;2928;7877;547;1625;1176;3116;1723;4741
510490;202011;1651;4226;1232;3705;170;504;817;2484;987;2988
510500;202011;1455;3623;899;2732;179;572;303;938;482;1510
510510;202011;3322;9600;2416;7993;581;2177;788;2738;1369;4915
510515;202011;5047;12812;3318;9717;760;2513;920;2368;1680;4881
510517;202011;982;2832;741;2427;232;852;136;395;368;1247
510520;202011;2031;4126;1147;3015;97;253;578;1634;675;1887
510523;202011;1105;2678;818;2237;175;458;474;1343;649;1801
510525;202011;7050;19165;5214;15572;790;2576;2541;7194;3331;9770
510530;202011;535;1371;389;1158;28;89;254;746;282;835
510550;202011;2170;6450;1573;5419;360;1298;721;2498;1081;3796
510558;202011;2257;6016;1620;5013;224;655;732;2489;956;3144
510560;202011;1456;4163;874;2999;183;709;216;811;399;1520
510562;202011;5391;13913;3949;11347;948;2943;1324;4004;2272;6947
510590;202011;2925;7322;2158;6320;167;504;1550;4652;1717;5156
510600;202011;1283;2934;851;2303;151;413;397;1076;548;1489
510610;202011;2469;5960;1692;4967;167;550;1078;3185;1245;3735
510615;202011;2516;6249;1765;5051;285;865;970;2830;1255;3695
510617;202011;949;2879;734;2535;98;388;472;1684;570;2072
510618;202011;1140;3011;801;2447;179;594;375;1100;554;1694
510619;202011;739;1830;469;1376;62;189;141;393;203;582
510620;202011;1390;3118;643;1897;173;627;34;71;207;698
510621;202011;1503;4036;899;2856;193;697;286;829;479;1526
510622;202011;4377;12198;2954;9206;965;3245;412;1185;1377;4430
510623;202011;2534;6289;1809;5145;452;1485;593;1633;1045;3118
510624;202011;1544;3919;746;2447;94;340;184;548;278;888
510625;202011;2742;6637;1450;4337;241;857;329;998;570;1855
510626;202011;1395;3390;865;2541;229;776;203;621;432;1397
510627;202011;605;1548;326;1011;79;270;80;263;159;533
510628;202011;1365;3165;908;2554;178;538;345;948;523;1486
510629;202011;1497;4227;1085;3475;208;719;404;1293;612;2012
510630;202011;3262;8976;1889;6371;436;1565;339;1238;775;2803
510631;202011;564;1344;413;1117;12;29;316;886;328;915
510637;202011;3340;7971;2401;6626;604;1887;687;1917;1291;3804
510642;202011;5156;14659;3894;12746;921;3300;1742;5788;2663;9088
510645;202011;964;1833;571;1339;177;381;223;546;400;927
510650;202011;6820;17436;5388;15860;605;1611;3697;12062;4302;13673
510665;202011;1786;3874;1128;2815;243;570;419;1140;662;1710
510670;202011;429;917;246;651;25;66;137;370;162;436
510675;202011;6015;16470;4123;12953;1152;3964;798;2408;1950;6372
510677;202011;2050;5204;1404;4245;190;671;768;2260;958;2931
510680;202011;664;1681;369;1125;72;247;80;214;152;461
510682;202011;1393;4092;1018;3478;354;1354;242;798;596;2152
510685;202011;458;1351;334;1101;53;187;179;587;232;774
510700;202011;3885;9285;2716;7670;246;763;2036;5734;2282;6497
510704;202011;10085;23625;6637;17734;1516;4332;1693;4433;3209;8765
510706;202011;1969;5858;1374;4868;260;939;731;2806;991;3745
510710;202011;2514;6286;1646;4627;361;1065;547;1488;908;2553
510715;202011;562;1222;402;1001;30;95;206;503;236;598
510718;202011;2247;5061;1305;3794;365;1071;473;1660;838;2731
510719;202011;439;921;252;675;22;62;149;376;171;438
510720;202011;803;1893;540;1493;89;280;266;698;355;978
510724;202011;774;2086;538;1648;75;239;295;880;370;1119
510726;202011;1018;1842;535;1261;66;172;257;616;323;788
510729;202011;576;1341;255;734;31;104;63;197;94;301
510730;202011;2804;6735;1887;5341;238;771;974;2680;1212;3451
510735;202011;991;2808;749;2469;70;293;552;1794;622;2087
510740;202011;904;2239;576;1623;102;293;263;732;365;1025
510757;202011;463;1458;366;1312;110;441;141;479;251;920
510760;202011;41440;90502;24683;65006;4998;15165;7940;19284;12938;34449
510770;202011;4067;9222;2775;7589;223;584;1910;5453;2133;6037
510774;202011;333;834;231;674;33;96;126;377;159;473
510775;202011;588;1548;370;1190;75;271;83;245;158;516
510776;202011;410;1031;286;805;66;181;101;305;167;486
510777;202011;1436;3844;1018;3303;143;534;648;2091;791;2625
510779;202011;669;1804;519;1562;58;165;298;982;356;1147
510780;202011;3564;9120;2627;7780;638;1853;1147;3830;1785;5683
510785;202011;1846;4850;1077;3488;293;1027;176;660;469;1687
510787;202011;2508;7052;1645;5269;505;1727;191;630;696;2357
510788;202011;562;1342;402;1093;61;177;191;590;252;767
510790;202011;16903;43095;10431;31278;2258;7587;1856;4973;4114;12560
510792;202011;8625;23699;5335;17231;1158;4197;888;2566;2046;6763
510794;202011;1108;2990;758;2382;252;870;145;406;397;1276
510795;202011;7771;20195;5037;15281;1133;3811;1370;4070;2503;7881
510800;202011;1592;4065;1020;3104;328;1020;123;363;451;1383
510805;202011;1388;3883;978;3117;234;797;333;969;567;1766
510810;202011;593;1207;366;906;102;254;142;378;244;632
510820;202011;725;1374;401;961;33;96;211;513;244;609
510830;202011;792;1915;569;1633;39;116;420;1278;459;1394
510835;202011;520;1255;347;1005;39;133;216;606;255;739
510840;202011;54065;113310;36346;91703;7097;16774;17755;49752;24852;66526
510850;202011;1678;4025;958;2884;318;1091;118;326;436;1417
510860;202011;2102;5555;1280;4145;396;1511;110;348;506;1859
510880;202011;706;1985;527;1648;128;423;191;599;319;1022
510885;202011;596;1420;398;1138;77;234;131;376;208;610
510890;202011;615;1791;455;1510;110;382;199;669;309;1051
510895;202011;1240;3130;816;2439;152;545;359;1006;511;1551
520005;202011;2565;6484;1971;5752;573;1677;806;2741;1379;4418
520010;202011;2213;6275;1584;5066;388;1375;501;1424;889;2799
520013;202011;2703;6895;1758;5162;391;1180;501;1608;892;2788
520015;202011;483;1206;343;1000;80;235;138;423;218;658
520017;202011;1162;2907;866;2456;186;552;438;1237;624;1789
520020;202011;386;852;294;740;23;73;231;558;254;631
520025;202011;31982;89244;27389;82800;2705;8876;19813;59618;22518;68494
520030;202011;5494;13834;4401;12312;295;899;3159;8804;3454;9703
520050;202011;384;904;239;654;14;39;153;431;167;470
520055;202011;1746;4178;1123;2979;108;269;641;1665;749;1934
520060;202011;1384;3727;1004;3045;246;845;275;820;521;1665
520080;202011;1692;4451;1288;3898;224;689;639;2111;863;2800
520082;202011;913;2303;710;1966;77;207;383;1108;460;1315
520085;202011;801;2110;621;1822;112;343;310;899;422;1242
520090;202011;817;1599;560;1320;65;108;422;1054;487;1162
520110;202011;35934;96027;24637;77150;7441;26678;2251;6423;9692;33101
520120;202011;192;455;110;321;12;44;47;133;59;177
520130;202011;3606;8772;2817;7558;568;1528;1211;3356;1779;4884
520140;202011;38411;101616;26242;80791;9328;31245;3457;11119;12785;42364
520145;202011;591;1329;406;1074;60;180;244;594;304;774
520150;202011;611;1380;447;1186;75;200;243;653;318;853
520160;202011;698;1618;506;1324;104;260;218;619;322;879
520170;202011;4626;9340;3069;7576;157;452;2385;5838;2542;6290
520180;202011;2177;5875;1775;5306;315;1028;987;2926;1302;3954
520215;202011;1602;3866;1132;3135;264;784;393;1040;657;1824
520235;202011;568;1300;324;929;35;121;125;346;160;467
520250;202011;1437;3647;1004;2922;319;994;243;785;562;1779
520260;202011;778;1800;500;1362;96;269;203;564;299;833
520280;202011;699;1698;545;1463;113;308;262;750;375;1058
520310;202011;986;2137;650;1641;141;400;257;684;398;1084
520320;202011;1550;4161;1159;3519;153;505;640;1897;793;2402
520330;202011;3853;10239;2785;8504;398;1443;1496;4464;1894;5907
520340;202011;2443;5353;1518;4067;185;467;875;2458;1060;2925
520350;202011;2645;6285;1892;5171;551;1584;749;2080;1300;3664
520355;202011;1798;4876;1278;3859;432;1400;256;667;688;2067
520357;202011;701;1678;500;1383;27;67;376;1080;403;1147
520360;202011;673;1765;519;1508;137;418;157;484;294;902
520380;202011;1373;3402;806;2346;87;265;403;1098;490;1363
520390;202011;963;2099;560;1601;154;472;196;609;350;1081
520393;202011;474;1136;315;886;39;123;145;385;184;508
520396;202011;827;2103;688;1890;40;130;512;1376;552;1506
520400;202011;1580;3849;1221;3359;151;462;841;2293;992;2755
520410;202011;1843;4195;1123;3079;196;575;432;1135;628;1710
520420;202011;356;823;279;707;20;54;219;532;239;586
520425;202011;1353;3276;736;2136;185;567;133;372;318;939
520430;202011;2227;5072;1255;3572;223;743;36;101;259;844
520440;202011;2762;6694;1667;4759;402;1253;443;1199;845;2452
520450;202011;11271;26469;7441;20741;2310;7090;1526;4409;3836;11499
520455;202011;676;1850;491;1568;140;476;135;450;275;926
520460;202011;1000;2311;776;2026;64;145;634;1685;698;1830
520465;202011;711;1812;574;1628;72;241;414;1132;486;1373
520470;202011;1966;5083;1493;4449;468;1458;559;1779;1027;3237
520480;202011;877;2406;605;1950;193;652;146;483;339;1135
520485;202011;1508;4279;1264;3940;149;473;914;2849;1063;3322
520490;202011;3841;10573;2892;9039;981;3170;1043;3404;2024;6574
520495;202011;1537;3392;1176;2905;47;119;963;2373;1010;2492
520500;202011;1139;3080;771;2356;184;601;320;976;504;1577
520505;202011;761;1667;522;1366;59;165;340;879;399;1044
520510;202011;7117;17613;4732;13962;1056;3480;1420;4469;2476;7949
520520;202011;1127;2812;831;2348;195;598;304;860;499;1458
520530;202011;1998;5582;1528;4809;391;1320;678;2181;1069;3501
520540;202011;2784;7203;1753;5198;318;1028;474;1310;792;2338
520545;202011;891;2313;667;1945;138;403;277;818;415;1221
520547;202011;764;2081;614;1827;150;456;308;915;458;1371
520549;202011;13281;35063;11054;31887;1424;4369;7611;21782;9035;26151
520551;202011;4408;11810;3653;10695;370;1262;2623;7507;2993;8769
520552;202011;798;2048;657;1867;138;383;377;1144;515;1527
520570;202011;486;1085;326;861;84;192;129;389;213;581
520580;202011;2121;4827;1606;4224;112;356;1192;3080;1304;3436
520590;202011;1228;3020;845;2409;273;783;223;658;496;1441
520620;202011;7453;20210;5876;17893;1458;4599;2628;8333;4086;12932
520630;202011;679;1762;491;1427;86;264;155;420;241;684
520640;202011;2274;5579;1713;4606;395;1041;747;2087;1142;3128
520650;202011;833;1915;621;1628;89;235;348;971;437;1206
520660;202011;507;1223;270;808;50;171;73;218;123;389
520670;202011;917;2458;771;2250;61;190;521;1491;582;1681
520680;202011;649;1655;500;1424;74;207;266;771;340;978
520690;202011;290;683;197;545;58;147;60;190;118;337
520710;202011;388;946;278;762;12;29;200;540;212;569
520725;202011;1409;3309;968;2605;108;338;612;1585;720;1923
520735;202011;713;1768;471;1361;100;272;181;566;281;838
520740;202011;2019;4530;1530;3960;259;620;881;2468;1140;3088
520750;202011;643;1537;439;1208;79;214;210;584;289;798
520753;202011;1173;3180;890;2650;174;555;365;1006;539;1561
520760;202011;1185;2649;1040;2475;29;54;955;2307;984;2361
520780;202011;1385;3264;1007;2727;115;315;522;1408;637;1723
520790;202011;3303;7829;2335;6257;336;921;1257;3526;1593;4447
520800;202011;15392;39926;12019;34934;1766;5363;7175;21391;8941;26754
520810;202011;1270;2672;953;2309;158;389;616;1580;774;1969
520815;202011;524;1621;401;1359;75;277;119;414;194;691
520830;202011;1835;3833;1296;3226;52;104;1074;2663;1126;2767
520840;202011;2509;6695;2034;6076;847;2752;557;1776;1404;4528
520850;202011;612;1550;457;1323;146;491;128;375;274;866
520860;202011;6164;16444;4468;13690;1186;3938;1635;4919;2821;8857
520870;202011;102046;235257;68308;184893;14660;43052;24934;66408;39594;109460
520880;202011;6459;18502;4952;15762;1111;3708;1895;6080;3006;9788
520890;202011;3797;9053;2568;7132;497;1520;1143;3135;1640;4655
520910;202011;4494;11234;2831;8359;684;2192;680;1950;1364;4142
520915;202011;695;1946;402;1278;70;241;138;419;208;660
520920;202011;4292;9594;3006;7974;389;1070;1633;4522;2022;5592
520929;202011;658;1533;494;1297;62;133;265;747;327;880
520940;202011;899;2405;707;2135;38;111;528;1573;566;1684
520945;202011;478;1048;377;909;14;33;271;644;285;677
520960;202011;1032;2455;811;2119;192;443;427;1176;619;1619
520970;202011;2404;6561;1864;5684;452;1551;489;1615;941;3166
520980;202011;738;1799;538;1530;90;276;226;623;316;899
520990;202011;2916;7715;2316;6940;343;977;1532;4689;1875;5666
520993;202011;1113;2612;769;2082;113;346;432;1111;545;1457
520995;202011;2221;5595;1645;4784;257;752;653;1979;910;2731
521000;202011;8169;21169;5337;16104;1055;3297;1647;4936;2702;8233
521010;202011;3408;8851;2556;7367;243;700;1511;4330;1754;5030
521015;202011;771;1898;535;1481;40;127;335;885;375;1012
521020;202011;3135;7954;1811;5388;538;1804;123;389;661;2193
521030;202011;494;1077;330;828;71;158;136;370;207;528
521040;202011;7326;17864;5376;14790;1161;3329;2268;6391;3429;9720
521056;202011;891;2328;698;2043;218;629;194;642;412;1271
521060;202011;928;2480;686;2031;106;329;286;847;392;1176
521080;202011;1087;2324;555;1502;79;230;233;552;312;782
521090;202011;3060;8174;2046;6143;554;1786;262;834;816;2620
521100;202011;1630;3831;1192;3208;188;485;727;1991;915;2476
521120;202011;4366;10378;3207;8935;177;459;1599;5175;1776;5634
521130;202011;960;2133;539;1411;16;48;286;795;302;843
521140;202011;1208;3101;883;2530;109;328;436;1266;545;1594
521150;202011;11823;25749;7297;19287;1201;3698;3473;9395;4674;13093
521160;202011;598;1246;427;997;49;108;285;648;334;756
521170;202011;983;2297;715;1900;52;148;476;1230;528;1378
521180;202011;7056;19290;5770;17070;926;2982;3049;8768;3975;11750
521190;202011;10401;25565;5996;18201;1507;4914;1260;4049;2767;8963
521200;202011;670;1615;467;1288;44;129;272;754;316;883
521205;202011;612;1500;458;1252;16;49;351;920;367;969
521210;202011;628;1599;363;1072;69;219;74;167;143;386
521220;202011;3395;8256;2194;6393;365;1185;857;2504;1222;3689
521225;202011;377;792;276;682;52;118;153;394;205;512
521230;202011;1289;3254;1137;3069;351;950;570;1664;921;2614
521250;202011;29137;77233;22531;67464;8278;25814;6689;21493;14967;47307
521260;202011;514;1201;377;982;57;146;220;560;277;706
521270;202011;1775;4426;1547;4161;77;178;1208;3269;1285;3447
521280;202011;1717;4589;1279;3861;302;1006;552;1680;854;2686
521290;202011;469;1085;323;898;41;134;207;560;248;694
521295;202011;1075;2354;830;2086;62;106;691;1793;753;1899
521300;202011;1829;4479;1439;3928;272;688;892;2529;1164;3217
521305;202011;701;1644;492;1338;75;189;282;781;357;970
521308;202011;4649;12334;3191;9568;297;875;1887;5567;2184;6442
521310;202011;7655;19545;5347;15678;1148;3693;2311;6495;3459;10188
521340;202011;389;897;281;743;22;59;184;478;206;537
521350;202011;1974;5010;1493;4290;124;454;1061;2899;1185;3353
521370;202011;1183;2997;694;2154;206;728;88;298;294;1026
521375;202011;1183;2867;796;2309;182;530;248;805;430;1335
521377;202011;1463;3087;1076;2613;98;165;861;2204;959;2369
521380;202011;5984;15728;3815;11723;418;1402;1009;3346;1427;4748
521385;202011;626;1491;486;1310;50;128;282;820;332;948
521390;202011;655;1623;463;1334;136;427;175;527;311;954
521400;202011;2554;5911;1991;5230;216;540;1380;3735;1596;4275
521405;202011;1267;3241;913;2618;165;488;456;1292;621;1780
521410;202011;778;2084;573;1723;96;281;289;921;385;1202
521440;202011;1097;2720;784;2258;262;832;224;655;486;1487
521450;202011;3803;11185;2766;9178;736;2446;695;2515;1431;4961
521460;202011;5337;13956;3704;11062;1231;3837;868;2675;2099;6512
521470;202011;559;1490;333;1025;44;123;111;338;155;461
521480;202011;350;878;210;616;46;133;68;194;114;327
521483;202011;2296;5424;1592;4366;331;974;648;1753;979;2727
521486;202011;1720;4079;1292;3477;82;208;925;2486;1007;2694
521487;202011;390;935;270;770;41;117;141;415;182;532
521490;202011;882;2326;657;1958;38;132;446;1285;484;1417
521500;202011;2185;5241;1622;4394;95;314;1197;3168;1292;3482
521520;202011;705;1639;500;1340;73;200;205;564;278;764
521523;202011;11487;34621;9358;31194;2628;9594;2442;8444;5070;18038
521525;202011;1028;2325;779;1983;85;214;557;1420;642;1634
521530;202011;2169;5545;1289;3781;270;805;362;1074;632;1879
521540;202011;810;2025;557;1622;73;243;276;830;349;1073
521550;202011;1550;3940;831;2471;146;499;219;662;365;1161
521560;202011;4339;11308;2962;9446;442;1639;1509;5131;1951;6770
521565;202011;627;1492;477;1285;70;174;294;784;364;958
521570;202011;3108;8555;2093;6564;415;1523;181;608;596;2131
521580;202011;470;1121;265;775;38;118;86;230;124;348
521590;202011;614;1434;452;1210;77;229;268;699;345;928
521600;202011;360;960;231;706;28;70;108;328;136;398
521630;202011;1630;3537;998;2619;200;569;343;878;543;1447
521640;202011;1766;4060;1164;3199;247;720;417;1128;664;1848
521645;202011;543;1399;342;1031;86;245;104;318;190;563
521680;202011;1056;3183;803;2696;233;850;134;497;367;1347
521690;202011;532;1273;440;1152;59;167;279;713;338;880
521710;202011;3073;7550;1948;5716;358;1199;510;1379;868;2578
521720;202011;2099;4825;1342;3686;133;417;762;2103;895;2520
521730;202011;3381;9318;2571;7914;699;2558;763;1969;1462;4527
521740;202011;3682;9539;2764;8205;647;2079;1052;3285;1699;5364
521760;202011;14010;38143;10757;33147;2711;9237;4082;13217;6793;22454
521770;202011;2974;7012;1919;5333;560;1671;494;1397;1054;3068
521800;202011;6242;16563;4503;13682;985;3056;1853;6109;2838;9165
521805;202011;441;1085;338;936;102;257;150;428;252;685
521810;202011;594;1400;422;1166;56;159;258;718;314;877
521830;202011;5380;14803;4251;13052;277;1030;3077;9269;3354;10299
521839;202011;713;1679;501;1337;82;252;276;657;358;909
521850;202011;5180;11961;3235;9077;558;1767;652;1761;1210;3528
521860;202011;1419;3783;977;2997;176;585;305;924;481;1509
521870;202011;667;1850;474;1472;95;328;127;352;222;680
521878;202011;638;1639;435;1241;54;183;240;618;294;801
521880;202011;17575;42690;11857;33830;2983;8936;4283;12420;7266;21356
521890;202011;2929;7591;1928;5823;539;1779;375;1038;914;2817
521900;202011;1432;3321;790;2331;227;639;79;238;306;877
521910;202011;1204;2539;787;2050;70;188;440;1258;510;1446
521920;202011;484;1310;352;1083;61;210;157;465;218;675
521925;202011;728;1859;525;1557;74;230;299;882;373;1112
521930;202011;5202;12390;3408;9659;865;2309;1283;4074;2148;6383
521935;202011;1038;2458;693;1850;65;188;406;1030;471;1218
521940;202011;1280;2769;810;2141;192;567;331;858;523;1425
521945;202011;598;1582;484;1393;104;307;263;772;367;1079
521950;202011;728;1746;502;1390;123;346;205;556;328;902
521960;202011;696;1796;452;1337;53;172;237;647;290;819
521970;202011;2469;6059;1969;5462;164;457;1492;4182;1656;4639
521971;202011;717;1682;507;1366;146;390;148;405;294;795
521973;202011;1361;3492;1094;3113;40;104;877;2489;917;2593
521975;202011;11408;30026;9333;27119;1555;4663;5811;16996;7366;21659
521980;202011;2457;5740;1893;4995;144;373;1435;3888;1579;4261
521990;202011;1011;2873;805;2502;182;596;290;900;472;1496
522000;202011;2536;6620;2043;6018;305;899;1265;3908;1570;4807
522005;202011;319;771;236;646;46;126;118;328;164;454
522010;202011;3868;9344;2709;7480;575;1759;1034;2755;1609;4514
522015;202011;982;2541;723;2150;230;661;262;818;492;1479
522020;202011;5388;12709;3488;9706;703;2053;1392;4025;2095;6078
522026;202011;751;1978;495;1523;88;299;180;511;268;810
522028;202011;407;986;301;817;68;189;129;356;197;545
522040;202011;3006;6734;2131;5569;264;739;1450;3739;1714;4478
522045;202011;16689;45979;12226;38061;2897;9723;3414;10389;6311;20112
522050;202011;1063;2773;721;2181;197;661;257;680;454;1341
522060;202011;2841;7382;1973;5947;174;539;1145;3555;1319;4094
522068;202011;1737;4444;1375;4009;113;306;1091;3221;1204;3527
522070;202011;635;1517;516;1344;18;50;433;1113;451;1163
522100;202011;706;1794;477;1440;61;209;252;729;313;938
522108;202011;1008;2499;784;2179;55;186;627;1691;682;1877
522119;202011;1578;3789;1203;3295;201;559;605;1786;806;2345
522130;202011;384;986;273;830;23;70;194;605;217;675
522140;202011;17435;45661;11994;35904;3086;9886;3280;9417;6366;19303
522145;202011;767;1890;517;1510;143;408;183;542;326;950
522150;202011;983;2412;698;1953;192;541;214;628;406;1169
522155;202011;1063;2653;813;2257;155;380;461;1332;616;1712
522157;202011;584;1369;479;1236;26;81;379;981;405;1062
522160;202011;5586;14345;3580;10665;981;3151;293;956;1274;4107
522170;202011;2511;6395;1882;5464;278;819;1077;3192;1355;4011
522180;202011;524;1213;332;866;57;158;82;229;139;387
522185;202011;18919;46303;13223;38463;5103;16182;2735;8685;7838;24867
522190;202011;744;1773;498;1348;90;261;200;520;290;781
522200;202011;1533;4347;1018;3382;212;768;192;579;404;1347
522205;202011;1671;3872;1269;3332;145;403;848;2236;993;2639
522220;202011;1237;3054;916;2566;110;327;543;1542;653;1869
522230;202011;1103;2760;875;2436;198;671;426;1102;624;1773
530010;202011;160947;429457;128891;382569;19198;62546;77454;226341;96652;288887
110001;202010;3985;11127;2652;8619;605;2107;1022;3388;1627;5495
110002;202010;13146;33855;9271;27151;2550;7969;2457;7296;5007;15265
110003;202010;633;1854;442;1458;103;364;115;361;218;725
110004;202010;11701;30243;7727;23117;1616;5281;2224;6775;3840;12056
110005;202010;2561;6621;1732;5238;357;1180;456;1500;813;2680
110006;202010;1795;4987;1095;3486;190;699;213;646;403;1345
110007;202010;1222;3126;773;2361;245;804;187;705;432;1509
110008;202010;3332;9126;2434;7751;276;854;1600;5443;1876;6297
110009;202010;4390;12218;2795;9299;592;2086;1122;3760;1714;5846
110010;202010;7928;25018;5749;20706;1153;4221;2794;10887;3947;15108
110011;202010;7028;18619;4738;14441;1644;5269;652;2087;2296;7356
110012;202010;16077;40073;9420;28224;2117;6921;859;2727;2976;9648
110013;202010;5397;15531;3795;12242;1508;5155;465;1666;1973;6821
110014;202010;3943;10339;2683;7948;571;1803;1115;3201;1686;5004
110015;202010;5861;14981;3415;10187;736;2402;796;2168;1532;4570
110018;202010;3876;9753;2196;6742;424;1505;593;1820;1017;3325
110020;202010;76599;182221;54583;151862;12162;34976;21933;67436;34095;102412
110025;202010;5266;12663;3473;9564;714;2105;1536;4248;2250;6353
110026;202010;534;1328;385;1114;86;282;162;490;248;772
110028;202010;6920;17521;4097;12381;1014;3352;622;1895;1636;5247
110029;202010;1558;3801;899;2638;199;599;317;982;516;1581
110030;202010;13035;29953;7936;22293;1687;5549;1487;4528;3174;10077
110032;202010;3284;9168;1982;6384;621;2008;387;1356;1008;3364
110033;202010;3757;11602;2846;9916;997;3538;702;2733;1699;6271
110034;202010;3437;7993;2261;6368;682;2165;750;2295;1432;4460
110037;202010;1674;4922;1246;4165;271;889;598;2068;869;2957
110040;202010;2994;8279;2139;6692;613;2077;651;1983;1264;4060
110045;202010;5099;14609;3738;12070;979;3417;1270;4190;2249;7607
110050;202010;1861;5003;1302;4030;501;1702;217;693;718;2395
110060;202010;899;2654;608;1962;203;709;77;246;280;955
110070;202010;1631;5100;1181;4092;373;1383;239;744;612;2127
110080;202010;6441;14865;4762;12865;672;1705;3082;8913;3754;10618
110090;202010;610;1624;420;1277;92;308;186;557;278;865
110092;202010;1209;3460;851;2783;152;517;418;1474;570;1991
110094;202010;2834;8416;2109;7027;878;3121;289;969;1167;4090
110100;202010;1717;5042;1368;4364;370;1256;571;1852;941;3108
110110;202010;1739;4745;1199;3827;396;1298;267;947;663;2245
110120;202010;1336;3841;1007;3196;235;823;344;1056;579;1879
110130;202010;2774;6909;1712;4964;281;911;380;1028;661;1939
110140;202010;2134;6252;1440;4809;351;1240;403;1383;754;2623
110143;202010;1400;3808;954;2907;285;883;158;492;443;1375
110145;202010;904;2346;546;1680;125;401;194;612;319;1013
110146;202010;475;1233;333;1013;68;187;162;540;230;727
110147;202010;798;2073;500;1484;69;227;191;493;260;720
110148;202010;807;2207;465;1525;128;483;48;151;176;634
110149;202010;3025;8245;2066;6692;707;2446;430;1478;1137;3924
110150;202010;2814;6825;1846;5448;540;1757;449;1605;989;3362
110155;202010;755;2197;525;1642;112;379;180;529;292;908
110160;202010;1473;4562;1069;3654;314;1094;253;893;567;1987
110170;202010;2203;5651;1346;4015;249;787;688;1982;937;2769
110175;202010;1688;4693;1191;3814;179;616;524;1763;703;2379
110180;202010;1457;3968;1012;3061;147;479;529;1579;676;2058
120001;202010;3302;9642;2696;8747;430;1459;1697;5664;2127;7123
120005;202010;1963;7421;1777;7154;157;701;1418;5790;1575;6491
120010;202010;5413;16125;4573;14866;445;1395;3327;11176;3772;12571
120013;202010;2179;7596;1921;7282;416;1502;1206;4897;1622;6399
120017;202010;2479;7983;2178;7524;350;1214;1371;5019;1721;6233
120020;202010;15303;58624;14031;56152;1090;4885;11056;44571;12146;49456
120025;202010;3156;8903;2526;8140;379;1205;1743;5817;2122;7022
120030;202010;6507;25640;6018;24714;430;2271;4659;19301;5089;21572
120032;202010;1740;7625;1644;7446;109;683;1358;6033;1467;6716
120033;202010;4139;15209;3883;14745;117;676;3394;12746;3511;13422
120034;202010;2696;9730;2302;9036;114;666;1900;7342;2014;8008
120035;202010;3775;14685;3572;14334;289;1373;2933;11766;3222;13139
120038;202010;2719;8690;2311;8017;528;1906;1239;4382;1767;6288
120039;202010;2026;8692;1889;8410;120;755;1524;6720;1644;7475
120040;202010;44685;139887;37852;128670;5340;19213;23530;81096;28870;100309
120042;202010;3398;12503;3127;11999;139;726;2625;9997;2764;10723
120043;202010;1402;5691;1275;5484;39;235;1167;5022;1206;5257
120045;202010;6235;15888;5397;14950;128;513;4901;13429;5029;13942
120050;202010;9372;33779;8560;32526;387;2064;7153;27243;7540;29307
120060;202010;9597;37093;8772;35863;394;2387;7617;30878;8011;33265
120070;202010;3193;10140;2750;9534;259;901;1980;7112;2239;8013
120080;202010;4336;13745;3850;13018;463;1649;2833;9758;3296;11407
130002;202010;3216;12220;2865;11715;201;799;2431;10140;2632;10939
130006;202010;2495;9142;2063;8371;172;710;1549;6329;1721;7039
130008;202010;2688;9370;2374;8912;72;372;2051;7711;2123;8083
130010;202010;4007;11539;3352;10785;86;245;3074;10048;3160;10293
130014;202010;3311;9603;2530;8316;439;1453;1558;5233;1997;6686
130020;202010;2916;11124;2586;10613;135;787;2072;8434;2207;9221
130030;202010;10371;33071;9417;31949;359;1101;8322;28778;8681;29879
130040;202010;4146;12011;3420;11041;201;608;2830;9258;3031;9866
130050;202010;7636;27832;6348;26135;185;905;5737;23876;5922;24781
130060;202010;7738;30169;6610;28687;425;2289;5463;23704;5888;25993
130063;202010;6527;20983;5797;20169;206;868;5265;18427;5471;19295
130068;202010;3929;13433;3310;12528;209;1164;2523;9410;2732;10574
130070;202010;7697;21458;6280;19904;291;880;5187;16988;5478;17868
130080;202010;7415;26051;6453;24933;256;1336;5494;21617;5750;22953
130083;202010;2792;9010;2465;8599;151;592;2090;7351;2241;7943
130090;202010;3607;11077;3191;10552;53;229;2833;9553;2886;9782
130100;202010;8153;24237;6925;22955;71;138;6522;22197;6593;22335
130110;202010;8748;24684;7154;22696;1070;2707;5133;17669;6203;20376
130115;202010;5318;16492;4563;15642;108;375;4014;13984;4122;14359
130120;202010;14395;50621;12628;48252;1111;4649;10217;39446;11328;44095
130130;202010;5500;17085;4228;15398;349;1338;3236;11947;3585;13285
130140;202010;7385;25601;6488;24568;190;1085;5689;21628;5879;22713
130150;202010;3656;13659;3435;13414;79;494;3147;12326;3226;12820
130160;202010;5228;18405;4452;17411;291;1153;3759;15065;4050;16218
130165;202010;3249;12206;3051;11955;123;533;2742;10856;2865;11389
130170;202010;12083;34604;9663;31770;724;2598;7764;26039;8488;28637
130180;202010;4498;14388;4260;14121;41;215;4112;13598;4153;13813
130185;202010;18687;45896;15206;42180;1027;1855;12723;37512;13750;39367
130190;202010;19185;62932;15356;57240;1736;6619;10839;41842;12575;48461
130195;202010;2493;8989;2008;8330;76;440;1693;7002;1769;7442
130200;202010;2631;7310;2160;6695;104;395;1786;5530;1890;5925
130210;202010;1386;5142;1249;4983;100;574;1009;3924;1109;4498
130220;202010;2325;7975;1980;7524;52;292;1745;6648;1797;6940
130230;202010;4800;19282;4160;18364;218;1346;3612;15904;3830;17250
130240;202010;12367;36823;9996;33686;177;1055;8990;30291;9167;31346
130250;202010;26727;78874;22878;74517;1687;4950;18376;62338;20063;67288
130255;202010;4647;15097;4029;14022;157;682;3270;11373;3427;12055
130260;202010;268931;743562;217982;669666;59089;192260;99363;316539;158452;508799
130270;202010;9888;34432;8154;31726;1360;5206;5211;21297;6571;26503
130280;202010;3619;14405;3328;14080;87;441;3106;13291;3193;13732
130290;202010;13590;44222;11731;41834;665;2443;9904;36102;10569;38545
130300;202010;4832;16531;4376;15908;147;811;3809;13808;3956;14619
130310;202010;6408;21111;5554;20011;284;1241;4744;17107;5028;18348
130320;202010;3489;11275;2894;10493;385;1344;2095;7891;2480;9235
130330;202010;4690;14913;3775;13801;217;952;3215;11764;3432;12716
130340;202010;24353;73979;20890;70042;1532;4245;17441;60658;18973;64903
130350;202010;4020;14413;3609;13891;154;793;3173;12164;3327;12957
130353;202010;7667;20535;6139;18596;792;2284;4390;13832;5182;16116
130356;202010;5393;16961;4448;15486;794;2697;2667;9867;3461;12564
130360;202010;3043;9880;2623;9294;94;398;2313;8145;2407;8543
130370;202010;5840;22896;5053;21778;308;1686;4040;17383;4348;19069
130380;202010;7596;31145;7023;30321;412;2286;5950;25487;6362;27773
130390;202010;5927;24849;5238;23685;557;2825;3916;17854;4473;20679
130395;202010;2385;7502;2039;6937;190;661;1551;5305;1741;5966
130400;202010;2868;8721;2443;8153;107;329;2179;7395;2286;7724
130406;202010;11246;38877;9402;36614;1782;6926;6234;25338;8016;32264
130410;202010;4322;15185;3670;14080;1087;4404;1675;6607;2762;11011
130420;202010;14175;48683;11746;45619;1008;4768;9023;35428;10031;40196
130423;202010;4445;13738;3875;13086;202;856;3381;11333;3583;12189
130426;202010;2828;11164;2628;10925;71;379;2423;10148;2494;10527
130430;202010;4341;12142;3744;11346;245;885;3152;9419;3397;10304
130440;202010;4959;15291;4216;14407;81;364;3906;13417;3987;13781
140002;202010;2260;6620;1958;6248;91;354;1645;5315;1736;5669
140005;202010;3368;9232;2930;8724;135;360;2491;7635;2626;7995
140010;202010;57859;153115;46095;135513;11425;35400;19721;59302;31146;94702
140015;202010;3954;11542;3350;10801;226;707;2921;9586;3147;10293
140017;202010;4495;12365;3884;11592;259;709;3184;9801;3443;10510
140020;202010;5368;15507;4604;14503;241;979;3787;11845;4028;12824
140023;202010;2527;7470;2065;6807;200;657;1564;5296;1764;5953
140028;202010;2060;5289;1736;4874;86;273;1404;3936;1490;4209
140030;202010;5353;13554;4727;12833;344;673;4115;11565;4459;12238
140040;202010;2582;10144;2367;9861;92;563;2138;8785;2230;9348
140045;202010;2615;9594;2196;9019;357;1288;1460;6467;1817;7755
140047;202010;6473;18160;5428;16636;595;1851;3903;12144;4498;13995
140050;202010;1472;4270;1237;3931;125;378;934;3061;1059;3439
140060;202010;1744;4537;1501;4179;114;283;1217;3465;1331;3748
140070;202010;1918;9925;1849;9791;123;855;1538;8061;1661;8916
150010;202010;45966;114675;41420;108814;1003;2333;36996;97164;37999;99497
150013;202010;2015;5053;1676;4691;156;302;1301;3898;1457;4200
150020;202010;14624;43702;13497;42228;1578;4115;10871;35247;12449;39362
150030;202010;8948;33390;8129;32377;497;2062;7018;28289;7515;30351
150034;202010;4284;10408;3509;9449;245;590;2915;8045;3160;8635
150040;202010;16565;42715;14524;40455;1303;2001;12094;36716;13397;38717
150050;202010;7020;24272;6387;23433;131;570;5866;21743;5997;22313
150060;202010;22812;61279;18294;54438;2878;8733;11612;35383;14490;44116
150070;202010;6937;25444;6077;24408;241;1109;5421;22003;5662;23112
150080;202010;96015;213682;79165;190508;19287;50805;22257;65637;41544;116442
150085;202010;7954;22628;7204;21741;120;384;6747;20515;6867;20899
150090;202010;10013;36651;9410;35476;784;2893;7441;28381;8225;31274
150095;202010;5789;16632;5028;15684;282;609;4258;13881;4540;14490
150100;202010;2901;10113;2565;9546;212;675;1995;7622;2207;8297
150110;202010;4466;18178;4139;17799;189;860;3802;16482;3991;17342
150120;202010;8288;25499;7845;24974;275;682;6930;22822;7205;23504
150125;202010;770;2026;568;1753;99;369;339;1030;438;1399
150130;202010;22834;65767;19679;60953;3514;9758;12624;41584;16138;51342
150140;202010;264777;604922;222208;545869;33450;79386;127691;326100;161141;405486
150145;202010;4332;13358;3654;12291;973;3017;1882;7096;2855;10113
150150;202010;16380;41728;14240;38977;548;1652;11899;32509;12447;34161
150157;202010;3564;9639;2862;8729;306;920;2001;6408;2307;7328
150160;202010;3064;8973;2836;8640;540;1538;1756;5599;2296;7137
150170;202010;24781;80907;21579;75413;3945;12970;13159;49031;17104;62001
150172;202010;4954;13457;3945;12021;273;738;2961;9346;3234;10084
150175;202010;1649;5167;1372;4631;250;872;782;2679;1032;3551
150178;202010;10665;28435;8812;26284;214;530;7883;23861;8097;24391
150180;202010;22757;79787;20501;77181;1181;3691;17933;69393;19114;73084
150190;202010;6816;22517;6319;21895;230;1041;5635;19407;5865;20448
150195;202010;5186;16448;4876;15961;88;435;4464;14444;4552;14879
150200;202010;5901;17151;5392;16586;65;173;5099;15802;5164;15975
150210;202010;26669;91673;24828;89233;1762;6207;20469;75982;22231;82189
150215;202010;7829;22061;6719;20420;1189;3531;3989;12665;5178;16196
150220;202010;12841;35732;11199;33376;1133;3190;7709;23579;8842;26769
150230;202010;12509;35305;10989;33274;1220;3302;7497;23800;8717;27102
150240;202010;33355;91845;27545;81906;7308;22243;9681;29132;16989;51375
150250;202010;4352;16342;4048;15998;608;2300;3125;12728;3733;15028
150260;202010;2796;8994;2525;8581;155;499;2018;6958;2173;7457
150270;202010;9065;25721;6358;20897;2021;6969;1595;5620;3616;12589
150275;202010;7008;22163;6377;21283;249;933;5502;18316;5751;19249
150276;202010;2395;6271;2044;5853;261;670;1405;4443;1666;5113
150277;202010;5285;13664;4231;12434;334;890;3211;10087;3545;10977
150280;202010;6969;27786;6713;27371;477;1918;5713;23561;6190;25479
150285;202010;3314;11556;2896;10891;247;941;2115;8112;2362;9053
150290;202010;10523;28316;9485;27209;292;602;8564;25186;8856;25788
150293;202010;9561;23393;7271;20381;934;2636;4475;13184;5409;15820
150295;202010;7854;20938;5753;18071;1850;6211;1967;7128;3817;13339
150300;202010;2419;7185;2163;6862;36;127;1971;6289;2007;6416
150304;202010;4175;12280;3426;11117;607;1865;2084;7125;2691;8990
150307;202010;6183;19842;5685;19017;330;1134;4628;15632;4958;16766
150309;202010;6353;18881;5101;16712;874;2835;2849;9786;3723;12621
150310;202010;7407;29141;7048;28712;209;1158;6304;25908;6513;27066
150320;202010;9514;25865;8655;24611;419;1266;6698;19019;7117;20285
150330;202010;14173;45221;13056;43444;1264;3901;9814;33754;11078;37655
150340;202010;2579;7484;2268;7013;341;989;1547;4957;1888;5946
150345;202010;8247;24040;7380;22876;431;1393;6234;19417;6665;20810
150350;202010;9072;22625;8338;21666;713;1330;6845;18373;7558;19703
150360;202010;24633;67114;19672;60840;2111;5160;13878;45993;15989;51153
150370;202010;11070;33281;9060;30561;1055;3005;6501;23691;7556;26696
150375;202010;3642;14522;3279;13998;233;1107;2788;12000;3021;13107
150380;202010;11337;28680;9286;25987;118;449;8211;22979;8329;23428
150390;202010;8041;31905;7195;30570;1098;4053;5093;22998;6191;27051
150400;202010;6676;23653;6392;23127;297;1057;5564;20263;5861;21320
150405;202010;9305;24458;8108;23022;505;1164;6533;19193;7038;20357
150410;202010;1962;6142;1661;5624;229;679;1043;3654;1272;4333
150420;202010;41024;112556;31421;98326;8678;28550;10733;39144;19411;67694
150430;202010;8617;24815;7844;23815;955;2108;6009;19274;6964;21382
150440;202010;5806;18312;5248;17525;967;2833;3383;12085;4350;14918
150442;202010;26973;63533;22097;57424;2355;5939;15240;40524;17595;46463
150445;202010;6351;19535;5565;18339;214;743;4743;15671;4957;16414
150450;202010;5183;21818;4767;21253;390;1843;4039;18151;4429;19994
150460;202010;8488;27697;7750;26757;242;945;6628;23759;6870;24704
150470;202010;21967;56653;19558;53906;363;1021;18388;50698;18751;51719
150475;202010;4969;15500;4270;14449;171;628;3565;12219;3736;12847
150480;202010;13963;44536;12473;42306;2248;6748;8271;30088;10519;36836
150490;202010;8456;29161;7739;28274;309;1234;6792;25010;7101;26244
150495;202010;5348;18057;5099;17707;113;553;4632;15993;4745;16546
150497;202010;2898;9129;2314;8113;507;1806;1206;4561;1713;6367
150500;202010;3354;8535;2960;7978;253;616;2285;6178;2538;6794
150503;202010;4841;12390;3328;10411;978;3302;1063;3820;2041;7122
150506;202010;10488;30951;8784;28636;1881;5366;5426;19694;7307;25060
150510;202010;10054;36202;8658;33588;1322;4778;5587;22969;6909;27747
150520;202010;6985;27337;6678;26954;232;1393;5981;24055;6213;25448
150530;202010;12480;42427;10773;39982;1543;4627;7710;30602;9253;35229
150540;202010;5002;13612;4253;12497;244;655;3531;10445;3775;11100
150543;202010;7459;19874;6128;18199;505;1488;4689;14573;5194;16061
150548;202010;10246;31889;9185;30439;252;1043;8133;27018;8385;28061
150549;202010;2022;5943;1724;5526;48;196;1460;4694;1508;4890
150550;202010;20980;60965;17380;54963;4218;13539;7394;25021;11612;38560
150553;202010;30702;87107;24027;75138;7004;22230;8677;28954;15681;51184
150555;202010;1999;5242;1544;4519;165;371;1048;3245;1213;3616
150560;202010;1889;5681;1669;5245;281;833;975;3200;1256;4033
150563;202010;2596;7708;2174;6980;438;1479;1205;3916;1643;5395
150565;202010;4419;13994;3929;13227;103;443;3278;11147;3381;11590
150570;202010;6340;20112;5896;19492;277;1036;5097;16835;5374;17871
150580;202010;10680;41549;9174;39860;636;3207;7374;33327;8010;36534
150590;202010;8237;28070;7043;26646;174;1024;6405;24149;6579;25173
150600;202010;9817;32251;9099;31377;218;831;8414;29216;8632;30047
150610;202010;2977;8605;2640;8066;86;351;2230;6729;2316;7080
150611;202010;3269;8984;2882;8450;91;337;2539;7395;2630;7732
150613;202010;13801;37629;10404;31796;1899;6162;5152;15692;7051;21854
150616;202010;3583;9708;2596;8062;608;1965;1102;3394;1710;5359
150618;202010;6956;20014;5611;17945;503;1567;3610;12221;4113;13788
150619;202010;6620;18205;5465;16591;210;641;4598;14137;4808;14778
150620;202010;6840;22529;5870;20881;683;2315;3972;14566;4655;16881
150630;202010;6359;17026;5792;16325;391;1039;4864;13822;5255;14861
150635;202010;4911;13380;4109;12095;566;1548;2632;8027;3198;9575
150640;202010;2296;6688;2087;6431;37;102;1936;6045;1973;6147
150650;202010;11714;32403;10149;29878;2970;8281;4441;14307;7411;22588
150655;202010;5848;16672;5284;15853;205;627;4548;13654;4753;14281
150658;202010;4512;12657;3532;11160;558;1849;2100;7030;2658;8879
150660;202010;5795;16468;5126;15523;499;1428;3560;11087;4059;12515
150670;202010;8527;19546;6638;17413;680;1431;5175;14387;5855;15818
150680;202010;70560;204182;54031;177973;12930;41646;23951;89483;36881;131129
150690;202010;2887;7333;2483;6860;79;172;2224;6290;2303;6462
150700;202010;6258;18349;5572;17451;370;928;4400;14214;4770;15142
150710;202010;3827;12633;3467;12052;297;1009;2603;9259;2900;10268
150715;202010;5034;14380;4105;12969;309;931;3201;10313;3510;11244
150720;202010;6993;24506;6480;23709;436;1676;5371;19943;5807;21619
150730;202010;12340;36977;10619;34535;1242;4166;7791;26087;9033;30253
150740;202010;4076;11188;3575;10388;325;781;2676;7988;3001;8769
150745;202010;5131;14439;4111;12928;827;2735;2592;8256;3419;10991
150746;202010;1663;5037;1508;4817;79;248;1240;3977;1319;4225
150747;202010;4967;15569;4358;14569;701;2045;2966;10429;3667;12474
150750;202010;3759;11617;3131;10655;229;826;2346;8273;2575;9099
150760;202010;11997;35167;10845;33567;1478;4180;7666;24489;9144;28669
150770;202010;6556;23033;6164;22587;183;542;5619;21213;5802;21755
150775;202010;955;2627;734;2332;132;466;400;1268;532;1734
150780;202010;4572;13650;4043;13033;155;433;3622;11993;3777;12426
150790;202010;5838;16255;5008;15359;250;598;3868;13390;4118;13988
150795;202010;14254;43572;12395;40685;3043;9433;7032;24656;10075;34089
150796;202010;3931;9463;3411;8868;201;462;2875;7613;3076;8075
150797;202010;4065;12370;3497;11564;145;361;2977;10053;3122;10414
150800;202010;13611;42265;12197;40377;1493;4623;9124;31301;10617;35924
150803;202010;7272;22886;6783;22123;421;1207;5703;18875;6124;20082
150805;202010;3517;10727;2970;9928;215;699;2318;7905;2533;8604
150808;202010;6127;17238;4467;14512;1733;6247;615;2292;2348;8539
150810;202010;21359;55243;16138;48955;3425;10576;8041;27203;11466;37779
150812;202010;5554;15376;4853;14224;427;1312;3586;10324;4013;11636
150815;202010;9772;28315;8142;26395;650;2073;6683;22070;7333;24143
150820;202010;12062;32914;10156;30515;1127;2875;7672;24210;8799;27085
150830;202010;12017;43491;11102;42372;446;1841;9559;37632;10005;39473
150835;202010;2396;7861;2025;7206;347;1213;1158;4191;1505;5404
150840;202010;7796;21654;6183;19057;1009;3356;3483;10641;4492;13997
160005;202010;1245;3368;1102;3190;68;224;924;2698;992;2922
160010;202010;2446;6417;2279;6235;20;105;2212;5979;2232;6084
160015;202010;2829;8190;2503;7789;68;231;2308;7204;2376;7435
160020;202010;2097;6681;1831;6349;164;532;1427;5143;1591;5675
160021;202010;1160;4310;1068;4195;60;327;889;3453;949;3780
160023;202010;1275;4475;1123;4221;120;415;786;3143;906;3558
160025;202010;1869;5617;1770;5504;13;39;1721;5375;1734;5414
160027;202010;9084;25097;8094;23822;648;1823;6511;19569;7159;21392
160030;202010;75368;212085;61048;192447;12991;38487;32325;112609;45316;151096
160040;202010;5892;19612;5360;18934;73;319;5027;17884;5100;18203
160050;202010;4854;14568;3795;13135;1428;4730;1307;5685;2735;10415
160053;202010;3852;11755;3479;11283;281;776;2823;9529;3104;10305
160055;202010;920;2663;883;2621;31;98;818;2431;849;2529
160060;202010;25255;66098;20454;60649;970;2961;16174;50414;17144;53375
160070;202010;2752;10354;2459;9903;198;786;1927;8025;2125;8811
160080;202010;3369;10622;3001;10210;30;156;2806;9615;2836;9771
170025;202010;615;1588;438;1321;68;207;228;713;296;920
170030;202010;1236;3732;949;3223;145;496;461;1618;606;2114
170035;202010;1506;3863;1107;3230;91;287;681;1987;772;2274
170040;202010;1915;5338;1508;4763;104;374;931;3054;1035;3428
170070;202010;1901;4397;1343;3682;88;272;792;2253;880;2525
170100;202010;2477;7025;2056;6318;209;580;1290;4107;1499;4687
170105;202010;744;2142;510;1644;133;374;169;571;302;945
170110;202010;980;2937;747;2492;119;398;360;1182;479;1580
170130;202010;1314;3908;937;3181;179;651;440;1528;619;2179
170190;202010;1437;3972;1037;3323;371;1275;157;658;528;1933
170200;202010;2067;4906;1328;3677;198;571;566;1565;764;2136
170210;202010;25220;68142;19054;57809;6424;21301;2498;8539;8922;29840
170215;202010;1346;3561;1068;3171;40;164;840;2486;880;2650
170220;202010;5904;18168;4925;16384;1346;4295;1945;7146;3291;11441
170230;202010;1238;3669;916;3038;264;888;163;594;427;1482
170240;202010;2643;7322;2042;6348;134;491;1441;4377;1575;4868
170255;202010;3993;11514;2832;9394;497;1698;1281;4345;1778;6043
170270;202010;972;2323;638;1848;40;108;369;1068;409;1176
170290;202010;2907;8523;2495;7985;123;401;1943;6405;2066;6806
170300;202010;2037;5416;1635;4813;195;551;1079;3248;1274;3799
170305;202010;642;1746;528;1548;70;241;270;775;340;1016
170307;202010;983;3293;791;2916;109;414;432;1611;541;2025
170310;202010;1599;3949;1104;3153;175;551;512;1467;687;2018
170320;202010;1037;2695;771;2263;65;203;481;1448;546;1651
170330;202010;922;2808;834;2674;39;179;695;2162;734;2341
170360;202010;517;1405;357;1133;24;85;233;705;257;790
170370;202010;1282;3430;916;2799;284;821;235;853;519;1674
170380;202010;1804;5178;1332;4435;92;367;777;2635;869;3002
170382;202010;549;1623;449;1449;32;128;326;1020;358;1148
170384;202010;1561;5525;1265;4948;256;1039;646;2573;902;3612
170386;202010;962;2595;597;1886;79;278;208;640;287;918
170388;202010;620;1766;432;1422;59;210;200;665;259;875
170389;202010;1032;3182;850;2888;42;169;625;2173;667;2342
170390;202010;1765;3981;1320;3438;41;94;1092;2922;1133;3016
170410;202010;578;1671;420;1380;36;147;248;781;284;928
170460;202010;380;983;302;859;39;107;189;558;228;665
170510;202010;933;2630;687;2188;43;163;446;1360;489;1523
170550;202010;6628;17618;4827;14689;1225;3993;1126;3721;2351;7714
170555;202010;1412;3781;1099;3295;72;222;539;1691;611;1913
170560;202010;1042;2882;782;2520;61;199;498;1708;559;1907
170600;202010;1301;3489;1052;3135;233;547;576;1891;809;2438
170610;202010;1645;4334;1173;3633;91;307;715;2187;806;2494
170625;202010;427;1157;265;826;43;130;87;260;130;390
170650;202010;1252;3676;974;3213;130;442;555;1905;685;2347
170700;202010;3379;9932;2514;8251;497;1645;1118;3760;1615;5405
170710;202010;1516;3950;1150;3369;152;486;711;2095;863;2581
170720;202010;1735;4363;1297;3644;296;880;577;1667;873;2547
170730;202010;1067;2867;792;2416;143;390;401;1300;544;1690
170740;202010;2100;6832;1797;6283;167;642;1274;4438;1441;5080
170755;202010;907;2490;625;2000;63;211;309;971;372;1182
170765;202010;1146;2964;797;2403;160;476;339;1072;499;1548
170770;202010;1863;5359;1508;4805;179;545;981;3228;1160;3773
170820;202010;3364;10077;2646;8757;546;1858;1197;4103;1743;5961
170825;202010;995;2289;803;2031;90;202;579;1482;669;1684
170830;202010;1428;3765;1165;3356;154;418;771;2290;925;2708
170900;202010;2790;8563;2334;7906;217;669;1824;6320;2041;6989
170930;202010;3769;10379;2859;8660;663;2126;941;2848;1604;4974
170950;202010;11406;31389;7797;24812;2166;7863;879;3050;3045;10913
170980;202010;464;1228;368;1079;26;93;252;704;278;797
171050;202010;1638;5079;1418;4700;53;228;1176;3871;1229;4099
171070;202010;1344;3826;1149;3536;316;959;490;1770;806;2729
171090;202010;1060;2591;838;2279;81;219;552;1486;633;1705
171110;202010;576;1539;402;1215;64;192;188;528;252;720
171150;202010;1115;2738;672;1981;63;216;408;1188;471;1404
171180;202010;808;2198;536;1677;101;286;217;691;318;977
171190;202010;1796;5968;1544;5529;247;956;923;3419;1170;4375
171195;202010;814;2569;646;2251;84;344;388;1329;472;1673
171200;202010;577;1603;429;1347;90;296;169;528;259;824
171215;202010;367;1014;300;896;34;115;206;594;240;709
171240;202010;770;2524;614;2214;34;185;411;1448;445;1633
171245;202010;668;1986;517;1670;46;175;319;987;365;1162
171250;202010;1035;2721;751;2294;135;431;341;1067;476;1498
171270;202010;479;1675;373;1447;77;292;164;695;241;987
171280;202010;887;2654;695;2306;66;236;403;1384;469;1620
171320;202010;4045;11246;3096;9561;635;1943;1149;3745;1784;5688
171330;202010;2802;7634;2142;6478;450;1334;958;3026;1408;4360
171360;202010;1403;4045;1107;3610;78;279;788;2647;866;2926
171370;202010;701;1764;531;1524;51;139;359;1040;410;1179
171380;202010;1480;3995;1233;3647;131;366;873;2667;1004;3033
171395;202010;983;2691;683;2129;62;228;426;1281;488;1509
171420;202010;1969;5734;1415;4621;243;844;639;2091;882;2935
171430;202010;1045;3058;859;2711;60;205;582;1765;642;1970
171488;202010;2356;6936;1842;6070;271;876;946;3283;1217;4159
171500;202010;991;2439;744;2065;45;121;569;1594;614;1715
171510;202010;815;2653;703;2437;44;197;491;1675;535;1872
171515;202010;477;1210;340;991;33;94;206;572;239;666
171525;202010;705;1985;530;1702;29;97;300;927;329;1024
171550;202010;350;1008;262;863;35;131;140;451;175;582
171570;202010;1141;3436;952;3095;123;400;558;1865;681;2265
171575;202010;1820;4843;1166;3657;119;397;522;1644;641;2041
171610;202010;5855;16245;4357;13648;896;3187;1191;3986;2087;7173
171620;202010;2605;7343;2183;6735;111;428;1762;5448;1873;5876
171630;202010;985;2560;773;2268;106;309;527;1596;633;1905
171650;202010;2060;5838;1578;5018;397;1379;459;1604;856;2983
171660;202010;2410;6032;1629;4716;236;617;851;2510;1087;3127
171665;202010;1255;3491;970;3024;169;596;446;1400;615;1996
171670;202010;1945;5121;1478;4350;211;682;783;2314;994;2996
171700;202010;1221;3450;885;2834;115;357;468;1543;583;1900
171720;202010;813;2058;640;1790;53;166;460;1261;513;1427
171750;202010;1318;3672;896;2872;226;747;110;445;336;1192
171780;202010;1248;3164;889;2632;98;319;582;1684;680;2003
171790;202010;1425;4613;1169;4084;208;748;557;1974;765;2722
171800;202010;722;1984;537;1704;62;250;305;947;367;1197
171820;202010;11542;32163;8467;26794;2061;6782;2477;8493;4538;15275
171830;202010;1556;4940;1308;4500;132;529;830;2859;962;3388
171840;202010;770;2050;593;1770;26;77;390;1156;416;1233
171845;202010;653;1579;493;1343;50;172;318;834;368;1006
171850;202010;923;3013;777;2684;77;338;537;1790;614;2128
171855;202010;1047;3187;887;2895;69;224;548;1759;617;1983
171865;202010;374;1166;304;1044;51;191;150;493;201;684
171870;202010;825;2255;583;1813;74;222;292;921;366;1143
171875;202010;1290;3727;1022;3290;42;180;764;2458;806;2638
171880;202010;1180;3506;1034;3312;44;131;817;2686;861;2817
171884;202010;887;2512;657;2109;122;454;240;797;362;1251
171886;202010;1380;3793;973;3115;281;1023;191;623;472;1646
171888;202010;731;2020;501;1592;30;108;312;968;342;1076
171889;202010;383;1188;302;1021;65;242;121;401;186;643
171890;202010;1196;3317;857;2766;177;536;471;1574;648;2110
171900;202010;553;1886;403;1508;85;308;163;637;248;945
172000;202010;584;1723;485;1533;55;171;274;842;329;1013
172010;202010;999;3427;849;3120;73;295;521;1898;594;2193
172015;202010;384;1311;282;1099;72;283;107;438;179;721
172020;202010;2712;7638;2383;7203;171;561;1749;5487;1920;6048
172025;202010;720;1970;526;1647;37;139;382;1190;419;1329
172030;202010;1231;3625;1038;3313;59;226;805;2563;864;2789
172049;202010;1320;3153;891;2562;186;498;441;1400;627;1898
172065;202010;1450;3603;1118;3189;103;226;881;2701;984;2927
172080;202010;2370;6935;1907;6130;109;372;1273;4087;1382;4459
172085;202010;476;1285;307;924;52;155;109;309;161;464
172090;202010;4103;10124;3156;8874;130;377;2392;6798;2522;7175
172093;202010;498;1464;352;1199;21;102;202;650;223;752
172097;202010;706;1841;487;1457;62;193;215;651;277;844
172100;202010;49808;122538;34815;98617;6049;18972;12486;36266;18535;55238
172110;202010;1581;5762;1361;5418;134;571;990;4122;1124;4693
172120;202010;5039;14716;3926;12902;499;1730;2220;7509;2719;9239
172125;202010;373;991;279;832;25;83;161;456;186;539
172130;202010;651;1569;505;1337;24;85;357;862;381;947
172208;202010;2578;6288;2062;5618;195;432;1481;4159;1676;4591
172210;202010;2688;6805;2053;5991;324;1033;1174;3567;1498;4600
210005;202010;19032;54486;14445;46777;4183;14117;5432;18463;9615;32580
210010;202010;1947;5951;1755;5715;70;298;1525;4982;1595;5280
210015;202010;3335;9932;2937;9383;156;505;2423;7758;2579;8263
210020;202010;7379;17309;6228;15956;126;403;5653;14463;5779;14866
210030;202010;4722;15556;4339;14971;265;1059;3645;12624;3910;13683
210040;202010;1846;4369;1626;4089;36;95;1390;3420;1426;3515
210043;202010;6225;17702;5252;16358;441;1287;4001;12773;4442;14060
210047;202010;6588;20409;5339;18735;141;727;4599;16116;4740;16843
210050;202010;2247;7525;1761;6623;156;674;1217;4562;1373;5236
210055;202010;1907;6067;1718;5777;73;266;1447;4900;1520;5166
210060;202010;7401;26833;6548;25295;682;2727;4501;17862;5183;20589
210070;202010;7149;20225;6674;19610;47;211;6304;18456;6351;18667
210080;202010;4353;14418;4126;14170;44;261;3801;13133;3845;13394
210083;202010;5598;16018;4579;14932;38;182;4332;14177;4370;14359
210087;202010;3030;8191;2604;7634;109;274;2204;6593;2313;6867
210090;202010;9345;29025;8673;27846;502;1297;7354;23892;7856;25189
210095;202010;6482;20689;5898;19944;251;1077;4900;16894;5151;17971
210100;202010;6830;20720;6078;19512;393;1384;4685;15096;5078;16480
210110;202010;2955;9520;2720;9237;64;361;2430;8192;2494;8553
210120;202010;23088;62771;18977;57355;1918;4697;12777;41265;14695;45962
210125;202010;4439;11811;3861;11130;741;1673;2702;8364;3443;10037
210130;202010;4382;11424;3616;10468;156;326;3050;8948;3206;9274
210135;202010;1455;4370;1245;4027;61;172;1004;3322;1065;3494
210140;202010;19375;50372;14809;44460;2843;8108;8200;26192;11043;34300
210150;202010;4428;10654;3918;9955;149;417;3301;8243;3450;8660
210160;202010;16717;48570;14378;45608;1243;4203;10126;33375;11369;37578
210170;202010;15239;46972;14138;45562;781;2181;12369;40317;13150;42498
210173;202010;2255;8663;2095;8380;107;605;1789;7103;1896;7708
210177;202010;3491;9477;3024;8902;160;350;2609;7978;2769;8328
210180;202010;1453;3862;1274;3648;28;76;1149;3306;1177;3382
210190;202010;5425;14437;4553;13259;76;317;3923;11281;3999;11598
210193;202010;1310;3796;1153;3544;32;140;864;2685;896;2825
210197;202010;2118;6513;1945;6275;153;494;1576;5164;1729;5658
210200;202010;7715;24708;6808;23188;406;1573;5372;18219;5778;19792
210203;202010;7114;20802;6047;19368;431;1440;4763;15585;5194;17025
210207;202010;3997;9668;3076;8689;166;341;2550;7435;2716;7776
210210;202010;8027;26069;7298;25055;166;957;6266;21317;6432;22274
210215;202010;2472;7778;2097;7207;123;634;1552;5253;1675;5887
210220;202010;6154;21252;5823;20743;187;1199;5073;17703;5260;18902
210230;202010;5168;15592;4671;14848;442;1120;3829;12552;4271;13672
210232;202010;11339;35386;9271;32240;1625;5614;5628;21011;7253;26625
210235;202010;3364;10122;2954;9560;169;685;2480;8010;2649;8695
210237;202010;2760;8971;2364;8512;34;199;2182;7855;2216;8054
210240;202010;2617;8179;2393;7780;83;303;1967;6275;2050;6578
210250;202010;5670;17176;5134;16489;80;457;4612;14734;4692;15191
210255;202010;2531;7727;2131;7016;302;1034;1329;4360;1631;5394
210260;202010;5519;16372;4861;15419;254;963;4043;12713;4297;13676
210270;202010;4910;13436;4371;12768;92;427;3890;11269;3982;11696
210275;202010;3537;8848;3071;8266;81;212;2552;6854;2633;7066
210280;202010;5581;15813;4463;14088;261;1009;3260;10156;3521;11165
210290;202010;7308;19401;6513;18411;114;363;6042;17074;6156;17437
210300;202010;33493;90349;27107;81222;1934;6083;19205;59696;21139;65779
210310;202010;3094;7883;2724;7340;129;287;2365;6416;2494;6703
210312;202010;2687;6821;2362;6468;31;137;2215;5998;2246;6135
210315;202010;3000;8269;2553;7760;77;230;2267;7020;2344;7250
210317;202010;4121;12878;3720;12405;147;730;3287;10861;3434;11591
210320;202010;19163;57497;17475;55259;384;1821;15494;48767;15878;50588
210325;202010;3699;10323;3158;9616;112;329;2736;8540;2848;8869
210330;202010;24795;69486;19869;63133;5976;17116;9365;34634;15341;51750
210340;202010;10195;29771;9027;28189;751;2286;6799;21957;7550;24243
210350;202010;9221;26457;8039;25009;157;539;7129;22309;7286;22848
210355;202010;4308;14172;3782;13349;100;492;3202;11366;3302;11858
210360;202010;13748;42696;12235;40446;609;2787;9267;30050;9876;32837
210370;202010;11007;24566;8483;21894;259;432;7723;20448;7982;20880
210375;202010;3295;8727;2511;7662;668;2098;1066;3629;1734;5727
210380;202010;5457;13966;4700;13085;207;484;4023;11320;4230;11804
210390;202010;2585;9048;2382;8693;128;586;1993;7241;2121;7827
210400;202010;4525;13691;4002;13046;137;425;3582;11846;3719;12271
210405;202010;6946;18684;5575;16710;1069;2984;3121;10008;4190;12992
210407;202010;1985;6525;1654;5918;83;355;1326;4681;1409;5036
210408;202010;2538;9372;2370;9119;153;717;1863;7200;2016;7917
210409;202010;3822;13120;3490;12664;117;627;2856;10421;2973;11048
210410;202010;3488;10614;2954;9720;166;654;2217;7241;2383;7895
210420;202010;3865;12249;3489;11587;200;621;2910;9762;3110;10383
210430;202010;2257;6584;1996;6243;87;251;1697;5379;1784;5630
210440;202010;4391;11740;3787;10973;74;274;3438;9879;3512;10153
210450;202010;2416;7155;2067;6649;84;300;1698;5440;1782;5740
210455;202010;4356;11441;3309;10098;958;2962;1506;4879;2464;7841
210460;202010;3734;10573;3153;9825;68;284;2748;8508;2816;8792
210462;202010;1647;4974;1404;4576;39;157;1137;3749;1176;3906
210465;202010;2731;7866;2366;7365;87;398;1848;5601;1935;5999
210467;202010;5946;18753;5159;17708;306;1154;4238;14767;4544;15921
210470;202010;2052;5368;1460;4520;103;224;1103;3579;1206;3803
210480;202010;16400;47869;13491;44263;1145;3433;9865;34984;11010;38417
210490;202010;3716;9367;2987;8355;94;278;2497;6980;2591;7258
210500;202010;6281;24101;5742;23159;377;1845;4686;18769;5063;20614
210510;202010;5974;19682;5219;18864;124;552;4667;17150;4791;17702
210515;202010;3735;10939;3253;10384;259;941;2571;8361;2830;9302
210520;202010;2550;7270;2264;6892;69;243;1928;5814;1997;6057
210530;202010;54355;131992;41945;113544;7005;23229;11156;38032;18161;61261
210535;202010;3107;10448;2903;10124;162;588;2385;8396;2547;8984
210540;202010;14724;42272;12194;38702;1445;4246;8479;28252;9924;32498
210542;202010;6555;15103;5242;13670;344;587;4281;11958;4625;12545
210545;202010;2218;6842;2082;6621;43;180;1836;5775;1879;5955
210547;202010;3594;12785;3172;11950;295;1083;2363;9110;2658;10193
210550;202010;6195;18465;4887;16413;350;1341;3478;11977;3828;13318
210560;202010;3616;10903;3230;10281;127;391;2708;8557;2835;8948
210565;202010;1482;4798;1230;4426;74;392;929;3342;1003;3734
210570;202010;10491;28390;9296;26931;339;955;8011;23669;8350;24624
210580;202010;2991;7965;2459;7309;129;273;1940;6073;2069;6346
210590;202010;4289;12661;3703;11909;73;396;3293;10510;3366;10906
210592;202010;2640;7765;2412;7394;24;117;2042;6174;2066;6291
210594;202010;2507;6750;1908;5825;90;275;1399;4424;1489;4699
210596;202010;2562;9021;2295;8486;108;457;1870;6937;1978;7394
210598;202010;1829;5311;1687;5098;63;258;1471;4371;1534;4629
210600;202010;3097;8151;2497;7309;115;282;1910;5650;2025;5932
210610;202010;2738;7581;2341;7090;65;282;1986;6010;2051;6292
210620;202010;2798;7430;2314;6848;60;180;2052;6100;2112;6280
210630;202010;3009;10076;2742;9640;126;605;2245;7789;2371;8394
210632;202010;4480;14250;3963;13505;238;986;3096;10509;3334;11495
210635;202010;1749;6202;1647;6024;96;352;1354;5042;1450;5394
210637;202010;2448;8073;2116;7593;164;711;1559;5644;1723;6355
210640;202010;4561;16249;4269;15900;69;345;3884;14506;3953;14851
210650;202010;7425;21084;6715;20164;98;357;6053;18173;6151;18530
210660;202010;8170;24101;7197;22538;303;1196;6043;18621;6346;19817
210663;202010;2578;7456;2365;7205;151;356;1997;6295;2148;6651
210667;202010;1950;6320;1750;6024;58;241;1547;5372;1605;5613
210670;202010;4557;15147;4151;14508;124;574;3612;12554;3736;13128
210675;202010;5083;13654;4325;12672;212;511;3610;10885;3822;11396
210680;202010;4634;11126;3864;10194;117;214;3424;9142;3541;9356
210690;202010;7709;23436;6438;22027;248;1053;5686;19617;5934;20670
210700;202010;2731;7659;2145;6801;140;435;1560;5144;1700;5579
210710;202010;4878;15268;4266;14397;107;593;3702;12324;3809;12917
210720;202010;2908;9600;2594;9208;73;426;2243;7888;2316;8314
210725;202010;1302;4362;1136;4113;40;154;827;3128;867;3282
210730;202010;1181;3095;989;2825;49;129;835;2387;884;2516
210735;202010;4700;13582;4001;12653;202;570;3415;11092;3617;11662
210740;202010;5299;14042;4600;13253;92;309;3883;11175;3975;11484
210745;202010;4413;11988;4083;11564;114;356;3692;10418;3806;10774
210750;202010;23523;59787;20275;55676;1909;4798;13875;40450;15784;45248
210760;202010;5965;15598;5035;14614;31;67;4784;14025;4815;14092
210770;202010;6161;15700;5278;14676;66;284;4915;13564;4981;13848
210780;202010;7415;23132;6477;21561;586;1711;4962;16883;5548;18594
210790;202010;4203;13311;3773;12752;184;466;3101;11009;3285;11475
210800;202010;4902;13041;4182;12084;125;496;3640;10360;3765;10856
210805;202010;3934;14205;3732;13907;121;660;3257;12032;3378;12692
210810;202010;4863;14050;4402;13423;321;715;3581;11300;3902;12015
210820;202010;6942;19697;5761;17793;682;2177;3313;10585;3995;12762
210825;202010;6714;20753;6038;19849;269;878;5164;17249;5433;18127
210830;202010;7773;21667;7035;20768;344;785;6117;18498;6461;19283
210840;202010;3193;8505;2846;8033;61;206;2528;7044;2589;7250
210845;202010;6540;17461;5839;16699;27;99;5595;16102;5622;16201
210850;202010;5905;19984;4905;18496;238;1220;3847;14532;4085;15752
210860;202010;21375;54243;17728;49656;980;2326;13962;41388;14942;43714
210870;202010;7351;19059;5794;17274;233;616;5046;15186;5279;15802
210880;202010;4253;13001;3821;12486;187;765;3046;9871;3233;10636
210890;202010;3880;11331;3456;10799;258;684;2755;8930;3013;9614
210900;202010;4599;13353;3491;11252;1354;4679;521;1912;1875;6591
210905;202010;2007;5482;1657;5030;45;76;1508;4697;1553;4773
210910;202010;7271;21916;6005;19835;791;2643;3873;12926;4664;15569
210920;202010;3223;10522;2783;9938;78;431;2466;8717;2544;9148
210923;202010;1534;4562;1309;4201;83;302;919;2959;1002;3261
210927;202010;5200;16364;4559;15598;321;1072;3594;12646;3915;13718
210930;202010;2492;8556;2184;7957;155;633;1632;5936;1787;6569
210940;202010;4090;11476;3781;11110;113;471;3431;9939;3544;10410
210945;202010;6570;18730;5882;17909;240;664;4922;15421;5162;16085
210950;202010;5206;14463;3995;12761;623;1572;2582;9030;3205;10602
210955;202010;1581;4980;1358;4592;138;476;928;3226;1066;3702
210960;202010;9114;26945;7833;25039;1263;3691;5062;17046;6325;20737
210970;202010;1343;4136;1064;3649;86;281;769;2614;855;2895
210975;202010;1756;5459;1570;5165;78;284;1241;4094;1319;4378
210980;202010;10179;23503;8902;22182;101;249;8401;21023;8502;21272
210990;202010;16203;45389;12680;40698;700;2451;9336;30879;10036;33330
211000;202010;14678;42557;12226;39526;806;2693;9332;31494;10138;34187
211003;202010;5679;16802;4750;15690;147;574;4082;13770;4229;14344
211010;202010;6380;22621;5702;21793;177;807;5039;19594;5216;20401
211020;202010;8195;23661;7087;22392;279;1047;5947;19329;6226;20376
211023;202010;1962;6362;1823;6177;93;337;1552;5247;1645;5584
211027;202010;3062;9790;2896;9528;198;535;2491;8290;2689;8825
211030;202010;3856;10607;3431;10087;248;578;2793;8461;3041;9039
211040;202010;4598;16519;4251;15909;132;745;3778;14009;3910;14754
211050;202010;9086;23541;8209;22381;88;307;7479;20352;7567;20659
211060;202010;6940;20910;6324;20078;168;694;5566;17660;5734;18354
211065;202010;2196;6118;1815;5633;107;337;1422;4535;1529;4872
211070;202010;7770;24488;6569;22656;540;1852;5004;17466;5544;19318
211080;202010;1307;3587;1041;3162;36;193;797;2284;833;2477
211085;202010;2060;5756;1753;5348;96;229;1496;4751;1592;4980
211090;202010;3176;8703;2862;8335;37;172;2655;7690;2692;7862
211100;202010;6799;17040;6265;16393;51;160;5808;15275;5859;15435
211102;202010;3104;10425;2829;10025;145;659;2432;8517;2577;9176
211105;202010;2384;7458;1969;6697;180;620;1391;4690;1571;5310
211107;202010;4640;14546;3947;13521;136;612;3126;11064;3262;11676
211110;202010;5921;16119;4594;14096;365;1059;3375;10564;3740;11623
211120;202010;44824;109171;36745;99699;5177;12743;23550;68467;28727;81210
211125;202010;2088;6207;1755;5693;51;184;1478;4819;1529;5003
211130;202010;190698;448525;164368;414364;24580;59422;76241;219882;100821;279304
211140;202010;4984;14697;4342;13859;228;627;3647;11770;3875;12397
211150;202010;9398;25554;7899;23597;343;967;6637;19959;6980;20926
211153;202010;2451;7127;1945;6489;251;877;1274;4423;1525;5300
211157;202010;1130;3546;940;3193;33;154;676;2295;709;2449
211160;202010;4091;11524;3207;10241;154;538;2399;7606;2553;8144
211163;202010;1620;5197;1471;4993;79;331;1264;4292;1343;4623
211167;202010;1527;4829;1426;4664;47;212;1232;3981;1279;4193
211170;202010;6431;15828;5963;15290;58;168;5660;14466;5718;14634
211172;202010;2538;6800;2165;6230;112;357;1652;4610;1764;4967
211174;202010;2850;8199;2574;7892;37;190;2403;7328;2440;7518
211176;202010;4262;12070;3298;10655;161;681;2608;8373;2769;9054
211178;202010;4644;10781;3985;10053;31;139;3778;9446;3809;9585
211180;202010;4063;13289;3757;12840;215;801;3101;10620;3316;11421
211190;202010;3063;8953;2594;8260;36;204;2296;7238;2332;7442
211195;202010;1411;3933;1202;3610;75;148;1007;3120;1082;3268
211200;202010;2148;6085;1715;5485;206;631;1193;3892;1399;4523
211210;202010;6258;19183;5649;18372;261;1085;4767;15342;5028;16427
211220;202010;37282;93411;30324;84825;2876;7539;22324;64149;25200;71688
211223;202010;5315;13916;4377;12678;383;1118;3176;9251;3559;10369
211227;202010;1763;5809;1583;5548;67;324;1228;4336;1295;4660
211230;202010;7582;21847;6605;20368;434;1139;5264;16661;5698;17800
211240;202010;8064;25490;7636;24937;136;746;7090;22880;7226;23626
211245;202010;6996;17579;6245;16802;88;219;6030;16246;6118;16465
211250;202010;13202;41361;11888;39540;735;2755;9605;31855;10340;34610
211260;202010;8082;25973;7183;24781;237;999;6396;22216;6633;23215
211270;202010;10489;33167;8943;31067;387;1750;7217;25260;7604;27010
211280;202010;12887;35185;11462;33386;908;2086;9231;28078;10139;30164
211285;202010;1799;5839;1584;5532;138;530;1152;4118;1290;4648
211290;202010;7473;22342;6717;21351;178;721;5778;18322;5956;19043
211300;202010;7804;22386;6868;20917;204;701;5803;17459;6007;18160
211400;202010;11603;32615;9416;29608;1099;3484;6205;20530;7304;24014
220005;202010;1855;4794;1671;4541;32;110;1417;3782;1449;3892
220010;202010;1494;4255;1218;3760;26;108;941;2885;967;2993
220020;202010;3685;10087;3175;9364;141;494;2609;7631;2750;8125
220025;202010;2246;5099;1925;4628;28;71;1610;3758;1638;3829
220027;202010;1288;3232;1096;2978;21;73;932;2488;953;2561
220030;202010;3365;8452;3143;8156;80;218;2776;7132;2856;7350
220040;202010;7285;21848;6320;19974;1530;4393;3205;10736;4735;15129
220045;202010;1475;4479;1206;4028;31;172;976;3194;1007;3366
220050;202010;4789;12863;4040;11877;63;284;3703;10762;3766;11046
220060;202010;2392;4980;2009;4540;25;60;1883;4240;1908;4300
220070;202010;2460;6165;2095;5629;72;150;1743;4703;1815;4853
220080;202010;741;2076;638;1924;24;85;542;1620;566;1705
220090;202010;1800;4297;1487;3856;20;67;1224;3299;1244;3366
220095;202010;647;1613;603;1566;27;44;541;1429;568;1473
220100;202010;1374;3767;1102;3334;45;151;882;2603;927;2754
220105;202010;2024;6242;1772;5742;114;411;1342;4332;1456;4743
220110;202010;3383;9303;3115;8842;38;189;2784;7793;2822;7982
220115;202010;2736;7876;2529;7598;72;226;2280;6818;2352;7044
220117;202010;1394;3316;1093;2903;7;33;924;2405;931;2438
220120;202010;12947;34346;11800;32921;82;285;11085;30894;11167;31179
220130;202010;1111;2964;946;2736;14;78;856;2448;870;2526
220140;202010;2161;4425;1815;4013;106;265;1582;3449;1688;3714
220150;202010;6350;18727;5784;17775;110;542;4896;14750;5006;15292
220155;202010;1166;3337;928;2900;36;114;648;1993;684;2107
220157;202010;1067;2600;902;2350;22;79;718;1808;740;1887
220160;202010;2879;7917;2478;7191;34;153;2038;5810;2072;5963
220170;202010;1600;4109;1363;3758;12;55;1221;3320;1233;3375
220173;202010;2163;5951;1742;5211;46;196;1383;4011;1429;4207
220177;202010;1994;5617;1887;5498;10;37;1865;5425;1875;5462
220180;202010;1146;2767;928;2403;4;21;718;1740;722;1761
220190;202010;7078;17467;5982;15969;379;1032;4466;12131;4845;13163
220191;202010;1574;4688;1430;4449;83;282;1010;3088;1093;3370
220192;202010;2070;5390;1505;4390;29;93;1212;3472;1241;3565
220194;202010;1738;4897;1538;4583;55;201;1262;3708;1317;3909
220196;202010;2027;5189;1834;4901;28;111;1579;4148;1607;4259
220198;202010;1296;3511;1091;3249;8;38;1005;3011;1013;3049
220200;202010;5176;14773;4499;13900;83;350;3871;11946;3954;12296
220202;202010;2179;6089;1865;5572;28;148;1599;4690;1627;4838
220205;202010;2478;7100;2215;6616;49;185;1866;5501;1915;5686
220207;202010;790;2341;640;2084;61;207;402;1321;463;1528
220208;202010;1687;5129;1385;4541;176;628;805;2598;981;3226
220209;202010;1595;4505;1369;4106;24;100;1125;3336;1149;3436
220210;202010;1751;4233;1499;3841;12;54;1290;3217;1302;3271
220211;202010;1632;4085;1495;3897;16;64;1309;3419;1325;3483
220213;202010;1773;4700;1527;4279;29;102;1224;3342;1253;3444
220217;202010;2199;6443;2047;6267;48;104;1891;5904;1939;6008
220220;202010;10624;27493;8782;24656;598;1479;5861;17383;6459;18862
220225;202010;1040;2699;838;2434;6;36;780;2238;786;2274
220230;202010;5711;14139;4895;13014;159;372;4210;11268;4369;11640
220240;202010;3047;8711;2761;8227;113;357;2244;6686;2357;7043
220245;202010;1790;4071;1370;3552;12;49;1248;3257;1260;3306
220250;202010;2987;8275;2630;7826;17;89;2466;7308;2483;7397
220253;202010;1620;4354;1427;4037;63;207;1198;3306;1261;3513
220255;202010;1937;4493;1648;4086;34;151;1421;3390;1455;3541
220260;202010;4298;13101;3771;12120;166;608;2986;9585;3152;10193
220265;202010;1314;4176;1177;3994;35;180;964;3209;999;3389
220270;202010;6177;19597;5794;18888;215;1029;4832;15236;5047;16265
220271;202010;1506;3815;1305;3539;29;99;1137;3068;1166;3167
220272;202010;1764;5058;1569;4703;51;156;1186;3459;1237;3615
220273;202010;1242;3503;1037;3130;33;124;797;2368;830;2492
220275;202010;2322;5410;1841;4753;38;92;1619;4199;1657;4291
220277;202010;2164;5408;1842;4938;27;72;1555;4102;1582;4174
220280;202010;1676;3873;1388;3497;23;74;1168;2922;1191;2996
220285;202010;1454;3599;1239;3352;11;39;1141;3066;1152;3105
220290;202010;6691;18472;5273;16463;382;1265;3787;12144;4169;13409
220300;202010;1983;5675;1609;5182;35;182;1342;4302;1377;4484
220310;202010;3116;8181;2407;7349;42;207;2013;6105;2055;6312
220320;202010;3065;8901;2352;7546;72;338;1833;5700;1905;6038
220323;202010;1649;4767;1299;4200;56;213;1063;3373;1119;3586
220325;202010;1265;3725;1078;3414;22;107;894;2775;916;2882
220327;202010;1525;4284;1321;3953;44;182;1092;3178;1136;3360
220330;202010;4515;10660;3817;9817;63;197;3443;8801;3506;8998
220335;202010;1675;5013;1504;4796;33;108;1338;4279;1371;4387
220340;202010;1885;4927;1442;4183;59;187;982;2750;1041;2937
220342;202010;1179;3376;1050;3182;51;186;822;2475;873;2661
220345;202010;3132;6996;2407;5957;15;47;2178;5369;2193;5416
220350;202010;3359;8485;2667;7454;141;409;1887;5298;2028;5707
220360;202010;1247;3173;986;2743;19;54;781;2165;800;2219
220370;202010;8701;25118;7885;23808;158;684;6866;20467;7024;21151
220375;202010;1600;4511;1414;4284;2;13;1341;4087;1343;4100
220380;202010;1495;3526;1207;3114;16;44;1054;2689;1070;2733
220385;202010;869;2061;696;1742;7;17;603;1492;610;1509
220390;202010;10567;27177;8066;23274;2064;5849;2814;9088;4878;14937
220400;202010;1513;3553;1149;2998;25;78;879;2211;904;2289
220410;202010;1183;3219;952;2824;51;153;759;2209;810;2362
220415;202010;806;2046;673;1834;21;59;540;1449;561;1508
220420;202010;2050;5645;1641;4868;56;172;1258;3685;1314;3857
220430;202010;2496;6651;2339;6423;74;235;1997;5419;2071;5654
220435;202010;1772;4517;1530;4161;47;159;1254;3335;1301;3494
220440;202010;2394;7426;2042;6877;89;374;1718;5694;1807;6068
220450;202010;2522;6487;2052;5901;63;209;1736;5016;1799;5225
220455;202010;1286;3950;1219;3856;11;59;1085;3430;1096;3489
220460;202010;989;2419;916;2325;37;91;782;1966;819;2057
220465;202010;2345;7220;2062;6773;184;606;1507;5069;1691;5675
220470;202010;3611;9857;3235;9262;95;243;2629;7429;2724;7672
220480;202010;2827;7211;2269;6309;221;497;1459;4130;1680;4627
220490;202010;2495;6169;2153;5735;25;124;1878;4928;1903;5052
220500;202010;2854;7237;2469;6613;61;193;2002;5241;2063;5434
220510;202010;2591;7265;2036;6268;76;208;1581;4904;1657;5112
220515;202010;1657;3971;1516;3776;41;58;1313;3276;1354;3334
220520;202010;4970;12789;4480;12099;105;291;3900;10460;4005;10751
220525;202010;1343;3344;1157;3109;9;42;1062;2816;1071;2858
220527;202010;1296;3620;1102;3338;13;54;943;2905;956;2959
220530;202010;1438;3559;1231;3294;31;99;1127;2986;1158;3085
220535;202010;809;2201;756;2131;29;86;615;1727;644;1813
220540;202010;3246;10262;3031;9854;131;444;2573;8330;2704;8774
220545;202010;1425;4260;1308;4069;69;258;1083;3329;1152;3587
220550;202010;8720;26596;7698;24808;498;1729;5777;18454;6275;20183
220551;202010;1428;4020;1247;3709;28;119;1016;2953;1044;3072
220552;202010;1599;4606;1299;4073;26;129;1044;3155;1070;3284
220553;202010;1757;4481;1451;4077;59;107;1168;3408;1227;3515
220554;202010;908;2342;660;1937;50;119;425;1237;475;1356
220555;202010;2351;6887;2087;6535;42;171;1711;5494;1753;5665
220556;202010;1215;3499;1048;3180;57;228;750;2179;807;2407
220557;202010;1631;4961;1369;4413;68;251;1005;3140;1073;3391
220558;202010;1406;3607;1102;3188;18;74;949;2718;967;2792
220559;202010;1802;4390;1523;3964;12;30;1237;3259;1249;3289
220560;202010;1781;3950;1431;3505;38;73;1303;3218;1341;3291
220570;202010;7194;21373;6535;20445;458;1441;5160;16269;5618;17710
220580;202010;6933;18871;6329;17897;81;289;5727;16083;5808;16372
220585;202010;2030;6372;1677;5717;47;158;1363;4708;1410;4866
220590;202010;1373;3642;1114;3251;72;197;791;2346;863;2543
220595;202010;2556;6901;2310;6562;21;103;2061;5788;2082;5891
220600;202010;1403;3115;1175;2833;88;108;977;2446;1065;2554
220605;202010;1614;4717;1370;4280;19;116;1110;3360;1129;3476
220610;202010;2786;8049;2602;7774;33;140;2428;7236;2461;7376
220620;202010;7885;24152;7249;23294;175;894;6584;20920;6759;21814
220630;202010;371;1082;284;920;22;76;191;613;213;689
220635;202010;1685;5193;1482;4755;50;240;1134;3531;1184;3771
220640;202010;2481;6860;2110;6325;79;309;1703;5051;1782;5360
220650;202010;2072;5686;1795;5265;39;142;1436;4214;1475;4356
220660;202010;2628;8135;2229;7465;79;395;1856;6076;1935;6471
220665;202010;1235;3710;1038;3380;31;173;854;2701;885;2874
220667;202010;1629;5012;1459;4690;57;218;1179;3767;1236;3985
220669;202010;1610;4876;1541;4771;49;235;1365;4129;1414;4364
220670;202010;2204;5673;1768;5060;17;80;1531;4377;1548;4457
220672;202010;3261;7884;2630;7117;100;322;2323;6211;2423;6533
220675;202010;1275;3467;1134;3210;31;99;937;2620;968;2719
220680;202010;2709;7282;2578;7098;103;234;2358;6532;2461;6766
220690;202010;1589;4145;1398;3857;60;162;1106;3064;1166;3226
220695;202010;907;2476;837;2357;21;62;728;2038;749;2100
220700;202010;10015;24526;8041;21801;346;967;6131;16535;6477;17502
220710;202010;904;2469;666;2020;36;108;499;1484;535;1592
220720;202010;2126;4999;1912;4713;17;70;1667;4054;1684;4124
220730;202010;1330;3681;1115;3314;12;65;941;2736;953;2801
220735;202010;985;2270;769;1935;20;68;632;1529;652;1597
220740;202010;1377;3530;1099;3174;30;78;915;2696;945;2774
220750;202010;3852;9734;3358;9025;192;469;2902;7833;3094;8302
220755;202010;1335;3228;1107;2890;22;83;904;2295;926;2378
220760;202010;3154;8553;2751;8012;67;209;2474;7265;2541;7474
220770;202010;23689;69536;19896;62988;5993;20011;6826;22586;12819;42597
220775;202010;1167;2924;1036;2761;14;46;991;2628;1005;2674
220777;202010;1603;4048;1214;3452;31;79;931;2664;962;2743
220779;202010;1295;3267;1114;3006;19;61;973;2608;992;2669
220780;202010;5622;14064;4883;12945;207;655;3982;10315;4189;10970
220785;202010;1491;3258;1303;3017;9;23;1253;2886;1262;2909
220790;202010;10287;28851;9235;27348;216;958;7742;22708;7958;23666
220793;202010;929;2429;735;2087;11;30;611;1756;622;1786
220795;202010;1390;3559;1220;3325;19;70;1086;2949;1105;3019
220800;202010;18194;40074;15374;36349;657;1468;11839;27975;12496;29443
220810;202010;3066;8398;2569;7520;55;162;2106;6107;2161;6269
220820;202010;5012;12974;4319;11963;281;673;3248;9010;3529;9683
220830;202010;7349;19302;6580;18239;252;789;5446;14879;5698;15668
220840;202010;12426;37830;10315;33488;2312;7173;4757;16110;7069;23283
220850;202010;3186;9681;2837;9245;58;301;2504;8173;2562;8474
220855;202010;694;1746;601;1621;16;53;544;1458;560;1511
220860;202010;1054;2602;912;2376;17;68;822;2109;839;2177
220865;202010;2452;6435;1903;5465;90;337;1385;3840;1475;4177
220870;202010;3017;8281;2513;7615;33;167;2309;6975;2342;7142
220880;202010;5337;12472;4575;11527;87;311;4161;10364;4248;10675
220885;202010;1415;4215;1163;3793;54;189;913;3026;967;3215
220887;202010;1598;3374;1331;3029;15;32;1235;2790;1250;2822
220890;202010;1422;4298;1243;4028;47;166;1029;3382;1076;3548
220900;202010;2042;4814;1697;4364;33;80;1485;3802;1518;3882
220910;202010;1528;4144;1277;3779;54;163;1050;3133;1104;3296
220915;202010;971;2606;782;2260;5;20;591;1651;596;1671
220920;202010;1444;4442;1246;4177;57;241;1024;3454;1081;3695
220930;202010;1761;4680;1470;4267;19;63;1366;3951;1385;4014
220935;202010;1093;3127;881;2678;23;96;578;1663;601;1759
220937;202010;1459;3830;1246;3502;24;88;992;2745;1016;2833
220940;202010;1552;4279;1241;3725;37;118;959;2845;996;2963
220945;202010;448;1544;386;1401;20;115;283;986;303;1101
220950;202010;1430;3270;930;2496;18;62;737;1911;755;1973
220955;202010;1633;4120;1353;3635;25;72;1157;3063;1182;3135
220960;202010;814;2048;604;1696;19;60;424;1128;443;1188
220965;202010;1793;4856;1560;4506;21;130;1350;3807;1371;3937
220970;202010;1971;4633;1443;3848;32;86;1211;3193;1243;3279
220975;202010;707;1967;602;1833;16;87;534;1561;550;1648
220980;202010;1150;3230;1017;3051;38;141;841;2498;879;2639
220985;202010;1235;3220;1071;2980;45;129;865;2340;910;2469
220987;202010;1428;4244;1243;3912;55;206;999;3129;1054;3335
220990;202010;1727;4694;1515;4383;19;101;1277;3629;1296;3730
220995;202010;1075;3237;874;2872;38;131;633;2075;671;2206
220997;202010;2374;7120;2190;6826;47;211;1953;6017;2000;6228
221000;202010;4513;12193;3976;11391;84;385;3390;9581;3474;9966
221005;202010;1480;3865;1344;3641;20;111;1166;3041;1186;3152
221010;202010;1255;2818;1001;2510;20;59;863;2115;883;2174
221020;202010;1528;4664;1420;4462;21;80;1074;3339;1095;3419
221030;202010;1662;4068;1419;3773;22;63;1220;3287;1242;3350
221035;202010;1513;3888;1314;3614;23;30;1159;3275;1182;3305
221037;202010;677;1852;559;1648;7;24;396;1118;403;1142
221038;202010;516;1450;400;1241;12;42;275;853;287;895
221039;202010;869;2345;744;2132;23;102;598;1635;621;1737
221040;202010;4052;11969;3526;11027;158;547;2769;8661;2927;9208
221050;202010;3929;10189;3442;9571;67;234;3096;8599;3163;8833
221060;202010;8580;23604;7065;21206;284;765;5705;17277;5989;18042
221062;202010;1176;3754;994;3450;42;188;795;2719;837;2907
221063;202010;1077;2917;920;2692;56;185;713;2042;769;2227
221065;202010;2629;6719;2305;6137;18;62;2032;5319;2050;5381
221070;202010;3376;10395;2721;9023;301;987;1664;5643;1965;6630
221080;202010;3543;8641;2870;7645;64;230;2342;6123;2406;6353
221090;202010;1419;3607;1158;3181;9;34;994;2666;1003;2700
221093;202010;1386;3876;1258;3613;140;387;840;2376;980;2763
221095;202010;893;2308;743;2076;11;35;621;1704;632;1739
221097;202010;843;2175;645;1822;23;70;470;1262;493;1332
221100;202010;118001;313220;97744;278317;10341;31552;62844;173841;73185;205393
221110;202010;9915;29394;9071;28292;144;725;8109;25033;8253;25758
221120;202010;4826;13197;4289;12327;159;485;3716;10658;3875;11143
221130;202010;5454;14072;4061;11369;776;2058;1953;5518;2729;7576
221135;202010;1670;4332;1497;4101;50;148;1316;3612;1366;3760
221140;202010;1340;3118;1125;2842;11;37;1011;2505;1022;2542
221150;202010;1137;2783;873;2321;22;97;675;1676;697;1773
221160;202010;729;1801;639;1683;14;18;520;1376;534;1394
221170;202010;1001;2848;906;2676;21;69;778;2274;799;2343
230010;202010;3077;8037;2521;7076;36;130;2051;5625;2087;5755
230015;202010;3075;9814;2684;9032;169;635;1880;6287;2049;6922
230020;202010;12937;40539;12062;39190;335;1373;10216;33005;10551;34378
230030;202010;13129;32383;10929;29521;200;594;9548;25755;9748;26349
230040;202010;4482;11474;3710;10228;51;238;3087;8360;3138;8598
230050;202010;2800;8629;2101;6970;341;1087;934;3028;1275;4115
230060;202010;2383;6482;1885;5601;39;166;1478;4320;1517;4486
230070;202010;3991;10481;3193;8936;148;445;2252;6221;2400;6666
230075;202010;8968;29037;8185;27650;482;1999;6478;21614;6960;23613
230080;202010;3095;6434;2330;5492;6;18;2125;5025;2131;5043
230090;202010;4400;10711;3697;9603;176;439;2960;7645;3136;8084
230100;202010;18204;46901;15962;43849;1267;3424;11371;31502;12638;34926
230110;202010;12810;37820;10713;33692;1763;5512;5609;17810;7372;23322
230120;202010;7536;19978;6594;18434;528;1303;4836;13715;5364;15018
230125;202010;3161;8304;2558;7331;89;292;1968;5568;2057;5860
230130;202010;5772;17674;4640;15148;358;1216;3029;9743;3387;10959
230140;202010;3451;10272;2907;9141;100;402;2204;6766;2304;7168
230150;202010;1599;4763;1313;4127;211;564;754;2480;965;3044
230160;202010;6551;16857;5585;15337;193;665;4525;12213;4718;12878
230170;202010;6327;17858;5111;15365;298;883;3660;10834;3958;11717
230180;202010;1660;4555;1404;4073;20;89;1133;3179;1153;3268
230185;202010;4460;12487;3748;11295;268;889;2768;8305;3036;9194
230190;202010;13368;38653;11196;34617;1490;4782;6339;19445;7829;24227
230195;202010;5343;15613;4822;14617;382;1127;3616;10954;3998;12081
230200;202010;5068;13888;4228;12298;159;506;3216;9159;3375;9665
230205;202010;4188;12256;3657;11430;210;679;2744;8544;2954;9223
230210;202010;10369;24837;8706;22591;348;1136;6821;17366;7169;18502
230220;202010;14061;35069;12256;32450;629;1660;10050;26374;10679;28034
230230;202010;6925;20556;6136;18946;412;1245;4503;13885;4915;15130
230240;202010;13076;34806;11222;31645;280;1177;9237;25441;9517;26618
230250;202010;9068;25261;8428;24256;253;866;6725;18793;6978;19659
230260;202010;14904;43920;12832;40208;1887;5652;7138;22950;9025;28602
230270;202010;7655;20426;5823;16971;507;1429;3792;11142;4299;12571
230280;202010;20579;54492;16676;47874;483;1983;13103;36217;13586;38200
230290;202010;4946;13514;4072;11870;255;663;3080;8970;3335;9633
230300;202010;4838;12830;4360;12179;103;295;3804;10581;3907;10876
230310;202010;4631;13112;3890;11801;131;572;2791;8216;2922;8788
230320;202010;7837;22442;6568;20113;236;964;5016;15017;5252;15981
230330;202010;4692;12762;3681;10806;144;471;2747;7876;2891;8347
230340;202010;3704;11326;3149;10195;270;941;2108;6721;2378;7662
230350;202010;18139;49340;15791;45839;854;2830;10578;30918;11432;33748
230360;202010;2983;7799;2327;6645;140;394;1569;4426;1709;4820
230365;202010;3081;7539;2527;6716;55;243;2149;5619;2204;5862
230370;202010;59415;163693;50302;150056;7444;22368;29851;90450;37295;112818
230380;202010;6314;17480;4944;14951;132;513;3623;10734;3755;11247
230390;202010;3445;10083;2962;9293;96;401;2280;7058;2376;7459
230393;202010;3319;9696;2639;8302;85;430;2023;6113;2108;6543
230395;202010;5815;15756;5043;14455;326;877;3568;10250;3894;11127
230400;202010;5472;14986;4845;13947;102;511;3866;10808;3968;11319
230410;202010;14239;41710;11663;36930;895;3073;7970;25209;8865;28282
230420;202010;29325;79659;23682;69790;2864;8785;13253;38763;16117;47548
230423;202010;4761;13937;4135;12684;85;379;3380;10175;3465;10554
230425;202010;5671;17273;5141;16190;417;1383;3638;11385;4055;12768
230426;202010;2800;7262;2016;5732;29;108;1517;4216;1546;4324
230427;202010;1849;5196;1307;4045;62;204;853;2531;915;2735
230428;202010;9675;25684;8246;23503;1125;3157;4826;13738;5951;16895
230430;202010;5062;14030;3956;12088;158;527;2944;8859;3102;9386
230435;202010;6015;15624;4964;13753;627;1636;2966;8317;3593;9953
230440;202010;420980;1033504;347749;925212;34268;96575;224302;589004;258570;685579
230445;202010;4334;11393;3489;9930;185;514;2380;6627;2565;7141
230450;202010;3658;10384;3163;9658;258;972;2273;6711;2531;7683
230460;202010;2159;5947;1870;5485;57;229;1561;4544;1618;4773
230465;202010;4110;11417;3467;10174;103;392;2604;7349;2707;7741
230470;202010;11339;37201;10105;34912;890;3437;7118;24214;8008;27651
230480;202010;1465;4206;1243;3801;66;263;922;2707;988;2970
230490;202010;2553;7115;2130;6319;163;553;1333;3709;1496;4262
230495;202010;5748;16932;5046;15672;381;1391;3334;10233;3715;11624
230500;202010;9497;30002;8472;28107;275;1106;6877;22783;7152;23889
230510;202010;1642;4895;1273;4086;170;596;640;2018;810;2614
230520;202010;4591;12847;3950;11689;336;941;2753;8184;3089;9125
230523;202010;15819;46181;12504;39057;2812;8773;3204;10675;6016;19448
230526;202010;3770;10643;3188;9639;186;521;2307;7041;2493;7562
230530;202010;5471;16907;4573;15138;287;1067;3307;10793;3594;11860
230533;202010;4526;10644;3739;9387;94;261;3118;7697;3212;7958
230535;202010;5337;14743;4487;13301;260;756;3064;9213;3324;9969
230540;202010;16288;43957;13923;40448;277;1081;11460;32993;11737;34074
230550;202010;21334;55796;17039;48464;1528;4473;10886;30759;12414;35232
230560;202010;8196;19764;6587;17225;53;216;5653;14652;5706;14868
230565;202010;3095;8525;2583;7577;102;408;1966;5642;2068;6050
230570;202010;3467;8822;2940;8096;82;230;2401;6597;2483;6827
230580;202010;11040;28353;9407;26002;352;970;7750;21313;8102;22283
230590;202010;9047;25344;7454;22426;405;1408;5495;15984;5900;17392
230600;202010;3691;9488;2890;8072;75;212;1996;5588;2071;5800
230610;202010;6743;18371;5942;17029;460;1273;4650;13255;5110;14528
230620;202010;2138;5724;1613;4688;123;386;975;2728;1098;3114
230625;202010;8122;22786;6790;20337;2030;6295;1832;5928;3862;12223
230630;202010;10829;31956;9344;28998;1448;4265;5388;17124;6836;21389
230640;202010;28046;83826;25189;79280;1209;4698;20017;62092;21226;66790
230650;202010;5235;13946;4421;12540;128;495;3597;9959;3725;10454
230655;202010;9386;31387;8796;30355;654;2264;6948;24306;7602;26570
230660;202010;6050;17874;4927;15879;159;841;3975;12534;4134;13375
230670;202010;6244;14745;4547;12016;139;459;3649;9400;3788;9859
230680;202010;2675;7237;2258;6496;131;356;1610;4660;1741;5016
230690;202010;7195;21097;6174;19063;398;1400;3893;11783;4291;13183
230700;202010;10294;26255;8264;22504;313;826;6100;16331;6413;17157
230710;202010;6859;21440;5952;19492;632;1976;3950;12865;4582;14841
230720;202010;1893;5567;1527;4819;120;358;1027;3168;1147;3526
230725;202010;4076;11941;3637;11172;385;1346;2121;6393;2506;7739
230730;202010;57507;154612;44868;135176;9867;32086;14902;47287;24769;79373
230740;202010;6136;16807;5180;15261;134;465;4140;12151;4274;12616
230750;202010;8451;22269;6975;19826;165;573;5537;15326;5702;15899
230760;202010;11167;29257;9688;27018;512;1689;7309;19909;7821;21598
230763;202010;4969;13210;4151;11752;123;552;3355;9166;3478;9718
230765;202010;41542;111824;34291;99954;5274;15955;17355;50092;22629;66047
230770;202010;25570;62932;21266;57208;2168;5873;14049;37908;16217;43781
230780;202010;6474;22388;5878;20982;828;2890;3441;12634;4269;15524
230790;202010;3041;8643;2728;8129;116;461;2043;5912;2159;6373
230800;202010;8300;26079;7257;23959;922;3227;4182;13610;5104;16837
230810;202010;11360;33800;10122;31796;396;1454;7815;24103;8211;25557
230820;202010;3420;11085;2795;9691;269;1062;1641;5443;1910;6505
230830;202010;7588;20487;6436;18554;131;546;5310;14917;5441;15463
230835;202010;4295;10133;3256;8476;91;267;2621;6707;2712;6974
230837;202010;3160;9582;2743;8846;114;511;2173;6819;2287;7330
230840;202010;9252;26744;7928;24503;872;2538;5579;17429;6451;19967
230850;202010;9741;27931;8144;24754;358;1257;5872;17570;6230;18827
230860;202010;5301;13214;4365;11869;65;215;3850;10401;3915;10616
230870;202010;16710;40327;14270;36264;403;1121;11666;29102;12069;30223
230880;202010;2128;6392;1941;6079;49;254;1533;4677;1582;4931
230890;202010;4578;14552;4144;13679;330;1190;2979;9683;3309;10873
230900;202010;3004;8589;2553;7716;187;631;1715;5073;1902;5704
230910;202010;3151;8394;2526;7404;65;293;2039;5953;2104;6246
230920;202010;4626;12918;3873;11724;124;503;3054;9056;3178;9559
230930;202010;6601;18266;5494;16273;304;873;3823;11320;4127;12193
230940;202010;8181;20409;7029;18642;204;491;5878;15483;6082;15974
230945;202010;6567;18651;5614;16828;296;1047;3998;11716;4294;12763
230950;202010;6187;15506;5441;14483;93;242;4714;12559;4807;12801
230960;202010;13468;38665;11795;35510;1987;5923;5820;17716;7807;23639
230970;202010;13798;36253;11450;32568;1739;4853;6516;18810;8255;23663
230980;202010;2725;7856;2388;7266;340;977;1476;4637;1816;5614
230990;202010;1662;4633;1361;4031;64;263;968;2738;1032;3001
231000;202010;2527;6726;2044;5769;79;202;1503;4143;1582;4345
231010;202010;3590;8344;2818;7010;41;161;2450;5903;2491;6064
231020;202010;8072;25051;7168;23271;1306;3887;4057;13752;5363;17639
231025;202010;7577;20652;6549;18954;740;2071;4548;13304;5288;15375
231030;202010;7452;21843;5805;18376;990;2980;2947;9414;3937;12394
231040;202010;2962;8437;2564;7695;130;386;1996;5896;2126;6282
231050;202010;11715;29870;9384;25739;638;1711;6990;18727;7628;20438
231060;202010;2934;8142;2560;7547;58;186;2098;6172;2156;6358
231070;202010;7834;22553;6673;20519;686;2176;4341;13265;5027;15441
231080;202010;3995;11253;3385;10257;134;540;2551;7558;2685;8098
231085;202010;6801;16379;5364;14657;210;539;4174;11418;4384;11957
231090;202010;4531;11668;3311;9322;110;420;2259;6102;2369;6522
231095;202010;2304;6805;1800;5709;143;452;1191;3770;1334;4222
231100;202010;3193;9124;2624;8053;116;417;1960;5938;2076;6355
231110;202010;3664;10629;3332;10008;131;470;2488;7357;2619;7827
231120;202010;2282;6569;1877;5860;84;309;1343;4143;1427;4452
231123;202010;1893;4871;1572;4320;74;161;1144;3178;1218;3339
231126;202010;5597;15221;4498;13135;306;856;3205;9279;3511;10135
231130;202010;21467;54311;17801;49679;1031;3630;13173;36076;14204;39706
231135;202010;4171;11662;3424;10205;158;513;2449;7171;2607;7684
231140;202010;16540;46115;13099;40051;606;2451;9195;27393;9801;29844
231150;202010;5867;15830;4484;13203;672;2013;1989;6006;2661;8019
231160;202010;6252;18952;5475;17518;767;2343;3155;10329;3922;12672
231170;202010;4340;12636;3562;11136;180;650;2467;7448;2647;8098
231180;202010;14617;41041;11757;35035;3226;9272;3964;12374;7190;21646
231190;202010;3910;10943;3201;9639;74;309;2444;7185;2518;7494
231195;202010;5071;15082;4179;13226;265;943;2992;9387;3257;10330
231200;202010;7817;24200;6792;22112;191;959;5350;16869;5541;17828
231210;202010;4857;14113;4121;12887;183;675;3106;9522;3289;10197
231220;202010;12278;31629;9435;26230;409;1211;6900;18491;7309;19702
231230;202010;9286;29380;8145;27305;521;1998;5957;19990;6478;21988
231240;202010;11649;33751;10208;31001;1566;4607;6178;19017;7744;23624
231250;202010;2153;5490;1402;3829;108;307;846;2249;954;2556
231260;202010;3279;9124;2826;8406;272;779;1919;5834;2191;6613
231270;202010;6383;16602;5150;14587;148;579;3869;10669;4017;11248
231280;202010;1723;5346;1569;5061;90;299;1171;3746;1261;4045
231290;202010;37802;112139;31236;98748;5290;16523;14432;45453;19722;61976
231300;202010;4118;11266;3204;9438;194;630;2133;6133;2327;6763
231310;202010;7440;18985;5883;16104;499;1359;4027;10804;4526;12163
231320;202010;7884;21366;6145;18285;87;396;4795;14033;4882;14429
231325;202010;2448;6399;2007;5727;169;387;1351;3953;1520;4340
231330;202010;9582;28292;7844;24835;1392;4198;4197;13877;5589;18075
231335;202010;5744;15027;4847;13575;82;356;4255;11774;4337;12130
231340;202010;17881;54170;15971;50761;1321;4202;11686;37525;13007;41727
231350;202010;15873;43028;14357;40876;267;950;12852;36229;13119;37179
231355;202010;4418;13025;3941;12126;226;757;3064;9306;3290;10063
231360;202010;7428;22266;6412;20490;268;953;5070;16148;5338;17101
231370;202010;2175;5947;1729;5158;35;113;1311;3898;1346;4011
231375;202010;4339;13440;3948;12793;137;616;3286;10508;3423;11124
231380;202010;6040;16302;5457;15498;191;501;4423;12740;4614;13241
231390;202010;3318;9622;2959;9023;125;472;2181;6478;2306;6950
231395;202010;4055;11767;3344;10623;427;1347;1944;6276;2371;7623
231400;202010;9685;27589;8086;24640;272;1148;6104;18181;6376;19329
231410;202010;14779;45428;13363;43075;624;2235;10759;34369;11383;36604
240010;202010;2624;6850;2035;5771;205;584;1210;3367;1415;3951
240020;202010;12525;34957;10464;31262;639;2361;6970;20500;7609;22861
240030;202010;2865;6975;2593;6552;89;256;2239;5621;2328;5877
240040;202010;816;2349;675;2074;32;126;468;1379;500;1505
240050;202010;3322;8862;2679;7699;49;152;2041;5754;2090;5906
240060;202010;1408;3756;1151;3292;23;86;939;2627;962;2713
240070;202010;2152;6223;1938;5774;181;578;1402;4058;1583;4636
240080;202010;2966;7937;2395;6884;55;207;1826;5142;1881;5349
240090;202010;2256;5527;1829;4801;18;50;1538;3999;1556;4049
240100;202010;10229;25094;8094;21191;210;635;6323;15975;6533;16610
240110;202010;4616;12978;3871;11623;188;677;2800;8248;2988;8925
240120;202010;3297;9097;2640;8283;188;625;1862;5984;2050;6609
240130;202010;3627;7541;3012;6742;31;89;2748;6064;2779;6153
240140;202010;1807;5391;1534;4852;156;546;1030;3224;1186;3770
240145;202010;6607;18265;5368;16135;820;2513;3019;9199;3839;11712
240150;202010;921;2682;808;2442;53;183;618;1811;671;1994
240160;202010;1455;4369;1213;3917;47;209;902;2923;949;3132
240165;202010;976;2637;807;2314;26;87;660;1857;686;1944
240170;202010;2554;6840;2133;6078;193;621;1451;4004;1644;4625
240180;202010;3000;8836;2374;7549;561;1689;1051;3548;1612;5237
240185;202010;1226;3806;1121;3623;57;227;920;2935;977;3162
240190;202010;1064;3114;908;2853;19;89;771;2433;790;2522
240200;202010;11020;27979;8738;24073;901;2689;4986;13397;5887;16086
240210;202010;3269;8012;2672;7068;26;137;2250;5765;2276;5902
240220;202010;7295;21661;6508;20422;333;1452;5124;15788;5457;17240
240230;202010;5855;14829;4665;12831;207;572;3691;10181;3898;10753
240240;202010;1827;5232;1131;3580;100;342;409;1155;509;1497
240250;202010;2968;7725;2599;7215;95;286;2179;6008;2274;6294
240260;202010;14068;41242;12111;37921;1721;5038;7485;24599;9206;29637
240270;202010;2282;6756;1982;6253;102;308;1427;4680;1529;4988
240280;202010;1693;4320;1434;3892;53;145;1140;3059;1193;3204
240290;202010;1185;3448;950;2923;29;134;677;1953;706;2087
240300;202010;2321;5888;1663;4678;68;206;1045;2872;1113;3078
240310;202010;8563;22537;6726;19224;895;2699;3474;9776;4369;12475
240320;202010;2072;5583;1510;4486;34;152;1133;3206;1167;3358
240325;202010;31939;84332;25183;72420;4377;12957;11226;32398;15603;45355
240330;202010;1777;4804;1359;4013;57;202;921;2582;978;2784
240340;202010;1984;4556;1608;3983;63;150;1314;3200;1377;3350
240350;202010;2193;5517;1950;5245;33;98;1760;4750;1793;4848
240360;202010;9092;24843;8087;23258;824;2388;5689;16532;6513;18920
240370;202010;1951;5063;1511;4170;71;204;1073;2887;1144;3091
240375;202010;921;2304;760;2008;28;104;618;1577;646;1681
240380;202010;2264;6405;1653;5024;143;411;953;2864;1096;3275
240390;202010;1047;2520;735;1928;28;62;471;1153;499;1215
240400;202010;1464;3548;1134;2978;35;116;798;1966;833;2082
240410;202010;563;1685;470;1478;39;148;296;879;335;1027
240420;202010;4561;15930;4004;14677;457;1972;2380;8550;2837;10522
240430;202010;3433;8765;2844;7735;179;561;2109;5549;2288;6110
240440;202010;2546;5516;2138;4951;141;269;1730;4021;1871;4290
240450;202010;4568;12347;3547;10414;349;1061;2099;5936;2448;6997
240460;202010;2939;8295;2605;7758;229;742;2029;6011;2258;6753
240470;202010;3639;10887;2761;9052;482;1485;1421;4883;1903;6368
240480;202010;579;1605;392;1187;32;101;181;536;213;637
240485;202010;2179;6071;1772;5315;119;366;1221;3663;1340;4029
240490;202010;1614;4128;1258;3465;86;200;920;2555;1006;2755
240500;202010;2163;5773;1883;5301;100;267;1516;4277;1616;4544
240510;202010;1701;4430;1487;4117;63;234;1223;3306;1286;3540
240520;202010;1484;3566;1146;3101;54;156;866;2350;920;2506
240530;202010;2192;6170;1969;5817;98;299;1617;4746;1715;5045
240540;202010;2286;5680;1989;5214;63;112;1717;4528;1780;4640
240550;202010;680;1920;614;1788;18;75;512;1447;530;1522
240560;202010;3324;8551;2786;7826;275;684;2021;5803;2296;6487
240570;202010;2865;7456;1878;5280;280;794;728;1918;1008;2712
240580;202010;8065;23420;7106;21639;552;1597;5659;17381;6211;18978
240590;202010;740;1921;639;1749;12;40;486;1294;498;1334
240600;202010;1781;4849;1308;3858;47;151;861;2454;908;2605
240610;202010;4219;11267;3559;10062;126;420;2718;7533;2844;7953
240615;202010;1285;3266;1014;2776;114;296;677;1828;791;2124
240620;202010;1863;5176;1596;4709;104;274;1266;3737;1370;4011
240630;202010;2098;5897;1890;5539;148;311;1330;4076;1478;4387
240640;202010;969;2558;765;2217;31;112;572;1620;603;1732
240650;202010;4064;11274;3480;10088;232;673;2631;7525;2863;8198
240660;202010;3095;7860;2745;7406;49;154;2489;6716;2538;6870
240670;202010;2479;6985;1986;5970;142;459;1283;3755;1425;4214
240680;202010;1646;4327;1317;3759;47;146;1003;2787;1050;2933
240690;202010;1011;2513;800;2161;16;69;635;1642;651;1711
240700;202010;2465;7076;1995;6192;54;192;1561;4764;1615;4956
240710;202010;16415;42157;13672;37444;1752;4689;8478;23197;10230;27886
240720;202010;5192;12700;4481;11704;396;1076;3277;8463;3673;9539
240725;202010;1135;3213;865;2673;40;129;571;1704;611;1833
240730;202010;2272;6339;1823;5447;63;221;1367;4010;1430;4231
240740;202010;1847;4935;1461;4180;43;166;1073;2903;1116;3069
240750;202010;2174;7081;1828;6345;268;1007;975;3405;1243;4412
240760;202010;1655;3813;1168;3059;67;94;894;2436;961;2530
240770;202010;3230;8854;2705;8089;125;455;2183;6443;2308;6898
240780;202010;4882;13349;3966;11814;544;1584;2410;7391;2954;8975
240790;202010;878;2475;728;2177;20;90;550;1590;570;1680
240800;202010;47913;114126;37101;97667;5122;13739;19091;50325;24213;64064
240810;202010;91583;234949;77242;211008;9312;26127;49429;132912;58741;159039
240820;202010;5891;17417;5091;15966;709;2186;3125;9977;3834;12163
240830;202010;8778;24723;7763;23183;266;1078;6396;18831;6662;19909
240840;202010;1116;2746;881;2368;29;74;630;1625;659;1699
240850;202010;1384;3730;985;2893;49;154;546;1547;595;1701
240860;202010;1315;3471;990;2886;16;76;739;2050;755;2126
240870;202010;1106;2793;831;2315;131;372;451;1282;582;1654
240880;202010;1270;3992;1115;3687;83;347;861;2769;944;3116
240890;202010;4466;12125;3376;10027;459;1479;1718;4904;2177;6383
240895;202010;2840;8621;2593;8227;154;475;2226;7147;2380;7622
240910;202010;3409;9140;2903;8214;55;196;2364;6555;2419;6751
240920;202010;904;2438;744;2179;68;180;423;1293;491;1473
240930;202010;3704;8348;3053;7550;199;290;2281;5961;2480;6251
240933;202010;1780;4275;1453;3799;40;158;1263;3245;1303;3403
240940;202010;6086;14978;4710;12625;541;1461;2811;7337;3352;8798
240950;202010;1036;3064;900;2813;28;115;727;2219;755;2334
240960;202010;691;2101;617;1953;30;107;468;1451;498;1558
240970;202010;1868;4788;1504;4170;60;215;1222;3282;1282;3497
240980;202010;3322;9855;2934;9154;112;483;2371;7273;2483;7756
240990;202010;2617;7330;2297;6691;268;855;1609;4527;1877;5382
241000;202010;961;2531;756;2147;27;69;556;1555;583;1624
241010;202010;2838;8929;2584;8376;172;645;1896;6063;2068;6708
241020;202010;2145;5656;1581;4527;135;387;1023;2878;1158;3265
241025;202010;1778;5044;1414;4358;49;202;1026;3112;1075;3314
241030;202010;2512;7793;1999;6695;226;772;1277;4292;1503;5064
241040;202010;2287;7160;2009;6679;94;436;1609;5281;1703;5717
241050;202010;1364;3769;1114;3318;34;128;814;2359;848;2487
241060;202010;754;2114;661;1917;28;90;463;1289;491;1379
241070;202010;662;1795;567;1631;14;43;442;1231;456;1274
241080;202010;1143;3208;867;2651;9;37;628;1893;637;1930
241090;202010;2022;5861;1639;5198;46;231;1292;4025;1338;4256
241100;202010;1184;3283;917;2741;70;214;594;1724;664;1938
241105;202010;978;2942;793;2589;251;795;257;875;508;1670
241110;202010;980;2727;736;2216;32;91;490;1424;522;1515
241120;202010;7662;21505;6476;19396;972;2833;3810;11747;4782;14580
241140;202010;3328;8735;2606;7291;151;432;1869;5109;2020;5541
241142;202010;782;2087;573;1684;27;93;341;945;368;1038
241150;202010;5962;15422;5238;14228;145;488;4294;11455;4439;11943
241160;202010;1151;3067;922;2646;136;393;590;1657;726;2050
241170;202010;1356;3425;1148;3065;29;109;961;2464;990;2573
241180;202010;1049;2656;762;2095;93;264;380;1038;473;1302
241190;202010;1157;3019;960;2628;18;73;696;1832;714;1905
241200;202010;20066;51880;17175;47117;2723;7437;9887;27142;12610;34579
241210;202010;1437;3796;1027;2972;119;380;580;1635;699;2015
241220;202010;9029;26169;7824;24114;1762;5351;3724;11944;5486;17295
241230;202010;2973;7739;2607;7160;109;325;2163;5874;2272;6199
241240;202010;1235;3426;771;2390;65;202;337;1050;402;1252
241250;202010;5461;15731;4354;13642;158;718;3162;9532;3320;10250
241255;202010;2262;7012;1992;6435;113;452;1516;4796;1629;5248
241260;202010;4993;12826;3917;11028;85;327;3094;8518;3179;8845
241270;202010;1736;4976;1425;4376;105;360;1023;3131;1128;3491
241280;202010;2196;5468;1872;4879;58;145;1589;4084;1647;4229
241290;202010;3404;8297;2512;6844;75;242;1972;5225;2047;5467
241300;202010;1495;3961;1190;3418;37;126;805;2248;842;2374
241310;202010;2160;5277;1850;4834;13;51;1579;4173;1592;4224
241320;202010;942;3043;805;2781;85;356;519;1769;604;2125
241330;202010;1759;4492;1375;3980;18;93;1192;3414;1210;3507
241335;202010;3316;9145;2911;8397;108;354;2383;6788;2491;7142
241340;202010;1581;4422;1218;3665;256;810;492;1444;748;2254
241350;202010;2100;5945;1832;5465;95;321;1422;4174;1517;4495
241355;202010;1318;3541;1076;3067;16;45;830;2350;846;2395
241360;202010;2061;5313;1546;4262;40;118;1101;2922;1141;3040
241370;202010;1357;3737;1050;3095;51;169;729;2058;780;2227
241380;202010;643;1791;488;1489;74;193;243;769;317;962
241390;202010;2786;8058;2467;7573;204;557;1887;5914;2091;6471
241400;202010;3607;9912;3200;9273;150;486;2593;7451;2743;7937
241410;202010;2424;7162;1969;6225;345;1116;1001;3175;1346;4291
241415;202010;1674;4937;1359;4321;58;213;948;2966;1006;3179
241420;202010;2398;7422;2040;6801;471;1752;980;3255;1451;5007
241430;202010;610;1676;418;1241;18;60;260;734;278;794
241440;202010;7720;23417;6870;21901;375;1291;5397;17171;5772;18462
241445;202010;1120;2829;988;2658;22;56;874;2412;896;2468
241450;202010;2692;6606;2291;5956;393;866;1477;4009;1870;4875
241460;202010;3834;10307;3098;8750;195;575;2154;5949;2349;6524
241470;202010;1423;3723;1147;3311;30;111;946;2722;976;2833
241475;202010;1235;3434;965;2909;24;111;692;1990;716;2101
241480;202010;2983;9229;2435;8021;722;2360;799;2929;1521;5289
241490;202010;646;1510;527;1349;27;66;379;952;406;1018
241500;202010;806;2215;715;2097;3;10;660;1956;663;1966
250010;202010;2524;7533;2090;6642;59;238;1521;4725;1580;4963
250020;202010;1653;4343;1191;3444;46;88;840;2446;886;2534
250030;202010;6996;18962;6139;17601;556;1616;4536;12860;5092;14476
250040;202010;4058;12344;3488;11277;233;840;2519;8025;2752;8865
250050;202010;3640;9671;3279;9183;127;434;2682;7509;2809;7943
250053;202010;1187;3302;1074;3114;73;211;776;2268;849;2479
250057;202010;654;2313;609;2243;10;44;546;2042;556;2086
250060;202010;5548;14341;4968;13620;289;766;4092;11285;4381;12051
250070;202010;4016;11062;3393;9965;37;151;2725;7817;2762;7968
250073;202010;765;2015;622;1797;9;22;506;1426;515;1448
250077;202010;2227;5955;1663;5025;59;208;1259;3779;1318;3987
250080;202010;4905;12158;4147;11176;63;280;3619;9616;3682;9896
250090;202010;3337;8090;2902;7514;55;161;2490;6327;2545;6488
250100;202010;3706;11174;3329;10465;167;584;2606;8028;2773;8612
250110;202010;4940;13788;4434;13044;252;938;3462;9970;3714;10908
250115;202010;701;1808;506;1505;10;42;350;1037;360;1079
250120;202010;1858;5372;1557;4867;33;157;1229;3809;1262;3966
250130;202010;5562;15152;4690;13909;72;383;3975;11623;4047;12006
250135;202010;1206;3314;1043;3027;25;94;899;2590;924;2684
250140;202010;2284;6592;2117;6377;107;424;1815;5428;1922;5852
250150;202010;4802;14808;4295;13938;157;679;3405;10852;3562;11531
250153;202010;1414;3714;1173;3344;31;89;934;2640;965;2729
250157;202010;1794;5183;1617;4854;58;232;1294;3816;1352;4048
250160;202010;3935;9706;3131;8614;42;150;2743;7552;2785;7702
250170;202010;1856;4741;1649;4447;24;90;1438;3837;1462;3927
250180;202010;20427;48862;17389;44969;770;2347;13572;34236;14342;36583
250190;202010;4069;10789;3390;9772;322;959;2338;6580;2660;7539
250200;202010;1961;5187;1664;4774;63;192;1391;3999;1454;4191
250205;202010;866;2641;747;2459;15;74;618;2007;633;2081
250210;202010;1557;4691;1398;4434;73;317;1087;3389;1160;3706
250215;202010;1589;4330;1321;3939;81;267;778;2334;859;2601
250220;202010;659;1814;526;1615;24;91;348;1046;372;1137
250230;202010;1682;3751;1118;2879;16;54;930;2311;946;2365
250240;202010;2302;6984;2012;6446;40;196;1664;5254;1704;5450
250250;202010;4594;12668;3992;11784;85;286;3401;10054;3486;10340
250260;202010;1714;4724;1424;4227;53;131;1120;3305;1173;3436
250270;202010;1207;3606;1088;3459;59;204;806;2666;865;2870
250280;202010;3374;9297;3013;8759;109;302;2382;6952;2491;7254
250290;202010;1597;4172;1356;3826;22;72;1063;2995;1085;3067
250300;202010;5524;14606;4951;13932;190;822;4126;11203;4316;12025
250310;202010;1178;3218;976;2881;38;127;741;2162;779;2289
250320;202010;12237;27152;10505;25155;263;717;9384;22171;9647;22888
250330;202010;2411;6586;2013;6037;105;319;1619;4853;1724;5172
250340;202010;1106;2792;987;2642;12;30;907;2419;919;2449
250350;202010;4159;11533;3658;10689;204;477;2862;8633;3066;9110
250355;202010;1969;5936;1764;5653;29;161;1569;4994;1598;5155
250360;202010;1787;4886;1589;4617;39;146;1331;3830;1370;3976
250370;202010;13686;34768;11267;31110;248;895;9469;25772;9717;26667
250375;202010;1192;3052;952;2760;6;23;897;2616;903;2639
250380;202010;1623;4138;1481;3955;30;113;1299;3365;1329;3478
250390;202010;1851;4698;1542;4202;82;230;1225;3301;1307;3531
250400;202010;71105;173382;51840;143209;14421;42793;14414;42186;28835;84979
250403;202010;1751;4851;1559;4620;74;367;1205;3397;1279;3764
250407;202010;1256;3089;994;2701;74;159;687;1941;761;2100
250410;202010;650;1729;560;1574;4;9;463;1272;467;1281
250415;202010;1880;5224;1638;4833;31;143;1395;4091;1426;4234
250420;202010;1190;3320;1079;3160;27;99;960;2791;987;2890
250430;202010;6287;15408;5289;14068;136;419;4361;11369;4497;11788
250435;202010;1552;4307;1238;3755;14;73;945;2814;959;2887
250440;202010;4597;12067;3920;11207;70;196;3473;9931;3543;10127
250450;202010;1836;4795;1494;4324;31;110;1238;3593;1269;3703
250460;202010;7361;19827;6514;18573;334;1010;5213;14795;5547;15805
250470;202010;1557;3982;1280;3555;51;159;1007;2748;1058;2907
250480;202010;4058;10850;3431;10099;41;143;3015;8948;3056;9091
250485;202010;728;1624;535;1344;43;74;389;947;432;1021
250490;202010;5173;12210;4586;11536;174;508;4048;9996;4222;10504
250500;202010;2004;5467;1773;5065;75;232;1430;4090;1505;4322
250510;202010;5487;13682;4698;12632;78;202;4099;11112;4177;11314
250520;202010;1827;4910;1554;4512;127;402;1107;3186;1234;3588
250523;202010;2236;5486;1977;5158;72;289;1635;4105;1707;4394
250527;202010;1683;4286;1512;4091;25;72;1339;3645;1364;3717
250530;202010;638;1615;542;1481;5;11;479;1307;484;1318
250535;202010;1348;3957;1214;3698;24;105;989;2929;1013;3034
250540;202010;3001;6800;2492;6231;77;138;2171;5539;2248;5677
250550;202010;773;2463;674;2268;22;86;503;1661;525;1747
250560;202010;1768;4818;1560;4518;39;144;1309;3707;1348;3851
250570;202010;2664;7900;2278;7196;79;292;1790;5565;1869;5857
250580;202010;1060;2744;930;2563;46;175;781;2101;827;2276
250590;202010;817;2271;727;2142;19;65;595;1763;614;1828
250600;202010;8221;20918;6836;19121;243;753;5612;15583;5855;16336
250610;202010;2976;8342;2656;7872;118;441;2202;6441;2320;6882
250620;202010;808;2086;687;1880;10;26;502;1345;512;1371
250625;202010;2498;7115;2227;6668;41;214;1888;5484;1929;5698
250630;202010;10273;28180;8291;24700;880;2630;5281;15434;6161;18064
250640;202010;3482;9464;3119;8990;101;387;2650;7523;2751;7910
250650;202010;975;2317;810;2093;13;36;702;1787;715;1823
250660;202010;1643;4045;1309;3588;39;108;1073;2873;1112;2981
250670;202010;2321;7197;2108;6819;43;190;1837;5837;1880;6027
250680;202010;5835;13408;5200;12691;56;215;4827;11625;4883;11840
250690;202010;6841;15310;5764;13964;97;229;5100;12265;5197;12494
250700;202010;4309;12047;3750;11196;448;1317;2583;7685;3031;9002
250710;202010;4446;12616;3813;11745;284;965;2767;8524;3051;9489
250720;202010;2749;7305;2447;6876;35;173;2140;5944;2175;6117
250730;202010;4132;10924;3596;10214;105;426;3003;8286;3108;8712
250740;202010;1939;4796;1606;4354;99;217;1245;3410;1344;3627
250750;202010;106648;259689;89812;235996;7198;20400;64952;167354;72150;187754
250760;202010;2386;6121;2073;5613;89;261;1637;4298;1726;4559
250770;202010;4035;12100;3598;11515;386;1184;2574;8358;2960;9542
250780;202010;1757;4704;1461;4163;48;173;1126;3115;1174;3288
250790;202010;2471;7248;2129;6734;131;517;1449;4467;1580;4984
250800;202010;2458;6486;2135;5962;86;173;1727;4865;1813;5038
250810;202010;1284;3341;1060;3024;30;61;893;2582;923;2643
250820;202010;1998;5477;1835;5297;33;144;1660;4754;1693;4898
250830;202010;5911;17591;4837;15404;276;1039;3292;10165;3568;11204
250840;202010;760;2401;650;2181;14;56;489;1651;503;1707
250850;202010;1810;5332;1613;4977;35;158;1328;3996;1363;4154
250855;202010;991;2872;842;2618;58;211;611;1885;669;2096
250860;202010;3175;9341;2619;8397;439;1484;1530;4910;1969;6394
250870;202010;1046;2845;877;2563;34;124;714;2055;748;2179
250880;202010;1637;4160;1342;3735;73;212;1024;2846;1097;3058
250890;202010;10364;26546;9145;24901;427;1658;7285;18918;7712;20576
250900;202010;2911;7883;2510;7173;91;259;2100;5914;2191;6173
250905;202010;2436;6812;2234;6520;42;165;2032;5924;2074;6089
250910;202010;6001;14667;4932;13449;84;285;4293;11750;4377;12035
250915;202010;2167;4989;1507;4277;26;56;1312;3809;1338;3865
250920;202010;3551;8932;3105;8250;335;762;2271;6080;2606;6842
250930;202010;2272;6024;2045;5730;57;238;1764;4836;1821;5074
250933;202010;1165;3443;1026;3189;21;101;786;2376;807;2477
250937;202010;698;1865;570;1654;24;74;434;1281;458;1355
250939;202010;1759;4670;1529;4366;63;199;1190;3382;1253;3581
250940;202010;4061;10686;3558;10021;17;64;3168;8927;3185;8991
250950;202010;1739;4383;1392;3939;26;96;1129;3134;1155;3230
250960;202010;1127;3276;984;3048;27;139;802;2395;829;2534
250970;202010;8349;21302;7290;19604;228;705;6042;15952;6270;16657
250980;202010;2438;6443;2178;6054;34;146;1880;5090;1914;5236
250990;202010;2078;6230;1728;5615;55;251;1277;4098;1332;4349
251000;202010;2062;5766;1664;5079;38;163;1358;4111;1396;4274
251010;202010;2676;7397;2418;7010;19;75;2173;6303;2192;6378
251020;202010;1648;4460;1469;4172;33;149;1273;3539;1306;3688
251030;202010;1019;2690;834;2351;36;98;583;1627;619;1725
251040;202010;1839;5153;1538;4641;38;188;1242;3721;1280;3909
251050;202010;1062;2886;879;2528;49;162;621;1718;670;1880
251060;202010;1086;2310;813;1962;8;26;637;1512;645;1538
251065;202010;480;1306;369;1098;12;34;250;726;262;760
251070;202010;735;1884;621;1718;10;41;531;1437;541;1478
251080;202010;18778;47795;15199;42361;1954;5598;9616;26945;11570;32543
251090;202010;2813;8059;2367;7261;56;201;1880;5725;1936;5926
251100;202010;816;2582;725;2413;25;93;554;1770;579;1863
251110;202010;1704;4541;1444;4089;52;132;1087;3074;1139;3206
251120;202010;7369;20365;6189;18916;276;978;4888;14967;5164;15945
251130;202010;3905;8627;3432;8091;59;164;3110;7291;3169;7455
251140;202010;4291;11882;3826;11223;76;314;3191;9244;3267;9558
251150;202010;2649;7694;2378;7256;102;426;1952;5820;2054;6246
251160;202010;2129;6224;1843;5807;39;189;1585;4898;1624;5087
251170;202010;1558;4219;1353;3950;32;111;1167;3390;1199;3501
251180;202010;2639;7013;2149;6318;168;492;1463;4281;1631;4773
251190;202010;4425;11472;4017;11009;46;255;3647;9791;3693;10046
251200;202010;4346;12655;3818;11968;73;309;3355;10541;3428;10850
251203;202010;949;3091;870;2913;22;112;653;2117;675;2229
251207;202010;1097;2981;842;2557;20;102;589;1744;609;1846
251210;202010;7687;19301;6273;17376;279;644;4792;13530;5071;14174
251220;202010;1189;2856;932;2515;54;122;712;1965;766;2087
251230;202010;4617;12743;3961;11608;114;417;3128;8925;3242;9342
251240;202010;3689;9983;3086;8981;163;442;2308;6614;2471;7056
251250;202010;10414;27783;9097;25563;734;2129;6713;18331;7447;20460
251260;202010;484;1373;440;1304;14;67;346;992;360;1059
251270;202010;4276;13226;3824;12622;110;446;3115;10506;3225;10952
251272;202010;1348;3634;1212;3453;46;175;1014;2812;1060;2987
251274;202010;899;2493;715;2151;60;203;475;1365;535;1568
251275;202010;1219;3413;1037;3115;29;131;814;2381;843;2512
251276;202010;1319;3563;1146;3335;30;150;927;2604;957;2754
251278;202010;586;1612;523;1520;49;118;378;1131;427;1249
251280;202010;2240;6050;2002;5685;50;152;1670;4692;1720;4844
251290;202010;5898;13808;5319;13097;149;483;4641;11070;4790;11553
251300;202010;866;2514;782;2386;7;36;661;2014;668;2050
251310;202010;2734;7840;2370;7270;49;263;1900;5681;1949;5944
251315;202010;1708;5312;1558;5033;86;266;1175;3755;1261;4021
251320;202010;1629;4299;1170;3510;34;117;869;2559;903;2676
251330;202010;2117;4884;1717;4415;22;83;1546;4002;1568;4085
251335;202010;1107;3156;989;2971;24;107;862;2527;886;2634
251340;202010;3713;8930;2964;7921;125;368;2267;6033;2392;6401
251350;202010;1054;3031;946;2850;26;100;777;2301;803;2401
251360;202010;1834;5105;1473;4594;21;106;1233;3843;1254;3949
251365;202010;727;1960;574;1658;5;20;450;1285;455;1305
251370;202010;24876;65003;21243;59778;2917;8263;12772;36802;15689;45065
251380;202010;1208;3400;1049;3130;19;108;874;2532;893;2640
251385;202010;761;1934;580;1604;21;60;425;1132;446;1192
251390;202010;6494;18721;5698;17465;485;1531;3775;11615;4260;13146
251392;202010;977;2635;816;2389;28;115;632;1810;660;1925
251394;202010;613;1771;501;1571;19;85;369;1137;388;1222
251396;202010;671;1792;571;1616;16;42;401;1113;417;1155
251398;202010;981;2448;674;1922;18;70;494;1369;512;1439
251400;202010;1236;2989;975;2640;24;93;767;2001;791;2094
251410;202010;1515;3551;1228;3146;21;89;1041;2561;1062;2650
251420;202010;1918;5022;1552;4595;40;152;1231;3602;1271;3754
251430;202010;1567;4706;1404;4426;29;139;1209;3806;1238;3945
251440;202010;1116;3089;896;2678;38;94;704;2125;742;2219
251445;202010;1551;4280;1425;4106;37;124;1204;3418;1241;3542
251450;202010;4502;13078;3981;12300;85;336;3305;10119;3390;10455
251455;202010;865;2600;784;2454;22;91;620;1893;642;1984
251460;202010;887;2568;774;2394;15;53;635;1973;650;2026
251465;202010;453;1314;388;1195;7;28;287;860;294;888
251470;202010;1192;3259;885;2616;73;235;514;1449;587;1684
251480;202010;1000;2630;812;2295;19;80;624;1680;643;1760
251490;202010;1894;4969;1496;4412;58;181;1107;3272;1165;3453
251500;202010;1947;5442;1785;5229;32;115;1606;4704;1638;4819
251510;202010;2644;7901;2181;6969;107;398;1480;4615;1587;5013
251520;202010;982;2569;748;2136;67;183;472;1314;539;1497
251530;202010;14769;35258;11848;31615;103;571;10463;27413;10566;27984
251540;202010;3003;8487;2705;7931;67;229;2248;6493;2315;6722
251550;202010;3801;8920;3030;7957;106;203;2523;6689;2629;6892
251560;202010;544;1640;474;1528;58;200;327;1024;385;1224
251570;202010;944;2652;764;2297;19;84;602;1758;621;1842
251580;202010;1895;4487;1688;4186;36;152;1471;3502;1507;3654
251590;202010;1567;3881;1315;3585;52;138;1094;2934;1146;3072
251593;202010;912;2657;813;2497;87;269;522;1584;609;1853
251597;202010;2112;5909;1899;5628;20;104;1688;4930;1708;5034
251600;202010;6420;17244;5598;15990;172;530;4617;13004;4789;13534
251610;202010;3233;9178;2761;8294;243;666;1874;5739;2117;6405
251615;202010;1260;3103;1017;2740;25;66;813;2138;838;2204
251620;202010;19202;43607;14745;38137;105;361;12628;33083;12733;33444
251630;202010;4745;11088;3793;9766;201;509;2838;7246;3039;7755
251640;202010;2155;5836;1905;5444;28;132;1654;4616;1682;4748
251650;202010;3988;10651;3479;9975;132;405;2940;8421;3072;8826
251660;202010;3476;10370;3045;9612;71;336;2531;7847;2602;8183
251670;202010;4029;11326;3579;10685;50;252;3176;9392;3226;9644
251675;202010;641;1838;579;1762;78;234;380;1176;458;1410
251680;202010;2530;6646;2098;6083;46;144;1687;4941;1733;5085
251690;202010;3103;8656;2613;7802;90;271;1951;5765;2041;6036
251700;202010;2100;5906;1748;5459;42;189;1476;4529;1518;4718
251710;202010;803;2060;550;1546;40;137;320;851;360;988
251720;202010;1314;3705;1049;3237;23;103;803;2404;826;2507
251740;202010;620;1726;497;1494;46;163;328;948;374;1111
260005;202010;30153;63402;24718;56367;1695;3796;18962;42446;20657;46242
260010;202010;10321;26854;8477;23858;458;1353;5014;14203;5472;15556
260020;202010;6892;15984;5825;14462;98;436;4920;11983;5018;12419
260030;202010;6892;17435;5803;15851;135;407;4721;12827;4856;13234
260040;202010;7675;19634;6387;17772;443;1213;4510;12734;4953;13947
260050;202010;14007;36099;11632;33458;180;691;10679;30760;10859;31451
260060;202010;4106;10116;3513;9165;212;485;2744;7196;2956;7681
260070;202010;10638;26553;9067;24273;322;1124;7325;19076;7647;20200
260080;202010;6534;14851;5683;13722;117;378;4770;11314;4887;11692
260090;202010;4633;11929;4101;11198;460;1278;2903;7935;3363;9213
260100;202010;2997;8068;2499;7333;53;267;2057;5930;2110;6197
260105;202010;5008;13628;4472;12901;132;465;3748;10662;3880;11127
260110;202010;22384;61393;19843;57675;926;3122;16375;46925;17301;50047
260120;202010;14720;38800;12332;35201;1449;4027;7865;22846;9314;26873
260130;202010;3100;7950;2750;7422;260;693;1984;5290;2244;5983
260140;202010;13147;29415;11301;27214;552;1486;9473;22454;10025;23940
260150;202010;3614;8318;3092;7671;90;259;2715;6668;2805;6927
260160;202010;6555;16904;5511;15630;91;318;4958;14198;5049;14516
260170;202010;20440;47881;17276;43557;910;2319;13781;34335;14691;36654
260180;202010;3519;9293;3033;8631;76;279;2608;7309;2684;7588
260190;202010;18327;36718;15356;33198;165;441;13617;28888;13782;29329
260200;202010;11199;26730;9576;24658;449;1012;7955;20777;8404;21789
260210;202010;11918;33370;10058;30317;322;1171;7982;23926;8304;25097
260220;202010;10365;24724;9552;23683;172;546;8381;20469;8553;21015
260230;202010;10747;26242;9350;24389;195;643;7882;20194;8077;20837
260240;202010;2730;8125;2381;7450;100;331;1827;5680;1927;6011
260250;202010;2197;5755;1898;5273;118;270;1442;4006;1560;4276
260260;202010;13069;33670;11598;31414;376;1245;9170;24329;9546;25574
260270;202010;4305;10273;3776;9636;131;467;3162;7912;3293;8379
260280;202010;12855;38343;11519;36438;441;1870;9789;30533;10230;32403
260290;202010;41291;103647;35377;95032;3839;10527;23959;64079;27798;74606
260300;202010;9668;25889;8377;24125;187;835;7062;20270;7249;21105
260310;202010;5229;13209;4588;12393;336;826;3520;9665;3856;10491
260320;202010;7691;22064;6464;19967;261;838;5241;16179;5502;17017
260330;202010;2565;7825;2242;7167;73;275;1774;5529;1847;5804
260340;202010;2059;5481;1769;5044;26;118;1514;4217;1540;4335
260345;202010;25509;65700;21219;59425;3175;9455;11174;30740;14349;40195
260350;202010;5662;13110;4886;12213;65;188;4338;10784;4403;10972
260360;202010;2526;6583;2278;6126;46;200;1593;4180;1639;4380
260370;202010;5584;15909;4794;14581;235;780;3692;11169;3927;11949
260380;202010;5049;14691;4305;13465;171;541;3225;9989;3396;10530
260390;202010;4530;13493;3742;11879;232;719;2483;7751;2715;8470
260392;202010;3348;10690;2992;10237;115;692;2408;8224;2523;8916
260400;202010;18380;42208;15836;38858;467;1322;12475;29457;12942;30779
260410;202010;73496;177691;56540;153806;9963;28418;25260;70982;35223;99400
260415;202010;4457;11827;3835;10791;60;250;3131;8659;3191;8909
260420;202010;12752;26322;10777;24116;101;283;9988;22142;10089;22425
260430;202010;2721;8419;2332;7647;103;414;1655;5349;1758;5763
260440;202010;3745;9637;3305;8967;68;241;2773;7384;2841;7625
260450;202010;5751;14402;5130;13600;288;577;4229;11427;4517;12004
260460;202010;5240;15514;4449;14114;475;1675;2647;8255;3122;9930
260470;202010;4904;12908;4134;12009;81;196;3787;11167;3868;11363
260480;202010;3992;10591;3342;9659;224;790;2296;6637;2520;7427
260490;202010;5388;12286;4754;11353;34;140;4328;10157;4362;10297
260500;202010;6109;15287;5208;14016;457;1156;3638;9933;4095;11089
260510;202010;9913;24239;8282;21958;113;437;7299;19174;7412;19611
260515;202010;4405;11737;3398;9852;162;450;2278;6426;2440;6876
260520;202010;17186;39551;14928;36653;749;1806;12155;29459;12904;31265
260530;202010;9860;27936;8374;25629;147;680;7190;21687;7337;22367
260540;202010;7243;15601;6370;14495;150;346;5712;12913;5862;13259
260545;202010;68;207;39;135;3;12;16;53;19;65
260550;202010;3122;8510;2553;7577;115;443;1743;5045;1858;5488
260560;202010;5931;15056;4969;13668;124;471;4177;11253;4301;11724
260570;202010;7745;20932;6799;19650;371;1180;5351;15509;5722;16689
260580;202010;4491;10564;4027;9953;26;89;3670;9010;3696;9099
260590;202010;6724;15547;5623;14311;231;556;4650;12014;4881;12570
260600;202010;31096;79991;25154;70818;1125;3491;18998;52553;20123;56044
260610;202010;7333;18836;6532;17780;390;1133;4894;13240;5284;14373
260620;202010;16625;42631;14470;39509;1257;3854;10520;28112;11777;31966
260630;202010;2395;6428;1953;5722;36;150;1573;4499;1609;4649
260640;202010;22074;49255;18392;45007;846;2040;14845;36143;15691;38183
260650;202010;6326;16123;5042;14538;423;873;4059;12069;4482;12942
260660;202010;7054;18428;6079;17124;169;697;5180;14263;5349;14960
260670;202010;2257;5853;1885;5284;76;193;1369;3762;1445;3955
260680;202010;29060;68694;24386;62021;1693;4578;17203;42852;18896;47430
260690;202010;3560;9125;2951;8180;87;334;2305;6323;2392;6657
260700;202010;6157;17132;5728;16637;21;71;5542;16204;5563;16275
260710;202010;1376;3576;1183;3300;32;120;923;2567;955;2687
260720;202010;24201;59395;20672;54656;1981;5308;14916;39265;16897;44573
260730;202010;7869;22229;6848;20794;257;932;5719;17116;5976;18048
260740;202010;1342;3771;1127;3417;14;73;881;2727;895;2800
260750;202010;7238;19599;6028;18093;261;529;5237;16244;5498;16773
260760;202010;5759;13485;4939;12514;200;526;4052;10313;4252;10839
260765;202010;8099;23160;7023;21674;416;1708;4942;14950;5358;16658
260770;202010;3897;9859;3224;8744;128;398;2517;6733;2645;7131
260775;202010;5251;13896;4606;12914;191;707;3597;9725;3788;10432
260780;202010;3678;10833;3273;10181;300;1081;2062;6187;2362;7268
260790;202010;121738;270468;100273;242269;15328;35765;61595;149387;76923;185152
260795;202010;3019;7664;2577;7089;81;269;2009;5572;2090;5841
260800;202010;5414;12450;4799;11587;125;397;4210;9831;4335;10228
260805;202010;3677;10269;3091;9236;158;555;2326;6803;2484;7358
260810;202010;6563;17707;5738;16117;479;1251;4117;11370;4596;12621
260820;202010;4600;10517;4022;9816;99;355;3333;7937;3432;8292
260825;202010;2956;8687;2564;7996;109;381;1916;5902;2025;6283
260830;202010;4253;12303;3512;10949;458;1251;2222;7171;2680;8422
260840;202010;4230;10879;3762;10232;208;528;3107;8475;3315;9003
260845;202010;4418;11559;3909;10693;227;647;2926;7882;3153;8529
260850;202010;5181;14062;4305;12390;352;1075;2753;7660;3105;8735
260860;202010;3515;9875;2961;8914;101;354;2355;6911;2456;7265
260870;202010;4580;10891;3880;10036;69;254;3459;8825;3528;9079
260875;202010;7193;17433;5871;15496;560;1473;3991;10608;4551;12081
260880;202010;9813;27305;8468;24965;487;1465;6599;19438;7086;20903
260890;202010;13137;33425;11327;30635;600;1723;8236;21729;8836;23452
260900;202010;5451;15016;4471;13623;328;1041;2954;8996;3282;10037
260910;202010;3264;8736;2818;8063;101;319;2210;6273;2311;6592
260915;202010;5191;15093;4528;14318;57;264;4136;13093;4193;13357
260920;202010;3319;8113;2792;7546;101;248;2381;6514;2482;6762
260930;202010;3786;11814;3209;10778;192;764;2374;7782;2566;8546
260940;202010;14977;35212;13001;32461;1036;2528;9744;24001;10780;26529
260950;202010;7163;18910;5770;16481;371;1251;3734;10164;4105;11415
260960;202010;71598;158497;57323;140061;6335;15886;36333;87660;42668;103546
260970;202010;5720;14795;5066;13919;267;584;3779;10593;4046;11177
260980;202010;4601;13156;4043;12453;54;188;3683;11435;3737;11623
260990;202010;18423;49661;15555;45727;887;2796;12098;35175;12985;37971
261000;202010;16441;38398;13771;34976;380;1314;11088;27480;11468;28794
261010;202010;2392;6211;2087;5811;75;195;1810;5063;1885;5258
261020;202010;6184;16680;5294;15144;192;701;4292;11801;4484;12502
261030;202010;4083;11720;3532;10773;127;512;2780;8251;2907;8763
261040;202010;5318;15323;4286;13364;152;594;3219;9770;3371;10364
261050;202010;7895;20355;7149;19183;455;870;5446;14742;5901;15612
261060;202010;14383;35544;12480;33224;270;876;10416;27435;10686;28311
261070;202010;66420;143073;54892;127833;3041;6825;41808;95243;44849;102068
261080;202010;6792;16067;6184;15306;134;323;5696;14082;5830;14405
261090;202010;19627;45568;17380;42645;297;979;15248;36733;15545;37712
261100;202010;8552;23289;7376;21526;525;1617;5351;15661;5876;17278
261110;202010;68076;186774;56693;166322;7965;24564;32994;95619;40959;120183
261120;202010;3697;9190;3178;8484;87;222;2735;7309;2822;7531
261130;202010;7376;17814;6445;16553;119;361;5697;14502;5816;14863
261140;202010;3734;8483;3311;7912;189;474;2628;6182;2817;6656
261150;202010;5328;13798;4698;12846;74;274;4078;11022;4152;11296
261153;202010;1892;5668;1597;5097;57;195;1074;3456;1131;3651
261160;202010;216165;496858;174478;438857;42536;110213;71702;183628;114238;293841
261170;202010;6080;15067;5385;14025;320;760;4283;11096;4603;11856
261180;202010;9658;23834;8414;22197;468;1174;6103;16214;6571;17388
261190;202010;4684;13465;4172;12612;179;755;3277;9567;3456;10322
261200;202010;3432;7865;3044;7344;119;314;2565;6070;2684;6384
261210;202010;1930;4620;1634;4202;68;192;1368;3455;1436;3647
261220;202010;13892;38956;11509;34540;1461;4743;6515;19271;7976;24014
261230;202010;4059;11515;3381;10571;49;203;2807;8851;2856;9054
261240;202010;5448;13454;4758;12359;279;702;3868;9937;4147;10639
261245;202010;3721;10332;3102;9241;79;371;2469;7093;2548;7464
261247;202010;2966;8790;2453;7861;166;565;1651;5268;1817;5833
261250;202010;22650;51267;19594;47682;1776;3862;14830;37060;16606;40922
261255;202010;4116;11985;3324;10442;136;597;2446;7444;2582;8041
261260;202010;12842;34341;11065;32021;352;1428;9490;27070;9842;28498
261270;202010;4500;10897;3916;10149;192;524;3229;8264;3421;8788
261280;202010;2597;7145;2273;6589;68;240;1809;5098;1877;5338
261290;202010;2995;7637;2500;7072;70;272;2016;5741;2086;6013
261300;202010;12664;34806;10690;31445;591;2069;7773;22354;8364;24423
261310;202010;8887;22392;7565;20586;628;1905;5555;14753;6183;16658
261320;202010;6003;16822;5221;15539;80;342;4381;12838;4461;13180
261330;202010;5865;14295;5264;13508;123;435;4568;11498;4691;11933
261340;202010;4319;11920;3730;11161;142;512;3086;9129;3228;9641
261350;202010;8791;25493;7769;23766;126;574;6315;19040;6441;19614
261360;202010;8249;19783;6958;17946;245;689;5525;13882;5770;14571
261370;202010;24364;60105;20325;54474;2149;5621;13064;35329;15213;40950
261380;202010;4152;12360;3643;11467;449;1472;2385;7397;2834;8869
261390;202010;17091;47820;14358;43380;1257;4106;9501;28456;10758;32562
261400;202010;4687;14686;4059;13328;172;759;3031;9663;3203;10422
261410;202010;9759;24074;7978;21328;442;1284;6303;16423;6745;17707
261420;202010;7467;22086;6707;21146;791;2843;4690;14710;5481;17553
261430;202010;3454;9688;2900;8816;58;263;2417;7236;2475;7499
261440;202010;1494;4410;1239;3918;42;195;886;2678;928;2873
261450;202010;15091;40332;13288;37537;184;669;10978;31056;11162;31725
261460;202010;7600;20698;6691;19256;293;911;5319;15242;5612;16153
261470;202010;4201;10329;3649;9598;24;119;3146;8255;3170;8374
261480;202010;5129;15551;4404;14328;204;812;3389;10804;3593;11616
261485;202010;5022;14152;4305;13015;337;1117;3079;9164;3416;10281
261500;202010;5959;15111;5198;14075;388;931;3622;10196;4010;11127
261510;202010;1919;5611;1656;5177;63;235;1254;3942;1317;4177
261520;202010;2364;7183;2122;6682;70;250;1548;4834;1618;5084
261530;202010;12088;35087;9745;30777;900;3383;4970;15120;5870;18503
261540;202010;8178;23272;7333;22050;1077;3183;4140;13152;5217;16335
261550;202010;3724;9792;3207;8978;235;700;2286;6276;2521;6976
261560;202010;7831;23100;6761;21505;283;1068;5194;16525;5477;17593
261570;202010;3567;9487;2835;8309;188;653;1956;5624;2144;6277
261580;202010;6851;17723;5893;16421;110;505;5282;14502;5392;15007
261590;202010;2753;6996;2202;6206;76;251;1650;4624;1726;4875
261600;202010;5195;12945;4349;11684;295;692;3057;8415;3352;9107
261610;202010;2212;6209;1766;5398;97;352;1198;3622;1295;3974
261618;202010;2564;6300;2232;5812;83;216;1778;4604;1861;4820
261620;202010;4246;11813;3867;11252;775;1976;2486;7605;3261;9581
261630;202010;6359;17746;5372;15884;369;1300;3595;10190;3964;11490
261640;202010;37919;84168;32164;77028;1911;3610;24117;59621;26028;63231
261650;202010;4166;10239;3531;9401;155;482;2639;6972;2794;7454
270010;202010;4369;14437;3749;13369;164;930;2970;10261;3134;11191
270020;202010;3910;9700;3401;9041;136;450;2898;7524;3034;7974
270030;202010;34748;93187;28874;83699;3662;10422;19185;55603;22847;66025
270040;202010;10889;28917;9312;27045;377;1365;7688;22146;8065;23511
270050;202010;5563;12831;4725;11878;232;550;4114;10394;4346;10944
270060;202010;2200;5470;1827;5045;155;375;1442;4046;1597;4421
270070;202010;4704;13079;4076;12195;141;524;3373;9894;3514;10418
270080;202010;1484;3988;1241;3569;43;134;949;2622;992;2756
270090;202010;1776;5404;1590;5036;65;263;1299;4017;1364;4280
270100;202010;5522;14423;4748;13280;161;598;3940;10810;4101;11408
270110;202010;3278;7596;2633;6851;143;325;2074;5652;2217;5977
270120;202010;2764;7494;2385;6986;73;310;2008;5785;2081;6095
270130;202010;5161;13021;4454;12179;132;400;3834;10513;3966;10913
270135;202010;2050;4858;1731;4503;49;152;1563;4049;1612;4201
270140;202010;9794;22619;7811;19873;326;1075;6132;14863;6458;15938
270150;202010;2720;8074;2478;7726;3;19;2339;7270;2342;7289
270160;202010;6327;16750;5330;15631;81;331;4919;14430;5000;14761
270170;202010;3393;9867;2854;9112;183;856;2161;6601;2344;7457
270180;202010;2258;6901;2052;6631;37;181;1849;5925;1886;6106
270190;202010;1641;4860;1449;4621;35;177;1269;4019;1304;4196
270200;202010;2429;7324;2108;6888;115;435;1530;4968;1645;5403
270210;202010;5741;13408;4875;12436;73;305;4479;11236;4552;11541
270220;202010;1552;4019;1241;3582;209;628;698;1995;907;2623
270230;202010;9445;25897;7767;23292;654;2148;5501;16347;6155;18495
270235;202010;5727;17525;4918;16228;118;540;4051;13219;4169;13759
270240;202010;10702;29266;8601;26310;971;3198;5913;18138;6884;21336
270250;202010;2784;6966;2431;6457;192;500;1918;5089;2110;5589
270255;202010;4449;12691;3438;10836;113;459;2618;8120;2731;8579
270260;202010;5605;16405;5064;15512;101;501;4428;13256;4529;13757
270270;202010;1051;2705;868;2478;101;298;636;1798;737;2096
270280;202010;3949;9380;3112;8330;489;800;2162;6262;2651;7062
270290;202010;7432;23562;6644;22244;179;848;5757;19055;5936;19903
270300;202010;4312;10989;3338;9933;167;430;2577;7872;2744;8302
270310;202010;7040;19459;6028;17879;93;496;5152;14880;5245;15376
270320;202010;5576;16285;4833;14844;424;1340;3421;10251;3845;11591
270330;202010;3900;12620;3457;11939;263;1038;2637;9055;2900;10093
270340;202010;1601;4317;1382;4028;46;148;1170;3359;1216;3507
270350;202010;1910;4459;1564;4048;150;420;1103;2870;1253;3290
270360;202010;2634;6531;2341;6200;77;165;2152;5743;2229;5908
270370;202010;1401;4287;1269;4036;36;165;1061;3321;1097;3486
270375;202010;3135;7226;2593;6629;19;62;2433;6233;2452;6295
270380;202010;5508;15368;4617;14200;630;1855;2996;9587;3626;11442
270390;202010;1216;3033;987;2768;23;93;809;2265;832;2358
270400;202010;6333;16568;5277;14977;261;745;4072;11492;4333;12237
270410;202010;4637;13243;3992;12243;152;536;3305;10085;3457;10621
270420;202010;5547;16281;4966;15431;130;612;4289;13063;4419;13675
270430;202010;136763;322584;107082;284441;21066;58221;50693;136615;71759;194836
270440;202010;4732;12724;4064;11898;88;387;3529;10192;3617;10579
270450;202010;7140;19023;6224;17908;271;883;5185;15071;5456;15954
270460;202010;3802;8374;3254;7722;159;323;2914;6939;3073;7262
270470;202010;11162;30845;9646;28685;649;2132;7418;22013;8067;24145
270480;202010;2990;7830;2511;7135;94;362;2046;5671;2140;6033
270490;202010;962;2626;832;2467;49;157;662;1948;711;2105
270500;202010;4936;14950;4359;13995;292;1068;3390;10744;3682;11812
270510;202010;5599;14759;4697;13609;335;1317;3498;9652;3833;10969
270520;202010;3999;11304;3149;9849;655;2134;1286;4185;1941;6319
270530;202010;1285;3622;1085;3316;56;162;766;2375;822;2537
270540;202010;2249;6329;1932;5917;63;269;1676;5043;1739;5312
270550;202010;6786;17361;5387;15815;595;1420;4011;12255;4606;13675
270560;202010;2996;7719;2570;7144;130;413;2080;5725;2210;6138
270570;202010;4179;11651;3526;10668;120;380;2864;8610;2984;8990
270580;202010;2290;6406;2065;6075;101;304;1781;5191;1882;5495
270590;202010;1604;4788;1477;4623;15;78;1390;4321;1405;4399
270600;202010;2772;8472;2503;8065;47;242;2218;7065;2265;7307
270610;202010;3677;9512;3171;8845;102;289;2811;7812;2913;8101
270620;202010;1233;3733;1122;3514;33;140;960;2914;993;3054
270630;202010;17725;42997;15145;39433;615;1918;12651;32234;13266;34152
270640;202010;5419;15501;4671;14295;169;683;3803;11403;3972;12086
270642;202010;2530;8069;2232;7582;153;654;1699;5643;1852;6297
270644;202010;3643;9003;2975;8125;293;704;2211;6215;2504;6919
270650;202010;3151;9209;2754;8645;359;1204;1951;6086;2310;7290
270660;202010;2059;5165;1715;4674;86;300;1268;3405;1354;3705
270670;202010;16480;37421;13609;33900;389;1150;11579;28212;11968;29362
270680;202010;5597;13124;4978;12447;125;179;4652;11786;4777;11965
270690;202010;9208;22427;7670;20498;492;1302;6026;16055;6518;17357
270700;202010;523;1560;453;1447;30;119;323;1011;353;1130
270710;202010;5467;16401;4824;15403;226;953;3873;12138;4099;13091
270720;202010;3647;10555;3217;9826;63;341;2832;8466;2895;8807
270730;202010;8195;18055;7143;16925;253;492;5574;14710;5827;15202
270740;202010;2389;6211;2104;5876;92;307;1749;4814;1841;5121
270750;202010;5750;14965;5020;14033;79;375;4468;12392;4547;12767
270760;202010;3289;9178;2828;8551;47;240;2396;7147;2443;7387
270770;202010;21170;51329;16867;46047;2671;6553;10419;30049;13090;36602
270780;202010;1817;4983;1666;4768;82;281;1422;4006;1504;4287
270790;202010;1632;4475;1363;4104;103;329;1004;2990;1107;3319
270800;202010;11059;29712;9886;28037;344;1217;8472;23661;8816;24878
270810;202010;3333;9444;2612;8217;174;662;1821;5622;1995;6284
270820;202010;1639;4891;1375;4469;55;262;1076;3407;1131;3669
270830;202010;5191;12334;4176;11084;166;542;3384;8837;3550;9379
270840;202010;8313;24560;7373;23219;172;925;6434;19749;6606;20674
270850;202010;9089;21356;8006;20064;655;1853;6604;16272;7259;18125
270860;202010;14471;31839;11400;28334;598;1370;9188;22807;9786;24177
270870;202010;2197;6162;1806;5526;233;688;1179;3707;1412;4395
270880;202010;8163;24230;7240;22843;221;934;5985;18541;6206;19475
270890;202010;2858;7670;2387;6994;183;558;1654;4836;1837;5394
270895;202010;3143;9492;2837;9090;71;389;2502;7840;2573;8229
270900;202010;1791;4604;1345;3881;37;108;1051;2999;1088;3107
270910;202010;3900;11174;3341;10289;93;300;2718;8278;2811;8578
270915;202010;9492;26945;7635;23894;659;2387;5192;15871;5851;18258
270920;202010;5146;15890;4640;15022;155;770;3820;11940;3975;12710
270930;202010;17458;40281;13508;35676;1887;4532;8996;25001;10883;29533
270940;202010;6650;17151;5622;15929;196;854;4575;12590;4771;13444
280010;202010;698;1908;543;1571;14;58;382;995;396;1053
280020;202010;4946;12408;4168;11174;466;1185;2822;7625;3288;8810
280030;202010;76591;178617;60156;155209;12583;32794;26725;71859;39308;104653
280040;202010;2924;8132;2532;7518;253;771;1692;4997;1945;5768
280050;202010;3879;10967;3319;10090;563;1778;1948;5917;2511;7695
280060;202010;5954;15456;4700;13509;891;2694;2175;6521;3066;9215
280067;202010;6993;17087;5911;15441;319;821;4333;11195;4652;12016
280070;202010;1927;5646;1788;5425;129;401;1472;4437;1601;4838
280100;202010;4030;10640;3377;9600;321;949;2315;6574;2636;7523
280110;202010;1388;3729;1205;3454;17;85;1060;2959;1077;3044
280120;202010;7633;21857;6785;20497;763;2122;4919;15247;5682;17369
280130;202010;9238;21437;8064;19752;412;1109;6535;15830;6947;16939
280140;202010;5506;13040;4831;12143;205;593;4096;10173;4301;10766
280150;202010;4244;10599;3661;9795;357;878;2785;7499;3142;8377
280160;202010;1227;3465;1019;3117;93;310;696;2079;789;2389
280170;202010;5214;13711;4648;12962;241;651;3734;10444;3975;11095
280190;202010;1317;2845;1145;2617;56;126;933;2092;989;2218
280200;202010;1269;3295;1038;2969;74;266;772;2164;846;2430
280210;202010;16865;41758;14578;38492;1556;4254;9267;24498;10823;28752
280220;202010;1764;4678;1507;4333;48;216;1236;3512;1284;3728
280230;202010;4413;10942;3694;9890;318;689;2576;7028;2894;7717
280240;202010;3327;8846;2956;8275;52;270;2527;6844;2579;7114
280250;202010;896;2184;725;1923;74;210;475;1228;549;1438
280260;202010;2251;5328;1984;4995;39;103;1797;4557;1836;4660
280270;202010;2438;6489;2143;6027;141;392;1745;4880;1886;5272
280280;202010;4239;12419;3752;11693;508;1350;2607;8522;3115;9872
280290;202010;18262;47835;15609;44105;1370;4097;10393;29635;11763;33732
280300;202010;12094;28691;10529;27005;298;818;7792;21962;8090;22780
280310;202010;1405;3577;1153;3143;40;139;866;2288;906;2427
280320;202010;8670;23263;7509;21521;902;2595;5009;14215;5911;16810
280330;202010;4769;11685;4036;10664;268;735;2940;7758;3208;8493
280340;202010;5490;11470;4571;10470;227;394;3954;9234;4181;9628
280350;202010;26386;61182;23047;56770;1139;2971;18146;43930;19285;46901
280360;202010;5798;15873;5035;14600;753;2201;2936;8658;3689;10859
280370;202010;2158;5317;1793;4710;61;166;1418;3661;1479;3827
280380;202010;1012;2657;865;2454;78;216;587;1693;665;1909
280390;202010;3705;9057;3084;8078;157;382;2441;6370;2598;6752
280400;202010;3953;9906;3405;9136;539;1264;2058;5847;2597;7111
280410;202010;2270;6249;1809;5489;190;592;1042;3110;1232;3702
280420;202010;4337;11375;3966;10904;72;271;3640;9934;3712;10205
280430;202010;2085;5005;1816;4647;67;242;1474;3650;1541;3892
280440;202010;4333;11395;3779;10582;153;505;3175;8687;3328;9192
280445;202010;2337;5915;2080;5470;51;160;1558;3920;1609;4080
280450;202010;10340;23791;8919;21850;1016;2110;5923;15139;6939;17249
280460;202010;6957;16333;6282;15388;335;799;5348;12934;5683;13733
280470;202010;1716;4803;1465;4349;69;237;1080;3120;1149;3357
280480;202010;43498;104661;37362;95919;3069;8457;26469;66489;29538;74946
280490;202010;3800;10709;3255;9756;90;385;2507;7278;2597;7663
280500;202010;1010;2395;857;2187;37;115;712;1780;749;1895
280510;202010;2581;6452;2226;5951;81;288;1715;4480;1796;4768
280520;202010;1612;4092;1402;3801;56;159;1120;2992;1176;3151
280530;202010;2474;6136;2125;5643;296;660;1477;4058;1773;4718
280540;202010;8988;23848;8152;22636;260;889;7118;19471;7378;20360
280550;202010;6742;15480;5515;13753;177;635;4552;10931;4729;11566
280560;202010;7277;19933;6793;19211;159;572;5959;16628;6118;17200
280570;202010;6515;15711;5279;14147;229;709;3937;10495;4166;11204
280580;202010;5748;15027;4972;13863;590;1436;3483;9914;4073;11350
280590;202010;2936;6580;2494;6073;112;423;1959;4574;2071;4997
280600;202010;3605;9472;3158;8841;176;544;2242;6279;2418;6823
280610;202010;2507;6114;2249;5726;144;357;1833;4633;1977;4990
280620;202010;5556;13380;4747;12312;429;925;3314;8988;3743;9913
280630;202010;3859;10681;3519;10200;165;601;2892;8269;3057;8870
280640;202010;2370;6312;2084;5984;56;170;1850;5320;1906;5490
280650;202010;1201;3121;963;2764;87;289;714;1958;801;2247
280660;202010;3712;8086;3169;7450;220;404;2625;6296;2845;6700
280670;202010;19967;44706;17142;41093;1092;2631;13413;32031;14505;34662
280680;202010;2829;6708;2405;6112;228;424;1720;4452;1948;4876
280690;202010;973;2342;820;2141;53;120;643;1658;696;1778
280700;202010;1181;2937;1020;2695;28;102;806;2092;834;2194
280710;202010;15450;34309;13000;31517;541;1013;10927;27227;11468;28240
280720;202010;2684;6072;2221;5523;61;194;1617;4152;1678;4346
280730;202010;1078;2745;958;2552;48;152;726;1865;774;2017
280740;202010;14245;34514;12078;31214;740;2074;8647;21758;9387;23832
280750;202010;3667;10120;3177;9274;197;624;2281;6553;2478;7177
280760;202010;6466;16942;5591;15591;603;1536;3648;10501;4251;12037
290010;202010;3213;6711;2096;4968;5;16;1723;3904;1728;3920
290020;202010;5426;14213;4908;13547;350;639;4106;11759;4456;12398
290030;202010;4638;10479;3723;9474;178;410;3142;8097;3320;8507
290035;202010;5241;11258;4325;10071;365;541;3428;8332;3793;8873
290040;202010;4256;10296;3597;9501;108;290;2815;7854;2923;8144
290050;202010;2048;6558;1702;5798;116;478;1132;3761;1248;4239
290060;202010;1368;3218;1009;2655;101;275;648;1691;749;1966
290070;202010;37602;81597;32145;74787;1795;4368;24961;57420;26756;61788
290080;202010;5352;15499;4578;14335;471;1575;3166;10023;3637;11598
290090;202010;2173;4156;1526;3465;17;53;1392;3134;1409;3187
290100;202010;9855;25552;7933;22645;1299;3482;4285;12832;5584;16314
290110;202010;5229;13716;4625;12772;332;931;3332;9107;3664;10038
290115;202010;3985;11411;3327;10218;230;770;2451;7464;2681;8234
290120;202010;6600;16063;5537;14595;141;464;4744;12301;4885;12765
290130;202010;4724;11419;3669;10046;162;466;2846;7773;3008;8239
290135;202010;4334;10050;3520;8723;180;467;2765;6644;2945;7111
290140;202010;4582;11835;3498;10375;98;356;2934;8645;3032;9001
290150;202010;2472;6331;2123;5896;140;384;1634;4577;1774;4961
290160;202010;3431;7711;3026;7152;277;568;2382;5651;2659;6219
290170;202010;3391;8508;2987;8064;113;305;2662;7257;2775;7562
290180;202010;2989;8105;2454;7227;86;303;1997;5824;2083;6127
290190;202010;4266;11787;3724;11049;145;546;3056;8952;3201;9498
290195;202010;2351;5802;1871;5168;27;136;1582;4328;1609;4464
290200;202010;4139;11449;3348;10126;185;613;2514;7530;2699;8143
290205;202010;3484;8936;3045;8267;143;502;2354;6171;2497;6673
290210;202010;13011;36150;11465;33792;869;2353;8828;26457;9697;28810
290220;202010;2904;7113;2540;6641;121;332;2070;5391;2191;5723
290225;202010;3232;6868;2480;6072;159;281;2059;5147;2218;5428
290230;202010;2450;6452;2224;6182;30;92;1999;5545;2029;5637
290240;202010;3760;9389;2983;8402;75;251;2509;7062;2584;7313
290250;202010;3980;11514;3316;10522;109;378;2710;8724;2819;9102
290260;202010;5575;13393;4625;12020;168;529;3854;9778;4022;10307
290265;202010;3560;10236;2868;8897;218;652;2008;6249;2226;6901
290270;202010;11065;37396;10317;36113;557;2414;8266;28644;8823;31058
290280;202010;6199;18340;5330;16607;299;1037;3825;11763;4124;12800
290290;202010;10081;29004;8095;25349;806;2711;5283;16331;6089;19042
290300;202010;4255;11503;3117;9344;158;508;2229;6656;2387;7164
290310;202010;1610;3937;1270;3521;54;232;982;2625;1036;2857
290320;202010;24919;64416;19641;56294;4342;12190;9280;28111;13622;40301
290323;202010;3784;10260;3275;9465;104;329;2587;7445;2691;7774
290327;202010;4167;12017;3533;10775;260;735;2521;7651;2781;8386
290330;202010;2226;4611;1719;4066;46;73;1521;3664;1567;3737
290340;202010;5804;14325;4459;12673;444;1301;3204;9248;3648;10549
290350;202010;4812;13186;3971;11757;285;839;2815;8389;3100;9228
290360;202010;5110;13241;4461;12393;134;341;3817;10710;3951;11051
290370;202010;5273;12784;3851;10896;163;426;2762;7971;2925;8397
290380;202010;5629;14820;4702;13554;118;281;4025;11832;4143;12113
290390;202010;14698;41489;12133;37429;1315;3964;7829;24596;9144;28560
290395;202010;2884;8267;2304;7263;64;303;1748;5418;1812;5721
290400;202010;3823;10214;3047;8932;83;352;2318;6616;2401;6968
290405;202010;4713;13571;4011;12343;304;960;2741;8632;3045;9592
290410;202010;5800;15550;4421;13334;119;524;3316;9729;3435;10253
290420;202010;3033;8334;2494;7484;72;250;1917;5710;1989;5960
290430;202010;3222;8726;2627;7794;225;702;1784;5214;2009;5916
290440;202010;2914;7132;2082;5812;51;123;1459;4145;1510;4268
290450;202010;3557;8914;2763;7703;157;400;2002;5662;2159;6062
290460;202010;12035;33691;10050;29873;2036;6155;4386;13054;6422;19209
290470;202010;4592;11220;3365;9524;393;1218;1908;5484;2301;6702
290475;202010;6580;18933;5531;17069;87;489;4521;13639;4608;14128
290480;202010;1799;4547;1464;4055;80;275;1011;2673;1091;2948
290485;202010;4540;13113;3997;12347;101;519;3406;10330;3507;10849
290490;202010;9263;21606;8261;20242;502;1116;6461;16068;6963;17184
290500;202010;4087;12136;3119;10030;542;1832;1362;4253;1904;6085
290510;202010;3509;8670;2908;7885;76;244;2502;6744;2578;6988
290515;202010;3711;10147;3190;9441;45;133;2858;8614;2903;8747
290520;202010;11672;33007;8983;27805;606;2001;5419;16572;6025;18573
290530;202010;5067;14336;4243;12992;137;534;3567;10857;3704;11391
290540;202010;3412;8884;3039;8453;52;175;2805;7776;2857;7951
290550;202010;4338;11187;3736;10477;11;59;3436;9740;3447;9799
290560;202010;6463;16618;4879;14259;417;1498;3189;9020;3606;10518
290570;202010;45225;110277;39909;103473;2545;6766;31952;82328;34497;89094
290580;202010;7844;22753;6740;21142;605;1833;4921;15843;5526;17676
290590;202010;7152;21747;6016;19711;153;589;4832;15908;4985;16497
290600;202010;19346;52831;16989;48990;686;2086;13674;39277;14360;41363
290610;202010;2628;8036;2041;6830;96;377;1420;4701;1516;5078
290620;202010;6394;17884;5496;16397;198;569;4609;13732;4807;14301
290630;202010;9360;22387;7406;19860;582;1537;5676;15354;6258;16891
290640;202010;2833;7204;2156;6223;84;245;1557;4594;1641;4839
290650;202010;13270;32659;11698;30875;2570;6474;7249;20016;9819;26490
290660;202010;3681;9346;3045;8418;54;155;2278;6493;2332;6648
290670;202010;6838;18704;5746;16894;383;1063;4333;12928;4716;13991
290680;202010;10923;30077;9108;27377;208;1071;7491;22043;7699;23114
290682;202010;4822;12241;4152;11338;126;283;3498;9641;3624;9924
290685;202010;3512;7878;2502;6422;206;483;1528;4211;1734;4694
290687;202010;6666;17893;5373;15759;709;2003;3428;10316;4137;12319
290689;202010;2873;7897;2181;6611;201;657;1478;4454;1679;5111
290690;202010;5551;14306;4478;12787;305;938;3239;9108;3544;10046
290700;202010;2642;7183;2319;6772;69;231;1952;5722;2021;5953
290710;202010;8311;23277;7091;21575;159;637;5967;18170;6126;18807
290720;202010;18661;50672;16919;48024;943;2942;13542;37956;14485;40898
290730;202010;7146;16819;6075;15567;300;593;4764;12438;5064;13031
290740;202010;1038;2765;793;2366;35;113;653;1951;688;2064
290750;202010;11151;27672;9610;25191;640;1802;7105;18084;7745;19886
290755;202010;2113;5907;1682;5123;93;290;1164;3576;1257;3866
290760;202010;3779;10941;3027;9495;183;534;2046;6628;2229;7162
290770;202010;2682;8376;2449;8084;48;242;2053;6834;2101;7076
290780;202010;8321;20430;7155;18897;283;609;5567;15071;5850;15680
290790;202010;4732;12955;4088;12023;171;491;3348;9987;3519;10478
290800;202010;7164;14798;5050;12312;299;685;3744;9209;4043;9894
290810;202010;5434;14161;4337;12545;116;366;3262;9645;3378;10011
290820;202010;4870;13143;4356;12398;183;526;3284;9476;3467;10002
290830;202010;4499;10167;3979;9519;29;81;3501;8274;3530;8355
290840;202010;17348;45414;14780;41403;1982;4592;9370;27965;11352;32557
290850;202010;6707;16001;5994;15235;210;525;5135;13175;5345;13700
290860;202010;6225;17633;5404;16678;223;721;4530;14273;4753;14994
290870;202010;4844;13214;3635;10910;156;482;2541;7561;2697;8043
290880;202010;1401;3468;1117;3094;75;188;761;2202;836;2390
290890;202010;9369;18755;8373;17637;153;326;7855;16479;8008;16805
290900;202010;2441;6307;1856;5281;106;251;1145;3243;1251;3494
290910;202010;5202;12339;3962;10451;49;155;3358;8767;3407;8922
290920;202010;5187;12838;4697;12268;80;126;4391;11648;4471;11774
290930;202010;7759;21386;6187;18638;221;905;4806;14096;5027;15001
290940;202010;3723;10358;3052;9383;164;580;2433;7474;2597;8054
290950;202010;1479;3692;1200;3268;67;188;834;2280;901;2468
290960;202010;5556;14348;4958;13598;186;464;4173;11502;4359;11966
290970;202010;3367;9825;2729;8664;106;385;2085;6622;2191;7007
290980;202010;12274;29246;10239;26119;804;2237;6365;15765;7169;18002
290990;202010;9789;25671;8606;23743;265;1038;7214;19225;7479;20263
291000;202010;3448;8827;2666;7831;119;361;2165;6425;2284;6786
291005;202010;15440;37766;13554;35286;1252;2968;10518;27633;11770;30601
291010;202010;3106;9318;2509;8040;120;433;1646;5137;1766;5570
291020;202010;1248;3075;996;2626;22;74;723;1796;745;1870
291030;202010;2531;6125;1755;4781;110;274;1087;2880;1197;3154
291040;202010;5464;14833;4540;13516;161;616;3564;10558;3725;11174
291050;202010;7717;19976;6556;18370;633;1986;4752;13083;5385;15069
291060;202010;6052;18354;5117;17092;327;1405;3851;12798;4178;14203
291070;202010;16233;43124;13454;38665;428;1445;10919;31202;11347;32647
291072;202010;24954;63425;17861;51212;3255;9660;7594;21970;10849;31630
291075;202010;5479;13395;4897;12497;105;278;4078;10216;4183;10494
291077;202010;1629;4222;1261;3579;55;123;884;2510;939;2633
291080;202010;110277;269533;86010;235141;25305;70976;23326;69114;48631;140090
291085;202010;5669;14232;4750;12804;176;521;3943;10608;4119;11129
291090;202010;2021;3812;1450;3171;47;100;1166;2501;1213;2601
291100;202010;3232;6996;2214;5778;103;272;1683;4353;1786;4625
291110;202010;6020;17722;5091;16136;335;1327;3846;11753;4181;13080
291120;202010;7612;18513;6397;16967;301;859;4923;13026;5224;13885
291125;202010;2218;3873;1660;3250;91;134;1335;2663;1426;2797
291130;202010;3286;9232;2404;7499;65;292;1793;5404;1858;5696
291140;202010;4942;13210;3568;10706;454;1211;2197;6612;2651;7823
291150;202010;2510;5414;1928;4757;5;17;1819;4480;1824;4497
291160;202010;5145;13954;4225;12622;373;1184;2820;8362;3193;9546
291165;202010;2212;5947;1652;4853;28;123;1210;3446;1238;3569
291170;202010;21212;53385;17619;47300;943;2763;11606;30610;12549;33373
291180;202010;6440;14671;4689;12319;265;675;3636;9550;3901;10225
291185;202010;3117;8292;2712;7640;92;268;2069;5861;2161;6129
291190;202010;7756;18810;6369;17024;289;884;5029;13394;5318;14278
291200;202010;2822;7656;2069;6229;88;277;1279;3693;1367;3970
291210;202010;7138;15183;5318;13088;138;446;3918;9698;4056;10144
291220;202010;4098;11569;3676;10936;178;651;2916;8559;3094;9210
291230;202010;4487;9572;3375;8353;38;99;3036;7590;3074;7689
291240;202010;4249;10815;3614;9751;63;221;3098;8233;3161;8454
291250;202010;3450;10078;2668;8639;154;481;1703;5549;1857;6030
291260;202010;1447;3365;1179;3016;30;94;966;2482;996;2576
291270;202010;5437;13960;4196;12136;640;1857;2603;7712;3243;9569
291280;202010;2677;6427;1995;5424;154;434;1276;3420;1430;3854
291290;202010;5900;15396;4527;13257;338;1064;3109;9024;3447;10088
291300;202010;3881;10408;2987;8939;113;409;2271;6686;2384;7095
291310;202010;5158;13607;4380;12193;120;378;3694;10141;3814;10519
291320;202010;6149;16959;4750;14349;1060;2996;2335;7491;3395;10487
291330;202010;1784;4525;1468;4004;78;211;1093;2947;1171;3158
291340;202010;4314;11116;3486;9673;80;265;2629;7169;2709;7434
291345;202010;2946;8760;2669;8329;110;376;2238;6991;2348;7367
291350;202010;6914;16962;5354;15064;58;186;4642;13299;4700;13485
291360;202010;37907;85985;29601;75989;2845;7339;19240;50622;22085;57961
291370;202010;8142;21965;7168;20461;543;1626;5283;14824;5826;16450
291380;202010;3440;9310;3008;8714;99;405;2508;7207;2607;7612
291390;202010;13362;28418;10325;25050;455;1067;8528;20702;8983;21769
291400;202010;14011;35613;11456;31742;1547;3754;6745;20190;8292;23944
291410;202010;3006;7791;2324;6635;36;149;1703;4778;1739;4927
291420;202010;1988;4776;1545;4230;27;110;1351;3673;1378;3783
291430;202010;2793;7814;2405;7166;74;317;1934;5588;2008;5905
291440;202010;6464;18351;5558;16855;333;1066;4310;13089;4643;14155
291450;202010;9588;22633;7892;20672;77;130;6942;18712;7019;18842
291460;202010;15900;41681;13865;38623;700;2149;10416;28817;11116;30966
291465;202010;9458;23005;7429;20674;133;592;6417;17735;6550;18327
291470;202010;17126;37844;14252;34591;787;1678;10537;26388;11324;28066
291480;202010;42308;93219;31042;77793;3681;9477;16335;40999;20016;50476
291490;202010;5637;13906;4837;12992;139;444;4352;11629;4491;12073
291500;202010;5050;12231;4176;11067;71;301;3788;9986;3859;10287
291510;202010;4344;10670;3218;9244;51;290;2688;7648;2739;7938
291520;202010;4597;10351;3445;8834;188;505;2636;6710;2824;7215
291530;202010;2380;5371;1670;4440;334;813;912;2677;1246;3490
291535;202010;3462;10030;3053;9310;174;477;2338;7312;2512;7789
291540;202010;2301;5089;1573;4209;68;220;1286;3386;1354;3606
291550;202010;5716;12990;4437;11365;396;835;3015;7930;3411;8765
291560;202010;18797;43987;13457;36916;1328;3493;7958;22786;9286;26279
291570;202010;2447;5753;1924;5112;60;161;1575;4347;1635;4508
291580;202010;6395;16341;5018;14498;231;739;3695;10583;3926;11322
291590;202010;2216;5293;1919;4945;72;247;1699;4280;1771;4527
291600;202010;5612;12840;4299;10836;377;1005;2928;7137;3305;8142
291610;202010;5724;14813;5129;14153;78;289;4702;12948;4780;13237
291620;202010;3179;7042;2340;6123;108;269;1818;4862;1926;5131
291630;202010;3379;7497;2517;6365;294;801;1788;4437;2082;5238
291640;202010;16148;39451;12182;33719;1750;4686;5464;15716;7214;20402
291650;202010;9604;23669;8463;22308;580;1071;7089;19201;7669;20272
291660;202010;2104;5105;1522;4208;128;417;989;2569;1117;2986
291670;202010;2073;5425;1743;4952;103;252;1314;3793;1417;4045
291680;202010;4183;10202;3374;9024;297;816;2381;6319;2678;7135
291685;202010;4773;11288;3802;10038;232;479;2854;7828;3086;8307
291690;202010;4223;9223;2903;7304;247;500;2181;5552;2428;6052
291700;202010;8749;25025;7634;23069;336;1199;6188;18361;6524;19560
291710;202010;5374;12626;3948;10624;219;673;2875;7596;3094;8269
291720;202010;4574;13685;3789;12106;499;1658;2362;7421;2861;9079
291730;202010;6397;16191;5481;14992;267;804;4529;12324;4796;13128
291733;202010;2895;7325;2431;6709;62;170;1761;5109;1823;5279
291735;202010;2951;7743;2340;6659;72;165;1766;4997;1838;5162
291740;202010;3987;10190;2936;8236;95;237;2062;5731;2157;5968
291750;202010;19918;47127;16137;41582;1589;3986;10774;28177;12363;32163
291760;202010;10416;29746;8119;26044;2451;8894;2224;7119;4675;16013
291770;202010;7241;19200;5997;17059;351;1071;4517;12511;4868;13582
291780;202010;5199;13645;4661;12888;88;317;4091;11196;4179;11513
291790;202010;2797;7579;2530;7233;241;576;1891;5597;2132;6173
291800;202010;29659;74188;22022;62752;3514;9720;10681;31681;14195;41401
291810;202010;10765;25167;8937;22927;295;722;7518;19475;7813;20197
291820;202010;3883;10083;3346;9393;88;294;2683;7541;2771;7835
291830;202010;4511;10512;3684;9406;199;418;2900;7434;3099;7852
291835;202010;6569;19504;5137;16744;539;1859;3266;10802;3805;12661
291840;202010;48388;131277;41692;120882;4334;13386;29204;84154;33538;97540
291845;202010;2584;6579;2025;5885;115;344;1633;4802;1748;5146
291850;202010;3907;11127;3195;9936;258;763;2275;7259;2533;8022
291855;202010;2237;4308;1732;3745;41;94;1559;3376;1600;3470
291860;202010;2269;5869;1578;4542;48;132;1060;2936;1108;3068
291870;202010;1299;3243;860;2478;45;129;582;1646;627;1775
291875;202010;2959;8794;2545;7926;65;266;1864;5630;1929;5896
291880;202010;5672;15920;4787;14414;222;644;3567;10813;3789;11457
291890;202010;1682;3386;1079;2686;134;306;713;1792;847;2098
291900;202010;1258;2969;958;2504;21;80;748;1901;769;1981
291905;202010;2529;6373;2042;5600;80;284;1553;4102;1633;4386
291910;202010;3033;7448;2565;6887;57;201;2199;6042;2256;6243
291915;202010;7501;21072;6079;18672;222;775;4569;14210;4791;14985
291920;202010;26963;69320;22684;63337;2155;6567;15782;43173;17937;49740
291930;202010;2542;6783;2161;6255;239;699;1447;4221;1686;4920
291940;202010;3910;9911;2601;7683;193;566;1533;4504;1726;5070
291950;202010;9277;27729;7843;24956;290;1061;5421;17063;5711;18124
291955;202010;15656;39162;13887;36883;1170;3258;10828;28822;11998;32080
291960;202010;3073;8047;2551;7336;126;365;1972;5819;2098;6184
291970;202010;4560;11401;3804;10455;141;478;2858;7873;2999;8351
291980;202010;9738;27599;7658;23949;1050;3034;4559;14663;5609;17697
291990;202010;2334;5951;1907;5442;31;125;1761;5028;1792;5153
291992;202010;4007;9577;3181;8510;245;548;2505;6852;2750;7400
291995;202010;2143;5842;1741;5184;54;241;1311;3797;1365;4038
292000;202010;2688;6212;2178;5597;98;355;1703;4317;1801;4672
292010;202010;5805;13445;4702;11873;170;515;3898;9640;4068;10155
292020;202010;4627;13253;3828;11834;212;753;2744;8216;2956;8969
292030;202010;1848;5618;1680;5299;75;266;1062;3293;1137;3559
292040;202010;4513;11368;3495;9851;244;634;2660;7634;2904;8268
292045;202010;4043;10465;2984;8903;30;84;2636;8015;2666;8099
292050;202010;6655;18398;5335;16056;256;875;3413;10128;3669;11003
292060;202010;11510;26302;10520;25068;488;1088;9180;21672;9668;22760
292070;202010;5819;15012;5058;14106;298;835;4326;12005;4624;12840
292080;202010;3132;7834;2580;7119;80;264;2281;6254;2361;6518
292090;202010;4655;9994;3287;8346;254;666;2462;6295;2716;6961
292100;202010;11210;26981;9575;24929;975;2619;6634;17286;7609;19905
292105;202010;3616;8765;3139;8117;97;221;2592;6720;2689;6941
292110;202010;6083;14614;4268;11735;954;2661;1999;5503;2953;8164
292120;202010;7030;17821;5766;15717;355;1034;4370;11696;4725;12730
292130;202010;3464;8196;2838;7420;109;329;2212;5703;2321;6032
292140;202010;5100;11965;4263;10696;318;794;3381;8451;3699;9245
292145;202010;2385;6835;2004;6181;64;164;1538;4812;1602;4976
292150;202010;14493;38882;12528;35665;314;1185;10154;28445;10468;29630
292160;202010;2999;7201;2245;6226;40;111;1826;5308;1866;5419
292170;202010;8563;22531;7089;20133;344;1145;5337;14835;5681;15980
292180;202010;2914;7902;2122;6429;168;502;1300;3878;1468;4380
292190;202010;2982;7794;2537;7110;91;315;1986;5512;2077;5827
292200;202010;8643;21193;6418;18026;1081;3172;3261;9449;4342;12621
292205;202010;3886;10644;3353;9850;57;260;2926;8547;2983;8807
292210;202010;6530;15103;5256;13502;90;389;4723;11995;4813;12384
292220;202010;2205;5167;1931;4749;50;135;1530;3636;1580;3771
292225;202010;3230;9332;2824;8712;74;339;2390;7242;2464;7581
292230;202010;8645;20499;7716;19324;163;534;6647;16369;6810;16903
292240;202010;4814;13789;4171;12627;313;919;2909;8834;3222;9753
292250;202010;5903;15066;5294;14144;425;1108;3957;10528;4382;11636
292260;202010;3450;8899;3043;8367;100;265;2640;7275;2740;7540
292265;202010;3397;9131;2836;8283;73;300;2251;6455;2324;6755
292270;202010;4433;10065;3517;8978;116;281;2915;7449;3031;7730
292273;202010;2804;5898;2222;5191;51;86;1626;4074;1677;4160
292275;202010;1648;4261;1289;3777;58;164;972;2900;1030;3064
292280;202010;2651;6196;2125;5589;83;164;1794;4854;1877;5018
292285;202010;2584;6166;2055;5454;78;164;1668;4470;1746;4634
292290;202010;7526;19580;5937;17351;169;637;4852;14121;5021;14758
292300;202010;10720;26341;8403;23234;780;2280;5822;16141;6602;18421
292303;202010;2972;8402;2575;7768;87;209;2141;6524;2228;6733
292305;202010;2327;6201;2143;5948;44;195;1935;5277;1979;5472
292310;202010;6754;16800;5803;15648;146;477;5051;13485;5197;13962
292320;202010;6206;16770;4916;14384;275;889;3560;10142;3835;11031
292330;202010;2740;6008;2194;5396;98;192;1705;4368;1803;4560
292335;202010;4782;12324;4238;11540;220;519;3558;9771;3778;10290
292340;202010;5640;15646;4637;13717;225;669;3427;10065;3652;10734
292350;202010;2517;6775;2089;6187;76;284;1683;5005;1759;5289
292360;202010;5015;13222;4147;11757;236;748;2910;8113;3146;8861
292370;202010;10593;24430;9075;22457;131;417;8411;20556;8542;20973
292380;202010;6828;18922;6091;17608;392;1142;4631;13269;5023;14411
292390;202010;4590;8683;3369;7257;121;223;2949;6369;3070;6592
292400;202010;22712;63849;19546;58811;1919;5830;13349;40422;15268;46252
292405;202010;4528;10845;3795;9700;95;238;3143;7920;3238;8158
292410;202010;2234;5271;1854;4790;67;147;1632;4245;1699;4392
292420;202010;3467;10452;3147;9941;110;549;2700;8295;2810;8844
292430;202010;4937;14616;3700;12342;281;970;2402;8011;2683;8981
292440;202010;8570;26811;7906;25810;128;629;7066;22960;7194;23589
292450;202010;4043;11460;3153;9718;86;320;2460;7535;2546;7855
292460;202010;4958;13452;4039;11894;333;939;2904;8566;3237;9505
292465;202010;2716;6877;2307;6353;93;195;1526;4633;1619;4828
292467;202010;1911;5351;1681;5039;239;634;1161;3628;1400;4262
292470;202010;3007;7569;2320;6509;58;117;1798;5060;1856;5177
292480;202010;6395;14907;5139;13380;75;277;4648;11985;4723;12262
292490;202010;2124;5408;1773;4888;124;271;1332;3768;1456;4039
292500;202010;6692;18165;5319;15721;503;1562;3426;9992;3929;11554
292510;202010;13422;35777;10410;30987;543;1862;7231;21459;7774;23321
292520;202010;7085;17499;6269;16328;452;1213;4878;12586;5330;13799
292525;202010;6017;14119;4904;12871;125;272;4227;11292;4352;11564
292530;202010;29234;76721;22399;65062;5304;15557;8853;26285;14157;41842
292540;202010;4482;8149;3489;7088;127;213;3130;6387;3257;6600
292550;202010;8580;21911;6543;19460;510;1448;4564;14549;5074;15997
292560;202010;4441;10949;3850;10171;92;244;3181;8484;3273;8728
292570;202010;3655;9546;3052;8424;84;302;2550;6854;2634;7156
292575;202010;6962;19703;6368;18909;381;1088;5102;15326;5483;16414
292580;202010;7646;19050;6311;17076;132;433;5329;14257;5461;14690
292590;202010;7413;19632;6302;17700;279;880;5182;14289;5461;15169
292593;202010;2876;7106;2368;6254;67;172;1985;5188;2052;5360
292595;202010;5467;14363;4651;13356;151;505;3913;11171;4064;11676
292600;202010;11013;29676;9441;27266;324;940;7483;21677;7807;22617
292610;202010;4223;10887;3561;9719;205;465;2665;7377;2870;7842
292620;202010;6502;17514;5377;16156;130;288;4896;15014;5026;15302
292630;202010;8671;20987;6937;18226;727;1899;4432;11725;5159;13624
292640;202010;8284;24042;7160;22168;203;781;5088;15884;5291;16665
292650;202010;4500;11004;4046;10412;111;292;3675;9362;3786;9654
292660;202010;11556;30777;9736;28103;457;1457;7425;21443;7882;22900
292665;202010;2199;6408;1898;6012;70;207;1591;5119;1661;5326
292670;202010;3616;9662;2763;8070;118;370;1865;5333;1983;5703
292680;202010;4007;10472;3155;8984;188;496;2309;6456;2497;6952
292690;202010;2683;6827;1845;5453;201;549;1082;3361;1283;3910
292700;202010;9994;26809;8684;24822;746;1877;5956;17636;6702;19513
292710;202010;2538;7669;2351;7410;42;139;2140;6775;2182;6914
292720;202010;9087;21463;7651;19801;212;584;6076;15999;6288;16583
292730;202010;4649;10453;4332;10071;295;479;3674;8766;3969;9245
292740;202010;328565;786820;281863;719364;39195;100019;175392;445674;214587;545693
292750;202010;6258;16599;5463;15442;230;661;4200;12062;4430;12723
292760;202010;3936;11242;3410;10309;223;759;2491;7462;2714;8221
292770;202010;6425;16498;5180;14753;779;2280;3323;9721;4102;12001
292780;202010;2132;4194;1571;3510;48;133;1267;2685;1315;2818
292790;202010;4090;8574;3115;7516;158;387;2593;6299;2751;6686
292800;202010;11406;28347;9727;25806;304;850;8111;21248;8415;22098
292805;202010;3655;8665;2857;7617;106;327;2253;5948;2359;6275
292810;202010;10759;27987;8477;24402;224;909;6370;17760;6594;18669
292820;202010;7445;20391;5409;16970;431;1427;3745;11555;4176;12982
292830;202010;2896;6798;2469;6268;94;267;2090;5329;2184;5596
292840;202010;8755;22711;7392;20859;147;544;6453;17908;6600;18452
292850;202010;2536;6649;2113;6019;150;446;1477;4180;1627;4626
292860;202010;17257;37651;15449;35507;414;1017;13371;30339;13785;31356
292870;202010;18201;44706;15574;41016;1000;2631;10592;27651;11592;30282
292880;202010;11089;29978;9410;27466;265;1082;7407;20906;7672;21988
292890;202010;7176;19500;6327;18277;181;719;5531;15862;5712;16581
292895;202010;3085;6530;2228;5252;106;252;1790;4178;1896;4430
292900;202010;2606;6963;2358;6581;61;238;1939;5250;2000;5488
292905;202010;4371;11175;3446;9824;134;449;2542;7167;2676;7616
292910;202010;4916;13261;4457;12597;214;603;3409;9568;3623;10171
292920;202010;9823;26724;9023;25569;270;995;7772;21605;8042;22600
292925;202010;5468;15350;4545;13688;225;664;3273;9767;3498;10431
292930;202010;6536;19033;5604;17312;471;1609;3585;10801;4056;12410
292935;202010;2504;6129;1937;5498;22;120;1740;4949;1762;5069
292937;202010;2798;6931;2385;6377;58;159;1998;5368;2056;5527
292940;202010;2871;7244;2277;6364;178;411;1643;4778;1821;5189
292950;202010;9553;24087;8340;22300;528;1223;6301;16824;6829;18047
292960;202010;5253;12625;4388;11393;129;335;3505;9006;3634;9341
292970;202010;3851;10892;3396;10204;78;354;2829;8523;2907;8877
292975;202010;4498;9488;3971;8896;125;206;3623;8214;3748;8420
292980;202010;3335;7961;2658;6968;84;261;2166;5570;2250;5831
292990;202010;11475;31288;9539;27849;649;1971;6947;19986;7596;21957
293000;202010;2726;6316;2321;5708;42;148;1859;4569;1901;4717
293010;202010;18087;45952;14525;40349;1953;5590;8837;24540;10790;30130
293015;202010;8450;25603;6597;21980;446;1590;4353;14781;4799;16371
293020;202010;9842;28233;8839;26803;139;591;7950;24157;8089;24748
293030;202010;5306;13809;4012;11784;99;324;2761;8310;2860;8634
293040;202010;4395;11452;3698;10462;74;278;3230;9105;3304;9383
293050;202010;22927;55282;20187;51228;1142;2901;15167;37980;16309;40881
293060;202010;3528;9327;2837;8040;234;694;1957;5451;2191;6145
293070;202010;25822;61321;22020;56525;2022;5446;15907;40818;17929;46264
293075;202010;3549;11067;3073;10252;141;629;2469;8218;2610;8847
293076;202010;3571;8664;3231;8262;54;147;2882;7429;2936;7576
293077;202010;6143;16938;4969;15034;430;1415;3232;10022;3662;11437
293080;202010;4806;13973;4119;12790;91;412;3343;10171;3434;10583
293090;202010;3286;9417;2500;8111;217;693;1594;5248;1811;5941
293100;202010;5870;15432;4834;13577;222;633;3788;10528;4010;11161
293105;202010;3777;11893;3291;10900;247;849;2295;7542;2542;8391
293110;202010;2418;5977;1989;5342;72;252;1623;4254;1695;4506
293120;202010;4411;11906;3916;11124;113;292;3259;9277;3372;9569
293130;202010;3693;10102;3210;9468;77;288;2751;8043;2828;8331
293135;202010;31138;72078;22940;61223;3448;10012;10866;29317;14314;39329
293140;202010;2404;5287;2072;4880;62;145;1744;4104;1806;4249
293150;202010;5519;16258;4519;14354;333;1063;3096;9890;3429;10953
293160;202010;3873;9358;3271;8700;244;397;2721;7607;2965;8004
293170;202010;4953;10278;4299;9470;117;251;3756;8241;3873;8492
293180;202010;4437;12308;3647;10868;89;351;2888;8404;2977;8755
293190;202010;14209;38181;12474;35659;145;647;11074;31405;11219;32052
293200;202010;8500;20887;6772;18163;198;694;5411;14215;5609;14909
293210;202010;5222;13706;4458;12526;276;771;3434;9626;3710;10397
293220;202010;5055;12936;3683;10589;857;2460;1465;4327;2322;6787
293230;202010;3866;9894;2838;8419;208;696;1933;5791;2141;6487
293240;202010;4539;11929;3628;10445;67;159;2747;8239;2814;8398
293245;202010;3868;10358;3454;9760;144;474;2935;8165;3079;8639
293250;202010;5975;13746;4857;12308;155;396;4043;10242;4198;10638
293260;202010;4672;12265;3837;10967;167;486;2614;7528;2781;8014
293270;202010;7265;15932;5718;14274;412;616;4468;12016;4880;12632
293280;202010;4542;11863;3922;10983;242;592;3027;8585;3269;9177
293290;202010;14679;42077;12896;39283;1672;5147;8486;26119;10158;31266
293300;202010;5831;14057;4986;12821;285;726;3613;9338;3898;10064
293305;202010;4120;9639;3578;8968;53;124;3228;8093;3281;8217
293310;202010;2134;5434;1781;4883;53;158;1408;3815;1461;3973
293315;202010;4200;9797;3436;8649;207;450;2816;7102;3023;7552
293317;202010;2668;6207;2353;5771;146;274;1858;4578;2004;4852
293320;202010;12318;29221;10900;27638;253;703;9754;24590;10007;25293
293325;202010;1800;4397;1393;3852;207;560;839;2366;1046;2926
293330;202010;59409;166187;48042;145975;8713;27424;22290;67684;31003;95108
293340;202010;2224;6204;1824;5491;83;275;1297;3844;1380;4119
293345;202010;3570;9538;2853;8469;368;847;1827;5964;2195;6811
293350;202010;6616;18863;5692;17756;62;310;5186;16383;5248;16693
293360;202010;15539;38514;13159;35339;294;1219;11583;30533;11877;31752
310010;202010;955;2154;615;1676;50;178;230;573;280;751
310020;202010;2731;7304;2026;6043;444;1437;437;1233;881;2670
310030;202010;1927;5374;1473;4586;216;738;939;2817;1155;3555
310040;202010;895;2316;703;1984;30;129;482;1271;512;1400
310050;202010;1490;4452;1247;4062;127;527;818;2556;945;3083
310060;202010;3174;8882;2747;8313;79;316;2275;6804;2354;7120
310070;202010;347;782;242;633;10;23;177;459;187;482
310080;202010;701;1856;500;1493;73;240;230;650;303;890
310090;202010;4769;12435;3895;11017;297;878;2842;7908;3139;8786
310100;202010;3534;9614;2946;8635;77;348;2392;6804;2469;7152
310110;202010;4676;12200;3615;10347;769;2406;1580;4331;2349;6737
310120;202010;642;1560;404;1179;43;151;238;643;281;794
310130;202010;374;962;311;869;27;106;229;601;256;707
310140;202010;272;783;191;640;40;157;71;208;111;365
310150;202010;5518;14396;4058;11696;532;1760;1928;5229;2460;6989
310160;202010;7951;19708;5644;15885;1075;3312;1991;5644;3066;8956
310163;202010;1029;3025;819;2625;181;665;276;814;457;1479
310170;202010;9361;23518;7437;20502;646;1838;5232;14390;5878;16228
310180;202010;1815;4475;1323;3663;162;495;775;2077;937;2572
310190;202010;2605;7493;2100;6571;468;1636;343;998;811;2634
310200;202010;1889;5539;1373;4537;179;671;646;2093;825;2764
310205;202010;1134;3090;873;2680;151;519;423;1276;574;1795
310210;202010;2629;6951;2131;6084;111;325;1539;4293;1650;4618
310220;202010;1278;3431;979;2849;86;268;643;1792;729;2060
310230;202010;2275;6223;1818;5352;227;745;1144;3137;1371;3882
310240;202010;976;2952;822;2676;53;202;577;1832;630;2034
310250;202010;1058;2787;852;2449;17;72;591;1686;608;1758
310260;202010;3229;8234;2087;6235;600;2092;615;1439;1215;3531
310270;202010;2752;6667;2172;5880;97;309;1781;4808;1878;5117
310280;202010;2477;5684;1911;4863;268;713;1115;2725;1383;3438
310285;202010;1850;5838;1534;5272;168;650;934;3182;1102;3832
310290;202010;1142;2986;931;2610;203;655;487;1224;690;1879
310300;202010;1545;4426;1311;4030;142;525;761;2180;903;2705
310310;202010;303;727;196;540;32;94;97;259;129;353
310320;202010;527;1326;360;1058;24;86;200;558;224;644
310330;202010;484;1142;287;794;42;133;117;292;159;425
310340;202010;8002;21061;6407;18391;877;2476;3247;9515;4124;11991
310350;202010;13014;31131;8876;24421;1554;4591;4072;10759;5626;15350
310360;202010;501;1124;381;969;12;34;258;660;270;694
310370;202010;1302;3990;1102;3608;206;736;356;1221;562;1957
310375;202010;881;2170;617;1774;100;295;325;934;425;1229
310380;202010;405;913;224;623;36;105;100;259;136;364
310390;202010;448;1321;350;1132;78;268;101;284;179;552
310400;202010;10344;24884;7396;20441;701;2243;4558;12272;5259;14515
310410;202010;891;2553;579;1969;89;333;219;696;308;1029
310420;202010;4542;11697;3076;8878;409;1331;1283;3419;1692;4750
310430;202010;1528;4122;994;3129;211;727;350;973;561;1700
310440;202010;664;1717;458;1342;42;151;243;670;285;821
310445;202010;1401;3924;1010;3139;61;197;722;2204;783;2401
310450;202010;4725;11737;3531;9851;138;512;2686;7273;2824;7785
310460;202010;1762;4611;1292;3746;206;642;458;1239;664;1881
310470;202010;3784;8191;2924;7068;300;699;2048;5091;2348;5790
310480;202010;982;2492;757;2130;83;247;480;1314;563;1561
310490;202010;2825;7609;2196;6581;227;844;1249;3515;1476;4359
310500;202010;1365;3815;1021;3227;179;649;546;1657;725;2306
310510;202010;2137;5526;1385;4123;247;831;513;1506;760;2337
310520;202010;1206;3101;867;2495;138;389;454;1305;592;1694
310530;202010;740;1853;474;1371;69;244;160;374;229;618
310540;202010;2988;8437;2472;7545;541;1739;1124;3285;1665;5024
310550;202010;1269;3205;890;2561;77;276;506;1350;583;1626
310560;202010;15138;39013;10698;31215;1517;5056;4624;12173;6141;17229
310570;202010;1027;2658;807;2350;55;196;598;1709;653;1905
310590;202010;4110;10821;3267;9259;204;661;1886;5041;2090;5702
310600;202010;1320;3877;1069;3351;142;505;553;1624;695;2129
310610;202010;475;1274;300;991;111;375;42;122;153;497
310620;202010;174432;439831;125815;351959;17869;58030;61576;156112;79445;214142
310630;202010;4564;12378;3554;10387;337;1049;2221;6274;2558;7323
310640;202010;1101;3232;899;2838;182;623;369;1114;551;1737
310650;202010;2428;6807;1753;5503;178;581;1009;3074;1187;3655
310660;202010;1308;3476;1068;3154;33;112;901;2641;934;2753
310665;202010;1432;3616;1149;3206;30;110;927;2615;957;2725
310670;202010;58872;149734;49431;133527;4556;14073;34048;87474;38604;101547
310680;202010;774;1796;633;1600;18;64;541;1313;559;1377
310690;202010;1949;5063;1397;4124;109;366;789;2213;898;2579
310700;202010;489;1070;388;950;22;69;306;724;328;793
310710;202010;5685;15938;4134;13644;862;3389;743;2181;1605;5570
310720;202010;1031;2357;804;2070;31;100;612;1529;643;1629
310730;202010;10154;26733;8643;24310;385;1343;6428;17678;6813;19021
310740;202010;6488;17530;4509;13425;675;2244;1707;4584;2382;6828
310750;202010;1265;3004;935;2527;106;320;492;1241;598;1561
310760;202010;639;1614;441;1306;38;119;235;709;273;828
310770;202010;1114;2964;765;2432;80;311;398;1164;478;1475
310780;202010;4338;10315;3577;9304;76;203;2898;7564;2974;7767
310790;202010;1798;5643;1544;5093;354;1249;261;764;615;2013
310800;202010;2333;6843;1695;5539;362;1418;107;276;469;1694
310810;202010;1275;3111;1036;2716;45;126;747;1881;792;2007
310820;202010;1211;3082;736;2278;178;578;156;494;334;1072
310825;202010;2610;7728;2081;6855;69;397;1679;5330;1748;5727
310830;202010;1896;5273;1332;4142;244;870;553;1614;797;2484
310840;202010;2082;5605;1517;4648;353;1250;377;982;730;2232
310850;202010;1468;3995;1222;3651;44;219;953;2716;997;2935
310855;202010;3100;8140;2396;7000;167;583;1709;4838;1876;5421
310860;202010;6947;20002;5533;17214;544;1785;3385;10628;3929;12413
310870;202010;967;2298;754;1991;57;136;553;1467;610;1603
310880;202010;992;2958;776;2516;111;377;437;1371;548;1748
310890;202010;2248;6380;1437;4734;264;940;220;621;484;1561
310900;202010;3944;10902;2674;8102;392;1241;1120;3164;1512;4405
310910;202010;2118;5127;1476;4105;132;423;311;802;443;1225
310920;202010;1940;5027;1467;4300;199;635;830;2382;1029;3017
310925;202010;945;2551;756;2243;69;242;514;1438;583;1680
310930;202010;5776;14974;4024;12104;771;2364;1830;5733;2601;8097
310940;202010;6799;15892;5450;13939;191;582;4182;10406;4373;10988
310945;202010;1320;3427;1034;2962;183;548;492;1373;675;1921
310950;202010;1917;5638;1239;4100;220;804;391;1104;611;1908
310960;202010;746;1995;407;1266;68;250;78;221;146;471
310970;202010;1140;3342;793;2601;200;731;145;436;345;1167
310980;202010;273;654;180;515;19;65;112;310;131;375
310990;202010;1328;3652;1031;3132;164;541;528;1574;692;2115
311000;202010;4013;11091;2912;9233;715;2435;1180;3631;1895;6066
311010;202010;912;2588;733;2237;215;729;306;911;521;1640
311020;202010;1108;2802;692;2042;38;118;377;1089;415;1207
311030;202010;1715;4182;1184;3310;222;690;528;1404;750;2094
311040;202010;278;867;228;756;68;237;72;226;140;463
311050;202010;2924;7099;2164;5989;360;1162;1101;2890;1461;4052
311060;202010;3239;8195;2377;6572;325;1029;979;2463;1304;3492
311070;202010;2313;5720;1670;4712;168;628;925;2418;1093;3046
311080;202010;1164;2605;928;2233;63;182;718;1639;781;1821
311090;202010;2039;6450;1590;5592;356;1391;483;1658;839;3049
311100;202010;2405;6791;1400;4700;266;1009;249;744;515;1753
311110;202010;3728;7592;2063;5257;362;980;739;1938;1101;2918
311115;202010;1398;3057;1168;2748;62;152;943;2179;1005;2331
311120;202010;6755;17586;5122;14639;712;2287;1945;4944;2657;7231
311130;202010;1893;4875;1437;4247;105;392;830;2371;935;2763
311140;202010;1454;3525;1128;3078;77;255;778;2080;855;2335
311150;202010;1475;4664;1140;4010;183;713;607;2073;790;2786
311160;202010;3833;10916;2673;8714;669;2406;791;2460;1460;4866
311170;202010;899;2250;709;1998;41;118;442;1312;483;1430
311180;202010;1383;3112;861;2336;163;487;383;1029;546;1516
311190;202010;876;2406;666;1998;114;390;267;697;381;1087
311200;202010;2058;5527;1477;4412;278;911;534;1443;812;2354
311205;202010;871;2592;701;2252;49;214;441;1337;490;1551
311210;202010;1001;2901;865;2717;109;308;621;2003;730;2311
311220;202010;738;2040;616;1824;49;169;390;1091;439;1260
311230;202010;7828;23291;5898;19348;1092;3727;2184;7324;3276;11051
311240;202010;1050;2715;807;2366;174;540;330;972;504;1512
311250;202010;1130;3254;865;2746;186;566;331;1005;517;1571
311260;202010;2713;6638;1732;4919;269;867;739;1910;1008;2777
311265;202010;1320;3394;966;2796;43;161;659;1864;702;2025
311270;202010;2996;8871;2603;8215;154;665;1895;5714;2049;6379
311280;202010;1073;2747;495;1570;84;303;38;100;122;403
311290;202010;1867;5626;1699;5277;146;463;1136;3522;1282;3985
311300;202010;4720;12986;3844;11517;195;776;3032;8877;3227;9653
311310;202010;575;1589;481;1421;44;137;291;826;335;963
311320;202010;3206;9678;2731;8652;365;1377;1320;3773;1685;5150
311330;202010;5184;13443;4081;11646;447;1384;2268;6590;2715;7974
311340;202010;10614;29429;8361;25409;2131;7064;2344;6702;4475;13766
311350;202010;2456;5973;1742;4674;167;476;922;2231;1089;2707
311360;202010;1136;2759;718;2123;196;657;239;682;435;1339
311370;202010;4687;11229;3422;9243;144;565;2278;5767;2422;6332
311380;202010;366;1089;263;874;65;209;112;397;177;606
311390;202010;1765;5300;1394;4780;604;2318;346;1073;950;3391
311400;202010;1525;4147;1100;3319;173;553;387;1031;560;1584
311410;202010;1723;4994;1370;4461;208;774;772;2444;980;3218
311420;202010;1537;4476;1064;3493;194;710;270;732;464;1442
311430;202010;4118;10741;2730;8003;499;1500;893;2573;1392;4073
311440;202010;2809;7808;2094;6575;511;1892;501;1475;1012;3367
311450;202010;1716;5084;1230;4172;324;1251;326;952;650;2203
311455;202010;1009;2230;666;1721;169;440;260;717;429;1157
311460;202010;487;1495;322;1137;65;300;87;253;152;553
311470;202010;515;1591;342;1182;81;329;52;167;133;496
311480;202010;1043;2673;854;2381;46;134;660;1833;706;1967
311490;202010;252;739;185;604;33;131;85;243;118;374
311500;202010;467;1147;364;999;22;69;243;644;265;713
311510;202010;3266;8422;2215;6591;300;997;933;2610;1233;3607
311520;202010;636;1759;557;1605;71;261;310;869;381;1130
311530;202010;8796;20427;5513;15129;1338;4054;1435;3743;2773;7797
311535;202010;794;2162;517;1582;82;254;179;512;261;766
311540;202010;491;1545;435;1437;81;306;288;910;369;1216
311545;202010;2020;5709;1715;5233;96;336;1320;3968;1416;4304
311547;202010;1467;3720;1263;3405;49;126;856;2335;905;2461
311550;202010;2762;7666;2175;6596;304;1058;929;2667;1233;3725
311560;202010;303;651;191;486;75;183;42;98;117;281
311570;202010;1664;3798;1167;3111;35;101;924;2504;959;2605
311580;202010;2153;3992;1412;3116;148;302;940;2081;1088;2383
311590;202010;495;1303;394;1149;64;214;219;626;283;840
311600;202010;1754;3925;1457;3529;67;160;1238;2956;1305;3116
311610;202010;2283;7278;1880;6426;199;750;1066;3576;1265;4326
311615;202010;3243;8992;2619;7946;115;423;2053;6108;2168;6531
311620;202010;444;1122;383;1055;8;32;329;895;337;927
311630;202010;1345;3660;1092;3134;100;328;718;1974;818;2302
311640;202010;661;1778;524;1541;68;239;243;641;311;880
311650;202010;1933;4902;1580;4349;166;501;1003;2670;1169;3171
311660;202010;2926;8224;2146;6703;383;1334;605;1585;988;2919
311670;202010;1554;4043;1127;3270;167;547;446;1288;613;1835
311680;202010;2155;6105;1603;5068;164;512;1070;3374;1234;3886
311690;202010;612;1296;476;1125;39;74;347;872;386;946
311700;202010;2220;5293;1725;4611;25;123;1458;3777;1483;3900
311710;202010;1524;4331;1098;3570;267;943;393;1265;660;2208
311720;202010;420;1227;333;1067;29;111;174;558;203;669
311730;202010;3781;9656;2402;7003;701;2200;474;1422;1175;3622
311740;202010;875;2284;733;2112;68;192;594;1761;662;1953
311750;202010;3869;11507;3076;10053;433;1536;1737;5451;2170;6987
311760;202010;645;1801;528;1591;69;253;267;697;336;950
311770;202010;2096;5970;1626;5119;247;818;760;2303;1007;3121
311780;202010;1348;3811;921;2953;157;575;289;800;446;1375
311783;202010;2291;6106;1830;5301;37;171;1478;4100;1515;4271
311787;202010;782;2232;589;1771;82;276;253;641;335;917
311790;202010;1490;3993;965;3029;238;827;258;754;496;1581
311800;202010;4799;14356;3851;12293;787;2679;628;1739;1415;4418
311810;202010;952;2839;748;2473;52;185;497;1624;549;1809
311820;202010;786;1888;578;1568;65;211;360;917;425;1128
311830;202010;8443;24027;5695;18057;1580;5431;685;2117;2265;7548
311840;202010;3612;9044;2901;8023;252;746;2130;5836;2382;6582
311850;202010;362;953;294;825;13;41;197;531;210;572
311860;202010;60277;150802;45883;126224;6523;19412;25709;67352;32232;86764
311870;202010;1900;4996;1281;3879;231;819;479;1274;710;2093
311880;202010;6296;16218;5235;14754;286;723;3926;11293;4212;12016
311890;202010;1698;4037;1304;3467;88;273;933;2351;1021;2624
311900;202010;743;1910;556;1657;63;219;351;1018;414;1237
311910;202010;4144;10605;3102;9240;546;1594;1566;4817;2112;6411
311920;202010;2126;5546;1690;4915;120;311;1060;3194;1180;3505
311930;202010;3865;8978;2754;7401;839;2450;811;2015;1650;4465
311940;202010;15745;40869;11535;32891;1613;5038;5265;13957;6878;18995
311950;202010;2347;6199;1748;5189;120;415;1036;3129;1156;3544
311960;202010;497;1206;395;1056;24;90;256;624;280;714
311970;202010;422;1345;308;1054;53;220;72;205;125;425
311980;202010;453;1218;237;784;21;67;83;272;104;339
311990;202010;544;1257;339;950;66;234;145;358;211;592
311995;202010;965;2636;486;1543;21;68;70;149;91;217
312000;202010;772;1908;571;1609;55;148;355;1022;410;1170
312010;202010;978;2639;748;2258;50;171;482;1375;532;1546
312015;202010;1377;3972;1208;3697;49;203;977;2924;1026;3127
312020;202010;1597;4869;1204;4019;245;870;295;907;540;1777
312030;202010;2015;4924;1747;4628;17;56;1634;4329;1651;4385
312040;202010;855;2486;593;1967;69;237;269;859;338;1096
312050;202010;1199;3692;959;3225;215;854;301;892;516;1746
312060;202010;866;2112;563;1729;135;420;269;836;404;1256
312070;202010;905;2587;639;2042;40;142;355;1070;395;1212
312080;202010;2643;6484;1961;5471;106;343;1278;3415;1384;3758
312083;202010;886;2278;651;1909;51;186;442;1249;493;1435
312087;202010;2484;6431;1996;5667;45;139;1557;4459;1602;4598
312090;202010;10349;26755;7991;23008;1151;3644;4087;11394;5238;15038
312100;202010;1573;4469;1221;3820;105;407;719;2133;824;2540
312110;202010;1035;3177;857;2814;187;711;312;920;499;1631
312120;202010;992;2656;659;2051;164;594;205;518;369;1112
312125;202010;1720;4411;1431;3992;112;367;1064;2848;1176;3215
312130;202010;1039;2521;777;2083;65;193;346;846;411;1039
312140;202010;694;1984;566;1728;117;397;242;680;359;1077
312150;202010;449;1244;381;1105;14;58;271;736;285;794
312160;202010;8851;23922;6697;20078;825;2829;3304;9414;4129;12243
312170;202010;900;2433;678;2001;38;142;446;1275;484;1417
312180;202010;1402;3726;1103;3152;162;476;557;1539;719;2015
312190;202010;678;1858;489;1489;79;268;171;478;250;746
312200;202010;4545;12352;3564;10762;1081;3250;1231;3846;2312;7096
312210;202010;1389;3055;996;2491;35;105;753;1839;788;1944
312220;202010;1617;4975;1392;4553;103;364;880;2878;983;3242
312230;202010;13434;34544;8866;26192;2084;6968;1757;4402;3841;11370
312235;202010;1974;4952;1546;4316;93;305;1099;2978;1192;3283
312240;202010;704;2278;534;1915;117;455;154;530;271;985
312245;202010;2666;6835;2166;6069;65;179;1767;4922;1832;5101
312247;202010;970;2345;698;1945;123;361;363;1026;486;1387
312250;202010;984;2590;623;1866;85;271;233;672;318;943
312260;202010;933;2488;741;2190;38;153;565;1608;603;1761
312270;202010;715;1963;537;1607;29;116;306;837;335;953
312280;202010;420;1242;327;1074;96;325;45;136;141;461
312290;202010;767;2242;615;1965;106;377;214;661;320;1038
312300;202010;969;2920;646;2126;158;567;121;328;279;895
312310;202010;980;2921;782;2503;122;421;357;1075;479;1496
312320;202010;1987;5087;1439;4113;337;1016;332;904;669;1920
312330;202010;848;2475;674;2109;60;214;410;1253;470;1467
312340;202010;261;680;184;550;44;156;78;204;122;360
312350;202010;248;497;174;417;17;48;118;270;135;318
312352;202010;1598;4766;1416;4439;88;281;863;2884;951;3165
312360;202010;2790;8002;2040;6548;395;1392;670;2021;1065;3413
312370;202010;1911;4885;1540;4258;176;536;914;2396;1090;2932
312380;202010;2149;4812;1763;4328;4;12;1577;3829;1581;3841
312385;202010;1237;3341;966;2852;145;455;448;1329;593;1784
312390;202010;1882;5394;1404;4488;196;723;523;1533;719;2256
312400;202010;2869;8159;2352;7252;707;2355;739;2251;1446;4606
312410;202010;11740;32197;9488;28387;1659;5136;5172;15273;6831;20409
312420;202010;3752;10089;3111;9042;575;1831;1640;4644;2215;6475
312430;202010;7822;20743;6366;18104;402;1337;4488;12425;4890;13762
312440;202010;931;2960;730;2497;353;1292;106;322;459;1614
312450;202010;1197;3488;908;2985;255;894;296;1009;551;1903
312460;202010;439;1151;301;936;47;148;152;492;199;640
312470;202010;476;1128;296;812;31;93;110;268;141;361
312480;202010;1048;2582;728;2110;96;311;357;976;453;1287
312490;202010;2119;5155;1626;4419;209;598;879;2321;1088;2919
312500;202010;1014;2473;827;2210;50;171;577;1518;627;1689
312510;202010;3755;9911;2662;7834;658;1876;687;2053;1345;3929
312520;202010;178;482;134;408;35;112;58;177;93;289
312530;202010;586;1429;501;1326;16;56;441;1170;457;1226
312540;202010;1595;4405;1062;3317;142;470;597;1804;739;2274
312550;202010;798;2089;604;1697;48;149;386;995;434;1144
312560;202010;1938;4981;1541;4356;74;228;1165;3284;1239;3512
312570;202010;2194;5327;1639;4624;461;1342;621;1837;1082;3179
312580;202010;618;1696;432;1305;56;198;196;547;252;745
312590;202010;1615;4665;1273;3976;81;376;802;2312;883;2688
312595;202010;1983;5768;1655;5205;265;780;981;3250;1246;4030
312600;202010;1194;2848;673;1847;114;391;131;403;245;794
312610;202010;6792;17120;4459;12738;674;2112;1541;4046;2215;6158
312620;202010;2529;6474;1865;5538;56;233;1476;4474;1532;4707
312630;202010;286;813;201;657;36;138;78;246;114;384
312640;202010;520;1415;361;1143;40;133;142;456;182;589
312650;202010;2043;5220;1387;3984;66;213;973;2660;1039;2873
312660;202010;1354;3258;1014;2680;99;277;677;1736;776;2013
312670;202010;4933;12965;4079;11594;182;732;2958;8037;3140;8769
312675;202010;1281;3318;1044;2970;57;182;848;2381;905;2563
312680;202010;1376;3858;1183;3558;54;226;972;2836;1026;3062
312690;202010;2947;6185;2289;5393;49;134;1914;4511;1963;4645
312695;202010;963;2598;797;2307;41;93;622;1806;663;1899
312700;202010;2101;5502;1513;4426;154;523;838;2317;992;2840
312705;202010;1426;3342;1211;3024;15;52;1104;2730;1119;2782
312707;202010;1376;3978;1055;3389;67;309;682;2068;749;2377
312710;202010;6524;14892;3800;10607;945;2829;1067;3083;2012;5912
312720;202010;1080;2844;808;2412;104;331;497;1436;601;1767
312730;202010;1643;3848;1158;3177;97;295;672;1775;769;2070
312733;202010;1378;3615;1043;2979;38;147;714;1930;752;2077
312735;202010;716;1923;597;1689;76;234;344;877;420;1111
312737;202010;810;1831;565;1471;73;209;352;875;425;1084
312738;202010;672;1705;477;1379;44;140;268;736;312;876
312740;202010;434;1072;250;755;47;155;62;144;109;299
312750;202010;1576;4541;1165;3763;209;712;498;1530;707;2242
312760;202010;1771;5189;1242;4094;223;793;454;1422;677;2215
312770;202010;45533;108608;28334;78955;5706;17090;9460;25613;15166;42703
312780;202010;2433;7214;2043;6582;243;827;1301;4188;1544;5015
312790;202010;247;577;129;391;5;25;41;107;46;132
312800;202010;4902;13776;3687;11434;890;2911;1291;3878;2181;6789
312810;202010;1587;4207;1049;3332;260;917;370;1079;630;1996
312820;202010;1777;4686;1405;4037;52;188;1050;2933;1102;3121
312825;202010;1353;3141;1170;2900;19;63;1006;2447;1025;2510
312830;202010;2883;8018;1710;5576;335;1238;430;1317;765;2555
312840;202010;1351;3614;1068;3133;91;343;579;1569;670;1912
312850;202010;940;2271;661;1856;24;99;406;1050;430;1149
312860;202010;1154;2976;770;2362;192;630;184;513;376;1143
312870;202010;6133;16412;3707;11711;600;2031;839;2456;1439;4487
312880;202010;1431;3537;1099;2971;38;124;653;1769;691;1893
312890;202010;2276;5620;1640;4564;116;309;831;2355;947;2664
312900;202010;1226;3095;989;2788;155;486;457;1401;612;1887
312910;202010;1649;2999;860;1956;171;327;323;766;494;1093
312920;202010;1008;2663;693;2136;118;422;286;804;404;1226
312930;202010;2357;5763;1808;4944;410;1144;786;2190;1196;3334
312940;202010;967;2642;751;2317;70;267;387;1121;457;1388
312950;202010;3108;7690;2002;5880;517;1653;628;1779;1145;3432
312960;202010;1815;4762;1526;4318;74;194;1178;3418;1252;3612
312965;202010;1636;4517;1357;4071;116;352;935;2761;1051;3113
312970;202010;1373;3813;1074;3323;148;558;631;1823;779;2381
312980;202010;24390;66430;19534;57600;3792;12160;9188;25389;12980;37549
312990;202010;489;1217;306;897;54;176;148;405;202;581
313000;202010;490;1394;364;1159;30;127;211;627;241;754
313005;202010;2521;7201;2101;6474;162;481;1480;4534;1642;5015
313010;202010;5104;13881;4053;12164;708;2323;2374;6972;3082;9295
313020;202010;1075;3205;747;2443;127;448;143;390;270;838
313030;202010;1126;2587;756;2040;91;300;485;1223;576;1523
313040;202010;798;2431;658;2149;44;184;389;1208;433;1392
313050;202010;1769;4831;1220;3994;201;790;391;1134;592;1924
313055;202010;1910;5084;1684;4756;58;186;1453;4083;1511;4269
313060;202010;979;2349;706;1882;180;580;131;308;311;888
313065;202010;1656;4882;1444;4528;52;190;1114;3409;1166;3599
313070;202010;954;2500;716;2086;69;219;424;1199;493;1418
313080;202010;395;1092;291;890;51;180;107;278;158;458
313090;202010;5123;13502;4330;12215;344;1116;2889;8050;3233;9166
313100;202010;1347;3457;1037;3009;27;112;787;2223;814;2335
313110;202010;1478;3872;1071;3159;99;356;599;1659;698;2015
313115;202010;2656;7598;2125;6544;280;966;1106;3184;1386;4150
313120;202010;3746;8825;2718;7471;223;711;1756;4780;1979;5491
313130;202010;31655;80943;23927;66689;2567;8120;13533;35503;16100;43623
313140;202010;622;1332;367;968;30;74;244;649;274;723
313150;202010;1375;3823;1011;3153;303;1034;207;570;510;1604
313160;202010;1183;2933;924;2537;25;88;690;1838;715;1926
313170;202010;11420;32165;8141;26031;1369;4796;3253;9754;4622;14550
313180;202010;2100;5499;1481;4276;197;588;837;2371;1034;2959
313190;202010;4400;12535;3180;10040;570;1946;1092;3202;1662;5148
313200;202010;1096;3016;951;2762;17;60;801;2254;818;2314
313210;202010;3862;11089;3122;9746;390;1319;1835;5533;2225;6852
313220;202010;1764;4607;1160;3404;167;547;466;1206;633;1753
313230;202010;2993;8255;2455;7585;46;167;2048;6473;2094;6640
313240;202010;9872;24032;6122;17949;1007;3389;2600;7065;3607;10454
313250;202010;6269;18225;4638;14770;838;2720;2026;6286;2864;9006
313260;202010;647;1680;462;1347;62;236;222;587;284;823
313270;202010;5860;14368;4676;12702;577;1505;3149;8736;3726;10241
313280;202010;470;1312;299;956;38;135;131;395;169;530
313290;202010;956;2943;696;2472;214;822;217;770;431;1592
313300;202010;1622;4292;1166;3471;290;938;278;709;568;1647
313310;202010;1194;3514;922;2941;150;572;267;718;417;1290
313320;202010;2144;5679;1542;4693;268;932;625;1915;893;2847
313330;202010;4127;10703;3103;9151;172;614;1989;5845;2161;6459
313340;202010;1411;3151;994;2574;89;244;694;1780;783;2024
313350;202010;2863;7936;1817;5529;228;764;651;1739;879;2503
313360;202010;1507;3616;1031;2858;156;527;541;1372;697;1899
313370;202010;1473;4121;1220;3614;145;507;665;1807;810;2314
313375;202010;1794;4646;1116;3372;196;637;239;672;435;1309
313380;202010;6319;15736;4497;12396;788;2434;2102;5141;2890;7575
313390;202010;804;2570;695;2386;51;239;464;1523;515;1762
313400;202010;3683;9039;2824;7851;153;470;2158;5908;2311;6378
313410;202010;1323;3408;1014;2859;53;180;756;2074;809;2254
313420;202010;15759;34880;8034;21868;1809;5489;1145;3053;2954;8542
313430;202010;969;2829;739;2349;128;501;317;868;445;1369
313440;202010;6243;13522;4060;10633;395;1069;2478;6504;2873;7573
313450;202010;743;1970;519;1530;86;273;177;449;263;722
313460;202010;2118;5986;1673;5285;338;1214;780;2320;1118;3534
313470;202010;2907;7359;2284;6440;243;693;1487;4234;1730;4927
313480;202010;1020;2894;568;1876;67;249;176;523;243;772
313490;202010;2692;6459;1313;3986;321;1081;264;778;585;1859
313500;202010;519;1435;381;1139;42;125;146;396;188;521
313505;202010;10173;26595;8656;24519;351;1220;6953;19648;7304;20868
313507;202010;1478;3801;1199;3366;34;142;955;2594;989;2736
313510;202010;13842;37940;10814;32079;1313;4049;5024;14594;6337;18643
313520;202010;14346;40125;11390;34996;597;2223;8491;25444;9088;27667
313530;202010;527;1550;395;1262;46;159;158;457;204;616
313535;202010;2375;6538;1953;5721;264;701;1187;3496;1451;4197
313540;202010;776;2282;619;1909;108;347;259;732;367;1079
313545;202010;1150;3759;960;3363;156;574;505;1713;661;2287
313550;202010;1766;5344;1442;4581;301;1055;733;2227;1034;3282
313560;202010;2698;5271;2007;4429;55;94;1697;3766;1752;3860
313570;202010;1002;2892;819;2560;200;659;321;967;521;1626
313580;202010;5786;14827;4432;12544;503;1476;2585;7374;3088;8850
313590;202010;1034;2887;833;2601;207;683;379;1257;586;1940
313600;202010;4022;10597;3339;9533;92;369;2806;7847;2898;8216
313610;202010;1062;2653;852;2303;91;275;539;1375;630;1650
313620;202010;5613;14766;4369;12485;547;1755;2499;6872;3046;8627
313630;202010;8811;21071;6179;17094;609;1960;3747;10125;4356;12085
313640;202010;1178;2564;722;1975;143;420;335;914;478;1334
313650;202010;1733;5139;1369;4518;101;382;888;2961;989;3343
313652;202010;746;2326;668;2164;108;368;416;1313;524;1681
313655;202010;1142;2861;895;2550;47;138;693;1973;740;2111
313657;202010;1174;3118;921;2711;38;144;676;1881;714;2025
313660;202010;904;2519;735;2218;78;281;455;1301;533;1582
313665;202010;4879;12904;3796;10981;397;1278;2373;6527;2770;7805
313670;202010;50280;122127;31815;90609;4607;14389;14180;38084;18787;52473
313680;202010;1015;2703;832;2406;59;199;555;1552;614;1751
313690;202010;809;2484;623;2139;154;584;159;526;313;1110
313695;202010;1849;4967;1392;4204;87;272;921;2809;1008;3081
313700;202010;2923;9234;2513;8680;249;860;1867;6512;2116;7372
313710;202010;1483;3328;1050;2753;77;210;686;1833;763;2043
313720;202010;5668;15519;3901;11814;550;1792;1605;4467;2155;6259
313730;202010;1346;2994;1010;2540;89;188;653;1659;742;1847
313740;202010;1703;6019;1404;5240;316;1361;262;835;578;2196
313750;202010;2039;5404;1557;4544;281;910;740;2016;1021;2926
313753;202010;2229;5257;1476;4035;147;438;815;2155;962;2593
313760;202010;5409;14785;4068;12194;786;2614;1835;5112;2621;7726
313770;202010;4022;11161;3180;9811;207;662;2350;7343;2557;8005
313780;202010;4017;10613;2890;8727;222;795;820;2536;1042;3331
313790;202010;498;1525;445;1431;48;178;245;763;293;941
313800;202010;1402;3176;1016;2633;129;383;525;1291;654;1674
313810;202010;1611;4067;1277;3593;55;203;976;2668;1031;2871
313820;202010;17705;44707;10997;30536;1751;5115;3019;8095;4770;13210
313830;202010;389;1108;274;845;50;176;91;251;141;427
313835;202010;921;2688;760;2391;60;243;426;1249;486;1492
313840;202010;7255;18750;5437;15698;1302;3994;1123;3347;2425;7341
313850;202010;995;2412;788;2134;146;479;369;884;515;1363
313860;202010;2576;6865;1915;5620;304;1008;795;2135;1099;3143
313862;202010;1351;2838;644;1796;41;119;309;858;350;977
313865;202010;2584;6822;2118;6051;84;256;1589;4452;1673;4708
313867;202010;1353;4031;1117;3597;164;509;664;2217;828;2726
313868;202010;1704;5223;1392;4589;47;233;1054;3355;1101;3588
313870;202010;774;2088;557;1686;89;278;215;595;304;873
313880;202010;1734;4490;1261;3681;168;552;589;1531;757;2083
313890;202010;2020;4388;1503;3711;49;168;1106;2646;1155;2814
313900;202010;4150;11951;2950;9479;755;2672;710;2066;1465;4738
313910;202010;660;1913;499;1612;105;364;108;338;213;702
313920;202010;2936;9000;2432;7948;503;1607;1189;3948;1692;5555
313925;202010;1589;3995;1264;3422;189;497;816;2197;1005;2694
313930;202010;4681;14010;3769;12343;291;1081;2413;7786;2704;8867
313940;202010;9086;25979;6552;21542;764;3127;1539;5633;2303;8760
313950;202010;5245;11474;3823;9715;415;1329;2258;5730;2673;7059
313960;202010;5831;14019;3887;10742;711;2231;1330;3362;2041;5593
313970;202010;1514;4075;1262;3650;23;78;803;2263;826;2341
313980;202010;1330;3431;861;2690;131;475;343;1005;474;1480
313990;202010;1925;6070;1367;4781;334;1361;437;1335;771;2696
314000;202010;9732;24814;8095;22002;587;2061;5392;14410;5979;16471
314010;202010;1479;3539;1154;3095;45;154;874;2263;919;2417
314015;202010;1993;5476;1508;4637;198;709;813;2439;1011;3148
314020;202010;477;1298;321;1027;72;276;64;218;136;494
314030;202010;808;2308;636;1979;61;191;334;1017;395;1208
314040;202010;624;1669;497;1432;76;247;266;736;342;983
314050;202010;1865;4932;1356;3989;149;529;735;1997;884;2526
314053;202010;1827;5405;1469;4694;303;967;753;2496;1056;3463
314055;202010;2255;6026;1893;5457;44;164;1544;4440;1588;4604
314060;202010;1299;3401;972;2881;34;128;684;2000;718;2128
314070;202010;4796;13041;3715;11068;742;2209;1633;4806;2375;7015
314080;202010;2142;5500;1458;4330;186;642;630;1679;816;2321
314085;202010;2199;6071;1786;5425;229;717;987;3053;1216;3770
314090;202010;4690;12467;3996;11450;255;920;2476;7233;2731;8153
314100;202010;3119;7420;2401;6425;41;119;1801;4840;1842;4959
314110;202010;4868;13586;3947;11797;442;1533;2226;6202;2668;7735
314120;202010;785;1833;321;967;66;243;72;197;138;440
314130;202010;630;1628;390;1196;25;103;238;717;263;820
314140;202010;4590;12872;3607;11006;487;1539;1809;5409;2296;6948
314150;202010;1504;3724;1095;3016;78;228;735;1958;813;2186
314160;202010;2229;5814;1613;4681;228;727;672;1953;900;2680
314170;202010;933;2605;751;2246;42;158;492;1378;534;1536
314180;202010;5456;15061;4379;13307;362;1190;2613;7934;2975;9124
314190;202010;628;1557;441;1278;81;272;205;530;286;802
314200;202010;3000;8318;2453;7382;163;540;1711;5016;1874;5556
314210;202010;2029;5272;1614;4518;200;567;784;2150;984;2717
314220;202010;1426;3862;1022;3143;225;781;365;1019;590;1800
314225;202010;1075;3004;882;2692;75;196;641;2007;716;2203
314230;202010;786;2023;639;1837;89;285;402;1182;491;1467
314240;202010;1052;2804;798;2399;194;619;294;883;488;1502
314250;202010;499;1394;305;988;49;149;105;315;154;464
314260;202010;947;2563;736;2272;166;556;399;1201;565;1757
314270;202010;3299;9286;2702;8351;78;332;1984;6075;2062;6407
314280;202010;3487;8023;2320;6236;259;773;1272;3242;1531;4015
314290;202010;4492;11550;3670;10079;315;879;2489;6702;2804;7581
314300;202010;1993;5605;1287;4092;229;790;443;1325;672;2115
314310;202010;4144;10710;2722;8249;855;2856;423;1117;1278;3973
314315;202010;943;3184;802;2884;53;239;557;1927;610;2166
314320;202010;3042;8207;1977;6190;361;1236;712;2119;1073;3355
314330;202010;49963;139268;37394;116750;9881;32271;7635;25119;17516;57390
314340;202010;2500;6164;1530;4412;280;924;390;961;670;1885
314345;202010;1466;4259;1175;3727;143;463;703;2207;846;2670
314350;202010;829;2251;532;1702;118;385;120;330;238;715
314360;202010;566;1636;341;1140;56;207;106;320;162;527
314370;202010;742;1956;594;1733;44;150;401;1121;445;1271
314380;202010;1161;3124;762;2404;167;601;161;474;328;1075
314390;202010;14039;35224;8965;25873;1554;4828;2874;7369;4428;12197
314400;202010;4009;11880;3003;9934;767;2627;1100;3765;1867;6392
314410;202010;2735;7588;1870;5965;254;925;614;2066;868;2991
314420;202010;845;2068;606;1671;40;152;402;1038;442;1190
314430;202010;7919;19222;5484;15113;812;2348;2568;6718;3380;9066
314435;202010;1841;4867;1446;4206;87;314;1001;2803;1088;3117
314437;202010;915;2329;659;1900;74;231;323;917;397;1148
314440;202010;618;1762;432;1382;123;429;85;224;208;653
314450;202010;1413;3748;1179;3383;111;375;686;1883;797;2258
314460;202010;3245;9831;2339;7907;595;2130;549;1782;1144;3912
314465;202010;2216;6360;1867;5698;59;220;1428;4217;1487;4437
314467;202010;932;2417;763;2139;25;75;619;1682;644;1757
314470;202010;2343;6618;1912;5746;337;1088;880;2478;1217;3566
314480;202010;6645;18782;4781;14827;783;2730;1770;4825;2553;7555
314490;202010;1091;2865;792;2244;68;197;493;1354;561;1551
314500;202010;1741;4167;1235;3452;312;863;426;1238;738;2101
314505;202010;2055;4999;1672;4455;102;285;1217;3150;1319;3435
314510;202010;1947;5059;1361;4147;273;931;600;1796;873;2727
314520;202010;5047;15370;3682;12478;742;2749;459;1389;1201;4138
314530;202010;5405;17271;4835;16174;306;1265;3545;11581;3851;12846
314535;202010;2525;6550;2027;5826;86;312;1545;4400;1631;4712
314537;202010;1093;3078;836;2663;42;167;602;1877;644;2044
314540;202010;390;968;261;748;18;58;150;412;168;470
314545;202010;1921;4545;1713;4302;30;90;1492;3837;1522;3927
314550;202010;674;1647;497;1389;38;136;282;717;320;853
314560;202010;4426;13218;3243;10542;478;1731;1109;3224;1587;4955
314570;202010;306;841;222;681;29;98;96;297;125;395
314580;202010;462;1372;366;1179;96;311;119;377;215;688
314585;202010;662;2059;499;1696;70;291;209;686;279;977
314587;202010;2001;5420;1504;4620;206;599;850;2692;1056;3291
314590;202010;4126;11150;2970;8946;389;1325;1317;3623;1706;4948
314600;202010;1932;5243;1135;3701;226;786;134;402;360;1188
314610;202010;9020;22347;6312;18283;1006;3491;2712;7956;3718;11447
314620;202010;2249;5244;1771;4637;43;139;1466;3824;1509;3963
314625;202010;1552;4186;1326;3874;31;179;1140;3246;1171;3425
314630;202010;5439;13547;4436;12216;107;434;3693;10112;3800;10546
314640;202010;698;1639;505;1338;73;221;280;684;353;905
314650;202010;839;1932;511;1422;51;166;280;685;331;851
314655;202010;1610;4401;1128;3533;172;533;554;1734;726;2267
314660;202010;330;738;208;521;14;28;135;326;149;354
314670;202010;1631;3706;1125;2993;22;69;741;1941;763;2010
314675;202010;1708;4494;1448;4055;76;241;1123;3059;1199;3300
314690;202010;2065;5728;1580;4999;413;1456;543;1672;956;3128
314700;202010;10447;28887;6739;21645;1285;4580;2092;6469;3377;11049
314710;202010;7929;22058;5694;17326;920;3074;2041;5428;2961;8502
314720;202010;2193;6427;1502;4985;302;1103;377;1166;679;2269
314730;202010;2327;6022;1660;4802;253;810;701;1858;954;2668
314740;202010;2946;8295;2269;7061;302;997;1132;3433;1434;4430
314750;202010;291;787;222;647;26;86;134;354;160;440
314760;202010;1953;5778;1269;4210;207;791;327;837;534;1628
314770;202010;1105;3204;601;1918;48;166;186;550;234;716
314780;202010;353;833;237;657;40;133;127;307;167;440
314790;202010;11152;29592;7690;23130;1522;5260;2751;7556;4273;12816
314795;202010;1521;3998;1279;3571;31;124;1017;2730;1048;2854
314800;202010;10984;27898;6698;19895;1203;3902;1773;4671;2976;8573
314810;202010;8707;23091;6244;18750;1598;5100;1999;5894;3597;10994
314820;202010;1258;2994;972;2564;62;217;617;1545;679;1762
314830;202010;1534;4621;1285;4154;213;786;631;1955;844;2741
314840;202010;846;2607;668;2318;49;225;465;1539;514;1764
314850;202010;2140;4874;1724;4346;47;151;1492;3764;1539;3915
314860;202010;3180;9349;2616;8315;196;799;1790;5537;1986;6336
314870;202010;6383;15934;4815;13849;278;886;3562;10341;3840;11227
314875;202010;1756;5215;1525;4909;123;314;1209;3991;1332;4305
314880;202010;824;2006;629;1707;33;91;373;1020;406;1111
314890;202010;419;1243;316;1023;50;183;129;390;179;573
314900;202010;740;1976;572;1676;82;278;254;693;336;971
314910;202010;1684;4721;1243;4000;202;755;626;1895;828;2650
314915;202010;2189;6457;1824;5812;117;377;1200;3758;1317;4135
314920;202010;468;1210;301;956;6;15;201;656;207;671
314930;202010;5611;15694;4204;13035;695;2395;1687;4826;2382;7221
314940;202010;396;992;323;866;36;92;203;516;239;608
314950;202010;541;1351;361;1047;28;104;192;492;220;596
314960;202010;852;2013;650;1678;28;91;464;1126;492;1217
314970;202010;984;2859;752;2372;144;490;329;948;473;1438
314980;202010;1526;3880;1119;3281;201;676;531;1520;732;2196
314990;202010;2497;7167;1740;5443;344;1149;364;1026;708;2175
314995;202010;1604;4443;1266;3831;38;164;849;2427;887;2591
315000;202010;1120;2806;792;2305;59;183;527;1511;586;1694
315010;202010;380;1042;286;878;45;162;138;402;183;564
315015;202010;2301;6392;1989;5864;190;634;1316;3808;1506;4442
315020;202010;802;2336;559;1780;72;285;237;691;309;976
315030;202010;598;1586;402;1219;88;271;83;222;171;493
315040;202010;826;2304;667;2018;87;289;409;1218;496;1507
315050;202010;1235;3180;891;2628;56;201;468;1341;524;1542
315053;202010;1097;2848;834;2385;50;156;490;1335;540;1491
315057;202010;1757;5247;1422;4665;140;455;940;3123;1080;3578
315060;202010;574;1720;420;1423;86;303;109;356;195;659
315070;202010;531;1391;360;1089;85;282;92;261;177;543
315080;202010;2968;8252;2265;6899;238;816;1444;4167;1682;4983
315090;202010;802;2393;587;1974;86;309;232;751;318;1060
315100;202010;1334;3893;867;2824;145;560;379;1086;524;1646
315110;202010;1890;4524;1360;3706;137;368;678;1898;815;2266
315120;202010;12409;28651;9101;23616;1195;2882;4925;13221;6120;16103
315130;202010;1625;4413;1347;3920;144;474;554;1518;698;1992
315140;202010;2943;8115;2268;6891;391;1287;1140;3286;1531;4573
315150;202010;4358;10398;3046;8289;461;1471;1419;3754;1880;5225
315160;202010;1786;4319;1172;3332;247;751;531;1488;778;2239
315170;202010;1397;4393;956;3320;226;873;228;733;454;1606
315180;202010;17501;42236;9377;27148;1249;4095;3052;7728;4301;11823
315190;202010;2231;4851;1726;4185;201;480;1251;3071;1452;3551
315200;202010;3926;11099;2822;9089;804;2805;745;2287;1549;5092
315210;202010;8654;22341;5862;16432;691;2099;2905;7367;3596;9466
315213;202010;1137;2969;978;2749;23;80;805;2213;828;2293
315217;202010;2825;8114;2140;6955;89;422;1481;4600;1570;5022
315220;202010;8639;23321;6759;19971;1124;3536;2891;8557;4015;12093
315230;202010;3083;7162;2572;6496;197;279;1953;5274;2150;5553
315240;202010;2444;7151;2049;6453;455;1482;981;3103;1436;4585
315250;202010;13171;35303;9419;28166;1466;4721;4007;11385;5473;16106
315260;202010;926;2542;484;1588;77;249;40;108;117;357
315270;202010;825;2349;582;1886;81;281;206;569;287;850
315280;202010;2930;7302;1731;5119;424;1359;279;792;703;2151
315290;202010;1175;2862;684;2074;192;653;202;579;394;1232
315300;202010;632;1533;427;1234;81;262;220;643;301;905
315310;202010;1263;3515;925;2863;80;278;508;1478;588;1756
315320;202010;660;1914;460;1514;65;234;195;591;260;825
315330;202010;757;2565;416;1633;65;300;131;454;196;754
315340;202010;3009;7243;2147;6006;289;833;1125;3138;1414;3971
315350;202010;1585;4290;1235;3747;174;616;690;2054;864;2670
315360;202010;1736;5087;1298;4156;199;679;532;1579;731;2258
315370;202010;474;1366;375;1163;71;218;148;446;219;664
315380;202010;197;577;144;463;40;139;30;68;70;207
315390;202010;1128;3195;892;2737;145;520;417;1171;562;1691
315400;202010;4054;10992;3166;9386;447;1394;1710;4856;2157;6250
315410;202010;2419;5520;1797;4616;472;1323;276;716;748;2039
315415;202010;1413;3800;1128;3362;239;830;425;1288;664;2118
315420;202010;1434;4026;974;3135;180;607;188;585;368;1192
315430;202010;3599;8722;2516;7075;449;1481;1083;2844;1532;4325
315440;202010;1039;2735;828;2386;64;219;493;1332;557;1551
315445;202010;1972;4712;1388;3885;86;289;1001;2758;1087;3047
315450;202010;2256;6201;1826;5495;223;637;1132;3405;1355;4042
315460;202010;37611;103941;30893;91689;4590;15459;16892;46973;21482;62432
315470;202010;634;1768;451;1317;31;99;266;741;297;840
315480;202010;1167;3360;811;2584;154;525;262;803;416;1328
315490;202010;2961;7424;2046;5939;290;880;761;2109;1051;2989
315500;202010;527;1413;324;972;43;151;160;422;203;573
315510;202010;1241;3214;1048;2941;23;95;913;2518;936;2613
315520;202010;994;2730;800;2393;50;177;606;1764;656;1941
315530;202010;620;1734;481;1480;134;472;231;656;365;1128
315540;202010;1467;3917;1021;3081;101;367;471;1374;572;1741
315550;202010;1918;4980;1232;3708;252;877;303;887;555;1764
315560;202010;6269;18943;5260;17090;302;933;3471;11525;3773;12458
315570;202010;2074;5567;1647;4847;108;368;919;2643;1027;3011
315580;202010;2946;6909;2205;5732;302;906;852;2092;1154;2998
315590;202010;896;2262;683;1924;74;253;379;984;453;1237
315600;202010;2488;7727;1779;6310;287;952;891;3343;1178;4295
315610;202010;964;2439;710;1971;107;372;323;773;430;1145
315620;202010;511;1355;382;1162;41;146;220;680;261;826
315630;202010;1064;2800;794;2307;129;395;368;968;497;1363
315640;202010;355;878;265;765;30;112;158;431;188;543
315645;202010;1001;2574;675;2030;157;512;175;499;332;1011
315650;202010;1732;4161;1379;3669;34;108;1117;2880;1151;2988
315660;202010;2448;6025;1833;4957;105;328;1301;3392;1406;3720
315670;202010;13865;37663;10496;31505;2047;6436;4738;13633;6785;20069
315680;202010;3158;9002;2303;7362;296;1077;1209;3658;1505;4735
315690;202010;3388;8197;2004;5802;447;1296;593;1853;1040;3149
315700;202010;8130;22292;6049;18102;977;3106;2663;7617;3640;10723
315710;202010;1843;4536;1291;3698;47;200;906;2475;953;2675
315720;202010;4434;12256;3678;10865;191;746;2579;7303;2770;8049
315725;202010;2177;5650;1647;4741;191;528;1014;3057;1205;3585
315727;202010;567;1467;427;1238;57;205;173;470;230;675
315730;202010;573;1788;500;1625;95;344;161;471;256;815
315733;202010;1150;2917;810;2331;120;410;312;852;432;1262
315737;202010;1162;3242;906;2738;25;101;650;1884;675;1985
315740;202010;830;2308;654;1953;70;244;422;1176;492;1420
315750;202010;1273;3343;998;2898;94;291;599;1770;693;2061
315760;202010;1122;2640;987;2464;41;123;826;2008;867;2131
315765;202010;1936;5075;1587;4616;30;121;1400;4051;1430;4172
315770;202010;1033;2835;788;2486;318;1105;161;426;479;1531
315780;202010;29988;81201;24965;72246;1360;4897;17334;47821;18694;52718
315790;202010;3573;10998;3016;9925;362;1252;1807;6037;2169;7289
315800;202010;1287;4430;951;3566;135;593;312;1020;447;1613
315810;202010;1303;3225;1058;2801;57;199;815;2052;872;2251
315820;202010;2593;6953;2101;6238;196;647;1440;4266;1636;4913
315830;202010;1187;3513;803;2684;77;277;282;869;359;1146
315840;202010;841;2017;583;1563;43;135;287;697;330;832
315850;202010;1175;3458;916;2988;185;640;443;1363;628;2003
315860;202010;484;1385;335;1112;65;229;106;312;171;541
315870;202010;463;1212;369;1066;17;60;265;728;282;788
315880;202010;1096;2830;722;2159;103;368;169;468;272;836
315890;202010;1691;4806;1357;4337;333;1169;663;2091;996;3260
315895;202010;6329;16952;4723;13786;458;1489;2462;6661;2920;8150
315900;202010;822;2083;707;1917;59;174;536;1411;595;1585
315910;202010;511;1424;425;1288;58;188;293;870;351;1058
315920;202010;1482;3723;805;2441;128;475;253;690;381;1165
315930;202010;1103;2447;737;1930;142;349;313;847;455;1196
315935;202010;811;2443;635;2096;128;449;216;702;344;1151
315940;202010;606;1668;481;1472;52;163;250;742;302;905
315950;202010;1169;3219;958;2876;88;256;730;2190;818;2446
315960;202010;5319;14936;3473;11161;978;3551;307;633;1285;4184
315970;202010;613;1613;482;1438;61;195;315;945;376;1140
315980;202010;4312;9299;2342;6070;423;1159;859;2035;1282;3194
315990;202010;3635;9210;2813;7798;274;803;1603;4300;1877;5103
316000;202010;584;1475;434;1256;51;184;209;564;260;748
316010;202010;845;2228;620;1843;43;145;382;1052;425;1197
316020;202010;932;2828;740;2439;100;379;411;1267;511;1646
316030;202010;2726;7628;2050;6416;236;757;1293;4106;1529;4863
316040;202010;2401;6767;1760;5565;309;1101;444;1219;753;2320
316045;202010;2096;5365;1921;5155;78;146;1655;4576;1733;4722
316050;202010;381;1051;294;901;31;98;159;449;190;547
316060;202010;671;1676;488;1406;18;80;338;931;356;1011
316070;202010;5330;14764;4318;12841;749;2290;2002;5806;2751;8096
316080;202010;726;2271;562;1934;139;497;83;259;222;756
316090;202010;411;1174;299;945;41;141;147;436;188;577
316095;202010;1294;3993;1025;3310;275;930;334;1035;609;1965
316100;202010;2467;7150;1778;5688;315;1104;667;1937;982;3041
316105;202010;811;2130;662;1888;33;113;452;1325;485;1438
316110;202010;13695;39287;11397;35367;826;2949;7698;23570;8524;26519
316120;202010;1200;3415;769;2391;123;398;232;588;355;986
316130;202010;1294;2905;825;2133;62;183;481;1211;543;1394
316140;202010;1211;3202;773;2383;96;327;376;1128;472;1455
316150;202010;1939;4230;1555;3714;189;579;643;1457;832;2036
316160;202010;977;2665;803;2365;41;144;551;1577;592;1721
316165;202010;859;2130;651;1795;92;297;346;892;438;1189
316170;202010;1180;2896;886;2454;50;172;612;1620;662;1792
316180;202010;1413;3969;954;3017;148;555;166;488;314;1043
316190;202010;2769;7797;1595;4978;233;760;603;1651;836;2411
316200;202010;3274;9363;2436;7883;585;2019;600;1865;1185;3884
316210;202010;4451;13044;3192;10176;1147;3963;184;496;1331;4459
316220;202010;603;1817;398;1350;94;361;41;160;135;521
316225;202010;1571;3544;1173;2906;54;200;886;2035;940;2235
316230;202010;412;1116;315;947;38;117;174;533;212;650
316240;202010;5602;16105;4885;14855;372;1216;3674;10998;4046;12214
316245;202010;3021;9727;2709;9184;123;706;2086;6726;2209;7432
316250;202010;10513;25045;7626;20465;1612;4750;2804;7394;4416;12144
316255;202010;2941;8103;2555;7478;114;351;1915;5673;2029;6024
316257;202010;1415;3400;1019;2705;125;333;590;1493;715;1826
316260;202010;2153;5397;1657;4571;219;580;849;2418;1068;2998
316265;202010;1131;3031;876;2600;23;85;638;1839;661;1924
316270;202010;3714;11405;3168;10188;481;1653;1547;4740;2028;6393
316280;202010;2880;8171;2444;7344;320;1056;1372;4005;1692;5061
316290;202010;3394;9301;2698;8023;296;1032;1160;3313;1456;4345
316292;202010;5045;13340;4035;11640;505;1564;2584;7156;3089;8720
316294;202010;836;2461;623;2089;117;445;170;525;287;970
316295;202010;3215;8953;2603;7876;146;543;1819;5217;1965;5760
316300;202010;1009;2858;814;2539;46;162;594;1828;640;1990
316310;202010;808;2156;521;1641;110;407;94;245;204;652
316320;202010;670;1868;521;1630;61;226;231;692;292;918
316330;202010;1094;2830;828;2355;54;189;622;1700;676;1889
316340;202010;1012;2718;754;2248;70;270;432;1220;502;1490
316350;202010;1287;3599;1056;3230;91;308;739;2231;830;2539
316360;202010;628;1652;511;1457;54;162;365;1028;419;1190
316370;202010;5052;13388;3708;10941;655;2233;1460;3837;2115;6070
316380;202010;1732;4144;1354;3605;54;122;931;2488;985;2610
316390;202010;808;2155;568;1730;231;797;88;239;319;1036
316400;202010;1183;3303;761;2461;113;395;246;731;359;1126
316410;202010;1118;3089;934;2817;62;202;731;2158;793;2360
316420;202010;1981;5330;1706;4971;42;154;1408;4014;1450;4168
316430;202010;844;2218;532;1660;96;326;164;481;260;807
316440;202010;840;2545;658;2212;112;435;167;506;279;941
316443;202010;539;1484;392;1201;99;357;82;230;181;587
316447;202010;1974;5274;1726;4858;26;104;1489;4112;1515;4216
316450;202010;2143;6522;1629;5445;225;810;955;3106;1180;3916
316460;202010;1217;3069;980;2684;133;405;615;1580;748;1985
316470;202010;6838;19480;4837;15241;778;2789;1877;5378;2655;8167
316480;202010;199;547;166;499;45;132;76;224;121;356
316490;202010;328;871;229;694;39;121;80;204;119;325
316500;202010;1181;3649;779;2677;162;614;176;575;338;1189
316510;202010;761;2468;612;2176;109;404;301;1058;410;1462
316520;202010;1305;3149;1012;2669;120;399;527;1242;647;1641
316530;202010;1120;2890;809;2327;86;325;418;1060;504;1385
316540;202010;866;2247;674;1948;107;350;321;835;428;1185
316550;202010;1351;3934;1152;3548;52;186;896;2741;948;2927
316553;202010;4408;12938;3091;9717;463;1608;1150;3189;1613;4797
316555;202010;2501;7895;2257;7555;114;406;1859;6271;1973;6677
316556;202010;544;1332;394;1073;30;85;219;535;249;620
316557;202010;1055;3252;907;3004;287;1033;317;1015;604;2048
316560;202010;329;907;226;753;50;209;72;203;122;412
316570;202010;1252;3619;1026;3192;259;825;355;1144;614;1969
316580;202010;382;806;220;540;37;110;108;245;145;355
316590;202010;1354;3474;942;2657;196;488;453;1258;649;1746
316600;202010;949;2891;810;2610;119;403;422;1345;541;1748
316610;202010;609;1888;495;1702;60;268;291;966;351;1234
316620;202010;2086;5477;1821;5104;91;268;1434;4006;1525;4274
316630;202010;1554;4657;1263;4101;326;1074;500;1760;826;2834
316640;202010;141;369;109;320;17;59;50;118;67;177
316650;202010;1042;3257;833;2926;81;303;511;1824;592;2127
316660;202010;185;463;82;251;8;29;14;37;22;66
316670;202010;1796;4540;1315;3749;310;962;474;1320;784;2282
316680;202010;2294;5798;1678;4628;106;312;1254;3368;1360;3680
316690;202010;1403;3939;1048;3290;178;603;478;1453;656;2056
316695;202010;1023;2969;837;2634;25;99;585;1824;610;1923
316700;202010;406;944;331;850;17;52;256;628;273;680
316710;202010;3081;10050;2353;8505;463;1796;941;3369;1404;5165
316720;202010;20832;56678;15177;45752;2653;8536;6460;18435;9113;26971
316730;202010;432;1173;349;1010;47;159;170;465;217;624
316740;202010;748;2175;644;2003;73;258;399;1249;472;1507
316750;202010;398;1186;303;1003;66;246;132;406;198;652
316760;202010;3490;11114;2846;9807;1131;4231;613;1991;1744;6222
316770;202010;1621;3673;1238;3136;25;74;1005;2613;1030;2687
316780;202010;566;1675;437;1413;166;599;69;188;235;787
316790;202010;715;1927;504;1502;97;317;149;396;246;713
316800;202010;6284;17573;5002;15218;570;1930;2504;7336;3074;9266
316805;202010;1005;2219;807;2003;57;160;622;1557;679;1717
316810;202010;631;1761;427;1337;79;292;221;648;300;940
316820;202010;304;737;172;500;20;76;63;159;83;235
316830;202010;760;2014;602;1760;83;273;364;1025;447;1298
316840;202010;2792;7151;2208;6169;191;664;1522;4033;1713;4697
316850;202010;1936;5079;1380;4051;228;712;593;1676;821;2388
316860;202010;19118;48949;13954;41202;2245;7711;6312;18167;8557;25878
316870;202010;7868;21405;5796;17369;874;2878;2598;7260;3472;10138
316880;202010;884;2373;715;2131;140;463;339;965;479;1428
316890;202010;1145;2521;672;1885;92;332;410;1049;502;1381
316900;202010;2326;6238;1778;5128;344;1095;547;1463;891;2558
316905;202010;521;1550;420;1350;108;377;164;537;272;914
316910;202010;900;2355;539;1704;138;474;42;123;180;597
316920;202010;1774;4345;1233;3524;230;713;555;1528;785;2241
316930;202010;7710;22176;5673;18434;1281;4458;1524;4666;2805;9124
316935;202010;4048;10938;2918;8796;521;1708;1171;3365;1692;5073
316940;202010;6471;18943;4935;15735;746;2627;1952;5756;2698;8383
316950;202010;1893;4416;1470;3836;42;136;1221;3136;1263;3272
316960;202010;5101;11464;3668;9497;345;987;2496;6306;2841;7293
316970;202010;3762;10613;3248;9643;512;1590;1350;3830;1862;5420
316980;202010;669;1998;505;1678;167;628;58;204;225;832
316990;202010;11905;31741;8592;24990;2173;6884;1322;3460;3495;10344
317000;202010;2535;7442;2221;6981;180;512;1622;5151;1802;5663
317005;202010;2597;7310;2052;6189;329;1045;1077;3170;1406;4215
317010;202010;24729;57811;15197;43081;3018;9455;5705;16560;8723;26015
317020;202010;64376;152308;36864;104337;6657;20677;11416;29805;18073;50482
317030;202010;712;1885;550;1659;15;71;421;1244;436;1315
317040;202010;11215;28191;7770;22217;1712;5301;2727;8003;4439;13304
317043;202010;864;1933;613;1581;51;133;445;1137;496;1270
317047;202010;1181;2832;814;2240;82;237;508;1340;590;1577
317050;202010;1177;3598;819;2754;111;399;342;1007;453;1406
317052;202010;2383;6630;1914;5864;277;847;1170;3606;1447;4453
317057;202010;1835;4385;1333;3563;34;130;860;2270;894;2400
317060;202010;511;1329;317;938;38;120;140;365;178;485
317065;202010;1177;3418;957;2987;58;177;591;1741;649;1918
317070;202010;7500;20690;5286;16377;972;3383;1562;4565;2534;7948
317075;202010;923;2391;665;1947;111;358;304;812;415;1170
317080;202010;6097;14251;4464;11624;1205;3378;1456;3644;2661;7022
317090;202010;4712;13684;4167;12779;300;875;3094;9545;3394;10420
317100;202010;2702;6394;1710;4740;390;1123;612;1668;1002;2791
317103;202010;2225;5845;1884;5322;82;369;1459;3936;1541;4305
317107;202010;1450;3824;1095;3144;80;279;657;1675;737;1954
317110;202010;713;1641;355;1080;54;192;118;374;172;566
317115;202010;1090;3102;924;2792;53;140;624;1890;677;2030
317120;202010;14695;39350;11720;34463;1138;3983;7131;20002;8269;23985
317130;202010;11323;26182;7150;19313;1147;3421;2409;6430;3556;9851
317140;202010;869;2062;670;1769;42;115;446;1219;488;1334
317150;202010;1008;2387;754;2070;34;100;588;1589;622;1689
317160;202010;3582;8608;2338;6611;178;544;1279;3708;1457;4252
317170;202010;1845;4567;1332;3699;207;687;564;1361;771;2048
317180;202010;1984;6158;1458;4888;278;997;376;1173;654;2170
317190;202010;1205;3234;887;2738;106;341;509;1550;615;1891
317200;202010;5436;14182;4144;11921;1036;3215;892;2360;1928;5575
317210;202010;1180;2860;916;2495;25;101;676;1865;701;1966
317220;202010;246;759;208;686;49;165;79;272;128;437
320010;202010;4616;13326;3671;11421;377;1306;2320;7008;2697;8314
320013;202010;2016;5424;1368;4131;229;701;610;1926;839;2627
320016;202010;3049;7767;2372;6728;174;461;1769;5030;1943;5491
320020;202010;3986;10318;2908;8436;629;2023;1023;3066;1652;5089
320030;202010;1775;4910;1146;3638;223;768;398;1207;621;1975
320035;202010;1900;5201;1545;4580;379;1240;668;1923;1047;3163
320040;202010;4147;11676;3410;10314;480;1538;1903;5534;2383;7072
320050;202010;1796;4087;1539;3713;193;560;906;2094;1099;2654
320060;202010;12936;35317;9579;28659;1451;4742;4506;12658;5957;17400
320070;202010;1562;4367;1086;3385;190;659;393;1167;583;1826
320080;202010;5775;14733;3992;11200;817;2427;1454;3858;2271;6285
320090;202010;8647;22883;5620;16578;1244;3914;2033;5574;3277;9488
320100;202010;3102;8380;2514;7353;439;1412;1264;3694;1703;5106
320110;202010;2105;4881;1398;3736;200;558;674;1723;874;2281
320115;202010;1804;5788;1529;5323;651;2399;405;1457;1056;3856
320120;202010;24077;61289;16525;47487;2355;7346;7594;20600;9949;27946
320130;202010;45988;127524;37549;112092;4890;16093;21848;63200;26738;79293
320140;202010;3638;9905;2391;7440;353;1269;949;2914;1302;4183
320150;202010;13935;35916;9829;27963;2469;7756;1649;4173;4118;11929
320160;202010;6112;16944;4447;13707;718;2441;2021;6108;2739;8549
320170;202010;1708;4883;1216;3884;328;1029;444;1503;772;2532
320180;202010;698;2201;557;1922;208;764;147;464;355;1228
320190;202010;2859;9059;2173;7523;518;1910;560;1834;1078;3744
320200;202010;1320;3531;886;2733;199;671;330;1018;529;1689
320210;202010;4422;11220;3375;9400;534;1614;1770;4706;2304;6320
320220;202010;2861;7490;2147;6309;353;1129;1100;3043;1453;4172
320225;202010;1361;4219;954;3252;335;1247;191;640;526;1887
320230;202010;5081;13923;3841;11817;840;2839;1501;4428;2341;7267
320240;202010;16313;41307;12031;34331;2884;8967;3913;10898;6797;19865
320245;202010;3086;9101;2414;7738;883;2986;437;1369;1320;4355
320250;202010;2376;6622;1591;4769;346;1144;465;1222;811;2366
320255;202010;1859;5787;1584;5287;426;1467;715;2464;1141;3931
320260;202010;1425;3972;846;2674;177;613;204;541;381;1154
320265;202010;2543;7763;2038;6722;899;3180;335;1097;1234;4277
320270;202010;2237;6390;1688;5304;422;1433;605;1914;1027;3347
320280;202010;7211;19112;5775;16624;1197;3726;2701;7469;3898;11195
320290;202010;1382;4091;884;2875;240;859;227;679;467;1538
320300;202010;3729;11235;2947;9605;849;2986;693;2119;1542;5105
320305;202010;5177;14630;3982;12242;749;2508;1925;5733;2674;8241
320310;202010;2185;6014;1496;4550;263;843;667;1917;930;2760
320313;202010;2459;6141;1586;4487;315;1010;415;1064;730;2074
320316;202010;1484;4173;1200;3692;187;590;716;2213;903;2803
320320;202010;22680;59126;15921;47247;3677;11427;5773;17151;9450;28578
320330;202010;2985;8089;2299;6836;434;1295;1187;3608;1621;4903
320332;202010;7438;19936;5861;17085;1346;4212;2632;7563;3978;11775
320334;202010;1805;5087;1248;3933;278;1040;301;726;579;1766
320335;202010;1479;4369;1031;3319;239;865;251;734;490;1599
320340;202010;4866;12102;4012;10844;499;1487;2319;6326;2818;7813
320350;202010;5507;13554;3836;10503;463;1384;2037;5254;2500;6638
320360;202010;1466;3723;1065;2964;122;342;530;1411;652;1753
320370;202010;2622;8018;1908;6445;573;2029;599;2007;1172;4036
320380;202010;2590;6908;2143;6177;242;744;1355;3790;1597;4534
320390;202010;7274;19591;5325;15655;1092;3430;2127;5854;3219;9284
320400;202010;3384;9494;2523;7652;706;2281;833;2397;1539;4678
320405;202010;4927;12863;3718;10771;566;1799;1809;5073;2375;6872
320410;202010;4896;12621;3645;10580;652;1844;1805;5466;2457;7310
320420;202010;3349;8718;2517;7287;700;2245;449;1292;1149;3537
320425;202010;2140;5128;1618;4244;102;300;1052;2660;1154;2960
320430;202010;3162;7878;2446;6575;333;981;1533;3956;1866;4937
320435;202010;2174;6741;1713;5825;612;2217;522;1777;1134;3994
320440;202010;1517;4180;1096;3354;171;564;489;1425;660;1989
320450;202010;1748;4967;1354;4212;266;946;606;1756;872;2702
320455;202010;4329;13006;2883;9552;713;2540;700;2102;1413;4642
320460;202010;2169;6342;1513;4951;362;1256;398;1214;760;2470
320465;202010;1312;3670;975;3021;138;431;516;1610;654;2041
320470;202010;3804;10405;2668;8012;595;1883;656;1750;1251;3633
320480;202010;1704;4665;1375;4101;188;639;810;2352;998;2991
320490;202010;21763;57013;15992;46753;2712;8639;6595;19053;9307;27692
320495;202010;1312;3550;893;2739;194;674;320;944;514;1618
320500;202010;53291;141456;42277;122276;5865;18405;24396;67476;30261;85881
320501;202010;4479;12931;3286;10734;903;3296;1066;3423;1969;6719
320503;202010;2437;6909;1546;5053;414;1481;434;1349;848;2830
320506;202010;2706;8009;1928;6272;563;1985;167;537;730;2522
320510;202010;10369;27966;8320;24359;917;3093;5126;14495;6043;17588
320515;202010;1825;4979;1394;4094;379;1226;464;1285;843;2511
320517;202010;2228;6644;1759;5628;542;1887;517;1637;1059;3524
320520;202010;36995;95585;27395;79201;4730;15017;11652;32423;16382;47440
320530;202010;33216;87370;25978;74371;2398;8116;16391;44248;18789;52364
330010;202010;22824;60190;18661;53180;2456;7620;12049;33314;14505;40934
330015;202010;1498;3665;1157;3141;198;601;619;1594;817;2195
330020;202010;20175;50114;16842;45250;2387;7202;11584;30382;13971;37584
330022;202010;1915;5108;1462;4312;257;772;836;2446;1093;3218
330023;202010;5138;12148;3690;10103;595;1811;2054;5473;2649;7284
330025;202010;6922;15992;3977;11022;911;2800;804;2122;1715;4922
330030;202010;10552;28001;7914;23629;839;2898;4814;13711;5653;16609
330040;202010;14918;38630;11740;33174;1111;3538;7828;21209;8939;24747
330045;202010;86264;202003;70338;181716;5448;13909;55414;142636;60862;156545
330050;202010;2550;6710;1866;5539;360;1143;923;2620;1283;3763
330060;202010;5293;13786;4081;11609;794;2515;1707;4465;2501;6980
330070;202010;22809;57499;18222;50764;2850;8474;10739;29639;13589;38113
330080;202010;8900;22342;7533;20393;928;2678;5216;13920;6144;16598
330090;202010;3521;7327;2387;5750;160;411;1632;3928;1792;4339
330093;202010;2766;6589;2061;5586;123;360;1567;4223;1690;4583
330095;202010;1301;3636;998;3064;79;294;609;1733;688;2027
330100;202010;71533;188064;60604;171734;3628;12226;46287;129074;49915;141300
330110;202010;2105;5833;1672;5093;273;905;938;2759;1211;3664
330115;202010;2564;6151;1786;4928;245;772;1006;2661;1251;3433
330120;202010;3597;8017;2666;6800;215;615;1852;4540;2067;5155
330130;202010;4432;11941;3602;10670;491;1515;2256;6642;2747;8157
330140;202010;3837;9870;3022;8686;426;1371;1917;5371;2343;6742
330150;202010;2161;5729;1634;4889;284;898;815;2376;1099;3274
330160;202010;1379;3723;1023;3086;180;588;542;1556;722;2144
330170;202010;111039;272954;88465;242133;11997;32378;59060;163669;71057;196047
330180;202010;2000;4798;1531;4134;102;320;1050;2749;1152;3069
330185;202010;9843;24579;8173;22243;500;1661;6505;17257;7005;18918
330187;202010;4400;11071;3390;9413;469;1413;1983;5449;2452;6862
330190;202010;34225;82224;28667;74484;1978;5564;22650;58073;24628;63637
330200;202010;16179;40729;13044;36837;2559;6844;8068;23558;10627;30402
330205;202010;2153;5281;1613;4408;102;334;1107;2897;1209;3231
330210;202010;3510;8667;2520;6918;371;1103;1244;3172;1615;4275
330220;202010;12252;30159;8523;23870;1729;5443;3058;7891;4787;13334
330225;202010;4034;10031;3040;8495;191;648;2197;5970;2388;6618
330227;202010;17472;41871;14544;38290;592;1726;12414;32319;13006;34045
330230;202010;2171;4647;1377;3653;124;357;808;2153;932;2510
330240;202010;24034;62100;19565;55048;2392;7416;12918;35383;15310;42799
330245;202010;1737;4233;1024;2973;199;579;395;1138;594;1717
330250;202010;38927;98616;31893;88127;5458;15521;19380;53331;24838;68852
330260;202010;4996;11976;3745;10264;352;1119;2623;6907;2975;8026
330270;202010;30654;67788;18623;48395;2966;8251;7670;19150;10636;27401
330280;202010;2398;6264;1788;5220;198;632;1047;2950;1245;3582
330285;202010;24709;58541;19341;50778;1475;4567;14239;36041;15714;40608
330290;202010;3924;9428;3136;8376;333;983;2221;5737;2554;6720
330300;202010;5870;13711;4216;11306;312;965;2946;7738;3258;8703
330310;202010;2737;6674;1923;5309;134;319;1268;3519;1402;3838
330320;202010;16991;39780;12905;34637;1506;3928;9205;24961;10711;28889
330330;202010;40656;87971;31025;74871;2763;7394;22168;52225;24931;59619
330340;202010;17315;40750;12273;32904;1786;5522;6473;16164;8259;21686
330350;202010;143651;328484;117522;296414;7481;19690;96262;241129;103743;260819
330360;202010;7500;18095;6397;16741;213;562;5422;14124;5635;14686
330370;202010;5021;14228;3806;12149;896;2925;1555;5185;2451;8110
330380;202010;5561;14749;4157;12214;699;2386;2086;5822;2785;8208
330385;202010;4045;11490;3264;10320;751;2618;1553;4835;2304;7453
330390;202010;26968;72121;20341;60585;2757;9485;11787;33003;14544;42488
330395;202010;3246;7961;2660;7191;159;503;1929;5090;2088;5593
330400;202010;3431;8913;2886;8047;157;550;2158;5665;2315;6215
330410;202010;3339;8825;2336;7047;470;1544;1013;2893;1483;4437
330411;202010;2823;7601;2158;6339;149;522;1493;4214;1642;4736
330412;202010;1546;4339;1240;3832;128;469;773;2241;901;2710
330414;202010;24547;61186;19778;54629;1589;4618;14660;39962;16249;44580
330415;202010;4290;11621;3287;9877;335;1063;1945;5791;2280;6854
330420;202010;11964;29335;8262;23275;976;3141;4320;11322;5296;14463
330430;202010;9717;23231;8055;20908;325;1076;6298;15836;6623;16912
330440;202010;2555;6799;1899;5680;297;1030;1082;3086;1379;4116
330450;202010;1396;3916;1084;3373;145;485;589;1806;734;2291
330452;202010;17666;44367;14058;38827;1705;5361;9068;24110;10773;29471
330455;202010;567695;1332837;431969;1136526;60261;169140;274787;709891;335048;879031
330460;202010;1197;3234;883;2766;152;517;476;1445;628;1962
330470;202010;4913;12202;3501;10011;1145;3395;969;2864;2114;6259
330475;202010;9682;24852;7773;22367;1202;3958;4976;13978;6178;17936
330480;202010;5984;15381;5003;13940;416;1304;3456;9326;3872;10630
330490;202010;115082;262250;92394;231623;10265;26812;65837;163364;76102;190176
330500;202010;7431;18252;6156;16495;622;1870;4442;11713;5064;13583
330510;202010;41229;101134;30252;85479;4920;14954;18426;51205;23346;66159
330513;202010;1241;3188;974;2808;212;653;468;1359;680;2012
330515;202010;2522;6620;1999;5874;373;1189;1112;3183;1485;4372
330520;202010;11384;29874;9154;26332;1199;3827;5604;15681;6803;19508
330530;202010;1765;4203;1276;3456;259;764;573;1528;832;2292
330540;202010;2916;7674;2238;6504;532;1602;947;2666;1479;4268
330550;202010;9210;23592;6996;20651;1927;6229;2871;8318;4798;14547
330555;202010;18422;38414;15178;34590;831;2119;12324;28285;13155;30404
330560;202010;4176;11108;3339;9691;505;1499;1988;5623;2493;7122
330570;202010;2769;7523;2319;6827;360;1147;1489;4330;1849;5477
330575;202010;5527;14217;4715;12818;286;888;3774;9941;4060;10829
330580;202010;17830;47252;13689;39705;2443;7651;6673;18511;9116;26162
330590;202010;1463;3930;1202;3593;222;663;743;2253;965;2916
330600;202010;12167;31553;9799;27735;906;2976;6280;17225;7186;20201
330610;202010;9258;24565;7357;21530;571;1952;5112;14583;5683;16535
330615;202010;2122;5737;1637;5067;308;973;1004;3173;1312;4146
330620;202010;4032;11468;3134;9899;699;2398;1323;3913;2022;6311
330630;202010;24917;61989;19428;53354;1381;4500;13837;36673;15218;41173
350010;202010;2094;5368;1061;3169;229;730;194;428;423;1158
350020;202010;711;1825;405;1234;50;160;161;454;211;614
350030;202010;3602;10011;2633;8306;654;2266;1085;3235;1739;5501
350040;202010;733;2087;414;1397;54;211;138;356;192;567
350050;202010;1328;3281;859;2455;186;616;291;676;477;1292
350055;202010;935;2420;716;2075;79;247;415;1138;494;1385
350060;202010;198;509;117;342;15;49;52;151;67;200
350070;202010;3461;9071;2158;6698;430;1496;674;1868;1104;3364
350075;202010;605;1761;445;1450;177;603;47;161;224;764
350080;202010;665;1717;421;1277;59;202;171;464;230;666
350090;202010;589;1392;354;978;70;209;152;387;222;596
350100;202010;2356;6186;1610;4854;126;470;994;2801;1120;3271
350110;202010;489;1234;329;948;17;59;190;540;207;599
350115;202010;1292;3723;1049;3209;187;629;537;1497;724;2126
350120;202010;690;1593;378;1016;36;118;202;474;238;592
350130;202010;3141;8260;2436;6960;416;1221;1208;3286;1624;4507
350140;202010;790;2217;522;1683;46;199;279;838;325;1037
350150;202010;535;1626;432;1428;98;321;123;371;221;692
350160;202010;11188;27928;7402;21004;933;3003;4444;11930;5377;14933
350170;202010;2295;6514;1835;5495;324;1061;841;2306;1165;3367
350180;202010;1045;2581;536;1594;110;345;112;289;222;634
350190;202010;2909;8188;1973;6184;365;1298;813;2174;1178;3472
350200;202010;458;1288;354;1091;18;62;229;660;247;722
350210;202010;5927;13514;3979;10520;517;1488;2428;6165;2945;7653
350220;202010;2903;7913;1940;5990;414;1348;637;1783;1051;3131
350230;202010;1020;2614;831;2338;154;464;464;1263;618;1727
350240;202010;657;1900;417;1341;87;281;104;310;191;591
350250;202010;2535;7137;1883;6044;618;2179;420;1330;1038;3509
350260;202010;845;1991;538;1459;58;180;326;848;384;1028
350270;202010;4592;12300;3615;10413;544;1732;1909;5101;2453;6833
350275;202010;2410;6424;1861;5557;308;1019;1065;3029;1373;4048
350280;202010;19343;43343;11309;30244;1886;5335;4432;11284;6318;16619
350290;202010;3244;8928;2147;6624;376;1273;848;2434;1224;3707
350300;202010;650;1745;477;1418;67;202;247;687;314;889
350310;202010;918;2635;670;2131;112;404;257;728;369;1132
350315;202010;597;1476;390;1131;24;85;203;540;227;625
350320;202010;15304;39100;11071;31551;2341;7372;4171;10959;6512;18331
350330;202010;14195;34749;9953;26582;1089;3193;6212;15564;7301;18757
350335;202010;371;1037;285;876;37;129;133;381;170;510
350340;202010;1185;3014;710;2138;122;420;281;751;403;1171
350350;202010;754;1898;574;1695;70;244;341;984;411;1228
350360;202010;1090;3213;823;2650;218;717;251;820;469;1537
350370;202010;620;1540;424;1186;153;411;128;363;281;774
350380;202010;4472;12199;3126;9451;898;2664;780;2433;1678;5097
350390;202010;10828;28429;8433;24299;1731;5185;3948;10976;5679;16161
350395;202010;437;1122;218;690;24;70;79;227;103;297
350400;202010;8168;20000;5604;15740;1380;4168;1546;4284;2926;8452
350410;202010;9967;27659;7176;22208;1492;5159;2754;7844;4246;13003
350420;202010;755;2023;525;1524;87;280;128;318;215;598
350430;202010;668;1796;536;1580;69;241;328;886;397;1127
350440;202010;2061;5143;1658;4529;134;392;1071;2853;1205;3245
350450;202010;6680;18269;5144;15602;1125;3734;2116;6012;3241;9746
350460;202010;1766;4552;916;2819;156;513;241;655;397;1168
350470;202010;255;640;196;540;12;38;137;363;149;401
350480;202010;1004;2508;638;1861;124;444;156;350;280;794
350490;202010;1992;5173;1401;4202;324;996;423;1179;747;2175
350500;202010;680;1795;510;1482;67;208;252;691;319;899
350510;202010;1177;3046;869;2483;96;308;516;1413;612;1721
350520;202010;2166;6558;1657;5540;264;981;741;2238;1005;3219
350530;202010;2856;7104;2094;5673;234;707;1248;3160;1482;3867
350535;202010;1443;3911;1239;3624;175;560;768;2181;943;2741
350540;202010;1961;4640;1444;3862;171;471;907;2337;1078;2808
350550;202010;8439;20739;5806;16382;624;2105;3371;8815;3995;10920
350560;202010;3965;11085;3125;9566;306;988;1948;5771;2254;6759
350570;202010;24606;68409;19661;58737;3654;11992;9937;28406;13591;40398
350580;202010;2127;5711;1230;3791;319;1075;223;558;542;1633
350590;202010;5132;13794;3725;10631;488;1593;2182;5736;2670;7329
350600;202010;36604;84207;22411;59407;3299;9883;10479;25458;13778;35341
350610;202010;6897;18842;4909;14840;863;2867;2251;6379;3114;9246
350620;202010;423;1073;265;828;28;90;151;457;179;547
350630;202010;1461;3780;1061;3062;75;282;688;1846;763;2128
350635;202010;9444;23124;7035;19347;978;2959;4230;11118;5208;14077
350640;202010;937;2494;488;1516;74;234;142;385;216;619
350650;202010;8567;22755;5796;17263;1125;3615;2165;5974;3290;9589
350660;202010;4627;12066;3533;10245;582;1706;1821;5285;2403;6991
350670;202010;1840;4875;1497;4374;156;471;1002;2926;1158;3397
350680;202010;1131;3042;750;2330;142;453;297;869;439;1322
350690;202010;1300;3341;908;2682;158;501;481;1378;639;1879
350700;202010;4913;12374;3449;10078;686;2282;1462;4049;2148;6331
350710;202010;2867;7795;2406;6974;412;1400;1306;3479;1718;4879
350715;202010;817;2331;666;2054;72;278;362;1038;434;1316
350720;202010;155;409;111;333;17;49;35;88;52;137
350730;202010;623;1664;522;1490;31;114;389;1044;420;1158
350740;202010;1691;4478;1153;3386;206;649;385;1038;591;1687
350745;202010;596;1512;326;994;40;149;133;368;173;517
350750;202010;9919;25703;7479;21481;1298;4309;3389;8680;4687;12989
350760;202010;14951;37055;10679;29615;2234;6831;4409;11012;6643;17843
350770;202010;990;2460;615;1796;36;118;400;1137;436;1255
350775;202010;673;1570;452;1239;51;147;214;582;265;729
350780;202010;2279;5507;1600;4520;261;865;572;1849;833;2714
350790;202010;1874;4955;1173;3633;236;807;335;836;571;1643
350800;202010;3489;9992;2978;9083;249;874;2051;6051;2300;6925
350810;202010;2829;6890;2196;5956;334;863;1198;3323;1532;4186
350820;202010;939;2192;531;1457;53;176;262;647;315;823
350830;202010;882;2439;493;1565;77;250;152;411;229;661
350840;202010;3320;9639;2461;7997;550;1961;1100;3278;1650;5239
350850;202010;7343;20257;5694;17287;1103;3636;2705;7799;3808;11435
350860;202010;3630;9658;3093;8926;113;417;2365;6743;2478;7160
350870;202010;2616;7322;1905;6160;261;954;1058;3321;1319;4275
350880;202010;1354;3856;1052;3250;275;880;286;852;561;1732
350890;202010;536;1376;334;955;51;152;126;337;177;489
350900;202010;7356;19866;4610;14014;984;3278;1551;4323;2535;7601
350910;202010;913;2230;776;2014;96;254;553;1417;649;1671
350920;202010;12265;30017;10310;26830;433;1400;8424;21078;8857;22478
350925;202010;4328;11746;3056;9418;578;1911;1436;4081;2014;5992
350930;202010;1524;3952;1038;2986;88;254;643;1822;731;2076
350940;202010;2300;6031;1757;5139;186;612;1099;3078;1285;3690
350945;202010;852;2379;632;1947;99;351;328;921;427;1272
350950;202010;89348;228832;68174;188827;8836;26912;41735;110097;50571;137009
350960;202010;6515;17554;5020;14727;597;2018;2997;8307;3594;10325
350970;202010;3621;10133;2582;8131;758;2658;526;1413;1284;4071
350980;202010;652;1787;523;1554;136;422;238;702;374;1124
350990;202010;1776;4932;1289;4124;316;1124;448;1345;764;2469
350995;202010;796;2452;706;2269;54;214;491;1511;545;1725
351000;202010;2892;7498;2003;5895;359;1106;724;2081;1083;3187
351010;202010;342;841;225;639;28;91;115;311;143;402
351015;202010;825;2470;650;2089;107;374;294;845;401;1219
351020;202010;8848;23958;6701;20247;1422;4369;3146;9273;4568;13642
351030;202010;2825;8377;2239;7183;319;1130;1204;3765;1523;4895
351040;202010;5015;12390;4166;11095;215;693;3395;8787;3610;9480
351050;202010;17405;42280;12295;34207;2434;7160;5392;14803;7826;21963
351060;202010;48864;122653;36897;101961;3826;11652;24652;65851;28478;77503
351070;202010;1435;3538;765;2354;186;629;131;390;317;1019
351080;202010;2794;6729;1985;5759;215;741;1315;3622;1530;4363
351090;202010;324;945;230;766;49;166;66;217;115;383
351100;202010;2660;7171;1692;5194;381;1231;478;1526;859;2757
351110;202010;6280;15925;4003;11723;670;2166;1697;4647;2367;6813
351120;202010;790;1990;519;1532;66;207;196;563;262;770
351130;202010;1196;3123;537;1702;100;322;139;412;239;734
351140;202010;2160;6081;1574;4934;311;1074;665;1870;976;2944
351150;202010;2609;7458;1732;5488;291;1008;672;1894;963;2902
351160;202010;1132;3500;833;2798;177;638;214;612;391;1250
351170;202010;1382;3774;1182;3403;94;293;841;2342;935;2635
351190;202010;1011;2799;657;2065;117;370;230;662;347;1032
351200;202010;1628;3877;1193;3225;99;302;838;2128;937;2430
351210;202010;1569;3864;957;2681;81;271;560;1450;641;1721
351220;202010;3305;9268;2801;8420;309;959;1863;5537;2172;6496
351230;202010;1786;4801;1309;3954;225;795;591;1601;816;2396
351240;202010;2458;6260;1486;4203;322;975;536;1353;858;2328
351250;202010;1076;2855;629;1943;88;288;223;678;311;966
351260;202010;923;2326;657;1835;130;368;248;653;378;1021
351270;202010;448;1195;364;1049;39;137;221;559;260;696
351280;202010;3933;10260;2955;8425;576;1674;1329;3642;1905;5316
351290;202010;1255;3076;858;2392;121;365;505;1353;626;1718
351300;202010;18314;49541;12398;37988;2193;7297;5350;15641;7543;22938
351310;202010;3475;8471;2621;7136;186;645;1922;4941;2108;5586
351320;202010;980;2800;722;2246;134;451;257;712;391;1163
351330;202010;492;1170;402;1003;21;60;289;652;310;712
351340;202010;6368;18063;5047;15716;1229;3994;2189;6796;3418;10790
351350;202010;11590;28898;9486;25562;1000;2889;6896;18056;7896;20945
351360;202010;3803;10156;3106;9097;750;2357;1208;3264;1958;5621
351370;202010;2087;5811;1382;4317;322;1087;432;1225;754;2312
351380;202010;49657;119338;34806;93197;4386;12603;19974;50993;24360;63596
351385;202010;336;889;150;465;30;90;41;116;71;206
351390;202010;1410;3445;869;2638;123;444;496;1396;619;1840
351400;202010;926;2591;756;2233;115;349;469;1346;584;1695
351410;202010;2651;7350;1876;5814;328;1063;755;2265;1083;3328
351420;202010;425;1000;239;670;28;75;143;373;171;448
351430;202010;953;2554;731;2183;57;171;505;1453;562;1624
351440;202010;3493;9123;2255;6576;415;1258;622;1550;1037;2808
351450;202010;1747;4618;1135;3460;226;742;181;425;407;1167
351460;202010;844;2194;649;1872;154;429;348;1002;502;1431
351470;202010;1220;3078;937;2602;88;302;610;1591;698;1893
351480;202010;2494;7302;1952;6340;362;1310;836;2541;1198;3851
351490;202010;2030;5687;1720;5126;73;297;1385;3977;1458;4274
351492;202010;358;963;292;821;8;24;217;596;225;620
351495;202010;188;487;138;386;17;43;75;208;92;251
351500;202010;38718;94632;28761;77731;4249;12293;17206;44401;21455;56694
351510;202010;13031;32312;9354;25874;1136;3585;5800;15286;6936;18871
351512;202010;484;1308;344;1005;61;184;117;310;178;494
351515;202010;3274;7292;1996;5268;349;1038;588;1646;937;2684
351518;202010;2374;5982;1498;4402;204;673;824;2196;1028;2869
351519;202010;720;1975;438;1414;88;282;67;202;155;484
351520;202010;1293;3199;537;1622;56;191;228;612;284;803
351530;202010;362;956;211;632;30;93;86;205;116;298
351535;202010;1919;4666;1353;3691;216;653;697;1778;913;2431
351540;202010;2530;6270;1671;4754;298;972;613;1531;911;2503
351550;202010;7174;17709;4751;13274;487;1568;2691;6966;3178;8534
351560;202010;456;1292;351;1080;85;287;108;307;193;594
351565;202010;225;635;178;549;41;145;46;122;87;267
351570;202010;21636;57614;16274;46663;1701;5297;10122;27737;11823;33034
351580;202010;249;639;136;418;12;41;58;185;70;226
351590;202010;533;1218;281;772;24;91;162;402;186;493
351600;202010;1367;3604;1036;2974;101;316;618;1663;719;1979
351610;202010;773;1814;482;1306;24;68;280;712;304;780
351620;202010;23386;61420;16750;49868;2743;9257;7571;20300;10314;29557
351630;202010;28474;74346;22683;64249;3203;9605;14133;38636;17336;48241
351640;202010;17797;46754;13744;39213;1331;4348;9261;25272;10592;29620
351650;202010;382;1002;173;553;23;77;53;145;76;222
351660;202010;758;2123;475;1483;79;261;72;181;151;442
351670;202010;5948;15908;3794;11209;807;2390;1623;4501;2430;6891
351680;202010;426;1208;267;855;44;138;67;179;111;317
351685;202010;420;1203;332;1053;91;289;105;310;196;599
351690;202010;1112;2782;611;1793;83;273;257;676;340;949
351700;202010;1371;3401;973;2698;163;466;526;1370;689;1836
351710;202010;759;2035;537;1609;55;186;284;765;339;951
351720;202010;1419;3670;921;2789;144;468;377;1073;521;1541
351730;202010;948;2485;780;2220;59;210;498;1333;557;1543
351740;202010;3589;8996;2781;7440;492;1426;1368;3362;1860;4788
351750;202010;1359;3548;829;2598;153;497;317;961;470;1458
351760;202010;3339;9398;2421;7525;506;1782;888;2480;1394;4262
351770;202010;1762;5182;1432;4544;274;910;745;2301;1019;3211
351780;202010;1257;3166;734;2176;106;363;260;730;366;1093
351790;202010;1363;3245;1060;2838;170;467;624;1676;794;2143
351800;202010;521;1209;252;699;28;81;98;230;126;311
351810;202010;1064;2770;864;2461;48;135;616;1677;664;1812
351820;202010;2613;7303;1795;5703;465;1607;414;1211;879;2818
351830;202010;4571;12199;3482;10297;329;1170;2174;6091;2503;7261
351840;202010;8640;23791;6412;19623;922;3173;3333;9485;4255;12658
351850;202010;1593;4293;1037;3205;173;612;356;934;529;1546
351860;202010;2768;7927;2109;6692;362;1234;1115;3570;1477;4804
351870;202010;24178;61516;17792;50929;4472;13275;7244;20978;11716;34253
351880;202010;133847;342983;99133;282609;22167;69852;45734;123464;67901;193316
351885;202010;915;2440;712;2095;61;220;468;1313;529;1533
351890;202010;837;2155;526;1630;111;360;93;244;204;604
351900;202010;1118;2960;861;2575;126;376;482;1429;608;1805
351905;202010;439;1187;310;939;26;90;148;391;174;481
351907;202010;21437;55887;16465;46944;1889;5953;10576;28950;12465;34903
351910;202010;1617;4198;1109;3084;75;227;651;1633;726;1860
351920;202010;884;2326;664;1907;106;353;290;749;396;1102
351925;202010;902;2368;695;1988;89;293;373;981;462;1274
351930;202010;3273;9120;2915;8457;592;1720;1922;5494;2514;7214
351940;202010;1105;2835;786;2272;126;394;383;1087;509;1481
351950;202010;1703;3829;1245;3152;62;184;873;2118;935;2302
351960;202010;5252;13217;3780;10573;831;2499;1687;4379;2518;6878
351970;202010;7217;21290;5663;18527;873;3193;3091;9785;3964;12978
351980;202010;1006;2345;628;1725;85;270;363;916;448;1186
351990;202010;1433;3363;1021;2760;54;201;505;1233;559;1434
352000;202010;2625;7442;2243;6644;250;850;1476;4083;1726;4933
352010;202010;2290;6086;1823;5304;470;1502;396;1171;866;2673
352020;202010;1440;3936;1095;3348;167;555;533;1543;700;2098
352030;202010;5841;15256;4468;12969;834;2642;2207;6177;3041;8819
352040;202010;2951;7855;1986;5861;276;920;757;1898;1033;2818
352042;202010;3059;7431;1968;5654;375;1221;855;2340;1230;3561
352044;202010;2111;5576;1188;3800;191;693;238;701;429;1394
352050;202010;12776;33937;8207;24804;2046;7052;1592;4011;3638;11063
352060;202010;705;1887;506;1515;73;237;224;616;297;853
352070;202010;915;1827;582;1386;62;158;286;601;348;759
352080;202010;497;1247;282;816;31;108;102;261;133;369
352090;202010;1506;4407;1234;3856;140;506;589;1659;729;2165
352100;202010;3470;9718;2794;8430;595;1971;1223;3545;1818;5516
352110;202010;606;1750;458;1452;96;317;184;539;280;856
352115;202010;510;1370;419;1229;57;203;245;693;302;896
352120;202010;896;2633;732;2297;81;246;434;1276;515;1522
352130;202010;2041;5663;1352;3994;203;639;542;1465;745;2104
352140;202010;1196;3252;835;2542;147;478;388;1137;535;1615
352150;202010;889;2336;683;1983;79;247;479;1355;558;1602
352160;202010;1010;2470;724;2013;78;270;409;1079;487;1349
352170;202010;3056;8113;2394;6799;322;1034;1456;3832;1778;4866
352180;202010;2526;6804;1923;5691;451;1501;576;1506;1027;3007
352190;202010;1252;3344;978;2918;185;517;467;1458;652;1975
352200;202010;339;1023;235;810;32;121;87;287;119;408
352210;202010;20027;46927;15621;41070;1006;2965;12127;31234;13133;34199
352215;202010;641;1647;548;1512;71;216;344;918;415;1134
352220;202010;21281;52485;14473;40221;2686;8122;6555;16802;9241;24924
352230;202010;14367;41318;11010;34944;2620;9256;3992;11638;6612;20894
352240;202010;10585;27163;7991;22801;1723;5543;3465;9103;5188;14646
352250;202010;23315;64995;18415;56409;3037;9935;10842;32649;13879;42584
352260;202010;4839;12116;3221;8953;465;1495;1820;4538;2285;6033
352265;202010;918;2533;806;2376;49;165;608;1746;657;1911
352270;202010;1470;4354;1075;3492;233;822;380;1153;613;1975
352280;202010;2487;6243;1867;5335;193;676;1105;2902;1298;3578
352290;202010;1160;3341;930;2885;124;431;503;1410;627;1841
352300;202010;914;2463;602;1805;81;283;319;888;400;1171
352310;202010;45464;120298;33515;99135;8219;24950;14389;42761;22608;67711
352320;202010;6650;17492;5088;14422;776;2487;2704;6902;3480;9389
352330;202010;2238;5893;1670;5086;287;1030;900;2570;1187;3600
352340;202010;5948;15607;4346;12665;671;2237;2214;5920;2885;8157
352350;202010;2175;6170;1675;5049;177;659;923;2495;1100;3154
352360;202010;1253;3321;1022;2916;82;288;768;2105;850;2393
352370;202010;1081;3026;931;2779;21;85;758;2218;779;2303
352380;202010;856;2325;637;1926;130;395;222;637;352;1032
352390;202010;15158;37088;10144;28322;1647;5026;5533;14571;7180;19597
352400;202010;3554;9763;2886;8509;617;2122;1455;3974;2072;6096
352410;202010;3279;8385;2461;7009;211;708;1537;4189;1748;4897
352420;202010;851;2048;599;1681;111;327;225;595;336;922
352430;202010;8064;19943;5738;15866;1182;3708;2687;6972;3869;10680
352440;202010;18215;49072;13427;39805;3256;9962;4990;14375;8246;24337
352450;202010;798;1943;397;1249;55;193;135;401;190;594
352460;202010;3005;8291;2055;6527;410;1428;819;2442;1229;3870
352470;202010;3452;8684;2582;7273;302;974;1558;4132;1860;5106
352480;202010;4039;9532;2656;7055;417;1260;1300;3107;1717;4367
352490;202010;748;2139;597;1870;101;343;293;869;394;1212
352500;202010;10511;26992;7003;20391;2914;9311;735;1205;3649;10516
352510;202010;3779;10166;2807;8470;564;1846;1314;3765;1878;5611
352520;202010;2910;7543;2245;6407;392;1275;1289;3334;1681;4609
352530;202010;10534;27161;6948;20220;1184;3965;2386;5919;3570;9884
352540;202010;581;1701;414;1321;64;237;145;401;209;638
352550;202010;1011;2797;696;2188;128;440;247;702;375;1142
352560;202010;586;1620;442;1338;80;254;205;574;285;828
352570;202010;2312;6581;1431;4630;342;1194;140;364;482;1558
352580;202010;671;1733;552;1524;48;159;374;981;422;1140
352585;202010;329;870;234;703;18;70;140;384;158;454
352590;202010;13347;35027;9302;27263;2373;7565;4068;11074;6441;18639
352600;202010;1963;5254;1521;4422;157;493;951;2617;1108;3110
352610;202010;2935;8180;2192;6867;430;1533;896;2631;1326;4164
352620;202010;5667;14437;4283;12423;1232;3653;1650;4825;2882;8478
352630;202010;854;2120;630;1783;118;376;288;743;406;1119
352640;202010;3030;7754;2150;6173;208;636;1238;3390;1446;4026
352650;202010;613;1713;424;1303;60;208;152;450;212;658
352660;202010;1093;3186;889;2767;109;354;512;1554;621;1908
352670;202010;9863;26310;6384;19352;1579;5167;1615;4549;3194;9716
352680;202010;3290;9720;2281;7407;344;1335;1094;3174;1438;4509
352690;202010;27643;69025;21320;58189;1405;4564;15070;39326;16475;43890
352700;202010;589;1465;433;1248;155;510;99;272;254;782
352710;202010;5257;13474;3709;10646;873;2765;1544;4061;2417;6826
352720;202010;7967;21598;6159;18196;2482;7518;1432;3932;3914;11450
352725;202010;602;1440;333;951;22;56;162;441;184;497
352730;202010;5169;14953;4636;13698;543;1752;2175;5647;2718;7399
352740;202010;2330;5471;1714;4560;175;552;1044;2606;1219;3158
352750;202010;419;1037;248;724;39;128;105;265;144;393
352760;202010;1691;4665;1292;3862;104;293;747;2246;851;2539
352770;202010;886;2382;595;1814;124;395;233;675;357;1070
352780;202010;632;1787;450;1426;96;291;123;390;219;681
352790;202010;452;1206;310;920;36;121;120;315;156;436
352800;202010;1283;3930;893;2992;242;831;121;350;363;1181
352810;202010;1179;2777;740;1997;107;312;448;1126;555;1438
352820;202010;512;1415;360;1151;74;235;76;252;150;487
352830;202010;586;1475;264;797;22;66;61;147;83;213
352840;202010;4070;11560;3309;10183;1094;3622;1103;3279;2197;6901
352850;202010;11191;27126;7516;21108;1983;6064;2397;6051;4380;12115
352860;202010;1037;2845;760;2329;145;477;288;840;433;1317
352870;202010;873;2169;605;1619;50;167;381;953;431;1120
352880;202010;1779;4181;1239;3239;201;551;684;1715;885;2266
352885;202010;301;821;221;676;23;79;131;377;154;456
352890;202010;706;1683;443;1139;41;119;266;612;307;731
352900;202010;18136;47173;11876;34749;1980;6186;5224;14327;7204;20513
352910;202010;434;1148;231;713;24;84;67;182;91;266
352920;202010;2683;6823;1936;5535;135;419;1318;3655;1453;4074
352930;202010;5858;15760;4317;12747;776;2540;2037;5557;2813;8097
352940;202010;22734;61700;16359;48246;3348;10851;6927;19130;10275;29981
352950;202010;539;1423;321;1020;91;285;60;174;151;459
352960;202010;749;1978;412;1266;71;238;121;323;192;561
352965;202010;236;665;147;484;45;144;34;102;79;246
352970;202010;2967;7073;2243;5886;241;680;1461;3771;1702;4451
352980;202010;1370;3633;1084;3198;258;832;551;1578;809;2410
352990;202010;4119;11492;3204;9975;641;2206;1582;4710;2223;6916
353000;202010;475;1296;256;788;35;118;60;151;95;269
353010;202010;2607;6363;1709;4773;344;1109;715;1806;1059;2915
353020;202010;3693;9469;2123;6191;299;966;720;1947;1019;2913
353030;202010;4543;11415;3090;8865;692;2166;893;2433;1585;4599
353040;202010;655;1500;455;1208;84;221;235;602;319;823
353050;202010;5196;14822;3649;11656;707;2442;1649;5037;2356;7479
353060;202010;49129;124648;40130;110221;2793;9204;29977;79386;32770;88590
353070;202010;9567;27223;6867;21456;1303;4478;2848;8197;4151;12675
353080;202010;4124;11414;2727;8686;506;1824;1051;2933;1557;4757
353090;202010;586;1736;447;1441;33;112;288;898;321;1010
353100;202010;315;845;140;442;28;97;40;99;68;196
353110;202010;7643;20322;6140;18134;1273;3862;3180;9703;4453;13565
353120;202010;403;996;294;817;40;134;136;331;176;465
353130;202010;2484;5801;1566;4282;396;1210;527;1289;923;2499
353140;202010;2731;6733;1951;5389;111;366;1368;3615;1479;3981
353150;202010;1632;3990;1145;3181;222;634;499;1323;721;1957
353160;202010;608;1565;434;1275;75;226;180;483;255;709
353170;202010;536;1436;401;1244;84;286;173;527;257;813
353180;202010;9924;24198;7723;20622;686;2032;5759;14926;6445;16958
353190;202010;3357;9002;2650;7576;334;1020;1573;4220;1907;5240
353200;202010;1929;5083;993;3126;160;553;247;698;407;1251
353205;202010;377;1141;322;1024;57;195;152;460;209;655
353210;202010;936;2159;586;1580;29;91;387;1018;416;1109
353215;202010;395;1096;305;928;46;151;143;398;189;549
353220;202010;749;2035;470;1443;95;286;72;205;167;491
353230;202010;832;2287;641;1980;180;611;247;701;427;1312
353240;202010;2361;6392;1908;5639;267;910;1123;3183;1390;4093
353250;202010;1308;2926;802;2084;106;315;458;1110;564;1425
353260;202010;1197;2738;652;1852;97;307;301;814;398;1121
353270;202010;690;1770;576;1566;50;154;394;1006;444;1160
353280;202010;699;1889;486;1494;128;399;125;367;253;766
353282;202010;1818;5064;1521;4519;170;562;937;2630;1107;3192
353284;202010;366;837;190;505;21;78;85;189;106;267
353286;202010;170;431;103;321;13;40;34;100;47;140
353290;202010;1487;3925;920;2769;151;459;305;834;456;1293
353300;202010;1974;5252;1430;4180;234;781;646;1688;880;2469
353310;202010;393;956;281;749;20;71;190;475;210;546
353320;202010;675;1647;559;1481;8;34;485;1273;493;1307
353325;202010;689;1974;469;1495;104;323;169;518;273;841
353330;202010;540;1369;366;1039;43;125;203;537;246;662
353340;202010;2866;7716;1978;5969;402;1351;883;2476;1285;3827
353350;202010;3643;9249;2488;6972;545;1642;716;1774;1261;3416
353360;202010;649;1818;498;1526;54;171;292;865;346;1036
353370;202010;569;1634;473;1482;36;117;333;1008;369;1125
353380;202010;280;847;230;746;23;84;125;371;148;455
353390;202010;6356;15659;4745;12942;497;1539;2812;7222;3309;8761
353400;202010;447;1211;332;990;57;199;126;312;183;511
353410;202010;537;1441;404;1202;73;215;223;671;296;886
353420;202010;424;1108;245;714;60;164;19;42;79;206
353430;202010;2258;6222;1708;5202;364;1209;747;2134;1111;3343
353440;202010;66218;177700;47440;141223;7607;24697;25403;71323;33010;96020
353450;202010;375;941;252;727;35;121;120;310;155;431
353460;202010;3251;8788;2294;6935;168;579;1039;3036;1207;3615
353470;202010;7789;20334;5525;16149;899;3034;2414;6411;3313;9445
353475;202010;1545;4009;1066;3019;159;495;529;1383;688;1878
353480;202010;1625;4335;1281;3730;61;220;897;2523;958;2743
353490;202010;1120;2943;741;2207;112;369;330;915;442;1284
353500;202010;1063;2487;783;2062;164;439;433;1133;597;1572
353510;202010;772;2315;555;1784;135;481;143;383;278;864
353520;202010;1074;2810;672;2072;81;277;307;876;388;1153
353530;202010;2438;6438;1891;5446;261;846;1000;2678;1261;3524
353540;202010;2071;5520;1675;4889;273;838;976;2775;1249;3613
353550;202010;5866;14942;4678;13039;764;2228;2649;7117;3413;9345
353560;202010;2273;6127;1675;5183;462;1560;471;1307;933;2867
353570;202010;595;1536;438;1284;48;148;259;714;307;862
353580;202010;2122;5560;1578;4504;342;987;737;2054;1079;3041
353590;202010;705;1841;458;1364;92;292;188;552;280;844
353600;202010;1731;4244;1289;3474;159;433;713;1864;872;2297
353610;202010;588;1756;423;1419;91;371;129;389;220;760
353620;202010;2665;7113;1866;5719;372;1272;597;1670;969;2942
353625;202010;511;1259;337;944;22;75;213;581;235;656
353630;202010;1298;3987;1076;3487;232;840;385;1143;617;1983
353640;202010;1415;3624;1115;3154;156;445;612;1717;768;2162
353650;202010;7940;21065;5875;17125;626;2028;3537;9715;4163;11743
353657;202010;396;1018;281;821;30;97;134;362;164;459
353660;202010;1290;2743;877;2185;399;999;194;468;593;1467
353670;202010;4122;11394;3155;9467;618;2104;1536;4267;2154;6371
353680;202010;698;1815;515;1548;83;278;285;802;368;1080
353690;202010;436;1120;190;583;23;68;37;99;60;167
353700;202010;2053;5325;1676;4692;118;380;1239;3326;1357;3706
353710;202010;5402;12016;3180;8077;325;867;1820;4133;2145;5000
353715;202010;435;1149;259;811;11;45;85;251;96;296
353720;202010;2032;5311;1562;4612;230;730;880;2555;1110;3285
353730;202010;4499;11719;3343;9627;492;1654;1713;4490;2205;6144
353740;202010;2031;5352;1400;4230;343;1123;462;1250;805;2373
353750;202010;855;2539;596;2025;143;535;111;374;254;909
353760;202010;12641;29346;9539;25097;1846;4995;5225;13467;7071;18462
353770;202010;736;2199;418;1405;73;269;56;163;129;432
353780;202010;5268;14639;4143;12451;850;2855;2002;5545;2852;8400
353790;202010;2615;7865;1870;6260;513;1908;403;1169;916;3077
353800;202010;18312;47613;14113;40737;2029;6242;7885;22627;9914;28869
353810;202010;1163;3101;736;2205;113;377;307;871;420;1248
353820;202010;1760;4724;1223;3628;254;817;397;1098;651;1915
353830;202010;627;1585;461;1305;82;241;205;552;287;793
353850;202010;1647;4552;1254;3788;269;793;451;1332;720;2125
353860;202010;2641;7260;2002;6146;475;1641;876;2453;1351;4094
353870;202010;29736;77748;20843;60244;2705;8817;10912;28676;13617;37493
353880;202010;3168;8693;2489;7383;205;704;1541;4392;1746;5096
353890;202010;2663;5732;1779;4498;133;367;1251;2993;1384;3360
353900;202010;754;2104;537;1668;84;293;212;606;296;899
353910;202010;2373;6510;1945;5832;201;714;1330;3900;1531;4614
353920;202010;1837;5079;1289;3997;304;1072;322;817;626;1889
353930;202010;4324;11448;2916;8833;511;1780;1194;3170;1705;4950
353940;202010;1081;3057;724;2340;126;422;246;738;372;1160
353950;202010;3231;8729;2457;7300;454;1467;1343;3719;1797;5186
353960;202010;715;1857;478;1401;93;293;205;574;298;867
353970;202010;666;1600;490;1331;45;138;330;871;375;1009
353980;202010;16750;42049;12929;35258;857;2713;9314;24244;10171;26957
353990;202010;928;2244;546;1539;92;281;251;667;343;948
354000;202010;2496;6016;1368;3857;309;921;240;643;549;1564
354010;202010;359;932;254;760;48;157;136;387;184;544
354020;202010;3545;9697;2757;8041;639;2017;1139;3027;1778;5044
354025;202010;726;2004;471;1489;67;237;127;382;194;619
354030;202010;516;1135;280;740;65;184;134;328;199;512
354040;202010;817;1891;516;1393;22;73;387;1011;409;1084
354050;202010;963;2685;653;2123;143;486;206;666;349;1152
354060;202010;3352;9488;2291;7239;514;1747;842;2434;1356;4181
354070;202010;3685;9728;2474;7345;428;1472;1048;2653;1476;4125
354075;202010;2666;7685;2057;6545;272;977;1162;3610;1434;4587
354080;202010;1372;3721;887;2764;187;609;230;649;417;1258
354085;202010;434;897;336;765;0;0;255;534;255;534
354090;202010;1666;4639;1421;4121;82;247;1101;3126;1183;3373
354100;202010;19518;52910;13247;41860;2925;9987;5009;15650;7934;25637
354105;202010;1483;3735;998;2839;130;379;463;1234;593;1613
354110;202010;480;1330;326;1042;53;177;111;345;164;522
354120;202010;1397;3752;922;2731;186;606;314;806;500;1412
354130;202010;5495;14401;3588;10746;889;2827;211;420;1100;3247
354140;202010;19566;47858;13039;35780;2239;6797;5595;14124;7834;20921
354150;202010;3032;7167;2253;5928;496;1344;886;2278;1382;3622
354160;202010;2914;8434;2107;6781;599;2078;575;1667;1174;3745
354165;202010;678;1994;508;1653;83;314;261;796;344;1110
354170;202010;1819;5029;1512;4436;90;304;967;2712;1057;3016
354180;202010;392;1088;280;847;52;165;110;299;162;464
354190;202010;1506;4194;1044;3243;72;250;481;1415;553;1665
354200;202010;885;2157;685;1851;72;217;442;1123;514;1340
354210;202010;816;2132;646;1838;38;131;472;1266;510;1397
354220;202010;3190;8496;2352;6823;378;1172;1224;3365;1602;4537
354230;202010;771;1899;608;1698;45;158;443;1186;488;1344
354240;202010;1671;4631;1115;3495;191;653;341;943;532;1596
354250;202010;550;1318;338;987;96;285;80;248;176;533
354260;202010;8230;21758;6191;18158;1255;3946;2597;7309;3852;11255
354270;202010;1045;3109;835;2702;176;550;331;1040;507;1590
354280;202010;797;2002;676;1825;62;205;429;1066;491;1271
354290;202010;931;2944;777;2617;131;434;390;1339;521;1773
354300;202010;3623;10571;3054;9501;819;2528;1208;3758;2027;6286
354310;202010;730;2144;590;1853;134;446;226;658;360;1104
354320;202010;1003;2432;645;1809;104;328;244;603;348;931
354323;202010;469;1134;311;844;39;85;134;355;173;440
354325;202010;1434;4286;987;3233;161;524;346;1081;507;1605
354330;202010;9692;24521;6407;17764;768;2454;3770;9697;4538;12151
354340;202010;32849;82160;21961;63023;3409;11029;11399;31082;14808;42111
354350;202010;1205;3098;953;2666;101;306;628;1682;729;1988
354360;202010;613;1575;355;1142;65;212;75;237;140;449
354370;202010;1006;2874;798;2528;127;434;461;1430;588;1864
354380;202010;716;1885;509;1543;93;370;129;304;222;674
354390;202010;14112;33998;9064;25065;1669;4935;3832;9995;5501;14930
354400;202010;1577;5022;1188;4101;202;765;441;1486;643;2251
354410;202010;5921;15950;4437;12942;919;2877;1999;5508;2918;8385
354420;202010;1496;3886;1082;3131;145;454;653;1797;798;2251
354425;202010;2742;6625;1919;5191;440;1194;831;2235;1271;3429
354430;202010;1517;4049;1160;3466;125;433;688;1919;813;2352
354440;202010;555;1486;360;1082;58;196;157;431;215;627
354450;202010;423;1109;231;737;32;106;76;211;108;317
354460;202010;877;2196;570;1644;73;228;312;871;385;1099
354470;202010;476;1210;313;888;21;66;153;381;174;447
354480;202010;1210;2742;777;2046;68;182;524;1324;592;1506
354490;202010;828;2441;591;1908;92;308;278;832;370;1140
354500;202010;2117;5898;1713;5271;519;1680;412;1294;931;2974
354510;202010;738;2048;580;1733;55;176;315;853;370;1029
354515;202010;339;980;249;793;42;156;103;312;145;468
354520;202010;7131;19471;4941;14705;711;2442;2723;7483;3434;9925
354530;202010;4319;12296;3272;10188;789;2502;1234;3877;2023;6379
354540;202010;1338;3524;957;2836;224;702;357;1054;581;1756
354550;202010;580;1498;452;1256;66;204;255;670;321;874
354560;202010;2242;5382;1193;3351;142;413;598;1573;740;1986
354570;202010;1248;3117;491;1399;83;248;57;157;140;405
354580;202010;8783;22987;5603;16917;848;2792;2779;8037;3627;10829
354600;202010;1916;5066;1461;4212;154;522;959;2608;1113;3130
354610;202010;445;1136;247;731;24;70;118;334;142;404
354620;202010;455;1266;279;915;53;198;102;298;155;496
354625;202010;312;838;169;542;31;102;24;49;55;151
354630;202010;2062;6115;1640;5233;579;1940;288;842;867;2782
354640;202010;3256;9311;2364;7497;408;1409;877;2574;1285;3983
354650;202010;885;2300;700;1990;57;160;433;1213;490;1373
354660;202010;3715;8651;1903;5583;175;629;902;2404;1077;3033
354670;202010;1068;2982;721;2266;153;510;262;749;415;1259
354680;202010;5341;13928;3989;11688;916;2812;1964;5855;2880;8667
354690;202010;505;1609;359;1278;77;285;97;334;174;619
354700;202010;898;2407;639;1896;86;270;313;882;399;1152
354710;202010;479;1278;339;1004;42;133;136;342;178;475
354720;202010;284;687;122;366;42;137;27;81;69;218
354730;202010;9938;27873;7377;22890;1040;3544;4141;12344;5181;15888
354740;202010;324;877;132;436;18;70;24;67;42;137
354750;202010;2605;6662;1660;4865;268;855;752;1975;1020;2830
354760;202010;2108;5625;1439;4330;356;1183;465;1224;821;2407
354765;202010;385;1026;149;479;25;84;31;82;56;166
354770;202010;2386;5883;1739;4780;329;999;818;2100;1147;3099
354780;202010;55216;139713;41316;112103;4432;13628;25942;65843;30374;79471
354790;202010;960;2648;739;2274;75;259;450;1321;525;1580
354800;202010;2612;6678;2030;5777;499;1444;889;2373;1388;3817
354805;202010;1334;3051;897;2407;99;268;531;1319;630;1587
354810;202010;656;1922;372;1306;46;188;86;282;132;470
354820;202010;968;2754;685;2200;116;414;199;512;315;926
354830;202010;466;1144;295;832;52;153;102;273;154;426
354840;202010;935;2301;556;1543;52;154;318;824;370;978
354850;202010;21483;55660;14683;43261;1669;5666;8710;24250;10379;29916
354860;202010;1773;4976;1064;3443;177;636;312;906;489;1542
354870;202010;58819;148278;44979;122379;4822;14481;28125;72265;32947;86746
354880;202010;5950;14657;2851;8005;333;1077;1131;2573;1464;3650
354890;202010;16432;40932;12594;34418;1712;5286;7447;19639;9159;24925
354900;202010;406;1011;251;734;44;142;69;173;113;315
354910;202010;5561;14544;3308;10417;766;2557;564;1690;1330;4247
354920;202010;515;1397;251;857;29;104;52;168;81;272
354925;202010;300;846;177;558;21;75;46;121;67;196
354930;202010;402;944;235;661;17;55;119;307;136;362
354940;202010;2355;7036;1652;5437;570;1997;306;923;876;2920
354950;202010;1495;3842;1185;3407;60;246;881;2387;941;2633
354960;202010;919;2457;691;2105;53;191;403;1159;456;1350
354970;202010;4268;11795;3291;10103;359;1246;2123;6300;2482;7546
354980;202010;33608;79237;22316;59738;2389;7635;13624;33822;16013;41457
354990;202010;67473;169678;50061;137637;4118;13155;32783;84760;36901;97915
354995;202010;2870;6455;2142;5485;151;466;1586;3878;1737;4344
355000;202010;1593;3967;1192;3386;189;622;574;1495;763;2117
355010;202010;3855;10443;2274;7058;752;2409;250;802;1002;3211
355020;202010;3708;10363;2704;8562;583;2017;1030;3083;1613;5100
355030;202010;1405752;3438624;998809;2642856;151266;439447;500833;1218593;652099;1658040
355040;202010;2977;7360;2305;6468;314;867;1616;4552;1930;5419
355050;202010;986;2306;704;1887;175;525;267;651;442;1176
355060;202010;6130;16573;4405;13295;726;2549;2130;5817;2856;8366
355070;202010;9110;23406;7258;20394;858;2769;4616;12197;5474;14966
355080;202010;926;2624;568;1940;110;410;79;215;189;625
355090;202010;1143;3282;860;2779;219;707;270;876;489;1583
355100;202010;22562;58872;17212;50806;2807;8770;10166;29715;12973;38485
355110;202010;848;2373;605;1982;182;681;102;296;284;977
355120;202010;707;1829;499;1520;39;137;220;626;259;763
355130;202010;883;1965;420;1109;27;85;252;623;279;708
355140;202010;1939;4381;1617;3931;98;276;1328;3128;1426;3404
355150;202010;4298;11328;3379;9688;393;1254;2135;5863;2528;7117
355160;202010;2036;5544;1446;4465;367;1232;345;1009;712;2241
355170;202010;10542;26622;8147;22534;1527;4601;4341;11583;5868;16184
355180;202010;2839;7600;1992;6154;411;1396;727;2054;1138;3450
355190;202010;1876;4912;1455;4244;348;1008;762;2357;1110;3365
355200;202010;821;2530;685;2305;184;682;280;896;464;1578
355210;202010;2956;8080;2280;6665;424;1403;1161;3160;1585;4563
355220;202010;44994;119380;35003;99925;8091;24551;14408;38057;22499;62608
355230;202010;1166;2907;629;1840;112;308;225;613;337;921
355240;202010;24573;64841;16970;49466;2290;7280;9185;25206;11475;32486
355250;202010;38200;101899;27797;81436;6965;21475;10398;28983;17363;50458
355255;202010;694;1742;360;1109;60;211;138;407;198;618
355260;202010;1473;3614;1050;2891;133;450;604;1522;737;1972
355270;202010;1195;3531;905;2923;209;688;309;924;518;1612
355280;202010;31383;80033;21919;61926;3033;9300;10863;28683;13896;37983
355290;202010;890;2447;669;2032;138;406;277;805;415;1211
355300;202010;1294;3783;992;3152;179;640;343;1015;522;1655
355310;202010;976;2686;725;2268;101;309;396;1253;497;1562
355320;202010;534;1406;393;1146;77;258;155;366;232;624
355330;202010;2912;7306;2199;6089;140;505;1670;4388;1810;4893
355340;202010;4122;9103;3155;7808;405;912;1938;4895;2343;5807
355350;202010;1332;3819;979;3131;205;681;355;1113;560;1794
355360;202010;1192;3039;912;2621;120;376;544;1532;664;1908
355365;202010;362;956;187;638;40;125;30;104;70;229
355370;202010;5452;13874;4155;11809;1011;2674;1798;5627;2809;8301
355380;202010;2909;7776;2160;6358;383;1219;784;2003;1167;3222
355385;202010;1466;3849;1193;3434;114;404;751;1975;865;2379
355390;202010;839;2288;598;1750;143;450;231;610;374;1060
355395;202010;2019;5519;1377;4190;232;749;495;1339;727;2088
355400;202010;9174;26293;7188;22304;1770;6253;2542;7049;4312;13302
355410;202010;22782;62274;13971;44143;2924;10207;3630;11161;6554;21368
355420;202010;634;2026;515;1789;146;552;126;426;272;978
355430;202010;3848;9747;2843;7903;637;1752;1314;3595;1951;5347
355440;202010;803;2190;483;1507;83;273;138;402;221;675
355450;202010;3124;8065;1976;5770;356;1119;815;2147;1171;3266
355460;202010;493;1203;306;896;45;170;137;356;182;526
355465;202010;422;1111;324;947;51;165;166;463;217;628
355470;202010;1084;2789;606;1835;163;550;194;525;357;1075
355475;202010;359;847;286;741;16;35;212;538;228;573
355480;202010;3838;10603;3108;9506;407;1432;2060;6133;2467;7565
355490;202010;964;2587;525;1631;42;148;277;791;319;939
355495;202010;815;2302;589;1889;73;275;207;594;280;869
355500;202010;6703;17352;3885;11719;607;2027;1296;3598;1903;5625
355510;202010;1339;3269;826;2388;112;385;358;924;470;1309
355520;202010;373;829;169;497;30;84;50;140;80;224
355530;202010;409;946;144;428;21;72;49;129;70;201
355535;202010;506;1384;379;1171;76;293;171;472;247;765
355540;202010;10844;27067;8818;24153;1334;3994;5714;15112;7048;19106
355550;202010;614;1813;497;1595;68;247;265;793;333;1040
355560;202010;1130;2893;603;1877;136;481;33;97;169;578
355570;202010;252;724;136;451;25;84;32;102;57;186
355580;202010;1215;2968;776;2222;141;442;311;831;452;1273
355590;202010;174;440;134;373;21;64;80;212;101;276
355600;202010;1526;3698;1010;2827;179;541;394;1078;573;1619
355610;202010;1780;4367;1158;3285;135;419;620;1669;755;2088
355620;202010;4799;12735;3544;10282;406;1431;1976;5271;2382;6702
355630;202010;2326;6391;1607;5011;262;859;787;2408;1049;3267
355635;202010;886;2593;642;2109;114;417;188;546;302;963
355640;202010;3012;8438;1984;6334;387;1332;592;1817;979;3149
355645;202010;4274;12000;3095;9917;459;1613;1647;5133;2106;6746
355650;202010;6646;17902;5136;15085;1396;4257;1673;4429;3069;8686
355660;202010;1338;3481;921;2703;138;449;320;926;458;1375
355670;202010;3686;9883;2382;6949;303;1043;1177;2985;1480;4028
355680;202010;2799;7656;1197;3898;316;1079;124;423;440;1502
355690;202010;799;2356;504;1745;117;443;18;41;135;484
355695;202010;243;687;142;461;12;62;26;60;38;122
355700;202010;7350;20993;5905;17742;1000;3195;3152;8952;4152;12147
355710;202010;8933;21069;5731;15189;866;2560;2677;6315;3543;8875
355715;202010;486;1295;252;766;54;180;51;136;105;316
355720;202010;1495;4184;1165;3586;193;633;625;1791;818;2424
355730;202010;925;2573;751;2237;134;438;344;930;478;1368
410010;202010;1251;3484;937;2806;192;631;200;578;392;1209
410020;202010;1043;3153;800;2588;281;854;174;596;455;1450
410030;202010;1555;4266;1318;3894;183;591;713;2107;896;2698
410040;202010;12525;34555;9039;27920;1978;6516;2849;8169;4827;14685
410045;202010;887;2341;617;1833;88;299;219;595;307;894
410050;202010;2393;5968;1597;4557;305;949;522;1393;827;2342
410060;202010;2098;5910;1604;4904;359;1169;497;1465;856;2634
410070;202010;1953;4945;1424;3965;238;735;558;1422;796;2157
410080;202010;1375;3694;968;2930;234;743;278;848;512;1591
410090;202010;1101;2817;932;2542;94;249;550;1574;644;1823
410100;202010;1860;5386;1209;3792;174;623;157;469;331;1092
410105;202010;496;1244;280;824;33;101;93;255;126;356
410110;202010;3263;8192;2240;6219;279;834;1034;2683;1313;3517
410115;202010;597;1535;428;1240;59;188;165;453;224;641
410120;202010;2594;7338;2245;6771;496;1652;1142;3316;1638;4968
410130;202010;1245;3362;1076;3041;195;645;557;1446;752;2091
410140;202010;16509;39854;10476;28954;1922;5850;2747;6831;4669;12681
410150;202010;16972;39874;8385;22973;1423;4335;2012;4965;3435;9300
410160;202010;2867;7958;2277;6909;527;1743;766;2336;1293;4079
410165;202010;741;1964;604;1685;56;192;360;935;416;1127
410170;202010;2806;7268;1831;5170;410;1272;126;362;536;1634
410180;202010;14596;40531;11056;33221;1506;4946;5812;16302;7318;21248
410185;202010;451;1299;310;945;57;183;91;252;148;435
410190;202010;2215;5494;1573;4344;325;920;418;1104;743;2024
410200;202010;5453;12558;2985;8265;467;1477;442;1177;909;2654
410210;202010;3116;7817;1906;5586;302;1010;652;1625;954;2635
410220;202010;530;1365;337;1000;60;192;80;231;140;423
410230;202010;1725;4582;1304;3725;182;594;661;1737;843;2331
410240;202010;5067;13342;3445;10178;811;2647;339;898;1150;3545
410250;202010;2693;6385;1977;5214;160;521;958;2446;1118;2967
410260;202010;1858;4651;1137;3275;190;566;494;1397;684;1963
410270;202010;467;1235;331;995;51;172;118;339;169;511
410275;202010;670;1887;458;1442;67;229;193;562;260;791
410280;202010;2323;6200;1506;4542;227;756;592;1653;819;2409
410290;202010;3318;9286;2232;6943;608;1872;578;1783;1186;3655
410300;202010;660;1680;520;1446;46;142;265;694;311;836
410302;202010;380;943;201;603;25;84;98;285;123;369
410304;202010;1267;3273;1053;2877;116;315;626;1663;742;1978
410305;202010;1786;4234;1206;3386;131;416;750;2018;881;2434
410310;202010;2583;7253;2037;6183;335;1112;969;2903;1304;4015
410315;202010;695;1644;374;1122;130;386;87;271;217;657
410320;202010;1066;2950;715;2226;116;405;123;358;239;763
410322;202010;591;1542;324;948;33;112;169;449;202;561
410330;202010;1531;3737;1043;2810;178;520;297;787;475;1307
410335;202010;857;2310;652;1921;93;296;289;799;382;1095
410337;202010;856;2070;595;1560;68;181;249;618;317;799
410340;202010;510;1436;336;1006;26;84;167;425;193;509
410345;202010;2492;6454;1264;3738;259;798;339;874;598;1672
410347;202010;762;1940;551;1541;51;164;182;518;233;682
410350;202010;1483;3722;1039;2950;147;432;431;1161;578;1593
410360;202010;4391;10696;3352;8883;422;1233;1754;4442;2176;5675
410370;202010;13615;36571;8742;24954;1035;3242;3701;9329;4736;12571
410380;202010;1611;4067;1184;3289;166;469;396;1009;562;1478
410390;202010;2666;6761;1745;5067;392;1268;538;1419;930;2687
410395;202010;925;2631;749;2259;153;485;292;883;445;1368
410400;202010;6606;17294;4884;13897;695;2112;2429;6498;3124;8610
410405;202010;866;2078;625;1719;110;341;280;721;390;1062
410410;202010;1273;3402;1188;3265;168;540;741;2110;909;2650
410420;202010;10567;28915;7994;23765;1263;4240;3250;8627;4513;12867
410425;202010;3265;9119;2196;6867;361;1224;790;2221;1151;3445
410430;202010;13298;33260;9177;25633;1428;4345;3266;8481;4694;12826
410440;202010;2302;6874;1958;6224;291;1040;1025;3197;1316;4237
410442;202010;2251;6819;1839;5927;487;1603;514;1556;1001;3159
410445;202010;2299;6650;1662;5379;320;1193;340;1153;660;2346
410450;202010;1459;3640;1067;2996;203;633;387;1012;590;1645
410460;202010;2045;5054;1554;4257;168;475;766;2017;934;2492
410465;202010;2712;7819;2114;6664;397;1309;744;2183;1141;3492
410470;202010;2040;5645;1416;4474;359;1306;220;742;579;2048
410480;202010;37393;88718;19564;56783;3111;10084;4247;10585;7358;20669
410490;202010;11256;31190;7977;24317;1460;4835;3154;8993;4614;13828
410500;202010;1887;4922;1310;3789;273;899;384;976;657;1875
410510;202010;1862;4607;1212;3386;236;650;339;942;575;1592
410520;202010;3050;9581;2690;8842;920;3102;922;3119;1842;6221
410530;202010;1683;4127;786;2239;100;287;199;457;299;744
410540;202010;2838;7616;1946;5792;294;955;882;2507;1176;3462
410550;202010;7469;19976;4855;14145;822;2604;1347;3391;2169;5995
410560;202010;1492;3927;1096;3092;241;745;376;938;617;1683
410570;202010;2506;6882;1815;5634;491;1810;203;661;694;2471
410580;202010;25713;66749;18451;53321;3530;10964;7833;21110;11363;32074
410590;202010;1532;4360;1007;3100;146;472;283;737;429;1209
410600;202010;1832;4833;1393;3989;314;862;450;1342;764;2204
410610;202010;724;1894;535;1537;59;202;235;630;294;832
410620;202010;2423;6967;1604;5023;341;1180;253;723;594;1903
410630;202010;2507;6595;1621;4765;302;1013;335;829;637;1842
410640;202010;4744;11076;3176;8329;694;2122;400;1049;1094;3171
410645;202010;1059;2991;858;2723;269;889;368;1180;637;2069
410650;202010;2286;6185;1555;4679;316;1018;531;1474;847;2492
410655;202010;923;2197;643;1701;27;84;331;827;358;911
410657;202010;660;1767;403;1202;54;187;142;361;196;548
410660;202010;3473;8884;1945;5543;344;1014;522;1380;866;2394
410670;202010;1058;2626;627;1781;123;361;223;568;346;929
410680;202010;2618;7863;1824;5836;435;1428;309;1009;744;2437
410685;202010;541;1371;396;1117;92;305;155;383;247;688
410690;202010;133412;324632;87481;238862;13679;42699;33796;81025;47475;123724
410700;202010;2530;6378;2085;5673;322;895;1038;2746;1360;3641
410710;202010;880;2218;574;1638;101;297;224;586;325;883
410712;202010;655;1878;536;1646;133;449;202;589;335;1038
410715;202010;813;2352;491;1620;73;248;170;532;243;780
410720;202010;3150;8038;2451;6675;331;1064;531;1406;862;2470
410725;202010;1109;2735;622;1813;115;372;89;214;204;586
410730;202010;676;1783;512;1484;118;387;101;287;219;674
410740;202010;929;2595;673;2093;91;312;267;814;358;1126
410750;202010;1765;4465;1388;3756;197;607;632;1627;829;2234
410752;202010;381;965;190;570;28;83;86;244;114;327
410753;202010;307;934;206;701;36;143;38;115;74;258
410754;202010;1114;2850;916;2549;57;125;626;1846;683;1971
410755;202010;588;1523;404;1151;59;182;176;441;235;623
410760;202010;3634;9312;2589;7403;668;2190;578;1495;1246;3685
410765;202010;13772;38318;10584;31936;1785;5839;2324;6187;4109;12026
410770;202010;1070;2538;745;1993;68;191;374;1007;442;1198
410773;202010;1275;3410;1113;3163;112;358;698;1909;810;2267
410775;202010;1499;3728;1299;3427;66;203;861;2212;927;2415
410780;202010;635;1570;413;1136;66;194;109;278;175;472
410785;202010;727;1900;557;1609;93;297;195;573;288;870
410790;202010;799;2254;641;1943;167;557;64;139;231;696
410800;202010;3442;7576;2768;6599;53;167;1801;4172;1854;4339
410810;202010;429;1151;334;961;24;74;173;449;197;523
410820;202010;896;2517;458;1414;91;294;85;220;176;514
410830;202010;37135;90005;25404;70167;4974;15860;9469;24210;14443;40070
410832;202010;1032;2685;820;2304;88;273;488;1292;576;1565
410840;202010;8389;21309;4919;14595;937;3013;1235;3418;2172;6431
410845;202010;1173;2907;912;2513;182;522;371;1010;553;1532
410850;202010;2244;6459;1944;5892;317;1036;953;2798;1270;3834
410855;202010;781;1952;507;1427;46;123;242;635;288;758
410860;202010;4357;10696;3390;9113;342;1073;1900;4815;2242;5888
410865;202010;1436;4168;1235;3763;146;493;724;2243;870;2736
410870;202010;1274;3436;1042;3032;83;263;701;2023;784;2286
410880;202010;4637;12379;3235;9763;542;1703;468;1532;1010;3235
410890;202010;977;2784;712;2249;158;551;180;555;338;1106
410895;202010;1006;3198;851;2854;252;939;187;581;439;1520
410900;202010;877;2299;597;1747;105;329;118;280;223;609
410910;202010;398;949;235;637;14;50;135;323;149;373
410920;202010;871;2076;602;1631;75;226;303;793;378;1019
410930;202010;1687;4327;1156;3386;272;940;229;640;501;1580
410940;202010;22721;61999;16198;50017;3328;11394;4951;14953;8279;26347
410950;202010;1916;5597;1696;5255;52;199;1400;4281;1452;4480
410960;202010;7691;19110;5180;14811;1196;3769;1956;5534;3152;9303
410965;202010;1139;2877;777;2187;88;270;437;1208;525;1478
410970;202010;4038;10817;2806;8420;633;2275;371;918;1004;3193
410975;202010;1360;3374;1028;2836;116;350;502;1362;618;1712
410980;202010;7505;18748;4787;13767;538;1717;2090;5451;2628;7168
410990;202010;1434;3496;953;2739;226;752;314;865;540;1617
411000;202010;643;1694;422;1266;57;202;126;314;183;516
411005;202010;466;1196;278;790;48;153;84;210;132;363
411007;202010;2290;6381;1855;5626;431;1389;652;1955;1083;3344
411010;202010;4228;12684;3311;10776;832;2951;354;1036;1186;3987
411020;202010;2317;6539;1855;5692;537;1707;501;1502;1038;3209
411030;202010;772;1895;541;1426;35;127;308;709;343;836
411040;202010;1000;2494;510;1415;68;214;166;387;234;601
411050;202010;1914;5953;1547;5130;395;1410;227;659;622;2069
411060;202010;1920;5017;1210;3607;267;927;198;528;465;1455
411065;202010;386;998;260;753;36;110;115;309;151;419
411070;202010;7281;18494;5699;15801;774;2391;2792;7462;3566;9853
411080;202010;2104;5549;1645;4733;415;1374;324;904;739;2278
411090;202010;853;2239;551;1650;49;177;156;441;205;618
411095;202010;2788;6420;1428;3880;168;476;356;873;524;1349
411100;202010;1202;3078;831;2411;88;289;273;810;361;1099
411110;202010;636;1642;287;897;38;121;18;38;56;159
411120;202010;1299;3582;1071;3144;323;1101;227;605;550;1706
411125;202010;5261;15281;4646;14105;1013;3019;2212;7064;3225;10083
411130;202010;717;1920;506;1523;103;278;177;575;280;853
411140;202010;2269;7012;1915;6243;564;1977;489;1560;1053;3537
411150;202010;3894;9919;2597;7278;514;1689;254;513;768;2202
411155;202010;958;2441;552;1673;80;225;230;666;310;891
411160;202010;360;829;235;655;31;98;53;149;84;247
411170;202010;739;2190;559;1772;136;431;185;565;321;996
411180;202010;5553;14616;4267;12325;622;2015;2063;5567;2685;7582
411190;202010;1712;4380;1264;3566;213;640;485;1226;698;1866
411200;202010;4955;13413;3423;10486;851;2900;674;1769;1525;4669
411210;202010;3217;7159;2095;5303;357;1010;694;1649;1051;2659
411220;202010;869;2239;605;1720;146;456;163;438;309;894
411230;202010;886;2335;629;1840;124;390;236;668;360;1058
411240;202010;1592;3815;1043;2807;111;343;506;1246;617;1589
411250;202010;2234;5919;1619;4795;314;1061;507;1448;821;2509
411260;202010;346;907;224;654;28;84;87;223;115;307
411270;202010;2074;5509;1524;4392;207;634;769;2022;976;2656
411275;202010;1463;3355;1002;2594;143;449;459;1093;602;1542
411280;202010;1330;3600;872;2702;229;728;125;364;354;1092
411290;202010;821;2154;524;1566;52;142;271;835;323;977
411295;202010;1236;3102;871;2373;104;303;379;965;483;1268
411300;202010;1047;2615;651;1839;63;194;303;743;366;937
411310;202010;893;2049;667;1724;52;131;295;749;347;880
411320;202010;5535;14311;3992;11491;675;2088;1697;4363;2372;6451
411325;202010;1379;3965;1169;3600;193;589;656;2090;849;2679
411330;202010;3382;9140;2427;7366;542;1785;753;2301;1295;4086
411340;202010;853;2312;498;1519;76;246;159;458;235;704
411342;202010;1050;2534;610;1674;100;296;233;598;333;894
411345;202010;1082;2794;812;2343;60;191;581;1687;641;1878
411350;202010;2760;7461;1769;5421;450;1490;267;748;717;2238
411360;202010;703;1696;492;1356;71;196;157;418;228;614
411370;202010;57949;141559;41498;113363;3011;9952;24966;63511;27977;73463
411373;202010;1391;3535;1126;3136;99;335;603;1693;702;2028
411375;202010;1103;2776;797;2192;128;369;314;830;442;1199
411380;202010;1172;2674;772;1935;43;123;481;1117;524;1240
411390;202010;1522;4206;1183;3471;194;622;484;1252;678;1874
411400;202010;2313;5727;1725;4609;170;540;878;2228;1048;2768
411410;202010;2584;7143;1879;5594;410;1335;432;1220;842;2555
411420;202010;4293;10522;2302;6653;323;1073;428;935;751;2008
411430;202010;3492;9444;2621;7786;546;1755;919;2510;1465;4265
411435;202010;415;1167;255;818;52;164;77;202;129;366
411440;202010;2544;7071;2047;6125;419;1356;717;2080;1136;3436
411450;202010;2500;6712;1891;5683;253;759;993;3040;1246;3799
411460;202010;4239;10896;2624;7795;428;1521;483;1274;911;2795
411470;202010;775;1985;565;1571;106;320;212;526;318;846
411480;202010;4993;13215;3625;10639;703;2475;1323;3435;2026;5910
411490;202010;1628;4208;1238;3555;155;517;521;1340;676;1857
411500;202010;1325;3552;870;2571;158;504;171;411;329;915
411510;202010;2330;5932;1850;5096;397;1270;444;1229;841;2499
411520;202010;30864;75042;17509;48893;2015;6545;6691;16726;8706;23271
411530;202010;935;2462;556;1713;87;297;96;267;183;564
411535;202010;496;1433;301;963;33;115;87;228;120;343
411540;202010;2751;6721;1845;5063;171;550;933;2465;1104;3015
411545;202010;922;2635;760;2344;75;235;491;1523;566;1758
411550;202010;719;1807;507;1407;77;232;86;259;163;491
411560;202010;1977;5320;1103;3427;159;543;74;208;233;751
411570;202010;7636;17596;5080;13671;1130;3305;922;2468;2052;5773
411573;202010;762;2053;641;1861;100;301;323;919;423;1220
411575;202010;2014;5470;1478;4357;280;910;359;1032;639;1942
411580;202010;4777;10957;2859;7983;417;1432;510;1279;927;2711
411585;202010;638;1912;277;901;64;229;50;138;114;367
411590;202010;400;1105;277;837;42;123;135;381;177;504
411600;202010;305;778;193;599;39;123;56;162;95;285
411605;202010;1600;3703;1006;2738;134;468;517;1364;651;1832
411610;202010;2587;6127;1804;4722;72;238;1199;2914;1271;3152
411620;202010;2846;7548;2400;6838;400;1215;1303;3695;1703;4910
411630;202010;770;2023;508;1509;78;283;186;492;264;775
411640;202010;469;1223;325;914;40;125;115;290;155;415
411650;202010;207;606;132;435;24;87;30;75;54;162
411660;202010;929;2358;670;1883;53;151;286;775;339;926
411670;202010;1382;3363;929;2474;101;287;440;1085;541;1372
411680;202010;1452;3869;1062;3097;139;460;466;1299;605;1759
411690;202010;3849;9785;2879;8079;626;1793;816;2426;1442;4219
411695;202010;669;2048;426;1381;49;173;180;542;229;715
411700;202010;1717;4415;1111;3254;233;731;181;492;414;1223
411705;202010;1927;5901;1615;5358;293;933;947;3344;1240;4277
411710;202010;1981;5013;1347;3835;297;866;258;720;555;1586
411720;202010;1072;2478;760;1931;155;406;282;683;437;1089
411721;202010;996;2522;736;2030;144;386;198;551;342;937
411722;202010;863;2263;485;1392;77;254;191;455;268;709
411725;202010;1192;3299;801;2524;191;648;172;537;363;1185
411727;202010;1529;4206;973;2991;223;721;168;472;391;1193
411729;202010;708;1707;441;1196;53;196;166;388;219;584
411730;202010;5303;14049;4080;11628;838;2548;1735;4862;2573;7410
411740;202010;537;1385;269;809;54;148;58;156;112;304
411745;202010;781;2211;517;1607;72;241;89;213;161;454
411750;202010;5490;14395;3977;11423;537;1661;1939;5229;2476;6890
411760;202010;6719;17937;5110;15108;1676;5154;980;3226;2656;8380
411770;202010;3075;8860;2212;6942;526;1768;337;977;863;2745
411780;202010;2795;7835;2371;7032;653;2023;792;2373;1445;4396
411790;202010;2856;6903;1528;4492;316;1075;264;669;580;1744
411800;202010;1031;2912;754;2283;133;417;153;437;286;854
411810;202010;1616;4163;1186;3289;201;573;555;1448;756;2021
411820;202010;11221;32157;9003;28200;2205;7408;3780;11539;5985;18947
411830;202010;584;1439;438;1195;83;246;98;284;181;530
411840;202010;12203;32429;8131;23906;1389;4403;2159;5812;3548;10215
411845;202010;564;1623;309;999;42;160;67;186;109;346
411850;202010;7332;18731;4913;14421;1214;4045;795;2129;2009;6174
411860;202010;692;1938;493;1517;75;240;122;342;197;582
411870;202010;592;1724;406;1297;92;327;96;274;188;601
411880;202010;2280;5681;1649;4649;226;727;575;1551;801;2278
411885;202010;1086;2793;770;2220;113;383;241;634;354;1017
411890;202010;1382;3677;970;2900;161;539;104;294;265;833
411900;202010;824;2262;501;1560;115;395;80;217;195;612
411910;202010;991;2920;716;2337;176;653;266;794;442;1447
411915;202010;15641;38216;10335;28534;1483;4619;4164;10256;5647;14875
411920;202010;1106;3255;919;2845;200;718;331;946;531;1664
411925;202010;468;1233;330;981;71;238;129;362;200;600
411930;202010;4992;15261;4175;13700;1796;6396;272;1071;2068;7467
411940;202010;3313;9801;2529;8048;622;2044;790;2266;1412;4310
411950;202010;14283;38385;11657;33999;1596;5298;6834;19025;8430;24323
411960;202010;5923;15876;4648;13255;852;2701;1764;4750;2616;7451
411965;202010;469;1294;332;1017;48;161;146;414;194;575
411970;202010;1109;2563;853;2220;168;415;364;1078;532;1493
411980;202010;1488;3701;1066;2997;261;736;386;1058;647;1794
411990;202010;38820;101472;24337;74498;4495;15175;8324;24321;12819;39496
411995;202010;3467;8487;2610;7156;766;2346;707;1839;1473;4185
412000;202010;1919;4414;1338;3418;33;106;946;2254;979;2360
412010;202010;602;1871;439;1509;71;265;125;363;196;628
412015;202010;550;1534;445;1347;60;196;264;791;324;987
412020;202010;449;1239;276;858;41;149;107;302;148;451
412030;202010;615;1721;444;1399;75;242;127;384;202;626
412033;202010;931;2455;655;1891;81;238;244;615;325;853
412035;202010;762;2068;483;1550;50;199;263;797;313;996
412040;202010;594;1587;367;1126;57;163;63;190;120;353
412050;202010;1645;4094;1105;3082;222;703;268;740;490;1443
412060;202010;7412;21555;6137;18977;1606;5619;1720;5088;3326;10707
412065;202010;622;1703;453;1357;104;333;108;324;212;657
412070;202010;1188;3061;927;2541;115;338;383;976;498;1314
412080;202010;2193;6146;1449;4587;210;695;341;960;551;1655
412085;202010;314;758;106;328;11;35;19;48;30;83
412090;202010;5763;15062;4246;12186;1106;3312;1499;4373;2605;7685
412100;202010;1620;4413;1217;3657;365;1199;254;836;619;2035
412110;202010;839;2191;567;1640;80;234;185;502;265;736
412120;202010;1999;5769;1524;4821;299;1049;411;1109;710;2158
412125;202010;649;1832;453;1424;89;288;123;366;212;654
412130;202010;813;2063;551;1561;91;273;141;409;232;682
412135;202010;623;1664;284;862;42;134;98;262;140;396
412140;202010;1714;4172;1128;3141;202;694;227;588;429;1282
412150;202010;2811;7345;2370;6562;344;1102;1445;3744;1789;4846
412160;202010;939;2907;518;1762;88;322;85;256;173;578
412170;202010;4365;11956;3630;10758;742;2412;1475;4033;2217;6445
412175;202010;1326;3762;1097;3364;225;703;481;1491;706;2194
412180;202010;1660;4572;1194;3692;146;522;540;1541;686;2063
412190;202010;3367;8406;2468;6820;329;989;1071;2942;1400;3931
412200;202010;1724;5139;1225;3967;317;1133;198;589;515;1722
412210;202010;636;1519;375;1040;50;155;141;346;191;501
412215;202010;3325;9007;2594;7564;644;1831;1099;3532;1743;5363
412217;202010;982;2542;827;2265;54;159;554;1467;608;1626
412220;202010;5604;15653;4510;13596;1308;3826;1417;4603;2725;8429
412230;202010;2683;7889;2114;6757;349;1259;559;1539;908;2798
412240;202010;7344;18790;4570;13295;784;2470;1374;3608;2158;6078
412250;202010;2036;5239;1506;4223;352;1026;324;843;676;1869
412260;202010;1236;3297;885;2534;147;434;268;714;415;1148
412265;202010;895;2437;703;2104;151;473;282;800;433;1273
412270;202010;1002;2741;636;1961;81;280;246;674;327;954
412280;202010;405;1134;312;975;63;209;94;271;157;480
412290;202010;1042;2650;705;2038;112;350;222;588;334;938
412300;202010;1683;4362;1160;3420;254;785;257;781;511;1566
412310;202010;763;2111;603;1786;95;333;219;595;314;928
412320;202010;828;2129;530;1514;51;167;170;493;221;660
412330;202010;1576;4236;1049;3204;197;665;346;1086;543;1751
412340;202010;1144;3198;704;2213;102;376;123;349;225;725
412350;202010;2849;7384;1784;5267;356;1114;309;831;665;1945
412360;202010;275;756;186;556;5;26;112;309;117;335
412370;202010;889;2521;595;1886;116;414;56;190;172;604
412380;202010;1534;4176;1070;3218;286;891;133;461;419;1352
412382;202010;512;1264;334;970;43;158;142;343;185;501
412385;202010;2228;6055;1811;5239;571;1563;560;1819;1131;3382
412390;202010;2473;5950;1975;5173;313;831;740;1942;1053;2773
412395;202010;681;1944;471;1458;58;159;199;633;257;792
412400;202010;930;2482;654;1941;128;417;179;529;307;946
412402;202010;2066;5089;1404;3970;339;989;182;526;521;1515
412405;202010;3058;8072;1984;6015;507;1817;84;226;591;2043
412410;202010;6107;15734;4459;13012;786;2648;1472;4048;2258;6696
412420;202010;538;1370;349;990;25;87;173;429;198;516
412430;202010;596;1492;310;894;34;114;121;324;155;438
412440;202010;2740;7438;1791;5556;434;1474;276;893;710;2367
412450;202010;451;1302;298;908;47;137;26;59;73;196
412460;202010;1022;2675;796;2286;146;453;365;1036;511;1489
412470;202010;1473;4734;1199;4098;302;1079;262;891;564;1970
412480;202010;1077;2850;702;2021;121;372;214;543;335;915
412490;202010;1305;3253;1036;2759;125;334;516;1290;641;1624
412500;202010;1943;4875;1449;3954;316;869;400;1016;716;1885
412510;202010;1951;5957;1323;4333;298;1045;138;372;436;1417
412520;202010;1242;3272;666;1994;153;436;59;192;212;628
412530;202010;714;1890;521;1487;80;248;108;311;188;559
412535;202010;796;2062;530;1544;89;282;114;277;203;559
412540;202010;1212;3075;862;2429;97;344;278;820;375;1164
412545;202010;685;1756;472;1312;71;201;171;464;242;665
412550;202010;33333;88768;23200;68162;3843;12305;9271;24770;13114;37075
412555;202010;298;786;198;563;22;62;57;126;79;188
412560;202010;4656;13636;3396;10637;579;1983;991;3104;1570;5087
412570;202010;4534;11380;2557;7530;533;1778;312;995;845;2773
412575;202010;1032;2593;819;2221;105;315;439;1105;544;1420
412580;202010;1440;3782;1012;2946;91;323;530;1474;621;1797
412590;202010;419;1093;226;702;33;108;22;57;55;165
412600;202010;1612;4351;1205;3517;177;589;541;1464;718;2053
412610;202010;822;2145;575;1602;61;172;292;724;353;896
412620;202010;1275;3328;962;2844;191;643;274;754;465;1397
412625;202010;8948;23669;5353;16360;744;2583;348;954;1092;3537
412627;202010;1159;3242;735;2351;132;461;196;624;328;1085
412630;202010;2865;8375;2023;6517;386;1256;604;1779;990;3035
412635;202010;392;1074;266;789;35;126;95;233;130;359
412640;202010;1040;2745;578;1755;72;224;177;489;249;713
412650;202010;1688;4612;1344;3890;217;696;528;1337;745;2033
412660;202010;2424;6194;1681;4762;277;836;497;1260;774;2096
412665;202010;398;1011;312;852;50;145;152;402;202;547
412667;202010;1732;4580;1284;3707;178;553;526;1452;704;2005
412670;202010;845;2003;561;1538;102;312;167;425;269;737
412680;202010;1968;5247;1346;4032;172;589;491;1314;663;1903
412690;202010;1110;2946;807;2344;135;422;311;852;446;1274
412700;202010;1974;5235;1621;4675;193;649;887;2476;1080;3125
412710;202010;6012;17477;4466;14079;873;3104;1281;3563;2154;6667
412720;202010;1171;3457;893;2833;145;488;173;467;318;955
412730;202010;2454;6484;1651;4852;316;1038;572;1576;888;2614
412740;202010;1915;5310;1288;4001;221;806;183;544;404;1350
412750;202010;3866;10174;3160;9143;304;1061;2075;5644;2379;6705
412760;202010;2926;7950;2422;7082;440;1452;1279;3509;1719;4961
412770;202010;10309;26040;5387;16206;748;2378;1269;3257;2017;5635
412780;202010;1188;3148;874;2560;189;601;335;956;524;1557
412785;202010;2080;5004;1449;3914;147;406;947;2499;1094;2905
412788;202010;1337;3734;1090;3297;293;889;459;1358;752;2247
412790;202010;1344;3542;748;2299;116;415;227;607;343;1022
412795;202010;1300;3355;678;2077;95;317;131;360;226;677
412796;202010;2213;6368;1807;5571;377;1220;587;1682;964;2902
412800;202010;3703;8983;2521;6787;292;909;1167;2767;1459;3676
412810;202010;11852;30028;7488;21117;892;2949;2916;7289;3808;10238
412820;202010;6436;17578;4476;13600;1073;3448;1287;3897;2360;7345
412830;202010;359;1008;246;762;35;103;58;171;93;274
412840;202010;1867;4658;1308;3559;149;453;576;1419;725;1872
412850;202010;2835;7437;2028;5999;329;1044;843;2452;1172;3496
412853;202010;1529;3854;1261;3373;180;529;642;1532;822;2061
412855;202010;1239;3283;789;2323;133;461;226;621;359;1082
412860;202010;792;1941;538;1537;75;236;289;785;364;1021
412862;202010;706;1720;471;1321;89;252;194;517;283;769
412863;202010;1264;3777;1122;3513;230;749;605;1873;835;2622
412865;202010;724;1970;525;1561;139;426;139;433;278;859
412870;202010;856;2202;619;1807;167;554;125;392;292;946
412880;202010;852;2292;558;1678;92;326;97;254;189;580
420005;202010;417;1229;244;837;36;129;109;377;145;506
420010;202010;3302;8014;2188;6140;138;434;1600;4515;1738;4949
420020;202010;433;1364;282;974;44;179;62;175;106;354
420030;202010;73;244;52;200;16;71;18;61;34;132
420040;202010;531;1590;307;1089;60;237;19;50;79;287
420050;202010;741;1699;488;1241;75;223;301;687;376;910
420055;202010;160;485;87;306;18;83;25;73;43;156
420060;202010;102;274;57;169;11;34;14;32;25;66
420070;202010;692;2095;513;1713;106;368;204;657;310;1025
420075;202010;81;200;42;122;6;21;17;33;23;54
420080;202010;354;1017;278;844;75;249;107;319;182;568
420090;202010;429;1323;254;892;52;196;45;129;97;325
420100;202010;1234;3227;1021;2900;52;176;823;2305;875;2481
420110;202010;244;787;222;741;45;174;104;322;149;496
420120;202010;556;1500;367;1087;66;223;173;435;239;658
420125;202010;349;1075;244;835;61;223;97;316;158;539
420127;202010;277;742;101;326;14;51;27;83;41;134
420130;202010;3238;8926;2443;7544;365;1359;1178;3313;1543;4672
420140;202010;3491;9425;2453;7593;690;2421;334;1047;1024;3468
420150;202010;673;1701;463;1340;46;152;274;769;320;921
420160;202010;203;494;79;249;10;30;22;67;32;97
420165;202010;158;450;88;287;20;68;27;78;47;146
420170;202010;278;856;186;628;23;76;55;157;78;233
420180;202010;178;549;106;371;12;41;33;102;45;143
420190;202010;201;632;124;431;38;148;33;108;71;256
420195;202010;1412;3613;1016;2969;305;1056;114;244;419;1300
420200;202010;4446;10822;2633;7390;357;1231;1066;2577;1423;3808
420205;202010;1718;4605;1153;3489;165;527;637;1922;802;2449
420207;202010;1711;4457;1039;3180;196;694;420;1184;616;1878
420208;202010;319;898;185;647;58;221;47;154;105;375
420209;202010;159;519;96;318;19;67;34;106;53;173
420210;202010;3050;7792;2012;6088;345;1184;985;2883;1330;4067
420213;202010;760;2351;635;2090;141;504;316;1019;457;1523
420215;202010;187;565;127;428;31;114;26;81;57;195
420220;202010;260;753;155;521;24;98;74;226;98;324
420230;202010;4981;13508;3736;11136;561;1811;1969;5643;2530;7454
420240;202010;13535;37184;8471;25596;1084;3740;4172;11028;5256;14768
420243;202010;367;1047;287;883;46;164;172;503;218;667
420245;202010;1255;3227;884;2592;61;218;545;1524;606;1742
420250;202010;428;1187;350;1051;53;181;198;552;251;733
420253;202010;481;1181;338;973;34;116;193;549;227;665
420257;202010;163;420;103;312;18;68;52;156;70;224
420260;202010;1068;2811;773;2394;128;457;482;1457;610;1914
420270;202010;518;1350;253;735;34;111;117;330;151;441
420280;202010;1143;3426;868;2850;155;573;305;968;460;1541
420285;202010;118;243;48;139;11;45;11;23;22;68
420287;202010;431;1002;305;826;84;231;113;307;197;538
420290;202010;4662;13216;3551;10692;475;1663;2086;5773;2561;7436
420300;202010;7194;20111;4119;12933;750;2646;1257;3429;2007;6075
420310;202010;787;1811;389;1075;37;121;215;548;252;669
420315;202010;770;2167;528;1735;112;390;213;700;325;1090
420320;202010;5018;13652;3586;11200;1003;3462;923;2669;1926;6131
420325;202010;294;832;203;647;30;97;97;286;127;383
420330;202010;966;2808;610;2046;110;436;181;526;291;962
420340;202010;951;2630;704;2180;162;526;109;295;271;821
420350;202010;1143;3018;829;2444;70;236;576;1666;646;1902
420360;202010;2818;7725;1509;4864;288;1007;129;419;417;1426
420370;202010;1090;2918;886;2586;82;275;610;1717;692;1992
420380;202010;4342;11392;2844;8670;599;1944;1069;3110;1668;5054
420390;202010;1070;2571;732;1889;127;394;301;528;428;922
420395;202010;1078;3030;729;2329;113;423;100;228;213;651
420400;202010;987;2784;673;2105;120;436;257;745;377;1181
420410;202010;550;1489;420;1214;43;130;286;811;329;941
420415;202010;286;835;218;686;56;201;79;247;135;448
420417;202010;603;1788;472;1505;127;410;166;548;293;958
420419;202010;142;501;109;421;37;149;9;38;46;187
420420;202010;10955;28271;7196;21385;2009;6787;1976;5299;3985;12086
420425;202010;644;1715;423;1267;40;138;206;594;246;732
420430;202010;3141;8421;1827;5530;428;1339;592;1657;1020;2996
420435;202010;247;631;117;378;15;51;57;175;72;226
420440;202010;731;1989;444;1366;116;397;170;483;286;880
420445;202010;268;643;171;469;30;83;80;202;110;285
420450;202010;696;2031;505;1616;92;353;179;498;271;851
420455;202010;1972;4829;1400;3948;193;633;673;1772;866;2405
420460;202010;9097;24210;6671;19673;970;3187;3421;9661;4391;12848
420470;202010;604;1581;319;1010;59;219;64;172;123;391
420475;202010;76;195;29;92;10;30;3;11;13;41
420480;202010;5358;13176;3211;9570;650;2127;1075;3182;1725;5309
420490;202010;348;963;250;765;52;179;99;292;151;471
420500;202010;1386;3836;874;2850;154;551;376;1226;530;1777
420510;202010;157;440;86;273;10;42;24;66;34;108
420515;202010;64;167;37;107;4;19;17;42;21;61
420517;202010;756;2084;648;1883;53;163;466;1355;519;1518
420519;202010;292;710;212;594;25;76;122;354;147;430
420520;202010;302;816;149;506;26;91;9;32;35;123
420530;202010;812;2344;550;1786;88;338;211;586;299;924
420535;202010;237;698;96;330;13;51;46;151;59;202
420540;202010;35828;85149;22589;62693;3340;10547;7932;18849;11272;29396
420543;202010;206;623;159;511;19;66;84;250;103;316
420545;202010;1119;3320;836;2696;151;540;322;928;473;1468
420550;202010;3430;9081;2140;6883;348;1298;874;2857;1222;4155
420555;202010;294;841;198;635;25;95;114;343;139;438
420560;202010;396;971;260;770;54;174;147;428;201;602
420570;202010;2229;6097;1738;5166;304;1037;767;2160;1071;3197
420580;202010;1841;4692;1306;3871;295;945;439;1342;734;2287
420590;202010;2766;7348;1587;4786;293;1069;425;968;718;2037
420600;202010;1011;2931;763;2449;100;378;438;1342;538;1720
420610;202010;351;1013;193;647;45;158;66;231;111;389
420620;202010;737;1805;484;1385;106;320;194;547;300;867
420630;202010;891;2670;641;2056;82;294;381;1150;463;1444
420640;202010;482;1299;225;766;71;240;25;85;96;325
420650;202010;3497;9170;2082;6188;298;970;807;2067;1105;3037
420660;202010;432;1111;274;781;50;151;75;192;125;343
420665;202010;596;1538;377;1156;67;239;167;447;234;686
420670;202010;1286;3538;817;2577;141;541;304;842;445;1383
420675;202010;167;469;94;319;16;74;44;130;60;204
420680;202010;320;743;160;516;30;109;82;251;112;360
420690;202010;871;2561;516;1713;70;284;140;387;210;671
420700;202010;2537;6631;1872;5502;231;744;1055;2996;1286;3740
420710;202010;907;2614;687;2140;65;261;415;1174;480;1435
420720;202010;1209;3348;855;2718;170;572;410;1238;580;1810
420730;202010;3013;7807;2209;6467;356;1149;1178;3311;1534;4460
420740;202010;518;1556;303;1069;87;332;25;106;112;438
420750;202010;1920;5573;1243;3982;213;801;503;1463;716;2264
420757;202010;80;194;40;126;4;8;18;54;22;62
420760;202010;348;1029;168;527;38;132;45;120;83;252
420765;202010;452;1312;196;676;28;113;77;253;105;366
420768;202010;1332;3727;1140;3402;149;446;827;2456;976;2902
420770;202010;450;1210;219;739;39;150;89;275;128;425
420775;202010;274;825;186;618;36;130;54;151;90;281
420780;202010;916;2536;552;1727;114;392;99;267;213;659
420785;202010;193;506;133;375;13;45;68;159;81;204
420790;202010;1003;3029;733;2474;122;483;395;1250;517;1733
420800;202010;655;1643;309;937;84;288;78;219;162;507
420810;202010;1396;4322;1124;3773;316;1210;376;1084;692;2294
420820;202010;11842;29471;8417;23833;1580;5050;3897;10106;5477;15156
420830;202010;3970;10379;2918;8433;527;1652;1261;3536;1788;5188
420840;202010;471;1370;222;801;61;239;27;86;88;325
420845;202010;2377;6028;1427;4300;266;976;577;1631;843;2607
420850;202010;1052;3379;644;2305;125;487;119;376;244;863
420860;202010;306;778;166;532;30;108;47;130;77;238
420870;202010;779;2151;576;1767;147;524;243;677;390;1201
420880;202010;1015;3112;780;2609;159;619;297;913;456;1532
420890;202010;7839;21110;4788;14797;699;2416;1717;4681;2416;7097
420895;202010;165;480;105;325;27;80;33;107;60;187
420900;202010;1495;3667;894;2601;120;422;421;1061;541;1483
420910;202010;29070;76454;17920;54714;2712;9404;7130;19330;9842;28734
420915;202010;520;1868;376;1451;55;212;200;792;255;1004
420917;202010;352;863;181;498;29;85;90;245;119;330
420920;202010;79;213;30;108;1;2;6;24;7;26
420930;202010;16001;41779;11131;33133;2045;6772;4852;13693;6897;20465
420940;202010;2898;7091;1679;4966;408;1384;328;798;736;2182
420945;202010;133;375;104;312;24;83;42;115;66;198
420950;202010;338;975;181;598;27;111;46;137;73;248
420960;202010;1004;2455;712;1954;124;407;315;754;439;1161
420970;202010;2366;6496;1656;5152;473;1540;447;1371;920;2911
420980;202010;268;888;231;810;113;402;61;224;174;626
420985;202010;302;868;145;517;36;141;45;141;81;282
420990;202010;306;950;167;600;28;102;35;117;63;219
421000;202010;533;1600;375;1245;79;279;101;301;180;580
421003;202010;471;1119;158;465;8;23;25;61;33;84
421005;202010;54;146;40;126;9;30;19;59;28;89
421010;202010;3210;8768;2314;7099;478;1654;644;1746;1122;3400
421020;202010;360;1118;278;966;44;179;142;475;186;654
421030;202010;721;2187;552;1825;167;624;170;516;337;1140
421040;202010;654;1541;412;1173;29;97;255;713;284;810
421050;202010;996;2665;645;1869;131;422;247;625;378;1047
421055;202010;173;469;94;286;15;50;58;160;73;210
421060;202010;633;1820;444;1396;77;286;213;589;290;875
421070;202010;643;1894;368;1202;72;255;116;356;188;611
421080;202010;496;1419;412;1260;44;157;252;762;296;919
421085;202010;368;1048;126;444;15;47;16;41;31;88
421090;202010;281;726;156;453;11;39;48;126;59;165
421100;202010;819;1823;342;1028;97;340;92;227;189;567
421105;202010;1522;4174;1033;3168;181;577;463;1344;644;1921
421110;202010;1069;2799;877;2552;22;68;639;1962;661;2030
421120;202010;1011;3048;734;2425;118;424;224;670;342;1094
421125;202010;293;773;209;619;74;242;73;181;147;423
421130;202010;4834;14045;3961;12322;908;3253;2017;5827;2925;9080
421140;202010;336;911;195;600;35;110;63;174;98;284
421145;202010;431;1195;276;858;69;229;96;271;165;500
421150;202010;623;1683;393;1224;64;233;202;592;266;825
421160;202010;520;1391;368;1100;53;178;238;682;291;860
421165;202010;213;628;131;434;26;88;57;181;83;269
421170;202010;1068;2804;840;2447;137;387;510;1534;647;1921
421175;202010;986;2464;592;1844;114;395;254;760;368;1155
421180;202010;393;1015;216;654;40;153;90;236;130;389
421185;202010;318;854;211;631;26;84;125;373;151;457
421187;202010;270;818;167;555;30;100;55;173;85;273
421189;202010;347;1005;265;845;43;147;102;304;145;451
421190;202010;11017;29647;7371;22681;1354;4501;2694;7649;4048;12150
421200;202010;644;1859;523;1632;63;223;326;988;389;1211
421205;202010;190;503;139;418;25;97;63;163;88;260
421210;202010;1055;2699;611;1929;129;420;234;738;363;1158
421220;202010;1324;3957;1013;3296;231;831;309;914;540;1745
421223;202010;323;893;196;655;48;159;90;304;138;463
421225;202010;867;2542;726;2297;128;453;434;1356;562;1809
421227;202010;583;1709;385;1272;75;274;171;573;246;847
421230;202010;591;1549;372;1138;65;236;145;430;210;666
421240;202010;274;804;128;452;10;41;23;72;33;113
421250;202010;1957;4963;1377;4018;154;529;820;2279;974;2808
421260;202010;183;535;50;184;14;62;10;32;24;94
421265;202010;654;1712;577;1604;10;32;516;1421;526;1453
421270;202010;332;882;139;491;20;67;51;173;71;240
421280;202010;1823;4908;1355;4117;197;743;762;2183;959;2926
421290;202010;974;2635;505;1541;91;299;115;323;206;622
421300;202010;272;705;137;435;14;53;21;60;35;113
421310;202010;177;499;118;385;23;77;63;209;86;286
421315;202010;222;604;136;418;43;117;27;96;70;213
421320;202010;657;2007;340;1147;35;103;41;100;76;203
421330;202010;590;1752;424;1398;86;321;115;357;201;678
421335;202010;340;1037;278;925;68;254;113;358;181;612
421340;202010;1342;3705;952;2957;173;625;408;1158;581;1783
421350;202010;1448;3741;958;2880;188;649;398;1107;586;1756
421360;202010;2217;5979;1295;4076;238;890;496;1359;734;2249
421370;202010;648;2113;392;1412;72;260;117;369;189;629
421380;202010;802;2125;685;1938;90;291;403;1095;493;1386
421390;202010;167;458;59;210;14;42;20;63;34;105
421400;202010;307;974;220;769;36;142;112;374;148;516
421410;202010;205;560;88;311;22;87;26;78;48;165
421415;202010;183;539;106;330;20;66;21;55;41;121
421420;202010;539;1461;436;1269;47;155;274;772;321;927
421430;202010;98;301;73;240;7;27;19;55;26;82
421440;202010;596;1603;357;1166;71;227;154;490;225;717
421450;202010;426;1258;246;841;31;130;41;141;72;271
421460;202010;368;1094;198;723;24;98;35;105;59;203
421470;202010;251;729;149;505;32;110;53;192;85;302
421480;202010;2754;7377;1784;5420;374;1333;683;1868;1057;3201
421490;202010;118;404;69;263;7;29;17;43;24;72
421500;202010;2041;5995;1414;4697;374;1455;339;976;713;2431
421505;202010;279;793;230;723;36;130;147;444;183;574
421507;202010;417;1181;221;743;53;192;77;242;130;434
421510;202010;301;856;185;571;26;86;101;284;127;370
421520;202010;496;1289;319;896;28;85;191;489;219;574
421530;202010;301;890;173;597;29;126;50;144;79;270
421535;202010;383;1004;233;734;35;132;121;362;156;494
421540;202010;290;675;139;417;20;64;47;122;67;186
421545;202010;669;1968;499;1656;113;444;235;722;348;1166
421550;202010;2010;5337;1609;4732;301;913;918;2693;1219;3606
421555;202010;160;488;68;242;8;34;8;19;16;53
421560;202010;83;272;56;209;11;42;18;62;29;104
421565;202010;882;2280;576;1788;146;497;155;484;301;981
421567;202010;427;1393;278;964;97;360;72;221;169;581
421568;202010;332;984;247;788;33;115;110;346;143;461
421569;202010;155;442;74;240;14;50;36;112;50;162
421570;202010;1121;3008;787;2377;181;622;221;615;402;1237
421575;202010;292;849;213;642;30;103;92;240;122;343
421580;202010;3927;10743;2523;7773;394;1428;990;2583;1384;4011
421590;202010;139;429;109;359;31;112;37;111;68;223
421600;202010;558;1504;379;1129;76;260;120;297;196;557
421605;202010;728;1865;515;1517;89;234;273;858;362;1092
421610;202010;1031;2792;676;2117;113;384;220;661;333;1045
421620;202010;3775;9958;2198;7050;451;1641;627;1900;1078;3541
421625;202010;132;368;55;177;13;44;13;40;26;84
421630;202010;2448;6371;1530;4566;265;950;540;1312;805;2262
421635;202010;254;691;181;535;16;51;114;314;130;365
421640;202010;690;1849;489;1537;94;336;209;640;303;976
421650;202010;2362;6437;1544;4898;358;1337;483;1303;841;2640
421660;202010;9820;27232;6843;21481;1054;3665;3009;8629;4063;12294
421670;202010;746;2140;521;1599;89;306;250;746;339;1052
421680;202010;1011;2753;758;2296;197;642;372;1030;569;1672
421690;202010;1264;3601;844;2703;167;605;295;938;462;1543
421700;202010;505;1486;323;1066;63;226;102;318;165;544
421710;202010;199;636;88;299;18;65;21;64;39;129
421715;202010;104;290;82;240;18;48;47;136;65;184
421720;202010;1844;4984;1071;3325;278;920;284;768;562;1688
421725;202010;256;625;131;407;20;64;56;138;76;202
421730;202010;403;1158;208;621;27;87;105;292;132;379
421740;202010;706;1991;484;1503;112;360;147;418;259;778
421750;202010;856;2013;387;1134;89;285;136;356;225;641
421755;202010;153;422;88;267;15;59;46;121;61;180
421760;202010;955;2466;624;1868;104;351;241;605;345;956
421770;202010;2359;6263;1688;5080;434;1292;598;1953;1032;3245
421775;202010;200;511;122;364;16;49;57;159;73;208
421780;202010;802;2356;515;1744;107;415;210;652;317;1067
421790;202010;841;2264;495;1622;114;384;235;757;349;1141
421795;202010;185;505;131;377;24;81;48;126;72;207
421800;202010;2480;6712;1783;5398;226;795;1019;2925;1245;3720
421810;202010;601;1645;407;1277;47;178;238;725;285;903
421820;202010;933;2715;525;1700;107;397;168;428;275;825
421825;202010;1294;3656;1147;3426;125;393;802;2351;927;2744
421830;202010;1974;5842;1596;5125;330;1127;672;2098;1002;3225
421835;202010;209;512;127;375;26;87;33;86;59;173
421840;202010;208;668;136;497;29;111;34;117;63;228
421850;202010;370;1041;197;669;40;149;55;143;95;292
421860;202010;303;846;164;562;25;98;55;165;80;263
421870;202010;4128;10371;2961;8193;482;1577;1502;3699;1984;5276
421875;202010;277;817;114;362;18;63;35;92;53;155
421880;202010;585;1655;379;1190;91;335;93;281;184;616
421885;202010;208;601;127;411;29;92;31;90;60;182
421890;202010;828;2501;615;2068;114;463;319;994;433;1457
421895;202010;397;1001;330;914;40;119;224;646;264;765
421900;202010;1002;2623;726;2050;94;314;348;892;442;1206
421910;202010;295;861;200;643;30;124;55;144;85;268
421915;202010;367;1027;200;635;45;140;36;107;81;247
421917;202010;572;1334;320;1006;115;390;77;255;192;645
421920;202010;368;1130;263;918;105;385;71;240;176;625
421930;202010;2558;6469;1309;4046;293;1029;432;1158;725;2187
421935;202010;398;1239;314;1056;61;218;171;558;232;776
421940;202010;359;1039;170;543;23;78;46;131;69;209
421950;202010;2959;7365;1620;4859;308;1009;413;1105;721;2114
421960;202010;170;441;88;283;18;72;19;53;37;125
421970;202010;1866;4742;1114;3230;217;751;429;1054;646;1805
421985;202010;283;750;162;513;16;52;63;186;79;238
422000;202010;1924;4959;1546;4337;162;538;1054;2901;1216;3439
430003;202010;569;1561;374;1194;66;229;163;520;229;749
430005;202010;262;684;162;503;31;103;76;224;107;327
430010;202010;1678;4048;1323;3498;136;399;932;2385;1068;2784
430020;202010;582;1321;435;1119;44;137;287;713;331;850
430030;202010;984;2319;535;1507;127;408;170;447;297;855
430040;202010;10319;24548;6037;16962;1600;4858;721;2150;2321;7008
430045;202010;502;1240;339;941;26;82;226;617;252;699
430047;202010;249;541;94;261;27;79;27;73;54;152
430050;202010;858;2166;492;1426;109;330;121;327;230;657
430055;202010;255;634;122;358;14;53;69;183;83;236
430057;202010;82;173;31;81;6;21;11;23;17;44
430060;202010;17046;45302;13058;38979;2713;8613;6027;17811;8740;26424
430063;202010;840;2332;663;1964;126;370;358;1064;484;1434
430064;202010;1016;2764;747;2210;222;674;288;835;510;1509
430066;202010;99;210;69;164;7;15;52;119;59;134
430070;202010;722;1826;93;300;7;26;16;43;23;69
430080;202010;851;2094;514;1432;82;271;272;657;354;928
430085;202010;866;1951;520;1394;100;277;220;577;320;854
430087;202010;736;1805;616;1642;69;177;417;1109;486;1286
430090;202010;552;1425;197;622;11;43;65;197;76;240
430100;202010;785;1866;463;1252;87;276;194;441;281;717
430105;202010;1158;3066;745;2348;124;448;359;1087;483;1535
430107;202010;165;482;96;303;20;72;27;71;47;143
430110;202010;2208;5480;1621;4600;280;838;854;2390;1134;3228
430120;202010;1202;3542;773;2459;143;480;334;1062;477;1542
430130;202010;3445;7903;2503;6571;894;2385;433;1387;1327;3772
430140;202010;963;2510;681;1981;175;468;333;953;508;1421
430150;202010;567;1446;304;917;68;224;99;286;167;510
430155;202010;251;634;114;342;18;51;22;61;40;112
430160;202010;19743;45794;15169;39282;1790;5031;8917;22823;10707;27854
430163;202010;3035;7134;2117;5668;89;299;1532;4005;1621;4304
430165;202010;303;745;85;275;14;31;14;39;28;70
430170;202010;949;2505;328;1123;52;187;43;132;95;319
430175;202010;642;1921;537;1691;135;438;250;770;385;1208
430180;202010;626;1505;492;1287;58;149;338;884;396;1033
430185;202010;615;1530;316;917;83;222;65;178;148;400
430187;202010;683;1535;479;1277;78;217;244;694;322;911
430190;202010;1389;3656;1107;3199;228;716;510;1402;738;2118
430192;202010;128;342;41;124;5;15;10;26;15;41
430195;202010;412;1223;62;219;7;23;9;26;16;49
430200;202010;1062;3146;846;2751;283;945;236;790;519;1735
430205;202010;461;1198;405;1100;15;50;348;919;363;969
430210;202010;5494;13947;3682;10086;622;1848;1278;2843;1900;4691
430215;202010;304;779;189;547;39;120;69;204;108;324
430220;202010;641;1593;186;618;23;86;44;113;67;199
430222;202010;187;517;135;405;15;54;47;130;62;184
430223;202010;249;643;195;552;16;46;124;347;140;393
430225;202010;17;34;11;25;1;2;7;16;8;18
430230;202010;1929;5203;1606;4703;142;463;1189;3413;1331;3876
430235;202010;340;951;217;679;50;183;70;184;120;367
430237;202010;510;1187;369;953;19;54;273;687;292;741
430240;202010;1281;2968;721;1981;85;283;382;956;467;1239
430245;202010;709;1991;543;1674;149;479;253;799;402;1278
430250;202010;896;2207;647;1814;219;659;40;101;259;760
430258;202010;134;349;96;273;7;13;52;150;59;163
430260;202010;661;1729;452;1333;60;198;251;733;311;931
430265;202010;216;615;139;458;30;92;44;149;74;241
430270;202010;2861;7049;2248;6088;391;1169;1344;3511;1735;4680
430280;202010;5060;11843;3476;9119;702;1862;1479;3818;2181;5680
430290;202010;2218;5049;1802;4558;50;163;1549;3822;1599;3985
430300;202010;9929;24923;7374;20446;1160;3539;3885;10457;5045;13996
430310;202010;11915;29384;7931;21916;1027;3158;3860;9887;4887;13045
430320;202010;1011;2597;543;1659;59;181;300;921;359;1102
430330;202010;691;1674;406;1103;73;212;169;408;242;620
430340;202010;724;1568;399;1069;60;164;229;598;289;762
430350;202010;7677;19285;5704;15746;773;2325;3344;8772;4117;11097
430355;202010;325;857;111;357;18;61;15;40;33;101
430360;202010;870;2032;550;1478;105;321;229;570;334;891
430367;202010;312;718;172;467;30;95;96;247;126;342
430370;202010;483;1296;222;672;40;127;60;155;100;282
430380;202010;704;1726;340;1052;77;278;99;286;176;564
430390;202010;3205;7716;1858;5202;343;1095;284;571;627;1666
430400;202010;1049;2238;803;1889;68;185;526;1191;594;1376
430410;202010;543;1305;370;1018;64;182;219;581;283;763
430420;202010;2600;7083;1981;5722;491;1505;886;2419;1377;3924
430430;202010;575;1468;265;820;62;184;58;194;120;378
430435;202010;1505;3788;1144;3196;207;619;577;1611;784;2230
430440;202010;3709;10093;2860;8584;299;1007;1745;5195;2044;6202
430450;202010;6767;16885;5316;14289;868;2583;2747;7056;3615;9639
430460;202010;32143;80960;23487;66585;4049;12715;11901;32146;15950;44861
430461;202010;283;731;88;274;13;43;33;87;46;130
430462;202010;252;688;144;466;24;86;51;160;75;246
430463;202010;5989;15610;4407;12754;877;2835;2019;5554;2896;8389
430465;202010;431;1098;346;942;57;178;213;558;270;736
430466;202010;4087;10255;3150;8723;764;2201;1450;3803;2214;6004
430467;202010;501;1193;356;959;48;155;194;481;242;636
430468;202010;1258;3083;974;2655;84;258;641;1701;725;1959
430469;202010;559;1504;68;219;7;23;13;24;20;47
430470;202010;5550;14156;3623;10660;1062;3427;924;2523;1986;5950
430471;202010;535;1514;433;1325;64;214;252;730;316;944
430480;202010;727;1970;426;1311;53;188;101;270;154;458
430485;202010;171;444;66;200;19;49;6;24;25;73
430490;202010;360;936;201;598;25;89;97;262;122;351
430495;202010;386;1018;247;747;32;98;120;345;152;443
430500;202010;990;2551;680;2030;229;747;179;484;408;1231
430510;202010;25559;66214;18329;51967;3020;9721;8500;22057;11520;31778
430511;202010;323;928;130;420;18;61;19;58;37;119
430512;202010;969;2173;747;1839;170;426;275;695;445;1121
430513;202010;762;1900;350;1009;49;148;175;478;224;626
430515;202010;371;1043;264;825;31;91;139;430;170;521
430517;202010;1175;3503;861;2768;165;536;391;1313;556;1849
430520;202010;1299;3283;666;1924;127;380;146;376;273;756
430530;202010;983;2438;387;1158;70;205;108;303;178;508
430535;202010;3493;8953;2510;7132;360;1077;1269;3448;1629;4525
430537;202010;332;1145;307;1076;20;64;244;854;264;918
430540;202010;617;1472;347;1001;60;170;162;467;222;637
430543;202010;804;1412;457;1018;57;118;202;510;259;628
430544;202010;746;2101;516;1573;127;409;175;513;302;922
430545;202010;2273;5867;1679;4943;335;1008;840;2527;1175;3535
430550;202010;351;953;251;744;45;146;95;255;140;401
430558;202010;113;261;50;136;7;14;18;52;25;66
430560;202010;340;764;147;438;21;74;50;139;71;213
430570;202010;849;2065;596;1598;101;307;312;782;413;1089
430580;202010;828;2058;587;1678;150;457;250;714;400;1171
430583;202010;195;483;33;104;2;7;10;24;12;31
430585;202010;238;579;118;318;21;66;50;116;71;182
430587;202010;203;548;150;442;20;65;65;183;85;248
430590;202010;1402;3343;1149;2968;61;181;945;2386;1006;2567
430593;202010;17;55;12;37;1;3;5;15;6;18
430595;202010;440;1111;120;392;7;27;23;57;30;84
430597;202010;461;1171;236;707;24;68;75;177;99;245
430600;202010;1997;5061;887;2510;167;510;238;608;405;1118
430605;202010;1272;3328;892;2613;111;380;418;1154;529;1534
430607;202010;534;1234;434;1073;26;71;318;776;344;847
430610;202010;5851;13603;3902;10610;1094;3366;852;2248;1946;5614
430613;202010;267;625;75;218;13;37;19;39;32;76
430620;202010;637;1521;459;1184;67;199;272;628;339;827
430630;202010;401;1104;110;357;20;63;22;65;42;128
430632;202010;474;1244;200;612;26;85;88;254;114;339
430635;202010;541;1272;400;1031;46;120;290;748;336;868
430637;202010;460;1122;358;968;45;140;223;572;268;712
430640;202010;1075;2782;665;1958;100;307;252;679;352;986
430642;202010;351;953;258;743;44;117;137;376;181;493
430645;202010;157;365;60;161;8;22;20;48;28;70
430650;202010;1613;4611;1281;4051;363;1152;571;1912;934;3064
430655;202010;278;700;168;472;27;88;81;195;108;283
430660;202010;5253;13343;3961;11149;856;2516;1714;4767;2570;7283
430670;202010;650;1573;489;1289;33;93;291;777;324;870
430673;202010;540;1212;217;616;36;105;85;222;121;327
430675;202010;239;686;56;197;9;33;23;79;32;112
430676;202010;5009;12313;3937;10660;484;1450;2505;6576;2989;8026
430680;202010;1041;2771;605;1867;157;489;143;434;300;923
430690;202010;2830;7651;2211;6520;753;2328;599;1686;1352;4014
430692;202010;220;672;165;570;12;39;123;437;135;476
430693;202010;951;2501;565;1723;105;375;146;403;251;778
430695;202010;435;1113;238;696;31;80;127;354;158;434
430697;202010;396;986;302;839;76;193;146;445;222;638
430700;202010;7151;17492;4168;11909;844;2651;907;2313;1751;4964
430705;202010;402;972;198;592;22;75;85;224;107;299
430710;202010;1661;3556;1151;2853;156;436;687;1666;843;2102
430720;202010;678;1634;347;1048;47;143;178;539;225;682
430730;202010;1026;2761;694;2130;103;305;362;1098;465;1403
430740;202010;618;1679;314;1029;52;172;78;271;130;443
430745;202010;363;986;226;686;43;149;70;180;113;329
430750;202010;1364;3449;941;2724;211;642;448;1269;659;1911
430755;202010;456;1110;281;756;21;60;160;396;181;456
430760;202010;2020;4941;1519;4164;348;1036;675;1754;1023;2790
430770;202010;6207;15385;4743;13184;601;1921;3025;8108;3626;10029
430780;202010;1843;4466;1058;3107;205;674;405;1126;610;1800
430781;202010;457;1265;246;765;32;96;73;193;105;289
430783;202010;357;813;213;592;19;60;132;343;151;403
430786;202010;33;114;23;82;3;13;2;9;5;22
430790;202010;4426;10699;3053;8339;344;1105;1872;4758;2216;5863
430800;202010;738;1716;539;1411;35;97;354;932;389;1029
430805;202010;358;954;219;646;16;58;139;385;155;443
430807;202010;484;1177;254;737;31;92;100;265;131;357
430810;202010;717;1709;301;896;35;130;136;372;171;502
430820;202010;1201;3231;707;2244;133;448;225;684;358;1132
430825;202010;246;620;87;232;11;29;27;66;38;95
430830;202010;1665;4726;1334;4089;64;214;958;2901;1022;3115
430840;202010;1032;2535;713;1991;104;298;474;1315;578;1613
430843;202010;159;369;68;178;4;13;32;79;36;92
430845;202010;459;1077;300;817;53;156;132;343;185;499
430850;202010;2279;5876;1524;4405;242;762;589;1712;831;2474
430860;202010;870;2015;378;1071;51;173;181;442;232;615
430865;202010;508;1268;375;1036;76;214;167;457;243;671
430870;202010;605;1572;254;795;41;152;79;207;120;359
430880;202010;1481;3356;997;2605;162;425;538;1379;700;1804
430885;202010;179;469;93;302;6;22;59;186;65;208
430890;202010;995;2462;656;1879;58;249;135;363;193;612
430900;202010;3107;6779;2145;5393;178;531;1423;3357;1601;3888
430905;202010;755;1910;468;1363;84;276;182;489;266;765
430910;202010;1620;4310;1141;3322;192;649;565;1463;757;2112
430912;202010;497;1377;329;1039;24;73;226;723;250;796
430915;202010;491;1477;375;1256;139;449;93;333;232;782
430920;202010;22768;57486;17169;48069;2289;7071;10328;28150;12617;35221
430925;202010;97;217;36;107;5;13;17;53;22;66
430930;202010;10134;23941;6353;18054;1232;3563;2600;7711;3832;11274
430940;202010;996;2596;595;1737;145;445;158;397;303;842
430950;202010;771;1779;490;1293;38;135;312;749;350;884
430955;202010;346;911;85;251;22;67;25;61;47;128
430957;202010;176;600;161;561;25;90;100;344;125;434
430960;202010;1314;3138;725;2049;154;463;315;862;469;1325
430965;202010;1613;3800;1238;3208;72;188;934;2482;1006;2670
430970;202010;355;844;173;486;23;75;81;197;104;272
430975;202010;495;1464;378;1192;82;278;197;589;279;867
430980;202010;392;894;229;617;28;92;109;268;137;360
430990;202010;531;1518;326;1023;42;133;156;490;198;623
430995;202010;566;1422;410;1168;46;139;229;637;275;776
431000;202010;1350;3173;546;1582;92;291;43;109;135;400
431010;202010;2179;5684;1368;4262;263;902;325;877;588;1779
431020;202010;7908;17163;4624;12184;1057;3141;1548;3539;2605;6680
431030;202010;354;956;170;568;31;109;22;73;53;182
431033;202010;3766;8747;2396;6573;523;1463;861;2372;1384;3835
431036;202010;341;747;67;192;8;29;24;53;32;82
431040;202010;886;2265;573;1701;84;280;263;717;347;997
431041;202010;463;1063;337;874;30;70;200;519;230;589
431043;202010;340;861;185;578;43;150;87;273;130;423
431046;202010;107;281;43;132;4;9;8;24;12;33
431050;202010;1386;3345;976;2670;184;552;459;1290;643;1842
431053;202010;641;1721;361;1104;82;294;116;304;198;598
431055;202010;588;1425;495;1282;59;136;350;905;409;1041
431057;202010;234;667;116;382;26;85;33;98;59;183
431060;202010;5451;13848;3613;10651;853;2757;1000;2857;1853;5614
431065;202010;420;1036;297;826;51;154;139;380;190;534
431070;202010;433;1185;242;755;54;183;63;185;117;368
431075;202010;221;636;134;433;30;106;36;117;66;223
431080;202010;582;1576;391;1162;60;213;144;398;204;611
431085;202010;772;1987;484;1329;60;167;253;674;313;841
431087;202010;401;1136;323;971;22;63;225;699;247;762
431090;202010;417;968;161;488;29;96;46;146;75;242
431100;202010;3330;7286;2267;5866;328;859;1152;3035;1480;3894
431110;202010;1396;3187;934;2392;257;690;367;855;624;1545
431112;202010;591;1632;494;1439;66;216;307;859;373;1075
431113;202010;374;1016;321;910;50;161;198;542;248;703
431115;202010;959;2701;742;2295;100;388;431;1233;531;1621
431120;202010;2540;6810;1710;5127;494;1665;380;1029;874;2694
431123;202010;403;1083;255;763;44;116;140;438;184;554
431125;202010;1016;2856;772;2371;278;822;260;867;538;1689
431127;202010;201;525;60;195;8;26;12;35;20;61
431130;202010;2953;7464;2142;6100;305;995;1200;3318;1505;4313
431140;202010;5553;12958;3337;8791;398;1173;1554;3510;1952;4683
431142;202010;503;1331;370;1092;49;150;225;664;274;814
431150;202010;1039;2741;734;2168;139;452;327;921;466;1373
431160;202010;630;1802;416;1322;70;241;126;392;196;633
431162;202010;512;1230;288;821;31;101;158;414;189;515
431164;202010;177;402;41;124;9;29;5;11;14;40
431170;202010;461;1275;319;970;96;298;90;257;186;555
431171;202010;657;1538;530;1364;113;256;310;827;423;1083
431173;202010;392;1039;290;883;75;262;120;341;195;603
431175;202010;1268;2928;783;2096;127;347;298;745;425;1092
431177;202010;802;2156;612;1853;131;462;370;1059;501;1521
431179;202010;336;737;97;289;18;54;23;66;41;120
431180;202010;2176;5458;1320;3772;320;934;390;1065;710;1999
431190;202010;514;1327;254;749;29;91;98;239;127;330
431198;202010;363;1044;285;893;89;290;89;306;178;596
431200;202010;362;901;80;223;16;45;10;28;26;73
431205;202010;195;539;99;321;28;92;36;115;64;207
431210;202010;612;1482;487;1308;128;344;216;615;344;959
431213;202010;258;676;191;552;13;46;102;296;115;342
431215;202010;588;1393;259;748;23;67;130;357;153;424
431217;202010;154;398;102;303;12;38;54;150;66;188
431220;202010;532;1374;314;945;31;110;174;484;205;594
431225;202010;1491;3504;1131;2897;118;319;768;1969;886;2288
431230;202010;694;1981;540;1632;75;235;324;948;399;1183
431235;202010;154;391;23;80;4;10;5;21;9;31
431237;202010;308;972;251;838;49;177;129;412;178;589
431238;202010;28;74;23;64;6;22;9;16;15;38
431240;202010;4436;10847;3441;9275;476;1468;2060;5255;2536;6723
431242;202010;244;646;208;588;43;129;110;297;153;426
431244;202010;319;771;165;466;23;82;60;142;83;224
431245;202010;1280;2983;797;2134;75;214;419;1070;494;1284
431247;202010;280;712;164;470;28;89;70;176;98;265
431250;202010;1670;4152;1226;3545;269;817;630;1908;899;2725
431260;202010;243;670;160;512;23;87;57;172;80;259
431261;202010;238;716;189;635;14;53;104;333;118;386
431262;202010;365;1010;176;570;10;27;117;384;127;411
431265;202010;1576;3712;621;1809;79;273;215;546;294;819
431267;202010;288;746;179;502;8;35;128;321;136;356
431270;202010;2791;6230;1480;4021;336;939;490;1343;826;2282
431275;202010;120;347;61;198;24;74;12;42;36;116
431280;202010;236;639;74;241;5;16;6;12;11;28
431290;202010;313;908;200;620;37;132;38;82;75;214
431295;202010;70;175;20;62;3;8;6;18;9;26
431300;202010;289;742;55;171;6;19;13;27;19;46
431301;202010;310;867;66;204;8;20;7;22;15;42
431303;202010;578;1514;341;1003;23;78;154;422;177;500
431306;202010;2288;5368;1366;3814;178;569;603;1487;781;2056
431308;202010;26;79;23;73;11;37;10;31;21;68
431310;202010;536;1503;374;1139;54;168;163;462;217;630
431320;202010;645;1756;325;1057;47;138;64;180;111;318
431330;202010;1728;4051;837;2378;150;484;338;863;488;1347
431333;202010;226;601;118;346;19;55;41;110;60;165
431335;202010;36;103;19;62;4;8;2;6;6;14
431337;202010;2573;6790;1862;5605;349;1191;969;2798;1318;3989
431339;202010;426;1101;311;884;85;250;121;340;206;590
431340;202010;18822;45369;12823;35256;2187;6693;5712;14664;7899;21357
431342;202010;432;931;313;752;27;54;261;632;288;686
431344;202010;391;986;230;678;9;30;123;349;132;379
431346;202010;237;580;91;289;15;53;25;76;40;129
431349;202010;656;1708;341;1000;82;238;124;361;206;599
431350;202010;4034;10366;2951;8470;417;1360;1571;4329;1988;5689
431360;202010;569;1349;277;782;86;247;72;204;158;451
431365;202010;2060;4801;1629;4209;130;381;1221;3113;1351;3494
431370;202010;4379;10611;3093;8472;650;1867;1520;4265;2170;6132
431380;202010;781;2090;629;1843;39;126;441;1289;480;1415
431390;202010;2652;6437;1595;4543;167;564;790;1967;957;2531
431395;202010;1282;3156;897;2557;200;596;403;1185;603;1781
431400;202010;323;901;174;543;35;103;40;124;75;227
431402;202010;881;1948;635;1573;79;207;428;1029;507;1236
431403;202010;198;553;153;460;24;74;69;195;93;269
431405;202010;4561;11907;3467;10066;593;1920;1702;4672;2295;6592
431406;202010;542;1518;388;1191;77;230;201;636;278;866
431407;202010;445;1235;307;939;68;226;154;453;222;679
431410;202010;16537;41322;10771;30978;1560;5209;5436;14475;6996;19684
431413;202010;232;605;59;188;7;25;8;28;15;53
431415;202010;663;1617;411;1194;70;246;202;525;272;771
431417;202010;546;1207;368;932;55;159;207;514;262;673
431420;202010;1603;3578;1200;3016;163;425;677;1672;840;2097
431430;202010;549;1405;261;811;40;135;83;227;123;362
431440;202010;29831;69539;20423;54661;3473;10084;7998;20062;11471;30146
431442;202010;119;334;57;195;14;47;9;28;23;75
431445;202010;386;1077;121;385;17;45;8;21;25;66
431446;202010;265;777;198;639;36;130;98;304;134;434
431447;202010;728;1920;412;1238;84;279;142;429;226;708
431449;202010;772;2001;456;1341;88;237;180;545;268;782
431450;202010;2246;4609;1750;3907;82;198;1370;2982;1452;3180
431454;202010;36;114;30;99;8;24;9;28;17;52
431455;202010;613;1450;293;789;38;110;148;360;186;470
431460;202010;2883;6945;2001;5373;518;1455;535;1463;1053;2918
431470;202010;1400;3920;1002;3062;185;568;437;1363;622;1931
431475;202010;251;670;49;168;5;18;7;14;12;32
431477;202010;409;1058;240;705;42;119;102;270;144;389
431478;202010;255;668;53;168;10;27;6;16;16;43
431480;202010;3245;7977;2538;6859;595;1606;1287;3527;1882;5133
431490;202010;108751;255009;81639;213130;5966;18452;59101;148158;65067;166610
431500;202010;472;1187;345;944;57;160;184;480;241;640
431505;202010;267;638;182;510;11;35;128;357;139;392
431507;202010;345;814;132;389;41;130;37;101;78;231
431510;202010;1572;4019;1048;2990;233;724;348;987;581;1711
431513;202010;210;462;118;309;9;19;83;219;92;238
431514;202010;108;272;74;210;3;10;52;139;55;149
431515;202010;482;1183;345;932;82;227;165;437;247;664
431517;202010;59;177;47;146;6;17;22;65;28;82
431520;202010;414;1006;159;490;22;80;70;184;92;264
431530;202010;4237;8956;2391;6193;550;1432;596;1569;1146;3001
431531;202010;206;511;125;353;13;39;56;142;69;181
431532;202010;562;1288;332;875;66;201;133;338;199;539
431535;202010;250;659;111;342;20;63;26;71;46;134
431540;202010;1779;5671;1648;5489;61;243;1333;4457;1394;4700
431545;202010;346;889;60;192;6;19;13;39;19;58
431550;202010;2069;5201;1507;4153;246;740;768;2030;1014;2770
431555;202010;645;1455;390;1022;26;78;236;608;262;686
431560;202010;22490;54408;15175;42825;3178;9340;5039;15024;8217;24364
431570;202010;4517;10835;3612;9513;461;1333;2514;6351;2975;7684
431575;202010;249;610;191;509;71;166;46;134;117;300
431580;202010;599;1540;359;1049;42;146;198;550;240;696
431590;202010;571;1582;428;1286;92;294;165;510;257;804
431595;202010;370;988;234;693;52;152;91;243;143;395
431600;202010;1424;3280;986;2646;231;673;394;1056;625;1729
431610;202010;1370;3503;919;2664;139;390;474;1400;613;1790
431620;202010;476;1214;219;631;34;99;86;235;120;334
431630;202010;1316;3247;610;1790;99;320;221;587;320;907
431640;202010;6248;14706;5249;13457;514;1349;3921;10102;4435;11451
431642;202010;560;1361;343;919;27;70;161;397;188;467
431643;202010;393;957;183;516;17;44;54;157;71;201
431645;202010;1824;4048;1406;3481;61;192;1129;2751;1190;2943
431647;202010;284;689;92;260;11;27;27;66;38;93
431650;202010;122;338;81;267;6;23;45;132;51;155
431660;202010;879;2334;429;1383;74;277;120;332;194;609
431670;202010;1145;2705;700;1892;111;315;354;905;465;1220
431673;202010;234;595;81;272;12;41;17;55;29;96
431675;202010;527;1328;113;383;11;42;23;65;34;107
431680;202010;7571;19284;5423;15244;1260;3698;2283;6267;3543;9965
431690;202010;23713;57672;15545;42926;3136;9261;6235;17004;9371;26265
431695;202010;170;410;103;303;22;77;53;133;75;210
431697;202010;461;1072;356;905;51;120;207;538;258;658
431700;202010;1316;3405;1097;3003;161;406;656;1790;817;2196
431710;202010;12919;30740;8927;24940;1527;4596;4483;12612;6010;17208
431720;202010;6395;15725;3729;10541;909;2709;742;1882;1651;4591
431725;202010;30;86;23;72;4;11;10;30;14;41
431730;202010;3948;9373;2418;6926;565;1719;748;2297;1313;4016
431740;202010;5112;12058;3315;9002;876;2751;846;1939;1722;4690
431750;202010;7421;18949;5584;15982;1228;3778;2329;6540;3557;10318
431755;202010;323;883;72;251;10;36;9;34;19;70
431760;202010;5389;12020;3601;9164;406;1182;2172;5207;2578;6389
431770;202010;1902;4427;1470;3849;97;288;1100;2801;1197;3089
431775;202010;199;513;102;311;20;58;15;41;35;99
431780;202010;2080;5125;1316;3690;216;677;555;1483;771;2160
431790;202010;805;2171;565;1700;100;292;250;740;350;1032
431795;202010;233;591;115;343;26;69;29;81;55;150
431800;202010;8204;19495;4988;14316;1281;4308;507;1539;1788;5847
431805;202010;301;710;90;292;12;42;23;70;35;112
431810;202010;3260;7660;2028;5406;382;1059;866;2207;1248;3266
431820;202010;2123;5699;1656;4947;458;1437;578;1806;1036;3243
431830;202010;9072;19468;6603;16171;1681;4866;1923;4676;3604;9542
431840;202010;2555;6663;2026;5799;315;909;1266;3635;1581;4544
431842;202010;535;1337;180;545;25;81;65;163;90;244
431843;202010;342;902;250;708;33;101;122;324;155;425
431844;202010;203;523;68;211;14;47;23;70;37;117
431845;202010;520;1366;360;1044;38;111;206;592;244;703
431846;202010;275;710;230;643;9;29;206;575;215;604
431848;202010;102;260;64;189;9;29;11;25;20;54
431849;202010;414;995;65;182;6;11;8;17;14;28
431850;202010;4133;11128;3145;9145;725;2278;1030;2955;1755;5233
431860;202010;656;1577;353;986;60;180;195;520;255;700
431861;202010;94;256;52;161;11;39;14;41;25;80
431862;202010;434;1369;356;1234;68;258;178;589;246;847
431870;202010;19901;50191;15955;43929;1851;5774;9892;26143;11743;31917
431880;202010;3961;10125;2772;7993;442;1454;1269;3463;1711;4917
431890;202010;4492;11234;2740;7883;769;2439;475;1510;1244;3949
431900;202010;979;2446;623;1795;100;321;317;859;417;1180
431910;202010;753;1800;274;764;42;120;88;199;130;319
431912;202010;474;1281;367;1091;76;233;202;601;278;834
431915;202010;1025;2523;802;2156;27;86;616;1622;643;1708
431920;202010;1228;2817;1009;2528;32;82;864;2154;896;2236
431930;202010;667;1766;445;1346;156;436;169;543;325;979
431935;202010;84;226;59;174;14;45;13;38;27;83
431936;202010;302;871;158;508;34;112;62;184;96;296
431937;202010;164;411;100;276;16;49;44;99;60;148
431940;202010;2983;7034;1690;4662;191;569;840;2219;1031;2788
431950;202010;1787;4697;1416;4080;443;1323;516;1444;959;2767
431960;202010;2952;7158;2133;5672;588;1648;550;1473;1138;3121
431970;202010;420;1056;167;478;36;100;47;116;83;216
431971;202010;83;208;31;100;2;8;4;8;6;16
431973;202010;475;1513;387;1344;40;143;281;975;321;1118
431975;202010;111;228;23;72;2;7;2;6;4;13
431980;202010;1001;2592;767;2204;157;476;362;1001;519;1477
431990;202010;5604;13363;3754;10687;461;1587;1871;5088;2332;6675
432000;202010;11293;26845;8177;21995;2008;5478;3450;9408;5458;14886
432010;202010;2191;5330;1599;4299;246;721;917;2321;1163;3042
432020;202010;1763;4510;1075;3074;232;692;436;1193;668;1885
432023;202010;507;1207;261;733;35;111;127;316;162;427
432026;202010;939;2624;686;2131;176;553;230;713;406;1266
432030;202010;361;888;203;565;20;58;118;317;138;375
432032;202010;344;881;235;664;29;93;128;337;157;430
432035;202010;649;1844;560;1691;174;530;232;727;406;1257
432040;202010;1046;2417;381;1162;61;202;130;361;191;563
432045;202010;163;453;98;318;24;71;32;116;56;187
432050;202010;497;1218;362;988;77;207;148;425;225;632
432055;202010;582;1565;377;1171;131;410;74;218;205;628
432057;202010;218;582;161;443;17;44;65;163;82;207
432060;202010;450;1085;137;422;34;114;45;120;79;234
432065;202010;215;597;151;455;33;99;60;179;93;278
432067;202010;733;2108;609;1832;59;198;454;1310;513;1508
432070;202010;1655;4328;1069;3168;232;759;351;929;583;1688
432080;202010;4639;10889;3515;9101;604;1827;1646;4013;2250;5840
432085;202010;348;893;238;723;61;193;95;297;156;490
432090;202010;1692;4192;1067;3008;191;586;527;1356;718;1942
432100;202010;966;2427;472;1440;99;327;83;210;182;537
432110;202010;2021;5371;1357;4160;328;1136;134;375;462;1511
432120;202010;2724;7332;2082;6216;399;1312;822;2338;1221;3650
432130;202010;2523;6411;2079;5756;604;1706;922;2608;1526;4314
432132;202010;183;518;108;352;22;71;50;141;72;212
432135;202010;1010;2364;663;1767;40;123;479;1260;519;1383
432140;202010;1613;4803;1208;3967;183;625;702;2297;885;2922
432143;202010;1379;3594;1050;3077;67;216;698;2035;765;2251
432145;202010;1648;4302;1025;2996;148;469;362;901;510;1370
432146;202010;101;283;66;221;22;82;22;65;44;147
432147;202010;486;1369;280;918;92;324;70;197;162;521
432149;202010;444;1079;221;620;18;55;107;265;125;320
432150;202010;3129;7875;2279;6365;468;1430;914;2488;1382;3918
432160;202010;5128;13462;3733;11190;904;3020;1350;3828;2254;6848
432162;202010;254;558;35;98;8;20;6;15;14;35
432163;202010;120;294;24;64;0;0;3;4;3;4
432166;202010;615;1701;465;1390;94;305;154;415;248;720
432170;202010;1433;3826;928;2863;171;574;373;1068;544;1642
432180;202010;3001;7078;1611;4446;304;872;613;1493;917;2365
432183;202010;373;1088;250;795;58;205;70;204;128;409
432185;202010;813;2085;464;1392;39;134;231;646;270;780
432190;202010;1880;4514;1239;3479;190;600;678;1771;868;2371
432195;202010;893;2238;581;1676;169;451;195;603;364;1054
432200;202010;3257;8242;2332;6740;376;1102;1306;3813;1682;4915
432210;202010;391;1030;241;732;45;174;109;275;154;449
432215;202010;618;1810;559;1719;54;146;414;1296;468;1442
432218;202010;246;610;109;309;14;51;52;133;66;184
432220;202010;3525;8271;2586;6762;467;1290;1370;3505;1837;4795
432225;202010;94;265;71;217;12;37;40;124;52;161
432230;202010;717;1665;376;1019;41;113;166;401;207;514
432232;202010;484;1187;299;866;62;187;107;281;169;468
432234;202010;268;668;123;362;20;53;16;43;36;96
432235;202010;49;139;17;55;5;17;4;13;9;30
432237;202010;324;828;282;758;11;22;232;616;243;638
432240;202010;15558;38247;11174;32300;860;2614;7051;21386;7911;24000
432250;202010;5260;14930;3950;12302;1014;3302;1645;5068;2659;8370
432252;202010;440;1045;272;749;35;103;142;374;177;477
432253;202010;896;2723;569;1892;134;475;51;154;185;629
432254;202010;712;1668;188;550;32;92;39;108;71;200
432255;202010;109;277;56;171;3;9;27;74;30;83
432260;202010;4888;12439;3588;9961;1022;2927;1170;3098;2192;6025
432270;202010;1806;5008;1435;4287;419;1361;308;847;727;2208
432280;202010;1382;3443;718;2130;103;324;264;649;367;973
432285;202010;143;431;22;67;2;6;3;7;5;13
432290;202010;341;949;183;571;60;192;35;80;95;272
432300;202010;25853;65073;19115;54029;2760;8805;11090;30190;13850;38995
432310;202010;837;2237;600;1799;64;198;408;1218;472;1416
432320;202010;213;499;77;235;8;29;28;75;36;104
432330;202010;229;513;68;219;8;18;13;40;21;58
432335;202010;190;530;66;233;5;21;17;58;22;79
432340;202010;308;740;138;427;11;32;52;148;63;180
432345;202010;672;1523;590;1422;17;44;488;1160;505;1204
432350;202010;341;888;184;579;27;89;71;224;98;313
432360;202010;237;689;46;150;4;7;16;54;20;61
432370;202010;304;744;201;570;15;52;135;368;150;420
432375;202010;469;1171;343;921;63;164;173;468;236;632
432377;202010;166;529;29;100;6;27;4;11;10;38
432380;202010;1653;4363;1061;3267;181;644;535;1577;716;2221
500020;202010;2509;6505;1804;5305;154;538;1131;3224;1285;3762
500025;202010;1216;2944;747;2057;77;223;401;1048;478;1271
500060;202010;7904;22124;5352;16809;666;2163;3100;10003;3766;12166
500070;202010;4316;11090;2954;8742;551;1664;1257;3795;1808;5459
500080;202010;1619;3969;971;2750;180;554;383;957;563;1511
500085;202010;2048;5058;1392;3958;321;964;651;1773;972;2737
500090;202010;2159;5693;1447;4429;238;772;490;1603;728;2375
500100;202010;3565;9068;2697;7648;453;1453;1318;3537;1771;4990
500110;202010;8032;20429;5089;15696;1080;3659;1514;5500;2594;9159
500124;202010;2046;5957;1613;5217;265;799;850;2897;1115;3696
500150;202010;1334;2988;828;2251;140;403;339;900;479;1303
500190;202010;4829;12416;3013;8877;658;1992;716;1984;1374;3976
500200;202010;2334;5505;1677;4404;185;497;1013;2564;1198;3061
500210;202010;4611;11077;3261;9288;884;2452;1415;4152;2299;6604
500215;202010;1395;3858;997;3124;100;340;553;1714;653;2054
500220;202010;2692;7514;1707;5581;285;1002;450;1390;735;2392
500230;202010;2018;4711;1517;4012;174;432;1021;2675;1195;3107
500240;202010;3951;11576;2763;9068;412;1509;1112;3715;1524;5224
500260;202010;3275;6930;2065;5276;281;731;1090;2675;1371;3406
500270;202010;137834;322381;81726;226498;13397;40919;30591;79113;43988;120032
500280;202010;1337;3350;909;2682;136;417;480;1399;616;1816
500290;202010;3663;8635;2087;5973;317;1043;683;1734;1000;2777
500295;202010;3510;8448;2187;6090;341;1045;862;2070;1203;3115
500310;202010;969;2006;650;1599;98;211;333;849;431;1060
500315;202010;3771;10362;2970;9148;251;807;2111;6613;2362;7420
500320;202010;19444;51930;13353;41796;3379;11138;4581;15222;7960;26360
500325;202010;4306;9587;2948;7775;229;635;1995;5309;2224;5944
500330;202010;6672;15180;4352;11778;375;1112;2324;6466;2699;7578
500345;202010;2090;5123;1384;4011;319;960;460;1314;779;2274
500348;202010;2371;6155;1789;5145;250;740;1021;2987;1271;3727
500350;202010;1311;3568;715;2253;91;288;291;870;382;1158
500370;202010;26513;67579;18518;54396;2398;8073;9807;28321;12205;36394
500375;202010;2422;6346;1578;4620;286;916;534;1455;820;2371
500380;202010;3386;8439;2286;6555;638;1985;513;1484;1151;3469
500390;202010;619;1268;366;956;54;172;217;539;271;711
500400;202010;1527;3850;1003;2831;177;568;352;874;529;1442
500410;202010;2400;5887;1677;4803;182;508;962;2878;1144;3386
500430;202010;2622;6366;1759;5072;227;779;758;2288;985;3067
500440;202010;1221;2959;761;2241;115;372;283;888;398;1260
500450;202010;1501;3682;837;2478;141;452;218;601;359;1053
500460;202010;3617;9698;2179;6816;358;1279;682;2077;1040;3356
500470;202010;2435;6534;1462;4517;408;1408;317;852;725;2260
500480;202010;2114;6376;1782;5843;175;590;1315;4382;1490;4972
500490;202010;1072;2472;629;1809;130;453;172;496;302;949
500500;202010;4234;11259;2672;8674;910;3441;415;1387;1325;4828
500510;202010;689;1745;440;1273;28;90;269;756;297;846
500515;202010;1712;4361;1305;3709;138;432;816;2216;954;2648
500520;202010;3242;9864;2491;8469;636;2159;1015;3712;1651;5871
500525;202010;893;2627;715;2353;59;206;461;1535;520;1741
500540;202010;4452;11536;2665;8369;694;2735;244;684;938;3419
500560;202010;5403;14645;4311;13267;287;894;3441;10783;3728;11677
500568;202010;4350;9467;2624;6906;640;1768;910;2439;1550;4207
500570;202010;7767;18024;4726;12828;839;2476;1793;4556;2632;7032
500580;202010;3038;8044;2189;6545;493;1526;1004;3024;1497;4550
500600;202010;3434;8506;2418;6890;542;1613;996;2886;1538;4499
500620;202010;7897;20587;5299;15636;1075;3332;1971;5601;3046;8933
500625;202010;546;1492;345;1061;64;200;93;268;157;468
500627;202010;767;1980;459;1428;79;270;147;443;226;713
500630;202010;6670;15313;3822;10560;770;2339;1125;3094;1895;5433
500635;202010;2911;9053;2245;8179;173;664;1539;6160;1712;6824
500640;202010;1711;3744;1123;2960;39;122;766;1990;805;2112
500660;202010;17755;45348;12128;37151;3769;13158;3045;9508;6814;22666
500690;202010;2330;6457;1503;5010;515;1988;78;200;593;2188
500710;202010;2813;7529;2157;6400;603;1900;683;1912;1286;3812
500720;202010;4824;12164;3124;9312;708;2231;932;2876;1640;5107
500730;202010;1080;2664;577;1732;115;330;139;452;254;782
500740;202010;4605;10903;3099;8509;405;1166;1596;4361;2001;5527
500750;202010;971;2462;645;1873;86;246;249;669;335;915
500755;202010;924;2408;508;1599;93;320;105;290;198;610
500769;202010;5130;12493;2767;8008;528;1731;372;865;900;2596
500770;202010;1458;3920;935;2986;165;604;313;984;478;1588
500780;202010;1229;2975;786;2226;163;521;203;537;366;1058
500790;202010;7007;18591;5406;15913;1113;3533;2640;7806;3753;11339
500793;202010;2049;5253;1454;4217;360;1105;470;1257;830;2362
500795;202010;2716;6673;2189;6008;113;284;1744;5042;1857;5326
500797;202010;685;1738;444;1289;134;398;133;391;267;789
500800;202010;3240;7311;1949;5388;613;2000;206;604;819;2604
500830;202010;18349;45640;12416;34691;2567;7708;4510;11855;7077;19563
500840;202010;1392;3395;854;2380;103;296;337;881;440;1177
510010;202010;1794;4039;1188;3255;108;263;845;2359;953;2622
510020;202010;3366;8490;1778;5380;370;1223;426;1135;796;2358
510025;202010;6621;16124;3982;11783;593;1983;1639;4694;2232;6677
510030;202010;2527;5635;1662;4337;349;927;646;1642;995;2569
510035;202010;1222;3179;766;2455;88;304;456;1548;544;1852
510040;202010;2305;5113;1691;4316;181;446;1045;2789;1226;3235
510050;202010;2094;4395;1380;3472;160;432;956;2364;1116;2796
510060;202010;1329;3354;931;2691;196;627;257;690;453;1317
510080;202010;1230;3237;779;2471;260;850;218;600;478;1450
510100;202010;643;1505;444;1191;55;153;234;606;289;759
510120;202010;268;489;146;344;10;22;106;254;116;276
510125;202010;1996;4931;1555;4296;159;571;826;2138;985;2709
510130;202010;1430;3578;1001;2892;213;679;304;901;517;1580
510140;202010;3085;7929;2099;6681;736;2733;750;2259;1486;4992
510160;202010;1705;4379;1239;3774;156;456;892;2788;1048;3244
510170;202010;4427;11667;3208;9693;780;2483;1251;3848;2031;6331
510180;202010;14764;32965;9286;24898;2004;5892;2794;8449;4798;14341
510185;202010;1723;4421;1108;3534;438;1429;275;1137;713;2566
510190;202010;2100;5909;1334;4622;373;1421;237;891;610;2312
510250;202010;16898;42389;12429;35673;2437;7320;6108;18226;8545;25546
510260;202010;1883;7920;1556;7325;260;1313;943;4847;1203;6160
510263;202010;3130;8697;1910;6192;318;1160;320;889;638;2049
510267;202010;4879;13776;2754;9046;500;1750;387;1130;887;2880
510268;202010;1255;3057;947;2591;109;280;623;1702;732;1982
510269;202010;997;2684;604;1935;143;508;187;554;330;1062
510270;202010;2925;8286;1999;6610;349;1289;819;2677;1168;3966
510279;202010;1749;4496;1074;3309;200;692;438;1302;638;1994
510285;202010;1122;2941;768;2325;244;822;165;450;409;1272
510300;202010;3619;9143;2646;7817;375;1141;1549;4794;1924;5935
510305;202010;1434;3933;863;2810;185;643;198;715;383;1358
510310;202010;902;2206;604;1703;169;495;171;506;340;1001
510320;202010;3629;8981;2471;6999;549;1708;613;1710;1162;3418
510325;202010;4272;12525;3142;10442;896;3162;914;3127;1810;6289
510330;202010;2675;8069;1794;6500;338;1227;655;2770;993;3997
510335;202010;4840;13794;3635;11848;552;1951;2035;6789;2587;8740
510336;202010;439;1234;314;1033;52;170;157;573;209;743
510337;202010;1498;4330;952;3330;367;1411;187;662;554;2073
510340;202010;91543;202960;57528;153265;13901;43774;16921;42302;30822;86076
510343;202010;1003;2753;681;2154;121;437;286;857;407;1294
510345;202010;1255;3583;943;2968;159;502;423;1308;582;1810
510350;202010;2847;7301;1854;5616;393;1277;747;2187;1140;3464
510360;202010;1860;3851;1195;3070;70;135;826;2291;896;2426
510370;202010;1769;4952;1279;4112;182;648;741;2492;923;3140
510380;202010;559;1368;306;934;50;179;117;355;167;534
510385;202010;1219;4067;895;3459;93;419;565;2251;658;2670
510390;202010;1257;3301;844;2769;254;853;277;1062;531;1915
510395;202010;725;1626;481;1267;26;73;299;837;325;910
510410;202010;4721;13070;3411;10733;668;2206;1747;5704;2415;7910
510420;202010;2426;5089;1638;4038;135;353;1057;2594;1192;2947
510450;202010;436;1086;254;736;60;175;37;124;97;299
510452;202010;786;2177;562;1754;78;260;324;982;402;1242
510454;202010;944;2574;721;2187;76;230;442;1404;518;1634
510455;202010;935;2560;670;2030;112;365;271;764;383;1129
510460;202010;1764;4367;1253;3601;99;344;802;2219;901;2563
510480;202010;4674;11187;3047;8211;576;1720;1210;3196;1786;4916
510490;202010;1671;4285;1245;3749;177;523;810;2473;987;2996
510500;202010;1501;3750;926;2814;184;584;307;952;491;1536
510510;202010;3436;9965;2523;8339;606;2269;802;2771;1408;5040
510515;202010;5289;13495;3464;10215;801;2667;931;2399;1732;5066
510517;202010;1037;3013;783;2581;240;886;141;402;381;1288
510520;202010;2105;4259;1189;3115;98;254;599;1691;697;1945
510523;202010;1123;2743;830;2278;174;460;484;1368;658;1828
510525;202010;7349;19959;5419;16169;832;2743;2619;7389;3451;10132
510530;202010;553;1421;402;1197;29;93;256;748;285;841
510550;202010;2348;6902;1671;5728;383;1377;749;2577;1132;3954
510558;202010;2273;6048;1629;5032;225;668;747;2517;972;3185
510560;202010;1598;4552;946;3250;197;764;229;857;426;1621
510562;202010;5623;14479;4054;11658;957;2963;1347;4075;2304;7038
510590;202010;3156;7708;2224;6519;174;532;1570;4701;1744;5233
510600;202010;1385;3129;892;2412;159;438;406;1103;565;1541
510610;202010;2614;6285;1782;5194;174;576;1116;3262;1290;3838
510615;202010;2652;6570;1839;5261;302;905;983;2875;1285;3780
510617;202010;985;2953;755;2576;99;389;477;1687;576;2076
510618;202010;1231;3252;845;2583;188;628;388;1137;576;1765
510619;202010;758;1901;483;1434;65;201;139;383;204;584
510620;202010;1417;3170;658;1937;175;631;36;73;211;704
510621;202010;1544;4116;927;2918;200;706;295;848;495;1554
510622;202010;4565;12790;3061;9566;1019;3410;428;1230;1447;4640
510623;202010;2693;6618;1891;5349;461;1523;606;1654;1067;3177
510624;202010;1693;4251;792;2604;94;340;185;554;279;894
510625;202010;2859;6955;1519;4545;248;884;337;1018;585;1902
510626;202010;1497;3630;929;2714;250;843;216;645;466;1488
510627;202010;626;1604;339;1045;81;278;82;267;163;545
510628;202010;1448;3330;950;2660;188;559;358;986;546;1545
510629;202010;1561;4426;1141;3663;220;756;411;1313;631;2069
510630;202010;3337;9191;1923;6500;442;1590;338;1233;780;2823
510631;202010;583;1382;420;1137;14;35;319;896;333;931
510637;202010;3440;8230;2464;6821;622;1945;691;1923;1313;3868
510642;202010;5395;15271;4062;13227;972;3456;1765;5855;2737;9311
510645;202010;991;1901;584;1384;182;400;224;549;406;949
510650;202010;6984;17809;5511;16184;632;1675;3747;12209;4379;13884
510665;202010;1896;4076;1164;2890;244;579;431;1155;675;1734
510670;202010;431;923;249;661;26;69;137;371;163;440
510675;202010;6246;17093;4268;13401;1181;4076;811;2442;1992;6518
510677;202010;2090;5330;1432;4335;196;692;775;2279;971;2971
510680;202010;697;1773;384;1178;72;246;82;225;154;471
510682;202010;1516;4435;1097;3737;374;1417;248;815;622;2232
510685;202010;525;1530;374;1218;58;205;187;603;245;808
510700;202010;4083;9753;2828;7988;264;824;2077;5847;2341;6671
510704;202010;10720;25092;6989;18666;1554;4469;1762;4564;3316;9033
510706;202010;2026;6015;1414;4996;270;974;739;2833;1009;3807
510710;202010;2662;6634;1719;4857;379;1113;568;1546;947;2659
510715;202010;595;1306;430;1078;34;106;210;509;244;615
510718;202010;2366;5299;1371;3954;384;1119;477;1663;861;2782
510719;202010;443;938;256;691;22;61;148;377;170;438
510720;202010;880;2049;567;1575;94;297;267;700;361;997
510724;202010;823;2207;562;1724;82;263;306;913;388;1176
510726;202010;1051;1904;552;1301;64;169;266;630;330;799
510729;202010;600;1395;265;763;34;111;64;201;98;312
510730;202010;2939;7059;1950;5514;247;793;980;2697;1227;3490
510735;202010;1002;2862;758;2515;74;311;558;1823;632;2134
510740;202010;946;2329;595;1673;105;298;265;737;370;1035
510757;202010;506;1554;397;1386;122;466;143;486;265;952
510760;202010;43669;95570;25825;68132;5216;15848;8127;19656;13343;35504
510770;202010;4222;9473;2861;7757;246;628;1934;5501;2180;6129
510774;202010;343;871;237;698;34;100;127;385;161;485
510775;202010;608;1610;387;1244;79;282;82;242;161;524
510776;202010;429;1068;301;831;74;200;100;298;174;498
510777;202010;1491;3979;1056;3410;151;556;666;2135;817;2691
510779;202010;679;1830;523;1577;59;169;299;983;358;1152
510780;202010;3745;9494;2726;8045;665;1947;1161;3870;1826;5817
510785;202010;1966;5202;1133;3671;295;1033;185;684;480;1717
510787;202010;2646;7459;1726;5534;541;1842;196;631;737;2473
510788;202010;588;1392;413;1120;67;190;193;594;260;784
510790;202010;17898;45806;10929;32928;2308;7792;1881;5019;4189;12811
510792;202010;9320;25281;5696;18248;1203;4346;955;2704;2158;7050
510794;202010;1219;3246;825;2568;258;888;155;431;413;1319
510795;202010;8209;21485;5344;16281;1213;4074;1418;4234;2631;8308
510800;202010;1662;4275;1076;3276;339;1047;135;395;474;1442
510805;202010;1490;4121;1032;3268;252;857;347;990;599;1847
510810;202010;621;1265;388;953;105;262;153;400;258;662
510820;202010;751;1429;415;1001;34;100;213;518;247;618
510830;202010;847;2040;606;1731;51;144;427;1303;478;1447
510835;202010;557;1335;363;1052;39;133;220;620;259;753
510840;202010;55830;117181;37571;94815;7331;17410;18179;50906;25510;68316
510850;202010;1798;4309;1013;3059;328;1126;130;362;458;1488
510860;202010;2330;6151;1433;4615;433;1642;115;359;548;2001
510880;202010;714;1998;533;1657;133;429;191;597;324;1026
510885;202010;572;1393;399;1149;81;248;133;379;214;627
510890;202010;646;1874;478;1584;111;389;214;712;325;1101
510895;202010;1284;3247;849;2541;167;597;369;1031;536;1628
520005;202010;2610;6611;2003;5862;582;1710;826;2788;1408;4498
520010;202010;2267;6435;1621;5198;392;1397;504;1435;896;2832
520013;202010;2759;7057;1793;5281;391;1180;513;1646;904;2826
520015;202010;510;1269;362;1049;84;249;142;435;226;684
520017;202010;1185;2967;874;2489;181;544;452;1276;633;1820
520020;202010;400;883;305;764;23;74;237;567;260;641
520025;202010;33332;92677;28432;85782;2864;9372;20320;61010;23184;70382
520030;202010;5708;14405;4542;12767;318;976;3202;8935;3520;9911
520050;202010;406;952;252;687;14;39;159;447;173;486
520055;202010;1832;4395;1169;3107;107;261;658;1707;765;1968
520060;202010;1447;3938;1044;3199;258;885;270;824;528;1709
520080;202010;1783;4616;1328;3994;231;701;646;2133;877;2834
520082;202010;919;2317;716;1979;79;210;383;1110;462;1320
520085;202010;823;2185;634;1873;115;348;310;899;425;1247
520090;202010;843;1644;574;1348;66;108;431;1071;497;1179
520110;202010;38365;102582;26323;82413;7904;28308;2338;6622;10242;34930
520120;202010;205;483;118;344;14;49;48;136;62;185
520130;202010;3697;9006;2885;7746;578;1554;1224;3388;1802;4942
520140;202010;40867;108612;28106;86654;9913;33235;3590;11504;13503;44739
520145;202010;619;1411;420;1130;66;202;245;608;311;810
520150;202010;631;1424;458;1213;75;199;247;665;322;864
520160;202010;754;1752;542;1417;109;272;233;654;342;926
520170;202010;4906;9837;3229;7919;179;504;2478;6023;2657;6527
520180;202010;2232;6014;1809;5406;320;1049;1001;2967;1321;4016
520215;202010;1688;4054;1192;3286;281;833;409;1073;690;1906
520235;202010;593;1354;341;968;37;128;130;358;167;486
520250;202010;1561;3940;1073;3115;325;1011;247;792;572;1803
520260;202010;800;1856;508;1394;97;274;207;590;304;864
520280;202010;721;1740;559;1491;116;312;263;753;379;1065
520310;202010;1055;2279;686;1732;148;428;260;690;408;1118
520320;202010;1632;4361;1219;3686;157;513;660;1957;817;2470
520330;202010;3931;10480;2840;8699;416;1502;1492;4469;1908;5971
520340;202010;2453;5379;1526;4086;184;465;882;2475;1066;2940
520350;202010;2843;6744;2014;5503;587;1685;765;2129;1352;3814
520355;202010;1860;5045;1315;3962;439;1435;270;698;709;2133
520357;202010;740;1774;525;1459;29;75;387;1112;416;1187
520360;202010;715;1849;543;1566;142;432;163;502;305;934
520380;202010;1413;3496;827;2407;89;271;410;1111;499;1382
520390;202010;1016;2222;595;1694;161;497;203;625;364;1122
520393;202010;506;1205;332;931;40;128;151;397;191;525
520396;202010;839;2150;696;1923;39;127;514;1383;553;1510
520400;202010;1636;3961;1252;3439;159;480;851;2320;1010;2800
520410;202010;1973;4436;1180;3214;196;577;456;1187;652;1764
520420;202010;369;849;286;723;21;57;225;546;246;603
520425;202010;1461;3564;802;2326;204;622;149;415;353;1037
520430;202010;2290;5245;1276;3646;228;766;40;107;268;873
520440;202010;2955;7112;1765;5018;428;1334;463;1245;891;2579
520450;202010;11996;28316;7910;22180;2464;7567;1541;4438;4005;12005
520455;202010;712;1933;513;1628;147;498;140;460;287;958
520460;202010;1019;2360;790;2068;72;166;637;1699;709;1865
520465;202010;774;1944;616;1730;77;257;436;1172;513;1429
520470;202010;2030;5231;1548;4584;477;1470;586;1856;1063;3326
520480;202010;941;2580;642;2065;195;655;147;488;342;1143
520485;202010;1549;4370;1295;4019;161;510;923;2862;1084;3372
520490;202010;4004;10960;2975;9300;1009;3261;1058;3450;2067;6711
520495;202010;1603;3496;1206;2959;51;127;973;2392;1024;2519
520500;202010;1201;3235;812;2466;191;630;325;984;516;1614
520505;202010;775;1690;535;1385;61;168;348;888;409;1056
520510;202010;7714;19042;5075;14949;1125;3701;1448;4556;2573;8257
520520;202010;1154;2895;849;2413;199;616;306;877;505;1493
520530;202010;2126;5873;1596;5001;416;1382;671;2170;1087;3552
520540;202010;2915;7576;1813;5417;329;1069;467;1295;796;2364
520545;202010;954;2473;709;2071;149;431;286;852;435;1283
520547;202010;811;2201;648;1929;154;463;326;974;480;1437
520549;202010;13682;36113;11280;32613;1475;4529;7679;22020;9154;26549
520551;202010;4522;12083;3745;10937;391;1328;2659;7594;3050;8922
520552;202010;824;2103;674;1911;140;391;385;1160;525;1551
520570;202010;521;1157;345;907;87;199;134;402;221;601
520580;202010;2208;4997;1668;4367;122;380;1221;3145;1343;3525
520590;202010;1275;3142;875;2502;279;803;225;660;504;1463
520620;202010;7995;21527;6226;18933;1562;4915;2733;8605;4295;13520
520630;202010;743;1893;514;1491;86;267;150;412;236;679
520640;202010;2374;5822;1793;4812;414;1087;757;2116;1171;3203
520650;202010;866;1992;639;1677;91;237;353;987;444;1224
520660;202010;537;1294;283;847;53;183;76;223;129;406
520670;202010;944;2519;788;2297;63;194;524;1499;587;1693
520680;202010;695;1748;519;1468;79;220;268;773;347;993
520690;202010;329;759;220;601;67;169;69;215;136;384
520710;202010;410;989;288;780;13;30;207;550;220;580
520725;202010;1502;3506;1015;2722;116;358;635;1640;751;1998
520735;202010;779;1891;507;1443;107;288;188;581;295;869
520740;202010;2105;4693;1575;4070;269;645;891;2490;1160;3135
520750;202010;664;1581;454;1243;79;206;218;608;297;814
520753;202010;1274;3375;957;2790;181;572;385;1044;566;1616
520760;202010;1207;2687;1059;2508;30;55;970;2335;1000;2390
520780;202010;1494;3476;1056;2856;117;317;536;1445;653;1762
520790;202010;3407;8072;2388;6398;343;928;1283;3611;1626;4539
520800;202010;16321;41900;12611;36465;1896;5712;7367;21912;9263;27624
520810;202010;1329;2753;980;2355;160;397;626;1594;786;1991
520815;202010;569;1725;424;1426;78;287;121;419;199;706
520830;202010;1839;3855;1300;3248;51;103;1075;2667;1126;2770
520840;202010;2574;6845;2080;6202;859;2794;558;1777;1417;4571
520850;202010;644;1645;474;1392;158;541;128;380;286;921
520860;202010;6426;17163;4647;14259;1228;4074;1676;5046;2904;9120
520870;202010;107829;248503;71800;194532;15494;45488;25491;67801;40985;113289
520880;202010;6796;19442;5204;16567;1194;3985;1926;6166;3120;10151
520890;202010;3948;9439;2662;7418;520;1600;1161;3199;1681;4799
520910;202010;4558;11415;2867;8485;696;2225;675;1946;1371;4171
520915;202010;708;1977;412;1308;69;239;138;417;207;656
520920;202010;4380;9769;3056;8097;406;1112;1652;4578;2058;5690
520929;202010;688;1603;512;1343;62;131;273;766;335;897
520940;202010;954;2520;734;2212;43;137;537;1588;580;1725
520945;202010;487;1083;387;942;16;37;272;652;288;689
520960;202010;1051;2499;822;2152;186;430;442;1214;628;1644
520970;202010;2536;6906;1962;5981;475;1633;498;1636;973;3269
520980;202010;776;1873;564;1584;100;294;230;630;330;924
520990;202010;2992;7895;2382;7097;353;993;1555;4749;1908;5742
520993;202010;1147;2692;785;2123;115;352;441;1132;556;1484
520995;202010;2255;5670;1677;4857;260;761;662;1990;922;2751
521000;202010;8572;22230;5590;16850;1111;3467;1699;5087;2810;8554
521010;202010;3597;9326;2673;7719;256;741;1556;4451;1812;5192
521015;202010;794;1940;544;1504;43;136;337;888;380;1024
521020;202010;3255;8263;1885;5618;556;1867;135;424;691;2291
521030;202010;498;1085;332;832;70;157;138;374;208;531
521040;202010;7683;18713;5614;15429;1215;3475;2326;6556;3541;10031
521056;202010;920;2409;716;2103;222;643;195;645;417;1288
521060;202010;967;2565;713;2099;106;327;290;856;396;1183
521080;202010;1128;2413;571;1550;78;227;240;565;318;792
521090;202010;3250;8659;2175;6515;590;1893;275;868;865;2761
521100;202010;1768;4088;1250;3352;200;514;745;2031;945;2545
521120;202010;4655;10860;3352;9252;201;511;1623;5244;1824;5755
521130;202010;999;2233;552;1462;20;61;291;817;311;878
521140;202010;1256;3216;907;2602;113;339;441;1284;554;1623
521150;202010;12496;27189;7672;20275;1295;3980;3576;9657;4871;13637
521160;202010;638;1332;446;1047;51;115;292;663;343;778
521170;202010;1024;2370;735;1948;54;152;488;1258;542;1410
521180;202010;7304;20000;5971;17689;957;3086;3102;8899;4059;11985
521190;202010;10671;26397;6172;18806;1544;5030;1275;4116;2819;9146
521200;202010;708;1707;489;1349;49;144;276;764;325;908
521205;202010;624;1537;466;1282;16;49;352;923;368;972
521210;202010;684;1744;388;1151;76;240;73;163;149;403
521220;202010;3639;8797;2326;6749;396;1273;882;2550;1278;3823
521225;202010;388;817;282;702;54;130;155;395;209;525
521230;202010;1367;3443;1203;3243;378;1032;596;1721;974;2753
521250;202010;31171;82204;23949;71571;8771;27456;6927;22146;15698;49602
521260;202010;555;1273;401;1030;57;149;229;578;286;727
521270;202010;1828;4561;1586;4277;87;200;1209;3283;1296;3483
521280;202010;1785;4762;1321;3984;313;1046;558;1695;871;2741
521290;202010;485;1113;333;918;44;139;209;561;253;700
521295;202010;1125;2429;854;2132;66;117;699;1808;765;1925
521300;202010;1883;4588;1475;4014;282;711;913;2578;1195;3289
521305;202010;724;1709;512;1394;79;199;287;788;366;987
521308;202010;4794;12714;3301;9867;304;890;1937;5701;2241;6591
521310;202010;8228;20882;5654;16549;1211;3882;2361;6594;3572;10476
521340;202010;414;967;302;803;21;59;195;502;216;561
521350;202010;2028;5120;1518;4353;132;467;1069;2919;1201;3386
521370;202010;1231;3119;723;2236;207;734;92;311;299;1045
521375;202010;1301;3139;873;2525;197;570;269;870;466;1440
521377;202010;1496;3133;1087;2632;96;161;869;2215;965;2376
521380;202010;6179;16291;3940;12142;415;1404;1030;3405;1445;4809
521385;202010;658;1556;507;1363;54;135;289;843;343;978
521390;202010;710;1729;492;1406;142;445;180;546;322;991
521400;202010;2669;6123;2062;5380;230;574;1417;3810;1647;4384
521405;202010;1309;3339;941;2697;169;495;464;1316;633;1811
521410;202010;802;2135;592;1765;100;287;296;935;396;1222
521440;202010;1173;2926;830;2403;281;892;227;663;508;1555
521450;202010;3964;11654;2891;9578;763;2531;723;2584;1486;5115
521460;202010;5673;14794;3929;11692;1302;4050;903;2764;2205;6814
521470;202010;605;1631;360;1117;48;144;118;358;166;502
521480;202010;364;913;216;632;46;133;70;198;116;331
521483;202010;2425;5713;1667;4562;352;1033;662;1780;1014;2813
521486;202010;1792;4207;1324;3549;85;210;948;2537;1033;2747
521487;202010;408;991;285;818;43;124;143;423;186;547
521490;202010;907;2376;665;1981;37;130;450;1296;487;1426
521500;202010;2281;5489;1675;4544;101;336;1212;3197;1313;3533
521520;202010;725;1679;508;1358;75;209;209;568;284;777
521523;202010;11675;35354;9507;31828;2676;9803;2466;8555;5142;18358
521525;202010;1062;2394;785;2010;82;210;560;1428;642;1638
521530;202010;2255;5797;1328;3915;277;837;363;1081;640;1918
521540;202010;843;2106;569;1654;74;247;277;830;351;1077
521550;202010;1620;4066;857;2528;149;503;220;657;369;1160
521560;202010;4538;11757;3085;9792;464;1724;1540;5218;2004;6942
521565;202010;642;1529;489;1315;70;172;301;801;371;973
521570;202010;3442;9359;2254;7043;431;1583;204;673;635;2256
521580;202010;493;1179;280;818;39;122;88;234;127;356
521590;202010;645;1498;468;1248;80;237;271;707;351;944
521600;202010;386;1028;249;758;33;80;109;332;142;412
521630;202010;1678;3639;1017;2668;201;571;346;881;547;1452
521640;202010;1833;4220;1211;3331;257;743;419;1137;676;1880
521645;202010;549;1420;345;1043;84;241;110;335;194;576
521680;202010;1104;3318;843;2812;238;866;133;489;371;1355
521690;202010;543;1300;446;1173;60;170;282;726;342;896
521710;202010;3219;7929;2034;5996;369;1239;521;1414;890;2653
521720;202010;2207;5061;1406;3845;146;447;778;2145;924;2592
521730;202010;3584;9908;2717;8396;738;2694;774;2002;1512;4696
521740;202010;3879;10037;2895;8593;689;2209;1078;3348;1767;5557
521760;202010;14834;40257;11359;34894;2826;9616;4192;13517;7018;23133
521770;202010;3026;7170;1957;5447;577;1727;497;1401;1074;3128
521800;202010;6540;17338;4717;14295;1046;3229;1880;6191;2926;9420
521805;202010;490;1181;361;997;108;272;153;439;261;711
521810;202010;625;1462;438;1206;60;165;264;737;324;902
521830;202010;5493;15135;4328;13331;292;1092;3110;9392;3402;10484
521839;202010;743;1739;518;1376;87;264;279;660;366;924
521850;202010;5518;12764;3450;9688;587;1859;652;1758;1239;3617
521860;202010;1536;4040;1045;3174;189;626;320;956;509;1582
521870;202010;695;1933;494;1534;103;353;129;361;232;714
521878;202010;676;1733;455;1299;56;188;246;633;302;821
521880;202010;18725;45381;12531;35800;3157;9465;4393;12784;7550;22249
521890;202010;3085;7961;2010;6052;557;1831;375;1034;932;2865
521900;202010;1484;3455;818;2419;230;648;87;257;317;905
521910;202010;1248;2625;817;2119;76;196;452;1291;528;1487
521920;202010;485;1314;353;1086;63;215;156;462;219;677
521925;202010;760;1959;549;1646;83;260;300;892;383;1152
521930;202010;5413;12938;3552;10073;908;2422;1317;4175;2225;6597
521935;202010;1065;2518;702;1882;70;204;407;1030;477;1234
521940;202010;1345;2941;856;2273;198;588;342;882;540;1470
521945;202010;619;1631;497;1429;109;317;264;774;373;1091
521950;202010;753;1810;517;1436;120;340;210;566;330;906
521960;202010;717;1842;461;1362;55;177;241;660;296;837
521970;202010;2551;6207;2022;5573;169;463;1523;4255;1692;4718
521971;202010;765;1785;537;1448;153;411;150;407;303;818
521973;202010;1411;3621;1124;3193;41;115;881;2486;922;2601
521975;202010;12017;31434;9755;28262;1626;4884;5998;17474;7624;22358
521980;202010;2536;5883;1934;5084;152;391;1450;3908;1602;4299
521990;202010;1073;3015;844;2605;187;609;299;922;486;1531
522000;202010;2633;6844;2103;6188;312;907;1294;4003;1606;4910
522005;202010;341;823;251;685;50;132;124;345;174;477
522010;202010;3976;9607;2786;7688;609;1857;1041;2776;1650;4633
522015;202010;1011;2619;741;2202;233;670;267;832;500;1502
522020;202010;5514;13037;3576;9961;728;2123;1422;4100;2150;6223
522026;202010;778;2059;516;1584;90;304;183;520;273;824
522028;202010;426;1037;314;856;68;190;134;365;202;555
522040;202010;3120;6981;2198;5751;275;771;1478;3821;1753;4592
522045;202010;17479;48246;12801;39894;3025;10172;3502;10612;6527;20784
522050;202010;1108;2885;752;2270;199;662;264;707;463;1369
522060;202010;2953;7634;2039;6114;185;554;1163;3605;1348;4159
522068;202010;1813;4575;1411;4090;119;319;1106;3249;1225;3568
522070;202010;655;1570;526;1379;20;57;438;1127;458;1184
522100;202010;728;1853;488;1469;60;205;254;732;314;937
522108;202010;1020;2531;790;2202;55;186;628;1701;683;1887
522119;202010;1622;3913;1234;3400;205;580;619;1823;824;2403
522130;202010;397;1009;283;849;26;77;194;605;220;682
522140;202010;17992;47387;12406;37306;3187;10255;3299;9518;6486;19773
522145;202010;803;1962;539;1558;151;423;187;547;338;970
522150;202010;1067;2583;750;2064;206;565;222;642;428;1207
522155;202010;1090;2723;832;2316;163;404;463;1339;626;1743
522157;202010;596;1395;486;1254;27;87;385;994;412;1081
522160;202010;5984;15368;3818;11391;1029;3313;297;966;1326;4279
522170;202010;2618;6654;1949;5656;295;866;1095;3242;1390;4108
522180;202010;545;1263;346;905;60;167;83;234;143;401
522185;202010;18882;46339;13220;38536;5131;16272;2759;8762;7890;25034
522190;202010;774;1852;520;1409;94;268;202;533;296;801
522200;202010;1624;4594;1066;3522;221;793;192;577;413;1370
522205;202010;1702;3939;1293;3390;147;407;863;2269;1010;2676
522220;202010;1283;3146;943;2630;114;333;553;1565;667;1898
522230;202010;1122;2822;888;2486;201;681;432;1125;633;1806
530010;202010;171955;458072;137353;406884;21075;68485;80007;233145;101082;301630
110001;202009;3972;11106;2646;8604;603;2105;1019;3371;1622;5476
110002;202009;13009;33607;9176;26956;2531;7932;2438;7260;4969;15192
110003;202009;627;1840;438;1446;103;363;110;348;213;711
110004;202009;11540;29935;7615;22874;1585;5227;2243;6837;3828;12064
110005;202009;2530;6560;1707;5181;352;1167;448;1482;800;2649
110006;202009;1798;4996;1105;3513;192;707;218;657;410;1364
110007;202009;1213;3109;765;2347;244;801;186;704;430;1505
110008;202009;3307;9101;2413;7732;269;842;1594;5447;1863;6289
110009;202009;4345;12151;2770;9257;599;2127;1115;3757;1714;5884
110010;202009;7798;24805;5666;20574;1132;4181;2762;10841;3894;15022
110011;202009;6953;18468;4688;14334;1643;5277;651;2087;2294;7364
110012;202009;15882;39656;9278;27879;2120;6926;838;2680;2958;9606
110013;202009;5299;15355;3769;12202;1504;5147;464;1677;1968;6824
110014;202009;3901;10255;2656;7894;582;1848;1089;3142;1671;4990
110015;202009;5820;14934;3394;10165;741;2414;778;2138;1519;4552
110018;202009;3821;9623;2176;6687;417;1489;595;1823;1012;3312
110020;202009;75960;181111;54092;150966;11950;34456;21929;67567;33879;102023
110025;202009;5222;12587;3439;9487;714;2106;1513;4201;2227;6307
110026;202009;525;1303;377;1091;86;278;157;477;243;755
110028;202009;6873;17444;4087;12365;1021;3382;614;1882;1635;5264
110029;202009;1544;3771;894;2625;198;594;314;976;512;1570
110030;202009;12941;29801;7905;22229;1685;5535;1508;4615;3193;10150
110032;202009;3092;8743;1949;6304;611;1974;394;1384;1005;3358
110033;202009;3691;11463;2809;9827;993;3531;697;2713;1690;6244
110034;202009;3424;7990;2250;6367;674;2156;754;2309;1428;4465
110037;202009;1669;4909;1242;4154;268;882;600;2071;868;2953
110040;202009;2975;8257;2123;6674;608;2069;645;1973;1253;4042
110045;202009;5078;14592;3731;12083;980;3427;1276;4219;2256;7646
110050;202009;1844;4960;1288;3992;498;1687;219;704;717;2391
110060;202009;899;2660;608;1967;206;720;77;246;283;966
110070;202009;1630;5111;1184;4108;373;1384;240;753;613;2137
110080;202009;6374;14762;4700;12767;644;1643;3055;8883;3699;10526
110090;202009;570;1531;407;1240;93;311;184;545;277;856
110092;202009;1189;3418;845;2769;150;506;418;1481;568;1987
110094;202009;2837;8442;2113;7055;884;3154;293;984;1177;4138
110100;202009;1713;5045;1370;4377;374;1268;572;1857;946;3125
110110;202009;1716;4721;1182;3808;389;1284;269;954;658;2238
110120;202009;1331;3834;1005;3193;237;825;340;1045;577;1870
110130;202009;2734;6826;1695;4926;286;935;397;1087;683;2022
110140;202009;2089;6121;1400;4685;343;1211;378;1303;721;2514
110143;202009;1390;3793;944;2891;285;886;156;487;441;1373
110145;202009;901;2348;546;1684;127;410;192;606;319;1016
110146;202009;473;1225;333;1010;66;182;163;540;229;722
110147;202009;799;2074;501;1485;70;228;191;493;261;721
110148;202009;795;2171;453;1494;125;475;49;158;174;633
110149;202009;3003;8213;2052;6676;715;2477;429;1481;1144;3958
110150;202009;2797;6804;1839;5445;543;1772;448;1604;991;3376
110155;202009;748;2177;523;1638;110;374;180;526;290;900
110160;202009;1468;4557;1069;3660;314;1098;256;908;570;2006
110170;202009;2185;5594;1331;3966;244;777;678;1943;922;2720
110175;202009;1689;4710;1196;3838;180;623;526;1771;706;2394
110180;202009;1439;3929;994;3024;142;461;520;1572;662;2033
120001;202009;3285;9613;2683;8724;428;1456;1693;5666;2121;7122
120005;202009;1951;7417;1766;7151;153;689;1407;5783;1560;6472
120010;202009;5366;16090;4530;14836;439;1401;3293;11132;3732;12533
120013;202009;2170;7594;1913;7282;423;1540;1193;4864;1616;6404
120017;202009;2464;7970;2167;7516;348;1208;1371;5039;1719;6247
120020;202009;15100;58515;13843;56055;1086;4968;10899;44464;11985;49432
120025;202009;3127;8884;2498;8122;375;1203;1723;5805;2098;7008
120030;202009;6501;25647;6017;24730;430;2276;4660;19318;5090;21594
120032;202009;1724;7592;1630;7418;107;679;1347;6014;1454;6693
120033;202009;4105;15142;3859;14710;123;698;3367;12709;3490;13407
120034;202009;2671;9681;2278;8990;115;680;1880;7297;1995;7977
120035;202009;3747;14676;3550;14334;286;1378;2910;11750;3196;13128
120038;202009;2700;8657;2294;7982;532;1918;1228;4356;1760;6274
120039;202009;2027;8711;1893;8439;122;773;1527;6737;1649;7510
120040;202009;44574;139847;37765;128658;5343;19269;23473;81089;28816;100358
120042;202009;3352;12469;3084;11973;135;727;2585;9954;2720;10681
120043;202009;1391;5645;1266;5442;39;235;1158;4982;1197;5217
120045;202009;6211;15886;5381;14958;125;510;4894;13459;5019;13969
120050;202009;9370;33737;8558;32487;391;2072;7154;27210;7545;29282
120060;202009;9576;37044;8765;35838;391;2349;7628;30954;8019;33303
120070;202009;3176;10119;2742;9522;250;870;1978;7133;2228;8003
120080;202009;4290;13682;3809;12964;455;1626;2810;9745;3265;11371
130002;202009;3182;12207;2838;11708;202;811;2403;10115;2605;10926
130006;202009;2461;9082;2034;8315;179;752;1520;6245;1699;6997
130008;202009;2683;9338;2369;8876;71;372;2049;7684;2120;8056
130010;202009;3993;11539;3348;10796;84;243;3074;10061;3158;10304
130014;202009;3249;9514;2490;8261;422;1407;1540;5227;1962;6634
130020;202009;2911;11113;2584;10610;136;788;2065;8419;2201;9207
130030;202009;10297;32942;9352;31831;346;1094;8274;28670;8620;29764
130040;202009;4123;11973;3405;11015;199;605;2813;9225;3012;9830
130050;202009;7605;27788;6321;26086;175;870;5721;23866;5896;24736
130060;202009;7668;30076;6549;28599;424;2309;5413;23637;5837;25946
130063;202009;6497;20954;5773;20145;205;870;5243;18399;5448;19269
130068;202009;3908;13431;3300;12538;211;1184;2512;9411;2723;10595
130070;202009;7662;21439;6257;19900;289;881;5172;16991;5461;17872
130080;202009;7377;26000;6420;24889;254;1334;5475;21588;5729;22922
130083;202009;2788;9021;2464;8613;150;585;2088;7364;2238;7949
130090;202009;3594;11044;3181;10526;52;228;2822;9516;2874;9744
130100;202009;8138;24253;6914;22973;69;141;6514;22212;6583;22353
130110;202009;8714;24680;7134;22709;1054;2675;5146;17740;6200;20415
130115;202009;5306;16467;4556;15623;104;364;4011;13969;4115;14333
130120;202009;14351;50549;12606;48205;1094;4591;10214;39450;11308;44041
130130;202009;5453;17006;4186;15324;340;1341;3205;11873;3545;13214
130140;202009;7368;25612;6479;24587;189;1079;5691;21679;5880;22758
130150;202009;3652;13662;3430;13415;79;493;3144;12331;3223;12824
130160;202009;5200;18341;4432;17359;286;1134;3748;15040;4034;16174
130165;202009;3238;12196;3041;11948;123;541;2733;10844;2856;11385
130170;202009;12008;34608;9601;31785;712;2596;7720;26051;8432;28647
130180;202009;4500;14403;4262;14137;41;215;4114;13614;4155;13829
130185;202009;18633;45840;15175;42154;1015;1846;12729;37526;13744;39372
130190;202009;19073;62738;15285;57095;1735;6660;10806;41737;12541;48397
130195;202009;2493;9002;2009;8343;78;455;1692;7004;1770;7459
130200;202009;2612;7279;2147;6673;103;391;1778;5522;1881;5913
130210;202009;1364;5083;1226;4922;99;576;990;3872;1089;4448
130220;202009;2327;7979;1982;7528;52;292;1747;6652;1799;6944
130230;202009;4740;19207;4112;18309;221;1365;3554;15804;3775;17169
130240;202009;12320;36773;9965;33654;182;1092;8959;30238;9141;31330
130250;202009;26661;78861;22825;74527;1677;4951;18335;62340;20012;67291
130255;202009;4604;15032;3994;13966;158;693;3240;11323;3398;12016
130260;202009;267536;741666;217007;668287;58720;191640;99261;316599;157981;508239
130270;202009;9748;34166;8039;31504;1303;5039;5175;21258;6478;26297
130280;202009;3591;14364;3300;14039;89;449;3078;13243;3167;13692
130290;202009;13516;44173;11678;41807;672;2505;9850;36030;10522;38535
130300;202009;4802;16516;4364;15921;147;815;3798;13815;3945;14630
130310;202009;6361;21055;5514;19961;283;1245;4704;17055;4987;18300
130320;202009;3476;11254;2885;10477;380;1334;2093;7893;2473;9227
130330;202009;4683;14900;3776;13799;214;953;3219;11766;3433;12719
130340;202009;24087;73871;20701;70014;1522;4314;17302;60648;18824;64962
130350;202009;4009;14396;3600;13875;155;798;3173;12180;3328;12978
130353;202009;7659;20530;6138;18602;792;2279;4392;13845;5184;16124
130356;202009;5338;16835;4409;15385;781;2664;2657;9849;3438;12513
130360;202009;3020;9849;2602;9269;95;415;2298;8128;2393;8543
130370;202009;5805;22778;5033;21684;304;1681;4040;17348;4344;19029
130380;202009;7562;31056;6997;30254;409;2262;5931;25463;6340;27725
130390;202009;5909;24797;5226;23646;559;2858;3910;17815;4469;20673
130395;202009;2379;7488;2033;6923;187;657;1554;5311;1741;5968
130400;202009;2850;8702;2431;8143;107;328;2164;7376;2271;7704
130406;202009;11179;38810;9367;36581;1779;6948;6223;25319;8002;32267
130410;202009;4297;15154;3650;14059;1085;4401;1671;6619;2756;11020
130420;202009;14035;48505;11661;45512;981;4769;8991;35409;9972;40178
130423;202009;4427;13736;3859;13087;198;854;3372;11348;3570;12202
130426;202009;2825;11163;2627;10926;72;391;2423;10143;2495;10534
130430;202009;4310;12096;3726;11320;247;897;3134;9387;3381;10284
130440;202009;4911;15224;4184;14356;84;363;3873;13374;3957;13737
140002;202009;2248;6608;1951;6242;91;354;1641;5318;1732;5672
140005;202009;3342;9183;2916;8695;136;365;2486;7623;2622;7988
140010;202009;57675;152853;45990;135379;11422;35434;19720;59346;31142;94780
140015;202009;3918;11503;3319;10767;226;716;2895;9552;3121;10268
140017;202009;4475;12355;3871;11592;257;711;3177;9805;3434;10516
140020;202009;5313;15448;4563;14459;232;967;3760;11820;3992;12787
140023;202009;2505;7427;2049;6771;198;662;1559;5277;1757;5939
140028;202009;2053;5280;1735;4873;87;275;1402;3932;1489;4207
140030;202009;5326;13532;4704;12816;343;675;4093;11547;4436;12222
140040;202009;2584;10147;2369;9864;92;563;2140;8788;2232;9351
140045;202009;2604;9534;2187;8961;344;1217;1472;6514;1816;7731
140047;202009;6417;18082;5385;16573;587;1832;3878;12117;4465;13949
140050;202009;1466;4257;1233;3921;123;378;933;3050;1056;3428
140060;202009;1731;4519;1487;4158;117;296;1204;3441;1321;3737
140070;202009;1912;9916;1844;9782;123;856;1532;8048;1655;8904
150010;202009;45846;114305;41351;108523;974;2282;37001;97060;37975;99342
150013;202009;1991;5031;1654;4671;154;305;1284;3880;1438;4185
150020;202009;14580;43738;13468;42286;1489;3906;10952;35559;12441;39465
150030;202009;8901;33318;8085;32309;479;2040;7000;28250;7479;30290
150034;202009;4259;10380;3493;9433;241;583;2902;8030;3143;8613
150040;202009;16523;42670;14498;40431;1282;1979;12092;36720;13374;38699
150050;202009;6997;24282;6373;23455;132;577;5854;21775;5986;22352
150060;202009;22738;61165;18237;54349;2874;8727;11575;35314;14449;44041
150070;202009;6903;25398;6046;24365;240;1109;5391;21968;5631;23077
150080;202009;95422;212471;78858;189772;19075;50218;22571;66523;41646;116741
150085;202009;7908;22557;7152;21662;121;388;6708;20462;6829;20850
150090;202009;9983;36685;9381;35509;742;2767;7468;28568;8210;31335
150095;202009;5732;16603;4985;15668;274;600;4220;13867;4494;14467
150100;202009;2886;10097;2556;9535;207;671;1993;7621;2200;8292
150110;202009;4459;18188;4131;17808;191;867;3793;16490;3984;17357
150120;202009;8247;25414;7808;24892;269;675;6908;22761;7177;23436
150125;202009;767;2019;566;1747;99;369;336;1020;435;1389
150130;202009;22692;65515;19584;60790;3462;9617;12651;41725;16113;51342
150140;202009;262300;601368;220307;543085;33016;78636;126841;325285;159857;403921
150145;202009;4307;13288;3643;12255;953;2949;1923;7214;2876;10163
150150;202009;16293;41647;14180;38932;540;1627;11841;32486;12381;34113
150157;202009;3556;9629;2860;8726;308;926;2002;6412;2310;7338
150160;202009;3050;8961;2833;8646;538;1543;1756;5600;2294;7143
150170;202009;24760;80897;21588;75471;3938;12946;13194;49176;17132;62122
150172;202009;4920;13387;3918;11965;265;725;2960;9348;3225;10073
150175;202009;1635;5132;1361;4604;246;875;785;2682;1031;3557
150178;202009;10614;28384;8780;26251;215;532;7855;23830;8070;24362
150180;202009;22652;79698;20402;77100;1142;3671;17872;69314;19014;72985
150190;202009;6782;22547;6291;21931;242;1089;5595;19397;5837;20486
150195;202009;5170;16499;4864;16021;87;442;4457;14506;4544;14948
150200;202009;5894;17151;5388;16589;65;173;5098;15812;5163;15985
150210;202009;26577;91496;24741;89057;1749;6195;20418;75844;22167;82039
150215;202009;7775;21960;6679;20349;1189;3523;3962;12626;5151;16149
150220;202009;12781;35649;11155;33317;1130;3198;7682;23519;8812;26717
150230;202009;12415;35156;10920;33158;1184;3207;7496;23863;8680;27070
150240;202009;33066;91418;27365;81636;7362;22446;9544;28879;16906;51325
150250;202009;4325;16314;4022;15970;611;2335;3103;12672;3714;15007
150260;202009;2787;8995;2518;8585;157;506;2007;6952;2164;7458
150270;202009;8980;25582;6318;20836;2024;7000;1612;5699;3636;12699
150275;202009;6974;22114;6348;21242;248;933;5477;18279;5725;19212
150276;202009;2380;6255;2031;5842;259;672;1402;4440;1661;5112
150277;202009;5222;13556;4197;12361;326;873;3209;10078;3535;10951
150280;202009;6935;27744;6681;27334;479;1931;5680;23510;6159;25441
150285;202009;3306;11526;2892;10872;238;913;2121;8128;2359;9041
150290;202009;10508;28377;9471;27269;294;613;8554;25245;8848;25858
150293;202009;9510;23319;7232;20319;928;2639;4453;13154;5381;15793
150295;202009;7807;20892;5730;18071;1858;6253;1968;7147;3826;13400
150300;202009;2422;7194;2166;6871;36;127;1974;6297;2010;6424
150304;202009;4154;12245;3415;11102;601;1854;2079;7104;2680;8958
150307;202009;6168;19821;5675;19003;336;1149;4616;15615;4952;16764
150309;202009;6330;18876;5092;16732;866;2829;2850;9813;3716;12642
150310;202009;7349;29014;6997;28596;207;1165;6258;25795;6465;26960
150320;202009;9512;25879;8658;24630;419;1265;6701;19038;7120;20303
150330;202009;14161;45216;13044;43438;1263;3900;9810;33754;11073;37654
150340;202009;2574;7488;2273;7036;335;972;1556;4986;1891;5958
150345;202009;8197;23981;7347;22841;433;1410;6242;19502;6675;20912
150350;202009;9047;22599;8322;21656;709;1319;6842;18394;7551;19713
150360;202009;24570;67087;19633;60838;2088;5140;13879;46039;15967;51179
150370;202009;10931;33054;8954;30385;1024;2920;6472;23699;7496;26619
150375;202009;3614;14448;3253;13926;232;1101;2765;11942;2997;13043
150380;202009;11266;28610;9241;25958;120;451;8167;22961;8287;23412
150390;202009;8018;31887;7177;30559;1084;4031;5100;23021;6184;27052
150400;202009;6648;23595;6372;23082;298;1066;5542;20200;5840;21266
150405;202009;9276;24362;8091;22941;486;1145;6541;19152;7027;20297
150410;202009;1955;6136;1658;5624;226;671;1050;3687;1276;4358
150420;202009;40871;112336;31340;98204;8684;28592;10705;39091;19389;67683
150430;202009;8580;24806;7811;23813;913;2024;6036;19391;6949;21415
150440;202009;5741;18281;5203;17518;847;2510;3522;12551;4369;15061
150442;202009;26923;63547;22072;57459;2340;5929;15240;40593;17580;46522
150445;202009;6323;19493;5544;18311;212;746;4733;15660;4945;16406
150450;202009;5169;21853;4758;21295;380;1823;4054;18251;4434;20074
150460;202009;8431;27642;7699;26710;247;981;6587;23701;6834;24682
150470;202009;21944;56622;19535;53877;363;1021;18367;50678;18730;51699
150475;202009;4946;15471;4259;14432;168;623;3558;12206;3726;12829
150480;202009;13877;44533;12411;42335;2216;6748;8238;30092;10454;36840
150490;202009;8421;29102;7715;28229;288;1178;6808;25086;7096;26264
150495;202009;5322;18062;5079;17718;113;554;4612;15998;4725;16552
150497;202009;2889;9111;2312;8107;507;1805;1205;4558;1712;6363
150500;202009;3338;8525;2955;7987;248;598;2293;6218;2541;6816
150503;202009;4828;12370;3329;10417;984;3317;1066;3827;2050;7144
150506;202009;10460;30920;8773;28630;1875;5344;5429;19721;7304;25065
150510;202009;10004;36111;8632;33539;1300;4714;5592;23007;6892;27721
150520;202009;6986;27351;6681;26970;233;1394;5982;24067;6215;25461
150530;202009;12478;42450;10784;40019;1547;4632;7716;30629;9263;35261
150540;202009;4987;13603;4239;12489;233;620;3533;10482;3766;11102
150543;202009;7431;19842;6112;18182;503;1490;4674;14552;5177;16042
150548;202009;10200;31804;9162;30383;250;1030;8114;26970;8364;28000
150549;202009;2023;5960;1725;5545;47;195;1463;4718;1510;4913
150550;202009;20792;60549;17253;54659;4136;13321;7452;25260;11588;38581
150553;202009;30131;85892;23636;74224;6890;21980;8553;28679;15443;50659
150555;202009;1978;5226;1533;4518;156;353;1045;3252;1201;3605
150560;202009;1870;5651;1657;5230;272;818;979;3214;1251;4032
150563;202009;2574;7687;2160;6973;435;1481;1197;3908;1632;5389
150565;202009;4377;13923;3892;13166;101;441;3246;11092;3347;11533
150570;202009;6332;20093;5891;19477;278;1038;5090;16816;5368;17854
150580;202009;10650;41499;9153;39822;627;3168;7381;33361;8008;36529
150590;202009;8188;28008;7008;26608;177;1043;6367;24088;6544;25131
150600;202009;9785;32244;9070;31372;222;837;8386;29214;8608;30051
150610;202009;2952;8575;2624;8049;87;355;2213;6709;2300;7064
150611;202009;3253;9000;2870;8470;96;354;2527;7412;2623;7766
150613;202009;13606;37235;10248;31473;1891;6168;5048;15469;6939;21637
150616;202009;3550;9642;2582;8038;608;1972;1099;3392;1707;5364
150618;202009;6902;19911;5568;17848;489;1533;3595;12182;4084;13715
150619;202009;6554;18106;5425;16529;203;632;4565;14084;4768;14716
150620;202009;6831;22585;5864;20947;680;2316;3983;14663;4663;16979
150630;202009;6335;17009;5778;16320;403;1063;4832;13782;5235;14845
150635;202009;4894;13348;4100;12071;561;1532;2624;8012;3185;9544
150640;202009;2291;6679;2082;6422;38;103;1931;6039;1969;6142
150650;202009;11697;32405;10144;29896;2974;8304;4444;14327;7418;22631
150655;202009;5847;16679;5287;15863;206;628;4551;13665;4757;14293
150658;202009;4455;12551;3523;11144;545;1816;2119;7088;2664;8904
150660;202009;5771;16446;5116;15518;473;1349;3588;11185;4061;12534
150670;202009;8480;19511;6612;17400;664;1417;5170;14389;5834;15806
150680;202009;70061;203246;53763;177368;12854;41474;23966;89603;36820;131077
150690;202009;2885;7338;2484;6867;83;180;2225;6299;2308;6479
150700;202009;6243;18342;5561;17447;364;921;4403;14239;4767;15160
150710;202009;3814;12635;3458;12060;292;998;2600;9274;2892;10272
150715;202009;5021;14369;4098;12970;303;922;3204;10329;3507;11251
150720;202009;6975;24504;6464;23710;434;1686;5366;19949;5800;21635
150730;202009;12153;36656;10514;34330;1230;4134;7737;26006;8967;30140
150740;202009;4049;11161;3556;10377;316;757;2681;8031;2997;8788
150745;202009;5119;14429;4109;12933;827;2736;2592;8261;3419;10997
150746;202009;1660;5034;1506;4813;80;251;1237;3969;1317;4220
150747;202009;4941;15555;4338;14565;698;2050;2956;10428;3654;12478
150750;202009;3743;11585;3125;10641;223;815;2349;8278;2572;9093
150760;202009;11986;35165;10846;33583;1479;4186;7676;24530;9155;28716
150770;202009;6517;22962;6124;22515;185;550;5580;21151;5765;21701
150775;202009;953;2629;734;2336;132;465;402;1274;534;1739
150780;202009;4560;13642;4037;13032;155;440;3618;11996;3773;12436
150790;202009;5786;16191;4960;15296;248;588;3873;13410;4121;13998
150795;202009;14177;43463;12343;40617;3019;9391;7039;24716;10058;34107
150796;202009;3913;9468;3394;8873;195;453;2871;7632;3066;8085
150797;202009;3979;12258;3429;11476;140;356;2926;9992;3066;10348
150800;202009;13564;42220;12166;40350;1470;4569;9160;31439;10630;36008
150803;202009;7225;22864;6742;22107;409;1197;5686;18891;6095;20088
150805;202009;3514;10733;2973;9940;213;702;2324;7920;2537;8622
150808;202009;6108;17201;4462;14497;1735;6251;610;2276;2345;8527
150810;202009;21207;55062;16063;48865;3421;10593;8046;27218;11467;37811
150812;202009;5510;15287;4822;14157;430;1322;3559;10260;3989;11582
150815;202009;9678;28219;8077;26327;639;2060;6642;22033;7281;24093
150820;202009;12041;32898;10144;30510;1126;2879;7668;24215;8794;27094
150830;202009;11956;43443;11055;42343;431;1823;9558;37679;9989;39502
150835;202009;2393;7862;2021;7205;346;1209;1159;4201;1505;5410
150840;202009;7762;21590;6161;19018;1008;3347;3469;10620;4477;13967
160005;202009;1239;3354;1096;3176;66;224;920;2686;986;2910
160010;202009;2451;6429;2284;6246;20;105;2217;5990;2237;6095
160015;202009;2827;8200;2503;7801;69;234;2306;7211;2375;7445
160020;202009;2087;6676;1824;6347;159;528;1429;5148;1588;5676
160021;202009;1144;4294;1054;4181;61;339;877;3440;938;3779
160023;202009;1276;4479;1124;4225;120;415;787;3147;907;3562
160025;202009;1862;5625;1763;5512;12;38;1715;5383;1727;5421
160027;202009;9076;25094;8095;23838;646;1820;6513;19584;7159;21404
160030;202009;73161;206201;59165;187268;12584;37348;31760;111110;44344;148458
160040;202009;5834;19579;5306;18907;75;334;4973;17849;5048;18183
160050;202009;4834;14546;3785;13128;1424;4729;1309;5690;2733;10419
160053;202009;3829;11721;3460;11253;271;750;2820;9536;3091;10286
160055;202009;916;2657;879;2615;31;98;812;2418;843;2516
160060;202009;25149;66061;20362;60629;950;2942;16111;50420;17061;53362
160070;202009;2754;10368;2462;9916;199;787;1930;8038;2129;8825
160080;202009;3349;10625;2992;10224;31;164;2795;9617;2826;9781
170025;202009;614;1589;439;1326;69;212;227;711;296;923
170030;202009;1234;3733;950;3229;142;486;463;1627;605;2113
170035;202009;1497;3863;1104;3236;90;283;678;1993;768;2276
170040;202009;1902;5322;1496;4748;102;367;924;3047;1026;3414
170070;202009;1878;4361;1327;3655;81;256;785;2250;866;2506
170100;202009;2474;7022;2055;6322;207;575;1291;4113;1498;4688
170105;202009;742;2139;508;1640;133;375;167;566;300;941
170110;202009;976;2935;744;2495;120;411;355;1169;475;1580
170130;202009;1313;3922;935;3190;178;649;440;1535;618;2184
170190;202009;1430;3964;1031;3316;365;1262;166;693;531;1955
170200;202009;2066;4901;1327;3672;201;581;562;1545;763;2126
170210;202009;25005;67767;18879;57483;6436;21383;2394;8308;8830;29691
170215;202009;1345;3561;1064;3168;41;171;835;2475;876;2646
170220;202009;5866;18108;4902;16357;1336;4284;1958;7190;3294;11474
170230;202009;1231;3663;911;3030;268;907;162;593;430;1500
170240;202009;2637;7325;2038;6354;137;510;1443;4389;1580;4899
170255;202009;3965;11464;2809;9351;499;1708;1269;4335;1768;6043
170270;202009;967;2314;635;1840;40;110;369;1068;409;1178
170290;202009;2906;8534;2497;8001;120;394;1949;6435;2069;6829
170300;202009;2021;5388;1622;4791;190;546;1074;3238;1264;3784
170305;202009;638;1740;529;1551;70;242;271;780;341;1022
170307;202009;983;3297;788;2914;109;416;431;1612;540;2028
170310;202009;1594;3951;1098;3152;172;546;512;1472;684;2018
170320;202009;1031;2669;770;2249;65;203;483;1447;548;1650
170330;202009;915;2801;829;2669;40;185;690;2157;730;2342
170360;202009;516;1400;356;1128;25;89;232;698;257;787
170370;202009;1282;3432;916;2801;284;821;234;853;518;1674
170380;202009;1794;5146;1322;4403;90;360;775;2626;865;2986
170382;202009;541;1603;443;1432;31;126;323;1011;354;1137
170384;202009;1543;5497;1253;4928;251;1022;642;2572;893;3594
170386;202009;950;2566;586;1854;81;288;201;616;282;904
170388;202009;619;1763;433;1424;60;215;199;660;259;875
170389;202009;1032;3192;849;2893;42;169;625;2176;667;2345
170390;202009;1752;3972;1313;3435;42;100;1087;2922;1129;3022
170410;202009;576;1667;419;1375;35;144;250;786;285;930
170460;202009;381;983;302;858;39;107;190;559;229;666
170510;202009;923;2616;680;2176;42;161;442;1356;484;1517
170550;202009;6588;17549;4794;14620;1220;3987;1126;3715;2346;7702
170555;202009;1405;3787;1095;3301;69;216;538;1695;607;1911
170560;202009;1033;2877;774;2513;60;206;491;1693;551;1899
170600;202009;1300;3492;1054;3145;232;546;579;1901;811;2447
170610;202009;1643;4341;1174;3638;91;305;713;2186;804;2491
170625;202009;428;1162;265;829;43;130;88;263;131;393
170650;202009;1243;3664;970;3215;132;453;551;1898;683;2351
170700;202009;3353;9862;2491;8192;501;1670;1111;3747;1612;5417
170710;202009;1503;3924;1141;3347;153;490;710;2091;863;2581
170720;202009;1733;4357;1299;3645;278;827;603;1742;881;2569
170730;202009;1063;2869;787;2411;145;394;401;1306;546;1700
170740;202009;2071;6799;1780;6267;160;629;1285;4501;1445;5130
170755;202009;905;2482;623;1993;62;210;310;969;372;1179
170765;202009;1144;2961;794;2397;159;475;342;1081;501;1556
170770;202009;1861;5360;1508;4809;176;536;985;3244;1161;3780
170820;202009;3344;10039;2634;8732;532;1823;1202;4124;1734;5947
170825;202009;990;2281;797;2022;91;207;574;1472;665;1679
170830;202009;1420;3750;1158;3341;152;415;770;2288;922;2703
170900;202009;2779;8556;2327;7906;214;663;1819;6321;2033;6984
170930;202009;3740;10328;2845;8633;658;2110;937;2836;1595;4946
170950;202009;11357;31282;7771;24753;2166;7861;883;3066;3049;10927
170980;202009;462;1223;367;1077;23;84;255;710;278;794
171050;202009;1628;5074;1411;4698;47;214;1174;3887;1221;4101
171070;202009;1344;3835;1148;3544;316;956;491;1783;807;2739
171090;202009;1052;2583;834;2274;78;210;553;1490;631;1700
171110;202009;574;1532;402;1211;63;189;189;527;252;716
171150;202009;1110;2732;672;1982;63;216;406;1187;469;1403
171180;202009;807;2195;537;1677;101;285;219;694;320;979
171190;202009;1782;5943;1533;5506;249;976;911;3375;1160;4351
171195;202009;808;2556;641;2240;84;343;384;1322;468;1665
171200;202009;574;1596;429;1344;85;281;172;538;257;819
171215;202009;364;1011;298;895;34;115;207;603;241;718
171240;202009;762;2517;613;2221;34;181;414;1466;448;1647
171245;202009;668;1992;514;1671;46;182;319;987;365;1169
171250;202009;1029;2701;745;2274;134;433;337;1050;471;1483
171270;202009;477;1674;373;1451;77;293;165;699;242;992
171280;202009;882;2643;691;2296;67;240;398;1371;465;1611
171320;202009;4004;11172;3068;9514;631;1925;1148;3753;1779;5678
171330;202009;2778;7589;2128;6450;434;1295;974;3078;1408;4373
171360;202009;1401;4048;1106;3613;79;285;790;2653;869;2938
171370;202009;696;1754;527;1515;50;139;357;1034;407;1173
171380;202009;1466;3977;1222;3634;119;335;877;2689;996;3024
171395;202009;964;2658;668;2101;57;224;412;1245;469;1469
171420;202009;1967;5732;1412;4615;241;840;639;2094;880;2934
171430;202009;1038;3045;854;2701;60;207;579;1762;639;1969
171488;202009;2334;6917;1827;6058;272;886;936;3276;1208;4162
171500;202009;988;2435;744;2065;43;113;571;1604;614;1717
171510;202009;815;2652;703;2436;45;199;488;1662;533;1861
171515;202009;476;1201;338;979;32;92;206;569;238;661
171525;202009;700;1973;527;1693;25;88;302;928;327;1016
171550;202009;350;1004;262;860;36;131;141;456;177;587
171570;202009;1137;3433;950;3095;125;402;556;1864;681;2266
171575;202009;1820;4850;1164;3660;119;397;521;1645;640;2042
171610;202009;5833;16193;4347;13624;898;3196;1186;3964;2084;7160
171620;202009;2598;7328;2177;6717;110;425;1758;5432;1868;5857
171630;202009;967;2530;756;2240;106;305;513;1571;619;1876
171650;202009;2042;5790;1563;4978;392;1362;458;1603;850;2965
171660;202009;2396;6020;1627;4727;239;628;843;2500;1082;3128
171665;202009;1249;3484;963;3016;168;596;445;1405;613;2001
171670;202009;1929;5092;1469;4332;201;648;784;2322;985;2970
171700;202009;1215;3447;880;2830;114;360;466;1542;580;1902
171720;202009;805;2048;633;1781;51;163;456;1259;507;1422
171750;202009;1312;3669;888;2867;227;756;107;439;334;1195
171780;202009;1238;3155;882;2623;96;319;577;1677;673;1996
171790;202009;1407;4600;1156;4083;215;799;544;1952;759;2751
171800;202009;719;1985;534;1703;64;258;302;945;366;1203
171820;202009;11481;32051;8414;26691;2059;6784;2486;8544;4545;15328
171830;202009;1548;4930;1299;4485;129;525;827;2855;956;3380
171840;202009;771;2048;594;1768;26;77;392;1158;418;1235
171845;202009;650;1581;491;1346;49;171;314;831;363;1002
171850;202009;908;2969;771;2664;77;342;538;1791;615;2133
171855;202009;1047;3192;887;2901;70;228;546;1758;616;1986
171865;202009;374;1166;304;1044;51;191;150;493;201;684
171870;202009;826;2265;582;1814;71;213;298;947;369;1160
171875;202009;1289;3733;1020;3293;42;181;763;2460;805;2641
171880;202009;1175;3511;1029;3317;43;129;815;2694;858;2823
171884;202009;880;2486;649;2086;117;435;237;792;354;1227
171886;202009;1368;3768;969;3105;281;1023;192;626;473;1649
171888;202009;729;2023;502;1599;30;108;312;971;342;1079
171889;202009;379;1176;300;1013;66;243;119;398;185;641
171890;202009;1192;3304;856;2760;177;536;471;1569;648;2105
171900;202009;552;1887;402;1509;85;308;163;640;248;948
172000;202009;583;1719;485;1530;55;172;274;842;329;1014
172010;202009;996;3423;847;3119;71;292;521;1900;592;2192
172015;202009;383;1312;281;1100;71;285;108;441;179;726
172020;202009;2683;7618;2357;7189;171;573;1731;5474;1902;6047
172025;202009;712;1954;521;1638;36;138;380;1189;416;1327
172030;202009;1225;3613;1035;3306;58;224;803;2558;861;2782
172049;202009;1314;3136;886;2546;182;488;441;1397;623;1885
172065;202009;1441;3583;1111;3170;100;218;874;2682;974;2900
172080;202009;2365;6930;1903;6127;108;374;1270;4084;1378;4458
172085;202009;474;1287;306;925;48;138;114;328;162;466
172090;202009;4068;10092;3135;8857;130;378;2379;6798;2509;7176
172093;202009;496;1460;352;1197;20;97;203;655;223;752
172097;202009;703;1838;485;1453;63;197;214;650;277;847
172100;202009;49494;122032;34571;98184;6030;19002;12358;35968;18388;54970
172110;202009;1576;5763;1357;5417;131;548;988;4140;1119;4688
172120;202009;4996;14650;3892;12853;501;1742;2203;7485;2704;9227
172125;202009;372;992;278;833;25;83;162;461;187;544
172130;202009;643;1554;499;1325;23;79;351;849;374;928
172208;202009;2568;6287;2053;5620;193;436;1472;4151;1665;4587
172210;202009;2677;6781;2044;5970;323;1028;1166;3549;1489;4577
210005;202009;18856;54099;14312;46500;4139;13996;5409;18462;9548;32458
210010;202009;1937;5931;1747;5699;73;308;1515;4962;1588;5270
210015;202009;3317;9894;2926;9356;154;505;2414;7731;2568;8236
210020;202009;7359;17303;6222;15967;123;396;5644;14462;5767;14858
210030;202009;4710;15549;4331;14975;216;935;3702;12797;3918;13732
210040;202009;1814;4329;1597;4052;36;94;1361;3385;1397;3479
210043;202009;6191;17669;5220;16326;436;1277;3973;12742;4409;14019
210047;202009;6583;20397;5341;18731;142;728;4604;16125;4746;16853
210050;202009;2234;7523;1749;6620;156;696;1209;4556;1365;5252
210055;202009;1900;6063;1713;5776;70;268;1447;4904;1517;5172
210060;202009;7298;26649;6453;25126;678;2744;4442;17761;5120;20505
210070;202009;7126;20200;6661;19597;45;204;6299;18471;6344;18675
210080;202009;4306;14418;4079;14170;46;276;3750;13108;3796;13384
210083;202009;5581;16041;4568;14961;38;179;4320;14207;4358;14386
210087;202009;3032;8193;2609;7641;112;279;2215;6628;2327;6907
210090;202009;9330;29056;8664;27886;510;1317;7344;23936;7854;25253
210095;202009;6439;20609;5859;19871;251;1083;4867;16835;5118;17918
210100;202009;6811;20707;6059;19498;374;1347;4695;15148;5069;16495
210110;202009;2949;9557;2715;9275;64;359;2427;8234;2491;8593
210120;202009;22961;62659;18911;57319;1893;4669;12764;41284;14657;45953
210125;202009;4435;11785;3862;11110;724;1627;2724;8402;3448;10029
210130;202009;4378;11484;3614;10529;155;333;3054;9018;3209;9351
210135;202009;1450;4351;1243;4018;63;178;1000;3308;1063;3486
210140;202009;19240;50121;14703;44267;2810;8083;8180;26159;10990;34242
210150;202009;4414;10632;3907;9938;143;404;3306;8264;3449;8668
210160;202009;16653;48470;14323;45521;1252;4249;10087;33270;11339;37519
210170;202009;15155;46882;14067;45487;785;2218;12312;40267;13097;42485
210173;202009;2245;8638;2092;8367;109;613;1781;7087;1890;7700
210177;202009;3470;9470;3011;8911;152;329;2614;8033;2766;8362
210180;202009;1450;3866;1273;3655;27;72;1149;3312;1176;3384
210190;202009;5384;14378;4524;13221;75;336;3898;11240;3973;11576
210193;202009;1302;3788;1147;3537;31;140;862;2687;893;2827
210197;202009;2088;6469;1918;6233;144;478;1565;5165;1709;5643
210200;202009;7682;24635;6783;23133;404;1568;5347;18155;5751;19723
210203;202009;7095;20772;6035;19346;418;1410;4775;15622;5193;17032
210207;202009;3986;9661;3064;8681;162;336;2541;7433;2703;7769
210210;202009;8029;26116;7308;25119;149;886;6350;21647;6499;22533
210215;202009;2462;7765;2088;7196;121;631;1565;5306;1686;5937
210220;202009;6138;21232;5808;20724;186;1198;5069;17713;5255;18911
210230;202009;5147;15577;4653;14835;423;1082;3839;12596;4262;13678
210232;202009;11276;35305;9232;32195;1592;5542;5651;21129;7243;26671
210235;202009;3356;10103;2948;9542;168;678;2478;8013;2646;8691
210237;202009;2760;8981;2364;8522;34;199;2181;7862;2215;8061
210240;202009;2597;8168;2378;7777;80;305;1956;6275;2036;6580
210250;202009;5634;17145;5101;16463;79;454;4581;14715;4660;15169
210255;202009;2527;7709;2128;7001;302;1034;1331;4366;1633;5400
210260;202009;5487;16346;4837;15401;248;944;4029;12722;4277;13666
210270;202009;4853;13360;4317;12695;98;453;3836;11198;3934;11651
210275;202009;3535;8882;3076;8310;78;201;2574;6950;2652;7151
210280;202009;5537;15752;4428;14033;258;1005;3229;10105;3487;11110
210290;202009;7235;19413;6451;18434;115;370;5979;17091;6094;17461
210300;202009;33431;90241;27066;81145;1899;5982;19262;59878;21161;65860
210310;202009;3069;7861;2707;7332;121;269;2363;6441;2484;6710
210312;202009;2684;6825;2360;6474;30;135;2213;6003;2243;6138
210315;202009;2983;8268;2542;7766;75;231;2264;7042;2339;7273
210317;202009;4069;12831;3676;12369;149;739;3235;10802;3384;11541
210320;202009;19070;57526;17395;55303;386;1848;15420;48793;15806;50641
210325;202009;3673;10290;3135;9587;109;323;2722;8525;2831;8848
210330;202009;24738;69429;19829;63092;5977;17127;9360;34639;15337;51766
210340;202009;10149;29711;8988;28140;739;2283;6790;21961;7529;24244
210350;202009;9187;26470;8013;25032;157;542;7107;22335;7264;22877
210355;202009;4275;14153;3749;13330;103;515;3170;11332;3273;11847
210360;202009;13652;42541;12158;40317;617;2823;9197;29929;9814;32752
210370;202009;10917;24453;8433;21819;259;432;7685;20394;7944;20826
210375;202009;3288;8719;2504;7659;654;2045;1089;3710;1743;5755
210380;202009;5435;13942;4681;13064;200;473;4014;11313;4214;11786
210390;202009;2584;9049;2380;8693;127;583;1994;7248;2121;7831
210400;202009;4488;13656;3976;13024;135;428;3557;11811;3692;12239
210405;202009;6906;18626;5549;16673;1060;2969;3106;9971;4166;12940
210407;202009;1972;6505;1644;5903;81;350;1318;4673;1399;5023
210408;202009;2531;9354;2365;9103;155;734;1866;7211;2021;7945
210409;202009;3811;13124;3480;12671;115;625;2852;10439;2967;11064
210410;202009;3466;10581;2940;9705;165;657;2204;7222;2369;7879
210420;202009;3848;12279;3476;11624;203;636;2901;9804;3104;10440
210430;202009;2249;6575;1993;6240;81;236;1699;5389;1780;5625
210440;202009;4383;11736;3782;10976;73;274;3432;9870;3505;10144
210450;202009;2417;7160;2070;6655;82;291;1705;5458;1787;5749
210455;202009;4341;11405;3298;10067;955;2945;1509;4889;2464;7834
210460;202009;3723;10550;3141;9802;69;290;2742;8496;2811;8786
210462;202009;1642;4974;1399;4576;39;157;1131;3744;1170;3901
210465;202009;2719;7846;2362;7355;85;384;1844;5600;1929;5984
210467;202009;5932;18800;5147;17758;312;1197;4236;14832;4548;16029
210470;202009;2045;5362;1455;4516;95;210;1107;3588;1202;3798
210480;202009;16359;47803;13467;44220;1137;3419;9870;34988;11007;38407
210490;202009;3702;9364;2977;8355;92;275;2491;6985;2583;7260
210500;202009;6274;24130;5740;23196;376;1835;4687;18833;5063;20668
210510;202009;5959;19664;5212;18856;123;542;4659;17141;4782;17683
210515;202009;3726;10920;3250;10371;264;956;2568;8342;2832;9298
210520;202009;2541;7251;2259;6881;72;252;1927;5818;1999;6070
210530;202009;53995;131303;41733;113071;6972;23158;11098;37965;18070;61123
210535;202009;3088;10424;2887;10103;160;580;2371;8389;2531;8969
210540;202009;14635;42162;12129;38628;1414;4168;8472;28313;9886;32481
210542;202009;6512;15043;5227;13641;347;591;4268;11933;4615;12524
210545;202009;2216;6865;2081;6646;43;180;1835;5799;1878;5979
210547;202009;3580;12771;3161;11940;294;1092;2352;9090;2646;10182
210550;202009;6175;18445;4869;16397;347;1330;3480;12004;3827;13334
210560;202009;3592;10865;3209;10249;125;393;2695;8538;2820;8931
210565;202009;1476;4801;1226;4432;74;394;924;3342;998;3736
210570;202009;10446;28356;9260;26908;320;913;8024;23751;8344;24664
210580;202009;2983;7959;2455;7308;132;275;1941;6085;2073;6360
210590;202009;4285;12669;3700;11920;73;396;3289;10515;3362;10911
210592;202009;2635;7753;2405;7378;25;123;2035;6155;2060;6278
210594;202009;2508;6760;1911;5839;92;280;1395;4413;1487;4693
210596;202009;2543;8989;2276;8451;104;447;1860;6927;1964;7374
210598;202009;1824;5297;1684;5087;63;258;1470;4363;1533;4621
210600;202009;3073;8113;2480;7282;111;278;1903;5650;2014;5928
210610;202009;2707;7561;2318;7079;61;279;1968;5996;2029;6275
210620;202009;2786;7432;2309;6857;62;185;2045;6098;2107;6283
210630;202009;2998;10063;2733;9626;124;589;2242;7801;2366;8390
210632;202009;4433;14192;3925;13458;234;1009;3075;10466;3309;11475
210635;202009;1739;6191;1636;6012;99;363;1349;5051;1448;5414
210637;202009;2431;8030;2107;7563;163;701;1551;5620;1714;6321
210640;202009;4565;16284;4273;15934;69;345;3888;14536;3957;14881
210650;202009;7395;21060;6696;20157;98;363;6039;18176;6137;18539
210660;202009;8129;24086;7166;22538;296;1194;6020;18621;6316;19815
210663;202009;2560;7431;2350;7184;148;352;1991;6282;2139;6634
210667;202009;1943;6294;1745;6002;58;237;1543;5356;1601;5593
210670;202009;4555;15140;4151;14505;121;565;3612;12549;3733;13114
210675;202009;5062;13640;4312;12673;191;468;3639;10961;3830;11429
210680;202009;4601;11102;3848;10193;118;220;3396;9096;3514;9316
210690;202009;7686;23408;6431;22020;246;1039;5686;19629;5932;20668
210700;202009;2726;7668;2141;6812;135;423;1559;5177;1694;5600
210710;202009;4871;15301;4265;14439;107;597;3712;12403;3819;13000
210720;202009;2908;9606;2593;9211;73;426;2243;7892;2316;8318
210725;202009;1298;4367;1132;4118;41;160;823;3129;864;3289
210730;202009;1181;3097;989;2827;49;129;833;2383;882;2512
210735;202009;4671;13555;3977;12631;187;545;3413;11107;3600;11652
210740;202009;5262;14007;4572;13228;94;314;3849;11126;3943;11440
210745;202009;4399;11968;4068;11543;111;353;3687;10420;3798;10773
210750;202009;23456;59633;20228;55555;1814;4599;13944;40569;15758;45168
210760;202009;5949;15580;5025;14603;31;67;4775;14012;4806;14079
210770;202009;6152;15714;5273;14694;66;285;4909;13574;4975;13859
210780;202009;7365;23115;6439;21566;565;1676;4969;16990;5534;18666
210790;202009;4203;13323;3773;12764;187;473;3101;11022;3288;11495
210800;202009;4892;13019;4177;12070;117;469;3647;10378;3764;10847
210805;202009;3924;14214;3726;13921;121;657;3252;12047;3373;12704
210810;202009;4849;14024;4395;13404;307;677;3585;11311;3892;11988
210820;202009;6923;19659;5747;17765;668;2138;3321;10614;3989;12752
210825;202009;6708;20751;6035;19855;269;880;5167;17262;5436;18142
210830;202009;7680;21577;6964;20704;342;784;6047;18433;6389;19217
210840;202009;3183;8486;2838;8019;61;205;2524;7038;2585;7243
210845;202009;6530;17466;5834;16709;28;104;5596;16122;5624;16226
210850;202009;5907;20016;4913;18537;238;1213;3851;14565;4089;15778
210860;202009;21230;54154;17628;49619;910;2190;13956;41509;14866;43699
210870;202009;7328;19045;5774;17264;233;628;5028;15166;5261;15794
210880;202009;4232;12993;3807;12484;188;776;3037;9877;3225;10653
210890;202009;3876;11341;3463;10840;254;682;2787;9049;3041;9731
210900;202009;4555;13255;3460;11182;1336;4634;531;1948;1867;6582
210905;202009;1995;5488;1649;5045;43;72;1500;4707;1543;4779
210910;202009;7257;21893;5997;19821;787;2623;3870;12935;4657;15558
210920;202009;3222;10532;2782;9949;80;442;2465;8723;2545;9165
210923;202009;1527;4558;1304;4201;81;296;923;2983;1004;3279
210927;202009;5203;16424;4565;15664;278;975;3666;12883;3944;13858
210930;202009;2484;8555;2176;7955;156;636;1626;5944;1782;6580
210940;202009;4077;11481;3774;11122;115;477;3431;9975;3546;10452
210945;202009;6516;18667;5836;17854;241;667;4880;15369;5121;16036
210950;202009;5179;14418;3978;12730;620;1574;2583;9032;3203;10606
210955;202009;1572;4962;1350;4576;135;466;931;3238;1066;3704
210960;202009;9072;26919;7797;25020;1257;3728;5037;16995;6294;20723
210970;202009;1336;4124;1061;3649;78;267;773;2620;851;2887
210975;202009;1751;5442;1566;5148;75;276;1233;4067;1308;4343
210980;202009;10167;23489;8900;22179;98;240;8403;21028;8501;21268
210990;202009;16077;45182;12608;40576;704;2476;9310;30832;10014;33308
211000;202009;14594;42445;12167;39447;772;2603;9346;31577;10118;34180
211003;202009;5640;16767;4732;15678;147;579;4065;13754;4212;14333
211010;202009;6373;22702;5706;21888;182;836;5040;19670;5222;20506
211020;202009;8188;23671;7080;22402;280;1056;5938;19323;6218;20379
211023;202009;1957;6343;1819;6159;91;329;1551;5240;1642;5569
211027;202009;3060;9790;2895;9531;194;530;2495;8301;2689;8831
211030;202009;3858;10614;3434;10097;238;545;2811;8523;3049;9068
211040;202009;4580;16498;4234;15885;132;741;3763;13996;3895;14737
211050;202009;9074;23562;8206;22415;88;307;7476;20379;7564;20686
211060;202009;6908;20873;6298;20048;160;668;5565;17699;5725;18367
211065;202009;2186;6094;1810;5617;108;341;1422;4540;1530;4881
211070;202009;7723;24439;6528;22614;519;1826;4990;17467;5509;19293
211080;202009;1302;3582;1036;3158;36;193;791;2274;827;2467
211085;202009;2061;5757;1753;5348;96;229;1496;4751;1592;4980
211090;202009;3173;8703;2861;8339;37;172;2653;7695;2690;7867
211100;202009;6729;16994;6208;16367;51;160;5741;15219;5792;15379
211102;202009;3070;10396;2799;10002;143;656;2412;8524;2555;9180
211105;202009;2378;7467;1966;6708;177;626;1393;4701;1570;5327
211107;202009;4625;14522;3938;13508;139;634;3123;11051;3262;11685
211110;202009;5875;16074;4553;14053;356;1042;3354;10568;3710;11610
211120;202009;44519;108781;36537;99458;5048;12508;23528;68596;28576;81104
211125;202009;2082;6188;1752;5681;49;175;1477;4816;1526;4991
211130;202009;189627;446899;163727;413299;24198;58804;76014;219514;100212;278318
211140;202009;4963;14684;4333;13864;218;611;3649;11803;3867;12414
211150;202009;9326;25502;7842;23566;345;984;6585;19936;6930;20920
211153;202009;2445;7126;1942;6485;249;870;1275;4428;1524;5298
211157;202009;1117;3519;927;3164;31;149;668;2275;699;2424
211160;202009;4084;11508;3205;10233;151;528;2399;7605;2550;8133
211163;202009;1619;5194;1473;4993;79;331;1268;4296;1347;4627
211167;202009;1525;4831;1424;4666;47;214;1229;3978;1276;4192
211170;202009;6425;15834;5961;15302;55;165;5659;14477;5714;14642
211172;202009;2526;6771;2156;6214;113;363;1643;4580;1756;4943
211174;202009;2844;8204;2570;7898;39;199;2398;7326;2437;7525
211176;202009;4244;12046;3286;10640;160;677;2603;8373;2763;9050
211178;202009;4629;10772;3977;10053;34;153;3769;9441;3803;9594
211180;202009;4042;13268;3741;12826;211;781;3105;10675;3316;11456
211190;202009;3055;8948;2588;8259;37;208;2286;7227;2323;7435
211195;202009;1405;3927;1198;3607;71;140;1006;3123;1077;3263
211200;202009;2139;6072;1707;5473;208;631;1184;3887;1392;4518
211210;202009;6232;19168;5626;18362;257;1081;4756;15353;5013;16434
211220;202009;37042;93017;30136;84484;2827;7420;22229;64029;25056;71449
211223;202009;5274;13850;4353;12634;382;1123;3165;9229;3547;10352
211227;202009;1758;5794;1581;5538;66;320;1225;4324;1291;4644
211230;202009;7561;21810;6591;20341;429;1143;5262;16644;5691;17787
211240;202009;8046;25612;7621;25064;135;745;7075;23006;7210;23751
211245;202009;6994;17600;6246;16825;87;215;6031;16269;6118;16484
211250;202009;13155;41182;11859;39408;699;2677;9638;31864;10337;34541
211260;202009;8039;25966;7153;24791;235;1003;6376;22239;6611;23242
211270;202009;10463;33171;8932;31094;386;1764;7209;25265;7595;27029
211280;202009;12794;35062;11382;33274;914;2119;9148;27958;10062;30077
211285;202009;1788;5822;1575;5522;139;530;1142;4106;1281;4636
211290;202009;7422;22325;6673;21343;179;756;5740;18301;5919;19057
211300;202009;7802;22404;6871;20946;197;676;5822;17541;6019;18217
211400;202009;11537;32540;9363;29543;1080;3453;6191;20532;7271;23985
220005;202009;1847;4792;1667;4546;32;116;1412;3779;1444;3895
220010;202009;1493;4251;1214;3753;26;108;942;2887;968;2995
220020;202009;3668;10065;3163;9350;138;489;2601;7621;2739;8110
220025;202009;2244;5095;1927;4632;27;69;1610;3758;1637;3827
220027;202009;1280;3220;1090;2968;20;70;928;2482;948;2552
220030;202009;3347;8426;3127;8134;77;219;2766;7116;2843;7335
220040;202009;7218;21764;6266;19921;1483;4289;3211;10809;4694;15098
220045;202009;1478;4493;1209;4041;31;172;979;3207;1010;3379
220050;202009;4774;12851;4033;11874;61;280;3698;10761;3759;11041
220060;202009;2380;4968;1997;4528;24;56;1872;4232;1896;4288
220070;202009;2462;6167;2096;5634;72;151;1747;4717;1819;4868
220080;202009;737;2066;634;1914;24;89;540;1612;564;1701
220090;202009;1791;4279;1478;3837;20;66;1221;3291;1241;3357
220095;202009;646;1609;602;1562;27;44;540;1425;567;1469
220100;202009;1372;3769;1101;3338;47;161;878;2594;925;2755
220105;202009;2012;6235;1763;5742;116;425;1333;4323;1449;4748
220110;202009;3380;9294;3113;8834;39;194;2784;7790;2823;7984
220115;202009;2725;7862;2521;7590;74;235;2270;6803;2344;7038
220117;202009;1377;3305;1076;2890;8;39;905;2381;913;2420
220120;202009;12854;34222;11723;32818;76;273;11007;30781;11083;31054
220130;202009;1110;2963;945;2735;14;78;855;2447;869;2525
220140;202009;2151;4422;1807;4012;105;263;1580;3454;1685;3717
220150;202009;6336;18723;5781;17794;107;529;4894;14774;5001;15303
220155;202009;1160;3325;925;2891;35;115;648;1990;683;2105
220157;202009;1065;2602;904;2358;23;83;721;1821;744;1904
220160;202009;2873;7901;2472;7174;34;158;2040;5812;2074;5970
220170;202009;1592;4095;1358;3751;12;55;1219;3320;1231;3375
220173;202009;2158;5949;1738;5211;43;190;1384;4025;1427;4215
220177;202009;1983;5603;1876;5484;10;37;1854;5411;1864;5448
220180;202009;1140;2760;927;2403;4;21;718;1742;722;1763
220190;202009;7028;17403;5942;15918;380;1046;4426;12066;4806;13112
220191;202009;1560;4644;1416;4406;83;281;1006;3077;1089;3358
220192;202009;2057;5358;1498;4369;28;91;1205;3450;1233;3541
220194;202009;1737;4898;1536;4578;55;200;1263;3714;1318;3914
220196;202009;2017;5172;1823;4883;28;111;1567;4125;1595;4236
220198;202009;1291;3507;1086;3245;8;38;1001;3007;1009;3045
220200;202009;5143;14739;4471;13869;91;382;3838;11885;3929;12267
220202;202009;2178;6091;1864;5572;28;147;1597;4688;1625;4835
220205;202009;2479;7117;2218;6642;47;183;1871;5527;1918;5710
220207;202009;790;2341;641;2087;61;207;402;1321;463;1528
220208;202009;1677;5114;1376;4531;176;627;807;2613;983;3240
220209;202009;1594;4502;1369;4107;25;105;1124;3335;1149;3440
220210;202009;1741;4218;1496;3838;12;54;1287;3215;1299;3269
220211;202009;1621;4080;1486;3894;16;65;1302;3422;1318;3487
220213;202009;1760;4687;1518;4269;29;102;1215;3330;1244;3432
220217;202009;2179;6438;2029;6263;48;104;1873;5900;1921;6004
220220;202009;10561;27389;8730;24570;590;1471;5841;17341;6431;18812
220225;202009;1039;2708;835;2441;6;36;778;2244;784;2280
220230;202009;5712;14155;4895;13026;162;380;4213;11284;4375;11664
220240;202009;3034;8692;2751;8210;113;359;2234;6667;2347;7026
220245;202009;1764;4054;1359;3550;11;48;1233;3245;1244;3293
220250;202009;2978;8274;2623;7827;17;89;2458;7304;2475;7393
220253;202009;1613;4341;1423;4029;62;206;1196;3304;1258;3510
220255;202009;1920;4477;1632;4071;34;151;1403;3369;1437;3520
220260;202009;4273;13055;3751;12090;164;608;2975;9574;3139;10182
220265;202009;1309;4170;1178;3996;33;167;966;3211;999;3378
220270;202009;6168;19554;5787;18849;211;1018;4830;15215;5041;16233
220271;202009;1510;3829;1308;3551;30;106;1144;3088;1174;3194
220272;202009;1765;5060;1570;4705;51;156;1187;3461;1238;3617
220273;202009;1241;3500;1034;3120;33;124;796;2365;829;2489
220275;202009;2302;5406;1827;4755;37;91;1606;4203;1643;4294
220277;202009;2154;5394;1836;4931;26;71;1552;4101;1578;4172
220280;202009;1669;3864;1380;3484;25;78;1160;2911;1185;2989
220285;202009;1445;3589;1232;3345;10;38;1134;3057;1144;3095
220290;202009;6661;18445;5251;16445;381;1274;3779;12137;4160;13411
220300;202009;1974;5669;1601;5177;36;188;1332;4290;1368;4478
220310;202009;3101;8167;2402;7346;42;207;2006;6096;2048;6303
220320;202009;3054;8902;2343;7551;77;370;1825;5690;1902;6060
220323;202009;1645;4770;1297;4205;53;210;1064;3384;1117;3594
220325;202009;1263;3724;1078;3415;21;103;896;2784;917;2887
220327;202009;1519;4277;1317;3949;44;184;1087;3170;1131;3354
220330;202009;4475;10617;3764;9755;60;182;3397;8739;3457;8921
220335;202009;1674;5025;1503;4808;33;108;1338;4297;1371;4405
220340;202009;1874;4903;1434;4162;58;186;976;2735;1034;2921
220342;202009;1172;3371;1044;3180;51;186;818;2474;869;2660
220345;202009;3116;6991;2402;5963;15;53;2178;5380;2193;5433
220350;202009;3333;8433;2644;7406;141;412;1872;5270;2013;5682
220360;202009;1243;3166;983;2738;19;54;781;2167;800;2221
220370;202009;8693;25146;7883;23848;164;711;6866;20506;7030;21217
220375;202009;1595;4512;1410;4286;2;13;1337;4089;1339;4102
220380;202009;1490;3520;1205;3113;15;40;1053;2692;1068;2732
220385;202009;863;2055;689;1733;8;24;597;1481;605;1505
220390;202009;10498;27070;8007;23174;2047;5811;2825;9125;4872;14936
220400;202009;1490;3520;1132;2972;24;74;865;2195;889;2269
220410;202009;1178;3208;948;2815;50;149;757;2207;807;2356
220415;202009;807;2050;675;1839;21;59;542;1454;563;1513
220420;202009;2048;5641;1639;4861;54;169;1260;3685;1314;3854
220430;202009;2483;6630;2329;6409;77;254;1984;5391;2061;5645
220435;202009;1768;4520;1529;4168;46;156;1257;3356;1303;3512
220440;202009;2386;7422;2038;6878;90;376;1714;5693;1804;6069
220450;202009;2515;6479;2048;5897;64;219;1731;5001;1795;5220
220455;202009;1286;3953;1219;3859;11;59;1085;3433;1096;3492
220460;202009;988;2411;916;2318;37;91;782;1959;819;2050
220465;202009;2347;7229;2065;6785;184;606;1509;5077;1693;5683
220470;202009;3581;9797;3207;9209;91;235;2606;7391;2697;7626
220480;202009;2805;7189;2252;6293;206;464;1467;4168;1673;4632
220490;202009;2482;6151;2141;5717;25;124;1867;4913;1892;5037
220500;202009;2819;7182;2449;6584;59;191;1991;5226;2050;5417
220510;202009;2581;7251;2028;6257;78;222;1582;4917;1660;5139
220515;202009;1651;3967;1509;3770;41;63;1310;3273;1351;3336
220520;202009;4950;12770;4461;12082;105;291;3877;10432;3982;10723
220525;202009;1336;3332;1150;3097;9;42;1056;2808;1065;2850
220527;202009;1298;3628;1104;3346;13;54;944;2912;957;2966
220530;202009;1436;3558;1230;3295;30;96;1126;2988;1156;3084
220535;202009;808;2200;756;2131;28;88;616;1729;644;1817
220540;202009;3233;10255;3022;9859;122;418;2579;8383;2701;8801
220545;202009;1416;4242;1297;4048;69;259;1075;3315;1144;3574
220550;202009;8652;26462;7639;24693;496;1725;5739;18396;6235;20121
220551;202009;1422;4010;1241;3699;28;119;1013;2949;1041;3068
220552;202009;1599;4606;1299;4073;26;129;1044;3155;1070;3284
220553;202009;1740;4451;1436;4051;61;109;1156;3403;1217;3512
220554;202009;908;2346;660;1941;50;119;426;1244;476;1363
220555;202009;2340;6874;2075;6520;42;171;1705;5482;1747;5653
220556;202009;1212;3496;1047;3183;57;228;751;2188;808;2416
220557;202009;1629;4954;1367;4409;68;256;1002;3132;1070;3388
220558;202009;1402;3599;1099;3181;18;78;948;2716;966;2794
220559;202009;1787;4364;1509;3939;10;24;1224;3235;1234;3259
220560;202009;1771;3942;1427;3504;38;73;1298;3213;1336;3286
220570;202009;7165;21327;6511;20406;448;1406;5157;16281;5605;17687
220580;202009;6930;18886;6327;17913;82;295;5727;16102;5809;16397
220585;202009;2024;6357;1673;5710;45;154;1365;4720;1410;4874
220590;202009;1359;3614;1106;3232;73;203;788;2338;861;2541
220595;202009;2551;6915;2306;6578;21;103;2057;5801;2078;5904
220600;202009;1399;3108;1175;2832;88;108;978;2446;1066;2554
220605;202009;1611;4710;1371;4281;19;116;1107;3349;1126;3465
220610;202009;2773;8026;2589;7751;32;138;2417;7216;2449;7354
220620;202009;7860;24109;7224;23250;173;896;6563;20877;6736;21773
220630;202009;371;1082;284;920;22;76;192;616;214;692
220635;202009;1658;5161;1457;4720;52;249;1113;3503;1165;3752
220640;202009;2476;6843;2107;6311;80;315;1703;5043;1783;5358
220650;202009;2055;5665;1780;5248;38;141;1424;4201;1462;4342
220660;202009;2621;8131;2228;7467;79;394;1853;6070;1932;6464
220665;202009;1226;3699;1031;3372;30;170;849;2700;879;2870
220667;202009;1620;4987;1452;4670;57;216;1176;3761;1233;3977
220669;202009;1607;4884;1537;4776;50;236;1360;4129;1410;4365
220670;202009;2199;5683;1763;5071;17;80;1528;4394;1545;4474
220672;202009;3238;7856;2609;7093;101;328;2306;6201;2407;6529
220675;202009;1263;3451;1124;3197;30;97;930;2610;960;2707
220680;202009;2696;7272;2568;7090;103;239;2348;6521;2451;6760
220690;202009;1587;4157;1397;3870;61;170;1106;3075;1167;3245
220695;202009;901;2462;830;2340;21;66;723;2023;744;2089
220700;202009;9973;24443;8003;21721;348;973;6102;16472;6450;17445
220710;202009;902;2465;664;2016;35;106;496;1477;531;1583
220720;202009;2117;4990;1903;4704;16;69;1657;4041;1673;4110
220730;202009;1319;3669;1106;3304;14;77;934;2726;948;2803
220735;202009;972;2258;759;1932;18;62;627;1533;645;1595
220740;202009;1375;3538;1098;3183;30;78;914;2702;944;2780
220750;202009;3847;9738;3354;9029;192;468;2897;7836;3089;8304
220755;202009;1326;3228;1100;2892;23;88;898;2297;921;2385
220760;202009;3138;8552;2739;8014;69;216;2459;7259;2528;7475
220770;202009;23427;69012;19696;62572;5948;19926;6784;22502;12732;42428
220775;202009;1164;2917;1034;2755;14;46;988;2617;1002;2663
220777;202009;1603;4050;1214;3453;30;78;932;2666;962;2744
220779;202009;1295;3267;1114;3006;19;61;973;2608;992;2669
220780;202009;5607;14045;4870;12931;206;654;3974;10313;4180;10967
220785;202009;1486;3257;1301;3020;9;23;1253;2894;1262;2917
220790;202009;10235;28811;9186;27311;218;982;7702;22673;7920;23655
220793;202009;927;2425;734;2084;11;30;610;1753;621;1783
220795;202009;1391;3561;1220;3326;18;69;1087;2951;1105;3020
220800;202009;18092;39891;15297;36207;651;1464;11779;27853;12430;29317
220810;202009;3048;8374;2558;7504;55;161;2095;6093;2150;6254
220820;202009;4993;12968;4306;11968;279;677;3249;9030;3528;9707
220830;202009;7304;19269;6540;18211;245;782;5421;14880;5666;15662
220840;202009;12378;37724;10281;33413;2315;7200;4744;16080;7059;23280
220850;202009;3144;9644;2801;9218;59;313;2467;8130;2526;8443
220855;202009;692;1742;599;1617;15;50;543;1457;558;1507
220860;202009;1049;2598;907;2372;17;68;817;2105;834;2173
220865;202009;2447;6435;1912;5494;91;340;1393;3870;1484;4210
220870;202009;2979;8261;2482;7605;33;168;2278;6959;2311;7127
220880;202009;5318;12466;4563;11530;85;305;4151;10372;4236;10677
220885;202009;1407;4212;1158;3793;54;190;908;3023;962;3213
220887;202009;1583;3361;1315;3015;13;30;1220;2774;1233;2804
220890;202009;1418;4298;1239;4023;46;161;1027;3386;1073;3547
220900;202009;2032;4800;1694;4359;33;80;1479;3791;1512;3871
220910;202009;1522;4131;1273;3770;54;161;1050;3135;1104;3296
220915;202009;965;2598;780;2261;5;20;590;1657;595;1677
220920;202009;1436;4428;1239;4164;57;242;1017;3439;1074;3681
220930;202009;1752;4670;1469;4265;20;62;1366;3954;1386;4016
220935;202009;1094;3122;881;2672;23;95;580;1663;603;1758
220937;202009;1451;3820;1242;3497;26;92;984;2730;1010;2822
220940;202009;1546;4274;1237;3721;38;124;953;2835;991;2959
220945;202009;446;1539;384;1395;21;120;280;976;301;1096
220950;202009;1432;3275;933;2503;18;62;739;1916;757;1978
220955;202009;1623;4115;1350;3638;24;69;1153;3060;1177;3129
220960;202009;811;2045;602;1695;19;60;423;1130;442;1190
220965;202009;1789;4854;1559;4508;21;130;1353;3820;1374;3950
220970;202009;1951;4619;1431;3843;34;89;1195;3181;1229;3270
220975;202009;704;1967;600;1835;16;87;532;1563;548;1650
220980;202009;1149;3225;1018;3050;39;147;842;2496;881;2643
220985;202009;1231;3208;1067;2968;45;129;862;2329;907;2458
220987;202009;1430;4251;1245;3919;54;205;1002;3136;1056;3341
220990;202009;1716;4668;1506;4361;19;102;1269;3608;1288;3710
220995;202009;1068;3225;866;2859;36;126;631;2075;667;2201
220997;202009;2373;7122;2190;6829;48;217;1951;6011;1999;6228
221000;202009;4499;12185;3965;11387;85;391;3379;9566;3464;9957
221005;202009;1472;3846;1341;3633;20;111;1161;3027;1181;3138
221010;202009;1248;2813;995;2506;20;59;858;2112;878;2171
221020;202009;1526;4657;1419;4456;21;80;1077;3344;1098;3424
221030;202009;1651;4067;1412;3776;22;63;1214;3291;1236;3354
221035;202009;1510;3885;1315;3619;23;30;1157;3274;1180;3304
221037;202009;676;1850;558;1647;7;24;395;1115;402;1139
221038;202009;517;1455;403;1249;12;42;278;860;290;902
221039;202009;868;2339;744;2129;23;102;598;1630;621;1732
221040;202009;4036;11949;3520;11025;158;551;2763;8644;2921;9195
221050;202009;3919;10190;3434;9574;69;239;3087;8596;3156;8835
221060;202009;8521;23514;7029;21148;276;753;5677;17229;5953;17982
221062;202009;1171;3746;992;3446;42;188;795;2728;837;2916
221063;202009;1074;2919;919;2696;55;182;714;2050;769;2232
221065;202009;2615;6705;2299;6138;20;74;2022;5305;2042;5379
221070;202009;3359;10383;2705;9007;296;980;1657;5641;1953;6621
221080;202009;3524;8605;2858;7622;63;227;2331;6100;2394;6327
221090;202009;1414;3603;1156;3181;8;28;994;2672;1002;2700
221093;202009;1379;3863;1251;3600;134;373;844;2386;978;2759
221095;202009;891;2303;741;2071;11;35;618;1696;629;1731
221097;202009;840;2177;644;1827;23;70;472;1275;495;1345
221100;202009;117022;311287;96942;276676;10297;31487;62397;173070;72694;204557
221110;202009;9885;29366;9050;28278;145;731;8092;25027;8237;25758
221120;202009;4816;13175;4281;12308;160;486;3708;10636;3868;11122
221130;202009;5427;14060;4047;11377;777;2066;1948;5524;2725;7590
221135;202009;1664;4323;1492;4094;48;146;1314;3608;1362;3754
221140;202009;1335;3115;1121;2840;11;37;1008;2503;1019;2540
221150;202009;1134;2773;871;2314;22;97;673;1668;695;1765
221160;202009;728;1800;638;1682;14;18;519;1375;533;1393
221170;202009;999;2849;905;2678;20;68;779;2279;799;2347
230010;202009;3060;7998;2510;7049;37;133;2039;5598;2076;5731
230015;202009;3059;9789;2673;9021;172;652;1873;6281;2045;6933
230020;202009;12917;40517;12042;39172;332;1366;10207;33019;10539;34385
230030;202009;13055;32309;10873;29468;188;570;9515;25758;9703;26328
230040;202009;4464;11461;3693;10213;50;239;3075;8355;3125;8594
230050;202009;2796;8630;2100;6979;338;1085;936;3038;1274;4123
230060;202009;2379;6472;1882;5593;39;165;1475;4312;1514;4477
230070;202009;3969;10455;3182;8934;148;453;2240;6205;2388;6658
230075;202009;8966;29025;8187;27644;475;1985;6492;21638;6967;23623
230080;202009;3086;6427;2330;5494;6;18;2126;5029;2132;5047
230090;202009;4388;10695;3691;9593;177;444;2952;7628;3129;8072
230100;202009;18079;46730;15857;43702;1238;3433;11330;31432;12568;34865
230110;202009;12757;37746;10681;33657;1736;5449;5616;17841;7352;23290
230120;202009;7462;19892;6543;18382;526;1308;4800;13681;5326;14989
230125;202009;3141;8277;2549;7319;87;293;1961;5551;2048;5844
230130;202009;5756;17641;4636;15148;331;1130;3065;9871;3396;11001
230140;202009;3439;10261;2898;9131;101;408;2199;6773;2300;7181
230150;202009;1590;4747;1309;4120;205;543;758;2496;963;3039
230160;202009;6523;16817;5557;15296;195;674;4503;12182;4698;12856
230170;202009;6286;17755;5081;15287;304;896;3643;10793;3947;11689
230180;202009;1654;4544;1399;4066;20;89;1129;3176;1149;3265
230185;202009;4437;12468;3731;11285;264;884;2766;8323;3030;9207
230190;202009;13279;38456;11126;34455;1467;4729;6304;19372;7771;24101
230195;202009;5328;15581;4809;14586;373;1105;3618;10963;3991;12068
230200;202009;5046;13833;4214;12258;152;492;3213;9147;3365;9639
230205;202009;4155;12225;3632;11422;204;673;2727;8525;2931;9198
230210;202009;10368;24856;8705;22607;344;1136;6832;17406;7176;18542
230220;202009;14003;34983;12203;32373;624;1656;10018;26335;10642;27991
230230;202009;6904;20545;6119;18940;402;1222;4494;13902;4896;15124
230240;202009;13061;34759;11225;31620;280;1179;9246;25439;9526;26618
230250;202009;8985;25092;8354;24103;243;846;6672;18692;6915;19538
230260;202009;14842;43937;12796;40272;1817;5499;7191;23181;9008;28680
230270;202009;7644;20450;5818;16989;504;1425;3798;11172;4302;12597
230280;202009;20481;54399;16608;47832;472;1980;13067;36224;13539;38204
230290;202009;4901;13447;4042;11823;257;668;3055;8934;3312;9602
230300;202009;4835;12830;4362;12185;102;294;3807;10588;3909;10882
230310;202009;4608;13077;3877;11779;133;581;2784;8211;2917;8792
230320;202009;7816;22396;6557;20086;241;978;5005;14986;5246;15964
230330;202009;4680;12744;3673;10795;142;470;2745;7885;2887;8355
230340;202009;3668;11242;3115;10113;265;924;2092;6688;2357;7612
230350;202009;18008;49229;15696;45772;846;2822;10532;30915;11378;33737
230360;202009;2968;7782;2317;6636;142;399;1557;4413;1699;4812
230365;202009;3052;7520;2505;6706;54;252;2130;5602;2184;5854
230370;202009;59055;163149;50018;149626;7420;22409;29685;90212;37105;112621
230380;202009;6293;17475;4926;14942;131;531;3621;10753;3752;11284
230390;202009;3428;10068;2951;9288;97;416;2268;7039;2365;7455
230393;202009;3287;9679;2617;8301;85;432;2001;6098;2086;6530
230395;202009;5786;15703;5025;14422;320;859;3569;10262;3889;11121
230400;202009;5469;14994;4851;13971;101;505;3870;10821;3971;11326
230410;202009;14199;41671;11637;36918;887;3068;7961;25204;8848;28272
230420;202009;29152;79376;23541;69560;2857;8795;13170;38644;16027;47439
230423;202009;4727;13891;4108;12648;86;385;3351;10119;3437;10504
230425;202009;5625;17179;5096;16088;409;1365;3616;11336;4025;12701
230426;202009;2768;7215;1992;5698;28;103;1492;4180;1520;4283
230427;202009;1852;5206;1313;4062;62;200;858;2550;920;2750
230428;202009;9661;25686;8244;23530;1116;3147;4835;13775;5951;16922
230430;202009;5033;14006;3936;12076;158;530;2931;8860;3089;9390
230435;202009;5960;15536;4935;13702;613;1604;2965;8330;3578;9934
230440;202009;416606;1026316;344179;919171;34267;97034;221121;583220;255388;680254
230445;202009;4319;11376;3478;9921;184;527;2373;6612;2557;7139
230450;202009;3622;10331;3132;9608;247;944;2260;6700;2507;7644
230460;202009;2150;5937;1863;5478;58;232;1554;4539;1612;4771
230465;202009;4079;11367;3439;10129;103;400;2583;7317;2686;7717
230470;202009;11313;37137;10092;34874;889;3444;7125;24244;8014;27688
230480;202009;1458;4190;1238;3789;68;272;914;2686;982;2958
230490;202009;2540;7102;2120;6312;165;559;1324;3702;1489;4261
230495;202009;5739;16925;5040;15672;377;1390;3335;10251;3712;11641
230500;202009;9456;29957;8443;28088;277;1124;6853;22756;7130;23880
230510;202009;1633;4885;1267;4084;171;603;634;2006;805;2609
230520;202009;4562;12806;3934;11675;323;903;2754;8208;3077;9111
230523;202009;15722;45993;12453;38974;2804;8774;3192;10660;5996;19434
230526;202009;3750;10600;3175;9614;185;516;2304;7038;2489;7554
230530;202009;5439;16857;4548;15097;295;1089;3280;10741;3575;11830
230533;202009;4494;10630;3719;9391;95;266;3096;7688;3191;7954
230535;202009;5325;14735;4486;13312;250;732;3082;9279;3332;10011
230540;202009;16237;43903;13887;40416;276;1084;11426;32958;11702;34042
230550;202009;21175;55517;16918;48239;1524;4473;10783;30559;12307;35032
230560;202009;8157;19702;6559;17183;54;220;5629;14621;5683;14841
230565;202009;3050;8429;2547;7502;99;395;1928;5561;2027;5956
230570;202009;3457;8795;2932;8073;80;227;2398;6590;2478;6817
230580;202009;10959;28239;9333;25891;338;956;7698;21240;8036;22196
230590;202009;8981;25296;7405;22408;406;1418;5443;15945;5849;17363
230600;202009;3669;9466;2868;8049;75;217;1994;5611;2069;5828
230610;202009;6710;18354;5913;17011;457;1275;4629;13246;5086;14521
230620;202009;2129;5704;1609;4681;125;391;973;2724;1098;3115
230625;202009;8069;22710;6746;20277;2025;6299;1817;5901;3842;12200
230630;202009;10771;31849;9293;28891;1440;4241;5357;17061;6797;21302
230640;202009;27943;83758;25110;79251;1204;4706;19955;62065;21159;66771
230650;202009;5212;13944;4411;12553;128;492;3593;9989;3721;10481
230655;202009;9358;31344;8778;30322;645;2263;6948;24309;7593;26572
230660;202009;6006;17821;4895;15849;160;841;3949;12517;4109;13358
230670;202009;6234;14758;4537;12024;140;450;3648;9434;3788;9884
230680;202009;2664;7231;2248;6493;132;357;1609;4677;1741;5034
230690;202009;7164;21066;6147;19038;397;1402;3871;11747;4268;13149
230700;202009;10268;26187;8257;22477;316;839;6104;16331;6420;17170
230710;202009;6830;21387;5939;19472;631;2000;3948;12850;4579;14850
230720;202009;1895;5573;1530;4822;120;354;1027;3164;1147;3518
230725;202009;4041;11870;3608;11109;388;1359;2096;6329;2484;7688
230730;202009;56947;153635;44400;134300;9762;31929;14791;47091;24553;79020
230740;202009;6067;16672;5125;15151;130;456;4108;12093;4238;12549
230750;202009;8408;22221;6940;19792;161;557;5515;15314;5676;15871
230760;202009;11122;29186;9654;26967;505;1674;7287;19876;7792;21550
230763;202009;4905;13148;4099;11705;118;537;3306;9120;3424;9657
230765;202009;41173;111244;33981;99468;5250;15927;17147;49797;22397;65724
230770;202009;25532;62911;21247;57206;2171;5898;14043;37914;16214;43812
230780;202009;6427;22307;5842;20919;822;2889;3415;12572;4237;15461
230790;202009;3024;8632;2714;8122;115;469;2032;5906;2147;6375
230800;202009;8218;25937;7189;23841;894;3172;4177;13638;5071;16810
230810;202009;11357;33825;10126;31831;396;1456;7816;24129;8212;25585
230820;202009;3405;11072;2786;9685;264;1061;1638;5448;1902;6509
230830;202009;7568;20456;6422;18527;132;550;5297;14898;5429;15448
230835;202009;4258;10091;3228;8445;89;265;2599;6684;2688;6949
230837;202009;3139;9551;2730;8832;114;517;2162;6802;2276;7319
230840;202009;9152;26580;7849;24380;832;2455;5576;17483;6408;19938
230850;202009;9683;27805;8090;24633;358;1269;5831;17483;6189;18752
230860;202009;5257;13195;4338;11875;66;218;3821;10397;3887;10615
230870;202009;16619;40246;14197;36215;398;1119;11608;29089;12006;30208
230880;202009;2128;6396;1939;6079;50;261;1533;4677;1583;4938
230890;202009;4567;14519;4134;13645;323;1170;2985;9695;3308;10865
230900;202009;2993;8573;2542;7702;187;631;1711;5076;1898;5707
230910;202009;3137;8364;2517;7383;64;290;2035;5946;2099;6236
230920;202009;4609;12910;3862;11723;129;532;3041;9038;3170;9570
230930;202009;6547;18183;5453;16215;298;862;3795;11279;4093;12141
230940;202009;8066;20292;6924;18539;195;485;5782;15367;5977;15852
230945;202009;6530;18613;5591;16815;299;1057;3971;11704;4270;12761
230950;202009;6162;15543;5429;14539;95;247;4700;12606;4795;12853
230960;202009;13368;38503;11727;35420;1954;5858;5837;17817;7791;23675
230970;202009;13632;35975;11320;32342;1721;4856;6423;18642;8144;23498
230980;202009;2694;7809;2360;7225;337;975;1460;4609;1797;5584
230990;202009;1656;4622;1357;4022;64;264;965;2729;1029;2993
231000;202009;2495;6647;2019;5697;78;191;1484;4107;1562;4298
231010;202009;3573;8315;2808;6989;42;164;2443;5893;2485;6057
231020;202009;8049;25065;7153;23295;1310;3921;4057;13800;5367;17721
231025;202009;7525;20600;6517;18942;739;2082;4519;13271;5258;15353
231030;202009;7396;21771;5762;18321;970;2958;2953;9458;3923;12416
231040;202009;2945;8430;2553;7696;127;381;1986;5904;2113;6285
231050;202009;11676;29834;9365;25738;641;1709;6964;18713;7605;20422
231060;202009;2923;8132;2553;7542;59;187;2087;6155;2146;6342
231070;202009;7766;22454;6616;20442;685;2183;4300;13211;4985;15394
231080;202009;3962;11205;3358;10218;127;524;2537;7552;2664;8076
231085;202009;6784;16382;5355;14668;211;550;4175;11443;4386;11993
231090;202009;4523;11661;3308;9320;110;419;2255;6094;2365;6513
231095;202009;2284;6779;1781;5684;137;444;1179;3756;1316;4200
231100;202009;3149;9057;2594;8013;120;437;1940;5919;2060;6356
231110;202009;3621;10547;3290;9931;122;442;2465;7328;2587;7770
231120;202009;2263;6556;1860;5853;82;313;1331;4139;1413;4452
231123;202009;1885;4859;1562;4303;73;160;1140;3173;1213;3333
231126;202009;5547;15156;4468;13110;301;850;3187;9259;3488;10109
231130;202009;21307;54183;17675;49592;1014;3614;13094;36029;14108;39643
231135;202009;4145;11643;3407;10202;156;514;2430;7151;2586;7665
231140;202009;16414;45974;13027;39980;596;2437;9129;27304;9725;29741
231150;202009;5837;15788;4470;13193;673;2030;1984;6006;2657;8036
231160;202009;6222;18891;5441;17438;762;2327;3135;10286;3897;12613
231170;202009;4331;12647;3552;11145;179;654;2462;7457;2641;8111
231180;202009;14526;40915;11703;34965;3229;9326;3943;12344;7172;21670
231190;202009;3897;10952;3194;9658;69;299;2448;7220;2517;7519
231195;202009;5009;14987;4130;13151;253;913;2963;9348;3216;10261
231200;202009;7804;24213;6785;22136;191;959;5338;16872;5529;17831
231210;202009;4832;14075;4103;12855;184;682;3098;9514;3282;10196
231220;202009;12190;31513;9381;26169;403;1218;6866;18454;7269;19672
231230;202009;9237;29281;8100;27220;498;1932;5950;20003;6448;21935
231240;202009;11563;33622;10144;30908;1542;4570;6170;19020;7712;23590
231250;202009;2141;5485;1397;3843;107;303;844;2270;951;2573
231260;202009;3266;9112;2814;8394;268;780;1918;5839;2186;6619
231270;202009;6371;16603;5140;14588;146;574;3868;10701;4014;11275
231280;202009;1716;5340;1562;5054;90;300;1171;3759;1261;4059
231290;202009;37640;111878;31111;98534;5244;16418;14384;45363;19628;61781
231300;202009;4083;11208;3174;9384;199;645;2109;6095;2308;6740
231310;202009;7374;18886;5841;16041;492;1354;3995;10769;4487;12123
231320;202009;7835;21301;6101;18223;90;418;4763;13989;4853;14407
231325;202009;2438;6399;2000;5732;170;394;1345;3953;1515;4347
231330;202009;9496;28201;7770;24756;1382;4186;4148;13806;5530;17992
231335;202009;5706;14993;4813;13545;86;370;4226;11756;4312;12126
231340;202009;17635;53865;15761;50511;1313;4234;11509;37287;12822;41521
231350;202009;15815;42960;14317;40830;271;979;12815;36182;13086;37161
231355;202009;4387;12978;3915;12089;230;771;3039;9271;3269;10042
231360;202009;7371;22154;6375;20408;263;953;5050;16096;5313;17049
231370;202009;2168;5948;1724;5163;35;113;1306;3897;1341;4010
231375;202009;4335;13429;3945;12785;138;617;3282;10490;3420;11107
231380;202009;6007;16274;5424;15467;188;501;4402;12726;4590;13227
231390;202009;3305;9615;2948;9020;123;467;2176;6485;2299;6952
231395;202009;4028;11745;3324;10609;421;1342;1940;6280;2361;7622
231400;202009;9650;27561;8058;24631;273;1158;6084;18177;6357;19335
231410;202009;14674;45290;13277;42966;603;2214;10695;34269;11298;36483
240010;202009;2614;6835;2029;5760;203;579;1206;3357;1409;3936
240020;202009;12489;34910;10436;31233;633;2339;6957;20505;7590;22844
240030;202009;2854;6959;2583;6537;88;255;2233;5613;2321;5868
240040;202009;813;2338;672;2063;32;126;467;1374;499;1500
240050;202009;3310;8835;2674;7686;47;148;2043;5761;2090;5909
240060;202009;1406;3754;1152;3295;23;86;939;2626;962;2712
240070;202009;2141;6195;1933;5764;179;568;1396;4052;1575;4620
240080;202009;2955;7919;2388;6872;53;202;1824;5147;1877;5349
240090;202009;2251;5516;1825;4792;18;50;1537;3994;1555;4044
240100;202009;10169;24998;8050;21123;208;632;6298;15961;6506;16593
240110;202009;4611;12961;3867;11603;187;675;2797;8234;2984;8909
240120;202009;3286;9069;2626;8250;187;623;1854;5974;2041;6597
240130;202009;3621;7540;3005;6739;29;86;2745;6070;2774;6156
240140;202009;1804;5388;1531;4849;155;545;1033;3237;1188;3782
240145;202009;6599;18257;5366;16139;821;2517;3021;9206;3842;11723
240150;202009;920;2690;807;2450;53;184;619;1822;672;2006
240160;202009;1452;4352;1210;3896;46;207;903;2919;949;3126
240165;202009;975;2636;807;2315;27;88;659;1857;686;1945
240170;202009;2533;6812;2118;6052;194;629;1438;3982;1632;4611
240180;202009;2976;8797;2362;7542;554;1669;1057;3595;1611;5264
240185;202009;1217;3793;1112;3610;55;219;917;2936;972;3155
240190;202009;1056;3104;904;2850;20;93;768;2429;788;2522
240200;202009;10966;27881;8700;23999;895;2675;4968;13369;5863;16044
240210;202009;3260;7994;2667;7057;26;136;2245;5758;2271;5894
240220;202009;7258;21592;6475;20361;328;1443;5099;15743;5427;17186
240230;202009;5837;14812;4661;12836;208;573;3690;10189;3898;10762
240240;202009;1821;5226;1128;3574;108;375;405;1148;513;1523
240250;202009;2942;7702;2584;7210;95;286;2165;6004;2260;6290
240260;202009;14065;41253;12103;37919;1719;5036;7483;24607;9202;29643
240270;202009;2271;6725;1976;6235;102;320;1427;4669;1529;4989
240280;202009;1687;4311;1429;3885;52;144;1140;3062;1192;3206
240290;202009;1187;3454;952;2929;29;134;678;1957;707;2091
240300;202009;2312;5869;1657;4661;71;216;1044;2864;1115;3080
240310;202009;8543;22516;6719;19225;893;2707;3479;9783;4372;12490
240320;202009;2058;5564;1502;4475;34;152;1127;3200;1161;3352
240325;202009;31630;83748;24965;71978;4356;12920;11106;32189;15462;45109
240330;202009;1765;4789;1349;4003;55;197;913;2567;968;2764
240340;202009;1979;4544;1605;3974;63;151;1312;3192;1375;3343
240350;202009;2180;5509;1940;5242;29;85;1755;4764;1784;4849
240360;202009;8991;24635;7989;23052;817;2380;5615;16365;6432;18745
240370;202009;1945;5073;1507;4186;72;211;1070;2886;1142;3097
240375;202009;911;2280;751;1983;28;100;610;1560;638;1660
240380;202009;2258;6392;1651;5023;144;413;954;2868;1098;3281
240390;202009;1044;2521;734;1931;28;61;470;1155;498;1216
240400;202009;1456;3535;1133;2976;34;112;799;1975;833;2087
240410;202009;561;1684;469;1478;39;148;296;880;335;1028
240420;202009;4552;15912;4000;14674;455;1973;2376;8539;2831;10512
240430;202009;3425;8758;2841;7734;179;561;2108;5556;2287;6117
240440;202009;2532;5503;2128;4942;135;259;1726;4020;1861;4279
240450;202009;4558;12341;3550;10434;350;1073;2099;5941;2449;7014
240460;202009;2916;8245;2597;7739;229;741;2024;6000;2253;6741
240470;202009;3640;10884;2763;9052;481;1479;1425;4895;1906;6374
240480;202009;576;1598;390;1182;34;105;180;533;214;638
240485;202009;2163;6048;1764;5308;120;367;1216;3664;1336;4031
240490;202009;1613;4121;1256;3458;86;200;921;2558;1007;2758
240500;202009;2154;5757;1877;5296;102;269;1510;4272;1612;4541
240510;202009;1694;4411;1481;4100;64;238;1223;3300;1287;3538
240520;202009;1472;3545;1141;3089;55;158;857;2331;912;2489
240530;202009;2178;6148;1956;5798;96;292;1608;4739;1704;5031
240540;202009;2279;5671;1985;5212;64;120;1713;4517;1777;4637
240550;202009;679;1918;613;1786;18;75;511;1445;529;1520
240560;202009;3308;8525;2774;7806;273;689;2013;5781;2286;6470
240570;202009;2855;7447;1876;5282;280;801;730;1924;1010;2725
240580;202009;8061;23420;7107;21646;554;1607;5659;17384;6213;18991
240590;202009;740;1921;640;1751;12;40;486;1294;498;1334
240600;202009;1776;4835;1305;3850;47;151;860;2449;907;2600
240610;202009;4215;11263;3555;10057;126;420;2714;7528;2840;7948
240615;202009;1281;3257;1012;2768;114;293;674;1820;788;2113
240620;202009;1851;5165;1587;4699;99;269;1266;3742;1365;4011
240630;202009;2086;5877;1880;5522;147;304;1327;4072;1474;4376
240640;202009;959;2547;758;2210;30;112;566;1617;596;1729
240650;202009;4049;11249;3472;10072;226;660;2638;7554;2864;8214
240660;202009;3093;7863;2743;7409;49;154;2487;6719;2536;6873
240670;202009;2455;6909;1964;5899;137;446;1278;3732;1415;4178
240680;202009;1638;4317;1311;3754;47;143;997;2782;1044;2925
240690;202009;1001;2499;792;2149;16;69;629;1636;645;1705
240700;202009;2447;7036;1980;6156;53;189;1553;4748;1606;4937
240710;202009;16363;42089;13642;37401;1748;4677;8465;23196;10213;27873
240720;202009;5174;12683;4468;11693;391;1061;3271;8473;3662;9534
240725;202009;1128;3205;858;2662;38;126;568;1704;606;1830
240730;202009;2264;6321;1819;5436;61;221;1370;4015;1431;4236
240740;202009;1840;4919;1458;4170;44;170;1071;2900;1115;3070
240750;202009;2157;7063;1813;6329;266;1004;970;3416;1236;4420
240760;202009;1637;3803;1153;3049;63;90;882;2429;945;2519
240770;202009;3224;8850;2704;8098;125;449;2179;6446;2304;6895
240780;202009;4884;13352;3967;11816;544;1585;2411;7391;2955;8976
240790;202009;873;2461;723;2165;18;81;547;1586;565;1667
240800;202009;47596;113582;36871;97248;5066;13616;18981;50182;24047;63798
240810;202009;90796;233617;76591;209908;9297;26156;48927;132059;58224;158215
240820;202009;5868;17353;5068;15900;701;2154;3121;9971;3822;12125
240830;202009;8745;24663;7735;23134;264;1086;6377;18793;6641;19879
240840;202009;1116;2746;881;2368;29;74;630;1625;659;1699
240850;202009;1378;3714;985;2889;49;153;546;1544;595;1697
240860;202009;1307;3453;984;2870;15;76;735;2036;750;2112
240870;202009;1105;2796;831;2318;130;370;452;1286;582;1656
240880;202009;1266;3988;1116;3691;85;356;859;2763;944;3119
240890;202009;4421;12041;3345;9963;454;1468;1706;4881;2160;6349
240895;202009;2805;8571;2564;8187;149;465;2216;7142;2365;7607
240910;202009;3387;9126;2888;8215;55;194;2350;6557;2405;6751
240920;202009;902;2436;742;2173;67;179;423;1292;490;1471
240930;202009;3696;8352;3048;7557;198;289;2283;5975;2481;6264
240933;202009;1775;4266;1449;3791;41;158;1260;3241;1301;3399
240940;202009;6085;14977;4708;12622;540;1459;2813;7342;3353;8801
240950;202009;1030;3056;897;2809;28;115;726;2221;754;2336
240960;202009;687;2088;614;1942;30;107;468;1451;498;1558
240970;202009;1857;4761;1497;4147;59;212;1219;3269;1278;3481
240980;202009;3319;9845;2932;9148;112;483;2370;7270;2482;7753
240990;202009;2600;7285;2290;6672;267;853;1607;4519;1874;5372
241000;202009;955;2519;754;2146;27;69;556;1557;583;1626
241010;202009;2819;8913;2567;8370;171;653;1884;6058;2055;6711
241020;202009;2142;5650;1582;4525;136;390;1025;2879;1161;3269
241025;202009;1774;5040;1411;4355;49;201;1024;3113;1073;3314
241030;202009;2505;7780;1993;6684;224;768;1275;4286;1499;5054
241040;202009;2309;7199;2032;6722;97;434;1623;5315;1720;5749
241050;202009;1357;3754;1110;3308;33;125;812;2353;845;2478
241060;202009;752;2109;659;1912;27;87;464;1293;491;1380
241070;202009;663;1798;567;1631;14;43;443;1233;457;1276
241080;202009;1141;3206;866;2650;9;37;627;1891;636;1928
241090;202009;2014;5871;1635;5216;44;220;1290;4050;1334;4270
241100;202009;1169;3268;918;2750;68;209;598;1734;666;1943
241105;202009;978;2944;792;2590;251;799;257;875;508;1674
241110;202009;974;2721;731;2208;35;103;484;1412;519;1515
241120;202009;7652;21496;6473;19398;971;2830;3812;11757;4783;14587
241140;202009;3314;8719;2597;7282;150;429;1864;5109;2014;5538
241142;202009;779;2081;570;1677;26;89;340;942;366;1031
241150;202009;5942;15387;5221;14197;143;486;4284;11437;4427;11923
241160;202009;1143;3057;919;2647;134;390;589;1658;723;2048
241170;202009;1346;3409;1144;3060;29;109;958;2460;987;2569
241180;202009;1041;2650;753;2085;93;266;378;1034;471;1300
241190;202009;1152;3013;956;2622;18;73;695;1832;713;1905
241200;202009;19795;51331;16964;46680;2698;7415;9799;26985;12497;34400
241210;202009;1433;3796;1021;2964;117;373;580;1640;697;2013
241220;202009;8942;26023;7755;24000;1763;5383;3676;11835;5439;17218
241230;202009;2969;7722;2605;7146;107;322;2164;5867;2271;6189
241240;202009;1227;3404;765;2370;65;205;336;1042;401;1247
241250;202009;5444;15710;4342;13629;157;719;3150;9514;3307;10233
241255;202009;2259;7004;1989;6427;112;449;1517;4801;1629;5250
241260;202009;4972;12804;3901;11013;84;325;3086;8520;3170;8845
241270;202009;1739;4985;1427;4381;104;356;1026;3142;1130;3498
241280;202009;2192;5457;1870;4870;58;145;1588;4078;1646;4223
241290;202009;3404;8302;2515;6852;74;242;1973;5225;2047;5467
241300;202009;1492;3957;1189;3416;38;127;802;2243;840;2370
241310;202009;2154;5275;1849;4843;13;51;1576;4171;1589;4222
241320;202009;943;3043;804;2777;85;356;521;1773;606;2129
241330;202009;1752;4494;1368;3981;16;83;1189;3428;1205;3511
241335;202009;3267;9063;2878;8351;106;348;2372;6802;2478;7150
241340;202009;1574;4407;1215;3659;253;804;494;1448;747;2252
241350;202009;2093;5926;1827;5449;94;318;1418;4162;1512;4480
241355;202009;1311;3528;1072;3058;16;45;827;2350;843;2395
241360;202009;2059;5310;1544;4257;40;118;1103;2928;1143;3046
241370;202009;1350;3725;1044;3085;49;168;726;2053;775;2221
241380;202009;634;1772;485;1480;73;190;243;768;316;958
241390;202009;2776;8036;2460;7560;201;554;1883;5905;2084;6459
241400;202009;3593;9889;3189;9256;152;489;2584;7438;2736;7927
241410;202009;2414;7142;1965;6217;343;1112;998;3166;1341;4278
241415;202009;1670;4926;1360;4319;59;219;949;2963;1008;3182
241420;202009;2379;7384;2025;6772;469;1741;974;3251;1443;4992
241430;202009;610;1676;417;1240;18;60;259;734;277;794
241440;202009;7651;23317;6814;21829;365;1284;5375;17174;5740;18458
241445;202009;1116;2825;985;2655;22;56;872;2410;894;2466
241450;202009;2680;6586;2282;5942;396;877;1471;3992;1867;4869
241460;202009;3815;10268;3082;8718;196;587;2153;5947;2349;6534
241470;202009;1420;3718;1145;3309;29;108;945;2722;974;2830
241475;202009;1228;3419;962;2902;25;119;689;1984;714;2103
241480;202009;2964;9188;2430;8013;723;2358;799;2934;1522;5292
241490;202009;644;1506;526;1346;27;66;379;952;406;1018
241500;202009;805;2225;716;2109;3;10;659;1962;662;1972
250010;202009;2522;7539;2090;6647;59;238;1522;4732;1581;4970
250020;202009;1643;4336;1186;3445;46;88;843;2456;889;2544
250030;202009;6967;18935;6117;17587;541;1579;4533;12890;5074;14469
250040;202009;4033;12300;3475;11256;229;844;2512;8011;2741;8855
250050;202009;3628;9651;3267;9163;127;432;2666;7477;2793;7909
250053;202009;1182;3287;1069;3099;72;209;774;2257;846;2466
250057;202009;655;2318;610;2248;10;44;547;2047;557;2091
250060;202009;5519;14313;4947;13602;291;771;4073;11269;4364;12040
250070;202009;3982;11017;3365;9929;38;158;2699;7783;2737;7941
250073;202009;763;2014;623;1799;9;22;508;1431;517;1453
250077;202009;2219;5951;1656;5022;61;215;1248;3761;1309;3976
250080;202009;4896;12146;4144;11173;64;286;3618;9615;3682;9901
250090;202009;3326;8088;2895;7516;54;160;2483;6328;2537;6488
250100;202009;3691;11149;3319;10442;163;569;2602;8021;2765;8590
250110;202009;4916;13742;4415;13006;253;947;3442;9921;3695;10868
250115;202009;700;1805;505;1502;10;42;349;1035;359;1077
250120;202009;1833;5336;1536;4842;32;149;1210;3785;1242;3934
250130;202009;5549;15133;4681;13899;74;393;3966;11611;4040;12004
250135;202009;1200;3301;1044;3025;25;94;901;2587;926;2681
250140;202009;2264;6563;2099;6351;104;429;1798;5393;1902;5822
250150;202009;4795;14848;4300;13999;157;693;3411;10888;3568;11581
250153;202009;1408;3703;1169;3337;31;89;931;2636;962;2725
250157;202009;1761;5154;1596;4841;58;232;1273;3794;1331;4026
250160;202009;3929;9694;3127;8604;41;147;2741;7551;2782;7698
250170;202009;1851;4729;1647;4440;24;90;1435;3824;1459;3914
250180;202009;20317;48721;17290;44840;771;2365;13488;34120;14259;36485
250190;202009;4061;10767;3385;9753;322;960;2335;6567;2657;7527
250200;202009;1956;5179;1659;4766;63;192;1388;3994;1451;4186
250205;202009;867;2640;747;2456;15;74;619;2006;634;2080
250210;202009;1555;4682;1397;4426;73;317;1086;3382;1159;3699
250215;202009;1583;4320;1315;3931;80;263;777;2339;857;2602
250220;202009;659;1817;527;1619;26;100;347;1041;373;1141
250230;202009;1676;3746;1113;2873;17;60;924;2298;941;2358
250240;202009;2298;6972;2009;6436;40;201;1664;5245;1704;5446
250250;202009;4590;12674;3991;11794;86;293;3397;10055;3483;10348
250260;202009;1711;4723;1421;4226;52;130;1118;3305;1170;3435
250270;202009;1205;3607;1088;3462;59;204;807;2669;866;2873
250280;202009;3357;9276;3002;8743;109;309;2372;6927;2481;7236
250290;202009;1593;4172;1353;3827;23;73;1060;2995;1083;3068
250300;202009;5503;14608;4936;13943;191;840;4110;11196;4301;12036
250310;202009;1175;3211;972;2872;38;127;738;2154;776;2281
250320;202009;12169;27053;10451;25073;256;700;9340;22103;9596;22803
250330;202009;2406;6585;2010;6039;106;325;1621;4865;1727;5190
250340;202009;1104;2789;986;2639;11;28;904;2412;915;2440
250350;202009;4130;11476;3632;10636;199;474;2846;8603;3045;9077
250355;202009;1965;5927;1760;5643;27;142;1577;5026;1604;5168
250360;202009;1783;4884;1586;4614;40;147;1327;3827;1367;3974
250370;202009;13617;34687;11211;31044;248;898;9416;25711;9664;26609
250375;202009;1191;3055;952;2764;5;17;897;2624;902;2641
250380;202009;1618;4140;1477;3958;28;111;1297;3370;1325;3481
250390;202009;1845;4686;1539;4195;82;232;1224;3298;1306;3530
250400;202009;70734;172699;51571;142679;14329;42504;14477;42400;28806;84904
250403;202009;1736;4828;1545;4598;72;363;1193;3381;1265;3744
250407;202009;1249;3079;991;2697;74;159;687;1942;761;2101
250410;202009;650;1729;560;1574;4;9;464;1275;468;1284
250415;202009;1875;5211;1638;4827;31;143;1395;4087;1426;4230
250420;202009;1185;3322;1076;3167;25;96;958;2801;983;2897
250430;202009;6275;15369;5282;14034;138;420;4358;11348;4496;11768
250435;202009;1546;4296;1232;3744;12;59;939;2810;951;2869
250440;202009;4586;12054;3914;11203;69;192;3472;9940;3541;10132
250450;202009;1833;4791;1492;4321;30;104;1237;3597;1267;3701
250460;202009;7341;19812;6493;18555;332;1011;5214;14831;5546;15842
250470;202009;1546;3971;1274;3553;50;158;1002;2744;1052;2902
250480;202009;4050;10835;3424;10084;41;146;3014;8950;3055;9096
250485;202009;723;1621;531;1342;43;76;386;945;429;1021
250490;202009;5170;12214;4585;11543;173;506;4043;9993;4216;10499
250500;202009;1997;5466;1766;5064;77;242;1422;4079;1499;4321
250510;202009;5467;13656;4678;12606;78;202;4084;11102;4162;11304
250520;202009;1822;4907;1550;4510;124;396;1106;3190;1230;3586
250523;202009;2228;5471;1970;5144;69;281;1635;4114;1704;4395
250527;202009;1676;4291;1505;4097;24;76;1335;3651;1359;3727
250530;202009;635;1611;539;1477;5;11;477;1306;482;1317
250535;202009;1348;3955;1215;3697;24;105;993;2932;1017;3037
250540;202009;2967;6772;2468;6215;69;126;2158;5533;2227;5659
250550;202009;774;2465;675;2270;22;86;504;1663;526;1749
250560;202009;1760;4793;1553;4496;38;143;1305;3691;1343;3834
250570;202009;2654;7891;2269;7190;80;299;1787;5568;1867;5867
250580;202009;1052;2719;923;2538;46;175;775;2078;821;2253
250590;202009;815;2270;725;2141;19;65;594;1763;613;1828
250600;202009;8210;20908;6829;19116;241;751;5626;15626;5867;16377
250610;202009;2973;8331;2653;7861;117;439;2202;6440;2319;6879
250620;202009;797;2073;677;1869;11;34;497;1339;508;1373
250625;202009;2487;7123;2217;6676;41;215;1876;5482;1917;5697
250630;202009;10207;28082;8234;24615;876;2636;5243;15381;6119;18017
250640;202009;3461;9422;3104;8959;99;384;2646;7517;2745;7901
250650;202009;967;2307;804;2087;13;36;697;1783;710;1819
250660;202009;1638;4036;1309;3582;39;108;1074;2874;1113;2982
250670;202009;2323;7202;2109;6823;44;193;1837;5837;1881;6030
250680;202009;5825;13377;5191;12663;57;218;4816;11593;4873;11811
250690;202009;6832;15293;5762;13957;96;228;5100;12260;5196;12488
250700;202009;4288;12014;3734;11169;428;1263;2593;7731;3021;8994
250710;202009;4423;12579;3795;11716;282;970;2756;8504;3038;9474
250720;202009;2738;7280;2445;6863;35;173;2138;5930;2173;6103
250730;202009;4116;10897;3586;10196;103;424;3000;8280;3103;8704
250740;202009;1931;4792;1599;4351;97;214;1243;3412;1340;3626
250750;202009;105520;257754;88818;234262;7122;20324;64203;166076;71325;186400
250760;202009;2387;6125;2076;5620;91;264;1639;4304;1730;4568
250770;202009;4027;12080;3594;11499;383;1175;2578;8361;2961;9536
250780;202009;1744;4679;1449;4140;47;169;1121;3113;1168;3282
250790;202009;2463;7243;2119;6718;130;515;1441;4456;1571;4971
250800;202009;2453;6486;2130;5962;86;178;1724;4867;1810;5045
250810;202009;1280;3334;1056;3017;29;61;890;2577;919;2638
250820;202009;1992;5476;1831;5298;33;145;1663;4774;1696;4919
250830;202009;5881;17530;4815;15366;262;1009;3300;10205;3562;11214
250840;202009;760;2403;650;2183;14;56;490;1655;504;1711
250850;202009;1798;5304;1603;4955;34;153;1321;3985;1355;4138
250855;202009;970;2843;833;2607;53;199;620;1917;673;2116
250860;202009;3172;9356;2619;8416;439;1482;1530;4928;1969;6410
250870;202009;1045;2840;877;2557;31;116;717;2059;748;2175
250880;202009;1624;4136;1333;3716;73;211;1018;2831;1091;3042
250890;202009;10269;26478;9057;24841;416;1682;7224;18871;7640;20553
250900;202009;2887;7854;2488;7144;82;249;2095;5922;2177;6171
250905;202009;2421;6802;2220;6511;43;167;2017;5910;2060;6077
250910;202009;5934;14611;4877;13410;84;288;4239;11708;4323;11996
250915;202009;2165;4995;1505;4283;25;55;1309;3812;1334;3867
250920;202009;3532;8886;3092;8211;336;763;2263;6054;2599;6817
250930;202009;2268;6007;2042;5717;57;237;1761;4820;1818;5057
250933;202009;1161;3437;1024;3188;21;106;786;2377;807;2483
250937;202009;698;1865;570;1654;24;74;434;1281;458;1355
250939;202009;1760;4673;1530;4369;63;199;1191;3385;1254;3584
250940;202009;4040;10673;3537;10007;16;62;3148;8911;3164;8973
250950;202009;1730;4360;1385;3915;26;97;1125;3118;1151;3215
250960;202009;1126;3276;983;3048;26;135;802;2399;828;2534
250970;202009;8329;21267;7273;19571;227;702;6022;15910;6249;16612
250980;202009;2431;6428;2172;6041;34;146;1874;5077;1908;5223
250990;202009;2071;6217;1724;5611;55;251;1274;4097;1329;4348
251000;202009;2059;5761;1664;5076;38;163;1357;4104;1395;4267
251010;202009;2671;7384;2415;7002;20;79;2170;6293;2190;6372
251020;202009;1645;4441;1465;4153;33;146;1270;3528;1303;3674
251030;202009;1014;2685;831;2347;35;99;583;1625;618;1724
251040;202009;1830;5144;1534;4640;38;188;1238;3717;1276;3905
251050;202009;1062;2884;880;2529;49;162;622;1719;671;1881
251060;202009;1084;2311;814;1967;8;26;639;1519;647;1545
251065;202009;478;1303;368;1099;12;34;248;723;260;757
251070;202009;732;1884;622;1724;10;41;531;1440;541;1481
251080;202009;18679;47631;15131;42253;1904;5490;9636;27036;11540;32526
251090;202009;2789;8022;2344;7224;55;200;1871;5721;1926;5921
251100;202009;819;2586;729;2418;25;93;559;1782;584;1875
251110;202009;1700;4536;1441;4085;49;127;1090;3078;1139;3205
251120;202009;7336;20323;6160;18877;276;994;4872;14939;5148;15933
251130;202009;3881;8602;3416;8080;60;165;3092;7270;3152;7435
251140;202009;4274;11859;3814;11212;76;314;3180;9231;3256;9545
251150;202009;2642;7675;2372;7240;99;414;1947;5813;2046;6227
251160;202009;2130;6224;1846;5809;39;189;1588;4901;1627;5090
251170;202009;1559;4224;1354;3955;32;111;1168;3395;1200;3506
251180;202009;2636;7017;2148;6325;167;491;1464;4291;1631;4782
251190;202009;4402;11417;3998;10958;47;256;3627;9736;3674;9992
251200;202009;4342;12659;3817;11977;73;310;3354;10546;3427;10856
251203;202009;948;3084;869;2907;21;102;654;2125;675;2227
251207;202009;1093;2968;841;2547;19;96;588;1734;607;1830
251210;202009;7652;19255;6240;17331;278;647;4761;13486;5039;14133
251220;202009;1181;2836;925;2496;54;122;710;1962;764;2084
251230;202009;4602;12731;3955;11611;117;430;3116;8909;3233;9339
251240;202009;3678;9969;3076;8963;164;443;2299;6605;2463;7048
251250;202009;10304;27618;9002;25419;734;2156;6650;18249;7384;20405
251260;202009;482;1376;438;1307;12;62;346;1000;358;1062
251270;202009;4260;13207;3817;12616;110;446;3108;10501;3218;10947
251272;202009;1344;3625;1209;3446;45;168;1014;2816;1059;2984
251274;202009;898;2487;714;2146;59;200;474;1360;533;1560
251275;202009;1215;3401;1035;3109;29;131;813;2377;842;2508
251276;202009;1319;3569;1146;3340;31;157;928;2606;959;2763
251278;202009;585;1609;522;1517;48;114;378;1130;426;1244
251280;202009;2236;6041;1996;5672;48;150;1668;4685;1716;4835
251290;202009;5894;13803;5316;13094;148;481;4636;11058;4784;11539
251300;202009;864;2513;780;2385;7;36;660;2014;667;2050
251310;202009;2725;7826;2367;7265;49;263;1895;5670;1944;5933
251315;202009;1705;5304;1555;5025;84;261;1176;3755;1260;4016
251320;202009;1624;4291;1166;3505;35;121;867;2556;902;2677
251330;202009;2109;4888;1715;4425;21;77;1546;4018;1567;4095
251335;202009;1098;3151;982;2969;24;107;855;2525;879;2632
251340;202009;3702;8924;2955;7922;121;362;2260;6027;2381;6389
251350;202009;1054;3032;945;2849;26;100;778;2306;804;2406
251360;202009;1834;5104;1474;4595;21;106;1235;3848;1256;3954
251365;202009;725;1958;573;1659;5;20;449;1287;454;1307
251370;202009;24741;64776;21148;59600;2885;8211;12761;36786;15646;44997
251380;202009;1207;3404;1050;3135;19;108;876;2539;895;2647
251385;202009;759;1932;580;1605;21;60;421;1125;442;1185
251390;202009;6478;18709;5692;17466;483;1528;3776;11632;4259;13160
251392;202009;974;2636;815;2394;28;115;632;1817;660;1932
251394;202009;610;1764;498;1563;19;85;368;1134;387;1219
251396;202009;667;1785;569;1613;15;41;400;1111;415;1152
251398;202009;974;2432;673;1916;18;70;492;1361;510;1431
251400;202009;1232;2990;972;2639;25;95;766;2002;791;2097
251410;202009;1505;3528;1223;3131;20;83;1034;2545;1054;2628
251420;202009;1913;5011;1550;4587;41;156;1226;3588;1267;3744
251430;202009;1561;4701;1398;4420;30;142;1206;3808;1236;3950
251440;202009;1111;3082;893;2675;36;93;704;2123;740;2216
251445;202009;1541;4268;1416;4094;37;124;1195;3405;1232;3529
251450;202009;4487;13062;3972;12291;85;336;3298;10113;3383;10449
251455;202009;861;2591;780;2445;22;91;617;1886;639;1977
251460;202009;887;2569;775;2397;15;53;635;1974;650;2027
251465;202009;453;1316;388;1197;7;28;288;865;295;893
251470;202009;1189;3256;884;2617;73;235;514;1450;587;1685
251480;202009;991;2616;804;2281;19;80;618;1670;637;1750
251490;202009;1885;4951;1489;4397;58;181;1105;3270;1163;3451
251500;202009;1942;5440;1781;5228;30;106;1603;4707;1633;4813
251510;202009;2646;7908;2185;6980;107;398;1482;4622;1589;5020
251520;202009;971;2553;737;2120;68;189;467;1309;535;1498
251530;202009;14731;35226;11812;31586;104;579;10430;27391;10534;27970
251540;202009;2992;8454;2695;7899;71;249;2245;6471;2316;6720
251550;202009;3778;8887;3014;7929;106;207;2508;6661;2614;6868
251560;202009;544;1642;475;1534;58;200;328;1027;386;1227
251570;202009;944;2648;762;2288;19;84;604;1762;623;1846
251580;202009;1895;4483;1686;4179;36;152;1470;3499;1506;3651
251590;202009;1567;3884;1315;3588;50;135;1096;2940;1146;3075
251593;202009;906;2643;808;2484;85;266;520;1577;605;1843
251597;202009;2108;5897;1895;5616;20;103;1685;4924;1705;5027
251600;202009;6412;17228;5594;15976;169;529;4619;13003;4788;13532
251610;202009;3226;9152;2753;8263;241;668;1877;5736;2118;6404
251615;202009;1251;3097;1010;2734;22;62;812;2144;834;2206
251620;202009;19099;43520;14681;38099;107;365;12560;33025;12667;33390
251630;202009;4726;11058;3779;9743;196;498;2838;7257;3034;7755
251640;202009;2151;5826;1901;5434;28;132;1649;4599;1677;4731
251650;202009;3972;10634;3468;9964;131;401;2934;8423;3065;8824
251660;202009;3473;10381;3044;9623;71;334;2535;7875;2606;8209
251670;202009;4011;11314;3563;10674;50;251;3165;9395;3215;9646
251675;202009;639;1832;577;1756;76;231;379;1172;455;1403
251680;202009;2515;6623;2089;6068;48;150;1683;4941;1731;5091
251690;202009;3102;8662;2612;7807;89;270;1951;5770;2040;6040
251700;202009;2089;5909;1741;5470;43;196;1469;4536;1512;4732
251710;202009;802;2066;549;1550;42;146;316;849;358;995
251720;202009;1310;3698;1048;3237;23;103;801;2399;824;2502
251740;202009;618;1721;496;1492;46;163;327;945;373;1108
260005;202009;30015;63126;24619;56148;1667;3742;18942;42419;20609;46161
260010;202009;10267;26791;8440;23812;461;1372;5005;14190;5466;15562
260020;202009;6869;15958;5810;14444;99;439;4902;11957;5001;12396
260030;202009;6857;17395;5773;15824;131;392;4692;12797;4823;13189
260040;202009;7624;19623;6346;17770;442;1230;4476;12722;4918;13952
260050;202009;13944;36036;11573;33400;182;703;10623;30705;10805;31408
260060;202009;4070;10073;3488;9137;203;473;2733;7184;2936;7657
260070;202009;10578;26459;9019;24192;328;1143;7285;19013;7613;20156
260080;202009;6518;14812;5672;13689;116;381;4767;11293;4883;11674
260090;202009;4633;11935;4101;11204;459;1276;2903;7941;3362;9217
260100;202009;3000;8079;2502;7344;53;267;2059;5938;2112;6205
260105;202009;5006;13636;4472;12914;131;455;3745;10680;3876;11135
260110;202009;22272;61251;19765;57593;918;3093;16302;46849;17220;49942
260120;202009;14622;38652;12251;35080;1438;4027;7827;22802;9265;26829
260130;202009;3088;7937;2744;7423;254;677;1985;5301;2239;5978
260140;202009;13111;29395;11272;27201;550;1476;9454;22468;10004;23944
260150;202009;3600;8302;3080;7658;85;253;2707;6660;2792;6913
260160;202009;6524;16901;5491;15640;89;310;4936;14204;5025;14514
260170;202009;20311;47747;17175;43459;908;2307;13693;34240;14601;36547
260180;202009;3488;9273;3011;8624;74;271;2588;7308;2662;7579
260190;202009;18301;36638;15338;33129;164;430;13606;28838;13770;29268
260200;202009;11163;26679;9552;24622;438;1004;7953;20775;8391;21779
260210;202009;11873;33360;10030;30332;324;1193;7957;23939;8281;25132
260220;202009;10327;24700;9521;23670;171;553;8357;20458;8528;21011
260230;202009;10731;26239;9338;24388;193;640;7874;20201;8067;20841
260240;202009;2708;8073;2361;7403;99;330;1820;5663;1919;5993
260250;202009;2183;5736;1887;5263;114;265;1439;4010;1553;4275
260260;202009;13041;33660;11579;31417;373;1237;9159;24333;9532;25570
260270;202009;4284;10240;3756;9602;133;473;3140;7871;3273;8344
260280;202009;12783;38292;11452;36399;445;1909;9735;30500;10180;32409
260290;202009;41198;103547;35323;94993;3829;10502;23922;64072;27751;74574
260300;202009;9624;25832;8343;24083;189;848;7023;20205;7212;21053
260310;202009;5172;13150;4534;12330;327;806;3477;9624;3804;10430
260320;202009;7672;22028;6452;19943;260;837;5237;16172;5497;17009
260330;202009;2562;7812;2240;7156;72;273;1772;5517;1844;5790
260340;202009;2048;5466;1761;5033;26;118;1506;4206;1532;4324
260345;202009;25351;65456;21106;59244;3140;9391;11129;30703;14269;40094
260350;202009;5607;13068;4847;12187;67;197;4298;10749;4365;10946
260360;202009;2514;6548;2267;6095;45;194;1587;4165;1632;4359
260370;202009;5566;15867;4777;14539;232;787;3685;11143;3917;11930
260380;202009;5001;14646;4262;13430;171;552;3189;9956;3360;10508
260390;202009;4503;13444;3728;11852;223;698;2483;7759;2706;8457
260392;202009;3342;10688;2989;10240;116;694;2407;8238;2523;8932
260400;202009;18289;42062;15771;38750;468;1315;12424;29380;12892;30695
260410;202009;73323;177445;56475;153720;9943;28385;25268;71008;35211;99393
260415;202009;4440;11810;3823;10780;60;250;3121;8644;3181;8894
260420;202009;12735;26331;10768;24133;101;283;9979;22157;10080;22440
260430;202009;2718;8424;2334;7664;100;398;1663;5392;1763;5790
260440;202009;3737;9631;3299;8962;68;244;2766;7372;2834;7616
260450;202009;5744;14419;5125;13620;288;586;4224;11442;4512;12028
260460;202009;5224;15477;4435;14079;472;1670;2649;8261;3121;9931
260470;202009;4904;12910;4134;12011;81;196;3787;11168;3868;11364
260480;202009;3986;10572;3337;9641;223;786;2294;6628;2517;7414
260490;202009;5373;12261;4740;11328;34;140;4316;10135;4350;10275
260500;202009;6103;15292;5213;14039;459;1163;3646;9961;4105;11124
260510;202009;9854;24146;8232;21880;116;448;7251;19084;7367;19532
260515;202009;4372;11701;3386;9854;165;460;2262;6408;2427;6868
260520;202009;17116;39448;14899;36598;756;1828;12133;29425;12889;31253
260530;202009;9793;27842;8317;25549;146;683;7131;21589;7277;22272
260540;202009;7220;15561;6352;14460;147;341;5699;12883;5846;13224
260545;202009;67;206;39;135;3;12;15;49;18;61
260550;202009;3102;8497;2539;7571;114;448;1728;5027;1842;5475
260560;202009;5909;15035;4958;13665;125;478;4172;11257;4297;11735
260570;202009;7726;20899;6782;19621;372;1180;5331;15476;5703;16656
260580;202009;4472;10541;4009;9931;28;98;3655;8995;3683;9093
260590;202009;6712;15510;5622;14289;230;553;4651;11995;4881;12548
260600;202009;30970;79818;25072;70717;1124;3492;18929;52462;20053;55954
260610;202009;7316;18793;6524;17759;390;1133;4895;13244;5285;14377
260620;202009;16499;42439;14354;39336;1263;3897;10419;27953;11682;31850
260630;202009;2392;6421;1951;5716;36;150;1573;4498;1609;4648
260640;202009;21941;49083;18278;44857;841;2039;14729;35966;15570;38005
260650;202009;6293;16077;5022;14520;401;854;4064;12074;4465;12928
260660;202009;7032;18472;6059;17168;159;674;5175;14334;5334;15008
260670;202009;2240;5820;1879;5270;77;194;1372;3779;1449;3973
260680;202009;28909;68438;24285;61823;1689;4575;17125;42711;18814;47286
260690;202009;3545;9114;2939;8175;88;340;2300;6332;2388;6672
260700;202009;6107;17137;5686;16654;20;69;5500;16219;5520;16288
260710;202009;1367;3562;1175;3288;33;126;918;2565;951;2691
260720;202009;23970;59011;20491;54353;1982;5359;14776;39002;16758;44361
260730;202009;7805;22132;6794;20713;263;964;5666;17022;5929;17986
260740;202009;1337;3768;1123;3417;14;73;876;2726;890;2799
260750;202009;7210;19533;6009;18033;258;523;5222;16187;5480;16710
260760;202009;5752;13483;4932;12511;200;530;4047;10312;4247;10842
260765;202009;8077;23122;7007;21646;411;1701;4943;14955;5354;16656
260770;202009;3873;9825;3210;8728;125;395;2508;6729;2633;7124
260775;202009;5232;13864;4589;12884;189;700;3585;9710;3774;10410
260780;202009;3661;10787;3257;10137;284;1052;2082;6243;2366;7295
260790;202009;121106;269411;99824;241483;15250;35644;61376;149015;76626;184659
260795;202009;3009;7653;2571;7082;80;267;2004;5565;2084;5832
260800;202009;5410;12443;4799;11589;124;394;4205;9819;4329;10213
260805;202009;3672;10269;3087;9238;157;552;2322;6802;2479;7354
260810;202009;6536;17644;5717;16062;478;1251;4114;11345;4592;12596
260820;202009;4587;10501;4011;9802;100;360;3313;7894;3413;8254
260825;202009;2928;8655;2542;7981;106;377;1899;5886;2005;6263
260830;202009;4240;12279;3504;10928;456;1249;2223;7169;2679;8418
260840;202009;4202;10840;3740;10203;206;525;3098;8469;3304;8994
260845;202009;4405;11540;3900;10679;225;638;2917;7870;3142;8508
260850;202009;5158;14013;4283;12343;345;1067;2750;7655;3095;8722
260860;202009;3515;9874;2961;8912;102;360;2355;6907;2457;7267
260870;202009;4567;10892;3875;10046;68;251;3451;8828;3519;9079
260875;202009;7149;17387;5844;15474;564;1487;3960;10574;4524;12061
260880;202009;9782;27268;8448;24948;483;1460;6594;19445;7077;20905
260890;202009;13088;33415;11297;30666;606;1754;8219;21773;8825;23527
260900;202009;5431;14994;4452;13602;319;1028;2950;9000;3269;10028
260910;202009;3255;8728;2811;8057;101;324;2204;6264;2305;6588
260915;202009;5192;15098;4533;14328;58;269;4139;13098;4197;13367
260920;202009;3311;8100;2784;7533;99;250;2375;6494;2474;6744
260930;202009;3761;11763;3185;10723;183;735;2359;7751;2542;8486
260940;202009;14889;35049;12933;32328;1017;2477;9700;23929;10717;26406
260950;202009;7085;18746;5702;16343;367;1243;3694;10099;4061;11342
260960;202009;71206;157940;57010;139613;6294;15826;36141;87415;42435;103241
260970;202009;5673;14736;5029;13875;258;568;3764;10582;4022;11150
260980;202009;4556;13114;4009;12425;55;194;3652;11410;3707;11604
260990;202009;18305;49632;15456;45722;875;2809;12034;35229;12909;38038
261000;202009;16391;38301;13729;34895;376;1310;11059;27420;11435;28730
261010;202009;2391;6214;2086;5814;74;187;1810;5075;1884;5262
261020;202009;6143;16571;5258;15044;192;702;4261;11716;4453;12418
261030;202009;4063;11667;3514;10722;123;501;2776;8235;2899;8736
261040;202009;5267;15270;4242;13319;150;597;3175;9721;3325;10318
261050;202009;7846;20276;7113;19120;451;877;5418;14682;5869;15559
261060;202009;14306;35447;12412;33135;270;886;10353;27338;10623;28224
261070;202009;65779;142035;54385;126968;2967;6764;41460;94670;44427;101434
261080;202009;6746;16007;6146;15254;135;329;5658;14026;5793;14355
261090;202009;19458;45317;17282;42503;295;968;15166;36650;15461;37618
261100;202009;8477;23208;7314;21463;510;1594;5310;15618;5820;17212
261110;202009;67511;185730;56264;165499;7930;24525;32688;95031;40618;119556
261120;202009;3698;9203;3179;8497;87;222;2736;7322;2823;7544
261130;202009;7349;17793;6427;16544;119;360;5681;14505;5800;14865
261140;202009;3711;8457;3289;7890;181;457;2618;6185;2799;6642
261150;202009;5326;13810;4696;12858;73;271;4077;11039;4150;11310
261153;202009;1886;5658;1600;5100;57;200;1077;3451;1134;3651
261160;202009;214547;494313;173136;436654;42177;109704;71265;182960;113442;292664
261170;202009;6039;14999;5355;13974;316;752;4270;11077;4586;11829
261180;202009;9628;23800;8394;22176;463;1167;6091;16195;6554;17362
261190;202009;4647;13414;4140;12569;179;763;3253;9549;3432;10312
261200;202009;3419;7838;3035;7320;123;321;2558;6053;2681;6374
261210;202009;1924;4609;1630;4197;66;189;1368;3459;1434;3648
261220;202009;13813;38848;11439;34449;1436;4685;6502;19290;7938;23975
261230;202009;4029;11486;3358;10555;48;198;2790;8848;2838;9046
261240;202009;5417;13428;4734;12346;268;696;3863;9935;4131;10631
261245;202009;3666;10262;3066;9200;75;360;2432;7047;2507;7407
261247;202009;2954;8773;2438;7837;162;561;1649;5267;1811;5828
261250;202009;22584;51194;19537;47619;1759;3835;14811;37053;16570;40888
261255;202009;4099;11988;3313;10459;142;628;2430;7425;2572;8053
261260;202009;12786;34263;11027;31966;350;1436;9460;27023;9810;28459
261270;202009;4491;10908;3909;10162;192;526;3224;8272;3416;8798
261280;202009;2592;7135;2273;6588;69;243;1808;5094;1877;5337
261290;202009;2988;7629;2497;7069;69;272;2017;5748;2086;6020
261300;202009;12606;34733;10645;31389;592;2076;7730;22291;8322;24367
261310;202009;8848;22370;7534;20576;626;1913;5529;14728;6155;16641
261320;202009;5954;16775;5181;15504;79;343;4347;12811;4426;13154
261330;202009;5862;14293;5264;13509;125;442;4566;11494;4691;11936
261340;202009;4303;11887;3716;11131;140;509;3073;9099;3213;9608
261350;202009;8788;25482;7773;23772;126;575;6315;19030;6441;19605
261360;202009;8228;19740;6945;17920;243;687;5523;13872;5766;14559
261370;202009;24035;59529;20088;54029;2138;5634;12924;35060;15062;40694
261380;202009;4138;12345;3630;11454;457;1504;2368;7365;2825;8869
261390;202009;16947;47532;14241;43134;1231;4037;9447;28364;10678;32401
261400;202009;4654;14644;4034;13307;170;744;3009;9651;3179;10395
261410;202009;9707;23982;7942;21256;454;1303;6258;16343;6712;17646
261420;202009;7431;22037;6674;21099;778;2820;4689;14741;5467;17561
261430;202009;3439;9647;2885;8776;59;264;2403;7202;2462;7466
261440;202009;1486;4402;1234;3912;38;182;882;2670;920;2852
261450;202009;15054;40310;13261;37525;184;672;10966;31073;11150;31745
261460;202009;7563;20673;6665;19251;290;911;5304;15236;5594;16147
261470;202009;4186;10328;3638;9604;24;125;3136;8259;3160;8384
261480;202009;5107;15518;4388;14308;199;790;3381;10804;3580;11594
261485;202009;4979;14104;4268;12979;329;1092;3054;9141;3383;10233
261500;202009;5919;15050;5170;14029;386;928;3605;10173;3991;11101
261510;202009;1913;5609;1652;5177;64;237;1254;3953;1318;4190
261520;202009;2358;7185;2117;6685;70;250;1542;4835;1612;5085
261530;202009;12039;34998;9725;30728;906;3398;4946;15069;5852;18467
261540;202009;8152;23229;7312;22017;1071;3179;4149;13185;5220;16364
261550;202009;3708;9768;3198;8963;232;691;2284;6285;2516;6976
261560;202009;7816;23083;6746;21488;285;1078;5186;16526;5471;17604
261570;202009;3553;9462;2831;8302;190;667;1956;5625;2146;6292
261580;202009;6822;17686;5869;16393;111;513;5258;14471;5369;14984
261590;202009;2741;6962;2192;6175;74;243;1648;4614;1722;4857
261600;202009;5163;12927;4328;11672;302;721;3029;8390;3331;9111
261610;202009;2213;6222;1768;5413;98;358;1201;3636;1299;3994
261618;202009;2563;6300;2231;5812;79;203;1778;4612;1857;4815
261620;202009;4229;11793;3854;11240;797;2044;2449;7519;3246;9563
261630;202009;6345;17724;5364;15869;364;1284;3594;10196;3958;11480
261640;202009;37753;84016;32026;76900;1875;3566;24075;59622;25950;63188
261650;202009;4154;10221;3523;9389;154;482;2633;6962;2787;7444
270010;202009;4330;14383;3711;13315;169;946;2935;10216;3104;11162
270020;202009;3898;9677;3388;9017;133;441;2888;7512;3021;7953
270030;202009;34475;92628;28633;83181;3671;10453;18977;55160;22648;65613
270040;202009;10850;28889;9283;27028;371;1377;7675;22139;8046;23516
270050;202009;5555;12814;4716;11859;229;545;4115;10398;4344;10943
270060;202009;2187;5445;1815;5020;155;373;1436;4034;1591;4407
270070;202009;4684;13041;4059;12163;140;521;3364;9879;3504;10400
270080;202009;1468;3962;1226;3548;42;130;936;2599;978;2729
270090;202009;1771;5400;1585;5031;64;260;1295;4013;1359;4273
270100;202009;5480;14388;4709;13248;151;573;3915;10807;4066;11380
270110;202009;3267;7574;2625;6829;141;322;2073;5641;2214;5963
270120;202009;2765;7507;2386;6999;73;310;2009;5798;2082;6108
270130;202009;5122;12995;4418;12158;130;395;3802;10491;3932;10886
270135;202009;2044;4841;1728;4489;49;152;1562;4039;1611;4191
270140;202009;9737;22526;7772;19807;321;1072;6113;14837;6434;15909
270150;202009;2715;8081;2473;7733;2;13;2335;7281;2337;7294
270160;202009;6299;16722;5317;15619;73;325;4915;14423;4988;14748
270170;202009;3390;9867;2852;9114;177;838;2162;6612;2339;7450
270180;202009;2245;6898;2041;6633;37;177;1839;5931;1876;6108
270190;202009;1639;4853;1447;4614;35;176;1267;4012;1302;4188
270200;202009;2426;7319;2106;6885;113;427;1528;4965;1641;5392
270210;202009;5731;13405;4868;12438;74;312;4472;11237;4546;11549
270220;202009;1545;4005;1237;3573;209;629;699;1997;908;2626
270230;202009;9399;25839;7731;23250;649;2151;5486;16341;6135;18492
270235;202009;5699;17459;4896;16175;118;540;4031;13173;4149;13713
270240;202009;10647;29170;8568;26251;955;3175;5923;18179;6878;21354
270250;202009;2757;6934;2407;6428;187;491;1898;5065;2085;5556
270255;202009;4445;12676;3437;10825;111;455;2619;8116;2730;8571
270260;202009;5597;16386;5061;15503;101;501;4427;13244;4528;13745
270270;202009;1048;2698;866;2472;101;297;634;1793;735;2090
270280;202009;3953;9376;3113;8323;489;799;2163;6257;2652;7056
270290;202009;7424;23573;6636;22252;181;858;5748;19059;5929;19917
270300;202009;4268;10951;3304;9909;168;440;2539;7810;2707;8250
270310;202009;6964;19347;5959;17779;96;511;5086;14783;5182;15294
270320;202009;5559;16232;4826;14810;430;1358;3411;10208;3841;11566
270330;202009;3878;12572;3436;11895;263;1029;2623;9040;2886;10069
270340;202009;1602;4323;1384;4035;45;146;1173;3368;1218;3514
270350;202009;1906;4457;1563;4049;146;414;1105;2874;1251;3288
270360;202009;2621;6520;2332;6193;75;163;2145;5736;2220;5899
270370;202009;1398;4286;1268;4041;36;165;1059;3320;1095;3485
270375;202009;3128;7230;2588;6635;19;62;2429;6241;2448;6303
270380;202009;5484;15348;4598;14185;624;1856;2985;9572;3609;11428
270390;202009;1212;3027;984;2763;23;93;808;2265;831;2358
270400;202009;6298;16480;5258;14911;253;722;4067;11457;4320;12179
270410;202009;4616;13196;3970;12194;151;533;3289;10052;3440;10585
270420;202009;5527;16271;4950;15422;127;608;4281;13077;4408;13685
270430;202009;135458;320391;106193;282835;20984;58131;50322;136063;71306;194194
270440;202009;4708;12691;4045;11870;88;387;3512;10166;3600;10553
270450;202009;7095;18946;6200;17865;267;878;5170;15040;5437;15918
270460;202009;3794;8356;3255;7715;158;321;2915;6931;3073;7252
270470;202009;11117;30781;9606;28627;656;2157;7381;21955;8037;24112
270480;202009;2970;7827;2497;7139;93;358;2035;5678;2128;6036
270490;202009;958;2619;827;2459;49;157;659;1945;708;2102
270500;202009;4924;14949;4347;13991;290;1066;3385;10759;3675;11825
270510;202009;5585;14735;4694;13600;338;1334;3497;9645;3835;10979
270520;202009;3980;11270;3133;9819;643;2103;1284;4180;1927;6283
270530;202009;1269;3597;1077;3304;53;154;762;2371;815;2525
270540;202009;2225;6317;1908;5903;60;264;1654;5026;1714;5290
270550;202009;6755;17341;5363;15809;594;1417;4000;12270;4594;13687
270560;202009;2963;7678;2544;7111;129;411;2053;5685;2182;6096
270570;202009;4145;11556;3495;10581;118;375;2836;8532;2954;8907
270580;202009;2284;6417;2064;6095;101;302;1783;5217;1884;5519
270590;202009;1604;4790;1477;4625;15;78;1390;4323;1405;4401
270600;202009;2768;8463;2501;8063;47;242;2215;7060;2262;7302
270610;202009;3631;9471;3128;8809;68;261;2803;7807;2871;8068
270620;202009;1220;3712;1109;3492;34;147;945;2882;979;3029
270630;202009;17626;42797;15082;39283;591;1873;12643;32202;13234;34075
270640;202009;5396;15466;4651;14263;169;685;3779;11357;3948;12042
270642;202009;2518;8041;2223;7559;154;660;1699;5646;1853;6306
270644;202009;3613;8957;2951;8091;282;685;2200;6201;2482;6886
270650;202009;3152;9210;2755;8646;359;1210;1951;6075;2310;7285
270660;202009;2054;5156;1707;4656;88;310;1262;3387;1350;3697
270670;202009;16415;37342;13557;33836;392;1159;11530;28142;11922;29301
270680;202009;5583;13112;4967;12439;124;178;4641;11777;4765;11955
270690;202009;9186;22356;7644;20419;499;1314;6006;16004;6505;17318
270700;202009;520;1552;450;1437;30;119;322;1009;352;1128
270710;202009;5439;16350;4799;15360;229;964;3850;12097;4079;13061
270720;202009;3616;10521;3190;9803;64;346;2804;8437;2868;8783
270730;202009;8183;18025;7132;16895;249;491;5572;14686;5821;15177
270740;202009;2386;6219;2101;5884;91;309;1748;4824;1839;5133
270750;202009;5733;14966;5004;14036;80;376;4447;12385;4527;12761
270760;202009;3272;9157;2827;8555;48;247;2399;7166;2447;7413
270770;202009;20930;50814;16663;45601;2617;6476;10362;29926;12979;36402
270780;202009;1802;4980;1652;4766;80;286;1408;3992;1488;4278
270790;202009;1617;4452;1351;4084;101;325;994;2979;1095;3304
270800;202009;10938;29582;9786;27939;339;1223;8381;23547;8720;24770
270810;202009;3324;9441;2608;8223;171;664;1821;5630;1992;6294
270820;202009;1637;4896;1377;4477;54;261;1079;3416;1133;3677
270830;202009;5181;12304;4168;11057;164;538;3380;8820;3544;9358
270840;202009;8257;24454;7328;23124;173;941;6397;19671;6570;20612
270850;202009;9066;21360;7990;20069;655;1871;6588;16262;7243;18133
270860;202009;14429;31817;11368;28319;600;1391;9161;22788;9761;24179
270870;202009;2164;6103;1779;5476;230;690;1170;3687;1400;4377
270880;202009;8114;24151;7194;22766;220;941;5947;18475;6167;19416
270890;202009;2823;7607;2364;6948;181;554;1640;4811;1821;5365
270895;202009;3131;9494;2825;9091;71;392;2491;7837;2562;8229
270900;202009;1785;4594;1342;3877;36;107;1045;2985;1081;3092
270910;202009;3881;11156;3324;10276;92;303;2703;8266;2795;8569
270915;202009;9441;26879;7593;23840;655;2397;5162;15830;5817;18227
270920;202009;5108;15830;4605;14961;155;775;3793;11902;3948;12677
270930;202009;17363;40151;13440;35589;1883;4533;8969;24968;10852;29501
270940;202009;6600;17098;5588;15890;193;870;4546;12546;4739;13416
280010;202009;697;1906;541;1566;14;58;381;994;395;1052
280020;202009;4926;12373;4160;11157;467;1181;2813;7612;3280;8793
280030;202009;76211;177936;59867;154684;12557;32816;26573;71541;39130;104357
280040;202009;2906;8114;2519;7505;246;754;1688;4995;1934;5749
280050;202009;3856;10924;3301;10046;557;1766;1947;5913;2504;7679
280060;202009;5918;15429;4680;13501;879;2675;2181;6550;3060;9225
280067;202009;6961;17042;5898;15437;318;826;4324;11184;4642;12010
280070;202009;1921;5638;1783;5418;128;395;1468;4434;1596;4829
280100;202009;4007;10606;3357;9568;317;936;2303;6555;2620;7491
280110;202009;1379;3726;1199;3458;17;85;1054;2959;1071;3044
280120;202009;7611;21813;6768;20459;748;2096;4928;15275;5676;17371
280130;202009;9228;21427;8057;19745;412;1102;6529;15831;6941;16933
280140;202009;5483;13044;4809;12143;205;597;4080;10182;4285;10779
280150;202009;4241;10600;3659;9797;354;879;2784;7496;3138;8375
280160;202009;1224;3457;1019;3116;93;312;694;2068;787;2380
280170;202009;5198;13682;4636;12938;234;642;3736;10435;3970;11077
280190;202009;1303;2822;1132;2595;55;123;924;2078;979;2201
280200;202009;1267;3300;1039;2976;73;265;772;2163;845;2428
280210;202009;16763;41626;14505;38393;1544;4219;9231;24452;10775;28671
280220;202009;1760;4674;1506;4332;46;214;1237;3515;1283;3729
280230;202009;4363;10878;3660;9843;308;682;2565;7003;2873;7685
280240;202009;3324;8846;2957;8282;55;284;2529;6856;2584;7140
280250;202009;884;2169;715;1913;69;205;471;1219;540;1424
280260;202009;2238;5307;1974;4981;38;101;1789;4546;1827;4647
280270;202009;2406;6459;2116;6006;132;385;1730;4861;1862;5246
280280;202009;4215;12402;3728;11673;493;1325;2605;8549;3098;9874
280290;202009;18169;47735;15539;44034;1378;4138;10349;29597;11727;33735
280300;202009;11983;28616;10430;26946;291;819;7711;21915;8002;22734
280310;202009;1400;3569;1150;3140;39;136;862;2280;901;2416
280320;202009;8653;23245;7495;21506;899;2595;5009;14233;5908;16828
280330;202009;4746;11651;4013;10627;266;730;2931;7739;3197;8469
280340;202009;5480;11457;4570;10471;226;385;3956;9249;4182;9634
280350;202009;26245;61025;22937;56645;1133;2981;18056;43816;19189;46797
280360;202009;5790;15859;5028;14588;756;2220;2934;8650;3690;10870
280370;202009;2151;5302;1792;4707;62;167;1414;3654;1476;3821
280380;202009;1005;2649;859;2447;77;215;584;1691;661;1906
280390;202009;3692;9035;3071;8053;147;366;2442;6371;2589;6737
280400;202009;3945;9897;3398;9130;533;1256;2055;5846;2588;7102
280410;202009;2269;6245;1815;5504;193;601;1043;3107;1236;3708
280420;202009;4319;11368;3954;10904;72;276;3625;9925;3697;10201
280430;202009;2072;5005;1806;4650;66;244;1467;3657;1533;3901
280440;202009;4314;11376;3768;10578;151;511;3167;8680;3318;9191
280445;202009;2334;5906;2076;5460;50;158;1559;3922;1609;4080
280450;202009;10331;23772;8917;21839;1012;2098;5941;15177;6953;17275
280460;202009;6936;16306;6263;15361;334;809;5339;12924;5673;13733
280470;202009;1708;4779;1460;4332;69;235;1075;3104;1144;3339
280480;202009;43051;103907;37008;95276;3034;8409;26220;66043;29254;74452
280490;202009;3743;10588;3213;9662;94;404;2483;7222;2577;7626
280500;202009;1008;2391;856;2184;36;114;712;1778;748;1892
280510;202009;2575;6459;2225;5964;78;283;1720;4503;1798;4786
280520;202009;1613;4091;1404;3801;59;162;1120;2994;1179;3156
280530;202009;2452;6109;2108;5624;294;656;1469;4046;1763;4702
280540;202009;8962;23821;8131;22617;260;894;7104;19457;7364;20351
280550;202009;6699;15445;5486;13739;179;643;4524;10911;4703;11554
280560;202009;7229;19891;6751;19179;155;564;5921;16606;6076;17170
280570;202009;6488;15686;5259;14123;230;713;3937;10510;4167;11223
280580;202009;5717;15011;4950;13864;585;1440;3466;9903;4051;11343
280590;202009;2934;6571;2491;6063;111;419;1957;4569;2068;4988
280600;202009;3596;9458;3151;8832;173;534;2243;6288;2416;6822
280610;202009;2486;6076;2232;5695;141;356;1831;4636;1972;4992
280620;202009;5498;13309;4701;12257;426;931;3284;8949;3710;9880
280630;202009;3837;10670;3504;10199;166;600;2879;8275;3045;8875
280640;202009;2364;6307;2080;5981;55;169;1847;5318;1902;5487
280650;202009;1194;3106;956;2749;87;295;711;1952;798;2247
280660;202009;3706;8081;3167;7449;221;412;2623;6294;2844;6706
280670;202009;19889;44549;17077;40955;1011;2470;13466;32120;14477;34590
280680;202009;2815;6692;2399;6106;230;426;1717;4454;1947;4880
280690;202009;972;2341;819;2140;53;120;642;1658;695;1778
280700;202009;1171;2926;1012;2687;29;103;798;2084;827;2187
280710;202009;15404;34260;12970;31489;532;991;10923;27255;11455;28246
280720;202009;2679;6066;2218;5518;60;188;1617;4156;1677;4344
280730;202009;1071;2739;955;2549;44;141;729;1874;773;2015
280740;202009;14158;34408;12008;31133;731;2063;8609;21732;9340;23795
280750;202009;3646;10070;3161;9231;197;624;2267;6514;2464;7138
280760;202009;6429;16883;5561;15540;594;1505;3633;10483;4227;11988
290010;202009;3200;6693;2085;4954;6;19;1709;3883;1715;3902
290020;202009;5399;14172;4883;13509;347;640;4092;11739;4439;12379
290030;202009;4618;10449;3708;9450;179;411;3129;8076;3308;8487
290035;202009;5220;11245;4307;10061;365;544;3412;8322;3777;8866
290040;202009;4242;10273;3587;9483;108;288;2810;7846;2918;8134
290050;202009;2045;6563;1702;5809;117;482;1132;3767;1249;4249
290060;202009;1355;3208;999;2648;91;264;645;1690;736;1954
290070;202009;37507;81487;32081;74708;1780;4338;24928;57395;26708;61733
290080;202009;5323;15462;4552;14304;460;1560;3171;10058;3631;11618
290090;202009;2160;4136;1516;3447;17;53;1383;3118;1400;3171
290100;202009;9827;25504;7915;22616;1295;3475;4279;12828;5574;16303
290110;202009;5227;13716;4623;12771;330;929;3332;9108;3662;10037
290115;202009;3974;11402;3325;10224;226;766;2456;7476;2682;8242
290120;202009;6563;16031;5509;14575;140;464;4723;12286;4863;12750
290130;202009;4728;11421;3673;10052;163;472;2850;7777;3013;8249
290135;202009;4288;9990;3488;8683;191;487;2725;6597;2916;7084
290140;202009;4566;11831;3487;10378;97;359;2924;8644;3021;9003
290150;202009;2470;6332;2122;5898;140;384;1634;4578;1774;4962
290160;202009;3413;7687;3008;7128;283;582;2361;5618;2644;6200
290170;202009;3390;8510;2985;8065;111;306;2660;7253;2771;7559
290180;202009;2982;8108;2449;7232;85;303;1993;5830;2078;6133
290190;202009;4259;11793;3718;11053;143;549;3056;8962;3199;9511
290195;202009;2352;5804;1872;5170;27;136;1582;4328;1609;4464
290200;202009;4122;11407;3337;10097;186;622;2506;7502;2692;8124
290205;202009;3478;8923;3040;8253;143;499;2349;6155;2492;6654
290210;202009;12999;36120;11461;33773;870;2359;8830;26454;9700;28813
290220;202009;2898;7115;2535;6644;119;323;2067;5401;2186;5724
290225;202009;3231;6868;2480;6073;159;281;2060;5152;2219;5433
290230;202009;2447;6442;2222;6173;31;98;1997;5534;2028;5632
290240;202009;3746;9366;2975;8383;74;247;2502;7050;2576;7297
290250;202009;3969;11482;3306;10495;108;374;2707;8715;2815;9089
290260;202009;5537;13347;4595;11983;168;533;3822;9728;3990;10261
290265;202009;3543;10200;2854;8866;209;639;2008;6244;2217;6883
290270;202009;11064;37398;10315;36112;555;2411;8267;28651;8822;31062
290280;202009;6174;18297;5319;16589;300;1048;3819;11746;4119;12794
290290;202009;10039;28956;8074;25331;804;2718;5267;16311;6071;19029
290300;202009;4240;11485;3106;9333;158;513;2223;6648;2381;7161
290310;202009;1600;3926;1262;3513;56;236;972;2613;1028;2849
290320;202009;24745;64113;19504;56032;4315;12155;9223;27976;13538;40131
290323;202009;3781;10263;3274;9473;105;332;2586;7451;2691;7783
290327;202009;4127;11959;3505;10740;256;734;2504;7638;2760;8372
290330;202009;2217;4613;1714;4071;47;85;1516;3659;1563;3744
290340;202009;5784;14308;4444;12660;443;1302;3193;9241;3636;10543
290350;202009;4782;13123;3947;11706;281;837;2808;8376;3089;9213
290360;202009;5085;13233;4443;12395;131;344;3807;10721;3938;11065
290370;202009;5260;12765;3840;10879;156;409;2767;7992;2923;8401
290380;202009;5605;14798;4686;13544;114;278;4018;11831;4132;12109
290390;202009;14661;41421;12107;37379;1307;3967;7845;24645;9152;28612
290395;202009;2858;8229;2288;7241;67;317;1738;5410;1805;5727
290400;202009;3806;10173;3034;8899;83;352;2310;6594;2393;6946
290405;202009;4690;13542;3991;12319;301;959;2729;8613;3030;9572
290410;202009;5772;15524;4402;13316;119;524;3301;9724;3420;10248
290420;202009;3020;8325;2485;7480;72;250;1911;5710;1983;5960
290430;202009;3206;8708;2617;7786;227;708;1773;5205;2000;5913
290440;202009;2905;7122;2074;5802;48;122;1457;4142;1505;4264
290450;202009;3540;8922;2748;7711;157;421;1989;5654;2146;6075
290460;202009;11966;33517;10007;29761;2015;6093;4394;13074;6409;19167
290470;202009;4577;11209;3356;9515;393;1223;1898;5462;2291;6685
290475;202009;6554;18886;5513;17035;88;494;4501;13596;4589;14090
290480;202009;1793;4534;1462;4046;82;282;1008;2660;1090;2942
290485;202009;4532;13110;3992;12351;101;519;3403;10335;3504;10854
290490;202009;9246;21583;8243;20219;501;1117;6444;16048;6945;17165
290500;202009;4066;12106;3105;10015;540;1823;1351;4237;1891;6060
290510;202009;3502;8660;2902;7876;76;247;2500;6742;2576;6989
290515;202009;3690;10114;3173;9415;44;132;2845;8596;2889;8728
290520;202009;11627;32923;8950;27739;596;1983;5421;16586;6017;18569
290530;202009;5041;14302;4223;12964;136;522;3555;10854;3691;11376
290540;202009;3389;8855;3017;8425;52;175;2782;7736;2834;7911
290550;202009;4324;11186;3728;10482;11;59;3428;9743;3439;9802
290560;202009;6454;16617;4874;14264;416;1492;3188;9031;3604;10523
290570;202009;45023;109879;39756;103152;2511;6688;31875;82165;34386;88853
290580;202009;7821;22705;6718;21093;598;1828;4915;15822;5513;17650
290590;202009;7136;21733;6003;19700;146;576;4828;15911;4974;16487
290600;202009;19121;52550;16809;48776;691;2124;13518;39084;14209;41208
290610;202009;2613;8025;2030;6826;94;379;1417;4703;1511;5082
290620;202009;6394;17886;5498;16405;199;570;4613;13744;4812;14314
290630;202009;9291;22319;7347;19807;557;1495;5660;15379;6217;16874
290640;202009;2818;7194;2148;6221;84;246;1553;4593;1637;4839
290650;202009;13238;32628;11674;30855;2565;6471;7233;20000;9798;26471
290660;202009;3671;9341;3039;8419;53;151;2283;6521;2336;6672
290670;202009;6814;18676;5723;16869;377;1048;4329;12946;4706;13994
290680;202009;10896;30040;9104;27370;209;1089;7488;22030;7697;23119
290682;202009;4817;12232;4151;11342;123;277;3502;9658;3625;9935
290685;202009;3504;7861;2496;6408;203;482;1528;4206;1731;4688
290687;202009;6652;17862;5366;15742;709;1999;3423;10308;4132;12307
290689;202009;2859;7873;2177;6607;202;658;1474;4449;1676;5107
290690;202009;5556;14335;4484;12816;306;941;3241;9125;3547;10066
290700;202009;2638;7171;2315;6760;71;236;1946;5704;2017;5940
290710;202009;8298;23256;7086;21564;157;630;5969;18178;6126;18808
290720;202009;18570;50521;16845;47897;936;2951;13487;37860;14423;40811
290730;202009;7143;16809;6071;15555;299;591;4763;12432;5062;13023
290740;202009;1038;2769;795;2372;35;113;654;1954;689;2067
290750;202009;11136;27653;9605;25186;638;1796;7109;18101;7747;19897
290755;202009;2105;5905;1677;5123;92;290;1159;3568;1251;3858
290760;202009;3769;10903;3020;9462;182;528;2042;6603;2224;7131
290770;202009;2661;8363;2429;8071;50;254;2038;6823;2088;7077
290780;202009;8302;20398;7151;18884;286;611;5564;15063;5850;15674
290790;202009;4721;12930;4080;12005;167;476;3348;9992;3515;10468
290800;202009;7156;14787;5048;12305;297;685;3741;9197;4038;9882
290810;202009;5423;14145;4329;12533;111;355;3260;9648;3371;10003
290820;202009;4859;13122;4346;12378;183;526;3276;9459;3459;9985
290830;202009;4488;10155;3971;9511;29;81;3497;8275;3526;8356
290840;202009;17220;45248;14707;41338;1917;4432;9403;28149;11320;32581
290850;202009;6692;15996;5978;15227;208;517;5123;13179;5331;13696
290860;202009;6200;17612;5387;16665;218;712;4523;14277;4741;14989
290870;202009;4827;13192;3625;10898;151;468;2544;7584;2695;8052
290880;202009;1398;3468;1113;3093;76;188;763;2214;839;2402
290890;202009;9343;18725;8354;17614;150;321;7842;16466;7992;16787
290900;202009;2420;6265;1842;5255;103;246;1142;3233;1245;3479
290910;202009;5177;12303;3940;10420;50;157;3336;8737;3386;8894
290920;202009;5182;12834;4694;12267;80;126;4388;11645;4468;11771
290930;202009;7711;21327;6149;18597;213;877;4785;14097;4998;14974
290940;202009;3717;10339;3051;9373;161;576;2432;7466;2593;8042
290950;202009;1476;3685;1198;3263;67;188;834;2281;901;2469
290960;202009;5515;14325;4928;13590;189;470;4141;11485;4330;11955
290970;202009;3362;9823;2731;8675;106;383;2091;6643;2197;7026
290980;202009;12183;29097;10167;25995;800;2228;6317;15692;7117;17920
290990;202009;9761;25613;8581;23688;260;1034;7200;19184;7460;20218
291000;202009;3445;8832;2663;7835;119;361;2165;6438;2284;6799
291005;202009;15394;37679;13514;35206;1240;2939;10505;27603;11745;30542
291010;202009;3092;9293;2495;8013;119;429;1640;5127;1759;5556
291020;202009;1248;3080;997;2631;22;74;723;1800;745;1874
291030;202009;2523;6111;1747;4768;110;274;1080;2868;1190;3142
291040;202009;5422;14794;4501;13481;162;623;3523;10505;3685;11128
291050;202009;7703;19957;6549;18355;632;1984;4758;13094;5390;15078
291060;202009;6027;18307;5094;17043;326;1408;3836;12757;4162;14165
291070;202009;16158;42990;13404;38576;422;1432;10892;31165;11314;32597
291072;202009;24823;63303;17742;51078;3239;9637;7535;21927;10774;31564
291075;202009;5466;13364;4889;12472;104;277;4072;10196;4176;10473
291077;202009;1622;4202;1256;3561;54;115;880;2493;934;2608
291080;202009;108897;267118;84996;233258;25140;70839;22939;68288;48079;139127
291085;202009;5652;14224;4735;12802;178;532;3931;10605;4109;11137
291090;202009;2020;3809;1450;3169;46;99;1167;2504;1213;2603
291100;202009;3235;7008;2218;5792;103;272;1688;4370;1791;4642
291110;202009;5995;17666;5067;16078;320;1299;3846;11747;4166;13046
291120;202009;7596;18468;6383;16921;306;871;4915;13000;5221;13871
291125;202009;2211;3860;1656;3240;94;137;1329;2651;1423;2788
291130;202009;3274;9222;2395;7495;64;292;1787;5401;1851;5693
291140;202009;4929;13191;3573;10727;447;1188;2196;6614;2643;7802
291150;202009;2506;5395;1925;4739;5;17;1816;4462;1821;4479
291160;202009;5130;13930;4220;12617;372;1180;2820;8363;3192;9543
291165;202009;2197;5904;1643;4824;27;119;1203;3423;1230;3542
291170;202009;21154;53294;17581;47237;943;2765;11581;30573;12524;33338
291180;202009;6386;14640;4647;12288;263;672;3593;9505;3856;10177
291185;202009;3100;8276;2701;7631;89;265;2075;5884;2164;6149
291190;202009;7702;18754;6319;16973;288;891;4991;13361;5279;14252
291200;202009;2812;7648;2069;6240;90;284;1273;3684;1363;3968
291210;202009;7112;15132;5298;13045;135;429;3917;9704;4052;10133
291220;202009;4092;11546;3672;10917;179;651;2911;8540;3090;9191
291230;202009;4477;9575;3367;8358;37;98;3031;7599;3068;7697
291240;202009;4247;10810;3615;9751;63;221;3098;8231;3161;8452
291250;202009;3442;10063;2661;8627;155;495;1705;5557;1860;6052
291260;202009;1443;3356;1177;3011;30;94;964;2474;994;2568
291270;202009;5431;13955;4193;12132;636;1852;2603;7709;3239;9561
291280;202009;2660;6409;1983;5409;147;423;1272;3414;1419;3837
291290;202009;5890;15383;4523;13254;337;1068;3110;9020;3447;10088
291300;202009;3861;10361;2976;8908;112;404;2264;6668;2376;7072
291310;202009;5154;13612;4378;12199;120;378;3693;10151;3813;10529
291320;202009;6138;16962;4751;14370;1061;2999;2334;7503;3395;10502
291330;202009;1781;4509;1469;3998;79;212;1094;2943;1173;3155
291340;202009;4294;11085;3468;9643;80;257;2620;7170;2700;7427
291345;202009;2946;8766;2669;8333;110;380;2238;6991;2348;7371
291350;202009;6909;16978;5353;15083;58;186;4640;13316;4698;13502
291360;202009;37799;85822;29511;75846;2811;7295;19235;50604;22046;57899
291370;202009;8109;21932;7142;20431;536;1618;5267;14810;5803;16428
291380;202009;3428;9284;2996;8688;99;405;2494;7177;2593;7582
291390;202009;13337;28406;10319;25060;453;1067;8523;20709;8976;21776
291400;202009;13988;35582;11450;31738;1543;3749;6746;20193;8289;23942
291410;202009;2981;7758;2306;6617;35;148;1688;4762;1723;4910
291420;202009;1959;4749;1524;4211;27;111;1326;3642;1353;3753
291430;202009;2781;7806;2398;7167;74;323;1927;5581;2001;5904
291440;202009;6424;18302;5518;16799;333;1077;4287;13062;4620;14139
291450;202009;9511;22587;7819;20629;79;133;6869;18667;6948;18800
291460;202009;15822;41538;13800;38506;690;2127;10367;28739;11057;30866
291465;202009;9410;22968;7389;20646;134;602;6387;17711;6521;18313
291470;202009;17012;37684;14163;34465;770;1648;10487;26317;11257;27965
291480;202009;41865;92480;30664;77122;3619;9379;16165;40706;19784;50085
291490;202009;5625;13888;4831;12981;139;444;4350;11627;4489;12071
291500;202009;5028;12214;4158;11057;69;304;3777;9989;3846;10293
291510;202009;4322;10639;3202;9219;52;294;2672;7623;2724;7917
291520;202009;4590;10343;3441;8828;184;494;2633;6704;2817;7198
291530;202009;2365;5360;1662;4435;329;802;915;2689;1244;3491
291535;202009;3443;9994;3043;9289;172;472;2335;7300;2507;7772
291540;202009;2299;5092;1572;4214;65;215;1288;3396;1353;3611
291550;202009;5694;12954;4424;11341;387;814;3007;7914;3394;8728
291560;202009;18769;43970;13434;36901;1324;3492;7974;22852;9298;26344
291570;202009;2443;5749;1920;5108;60;161;1573;4347;1633;4508
291580;202009;6360;16298;4991;14467;228;724;3680;10588;3908;11312
291590;202009;2193;5265;1901;4922;74;254;1683;4264;1757;4518
291600;202009;5598;12830;4290;10832;379;1013;2920;7135;3299;8148
291610;202009;5685;14795;5095;14140;80;301;4671;12936;4751;13237
291620;202009;3174;7032;2333;6110;105;269;1817;4859;1922;5128
291630;202009;3349;7453;2496;6335;288;797;1768;4396;2056;5193
291640;202009;16053;39307;12121;33619;1738;4684;5453;15702;7191;20386
291650;202009;9555;23601;8418;22248;568;1044;7074;19191;7642;20235
291660;202009;2098;5102;1516;4200;125;407;986;2569;1111;2976
291670;202009;2068;5420;1743;4953;104;258;1311;3788;1415;4046
291680;202009;4177;10170;3370;8996;291;803;2378;6295;2669;7098
291685;202009;4756;11245;3790;10006;233;478;2849;7816;3082;8294
291690;202009;4209;9200;2892;7286;243;499;2179;5544;2422;6043
291700;202009;8708;24937;7605;22997;326;1183;6178;18329;6504;19512
291710;202009;5375;12644;3948;10640;218;673;2877;7610;3095;8283
291720;202009;4542;13645;3762;12078;460;1546;2394;7547;2854;9093
291730;202009;6392;16202;5478;15009;266;803;4527;12333;4793;13136
291733;202009;2895;7329;2431;6713;60;168;1763;5114;1823;5282
291735;202009;2946;7728;2335;6644;72;165;1767;5003;1839;5168
291740;202009;3964;10156;2921;8215;94;238;2060;5725;2154;5963
291750;202009;19805;46948;16054;41450;1576;3975;10747;28132;12323;32107
291760;202009;10382;29720;8099;26036;2439;8888;2217;7098;4656;15986
291770;202009;7187;19139;5962;17027;347;1069;4481;12461;4828;13530
291780;202009;5174;13616;4645;12872;86;323;4082;11182;4168;11505
291790;202009;2790;7577;2523;7231;239;571;1886;5598;2125;6169
291800;202009;29578;74093;21955;62683;3482;9648;10685;31751;14167;41399
291810;202009;10745;25142;8917;22903;287;715;7513;19468;7800;20183
291820;202009;3861;10058;3332;9376;87;294;2675;7536;2762;7830
291830;202009;4499;10518;3672;9410;198;424;2892;7440;3090;7864
291835;202009;6548;19457;5123;16707;534;1844;3265;10798;3799;12642
291840;202009;48242;131070;41594;120746;4327;13373;29136;84073;33463;97446
291845;202009;2573;6565;2015;5874;112;338;1628;4802;1740;5140
291850;202009;3908;11136;3198;9947;259;765;2275;7259;2534;8024
291855;202009;2233;4308;1729;3748;41;94;1558;3385;1599;3479
291860;202009;2253;5840;1565;4519;45;124;1055;2931;1100;3055
291870;202009;1293;3234;859;2480;45;130;581;1646;626;1776
291875;202009;2952;8781;2539;7916;62;253;1860;5627;1922;5880
291880;202009;5661;15889;4777;14384;222;644;3565;10800;3787;11444
291890;202009;1671;3375;1072;2681;130;303;713;1792;843;2095
291900;202009;1243;2956;943;2492;20;79;735;1887;755;1966
291905;202009;2520;6361;2034;5585;79;286;1551;4097;1630;4383
291910;202009;3007;7432;2556;6892;56;196;2192;6050;2248;6246
291915;202009;7500;21082;6084;18694;222;775;4574;14231;4796;15006
291920;202009;26846;69138;22582;63175;2159;6583;15699;43062;17858;49645
291930;202009;2528;6772;2157;6254;241;709;1440;4208;1681;4917
291940;202009;3911;9913;2602;7685;195;569;1532;4501;1727;5070
291950;202009;9260;27709;7846;24975;294;1095;5425;17071;5719;18166
291955;202009;15599;39079;13852;36832;1170;3251;10801;28803;11971;32054
291960;202009;3066;8050;2544;7336;123;364;1974;5829;2097;6193
291970;202009;4547;11386;3791;10435;142;482;2847;7855;2989;8337
291980;202009;9729;27560;7651;23917;1044;3014;4565;14666;5609;17680
291990;202009;2329;5944;1902;5433;30;119;1758;5025;1788;5144
291992;202009;3994;9558;3169;8492;239;540;2500;6843;2739;7383
291995;202009;2121;5805;1733;5173;54;242;1307;3791;1361;4033
292000;202009;2677;6205;2172;5595;98;353;1693;4303;1791;4656
292010;202009;5772;13398;4684;11844;172;524;3884;9626;4056;10150
292020;202009;4612;13230;3811;11808;210;740;2737;8222;2947;8962
292030;202009;1843;5606;1678;5298;76;267;1060;3287;1136;3554
292040;202009;4482;11326;3465;9808;238;611;2637;7611;2875;8222
292045;202009;4030;10465;2977;8911;32;87;2628;8024;2660;8111
292050;202009;6630;18367;5318;16039;252;863;3404;10110;3656;10973
292060;202009;11492;26286;10507;25061;489;1094;9168;21663;9657;22757
292070;202009;5817;14999;5058;14094;299;835;4326;11995;4625;12830
292080;202009;3129;7830;2577;7115;80;264;2278;6250;2358;6514
292090;202009;4655;10003;3294;8364;255;665;2471;6319;2726;6984
292100;202009;11188;26943;9551;24886;968;2620;6633;17271;7601;19891
292105;202009;3593;8750;3123;8113;98;225;2573;6703;2671;6928
292110;202009;6029;14541;4244;11705;978;2748;1954;5396;2932;8144
292120;202009;7014;17788;5750;15684;356;1032;4364;11695;4720;12727
292130;202009;3462;8192;2837;7418;106;320;2216;5713;2322;6033
292140;202009;5092;11954;4257;10686;317;793;3377;8444;3694;9237
292145;202009;2383;6825;2003;6174;63;160;1537;4805;1600;4965
292150;202009;14315;38670;12380;35494;327;1225;10014;28309;10341;29534
292160;202009;2985;7178;2244;6221;42;114;1823;5301;1865;5415
292170;202009;8506;22422;7045;20043;340;1134;5319;14807;5659;15941
292180;202009;2905;7886;2119;6417;170;504;1296;3867;1466;4371
292190;202009;2977;7782;2534;7100;91;315;1986;5508;2077;5823
292200;202009;8529;21018;6350;17921;1049;3080;3273;9525;4322;12605
292205;202009;3884;10643;3352;9850;57;260;2926;8550;2983;8810
292210;202009;6530;15108;5256;13507;90;389;4723;12000;4813;12389
292220;202009;2187;5172;1912;4749;50;141;1516;3638;1566;3779
292225;202009;3224;9336;2818;8716;73;337;2381;7232;2454;7569
292230;202009;8628;20476;7701;19302;160;526;6638;16359;6798;16885
292240;202009;4804;13775;4165;12621;312;917;2906;8834;3218;9751
292250;202009;5849;14965;5251;14061;423;1106;3918;10451;4341;11557
292260;202009;3439;8885;3035;8357;96;254;2635;7267;2731;7521
292265;202009;3394;9131;2835;8286;74;307;2248;6444;2322;6751
292270;202009;4425;10034;3510;8948;114;278;2913;7426;3027;7704
292273;202009;2793;5889;2212;5183;52;87;1621;4072;1673;4159
292275;202009;1648;4264;1290;3781;58;164;973;2904;1031;3068
292280;202009;2646;6207;2123;5603;81;160;1798;4878;1879;5038
292285;202009;2567;6148;2044;5442;76;163;1660;4462;1736;4625
292290;202009;7483;19547;5905;17331;167;634;4828;14110;4995;14744
292300;202009;10610;26197;8338;23147;763;2260;5803;16138;6566;18398
292303;202009;2968;8394;2571;7760;84;209;2140;6521;2224;6730
292305;202009;2325;6194;2142;5942;44;202;1936;5271;1980;5473
292310;202009;6734;16795;5787;15647;146;481;5032;13478;5178;13959
292320;202009;6158;16705;4883;14339;274;886;3545;10139;3819;11025
292330;202009;2734;6008;2193;5401;98;196;1705;4370;1803;4566
292335;202009;4764;12291;4226;11522;219;515;3552;9769;3771;10284
292340;202009;5621;15609;4622;13688;226;674;3414;10035;3640;10709
292350;202009;2512;6768;2085;6180;77;285;1678;4997;1755;5282
292360;202009;4991;13193;4132;11746;238;755;2904;8105;3142;8860
292370;202009;10566;24387;9056;22422;129;415;8395;20527;8524;20942
292380;202009;6815;18900;6084;17599;392;1142;4628;13267;5020;14409
292390;202009;4575;8667;3355;7244;118;214;2938;6361;3056;6575
292400;202009;22675;63808;19524;58799;1915;5830;13338;40431;15253;46261
292405;202009;4505;10815;3777;9674;95;239;3126;7894;3221;8133
292410;202009;2229;5266;1851;4787;67;147;1629;4242;1696;4389
292420;202009;3468;10454;3148;9943;110;549;2701;8298;2811;8847
292430;202009;4911;14556;3687;12312;280;969;2401;8013;2681;8982
292440;202009;8491;26706;7834;25715;129;640;6999;22873;7128;23513
292450;202009;4023;11430;3144;9716;83;317;2454;7532;2537;7849
292460;202009;4917;13387;4009;11840;336;951;2882;8533;3218;9484
292465;202009;2712;6871;2303;6346;92;195;1525;4633;1617;4828
292467;202009;1909;5344;1680;5034;239;634;1161;3622;1400;4256
292470;202009;2999;7574;2314;6514;58;122;1795;5068;1853;5190
292480;202009;6363;14895;5119;13381;77;290;4626;11976;4703;12266
292490;202009;2118;5400;1767;4879;124;272;1326;3758;1450;4030
292500;202009;6673;18114;5309;15684;503;1568;3424;9974;3927;11542
292510;202009;13329;35707;10359;30964;537;1874;7209;21468;7746;23342
292520;202009;7045;17445;6238;16288;450;1215;4854;12552;5304;13767
292525;202009;5976;14104;4867;12860;124;282;4197;11284;4321;11566
292530;202009;28975;76247;22177;64634;5272;15526;8698;25915;13970;41441
292540;202009;4465;8149;3478;7093;122;207;3120;6388;3242;6595
292550;202009;8450;21627;6441;19215;491;1420;4537;14452;5028;15872
292560;202009;4423;10926;3835;10149;86;237;3174;8473;3260;8710
292570;202009;3631;9510;3035;8399;83;295;2539;6853;2622;7148
292575;202009;6952;19698;6361;18910;378;1089;5102;15331;5480;16420
292580;202009;7597;18983;6267;17015;132;440;5293;14214;5425;14654
292590;202009;7392;19612;6295;17706;263;843;5216;14396;5479;15239
292593;202009;2870;7098;2364;6247;68;174;1983;5185;2051;5359
292595;202009;5437;14323;4635;13340;152;509;3901;11156;4053;11665
292600;202009;10993;29661;9428;27264;321;935;7481;21701;7802;22636
292610;202009;4187;10841;3531;9685;203;468;2644;7351;2847;7819
292620;202009;6467;17497;5355;16156;129;290;4876;15016;5005;15306
292630;202009;8630;20944;6907;18194;711;1867;4428;11742;5139;13609
292640;202009;8255;24022;7142;22174;200;776;5079;15897;5279;16673
292650;202009;4489;10986;4036;10395;110;291;3667;9349;3777;9640
292660;202009;11509;30714;9706;28064;453;1457;7408;21410;7861;22867
292665;202009;2192;6392;1892;5997;67;198;1589;5115;1656;5313
292670;202009;3604;9636;2754;8050;118;371;1866;5341;1984;5712
292680;202009;3988;10430;3141;8957;188;495;2298;6435;2486;6930
292690;202009;2668;6786;1833;5421;197;538;1084;3365;1281;3903
292700;202009;9930;26730;8623;24741;739;1882;5921;17591;6660;19473
292710;202009;2528;7647;2342;7390;43;143;2130;6751;2173;6894
292720;202009;9023;21411;7620;19794;210;586;6050;15986;6260;16572
292730;202009;4602;10388;4299;10023;279;453;3664;8753;3943;9206
292740;202009;327537;785444;281042;718286;39012;99778;174970;445191;213982;544969
292750;202009;6231;16578;5443;15428;231;662;4194;12074;4425;12736
292760;202009;3914;11204;3393;10278;224;768;2475;7433;2699;8201
292770;202009;6368;16405;5136;14679;782;2300;3286;9642;4068;11942
292780;202009;2134;4204;1575;3522;48;138;1272;2694;1320;2832
292790;202009;4081;8576;3111;7523;156;384;2591;6305;2747;6689
292800;202009;11389;28303;9719;25776;304;850;8112;21244;8416;22094
292805;202009;3629;8618;2836;7575;105;328;2230;5898;2335;6226
292810;202009;10696;27924;8430;24375;219;911;6325;17714;6544;18625
292820;202009;7432;20369;5396;16950;429;1431;3743;11561;4172;12992
292830;202009;2886;6784;2469;6268;93;273;2089;5316;2182;5589
292840;202009;8746;22685;7384;20835;147;543;6450;17893;6597;18436
292850;202009;2530;6643;2109;6016;148;444;1477;4183;1625;4627
292860;202009;17242;37615;15439;35478;412;1010;13364;30322;13776;31332
292870;202009;18102;44533;15489;40862;962;2579;10566;27583;11528;30162
292880;202009;11028;29870;9370;27391;266;1087;7373;20843;7639;21930
292890;202009;7142;19471;6298;18253;182;728;5513;15854;5695;16582
292895;202009;3058;6500;2209;5238;104;249;1779;4180;1883;4429
292900;202009;2597;6952;2355;6580;61;238;1935;5244;1996;5482
292905;202009;4363;11161;3445;9818;135;451;2543;7163;2678;7614
292910;202009;4912;13258;4455;12596;214;603;3408;9573;3622;10176
292920;202009;9781;26648;9001;25526;265;983;7763;21612;8028;22595
292925;202009;5450;15306;4540;13668;219;648;3276;9769;3495;10417
292930;202009;6514;18986;5585;17275;470;1619;3577;10777;4047;12396
292935;202009;2494;6148;1927;5516;22;120;1730;4965;1752;5085
292937;202009;2780;6908;2366;6349;53;155;1995;5371;2048;5526
292940;202009;2865;7223;2273;6348;179;410;1640;4767;1819;5177
292950;202009;9555;24100;8342;22313;530;1227;6299;16826;6829;18053
292960;202009;5244;12617;4382;11388;129;335;3500;9002;3629;9337
292970;202009;3828;10879;3377;10194;80;372;2808;8507;2888;8879
292975;202009;4493;9491;3971;8905;127;214;3618;8209;3745;8423
292980;202009;3314;7936;2643;6951;83;258;2155;5564;2238;5822
292990;202009;11462;31254;9528;27817;648;1972;6954;20002;7602;21974
293000;202009;2712;6306;2312;5703;43;149;1847;4554;1890;4703
293010;202009;18035;45906;14487;40316;1940;5571;8828;24543;10768;30114
293015;202009;8390;25491;6559;21900;440;1592;4356;14799;4796;16391
293020;202009;9826;28250;8829;26829;135;586;7944;24187;8079;24773
293030;202009;5283;13787;4001;11781;106;350;2756;8313;2862;8663
293040;202009;4332;11386;3641;10404;71;274;3180;9057;3251;9331
293050;202009;22785;55127;20064;51109;1112;2863;15093;37926;16205;40789
293060;202009;3518;9312;2834;8033;233;693;1957;5451;2190;6144
293070;202009;25627;61040;21836;56249;2024;5468;15737;40561;17761;46029
293075;202009;3527;11058;3052;10242;149;652;2442;8190;2591;8842
293076;202009;3567;8657;3230;8259;55;148;2878;7422;2933;7570
293077;202009;6131;16906;4965;15017;432;1431;3231;10006;3663;11437
293080;202009;4769;13930;4091;12765;93;429;3316;10142;3409;10571
293090;202009;3269;9402;2487;8102;215;691;1589;5243;1804;5934
293100;202009;5834;15391;4814;13556;222;643;3772;10505;3994;11148
293105;202009;3758;11849;3274;10858;240;827;2292;7543;2532;8370
293110;202009;2407;5961;1983;5336;70;246;1618;4247;1688;4493
293120;202009;4393;11883;3904;11114;113;292;3255;9283;3368;9575
293130;202009;3685;10081;3205;9451;77;288;2752;8036;2829;8324
293135;202009;31058;72021;22883;61186;3438;10007;10855;29338;14293;39345
293140;202009;2403;5290;2072;4884;62;145;1744;4108;1806;4253
293150;202009;5516;16243;4519;14343;333;1061;3098;9890;3431;10951
293160;202009;3867;9335;3280;8698;248;406;2724;7598;2972;8004
293170;202009;4948;10263;4296;9457;116;250;3754;8228;3870;8478
293180;202009;4416;12279;3629;10843;88;344;2872;8379;2960;8723
293190;202009;14156;38137;12425;35620;144;638;11028;31380;11172;32018
293200;202009;8449;20820;6721;18091;202;709;5361;14136;5563;14845
293210;202009;5203;13710;4443;12539;275;777;3420;9629;3695;10406
293220;202009;5046;12937;3679;10599;855;2461;1460;4320;2315;6781
293230;202009;3864;9895;2835;8420;207;695;1935;5801;2142;6496
293240;202009;4533;11927;3622;10440;66;158;2744;8239;2810;8397
293245;202009;3862;10349;3450;9755;143;472;2937;8174;3080;8646
293250;202009;5966;13717;4849;12284;144;364;4055;10279;4199;10643
293260;202009;4645;12243;3822;10964;166;486;2609;7537;2775;8023
293270;202009;7247;15925;5702;14269;403;607;4467;12030;4870;12637
293280;202009;4513;11821;3914;10973;241;592;3031;8594;3272;9186
293290;202009;14513;41843;12750;39088;1681;5228;8380;26013;10061;31241
293300;202009;5800;13992;4962;12766;282;728;3610;9316;3892;10044
293305;202009;4097;9629;3560;8964;51;122;3213;8092;3264;8214
293310;202009;2125;5410;1779;4870;56;163;1406;3804;1462;3967
293315;202009;4169;9760;3420;8637;205;451;2808;7095;3013;7546
293317;202009;2655;6193;2341;5759;145;273;1852;4574;1997;4847
293320;202009;12243;29140;10834;27567;253;701;9694;24534;9947;25235
293325;202009;1799;4404;1395;3862;204;552;843;2379;1047;2931
293330;202009;58664;164728;47472;144807;8665;27364;21981;67155;30646;94519
293340;202009;2212;6181;1819;5487;82;274;1294;3848;1376;4122
293345;202009;3563;9524;2848;8456;369;850;1826;5959;2195;6809
293350;202009;6611;18871;5692;17775;61;308;5187;16396;5248;16704
293360;202009;15534;38517;13154;35343;294;1219;11578;30539;11872;31758
310010;202009;951;2141;612;1667;50;178;229;570;279;748
310020;202009;2698;7233;1995;5978;438;1426;434;1232;872;2658
310030;202009;1924;5378;1474;4597;215;745;942;2826;1157;3571
310040;202009;894;2320;705;1993;30;129;485;1283;515;1412
310050;202009;1490;4456;1247;4066;128;529;817;2558;945;3087
310060;202009;3165;8873;2739;8305;79;321;2268;6792;2347;7113
310070;202009;346;784;242;636;9;19;178;463;187;482
310080;202009;697;1843;496;1477;74;243;227;639;301;882
310090;202009;4746;12442;3878;11028;295;878;2834;7928;3129;8806
310100;202009;3527;9627;2938;8647;78;347;2382;6808;2460;7155
310110;202009;4638;12133;3598;10308;768;2401;1569;4306;2337;6707
310120;202009;641;1559;405;1180;43;151;238;643;281;794
310130;202009;371;958;308;865;26;105;227;598;253;703
310140;202009;273;788;191;644;40;157;71;210;111;367
310150;202009;5472;14329;4031;11660;528;1751;1916;5219;2444;6970
310160;202009;7857;19504;5567;15706;1063;3292;1965;5593;3028;8885
310163;202009;1029;3025;819;2625;181;665;276;814;457;1479
310170;202009;9294;23419;7380;20415;631;1803;5211;14387;5842;16190
310180;202009;1804;4463;1317;3658;164;502;771;2070;935;2572
310190;202009;2590;7479;2091;6570;461;1628;341;998;802;2626
310200;202009;1874;5509;1362;4513;180;685;642;2080;822;2765
310205;202009;1126;3072;865;2661;144;500;405;1224;549;1724
310210;202009;2614;6971;2123;6117;121;369;1528;4299;1649;4668
310220;202009;1268;3411;968;2827;85;262;637;1782;722;2044
310230;202009;2255;6183;1805;5331;225;738;1133;3123;1358;3861
310240;202009;975;2954;821;2678;54;204;577;1834;631;2038
310250;202009;1049;2783;844;2445;17;72;577;1666;594;1738
310260;202009;3198;8177;2064;6193;587;2056;604;1420;1191;3476
310270;202009;2736;6656;2160;5876;98;315;1766;4789;1864;5104
310280;202009;2473;5677;1908;4858;266;709;1114;2729;1380;3438
310285;202009;1852;5844;1535;5277;168;650;936;3189;1104;3839
310290;202009;1139;2980;929;2605;206;666;485;1217;691;1883
310300;202009;1523;4366;1292;3976;138;511;759;2188;897;2699
310310;202009;301;723;196;541;32;92;99;268;131;360
310320;202009;526;1324;358;1054;23;84;201;559;224;643
310330;202009;484;1141;287;794;42;133;117;292;159;425
310340;202009;7959;21032;6373;18375;868;2444;3230;9522;4098;11966
310350;202009;12885;30852;8770;24194;1565;4618;3995;10620;5560;15238
310360;202009;496;1115;376;960;13;37;253;650;266;687
310370;202009;1293;3972;1093;3588;208;744;356;1213;564;1957
310375;202009;880;2168;616;1772;100;296;326;936;426;1232
310380;202009;403;907;223;620;36;105;100;259;136;364
310390;202009;443;1311;346;1124;77;266;98;275;175;541
310400;202009;10282;24759;7347;20337;700;2245;4517;12186;5217;14431
310410;202009;893;2561;581;1977;89;330;218;694;307;1024
310420;202009;4486;11539;3040;8757;408;1327;1272;3380;1680;4707
310430;202009;1515;4090;982;3096;214;742;341;948;555;1690
310440;202009;662;1718;456;1342;42;151;242;669;284;820
310445;202009;1385;3897;1002;3135;59;197;714;2194;773;2391
310450;202009;4714;11732;3526;9860;139;523;2680;7273;2819;7796
310460;202009;1736;4557;1266;3690;205;644;444;1212;649;1856
310470;202009;3771;8178;2915;7062;293;687;2051;5105;2344;5792
310480;202009;970;2474;750;2120;83;252;476;1306;559;1558
310490;202009;2821;7603;2194;6576;227;844;1245;3503;1472;4347
310500;202009;1355;3797;1013;3211;177;645;544;1659;721;2304
310510;202009;2126;5500;1376;4100;243;824;512;1504;755;2328
310520;202009;1206;3104;868;2500;141;394;452;1301;593;1695
310530;202009;736;1846;470;1362;68;241;158;371;226;612
310540;202009;2965;8420;2452;7535;550;1792;1118;3293;1668;5085
310550;202009;1268;3209;887;2557;77;277;506;1351;583;1628
310560;202009;14964;38608;10579;30924;1515;5071;4549;12007;6064;17078
310570;202009;1025;2659;804;2350;55;196;597;1713;652;1909
310590;202009;4086;10768;3247;9207;205;677;1878;5021;2083;5698
310600;202009;1306;3858;1060;3350;143;510;541;1600;684;2110
310610;202009;470;1265;297;984;110;370;41;119;151;489
310620;202009;172729;435865;124457;348745;17810;57915;60785;154433;78595;212348
310630;202009;4541;12324;3538;10354;323;1010;2226;6306;2549;7316
310640;202009;1093;3214;893;2820;182;628;368;1109;550;1737
310650;202009;2399;6781;1728;5480;173;577;1001;3072;1174;3649
310660;202009;1308;3476;1068;3154;32;106;903;2646;935;2752
310665;202009;1426;3614;1146;3206;30;110;925;2616;955;2726
310670;202009;58359;148831;49041;132853;4544;14111;33759;87005;38303;101116
310680;202009;773;1789;632;1593;18;64;540;1305;558;1369
310690;202009;1944;5060;1394;4124;108;364;789;2222;897;2586
310700;202009;488;1069;387;949;22;69;306;725;328;794
310710;202009;5642;15854;4104;13593;870;3435;740;2186;1610;5621
310720;202009;1024;2351;798;2064;33;106;603;1514;636;1620
310730;202009;10034;26581;8561;24223;350;1241;6438;17851;6788;19092
310740;202009;6375;17258;4412;13168;678;2258;1646;4452;2324;6710
310750;202009;1248;2966;920;2493;106;318;479;1214;585;1532
310760;202009;618;1583;433;1292;37;113;228;701;265;814
310770;202009;1107;2956;760;2424;82;319;393;1156;475;1475
310780;202009;4313;10322;3559;9313;79;215;2880;7573;2959;7788
310790;202009;1796;5646;1545;5102;355;1251;259;759;614;2010
310800;202009;2300;6756;1665;5458;358;1403;106;274;464;1677
310810;202009;1263;3087;1027;2696;44;123;739;1864;783;1987
310820;202009;1171;3002;719;2235;173;561;159;510;332;1071
310825;202009;2600;7727;2074;6860;69;401;1674;5337;1743;5738
310830;202009;1878;5240;1319;4123;242;869;552;1625;794;2494
310840;202009;2061;5554;1499;4607;350;1238;368;970;718;2208
310850;202009;1471;4009;1225;3666;44;223;954;2721;998;2944
310855;202009;3066;8078;2363;6939;157;564;1701;4848;1858;5412
310860;202009;6932;19976;5520;17189;539;1777;3381;10619;3920;12396
310870;202009;966;2302;754;1998;56;135;553;1470;609;1605
310880;202009;987;2959;773;2522;107;366;440;1387;547;1753
310890;202009;2243;6371;1435;4732;264;940;223;624;487;1564
310900;202009;3903;10818;2647;8046;390;1244;1111;3150;1501;4394
310910;202009;2094;5088;1457;4072;124;407;302;789;426;1196
310920;202009;1926;5002;1453;4275;198;634;821;2366;1019;3000
310925;202009;943;2544;755;2240;69;242;513;1436;582;1678
310930;202009;5710;14913;4017;12138;769;2381;1842;5799;2611;8180
310940;202009;6767;15876;5428;13927;186;576;4164;10394;4350;10970
310945;202009;1318;3434;1033;2970;183;555;495;1389;678;1944
310950;202009;1905;5620;1231;4084;220;814;402;1148;622;1962
310960;202009;746;1993;407;1264;70;253;79;223;149;476
310970;202009;1132;3329;793;2596;201;731;145;434;346;1165
310980;202009;273;654;178;512;19;65;110;307;129;372
310990;202009;1321;3639;1024;3118;162;533;527;1574;689;2107
311000;202009;3994;11048;2896;9200;710;2431;1180;3628;1890;6059
311010;202009;904;2578;727;2226;213;724;305;911;518;1635
311020;202009;1102;2792;692;2040;42;127;373;1077;415;1204
311030;202009;1701;4165;1169;3290;216;676;525;1404;741;2080
311040;202009;279;870;227;754;68;237;73;230;141;467
311050;202009;2884;7015;2131;5913;359;1161;1092;2888;1451;4049
311060;202009;3213;8146;2352;6516;325;1035;976;2455;1301;3490
311070;202009;2310;5714;1667;4706;168;627;918;2405;1086;3032
311080;202009;1155;2603;926;2238;63;183;717;1644;780;1827
311090;202009;2023;6406;1576;5555;354;1384;476;1635;830;3019
311100;202009;2386;6751;1389;4673;261;996;243;727;504;1723
311110;202009;3666;7470;2041;5212;368;1007;744;1951;1112;2958
311115;202009;1392;3061;1161;2750;64;159;936;2179;1000;2338
311120;202009;6698;17450;5076;14527;708;2277;1929;4911;2637;7188
311130;202009;1883;4852;1425;4221;105;395;823;2354;928;2749
311140;202009;1436;3503;1116;3062;78;260;768;2065;846;2325
311150;202009;1475;4667;1140;4008;182;710;609;2079;791;2789
311160;202009;3799;10835;2651;8663;665;2399;788;2460;1453;4859
311170;202009;893;2243;704;1992;39;110;444;1326;483;1436
311180;202009;1371;3087;853;2317;163;486;378;1020;541;1506
311190;202009;871;2398;666;2001;115;398;267;694;382;1092
311200;202009;2052;5501;1474;4392;274;899;536;1438;810;2337
311205;202009;864;2583;698;2248;49;220;439;1331;488;1551
311210;202009;1001;2902;867;2721;109;312;624;2008;733;2320
311220;202009;725;2015;604;1800;48;163;382;1078;430;1241
311230;202009;7745;23155;5841;19263;1044;3595;2187;7384;3231;10979
311240;202009;1036;2695;795;2348;174;549;325;962;499;1511
311250;202009;1120;3232;859;2729;190;582;322;980;512;1562
311260;202009;2696;6603;1723;4903;275;890;732;1900;1007;2790
311265;202009;1318;3392;967;2800;44;164;658;1861;702;2025
311270;202009;2974;8839;2582;8183;158;697;1874;5658;2032;6355
311280;202009;1068;2730;494;1564;93;340;49;131;142;471
311290;202009;1857;5604;1688;5251;146;473;1135;3514;1281;3987
311300;202009;4690;12975;3818;11515;193;782;3016;8895;3209;9677
311310;202009;572;1583;480;1421;45;139;289;824;334;963
311320;202009;3189;9646;2708;8607;372;1408;1301;3729;1673;5137
311330;202009;5136;13373;4051;11610;451;1405;2247;6558;2698;7963
311340;202009;10549;29338;8310;25334;2139;7102;2321;6672;4460;13774
311350;202009;2446;5969;1732;4665;163;463;921;2239;1084;2702
311360;202009;1131;2746;713;2109;196;658;236;672;432;1330
311370;202009;4673;11214;3412;9237;145;571;2274;5780;2419;6351
311380;202009;365;1087;263;872;66;212;110;391;176;603
311390;202009;1755;5277;1385;4759;601;2309;341;1062;942;3371
311400;202009;1518;4135;1094;3311;166;530;397;1062;563;1592
311410;202009;1708;4952;1355;4415;204;766;766;2434;970;3200
311420;202009;1521;4431;1060;3476;192;701;269;738;461;1439
311430;202009;4070;10669;2701;7968;496;1504;875;2551;1371;4055
311440;202009;2792;7762;2072;6527;495;1846;512;1522;1007;3368
311450;202009;1710;5077;1225;4165;321;1244;328;959;649;2203
311455;202009;1005;2221;661;1710;168;439;258;711;426;1150
311460;202009;483;1486;319;1128;63;294;87;252;150;546
311470;202009;512;1585;339;1175;79;322;51;166;130;488
311480;202009;1043;2676;857;2393;46;134;660;1836;706;1970
311490;202009;251;738;186;606;33;131;86;245;119;376
311500;202009;462;1133;359;985;21;66;241;639;262;705
311510;202009;3246;8381;2199;6556;303;1004;920;2584;1223;3588
311520;202009;632;1760;553;1606;71;263;306;867;377;1130
311530;202009;8764;20369;5487;15076;1327;4034;1431;3731;2758;7765
311535;202009;793;2159;516;1579;81;251;180;513;261;764
311540;202009;486;1536;430;1428;79;300;287;914;366;1214
311545;202009;2004;5701;1702;5230;95;343;1313;3974;1408;4317
311547;202009;1459;3710;1257;3397;48;127;853;2333;901;2460
311550;202009;2755;7663;2172;6594;304;1053;936;2694;1240;3747
311560;202009;298;650;187;486;72;179;42;101;114;280
311570;202009;1661;3797;1166;3113;35;101;923;2506;958;2607
311580;202009;2150;3987;1411;3116;148;302;941;2081;1089;2383
311590;202009;492;1299;391;1145;63;212;218;628;281;840
311600;202009;1751;3934;1456;3541;62;147;1241;2980;1303;3127
311610;202009;2269;7258;1871;6412;201;755;1056;3556;1257;4311
311615;202009;3224;8961;2607;7933;115;423;2044;6100;2159;6523
311620;202009;438;1110;379;1046;8;32;325;886;333;918
311630;202009;1342;3652;1088;3125;106;340;706;1949;812;2289
311640;202009;654;1765;516;1527;67;236;240;638;307;874
311650;202009;1925;4893;1575;4346;164;501;1008;2693;1172;3194
311660;202009;2900;8151;2132;6656;384;1338;602;1580;986;2918
311670;202009;1546;4018;1125;3260;165;538;447;1292;612;1830
311680;202009;2142;6094;1590;5059;168;536;1058;3357;1226;3893
311690;202009;611;1294;476;1123;39;74;347;871;386;945
311700;202009;2203;5286;1709;4601;26;128;1441;3754;1467;3882
311710;202009;1516;4314;1091;3555;258;918;396;1275;654;2193
311720;202009;418;1226;333;1067;28;107;178;565;206;672
311730;202009;3772;9645;2398;7002;701;2199;474;1426;1175;3625
311740;202009;875;2292;733;2120;67;189;595;1770;662;1959
311750;202009;3846;11453;3058;10009;434;1544;1719;5405;2153;6949
311760;202009;637;1789;521;1578;68;250;263;694;331;944
311770;202009;2082;5948;1612;5100;243;805;756;2306;999;3111
311780;202009;1334;3779;905;2914;158;581;274;758;432;1339
311783;202009;2282;6087;1825;5288;37;171;1475;4093;1512;4264
311787;202009;771;2202;578;1747;80;272;250;641;330;913
311790;202009;1478;3956;958;3008;234;815;256;748;490;1563
311800;202009;4782;14321;3851;12293;802;2768;647;1780;1449;4548
311810;202009;942;2820;740;2459;53;194;488;1598;541;1792
311820;202009;783;1883;575;1563;66;213;359;918;425;1131
311830;202009;8381;23891;5656;17965;1569;5401;691;2143;2260;7544
311840;202009;3575;8992;2873;7987;252;740;2110;5821;2362;6561
311850;202009;362;953;294;825;13;41;197;531;210;572
311860;202009;59508;149198;45299;124957;6510;19397;25318;66567;31828;85964
311870;202009;1891;4968;1274;3860;233;812;477;1278;710;2090
311880;202009;6238;16098;5199;14660;286;721;3909;11240;4195;11961
311890;202009;1687;4018;1295;3450;88;272;931;2354;1019;2626
311900;202009;741;1907;554;1654;64;225;348;1009;412;1234
311910;202009;4133;10584;3094;9221;548;1603;1558;4795;2106;6398
311920;202009;2112;5528;1677;4897;121;314;1054;3192;1175;3506
311930;202009;3845;8928;2735;7352;839;2463;805;1984;1644;4447
311940;202009;15578;40537;11455;32715;1613;5056;5231;13876;6844;18932
311950;202009;2343;6204;1744;5195;115;406;1035;3132;1150;3538
311960;202009;494;1207;397;1062;24;90;256;625;280;715
311970;202009;422;1348;309;1062;54;223;73;213;127;436
311980;202009;448;1207;232;773;23;80;80;262;103;342
311990;202009;542;1253;339;950;66;234;145;358;211;592
311995;202009;961;2630;485;1544;21;68;69;149;90;217
312000;202009;762;1893;566;1601;54;145;354;1021;408;1166
312010;202009;963;2623;740;2248;49;168;477;1374;526;1542
312015;202009;1364;3963;1194;3686;48;208;965;2907;1013;3115
312020;202009;1583;4830;1199;3999;255;895;295;914;550;1809
312030;202009;2003;4913;1736;4618;18;63;1623;4314;1641;4377
312040;202009;854;2480;592;1961;69;237;268;853;337;1090
312050;202009;1197;3688;955;3218;216;859;297;882;513;1741
312060;202009;850;2086;554;1715;134;412;269;851;403;1263
312070;202009;900;2581;642;2065;45;165;354;1074;399;1239
312080;202009;2633;6465;1952;5452;105;341;1274;3405;1379;3746
312083;202009;871;2252;636;1882;52;189;427;1220;479;1409
312087;202009;2478;6416;1990;5649;45;139;1554;4449;1599;4588
312090;202009;10294;26662;7937;22911;1153;3669;4032;11264;5185;14933
312100;202009;1562;4472;1212;3828;104;405;709;2129;813;2534
312110;202009;1031;3161;853;2798;185;705;311;911;496;1616
312120;202009;989;2658;655;2051;167;604;203;521;370;1125
312125;202009;1717;4413;1428;3994;113;369;1062;2852;1175;3221
312130;202009;1030;2494;770;2059;62;183;343;835;405;1018
312140;202009;683;1959;555;1703;115;389;234;664;349;1053
312150;202009;447;1245;379;1105;13;56;271;738;284;794
312160;202009;8754;23740;6625;19938;814;2819;3277;9346;4091;12165
312170;202009;897;2428;676;1997;35;131;445;1276;480;1407
312180;202009;1397;3713;1098;3139;160;472;555;1531;715;2003
312190;202009;674;1850;486;1480;81;276;171;476;252;752
312200;202009;4531;12318;3558;10739;1086;3267;1229;3837;2315;7104
312210;202009;1377;3051;987;2487;36;107;745;1833;781;1940
312220;202009;1618;4982;1394;4561;103;364;882;2886;985;3250
312230;202009;13281;34234;8748;25945;2064;6922;1734;4385;3798;11307
312235;202009;1970;4940;1545;4311;92;313;1102;2980;1194;3293
312240;202009;696;2263;525;1899;115;448;153;531;268;979
312245;202009;2656;6818;2161;6061;64;176;1763;4915;1827;5091
312247;202009;963;2332;692;1933;122;356;360;1021;482;1377
312250;202009;981;2591;623;1874;86;280;232;671;318;951
312260;202009;934;2493;742;2195;38;153;566;1613;604;1766
312270;202009;706;1923;530;1574;28;112;305;823;333;935
312280;202009;419;1238;326;1070;95;321;45;136;140;457
312290;202009;752;2206;600;1928;107;383;211;655;318;1038
312300;202009;968;2918;645;2126;158;569;121;328;279;897
312310;202009;966;2884;771;2470;117;405;355;1075;472;1480
312320;202009;1981;5075;1432;4098;333;1005;332;904;665;1909
312330;202009;841;2472;669;2109;60;214;409;1259;469;1473
312340;202009;261;680;184;550;44;156;78;204;122;360
312350;202009;246;495;172;415;15;46;118;270;133;316
312352;202009;1598;4770;1417;4445;88;281;865;2892;953;3173
312360;202009;2765;7947;2021;6509;395;1399;661;2006;1056;3405
312370;202009;1894;4855;1527;4236;175;534;905;2388;1080;2922
312380;202009;2138;4794;1754;4313;4;12;1568;3813;1572;3825
312385;202009;1225;3324;953;2827;144;456;450;1331;594;1787
312390;202009;1868;5369;1388;4458;197;729;518;1524;715;2253
312400;202009;2856;8130;2341;7226;706;2348;737;2252;1443;4600
312410;202009;11659;32026;9433;28252;1650;5129;5147;15219;6797;20348
312420;202009;3724;10052;3087;9004;564;1812;1640;4658;2204;6470
312430;202009;7773;20689;6326;18063;397;1325;4457;12399;4854;13724
312440;202009;921;2948;725;2499;355;1303;102;319;457;1622
312450;202009;1189;3470;903;2975;254;892;294;1007;548;1899
312460;202009;437;1146;300;933;47;148;152;492;199;640
312470;202009;476;1128;297;815;31;93;110;268;141;361
312480;202009;1040;2573;723;2106;95;308;355;975;450;1283
312490;202009;2102;5118;1610;4384;204;584;868;2298;1072;2882
312500;202009;1005;2447;819;2188;50;171;569;1495;619;1666
312510;202009;3713;9801;2628;7735;660;1882;688;2063;1348;3945
312520;202009;176;479;133;406;34;111;59;178;93;289
312530;202009;586;1430;502;1328;16;56;443;1174;459;1230
312540;202009;1581;4376;1055;3297;146;489;587;1775;733;2264
312550;202009;785;2067;597;1686;48;152;382;992;430;1144
312560;202009;1936;4973;1539;4346;72;223;1168;3292;1240;3515
312570;202009;2169;5277;1619;4579;460;1344;615;1825;1075;3169
312580;202009;618;1699;434;1311;56;198;196;546;252;744
312590;202009;1607;4661;1272;3992;84;398;799;2310;883;2708
312595;202009;1961;5733;1638;5175;264;778;973;3243;1237;4021
312600;202009;1184;2833;670;1848;115;393;129;398;244;791
312610;202009;6722;16952;4410;12621;663;2078;1534;4042;2197;6120
312620;202009;2522;6462;1858;5529;55;236;1467;4457;1522;4693
312630;202009;286;813;202;659;37;141;78;246;115;387
312640;202009;512;1392;353;1118;40;134;137;444;177;578
312650;202009;2034;5197;1380;3964;64;206;972;2661;1036;2867
312660;202009;1352;3252;1014;2679;97;273;679;1740;776;2013
312670;202009;4919;12929;4072;11572;183;738;2953;8020;3136;8758
312675;202009;1274;3308;1040;2962;59;186;840;2365;899;2551
312680;202009;1379;3874;1185;3573;53;225;974;2851;1027;3076
312690;202009;2920;6141;2268;5356;48;134;1898;4484;1946;4618
312695;202009;960;2593;794;2302;40;92;620;1802;660;1894
312700;202009;2104;5526;1513;4444;152;521;841;2335;993;2856
312705;202009;1414;3332;1202;3016;15;51;1095;2723;1110;2774
312707;202009;1376;3978;1055;3389;67;309;682;2068;749;2377
312710;202009;6474;14798;3764;10536;949;2856;1058;3057;2007;5913
312720;202009;1077;2851;807;2421;105;335;496;1442;601;1777
312730;202009;1633;3842;1152;3173;94;291;668;1771;762;2062
312733;202009;1373;3613;1042;2981;38;148;713;1932;751;2080
312735;202009;711;1913;596;1686;74;230;344;874;418;1104
312737;202009;802;1821;557;1461;72;211;347;865;419;1076
312738;202009;658;1672;467;1352;46;150;260;712;306;862
312740;202009;434;1071;251;756;48;159;63;145;111;304
312750;202009;1572;4526;1164;3756;210;714;494;1512;704;2226
312760;202009;1767;5186;1244;4102;223;793;453;1422;676;2215
312770;202009;45078;107573;28091;78378;5718;17130;9347;25419;15065;42549
312780;202009;2412;7183;2037;6576;243;830;1303;4201;1546;5031
312790;202009;246;582;129;398;7;38;41;105;48;143
312800;202009;4856;13681;3652;11362;891;2920;1262;3825;2153;6745
312810;202009;1579;4190;1045;3328;258;914;370;1077;628;1991
312820;202009;1765;4674;1399;4033;48;178;1046;2931;1094;3109
312825;202009;1341;3136;1161;2901;20;73;994;2430;1014;2503
312830;202009;2858;7962;1682;5519;336;1254;423;1305;759;2559
312840;202009;1331;3589;1051;3111;90;347;563;1543;653;1890
312850;202009;926;2245;653;1840;23;95;400;1038;423;1133
312860;202009;1146;2959;766;2358;192;630;182;514;374;1144
312870;202009;6109;16371;3698;11704;622;2123;847;2495;1469;4618
312880;202009;1425;3531;1094;2969;36;119;651;1767;687;1886
312890;202009;2262;5604;1627;4548;117;313;822;2341;939;2654
312900;202009;1212;3074;981;2776;156;490;454;1399;610;1889
312910;202009;1642;2989;854;1948;165;316;322;764;487;1080
312920;202009;1000;2653;684;2122;117;420;281;800;398;1220
312930;202009;2344;5741;1797;4924;410;1149;780;2174;1190;3323
312940;202009;960;2632;748;2316;75;280;379;1106;454;1386
312950;202009;3103;7679;2001;5875;516;1652;629;1781;1145;3433
312960;202009;1799;4736;1509;4288;69;184;1176;3418;1245;3602
312965;202009;1632;4520;1356;4079;113;355;935;2761;1048;3116
312970;202009;1352;3763;1055;3278;147;557;613;1775;760;2332
312980;202009;24157;65915;19382;57237;3758;12097;9156;25335;12914;37432
312990;202009;490;1221;307;901;54;176;149;409;203;585
313000;202009;489;1394;363;1159;29;124;211;627;240;751
313005;202009;2503;7164;2092;6453;162;484;1476;4519;1638;5003
313010;202009;5055;13819;4010;12107;706;2331;2350;6939;3056;9270
313020;202009;1060;3169;734;2406;129;462;140;379;269;841
313030;202009;1115;2573;748;2029;88;287;485;1242;573;1529
313040;202009;794;2424;656;2144;44;184;388;1205;432;1389
313050;202009;1761;4810;1220;3986;202;795;393;1136;595;1931
313055;202009;1904;5094;1679;4768;58;185;1448;4095;1506;4280
313060;202009;976;2336;704;1872;180;580;130;307;310;887
313065;202009;1643;4856;1432;4503;50;188;1104;3384;1154;3572
313070;202009;951;2496;714;2083;72;227;419;1188;491;1415
313080;202009;391;1082;287;880;50;179;105;272;155;451
313090;202009;5089;13434;4303;12162;341;1106;2877;8038;3218;9144
313100;202009;1342;3448;1033;3000;27;113;785;2218;812;2331
313110;202009;1475;3873;1069;3163;96;353;600;1668;696;2021
313115;202009;2646;7583;2117;6537;275;948;1108;3199;1383;4147
313120;202009;3739;8812;2713;7458;223;711;1753;4777;1976;5488
313130;202009;31117;79909;23573;66011;2540;8050;13338;35216;15878;43266
313140;202009;616;1326;363;963;29;71;243;650;272;721
313150;202009;1363;3797;1005;3137;301;1025;208;579;509;1604
313160;202009;1165;2901;911;2510;26;94;679;1815;705;1909
313170;202009;11323;31983;8067;25903;1361;4789;3211;9685;4572;14474
313180;202009;2087;5489;1471;4270;194;584;834;2378;1028;2962
313190;202009;4348;12419;3154;9974;575;1978;1079;3174;1654;5152
313200;202009;1080;2981;937;2732;15;55;793;2241;808;2296
313210;202009;3815;11018;3089;9703;375;1297;1829;5531;2204;6828
313220;202009;1758;4595;1154;3393;167;552;465;1206;632;1758
313230;202009;2972;8244;2435;7577;43;157;2036;6482;2079;6639
313240;202009;9788;23853;6050;17783;1005;3392;2558;6962;3563;10354
313250;202009;6249;18176;4628;14743;839;2723;2023;6282;2862;9005
313260;202009;639;1669;458;1339;64;246;219;584;283;830
313270;202009;5829;14339;4648;12673;575;1520;3130;8695;3705;10215
313280;202009;467;1306;298;955;37;133;130;391;167;524
313290;202009;954;2938;693;2464;214;825;218;773;432;1598
313300;202009;1611;4277;1157;3457;288;940;275;702;563;1642
313310;202009;1181;3478;912;2912;147;563;262;709;409;1272
313320;202009;2134;5648;1533;4665;269;935;620;1903;889;2838
313330;202009;4102;10668;3083;9129;169;615;1985;5852;2154;6467
313340;202009;1403;3140;987;2564;89;244;688;1771;777;2015
313350;202009;2827;7841;1793;5459;231;774;640;1715;871;2489
313360;202009;1483;3571;1017;2827;156;530;527;1339;683;1869
313370;202009;1450;4056;1200;3562;140;488;664;1806;804;2294
313375;202009;1783;4636;1104;3354;194;638;241;678;435;1316
313380;202009;6299;15686;4477;12349;787;2437;2096;5124;2883;7561
313390;202009;802;2569;693;2385;50;235;463;1525;513;1760
313400;202009;3712;9097;2839;7884;154;466;2175;5948;2329;6414
313410;202009;1316;3406;1010;2861;52;178;753;2078;805;2256
313420;202009;15678;34753;7977;21782;1802;5468;1141;3055;2943;8523
313430;202009;962;2819;732;2342;129;506;309;855;438;1361
313440;202009;6209;13466;4040;10597;390;1062;2468;6486;2858;7548
313450;202009;741;1971;518;1530;85;267;179;456;264;723
313460;202009;2107;5966;1664;5267;330;1180;782;2334;1112;3514
313470;202009;2896;7351;2277;6439;245;698;1482;4236;1727;4934
313480;202009;1015;2896;566;1879;69;257;175;526;244;783
313490;202009;2649;6384;1280;3919;321;1102;251;748;572;1850
313500;202009;519;1438;387;1154;44;133;150;406;194;539
313505;202009;10112;26532;8613;24483;348;1210;6923;19639;7271;20849
313507;202009;1470;3790;1193;3358;32;129;951;2597;983;2726
313510;202009;13747;37754;10732;31916;1311;4064;5005;14566;6316;18630
313520;202009;14242;39937;11303;34860;599;2237;8418;25344;9017;27581
313530;202009;521;1536;390;1251;46;157;156;454;202;611
313535;202009;2371;6533;1955;5728;264;701;1190;3503;1454;4204
313540;202009;773;2281;617;1906;109;349;255;725;364;1074
313545;202009;1150;3761;958;3361;156;574;506;1720;662;2294
313550;202009;1753;5328;1431;4562;306;1088;724;2200;1030;3288
313560;202009;2684;5254;1998;4418;56;96;1689;3756;1745;3852
313570;202009;997;2881;815;2552;202;666;317;956;519;1622
313580;202009;5728;14753;4394;12513;505;1526;2549;7311;3054;8837
313590;202009;1028;2885;824;2594;205;681;378;1263;583;1944
313600;202009;4004;10605;3325;9547;91;369;2787;7844;2878;8213
313610;202009;1059;2647;849;2298;93;281;539;1377;632;1658
313620;202009;5588;14715;4349;12437;550;1759;2488;6855;3038;8614
313630;202009;8731;20898;6118;16961;607;1944;3693;10018;4300;11962
313640;202009;1127;2502;716;1975;147;434;324;895;471;1329
313650;202009;1719;5108;1356;4488;98;380;887;2965;985;3345
313652;202009;739;2321;664;2164;109;376;413;1314;522;1690
313655;202009;1130;2857;889;2549;45;136;689;1967;734;2103
313657;202009;1174;3125;921;2720;39;152;674;1880;713;2032
313660;202009;899;2505;730;2204;78;281;450;1289;528;1570
313665;202009;4828;12813;3755;10905;401;1289;2332;6451;2733;7740
313670;202009;49701;120965;31456;89899;4612;14464;13921;37581;18533;52045
313680;202009;1008;2696;826;2401;61;207;551;1551;612;1758
313690;202009;804;2475;618;2129;152;578;160;532;312;1110
313695;202009;1829;4947;1383;4203;87;271;917;2814;1004;3085
313700;202009;2907;9210;2500;8665;250;873;1855;6491;2105;7364
313710;202009;1460;3301;1037;2736;80;218;677;1818;757;2036
313720;202009;5597;15361;3839;11677;551;1815;1581;4424;2132;6239
313730;202009;1335;2984;1003;2533;86;184;651;1658;737;1842
313740;202009;1683;5960;1390;5199;315;1352;258;828;573;2180
313750;202009;2020;5365;1542;4518;276;901;727;1990;1003;2891
313753;202009;2222;5253;1473;4035;147;441;814;2152;961;2593
313760;202009;5338;14609;4013;12045;790;2623;1801;5024;2591;7647
313770;202009;3989;11119;3152;9772;202;657;2332;7317;2534;7974
313780;202009;3994;10575;2870;8689;221;795;820;2538;1041;3333
313790;202009;493;1516;441;1423;49;178;246;771;295;949
313800;202009;1387;3150;1004;2606;129;383;523;1287;652;1670
313810;202009;1605;4068;1274;3597;53;197;970;2664;1023;2861
313820;202009;17634;44537;10971;30470;1745;5107;3013;8074;4758;13181
313830;202009;386;1100;271;834;47;165;91;253;138;418
313835;202009;917;2686;757;2390;59;239;428;1262;487;1501
313840;202009;7161;18544;5349;15523;1295;3986;1118;3327;2413;7313
313850;202009;986;2393;782;2118;145;475;368;883;513;1358
313860;202009;2562;6851;1904;5607;299;999;796;2140;1095;3139
313862;202009;1353;2846;646;1804;41;119;311;866;352;985
313865;202009;2574;6799;2112;6038;85;259;1586;4445;1671;4704
313867;202009;1342;3996;1104;3559;158;496;667;2216;825;2712
313868;202009;1700;5226;1393;4601;48;239;1054;3361;1102;3600
313870;202009;768;2071;555;1678;89;275;215;596;304;871
313880;202009;1710;4438;1245;3643;166;550;587;1525;753;2075
313890;202009;2019;4385;1507;3718;49;168;1107;2645;1156;2813
313900;202009;4128;11898;2938;9455;755;2678;707;2060;1462;4738
313910;202009;657;1911;497;1610;106;367;106;335;212;702
313920;202009;2920;8975;2426;7944;500;1603;1191;3961;1691;5564
313925;202009;1581;3985;1260;3418;188;495;815;2198;1003;2693
313930;202009;4636;13913;3739;12278;291;1091;2399;7755;2690;8846
313940;202009;8978;25762;6464;21347;770;3155;1529;5620;2299;8775
313950;202009;5218;11456;3801;9707;410;1315;2257;5754;2667;7069
313960;202009;5788;13937;3864;10698;701;2208;1337;3375;2038;5583
313970;202009;1506;4060;1256;3637;22;71;800;2261;822;2332
313980;202009;1331;3432;863;2693;132;478;343;1005;475;1483
313990;202009;1916;6053;1356;4763;338;1382;428;1301;766;2683
314000;202009;9679;24719;8056;21937;579;2031;5369;14382;5948;16413
314010;202009;1476;3537;1151;3093;45;153;874;2270;919;2423
314015;202009;1974;5445;1497;4620;194;699;809;2439;1003;3138
314020;202009;472;1286;317;1018;71;273;63;216;134;489
314030;202009;804;2302;635;1978;64;201;334;1018;398;1219
314040;202009;621;1665;494;1427;75;244;264;734;339;978
314050;202009;1844;4879;1340;3942;147;520;727;1977;874;2497
314053;202009;1817;5379;1459;4668;299;953;751;2491;1050;3444
314055;202009;2259;6056;1898;5489;45;167;1551;4477;1596;4644
314060;202009;1299;3404;972;2884;33;127;684;2000;717;2127
314070;202009;4747;12948;3684;11006;732;2184;1619;4767;2351;6951
314080;202009;2120;5452;1447;4300;188;664;627;1664;815;2328
314085;202009;2166;6018;1758;5372;227;726;973;3025;1200;3751
314090;202009;4633;12396;3955;11396;254;927;2463;7232;2717;8159
314100;202009;3115;7408;2399;6416;42;121;1800;4833;1842;4954
314110;202009;4759;13351;3857;11599;436;1528;2189;6136;2625;7664
314120;202009;773;1812;318;959;66;244;72;197;138;441
314130;202009;621;1606;383;1177;23;97;237;718;260;815
314140;202009;4555;12833;3575;10967;486;1549;1788;5391;2274;6940
314150;202009;1495;3713;1088;3010;80;235;728;1952;808;2187
314160;202009;2218;5797;1606;4670;226;721;674;1961;900;2682
314170;202009;930;2605;749;2250;42;160;489;1377;531;1537
314180;202009;5432;15055;4367;13319;365;1205;2601;7926;2966;9131
314190;202009;626;1553;440;1275;82;275;205;529;287;804
314200;202009;2980;8278;2436;7347;159;536;1709;5015;1868;5551
314210;202009;2018;5266;1603;4505;189;538;785;2164;974;2702
314220;202009;1420;3844;1009;3114;223;781;367;1030;590;1811
314225;202009;1076;3005;884;2696;75;196;643;2011;718;2207
314230;202009;776;1999;633;1818;81;261;403;1186;484;1447
314240;202009;1043;2794;797;2405;193;616;299;905;492;1521
314250;202009;498;1397;306;994;51;161;107;320;158;481
314260;202009;945;2558;735;2269;164;551;400;1204;564;1755
314270;202009;3288;9270;2696;8345;77;329;1975;6057;2052;6386
314280;202009;3459;7989;2300;6211;263;785;1250;3210;1513;3995
314290;202009;4457;11504;3638;10036;309;870;2466;6670;2775;7540
314300;202009;1946;5513;1264;4045;237;824;430;1299;667;2123
314310;202009;4121;10646;2707;8209;857;2858;430;1143;1287;4001
314315;202009;932;3165;794;2874;54;248;554;1927;608;2175
314320;202009;3015;8144;1961;6145;356;1215;717;2150;1073;3365
314330;202009;49762;138902;37264;116458;9870;32259;7620;25106;17490;57365
314340;202009;2479;6113;1515;4370;280;925;385;948;665;1873
314345;202009;1458;4247;1172;3723;145;468;699;2202;844;2670
314350;202009;826;2239;529;1690;116;382;124;343;240;725
314360;202009;566;1638;341;1141;56;208;106;320;162;528
314370;202009;738;1953;590;1730;43;147;399;1120;442;1267
314380;202009;1154;3115;760;2403;168;606;161;474;329;1080
314390;202009;13908;34930;8877;25667;1550;4852;2873;7373;4423;12225
314400;202009;3997;11850;3003;9925;767;2615;1102;3778;1869;6393
314410;202009;2721;7564;1866;5963;248;904;619;2094;867;2998
314420;202009;839;2052;602;1658;39;146;399;1032;438;1178
314430;202009;7872;19152;5454;15064;814;2359;2536;6655;3350;9014
314435;202009;1816;4798;1425;4140;75;277;1014;2845;1089;3122
314437;202009;911;2319;656;1891;72;227;320;906;392;1133
314440;202009;617;1757;432;1378;123;429;86;226;209;655
314450;202009;1404;3738;1174;3382;114;385;684;1882;798;2267
314460;202009;3235;9810;2332;7888;596;2134;545;1770;1141;3904
314465;202009;2209;6357;1865;5702;57;218;1429;4224;1486;4442
314467;202009;924;2402;760;2133;25;74;614;1672;639;1746
314470;202009;2308;6541;1875;5656;327;1066;871;2465;1198;3531
314480;202009;6554;18570;4708;14658;777;2709;1736;4754;2513;7463
314490;202009;1076;2846;786;2243;67;194;485;1346;552;1540
314500;202009;1732;4154;1229;3445;311;862;425;1236;736;2098
314505;202009;2041;4969;1658;4422;100;277;1207;3129;1307;3406
314510;202009;1931;5017;1349;4111;271;930;600;1792;871;2722
314520;202009;5027;15324;3670;12448;742;2747;459;1384;1201;4131
314530;202009;5395;17267;4826;16168;307;1273;3545;11596;3852;12869
314535;202009;2511;6541;2018;5824;87;319;1541;4400;1628;4719
314537;202009;1089;3070;833;2657;43;169;600;1872;643;2041
314540;202009;388;961;259;741;18;58;149;409;167;467
314545;202009;1902;4512;1698;4274;29;84;1481;3820;1510;3904
314550;202009;663;1620;490;1371;38;136;279;707;317;843
314560;202009;4382;13104;3214;10462;487;1773;1108;3233;1595;5006
314570;202009;304;837;220;677;28;101;96;296;124;397
314580;202009;462;1376;365;1180;96;312;122;389;218;701
314585;202009;658;2051;496;1691;70;291;208;682;278;973
314587;202009;2002;5428;1504;4626;202;589;853;2702;1055;3291
314590;202009;4086;11075;2946;8897;397;1356;1297;3594;1694;4950
314600;202009;1924;5227;1126;3681;226;788;132;397;358;1185
314610;202009;8930;22193;6243;18166;1004;3489;2664;7874;3668;11363
314620;202009;2244;5235;1766;4629;42;136;1466;3822;1508;3958
314625;202009;1541;4170;1316;3859;31;179;1132;3233;1163;3412
314630;202009;5404;13511;4408;12185;105;428;3671;10093;3776;10521
314640;202009;688;1626;497;1328;70;216;276;679;346;895
314650;202009;839;1930;511;1419;51;166;279;681;330;847
314655;202009;1612;4406;1133;3537;172;541;554;1718;726;2259
314660;202009;328;733;208;518;15;30;136;324;151;354
314670;202009;1613;3689;1110;2974;17;53;733;1936;750;1989
314675;202009;1699;4487;1443;4055;74;238;1121;3065;1195;3303
314690;202009;2060;5724;1578;5000;413;1457;541;1673;954;3130
314700;202009;10307;28600;6667;21498;1287;4582;2037;6346;3324;10928
314710;202009;7865;21925;5643;17206;927;3113;2008;5346;2935;8459
314720;202009;2175;6390;1489;4955;302;1118;372;1158;674;2276
314730;202009;2298;5971;1645;4777;254;819;690;1834;944;2653
314740;202009;2925;8258;2250;7022;297;984;1123;3423;1420;4407
314750;202009;292;790;223;650;27;92;134;351;161;443
314760;202009;1948;5781;1264;4211;206;788;324;841;530;1629
314770;202009;1105;3219;590;1901;46;160;182;546;228;706
314780;202009;350;827;235;652;40;133;125;303;165;436
314790;202009;10906;29012;7498;22649;1535;5300;2670;7401;4205;12701
314795;202009;1516;3981;1275;3557;30;122;1014;2720;1044;2842
314800;202009;10894;27682;6631;19719;1195;3886;1725;4560;2920;8446
314810;202009;8661;22997;6218;18687;1585;5061;1997;5892;3582;10953
314820;202009;1239;2958;962;2545;57;210;617;1550;674;1760
314830;202009;1524;4598;1274;4125;214;792;625;1945;839;2737
314840;202009;839;2635;663;2349;53;254;464;1572;517;1826
314850;202009;2106;4845;1702;4328;46;149;1473;3753;1519;3902
314860;202009;3166;9321;2612;8306;195;797;1791;5542;1986;6339
314870;202009;6356;15927;4796;13844;281;898;3549;10336;3830;11234
314875;202009;1752;5207;1521;4901;121;309;1208;3989;1329;4298
314880;202009;821;2004;626;1702;32;89;374;1026;406;1115
314890;202009;419;1243;316;1023;50;183;129;390;179;573
314900;202009;736;1966;569;1667;81;275;254;692;335;967
314910;202009;1675;4708;1242;4003;206;766;621;1889;827;2655
314915;202009;2193;6460;1827;5817;116;375;1202;3764;1318;4139
314920;202009;470;1212;300;953;6;15;199;651;205;666
314930;202009;5532;15509;4135;12879;695;2404;1656;4775;2351;7179
314940;202009;397;996;324;870;36;92;204;520;240;612
314950;202009;533;1330;353;1026;27;102;187;479;214;581
314960;202009;848;2008;649;1678;28;91;463;1126;491;1217
314970;202009;976;2836;744;2349;141;483;327;940;468;1423
314980;202009;1510;3844;1107;3252;202;684;520;1490;722;2174
314990;202009;2483;7143;1727;5422;343;1154;358;1009;701;2163
314995;202009;1589;4426;1254;3814;37;162;837;2405;874;2567
315000;202009;1120;2817;794;2317;60;189;527;1515;587;1704
315010;202009;379;1038;287;880;46;165;136;397;182;562
315015;202009;2281;6362;1974;5842;192;640;1301;3782;1493;4422
315020;202009;799;2326;557;1774;70;279;239;698;309;977
315030;202009;598;1588;402;1221;89;276;84;227;173;503
315040;202009;807;2265;652;1992;85;281;400;1211;485;1492
315050;202009;1232;3177;889;2627;55;198;467;1343;522;1541
315053;202009;1095;2851;832;2387;51;158;488;1336;539;1494
315057;202009;1750;5245;1416;4661;138;456;940;3129;1078;3585
315060;202009;564;1697;416;1408;80;275;109;360;189;635
315070;202009;530;1390;360;1089;86;285;92;261;178;546
315080;202009;2952;8234;2256;6889;239;818;1430;4141;1669;4959
315090;202009;798;2382;583;1964;86;312;227;737;313;1049
315100;202009;1328;3879;864;2816;141;547;381;1091;522;1638
315110;202009;1868;4482;1345;3674;134;358;672;1891;806;2249
315120;202009;12298;28458;9012;23462;1186;2888;4880;13126;6066;16014
315130;202009;1599;4345;1322;3855;139;459;547;1507;686;1966
315140;202009;2933;8110;2257;6880;395;1305;1130;3270;1525;4575
315150;202009;4337;10358;3027;8253;459;1469;1408;3723;1867;5192
315160;202009;1772;4305;1162;3322;246;748;528;1490;774;2238
315170;202009;1375;4351;942;3293;222;861;223;735;445;1596
315180;202009;17340;41892;9257;26871;1243;4098;2994;7602;4237;11700
315190;202009;2219;4829;1715;4165;203;483;1246;3062;1449;3545
315200;202009;3896;11027;2794;9028;799;2780;734;2266;1533;5046
315210;202009;8573;22196;5802;16314;687;2109;2879;7310;3566;9419
315213;202009;1124;2931;965;2711;22;76;795;2185;817;2261
315217;202009;2812;8068;2131;6919;87;424;1482;4586;1569;5010
315220;202009;8598;23250;6727;19912;1129;3552;2871;8509;4000;12061
315230;202009;3083;7158;2572;6493;199;281;1951;5272;2150;5553
315240;202009;2440;7142;2046;6442;457;1484;980;3101;1437;4585
315250;202009;13005;34949;9296;27888;1448;4678;3968;11335;5416;16013
315260;202009;918;2519;480;1577;77;255;39;106;116;361
315270;202009;826;2360;583;1893;81;282;207;575;288;857
315280;202009;2918;7267;1717;5087;427;1375;269;769;696;2144
315290;202009;1171;2856;681;2069;192;657;200;573;392;1230
315300;202009;628;1526;429;1238;81;262;221;645;302;907
315310;202009;1256;3516;926;2880;77;273;513;1502;590;1775
315320;202009;660;1918;460;1515;66;242;197;596;263;838
315330;202009;750;2553;411;1629;65;302;129;452;194;754
315340;202009;2991;7204;2139;5987;287;826;1120;3126;1407;3952
315350;202009;1567;4266;1216;3718;174;618;677;2031;851;2649
315360;202009;1722;5064;1289;4141;200;687;518;1550;718;2237
315370;202009;471;1359;371;1154;71;218;146;444;217;662
315380;202009;194;572;142;459;40;139;30;68;70;207
315390;202009;1088;3083;860;2644;143;511;402;1134;545;1645
315400;202009;4028;10953;3149;9356;444;1388;1698;4840;2142;6228
315410;202009;2385;5459;1787;4599;481;1327;270;721;751;2048
315415;202009;1399;3776;1117;3342;232;814;427;1295;659;2109
315420;202009;1415;3984;962;3105;179;605;187;584;366;1189
315430;202009;3574;8687;2500;7055;444;1472;1079;2844;1523;4316
315440;202009;1037;2738;830;2398;64;221;495;1343;559;1564
315445;202009;1966;4714;1385;3891;87;291;999;2759;1086;3050
315450;202009;2232;6192;1810;5498;233;689;1111;3378;1344;4067
315460;202009;37008;102623;30395;90581;4577;15466;16531;46236;21108;61702
315470;202009;629;1763;447;1314;32;103;259;725;291;828
315480;202009;1166;3350;813;2584;157;530;262;804;419;1334
315490;202009;2948;7411;2038;5935;293;882;755;2108;1048;2990
315500;202009;527;1407;323;965;44;154;159;417;203;571
315510;202009;1233;3209;1041;2936;23;96;905;2508;928;2604
315520;202009;986;2722;792;2388;50;177;597;1755;647;1932
315530;202009;612;1715;477;1470;132;468;229;653;361;1121
315540;202009;1460;3909;1012;3070;101;367;466;1367;567;1734
315550;202009;1917;4986;1238;3723;254;880;306;894;560;1774
315560;202009;6262;18934;5256;17084;302;933;3473;11534;3775;12467
315570;202009;2058;5546;1638;4837;105;351;920;2662;1025;3013
315580;202009;2899;6812;2174;5670;291;881;839;2074;1130;2955
315590;202009;894;2262;684;1927;72;250;382;994;454;1244
315600;202009;2479;7718;1776;6319;276;927;896;3366;1172;4293
315610;202009;962;2434;709;1965;107;370;321;766;428;1136
315620;202009;507;1346;380;1156;43;154;219;675;262;829
315630;202009;1054;2783;781;2283;131;401;359;955;490;1356
315640;202009;354;878;264;765;30;112;158;435;188;547
315645;202009;999;2569;676;2027;158;515;173;495;331;1010
315650;202009;1723;4144;1372;3654;34;109;1112;2874;1146;2983
315660;202009;2440;6008;1827;4949;106;326;1294;3377;1400;3703
315670;202009;13715;37338;10389;31272;2038;6431;4686;13526;6724;19957
315680;202009;3140;8978;2287;7343;286;1053;1209;3687;1495;4740
315690;202009;3357;8148;1981;5767;436;1282;587;1837;1023;3119
315700;202009;8079;22233;6028;18088;967;3072;2667;7664;3634;10736
315710;202009;1839;4540;1290;3705;45;192;906;2487;951;2679
315720;202009;4357;12093;3637;10788;181;726;2568;7301;2749;8027
315725;202009;2161;5629;1638;4732;184;508;1019;3084;1203;3592
315727;202009;564;1459;424;1230;57;203;172;467;229;670
315730;202009;568;1776;497;1619;91;331;167;496;258;827
315733;202009;1147;2905;807;2319;120;415;311;848;431;1263
315737;202009;1161;3253;906;2748;25;103;651;1888;676;1991
315740;202009;828;2303;653;1949;71;247;420;1170;491;1417
315750;202009;1268;3336;993;2890;93;289;598;1770;691;2059
315760;202009;1121;2644;987;2468;41;126;831;2022;872;2148
315765;202009;1915;5048;1571;4594;28;127;1385;4015;1413;4142
315770;202009;1031;2838;787;2490;320;1116;161;428;481;1544
315780;202009;29645;80484;24719;71734;1330;4793;17166;47546;18496;52339
315790;202009;3546;10938;3001;9891;375;1296;1787;5986;2162;7282
315800;202009;1270;4401;936;3533;131;581;308;1017;439;1598
315810;202009;1301;3220;1056;2797;58;200;811;2045;869;2245
315820;202009;2581;6939;2091;6226;192;651;1436;4257;1628;4908
315830;202009;1186;3512;806;2690;85;311;283;869;368;1180
315840;202009;849;2041;589;1582;45;140;293;717;338;857
315850;202009;1166;3443;909;2977;183;646;443;1362;626;2008
315860;202009;476;1368;331;1100;67;241;99;292;166;533
315870;202009;460;1207;367;1062;17;60;265;728;282;788
315880;202009;1089;2823;716;2154;104;375;167;467;271;842
315890;202009;1684;4798;1349;4328;330;1166;663;2096;993;3262
315895;202009;6278;16840;4682;13687;456;1489;2443;6621;2899;8110
315900;202009;814;2079;699;1912;58;177;529;1402;587;1579
315910;202009;501;1416;421;1287;57;191;293;875;350;1066
315920;202009;1470;3697;797;2420;124;459;250;693;374;1152
315930;202009;1097;2447;730;1927;141;351;307;837;448;1188
315935;202009;803;2421;626;2071;125;433;215;702;340;1135
315940;202009;604;1669;480;1475;51;162;252;748;303;910
315950;202009;1163;3204;954;2865;86;253;729;2187;815;2440
315960;202009;5212;14653;3380;10904;967;3516;296;613;1263;4129
315970;202009;614;1624;483;1448;61;200;316;950;377;1150
315980;202009;4302;9282;2334;6055;419;1150;858;2037;1277;3187
315990;202009;3630;9204;2813;7798;270;799;1600;4295;1870;5094
316000;202009;581;1471;432;1254;51;184;207;562;258;746
316010;202009;845;2230;620;1845;43;145;381;1051;424;1196
316020;202009;929;2824;737;2436;96;374;412;1270;508;1644
316030;202009;2701;7601;2031;6395;237;767;1284;4092;1521;4859
316040;202009;2388;6734;1745;5528;310;1106;438;1205;748;2311
316045;202009;2083;5341;1912;5135;76;143;1648;4557;1724;4700
316050;202009;373;1032;287;887;33;110;158;449;191;559
316060;202009;669;1671;487;1403;17;74;338;932;355;1006
316070;202009;5287;14697;4283;12789;740;2273;1994;5808;2734;8081
316080;202009;721;2264;561;1937;141;505;80;253;221;758
316090;202009;406;1165;296;940;40;140;145;433;185;573
316095;202009;1282;3963;1018;3293;272;928;333;1039;605;1967
316100;202009;2462;7152;1776;5695;311;1092;665;1939;976;3031
316105;202009;812;2138;663;1897;34;118;452;1328;486;1446
316110;202009;13578;39146;11289;35244;826;2968;7608;23434;8434;26402
316120;202009;1200;3418;769;2392;122;397;234;596;356;993
316130;202009;1289;2896;823;2127;63;186;480;1207;543;1393
316140;202009;1205;3196;771;2380;97;330;376;1133;473;1463
316150;202009;1917;4179;1541;3668;177;535;640;1453;817;1988
316160;202009;969;2658;795;2354;40;143;545;1563;585;1706
316165;202009;856;2124;649;1791;92;297;344;888;436;1185
316170;202009;1171;2877;879;2438;51;176;609;1614;660;1790
316180;202009;1407;3956;955;3025;149;555;167;494;316;1049
316190;202009;2748;7774;1586;4971;231;754;599;1655;830;2409
316200;202009;3243;9288;2408;7812;580;1999;588;1839;1168;3838
316210;202009;4445;13024;3185;10155;1149;3973;187;504;1336;4477
316220;202009;595;1790;394;1334;93;358;41;160;134;518
316225;202009;1564;3537;1168;2899;54;200;881;2026;935;2226
316230;202009;411;1118;314;949;38;117;174;537;212;654
316240;202009;5584;16075;4875;14840;369;1204;3671;11006;4040;12210
316245;202009;2977;9646;2673;9117;123;711;2052;6659;2175;7370
316250;202009;10410;24826;7551;20294;1600;4726;2770;7305;4370;12031
316255;202009;2935;8104;2551;7480;115;358;1913;5675;2028;6033
316257;202009;1394;3359;1001;2668;124;337;577;1460;701;1797
316260;202009;2138;5375;1642;4547;215;577;846;2410;1061;2987
316265;202009;1130;3024;875;2594;22;81;638;1839;660;1920
316270;202009;3681;11343;3145;10149;489;1685;1521;4678;2010;6363
316280;202009;2871;8152;2440;7336;320;1052;1371;4002;1691;5054
316290;202009;3387;9289;2696;8026;294;1028;1154;3311;1448;4339
316292;202009;5012;13303;4007;11613;502;1571;2575;7167;3077;8738
316294;202009;829;2441;618;2071;115;436;169;524;284;960
316295;202009;3183;8887;2574;7810;143;524;1803;5185;1946;5709
316300;202009;1003;2838;811;2528;47;163;595;1831;642;1994
316310;202009;800;2143;516;1632;108;402;91;238;199;640
316320;202009;665;1851;515;1609;61;226;231;691;292;917
316330;202009;1092;2824;827;2349;54;189;623;1701;677;1890
316340;202009;1010;2723;752;2252;72;281;429;1217;501;1498
316350;202009;1278;3587;1054;3229;90;304;735;2227;825;2531
316360;202009;623;1648;507;1452;52;157;363;1028;415;1185
316370;202009;4981;13249;3649;10811;666;2267;1392;3671;2058;5938
316380;202009;1722;4122;1346;3584;51;114;934;2493;985;2607
316390;202009;808;2156;571;1735;229;792;94;253;323;1045
316400;202009;1178;3291;756;2446;114;399;244;725;358;1124
316410;202009;1115;3088;931;2817;61;201;730;2160;791;2361
316420;202009;1965;5308;1692;4948;42;154;1396;4002;1438;4156
316430;202009;840;2210;530;1657;95;326;163;478;258;804
316440;202009;831;2526;652;2198;112;438;163;493;275;931
316443;202009;535;1472;391;1197;98;353;82;230;180;583
316447;202009;1960;5250;1714;4836;26;104;1479;4092;1505;4196
316450;202009;2124;6488;1613;5417;219;800;956;3121;1175;3921
316460;202009;1200;3037;963;2650;132;406;607;1572;739;1978
316470;202009;6802;19409;4809;15188;779;2807;1863;5360;2642;8167
316480;202009;200;548;166;499;45;132;76;224;121;356
316490;202009;328;870;229;693;40;124;80;204;120;328
316500;202009;1176;3635;776;2666;163;616;175;573;338;1189
316510;202009;754;2452;606;2162;110;410;296;1050;406;1460
316520;202009;1279;3119;986;2641;116;388;507;1219;623;1607
316530;202009;1111;2879;801;2321;82;320;415;1054;497;1374
316540;202009;845;2197;653;1897;101;334;314;832;415;1166
316550;202009;1349;3928;1151;3543;53;189;895;2736;948;2925
316553;202009;4351;12829;3055;9647;464;1627;1119;3126;1583;4753
316555;202009;2498;7901;2253;7560;114;401;1853;6275;1967;6676
316556;202009;542;1323;391;1061;29;78;218;534;247;612
316557;202009;1043;3228;894;2981;291;1049;305;985;596;2034
316560;202009;329;910;226;756;49;207;72;205;121;412
316570;202009;1239;3581;1017;3164;254;803;356;1148;610;1951
316580;202009;382;811;219;543;36;107;108;251;144;358
316590;202009;1344;3457;936;2652;193;482;455;1268;648;1750
316600;202009;940;2880;801;2597;119;405;420;1343;539;1748
316610;202009;605;1875;491;1690;57;251;289;962;346;1213
316620;202009;2056;5434;1796;5069;90;268;1412;3974;1502;4242
316630;202009;1545;4641;1257;4089;326;1077;501;1760;827;2837
316640;202009;141;369;109;320;17;59;50;118;67;177
316650;202009;1031;3251;822;2919;77;291;511;1843;588;2134
316660;202009;184;460;81;248;7;26;14;37;21;63
316670;202009;1789;4522;1308;3734;308;962;476;1325;784;2287
316680;202009;2293;5796;1675;4626;104;311;1261;3387;1365;3698
316690;202009;1396;3930;1041;3280;179;611;469;1436;648;2047
316695;202009;1019;2964;834;2631;26;105;580;1810;606;1915
316700;202009;400;931;329;841;16;53;256;621;272;674
316710;202009;3069;10012;2348;8491;470;1823;927;3325;1397;5148
316720;202009;20578;56091;14976;45265;2620;8455;6370;18252;8990;26707
316730;202009;428;1162;345;1000;44;149;171;468;215;617
316740;202009;739;2165;637;1995;72;261;396;1245;468;1506
316750;202009;394;1176;301;996;66;247;133;411;199;658
316760;202009;3490;11110;2843;9806;1131;4232;613;1992;1744;6224
316770;202009;1601;3659;1222;3126;25;75;992;2607;1017;2682
316780;202009;564;1670;435;1408;167;605;67;181;234;786
316790;202009;707;1903;499;1484;98;321;148;391;246;712
316800;202009;6235;17477;4964;15142;540;1842;2515;7402;3055;9244
316805;202009;1005;2221;807;2005;57;160;622;1559;679;1719
316810;202009;627;1750;424;1328;78;286;221;649;299;935
316820;202009;304;731;171;492;19;70;65;163;84;233
316830;202009;750;1994;594;1745;80;267;359;1018;439;1285
316840;202009;2741;7089;2183;6134;191;670;1499;4000;1690;4670
316850;202009;1923;5063;1370;4036;226;713;589;1659;815;2372
316860;202009;19013;48796;13899;41123;2240;7704;6294;18155;8534;25859
316870;202009;7839;21366;5797;17397;872;2876;2600;7277;3472;10153
316880;202009;865;2330;699;2098;139;461;330;945;469;1406
316890;202009;1145;2524;673;1889;93;335;409;1047;502;1382
316900;202009;2312;6205;1771;5105;343;1085;548;1465;891;2550
316905;202009;521;1550;420;1350;108;377;164;537;272;914
316910;202009;898;2348;538;1701;137;472;42;123;179;595
316920;202009;1760;4317;1220;3497;229;711;548;1510;777;2221
316930;202009;7633;21991;5604;18254;1268;4408;1497;4609;2765;9017
316935;202009;4014;10864;2897;8753;517;1699;1164;3347;1681;5046
316940;202009;6442;18886;4908;15673;752;2663;1940;5718;2692;8381
316950;202009;1878;4393;1462;3824;42;135;1212;3123;1254;3258
316960;202009;5074;11430;3647;9466;345;986;2471;6265;2816;7251
316970;202009;3739;10571;3231;9612;515;1596;1348;3839;1863;5435
316980;202009;662;1981;499;1663;163;613;58;202;221;815
316990;202009;11750;31405;8458;24690;2154;6839;1299;3431;3453;10270
317000;202009;2525;7437;2217;6985;173;502;1628;5174;1801;5676
317005;202009;2587;7300;2042;6179;330;1062;1072;3163;1402;4225
317010;202009;24468;57277;15008;42694;2991;9406;5639;16459;8630;25865
317020;202009;63967;151545;36581;103777;6628;20631;11271;29501;17899;50132
317030;202009;710;1881;550;1660;16;73;419;1241;435;1314
317040;202009;11065;27929;7666;22010;1689;5259;2709;7979;4398;13238
317043;202009;863;1933;612;1581;52;136;444;1137;496;1273
317047;202009;1185;2837;818;2245;87;247;509;1339;596;1586
317050;202009;1168;3576;811;2738;110;396;339;1003;449;1399
317052;202009;2380;6632;1913;5868;278;850;1169;3608;1447;4458
317057;202009;1809;4357;1315;3543;36;140;844;2252;880;2392
317060;202009;507;1320;314;930;37;114;134;348;171;462
317065;202009;1172;3415;952;2984;61;196;585;1726;646;1922
317070;202009;7515;20714;5283;16374;982;3415;1554;4552;2536;7967
317075;202009;927;2390;667;1941;111;358;305;808;416;1166
317080;202009;6060;14189;4439;11580;1201;3371;1443;3619;2644;6990
317090;202009;4675;13628;4134;12727;306;901;3060;9484;3366;10385
317100;202009;2695;6383;1705;4732;390;1125;612;1670;1002;2795
317103;202009;2210;5849;1873;5331;83;376;1444;3923;1527;4299
317107;202009;1441;3807;1093;3137;79;273;656;1674;735;1947
317110;202009;712;1641;356;1085;54;192;120;381;174;573
317115;202009;1087;3102;922;2794;55;150;621;1887;676;2037
317120;202009;14411;38739;11477;33934;1135;3994;6959;19652;8094;23646
317130;202009;11255;26056;7096;19198;1140;3415;2385;6389;3525;9804
317140;202009;856;2057;659;1766;42;115;439;1219;481;1334
317150;202009;1002;2373;749;2057;33;95;585;1584;618;1679
317160;202009;3544;8562;2311;6585;177;542;1272;3713;1449;4255
317170;202009;1835;4547;1324;3682;211;699;553;1335;764;2034
317180;202009;1971;6132;1445;4864;282;1012;367;1154;649;2166
317190;202009;1209;3253;891;2755;106;341;513;1566;619;1907
317200;202009;5346;13952;4068;11722;1036;3216;870;2302;1906;5518
317210;202009;1169;2852;911;2496;26;106;673;1868;699;1974
317220;202009;245;758;207;685;49;165;78;271;127;436
320010;202009;4573;13236;3650;11376;367;1267;2337;7091;2704;8358
320013;202009;1968;5328;1328;4048;217;675;595;1881;812;2556
320016;202009;3024;7724;2354;6695;178;476;1764;5029;1942;5505
320020;202009;3970;10293;2897;8420;629;2023;1020;3066;1649;5089
320030;202009;1760;4881;1136;3618;218;750;396;1205;614;1955
320035;202009;1893;5182;1542;4568;377;1231;665;1918;1042;3149
320040;202009;4075;11498;3352;10157;469;1511;1877;5485;2346;6996
320050;202009;1778;4040;1520;3666;189;546;901;2085;1090;2631
320060;202009;12653;34736;9420;28360;1433;4741;4451;12642;5884;17383
320070;202009;1535;4296;1063;3319;188;655;382;1137;570;1792
320080;202009;5711;14603;3983;11193;827;2460;1451;3865;2278;6325
320090;202009;8569;22697;5595;16520;1243;3923;2012;5517;3255;9440
320100;202009;3028;8239;2459;7241;425;1380;1255;3688;1680;5068
320110;202009;2094;4869;1390;3725;201;559;665;1709;866;2268
320115;202009;1796;5772;1522;5305;643;2367;414;1492;1057;3859
320120;202009;23645;60313;16241;46818;2343;7318;7448;20310;9791;27628
320130;202009;45304;126010;37007;110860;4862;16064;21490;62447;26352;78511
320140;202009;3613;9858;2378;7421;350;1265;943;2908;1293;4173
320150;202009;13656;35305;9632;27500;2433;7670;1636;4168;4069;11838
320160;202009;6022;16797;4409;13652;722;2462;2008;6083;2730;8545
320170;202009;1672;4785;1191;3812;325;1024;443;1504;768;2528
320180;202009;691;2185;550;1908;209;765;144;458;353;1223
320190;202009;2803;8912;2137;7418;519;1914;554;1811;1073;3725
320200;202009;1290;3446;867;2665;195;654;324;994;519;1648
320210;202009;4384;11155;3353;9362;537;1635;1768;4723;2305;6358
320220;202009;2815;7387;2121;6251;361;1154;1072;2984;1433;4138
320225;202009;1351;4194;948;3238;333;1241;191;636;524;1877
320230;202009;5041;13855;3811;11771;832;2823;1488;4429;2320;7252
320240;202009;16091;40866;11865;33977;2850;8908;3891;10855;6741;19763
320245;202009;3050;9028;2400;7701;884;2988;447;1410;1331;4398
320250;202009;2334;6517;1564;4689;337;1121;467;1231;804;2352
320255;202009;1819;5704;1553;5214;427;1468;714;2479;1141;3947
320260;202009;1423;3983;846;2690;176;618;207;556;383;1174
320265;202009;2521;7728;2030;6715;917;3239;339;1117;1256;4356
320270;202009;2213;6334;1674;5278;413;1404;619;1964;1032;3368
320280;202009;7122;18939;5708;16484;1232;3830;2608;7247;3840;11077
320290;202009;1374;4072;881;2866;237;843;232;702;469;1545
320300;202009;3661;11071;2895;9477;829;2924;689;2118;1518;5042
320305;202009;5144;14552;3957;12169;748;2502;1917;5708;2665;8210
320310;202009;2148;5928;1464;4467;261;838;658;1911;919;2749
320313;202009;2434;6103;1571;4465;309;1001;415;1068;724;2069
320316;202009;1479;4162;1197;3681;187;591;721;2223;908;2814
320320;202009;22445;58637;15769;46940;3655;11384;5741;17149;9396;28533
320330;202009;2950;8015;2275;6788;434;1300;1176;3574;1610;4874
320332;202009;7155;19336;5647;16620;1331;4209;2525;7332;3856;11541
320334;202009;1782;5059;1234;3920;266;1005;300;740;566;1745
320335;202009;1449;4298;1008;3260;236;857;249;735;485;1592
320340;202009;4832;12030;3983;10790;496;1487;2315;6328;2811;7815
320350;202009;5442;13444;3814;10485;465;1386;2018;5250;2483;6636
320360;202009;1447;3678;1065;2956;124;349;532;1408;656;1757
320370;202009;2606;7970;1899;6416;575;2044;601;2006;1176;4050
320380;202009;2563;6848;2120;6117;239;742;1341;3752;1580;4494
320390;202009;7181;19384;5267;15531;1074;3378;2125;5870;3199;9248
320400;202009;3339;9411;2502;7613;703;2278;853;2466;1556;4744
320405;202009;4790;12580;3607;10540;560;1783;1732;4932;2292;6715
320410;202009;4855;12564;3632;10568;647;1836;1805;5477;2452;7313
320420;202009;3308;8621;2499;7236;702;2248;451;1305;1153;3553
320425;202009;2114;5065;1597;4194;98;283;1051;2671;1149;2954
320430;202009;3128;7790;2434;6525;322;941;1546;3996;1868;4937
320435;202009;2169;6736;1711;5827;609;2205;517;1769;1126;3974
320440;202009;1493;4111;1087;3324;167;546;487;1430;654;1976
320450;202009;1676;4799;1301;4087;265;949;584;1708;849;2657
320455;202009;4263;12817;2844;9444;712;2545;692;2075;1404;4620
320460;202009;2147;6295;1501;4921;360;1251;396;1213;756;2464
320465;202009;1292;3637;958;2985;138;437;511;1597;649;2034
320470;202009;3770;10345;2641;7953;602;1910;632;1694;1234;3604
320480;202009;1696;4661;1373;4111;188;638;804;2346;992;2984
320490;202009;21493;56358;15806;46262;2698;8619;6514;18834;9212;27453
320495;202009;1297;3522;881;2713;196;692;322;941;518;1633
320500;202009;52775;140240;41863;121275;5815;18267;24165;67020;29980;85287
320501;202009;4431;12820;3255;10661;898;3284;1066;3432;1964;6716
320503;202009;2433;6914;1551;5071;415;1481;438;1360;853;2841
320506;202009;2669;7906;1913;6221;562;1973;176;569;738;2542
320510;202009;10232;27638;8220;24113;913;3086;5069;14370;5982;17456
320515;202009;1804;4909;1383;4054;373;1198;465;1293;838;2491
320517;202009;2190;6550;1728;5549;537;1885;511;1606;1048;3491
320520;202009;36509;94524;27037;78415;4696;14987;11468;32055;16164;47042
320530;202009;32619;86024;25549;73366;2379;8061;16103;43679;18482;51740
330010;202009;22350;59269;18238;52344;2429;7551;11724;32752;14153;40303
330015;202009;1492;3658;1153;3136;199;607;617;1595;816;2202
330020;202009;20082;49952;16777;45138;2388;7211;11538;30300;13926;37511
330022;202009;1908;5097;1455;4301;254;764;835;2452;1089;3216
330023;202009;5078;12026;3631;9983;589;1798;2019;5413;2608;7211
330025;202009;6904;15948;3967;10990;908;2790;808;2122;1716;4912
330030;202009;10435;27760;7838;23460;831;2869;4770;13629;5601;16498
330040;202009;14753;38298;11617;32938;1102;3520;7738;21047;8840;24567
330045;202009;85671;201139;69895;181061;5383;13823;55128;142290;60511;156113
330050;202009;2524;6659;1839;5484;358;1152;900;2558;1258;3710
330060;202009;5255;13742;4060;11589;788;2509;1697;4445;2485;6954
330070;202009;22693;57316;18124;50596;2857;8494;10656;29512;13513;38006
330080;202009;8880;22344;7518;20399;930;2697;5199;13910;6129;16607
330090;202009;3524;7336;2390;5759;160;411;1635;3937;1795;4348
330093;202009;2749;6567;2051;5572;122;360;1565;4222;1687;4582
330095;202009;1293;3624;992;3055;79;290;605;1731;684;2021
330100;202009;71023;187323;60169;171104;3637;12303;45905;128493;49542;140796
330110;202009;2095;5821;1672;5104;272;907;932;2738;1204;3645
330115;202009;2563;6161;1785;4938;243;769;1009;2681;1252;3450
330120;202009;3577;7984;2651;6780;219;622;1833;4512;2052;5134
330130;202009;4372;11809;3554;10558;486;1512;2227;6568;2713;8080
330140;202009;3814;9813;3001;8634;423;1363;1904;5344;2327;6707
330150;202009;2155;5727;1626;4883;286;909;809;2365;1095;3274
330160;202009;1375;3709;1020;3078;177;573;541;1557;718;2130
330170;202009;109674;270579;87344;240117;11786;32034;58326;162376;70112;194410
330180;202009;1988;4777;1520;4115;100;314;1045;2748;1145;3062
330185;202009;9768;24447;8108;22118;488;1636;6466;17197;6954;18833
330187;202009;4344;10998;3344;9356;461;1398;1958;5419;2419;6817
330190;202009;33828;81586;28389;74027;1959;5535;22446;57764;24405;63299
330200;202009;16017;40465;12914;36616;2533;6841;8009;23422;10542;30263
330205;202009;2140;5253;1601;4379;97;319;1100;2881;1197;3200
330210;202009;3477;8628;2493;6890;363;1096;1219;3120;1582;4216
330220;202009;12150;29983;8456;23751;1739;5481;3009;7801;4748;13282
330225;202009;4013;10002;3019;8467;195;665;2183;5956;2378;6621
330227;202009;17459;41873;14535;38299;592;1725;12412;32347;13004;34072
330230;202009;2166;4644;1375;3653;124;357;809;2161;933;2518
330240;202009;23961;62016;19506;54984;2396;7431;12850;35293;15246;42724
330245;202009;1729;4223;1018;2959;202;591;390;1124;592;1715
330250;202009;38592;98090;31647;87767;5468;15574;19194;53092;24662;68666
330260;202009;4895;11785;3663;10104;348;1100;2560;6807;2908;7907
330270;202009;30093;66454;18311;47615;2939;8182;7512;18805;10451;26987
330280;202009;2385;6244;1776;5197;196;628;1038;2935;1234;3563
330285;202009;24455;58134;19150;50470;1487;4612;14059;35744;15546;40356
330290;202009;3886;9369;3101;8319;329;972;2190;5690;2519;6662
330300;202009;5840;13686;4192;11288;313;966;2921;7708;3234;8674
330310;202009;2723;6663;1914;5303;128;311;1266;3516;1394;3827
330320;202009;16866;39612;12796;34497;1477;3919;9142;24855;10619;28774
330330;202009;39707;86146;30261;73364;2714;7301;21631;51259;24345;58560
330340;202009;16617;39547;11874;32120;1762;5454;6230;15767;7992;21221
330350;202009;141354;324500;115647;292954;7391;19511;94634;238243;102025;257754
330360;202009;7484;18081;6385;16733;210;556;5414;14122;5624;14678
330370;202009;4996;14187;3784;12114;886;2924;1551;5167;2437;8091
330380;202009;5487;14613;4091;12096;694;2382;2037;5720;2731;8102
330385;202009;4002;11415;3233;10264;753;2637;1543;4829;2296;7466
330390;202009;26630;71489;20063;60037;2765;9543;11551;32531;14316;42074
330395;202009;3219;7925;2638;7162;160;506;1911;5071;2071;5577
330400;202009;3416;8896;2871;8028;157;553;2147;5649;2304;6202
330410;202009;3267;8683;2283;6929;456;1508;991;2854;1447;4362
330411;202009;2802;7556;2146;6313;148;516;1483;4189;1631;4705
330412;202009;1545;4350;1240;3846;127;467;772;2250;899;2717
330414;202009;24318;60716;19571;54188;1583;4600;14484;39621;16067;44221
330415;202009;4264;11562;3273;9835;328;1053;1942;5778;2270;6831
330420;202009;11839;29064;8173;23080;978;3151;4252;11179;5230;14330
330430;202009;9655;23132;8003;20826;328;1084;6253;15767;6581;16851
330440;202009;2535;6772;1885;5663;301;1061;1066;3048;1367;4109
330450;202009;1385;3895;1081;3373;139;464;596;1834;735;2298
330452;202009;17500;44052;13919;38551;1708;5377;8940;23868;10648;29245
330455;202009;563030;1324987;428346;1130283;60109;169202;271927;705001;332036;874203
330460;202009;1194;3241;880;2773;152;517;472;1445;624;1962
330470;202009;4873;12129;3479;9964;1126;3344;988;2916;2114;6260
330475;202009;9590;24743;7698;22279;1192;3959;4926;13927;6118;17886
330480;202009;5944;15327;4968;13889;412;1289;3433;9305;3845;10594
330490;202009;114080;260516;91621;230270;10172;26686;65357;162585;75529;189271
330500;202009;7400;18195;6134;16451;621;1871;4431;11697;5052;13568
330510;202009;40762;100235;29867;84721;4900;14930;18111;50616;23011;65546
330513;202009;1239;3183;971;2802;209;641;470;1367;679;2008
330515;202009;2510;6589;1988;5846;371;1183;1105;3164;1476;4347
330520;202009;11327;29796;9108;26275;1196;3827;5566;15637;6762;19464
330530;202009;1743;4166;1266;3436;255;756;573;1530;828;2286
330540;202009;2901;7645;2224;6473;524;1579;946;2668;1470;4247
330550;202009;9118;23461;6918;20533;1914;6219;2815;8212;4729;14431
330555;202009;18285;38267;15064;34466;836;2140;12200;28118;13036;30258
330560;202009;4158;11104;3326;9700;506;1520;1977;5614;2483;7134
330570;202009;2752;7497;2301;6798;355;1137;1477;4311;1832;5448
330575;202009;5498;14173;4698;12793;282;875;3759;9907;4041;10782
330580;202009;17660;46909;13541;39400;2428;7648;6564;18255;8992;25903
330590;202009;1463;3934;1203;3599;223;665;743;2257;966;2922
330600;202009;12015;31322;9701;27596;899;2981;6212;17120;7111;20101
330610;202009;9236;24545;7346;21526;573;1967;5099;14560;5672;16527
330615;202009;2107;5708;1625;5041;306;972;995;3149;1301;4121
330620;202009;4028;11465;3134;9906;700;2396;1319;3911;2019;6307
330630;202009;24690;61588;19249;53033;1383;4518;13693;36418;15076;40936
350010;202009;2069;5288;1036;3095;224;721;187;408;411;1129
350020;202009;704;1807;400;1224;50;159;158;445;208;604
350030;202009;3582;9960;2620;8262;649;2240;1077;3217;1726;5457
350040;202009;727;2070;410;1383;55;214;138;357;193;571
350050;202009;1298;3211;836;2401;193;642;274;635;467;1277
350055;202009;927;2407;706;2059;78;248;411;1136;489;1384
350060;202009;197;503;117;339;14;46;54;157;68;203
350070;202009;3446;9051;2145;6677;431;1501;664;1854;1095;3355
350075;202009;596;1735;442;1439;177;602;45;157;222;759
350080;202009;664;1715;421;1275;59;202;172;463;231;665
350090;202009;587;1396;354;985;71;212;153;396;224;608
350100;202009;2348;6176;1604;4843;125;466;992;2804;1117;3270
350110;202009;486;1231;329;949;17;59;189;538;206;597
350115;202009;1288;3717;1048;3206;186;626;540;1502;726;2128
350120;202009;685;1584;375;1007;35;116;200;465;235;581
350130;202009;3129;8228;2428;6940;418;1225;1204;3275;1622;4500
350140;202009;783;2195;517;1665;47;204;276;823;323;1027
350150;202009;524;1595;426;1404;94;307;120;361;214;668
350160;202009;11106;27757;7340;20880;930;3004;4400;11832;5330;14836
350170;202009;2263;6442;1799;5417;326;1066;811;2242;1137;3308
350180;202009;1041;2569;530;1576;112;352;102;265;214;617
350190;202009;2881;8114;1958;6152;358;1276;807;2163;1165;3439
350200;202009;454;1282;352;1088;18;62;227;658;245;720
350210;202009;5878;13396;3934;10416;510;1465;2407;6122;2917;7587
350220;202009;2881;7879;1921;5957;418;1370;629;1767;1047;3137
350230;202009;1022;2620;834;2345;154;464;465;1264;619;1728
350240;202009;649;1884;412;1326;87;282;101;304;188;586
350250;202009;2498;7081;1851;5997;616;2198;399;1274;1015;3472
350260;202009;842;1989;538;1462;58;180;326;849;384;1029
350270;202009;4528;12157;3567;10306;540;1711;1893;5105;2433;6816
350275;202009;2384;6361;1839;5497;301;1005;1065;3028;1366;4033
350280;202009;19201;43021;11205;29979;1873;5311;4390;11193;6263;16504
350290;202009;3213;8841;2135;6585;378;1275;847;2419;1225;3694
350300;202009;646;1744;473;1414;68;208;244;682;312;890
350310;202009;906;2608;662;2109;113;412;254;730;367;1142
350315;202009;590;1468;386;1126;25;87;200;538;225;625
350320;202009;15157;38777;10983;31341;2335;7365;4121;10861;6456;18226
350330;202009;14160;34703;9924;26527;1081;3182;6198;15544;7279;18726
350335;202009;367;1031;282;872;36;125;132;385;168;510
350340;202009;1174;2994;703;2125;122;418;278;749;400;1167
350350;202009;749;1892;571;1691;70;244;339;984;409;1228
350360;202009;1087;3212;826;2661;219;720;252;824;471;1544
350370;202009;616;1533;422;1181;152;410;127;359;279;769
350380;202009;4418;12054;3088;9358;889;2660;766;2378;1655;5038
350390;202009;10667;28101;8302;24025;1748;5258;3817;10682;5565;15940
350395;202009;436;1122;220;701;22;66;81;234;103;300
350400;202009;8093;19879;5554;15667;1363;4143;1542;4289;2905;8432
350410;202009;9846;27353;7077;21938;1474;5126;2716;7739;4190;12865
350420;202009;739;1980;514;1492;86;280;124;305;210;585
350430;202009;671;1812;539;1598;70;249;327;884;397;1133
350440;202009;2044;5119;1645;4510;130;384;1064;2849;1194;3233
350450;202009;6657;18204;5120;15528;1120;3715;2116;6004;3236;9719
350460;202009;1747;4515;897;2777;156;514;224;620;380;1134
350470;202009;255;640;196;540;12;38;137;363;149;401
350480;202009;1007;2512;640;1861;126;449;154;345;280;794
350490;202009;1954;5099;1380;4157;325;1006;407;1134;732;2140
350500;202009;679;1794;510;1479;67;208;254;694;321;902
350510;202009;1170;3034;865;2476;96;308;509;1397;605;1705
350520;202009;2144;6514;1640;5511;265;985;728;2208;993;3193
350530;202009;2813;7018;2058;5601;230;702;1222;3112;1452;3814
350535;202009;1430;3874;1229;3593;169;555;764;2162;933;2717
350540;202009;1940;4613;1424;3838;170;471;890;2323;1060;2794
350550;202009;8394;20648;5777;16322;628;2120;3357;8798;3985;10918
350560;202009;3929;11009;3091;9495;305;999;1917;5690;2222;6689
350570;202009;24373;67836;19466;58256;3653;11988;9808;28110;13461;40098
350580;202009;2111;5690;1223;3783;317;1071;221;556;538;1627
350590;202009;5062;13676;3664;10536;485;1586;2136;5668;2621;7254
350600;202009;36295;83591;22221;59002;3273;9827;10416;25376;13689;35203
350610;202009;6855;18750;4879;14775;850;2816;2242;6391;3092;9207
350620;202009;416;1054;262;818;26;81;150;456;176;537
350630;202009;1454;3769;1055;3053;76;284;682;1838;758;2122
350635;202009;9308;22908;6949;19222;989;3005;4134;10935;5123;13940
350640;202009;932;2487;484;1507;73;231;141;384;214;615
350650;202009;8480;22576;5750;17153;1112;3570;2135;5912;3247;9482
350660;202009;4608;12049;3516;10222;582;1713;1815;5273;2397;6986
350670;202009;1835;4868;1491;4363;156;469;999;2923;1155;3392
350680;202009;1127;3025;742;2310;139;445;298;872;437;1317
350690;202009;1279;3301;895;2657;152;486;479;1377;631;1863
350700;202009;4842;12210;3388;9933;653;2181;1448;4007;2101;6188
350710;202009;2843;7756;2390;6950;408;1385;1305;3485;1713;4870
350715;202009;815;2337;665;2063;70;279;361;1032;431;1311
350720;202009;155;409;111;333;17;49;35;88;52;137
350730;202009;613;1638;513;1463;29;110;382;1023;411;1133
350740;202009;1664;4432;1129;3345;205;651;374;1015;579;1666
350745;202009;592;1494;323;974;40;148;127;343;167;491
350750;202009;9840;25554;7407;21341;1294;4307;3342;8598;4636;12905
350760;202009;14797;36760;10586;29452;2239;6873;4332;10871;6571;17744
350770;202009;974;2442;604;1785;37;119;389;1127;426;1246
350775;202009;672;1571;453;1243;48;138;215;588;263;726
350780;202009;2219;5410;1554;4441;261;864;553;1810;814;2674
350790;202009;1801;4759;1118;3470;223;764;332;829;555;1593
350800;202009;3472;9958;2964;9059;251;882;2042;6041;2293;6923
350810;202009;2792;6804;2169;5886;325;848;1191;3302;1516;4150
350820;202009;932;2184;525;1444;55;182;259;638;314;820
350830;202009;873;2434;487;1561;76;244;147;409;223;653
350840;202009;3287;9556;2434;7925;548;1949;1075;3214;1623;5163
350850;202009;7219;19984;5587;17040;1104;3646;2619;7597;3723;11243
350860;202009;3597;9606;3066;8880;115;419;2336;6696;2451;7115
350870;202009;2600;7299;1892;6144;263;960;1043;3298;1306;4258
350880;202009;1335;3808;1039;3220;271;870;285;853;556;1723
350890;202009;529;1362;329;946;50;150;123;329;173;479
350900;202009;7235;19564;4552;13815;991;3283;1519;4224;2510;7507
350910;202009;911;2230;777;2022;94;254;557;1428;651;1682
350920;202009;11996;29516;10057;26351;436;1420;8168;20578;8604;21998
350925;202009;4310;11723;3044;9404;583;1943;1429;4073;2012;6016
350930;202009;1510;3929;1028;2971;87;253;637;1814;724;2067
350940;202009;2279;5996;1738;5105;183;602;1092;3076;1275;3678
350945;202009;837;2350;618;1919;95;344;323;917;418;1261
350950;202009;87909;225712;66959;186122;8801;26974;40862;108208;49663;135182
350960;202009;6461;17443;4978;14640;593;2002;2972;8275;3565;10277
350970;202009;3610;10112;2576;8117;756;2661;527;1415;1283;4076
350980;202009;646;1780;518;1548;135;420;234;697;369;1117
350990;202009;1771;4922;1289;4126;318;1131;443;1332;761;2463
350995;202009;789;2435;699;2252;53;210;491;1510;544;1720
351000;202009;2874;7455;1984;5838;350;1085;725;2083;1075;3168
351010;202009;335;821;222;626;28;90;116;313;144;403
351015;202009;818;2453;645;2077;104;365;293;846;397;1211
351020;202009;8827;23950;6689;20256;1400;4308;3175;9389;4575;13697
351030;202009;2819;8371;2236;7182;320;1135;1204;3775;1524;4910
351040;202009;4983;12322;4136;11031;213;686;3372;8747;3585;9433
351050;202009;17301;42091;12214;34061;2440;7199;5315;14627;7755;21826
351060;202009;48740;122473;36831;101862;3828;11657;24586;65746;28414;77403
351070;202009;1431;3532;763;2351;185;622;131;391;316;1013
351080;202009;2787;6723;1972;5745;213;733;1301;3607;1514;4340
351090;202009;323;945;229;766;50;169;65;215;115;384
351100;202009;2649;7144;1685;5181;381;1227;477;1527;858;2754
351110;202009;6265;15907;3991;11707;668;2164;1694;4652;2362;6816
351120;202009;787;1977;519;1527;64;202;199;565;263;767
351130;202009;1200;3135;541;1716;102;322;139;417;241;739
351140;202009;2135;6038;1565;4919;314;1104;648;1814;962;2918
351150;202009;2580;7392;1718;5457;292;1019;665;1884;957;2903
351160;202009;1130;3497;832;2796;177;638;214;612;391;1250
351170;202009;1376;3754;1178;3389;94;293;837;2328;931;2621
351190;202009;1006;2786;653;2054;117;372;232;670;349;1042
351200;202009;1631;3887;1200;3237;99;302;846;2143;945;2445
351210;202009;1558;3844;954;2683;79;263;556;1447;635;1710
351220;202009;3287;9245;2790;8416;313;983;1852;5523;2165;6506
351230;202009;1761;4763;1284;3916;220;780;575;1588;795;2368
351240;202009;2440;6236;1470;4182;321;980;536;1354;857;2334
351250;202009;1066;2837;621;1926;84;276;221;677;305;953
351260;202009;924;2331;658;1840;130;368;249;658;379;1026
351270;202009;446;1188;366;1050;37;133;226;564;263;697
351280;202009;3893;10199;2919;8358;560;1644;1326;3641;1886;5285
351290;202009;1248;3063;850;2374;119;364;502;1342;621;1706
351300;202009;18079;49020;12220;37554;2170;7240;5244;15425;7414;22665
351310;202009;3444;8388;2589;7058;181;626;1898;4896;2079;5522
351320;202009;969;2768;716;2230;134;451;252;690;386;1141
351330;202009;490;1160;402;998;22;62;289;649;311;711
351340;202009;6343;18029;5032;15699;1216;3960;2190;6816;3406;10776
351350;202009;11486;28712;9404;25414;1009;2925;6822;17912;7831;20837
351360;202009;3802;10153;3102;9089;748;2352;1208;3268;1956;5620
351370;202009;2076;5781;1374;4299;324;1096;431;1231;755;2327
351380;202009;49013;118144;34324;92262;4353;12552;19650;50405;24003;62957
351385;202009;336;891;151;468;30;90;41;116;71;206
351390;202009;1403;3434;861;2623;124;451;493;1392;617;1843
351400;202009;924;2582;754;2225;117;353;467;1341;584;1694
351410;202009;2616;7282;1851;5763;328;1059;734;2217;1062;3276
351420;202009;415;976;229;647;27;74;138;362;165;436
351430;202009;948;2543;728;2177;56;168;504;1456;560;1624
351440;202009;3459;9061;2233;6537;412;1255;625;1566;1037;2821
351450;202009;1731;4572;1115;3405;225;746;179;416;404;1162
351460;202009;837;2179;642;1859;151;427;346;995;497;1422
351470;202009;1212;3063;928;2585;88;302;601;1567;689;1869
351480;202009;2473;7282;1929;6308;362;1310;815;2496;1177;3806
351490;202009;2018;5665;1709;5105;72;288;1377;3968;1449;4256
351492;202009;353;951;287;809;8;24;214;588;222;612
351495;202009;186;481;136;380;17;43;73;202;90;245
351500;202009;38131;93509;28295;76813;4256;12358;16777;43535;21033;55893
351510;202009;12965;32241;9320;25852;1143;3623;5771;15245;6914;18868
351512;202009;482;1308;339;997;60;180;117;314;177;494
351515;202009;3239;7230;1971;5226;347;1041;574;1610;921;2651
351518;202009;2374;5983;1499;4405;204;673;824;2196;1028;2869
351519;202009;716;1969;437;1414;87;280;68;205;155;485
351520;202009;1279;3170;531;1613;56;189;221;595;277;784
351530;202009;359;947;209;624;29;91;84;196;113;287
351535;202009;1904;4633;1343;3671;212;644;704;1798;916;2442
351540;202009;2494;6206;1649;4708;309;1024;595;1494;904;2518
351550;202009;7102;17548;4696;13139;475;1532;2664;6924;3139;8456
351560;202009;450;1285;343;1067;82;287;105;298;187;585
351565;202009;223;628;178;548;42;150;45;118;87;268
351570;202009;21376;57110;16077;46243;1710;5351;9968;27392;11678;32743
351580;202009;248;638;136;419;12;41;58;185;70;226
351590;202009;516;1164;274;748;23;84;157;389;180;473
351600;202009;1352;3564;1026;2949;97;301;620;1674;717;1975
351610;202009;770;1812;485;1313;25;71;279;711;304;782
351620;202009;23181;61007;16615;49588;2722;9205;7501;20192;10223;29397
351630;202009;28199;73772;22473;63786;3207;9621;13944;38224;17151;47845
351640;202009;17490;46104;13501;38659;1308;4297;9112;24974;10420;29271
351650;202009;377;995;169;548;22;75;50;135;72;210
351660;202009;749;2101;464;1454;85;282;68;168;153;450
351670;202009;5944;15912;3800;11235;810;2390;1621;4509;2431;6899
351680;202009;427;1210;267;854;44;138;66;176;110;314
351685;202009;419;1197;333;1057;90;287;105;310;195;597
351690;202009;1108;2784;616;1811;85;280;258;681;343;961
351700;202009;1365;3384;968;2685;162;464;523;1365;685;1829
351710;202009;757;2031;537;1609;52;179;282;761;334;940
351720;202009;1409;3655;918;2784;147;476;373;1066;520;1542
351730;202009;942;2472;775;2206;58;204;496;1333;554;1537
351740;202009;3562;8939;2755;7387;495;1441;1357;3343;1852;4784
351750;202009;1349;3525;820;2578;154;502;309;946;463;1448
351760;202009;3330;9385;2414;7519;501;1775;883;2469;1384;4244
351770;202009;1749;5168;1418;4522;267;902;740;2297;1007;3199
351780;202009;1257;3167;736;2178;106;362;262;731;368;1093
351790;202009;1363;3244;1060;2838;172;471;623;1673;795;2144
351800;202009;522;1212;251;697;26;74;98;233;124;307
351810;202009;1052;2752;852;2441;44;126;612;1671;656;1797
351820;202009;2588;7219;1780;5643;462;1603;410;1195;872;2798
351830;202009;4546;12152;3464;10267;324;1157;2166;6086;2490;7243
351840;202009;8563;23641;6346;19490;918;3148;3288;9422;4206;12570
351850;202009;1579;4264;1023;3179;170;607;352;934;522;1541
351860;202009;2763;7945;2106;6707;359;1223;1116;3603;1475;4826
351870;202009;23889;60869;17595;50480;4457;13225;7144;20782;11601;34007
351880;202009;132005;339231;97810;279779;22106;69897;44709;121151;66815;191048
351885;202009;889;2391;694;2059;66;242;453;1275;519;1517
351890;202009;834;2153;522;1621;110;361;94;241;204;602
351900;202009;1102;2926;848;2544;123;367;476;1420;599;1787
351905;202009;434;1177;306;928;26;90;145;382;171;472
351907;202009;21253;55486;16307;46582;1883;5943;10460;28709;12343;34652
351910;202009;1580;4124;1087;3052;72;218;634;1611;706;1829
351920;202009;873;2298;656;1881;102;338;290;751;392;1089
351925;202009;900;2372;693;1991;87;286;374;990;461;1276
351930;202009;3251;9072;2902;8430;590;1719;1921;5496;2511;7215
351940;202009;1097;2815;780;2253;126;392;385;1095;511;1487
351950;202009;1690;3831;1236;3159;62;189;864;2121;926;2310
351960;202009;5255;13227;3783;10582;832;2500;1687;4379;2519;6879
351970;202009;7181;21230;5639;18492;881;3227;3078;9775;3959;13002
351980;202009;998;2335;625;1727;84;266;361;918;445;1184
351990;202009;1423;3342;1013;2744;53;200;492;1202;545;1402
352000;202009;2608;7403;2233;6630;253;861;1465;4063;1718;4924
352010;202009;2272;6050;1810;5273;468;1502;388;1157;856;2659
352020;202009;1440;3937;1096;3351;167;555;533;1543;700;2098
352030;202009;5857;15325;4494;13064;840;2661;2215;6216;3055;8877
352040;202009;2911;7754;1947;5768;278;919;734;1855;1012;2774
352042;202009;2994;7306;1924;5579;375;1233;825;2280;1200;3513
352044;202009;2077;5527;1168;3766;179;655;250;749;429;1404
352050;202009;12558;33399;8055;24421;2020;6996;1551;3910;3571;10906
352060;202009;706;1888;507;1516;73;237;225;617;298;854
352070;202009;911;1830;578;1385;61;157;281;598;342;755
352080;202009;496;1243;283;818;30;104;102;264;132;368
352090;202009;1490;4358;1220;3815;143;522;584;1646;727;2168
352100;202009;3457;9682;2788;8415;596;1970;1220;3542;1816;5512
352110;202009;598;1732;454;1442;95;316;182;534;277;850
352115;202009;497;1354;406;1213;50;178;242;702;292;880
352120;202009;893;2619;732;2290;87;270;433;1267;520;1537
352130;202009;2023;5637;1342;3987;206;651;541;1479;747;2130
352140;202009;1189;3227;829;2517;148;482;390;1138;538;1620
352150;202009;877;2312;670;1955;82;256;465;1320;547;1576
352160;202009;1000;2452;714;1999;77;268;404;1073;481;1341
352170;202009;3050;8105;2391;6790;322;1034;1451;3818;1773;4852
352180;202009;2514;6782;1918;5676;452;1502;574;1493;1026;2995
352190;202009;1235;3302;965;2885;178;500;465;1456;643;1956
352200;202009;337;1021;233;808;32;121;86;287;118;408
352210;202009;19776;46530;15438;40768;1014;2983;11952;30951;12966;33934
352215;202009;630;1631;542;1505;66;203;348;939;414;1142
352220;202009;20979;51863;14254;39734;2649;8022;6463;16636;9112;24658
352230;202009;14199;40968;10880;34671;2604;9208;3962;11630;6566;20838
352240;202009;10568;27152;7982;22800;1727;5573;3460;9097;5187;14670
352250;202009;23226;64821;18355;56281;3040;9947;10798;32561;13838;42508
352260;202009;4812;12064;3215;8948;468;1502;1819;4552;2287;6054
352265;202009;918;2532;806;2375;50;167;609;1752;659;1919
352270;202009;1463;4342;1070;3485;230;819;378;1154;608;1973
352280;202009;2469;6213;1858;5313;198;699;1099;2887;1297;3586
352290;202009;1149;3328;919;2871;126;446;494;1397;620;1843
352300;202009;910;2459;602;1807;82;285;316;883;398;1168
352310;202009;45207;119766;33306;98661;8235;25030;14219;42324;22454;67354
352320;202009;6603;17394;5045;14326;771;2476;2676;6842;3447;9318
352330;202009;2229;5881;1665;5082;285;1025;896;2562;1181;3587
352340;202009;5840;15335;4259;12431;659;2191;2171;5821;2830;8012
352350;202009;2156;6125;1659;5014;181;670;903;2447;1084;3117
352360;202009;1245;3299;1016;2903;82;288;765;2103;847;2391
352370;202009;1070;3008;923;2767;21;85;750;2204;771;2289
352380;202009;850;2313;630;1912;128;396;219;630;347;1026
352390;202009;15082;36890;10110;28208;1642;5008;5536;14569;7178;19577
352400;202009;3529;9714;2867;8475;617;2117;1461;3996;2078;6113
352410;202009;3246;8317;2435;6954;219;751;1506;4098;1725;4849
352420;202009;845;2038;596;1673;111;329;224;592;335;921
352430;202009;7993;19813;5680;15759;1191;3746;2634;6872;3825;10618
352440;202009;18030;48615;13287;39437;3227;9911;4946;14279;8173;24190
352450;202009;782;1911;390;1230;54;189;132;394;186;583
352460;202009;2974;8227;2030;6464;407;1431;802;2390;1209;3821
352470;202009;3422;8607;2563;7217;302;966;1539;4086;1841;5052
352480;202009;4014;9482;2641;7019;418;1278;1301;3102;1719;4380
352490;202009;736;2105;585;1835;101;341;288;857;389;1198
352500;202009;10396;26720;6944;20233;2912;9336;736;1203;3648;10539
352510;202009;3749;10084;2784;8396;570;1868;1300;3718;1870;5586
352520;202009;2872;7472;2213;6355;394;1284;1259;3280;1653;4564
352530;202009;10399;26856;6833;19939;1204;4033;2258;5603;3462;9636
352540;202009;573;1689;413;1324;65;236;141;398;206;634
352550;202009;1004;2788;694;2192;128;442;240;687;368;1129
352560;202009;583;1614;439;1328;80;254;203;569;283;823
352570;202009;2291;6530;1416;4591;335;1184;134;347;469;1531
352580;202009;666;1721;548;1514;48;159;371;973;419;1132
352585;202009;322;858;230;694;17;67;138;380;155;447
352590;202009;13308;34937;9236;27116;2374;7593;4022;10969;6396;18562
352600;202009;1976;5279;1522;4424;154;482;949;2609;1103;3091
352610;202009;2919;8166;2183;6869;433;1541;886;2614;1319;4155
352620;202009;5642;14423;4271;12436;1236;3696;1637;4790;2873;8486
352630;202009;840;2092;620;1758;116;372;285;737;401;1109
352640;202009;3008;7724;2130;6145;208;636;1224;3375;1432;4011
352650;202009;610;1708;421;1297;59;205;151;449;210;654
352660;202009;1092;3177;888;2758;108;351;510;1545;618;1896
352670;202009;9758;26119;6305;19208;1574;5142;1551;4423;3125;9565
352680;202009;3293;9762;2279;7436;339;1336;1111;3255;1450;4591
352690;202009;27332;68365;21038;57557;1370;4456;14873;38946;16243;43402
352700;202009;582;1444;427;1228;154;505;96;264;250;769
352710;202009;5214;13389;3669;10563;863;2731;1526;4038;2389;6769
352720;202009;7860;21359;6063;17974;2482;7522;1348;3735;3830;11257
352725;202009;601;1438;334;954;21;54;163;441;184;495
352730;202009;5106;14792;4574;13533;531;1715;2160;5624;2691;7339
352740;202009;2323;5457;1707;4544;172;541;1046;2609;1218;3150
352750;202009;414;1019;245;711;39;123;103;260;142;383
352760;202009;1678;4633;1281;3838;105;297;735;2220;840;2517
352770;202009;878;2363;589;1798;121;383;234;685;355;1068
352780;202009;626;1773;443;1413;95;290;122;387;217;677
352790;202009;450;1201;310;918;35;118;118;314;153;432
352800;202009;1269;3910;882;2982;242;839;115;344;357;1183
352810;202009;1167;2752;729;1975;101;297;443;1117;544;1414
352820;202009;509;1403;356;1139;75;236;75;253;150;489
352830;202009;582;1466;261;791;23;72;60;149;83;221
352840;202009;4025;11451;3277;10102;1100;3639;1082;3221;2182;6860
352850;202009;11029;26813;7425;20916;1962;6023;2375;6029;4337;12052
352860;202009;1019;2802;748;2298;142;472;281;819;423;1291
352870;202009;868;2154;605;1616;42;139;392;988;434;1127
352880;202009;1759;4143;1228;3213;187;510;704;1754;891;2264
352885;202009;299;825;220;681;24;85;129;375;153;460
352890;202009;704;1682;439;1132;41;118;264;609;305;727
352900;202009;17974;46805;11761;34480;1959;6113;5181;14252;7140;20365
352910;202009;431;1145;229;712;24;84;68;187;92;271
352920;202009;2664;6793;1916;5501;137;426;1300;3623;1437;4049
352930;202009;5824;15705;4288;12700;775;2541;2015;5506;2790;8047
352940;202009;22420;61022;16088;47628;3313;10782;6738;18693;10051;29475
352950;202009;535;1421;319;1021;90;286;59;172;149;458
352960;202009;747;1977;411;1264;70;233;119;316;189;549
352965;202009;236;665;147;484;45;144;34;102;79;246
352970;202009;2962;7073;2237;5877;240;677;1461;3782;1701;4459
352980;202009;1372;3639;1084;3201;261;842;548;1571;809;2413
352990;202009;4086;11462;3184;9964;642;2225;1567;4685;2209;6910
353000;202009;475;1302;257;795;38;125;59;154;97;279
353010;202009;2601;6358;1703;4770;343;1108;711;1799;1054;2907
353020;202009;3660;9379;2095;6107;297;962;713;1930;1010;2892
353030;202009;4537;11418;3086;8859;692;2166;892;2431;1584;4597
353040;202009;648;1492;457;1212;80;212;236;602;316;814
353050;202009;5164;14756;3619;11583;705;2443;1632;4983;2337;7426
353060;202009;48738;123905;39852;109677;2771;9162;29772;79010;32543;88172
353070;202009;9427;26881;6762;21182;1302;4481;2766;7990;4068;12471
353080;202009;4070;11274;2700;8600;505;1815;1043;2920;1548;4735
353090;202009;585;1737;446;1442;31;110;289;899;320;1009
353100;202009;310;837;139;443;28;97;39;97;67;194
353110;202009;7605;20313;6118;18145;1253;3815;3203;9802;4456;13617
353120;202009;403;996;294;817;40;134;136;331;176;465
353130;202009;2447;5730;1540;4231;390;1194;517;1275;907;2469
353140;202009;2725;6726;1945;5379;112;368;1361;3603;1473;3971
353150;202009;1570;3832;1099;3049;206;589;486;1282;692;1871
353160;202009;601;1547;428;1258;75;229;179;478;254;707
353170;202009;533;1431;399;1241;84;290;171;520;255;810
353180;202009;9836;24034;7653;20487;680;2023;5692;14792;6372;16815
353190;202009;3274;8825;2594;7459;320;986;1553;4203;1873;5189
353200;202009;1921;5071;985;3114;158;551;245;693;403;1244
353205;202009;370;1116;316;1000;55;190;155;467;210;657
353210;202009;932;2148;583;1573;29;91;385;1015;414;1106
353215;202009;394;1093;305;927;45;151;146;403;191;554
353220;202009;745;2028;464;1429;94;284;68;194;162;478
353230;202009;833;2290;642;1983;180;611;247;701;427;1312
353240;202009;2348;6353;1898;5598;267;910;1117;3154;1384;4064
353250;202009;1292;2887;786;2043;106;319;445;1080;551;1399
353260;202009;1195;2729;649;1838;92;293;306;821;398;1114
353270;202009;684;1760;571;1557;48;149;394;1013;442;1162
353280;202009;703;1903;488;1502;126;390;126;373;252;763
353282;202009;1802;5031;1506;4482;159;541;945;2644;1104;3185
353284;202009;364;834;186;498;21;78;83;186;104;264
353286;202009;170;431;103;321;13;40;34;100;47;140
353290;202009;1479;3923;912;2762;151;457;301;829;452;1286
353300;202009;1950;5194;1405;4120;229;761;634;1668;863;2429
353310;202009;392;952;280;745;20;71;190;473;210;544
353320;202009;668;1627;552;1461;9;39;481;1257;490;1296
353325;202009;678;1958;464;1490;100;312;167;511;267;823
353330;202009;538;1374;364;1044;44;131;201;540;245;671
353340;202009;2844;7667;1959;5931;404;1360;870;2455;1274;3815
353350;202009;3602;9174;2455;6907;539;1642;718;1769;1257;3411
353360;202009;640;1792;493;1509;57;179;288;859;345;1038
353370;202009;569;1638;472;1485;36;117;331;1006;367;1123
353380;202009;279;843;229;742;23;83;125;370;148;453
353390;202009;6276;15472;4685;12797;499;1548;2749;7077;3248;8625
353400;202009;439;1194;327;979;57;202;124;307;181;509
353410;202009;531;1427;398;1188;71;216;224;673;295;889
353420;202009;423;1105;244;711;60;164;19;42;79;206
353430;202009;2248;6195;1698;5175;369;1226;736;2111;1105;3337
353440;202009;65216;175587;46705;139605;7583;24698;24808;70089;32391;94787
353450;202009;374;945;251;731;35;121;119;314;154;435
353460;202009;3242;8769;2282;6903;164;569;1040;3040;1204;3609
353470;202009;7737;20238;5485;16067;896;3028;2397;6382;3293;9410
353475;202009;1531;3966;1055;2982;159;493;521;1359;680;1852
353480;202009;1610;4307;1272;3709;59;216;893;2514;952;2730
353490;202009;1112;2918;735;2187;111;365;328;913;439;1278
353500;202009;1056;2476;779;2056;163;436;431;1132;594;1568
353510;202009;771;2320;554;1787;138;494;142;381;280;875
353520;202009;1069;2800;669;2064;82;281;308;883;390;1164
353530;202009;2421;6394;1877;5406;257;836;994;2663;1251;3499
353540;202009;2053;5473;1660;4850;265;818;983;2805;1248;3623
353550;202009;5829;14882;4645;12982;764;2236;2632;7104;3396;9340
353560;202009;2250;6067;1656;5137;457;1546;467;1300;924;2846
353570;202009;592;1534;438;1286;48;150;258;712;306;862
353580;202009;2114;5545;1571;4491;337;972;745;2077;1082;3049
353590;202009;706;1847;459;1370;92;291;189;559;281;850
353600;202009;1722;4215;1280;3442;157;428;709;1853;866;2281
353610;202009;565;1680;404;1358;87;356;118;352;205;708
353620;202009;2654;7092;1859;5710;373;1271;597;1679;970;2950
353625;202009;506;1254;335;948;22;75;209;575;231;650
353630;202009;1287;3970;1068;3476;234;852;376;1118;610;1970
353640;202009;1398;3569;1104;3116;155;446;614;1724;769;2170
353650;202009;7884;20956;5835;17052;611;1997;3529;9702;4140;11699
353657;202009;397;1019;282;822;30;92;134;362;164;454
353660;202009;1281;2725;870;2171;398;1000;189;456;587;1456
353670;202009;4083;11304;3128;9409;616;2100;1525;4251;2141;6351
353680;202009;695;1802;509;1529;85;283;280;788;365;1071
353690;202009;436;1123;190;586;22;67;38;103;60;170
353700;202009;2050;5332;1674;4699;120;385;1232;3317;1352;3702
353710;202009;5334;11877;3137;7978;324;860;1804;4112;2128;4972
353715;202009;431;1137;256;801;10;41;83;244;93;285
353720;202009;2013;5294;1550;4603;218;711;886;2580;1104;3291
353730;202009;4455;11647;3306;9567;495;1663;1674;4414;2169;6077
353740;202009;2024;5337;1399;4229;344;1131;462;1247;806;2378
353750;202009;846;2524;590;2015;145;546;109;367;254;913
353760;202009;12471;29075;9401;24867;1818;4940;5137;13313;6955;18253
353770;202009;733;2192;417;1399;72;267;59;172;131;439
353780;202009;5198;14504;4077;12322;830;2802;1962;5471;2792;8273
353790;202009;2560;7757;1843;6228;530;1996;384;1118;914;3114
353800;202009;18151;47305;13990;40506;2004;6178;7818;22542;9822;28720
353810;202009;1156;3086;734;2196;113;379;305;862;418;1241
353820;202009;1739;4679;1203;3584;250;810;390;1086;640;1896
353830;202009;621;1572;459;1301;81;238;202;545;283;783
353850;202009;1629;4515;1239;3752;268;799;443;1316;711;2115
353860;202009;2618;7200;1984;6088;473;1649;868;2413;1341;4062
353870;202009;29506;77347;20666;59923;2695;8812;10824;28543;13519;37355
353880;202009;3150;8641;2475;7341;202;698;1537;4378;1739;5076
353890;202009;2645;5714;1764;4485;132;368;1234;2966;1366;3334
353900;202009;752;2100;534;1662;83;285;210;602;293;887
353910;202009;2328;6419;1916;5758;195;695;1308;3848;1503;4543
353920;202009;1826;5057;1280;3984;301;1062;325;834;626;1896
353930;202009;4289;11386;2897;8800;505;1762;1186;3158;1691;4920
353940;202009;1076;3042;721;2331;125;415;248;745;373;1160
353950;202009;3214;8704;2449;7292;442;1437;1353;3749;1795;5186
353960;202009;707;1850;472;1395;92;294;197;552;289;846
353970;202009;664;1597;488;1328;45;138;328;868;373;1006
353980;202009;16519;41623;12765;34941;858;2729;9157;23944;10015;26673
353990;202009;890;2171;521;1495;85;262;238;652;323;914
354000;202009;2486;5991;1367;3851;308;917;236;637;544;1554
354010;202009;356;927;252;757;46;150;137;396;183;546
354020;202009;3495;9587;2715;7954;677;2139;1105;2946;1782;5085
354025;202009;724;2011;469;1489;67;239;126;378;193;617
354030;202009;493;1085;259;692;55;162;128;314;183;476
354040;202009;808;1869;509;1374;22;72;382;999;404;1071
354050;202009;946;2634;638;2072;140;473;204;666;344;1139
354060;202009;3329;9430;2272;7192;514;1751;827;2398;1341;4149
354070;202009;3654;9664;2453;7295;427;1461;1030;2621;1457;4082
354075;202009;2626;7604;2019;6463;264;959;1145;3569;1409;4528
354080;202009;1367;3716;885;2763;191;629;223;624;414;1253
354085;202009;430;890;332;758;0;0;251;527;251;527
354090;202009;1653;4616;1409;4097;78;234;1093;3114;1171;3348
354100;202009;19392;52703;13159;41719;2905;9949;4988;15661;7893;25610
354105;202009;1485;3743;1000;2848;129;377;463;1238;592;1615
354110;202009;476;1323;323;1036;49;164;111;352;160;516
354120;202009;1388;3734;918;2726;185;604;310;799;495;1403
354130;202009;5451;14320;3564;10684;896;2862;211;411;1107;3273
354140;202009;19413;47558;12947;35590;2227;6770;5550;14055;7777;20825
354150;202009;3018;7148;2235;5897;494;1336;880;2267;1374;3603
354160;202009;2904;8410;2109;6784;601;2081;581;1691;1182;3772
354165;202009;654;1939;495;1624;82;310;253;784;335;1094
354170;202009;1811;4991;1500;4396;90;307;963;2698;1053;3005
354180;202009;389;1078;277;837;51;162;109;296;160;458
354190;202009;1495;4160;1035;3206;69;235;478;1409;547;1644
354200;202009;877;2145;679;1843;72;216;436;1116;508;1332
354210;202009;796;2088;631;1804;40;142;464;1252;504;1394
354220;202009;3148;8404;2313;6735;377;1172;1191;3293;1568;4465
354230;202009;763;1888;603;1690;44;157;441;1186;485;1343
354240;202009;1654;4599;1105;3478;189;649;331;926;520;1575
354250;202009;552;1323;340;992;96;285;82;253;178;538
354260;202009;8147;21614;6116;18026;1256;3956;2536;7181;3792;11137
354270;202009;1040;3100;830;2689;181;566;324;1022;505;1588
354280;202009;790;1979;669;1802;60;196;424;1051;484;1247
354290;202009;927;2937;774;2609;131;434;390;1339;521;1773
354300;202009;3591;10509;3034;9467;837;2598;1173;3652;2010;6250
354310;202009;724;2132;585;1842;136;450;222;652;358;1102
354320;202009;994;2421;635;1794;105;332;238;593;343;925
354323;202009;461;1120;306;836;37;79;132;353;169;432
354325;202009;1423;4247;983;3222;158;508;357;1125;515;1633
354330;202009;9609;24336;6339;17607;759;2437;3728;9605;4487;12042
354340;202009;32390;81237;21636;62326;3400;11009;11144;30555;14544;41564
354350;202009;1196;3069;945;2634;91;273;637;1706;728;1979
354360;202009;604;1559;349;1127;68;220;71;228;139;448
354370;202009;994;2862;786;2515;129;448;448;1411;577;1859
354380;202009;713;1882;508;1542;92;364;127;299;219;663
354390;202009;13897;33583;8910;24757;1666;4945;3703;9736;5369;14681
354400;202009;1555;4968;1169;4052;198;753;429;1455;627;2208
354410;202009;5867;15823;4398;12845;904;2843;1985;5480;2889;8323
354420;202009;1484;3869;1076;3126;141;438;655;1808;796;2246
354425;202009;2721;6582;1910;5176;441;1201;826;2228;1267;3429
354430;202009;1501;4014;1145;3436;127;442;671;1881;798;2323
354440;202009;550;1471;357;1072;57;191;156;428;213;619
354450;202009;419;1097;228;729;34;111;71;201;105;312
354460;202009;875;2194;569;1647;73;227;314;878;387;1105
354470;202009;474;1206;311;882;21;66;152;379;173;445
354480;202009;1209;2743;778;2050;68;182;527;1332;595;1514
354490;202009;824;2435;590;1910;94;325;275;826;369;1151
354500;202009;2100;5875;1714;5274;523;1693;408;1287;931;2980
354510;202009;731;2030;574;1718;54;175;312;844;366;1019
354515;202009;334;964;245;780;40;146;103;313;143;459
354520;202009;7037;19258;4880;14574;710;2448;2689;7418;3399;9866
354530;202009;4267;12154;3239;10085;774;2446;1242;3898;2016;6344
354540;202009;1326;3497;949;2818;219;686;360;1068;579;1754
354550;202009;573;1487;446;1245;63;199;255;670;318;869
354560;202009;2202;5303;1171;3308;142;410;576;1519;718;1929
354570;202009;1230;3072;488;1391;80;239;59;163;139;402
354580;202009;8768;22959;5590;16892;852;2806;2769;8028;3621;10834
354600;202009;1900;5044;1446;4189;154;528;944;2576;1098;3104
354610;202009;438;1126;243;724;24;70;115;327;139;397
354620;202009;451;1258;277;911;53;199;102;303;155;502
354625;202009;312;838;169;542;31;102;24;49;55;151
354630;202009;2024;6028;1609;5162;575;1935;279;819;854;2754
354640;202009;3257;9324;2366;7510;407;1408;877;2576;1284;3984
354650;202009;881;2289;698;1986;56;157;431;1208;487;1365
354660;202009;3707;8627;1900;5571;175;628;906;2417;1081;3045
354670;202009;1069;2985;723;2273;154;514;262;748;416;1262
354680;202009;5291;13825;3953;11608;913;2809;1945;5811;2858;8620
354690;202009;506;1613;361;1283;77;285;98;338;175;623
354700;202009;882;2364;629;1870;82;257;313;881;395;1138
354710;202009;474;1270;338;1001;42;133;137;343;179;476
354720;202009;284;690;125;373;42;134;28;83;70;217
354730;202009;9861;27681;7330;22767;1042;3549;4106;12258;5148;15807
354740;202009;320;870;129;430;17;66;22;65;39;131
354750;202009;2586;6632;1648;4845;264;847;742;1955;1006;2802
354760;202009;2089;5593;1435;4326;345;1148;459;1221;804;2369
354765;202009;382;1023;147;478;25;84;31;85;56;169
354770;202009;2354;5829;1712;4727;331;1006;797;2053;1128;3059
354780;202009;54642;138495;40909;111217;4437;13659;25621;65237;30058;78896
354790;202009;960;2644;740;2276;77;265;450;1320;527;1585
354800;202009;2594;6653;2016;5763;502;1466;872;2336;1374;3802
354805;202009;1332;3057;894;2412;98;266;530;1328;628;1594
354810;202009;655;1920;368;1298;45;186;83;272;128;458
354820;202009;964;2741;682;2189;113;408;201;517;314;925
354830;202009;459;1129;290;818;54;164;99;260;153;424
354840;202009;935;2300;555;1541;52;154;317;822;369;976
354850;202009;21430;55597;14650;43225;1669;5695;8700;24257;10369;29952
354860;202009;1763;4959;1055;3427;177;633;307;898;484;1531
354870;202009;57840;146043;44211;120556;4813;14477;27535;70911;32348;85388
354880;202009;5924;14612;2821;7951;326;1060;1110;2540;1436;3600
354890;202009;16421;40903;12593;34412;1716;5302;7460;19668;9176;24970
354900;202009;405;1009;250;732;41;132;71;181;112;313
354910;202009;5536;14480;3290;10371;754;2513;558;1673;1312;4186
354920;202009;507;1372;244;834;28;102;55;180;83;282
354925;202009;295;838;173;552;23;81;42;113;65;194
354930;202009;403;947;236;664;17;55;119;307;136;362
354940;202009;2320;6948;1621;5371;556;1969;292;888;848;2857
354950;202009;1491;3833;1182;3399;61;249;875;2366;936;2615
354960;202009;917;2445;688;2092;54;195;399;1142;453;1337
354970;202009;4239;11755;3275;10083;359;1251;2107;6273;2466;7524
354980;202009;33393;78834;22163;59420;2384;7637;13515;33602;15899;41239
354990;202009;66829;168395;49622;136760;4112;13197;32430;84049;36542;97246
354995;202009;2846;6429;2132;5476;150;465;1580;3871;1730;4336
355000;202009;1591;3964;1191;3385;185;614;573;1495;758;2109
355010;202009;3808;10357;2251;7015;747;2410;244;785;991;3195
355020;202009;3679;10316;2693;8545;607;2110;1010;3006;1617;5116
355030;202009;1390401;3406026;988070;2619340;150360;437578;494153;1205400;644513;1642978
355040;202009;2928;7294;2267;6413;319;888;1573;4480;1892;5368
355050;202009;981;2304;701;1887;176;527;264;649;440;1176
355060;202009;6105;16526;4389;13258;726;2553;2125;5814;2851;8367
355070;202009;9062;23324;7226;20341;854;2765;4603;12177;5457;14942
355080;202009;922;2618;562;1924;109;406;78;214;187;620
355090;202009;1128;3237;844;2731;219;708;262;861;481;1569
355100;202009;22513;58833;17188;50796;2806;8774;10162;29731;12968;38505
355110;202009;840;2363;603;1978;183;679;105;308;288;987
355120;202009;699;1820;492;1514;38;134;214;619;252;753
355130;202009;881;1954;418;1100;27;85;249;612;276;697
355140;202009;1932;4369;1609;3918;99;279;1321;3115;1420;3394
355150;202009;4283;11314;3370;9681;396;1268;2123;5836;2519;7104
355160;202009;2027;5535;1446;4469;363;1225;347;1016;710;2241
355170;202009;10389;26296;8028;22288;1514;4584;4281;11448;5795;16032
355180;202009;2813;7565;1972;6125;412;1411;716;2034;1128;3445
355190;202009;1856;4861;1442;4207;349;1006;754;2340;1103;3346
355200;202009;823;2535;687;2310;184;682;281;897;465;1579
355210;202009;2916;7966;2256;6594;426;1417;1147;3124;1573;4541
355220;202009;44505;118349;34630;99128;8124;24753;14134;37415;22258;62168
355230;202009;1159;2900;626;1838;111;307;223;612;334;919
355240;202009;24197;63815;16695;48672;2273;7216;8997;24702;11270;31918
355250;202009;37789;101040;27487;80773;6890;21337;10259;28672;17149;50009
355255;202009;694;1742;360;1109;60;211;138;407;198;618
355260;202009;1454;3581;1039;2874;136;459;597;1512;733;1971
355270;202009;1190;3524;906;2925;209;689;309;923;518;1612
355280;202009;31056;79399;21723;61490;3046;9345;10719;28424;13765;37769
355290;202009;875;2407;655;1994;135;396;268;792;403;1188
355300;202009;1290;3772;987;3131;179;639;342;1014;521;1653
355310;202009;971;2687;727;2277;101;309;398;1262;499;1571
355320;202009;536;1413;395;1153;77;258;158;374;235;632
355330;202009;2881;7265;2175;6058;142;516;1641;4332;1783;4848
355340;202009;4100;9056;3137;7767;404;905;1931;4890;2335;5795
355350;202009;1316;3784;962;3089;203;674;347;1098;550;1772
355360;202009;1182;3023;903;2607;118;371;542;1542;660;1913
355365;202009;362;958;187;640;40;125;31;110;71;235
355370;202009;5393;13757;4117;11737;990;2627;1799;5639;2789;8266
355380;202009;2872;7687;2136;6291;385;1225;771;1973;1156;3198
355385;202009;1460;3837;1189;3430;114;406;748;1969;862;2375
355390;202009;835;2282;594;1744;141;447;227;603;368;1050
355395;202009;2010;5495;1373;4180;231;745;497;1343;728;2088
355400;202009;9087;26121;7119;22159;1751;6216;2514;6986;4265;13202
355410;202009;22506;61539;13797;43669;2911;10178;3558;10980;6469;21158
355420;202009;632;2026;512;1786;148;556;124;428;272;984
355430;202009;3803;9662;2819;7856;653;1786;1279;3529;1932;5315
355440;202009;792;2161;472;1478;85;280;138;401;223;681
355450;202009;3103;8033;1965;5753;355;1116;806;2131;1161;3247
355460;202009;494;1204;308;898;45;170;139;358;184;528
355465;202009;416;1099;322;942;51;165;164;458;215;623
355470;202009;1083;2789;606;1831;163;553;194;518;357;1071
355475;202009;355;843;283;738;16;35;207;527;223;562
355480;202009;3810;10551;3093;9479;421;1497;2035;6053;2456;7550
355490;202009;961;2591;519;1619;40;143;277;792;317;935
355495;202009;807;2282;579;1862;72;270;208;603;280;873
355500;202009;6637;17209;3838;11597;597;1991;1282;3575;1879;5566
355510;202009;1328;3237;820;2367;114;392;358;915;472;1307
355520;202009;371;824;167;491;30;84;49;137;79;221
355530;202009;406;941;143;424;20;70;49;127;69;197
355535;202009;504;1388;377;1175;76;297;170;472;246;769
355540;202009;10719;26837;8701;23930;1332;3990;5605;14903;6937;18893
355550;202009;616;1822;499;1604;68;247;267;802;335;1049
355560;202009;1122;2884;602;1875;133;471;36;112;169;583
355570;202009;248;709;134;440;25;84;31;100;56;184
355580;202009;1205;2947;775;2211;142;446;312;833;454;1279
355590;202009;172;432;132;365;20;61;79;207;99;268
355600;202009;1502;3640;996;2787;177;535;397;1088;574;1623
355610;202009;1759;4326;1147;3258;133;417;614;1661;747;2078
355620;202009;4761;12637;3514;10194;403;1422;1962;5231;2365;6653
355630;202009;2317;6378;1601;5000;262;861;785;2406;1047;3267
355635;202009;882;2582;642;2107;117;426;187;546;304;972
355640;202009;2981;8342;1960;6259;382;1317;584;1800;966;3117
355645;202009;4251;11957;3078;9876;453;1576;1647;5162;2100;6738
355650;202009;6587;17753;5112;15006;1399;4268;1690;4473;3089;8741
355660;202009;1321;3424;905;2650;140;453;310;898;450;1351
355670;202009;3609;9683;2325;6799;299;1024;1147;2929;1446;3953
355680;202009;2771;7597;1186;3873;314;1078;125;428;439;1506
355690;202009;796;2361;500;1744;116;441;19;43;135;484
355695;202009;243;682;141;455;12;59;26;58;38;117
355700;202009;7276;20829;5847;17619;1012;3228;3101;8844;4113;12072
355710;202009;8869;20937;5680;15072;862;2538;2640;6248;3502;8786
355715;202009;483;1284;250;759;51;170;51;134;102;304
355720;202009;1494;4183;1164;3585;193;633;624;1788;817;2421
355730;202009;916;2541;743;2208;134;438;339;914;473;1352
410010;202009;1240;3458;929;2788;194;634;192;562;386;1196
410020;202009;1024;3118;788;2570;279;857;176;603;455;1460
410030;202009;1526;4204;1290;3830;176;574;708;2094;884;2668
410040;202009;12401;34266;8968;27759;1964;6480;2834;8153;4798;14633
410045;202009;883;2339;616;1839;86;291;224;626;310;917
410050;202009;2381;5949;1591;4547;305;955;516;1382;821;2337
410060;202009;2082;5874;1595;4884;364;1190;500;1476;864;2666
410070;202009;1941;4918;1415;3943;236;731;557;1417;793;2148
410080;202009;1369;3670;964;2911;230;729;290;878;520;1607
410090;202009;1094;2801;928;2535;95;252;552;1578;647;1830
410100;202009;1842;5329;1201;3760;174;622;157;472;331;1094
410105;202009;493;1237;279;822;33;100;92;254;125;354
410110;202009;3222;8106;2221;6178;278;839;1021;2657;1299;3496
410115;202009;594;1526;427;1234;59;189;165;448;224;637
410120;202009;2577;7312;2234;6756;494;1653;1135;3297;1629;4950
410130;202009;1229;3327;1063;3012;187;623;552;1442;739;2065
410140;202009;16281;39297;10320;28531;1891;5751;2712;6762;4603;12513
410150;202009;16825;39579;8319;22832;1404;4279;1996;4947;3400;9226
410160;202009;2843;7891;2260;6857;514;1697;775;2362;1289;4059
410165;202009;742;1968;605;1689;55;187;360;934;415;1121
410170;202009;2771;7188;1800;5095;414;1287;122;353;536;1640
410180;202009;14593;40577;11066;33301;1510;4960;5822;16359;7332;21319
410185;202009;450;1301;314;960;57;185;92;255;149;440
410190;202009;2214;5493;1575;4352;328;927;418;1106;746;2033
410200;202009;5409;12476;2958;8201;464;1485;443;1173;907;2658
410210;202009;3083;7756;1892;5558;300;1000;646;1611;946;2611
410220;202009;523;1348;332;985;59;190;79;228;138;418
410230;202009;1695;4520;1287;3683;179;589;663;1741;842;2330
410240;202009;5023;13282;3428;10170;808;2652;332;883;1140;3535
410250;202009;2673;6341;1959;5174;155;511;952;2434;1107;2945
410260;202009;1860;4655;1139;3279;190;566;495;1398;685;1964
410270;202009;462;1227;328;991;50;169;118;343;168;512
410275;202009;666;1873;456;1433;63;210;195;573;258;783
410280;202009;2295;6145;1493;4517;229;759;587;1637;816;2396
410290;202009;3296;9240;2231;6940;601;1855;577;1781;1178;3636
410300;202009;647;1646;508;1416;43;133;260;685;303;818
410302;202009;380;944;199;600;25;85;96;281;121;366
410304;202009;1255;3237;1044;2847;113;306;627;1663;740;1969
410305;202009;1780;4224;1204;3384;130;412;751;2027;881;2439
410310;202009;2545;7183;2004;6122;335;1110;944;2868;1279;3978
410315;202009;683;1629;362;1106;129;390;82;259;211;649
410320;202009;1063;2942;715;2220;116;407;125;367;241;774
410322;202009;586;1526;322;938;33;108;169;453;202;561
410330;202009;1520;3718;1034;2794;174;505;293;783;467;1288
410335;202009;844;2285;647;1907;96;306;288;788;384;1094
410337;202009;860;2082;599;1572;68;181;251;623;319;804
410340;202009;508;1422;339;1005;29;95;167;421;196;516
410345;202009;2456;6360;1241;3673;256;791;332;862;588;1653
410347;202009;753;1927;547;1543;49;161;179;513;228;674
410350;202009;1465;3694;1038;2955;145;427;430;1167;575;1594
410360;202009;4353;10609;3325;8823;396;1155;1778;4520;2174;5675
410370;202009;13467;36231;8660;24750;1026;3213;3664;9247;4690;12460
410380;202009;1592;4022;1171;3255;165;465;398;1020;563;1485
410390;202009;2636;6722;1719;5030;387;1260;525;1401;912;2661
410395;202009;913;2605;739;2237;146;469;294;893;440;1362
410400;202009;6538;17162;4824;13782;697;2124;2381;6403;3078;8527
410405;202009;837;2021;614;1686;112;350;271;688;383;1038
410410;202009;1263;3383;1178;3246;169;542;735;2101;904;2643
410420;202009;10354;28472;7837;23424;1248;4214;3144;8407;4392;12621
410425;202009;3232;9066;2178;6846;361;1226;788;2228;1149;3454
410430;202009;13182;33012;9093;25457;1415;4343;3228;8409;4643;12752
410440;202009;2289;6827;1946;6179;291;1042;1018;3170;1309;4212
410442;202009;2231;6770;1849;5935;534;1787;577;1764;1111;3551
410445;202009;2286;6631;1657;5385;322;1207;348;1179;670;2386
410450;202009;1450;3624;1068;3000;203;632;385;1006;588;1638
410460;202009;2009;4977;1534;4214;164;457;761;2020;925;2477
410465;202009;2687;7767;2095;6622;389;1296;744;2180;1133;3476
410470;202009;2027;5626;1412;4467;360;1313;221;743;581;2056
410480;202009;37233;88206;19413;56357;3092;10080;4201;10463;7293;20543
410490;202009;11136;30954;7886;24124;1460;4851;3103;8901;4563;13752
410500;202009;1867;4902;1294;3780;275;910;374;972;649;1882
410510;202009;1860;4601;1212;3378;239;654;336;935;575;1589
410520;202009;3029;9534;2674;8800;918;3098;922;3120;1840;6218
410530;202009;1667;4105;787;2247;98;283;197;456;295;739
410540;202009;2780;7496;1908;5711;286;931;869;2495;1155;3426
410550;202009;7421;19899;4820;14091;827;2644;1329;3361;2156;6005
410560;202009;1460;3860;1073;3040;237;737;371;928;608;1665
410570;202009;2481;6836;1815;5631;485;1783;204;667;689;2450
410580;202009;25567;66489;18379;53222;3534;10996;7771;20996;11305;31992
410590;202009;1527;4353;1010;3111;147;482;287;756;434;1238
410600;202009;1825;4821;1386;3974;311;854;460;1371;771;2225
410610;202009;717;1888;529;1526;59;206;232;626;291;832
410620;202009;2397;6901;1584;4967;339;1172;258;736;597;1908
410630;202009;2481;6526;1600;4705;302;1007;326;798;628;1805
410640;202009;4702;10987;3150;8272;692;2113;402;1054;1094;3167
410645;202009;1053;2992;854;2728;265;874;368;1196;633;2070
410650;202009;2269;6150;1551;4676;318;1025;536;1499;854;2524
410655;202009;907;2169;633;1684;27;84;328;828;355;912
410657;202009;658;1763;402;1199;54;190;140;352;194;542
410660;202009;3432;8808;1936;5526;351;1039;507;1354;858;2393
410670;202009;1053;2620;625;1785;124;366;222;570;346;936
410680;202009;2616;7887;1837;5895;446;1485;318;1034;764;2519
410685;202009;535;1353;396;1116;93;310;157;386;250;696
410690;202009;131969;321837;86478;236805;13583;42602;33211;79807;46794;122409
410700;202009;2507;6322;2067;5626;311;862;1041;2765;1352;3627
410710;202009;874;2203;569;1626;97;288;224;588;321;876
410712;202009;638;1837;523;1613;133;450;194;568;327;1018
410715;202009;805;2340;489;1617;68;228;172;544;240;772
410720;202009;3140;7991;2443;6636;327;1051;532;1408;859;2459
410725;202009;1102;2719;617;1798;113;366;91;220;204;586
410730;202009;666;1759;504;1464;116;378;97;276;213;654
410740;202009;925;2591;671;2096;89;309;265;816;354;1125
410750;202009;1755;4446;1380;3739;200;613;628;1620;828;2233
410752;202009;373;948;186;561;27;80;84;240;111;320
410753;202009;304;924;206;698;35;137;39;118;74;255
410754;202009;1098;2814;906;2519;57;124;618;1825;675;1949
410755;202009;589;1522;404;1148;58;179;172;426;230;605
410760;202009;3608;9263;2569;7357;658;2154;575;1502;1233;3656
410765;202009;13522;37677;10402;31440;1765;5805;2249;6008;4014;11813
410770;202009;1063;2526;740;1982;67;192;372;998;439;1190
410773;202009;1257;3376;1092;3122;113;361;676;1869;789;2230
410775;202009;1488;3701;1290;3404;67;205;857;2206;924;2411
410780;202009;629;1555;410;1130;66;196;110;279;176;475
410785;202009;726;1901;556;1610;94;303;194;573;288;876
410790;202009;792;2236;638;1935;168;559;64;139;232;698
410800;202009;3419;7528;2744;6546;52;165;1791;4148;1843;4313
410810;202009;423;1133;331;952;23;73;171;442;194;515
410820;202009;889;2503;454;1405;93;300;89;233;182;533
410830;202009;36330;88249;24776;68713;4904;15663;9138;23506;14042;39169
410832;202009;1024;2660;813;2282;86;270;484;1282;570;1552
410840;202009;8288;21105;4863;14493;918;2955;1213;3372;2131;6327
410845;202009;1159;2885;901;2491;172;502;374;1016;546;1518
410850;202009;2222;6412;1922;5848;305;1016;950;2798;1255;3814
410855;202009;777;1943;505;1422;47;126;238;623;285;749
410860;202009;4342;10671;3380;9094;343;1077;1900;4823;2243;5900
410865;202009;1420;4136;1223;3739;142;485;720;2235;862;2720
410870;202009;1273;3431;1044;3033;84;266;702;2019;786;2285
410880;202009;4590;12281;3211;9714;547;1741;459;1524;1006;3265
410890;202009;968;2763;706;2235;155;544;179;552;334;1096
410895;202009;1003;3200;851;2862;252;941;189;583;441;1524
410900;202009;861;2263;589;1726;105;327;113;262;218;589
410910;202009;393;938;231;628;13;47;133;319;146;366
410920;202009;865;2068;594;1618;75;226;295;778;370;1004
410930;202009;1661;4273;1138;3346;266;925;235;669;501;1594
410940;202009;22576;61717;16105;49813;3303;11336;4936;14946;8239;26282
410950;202009;1911;5605;1690;5260;49;188;1398;4300;1447;4488
410960;202009;7612;18989;5123;14717;1186;3751;1924;5472;3110;9223
410965;202009;1122;2841;764;2154;87;267;427;1187;514;1454
410970;202009;3998;10735;2774;8345;630;2265;367;917;997;3182
410975;202009;1353;3369;1023;2834;114;341;500;1368;614;1709
410980;202009;7411;18557;4719;13631;539;1740;2051;5369;2590;7109
410990;202009;1424;3468;945;2716;226;753;310;854;536;1607
411000;202009;631;1669;419;1253;55;197;126;312;181;509
411005;202009;459;1182;277;795;47;149;81;205;128;354
411007;202009;2282;6362;1852;5611;429;1379;652;1947;1081;3326
411010;202009;4208;12628;3300;10750;835;2962;356;1047;1191;4009
411020;202009;2265;6448;1839;5672;541;1728;500;1510;1041;3238
411030;202009;769;1891;539;1423;35;123;304;705;339;828
411040;202009;990;2468;503;1392;66;207;165;389;231;596
411050;202009;1901;5916;1534;5093;395;1406;227;663;622;2069
411060;202009;1879;4881;1185;3528;264;926;198;524;462;1450
411065;202009;385;998;259;753;36;116;114;304;150;420
411070;202009;7190;18340;5646;15720;775;2406;2764;7414;3539;9820
411080;202009;2096;5531;1635;4707;416;1372;324;908;740;2280
411090;202009;853;2233;552;1646;49;177;156;435;205;612
411095;202009;2757;6346;1405;3817;167;477;342;840;509;1317
411100;202009;1195;3066;825;2397;85;279;272;809;357;1088
411110;202009;632;1635;281;880;36;114;18;38;54;152
411120;202009;1283;3555;1057;3117;320;1098;227;607;547;1705
411125;202009;5234;15218;4621;14048;1009;3014;2204;7042;3213;10056
411130;202009;716;1915;505;1518;101;271;177;576;278;847
411140;202009;2254;6976;1900;6205;554;1953;490;1565;1044;3518
411150;202009;3862;9862;2573;7236;514;1694;252;510;766;2204
411155;202009;958;2440;553;1674;77;220;234;675;311;895
411160;202009;355;813;234;649;32;99;50;139;82;238
411170;202009;730;2166;551;1752;133;422;180;553;313;975
411180;202009;5512;14528;4233;12246;622;2016;2048;5545;2670;7561
411190;202009;1692;4336;1246;3523;211;635;477;1211;688;1846
411200;202009;4941;13377;3410;10450;850;2900;669;1754;1519;4654
411210;202009;3181;7084;2065;5234;355;1007;682;1628;1037;2635
411220;202009;851;2194;592;1690;137;426;166;448;303;874
411230;202009;879;2317;622;1820;122;382;238;677;360;1059
411240;202009;1573;3788;1024;2769;108;337;496;1226;604;1563
411250;202009;2226;5911;1613;4789;315;1073;506;1446;821;2519
411260;202009;342;902;220;649;28;86;85;223;113;309
411270;202009;2058;5474;1514;4374;205;631;765;2021;970;2652
411275;202009;1450;3328;991;2570;143;451;452;1073;595;1524
411280;202009;1326;3581;869;2688;232;735;123;360;355;1095
411290;202009;814;2138;518;1551;50;138;271;838;321;976
411295;202009;1218;3070;855;2345;104;304;375;966;479;1270
411300;202009;1031;2579;642;1818;61;189;297;734;358;923
411310;202009;867;2015;658;1707;50;127;289;737;339;864
411320;202009;5498;14226;3968;11436;673;2079;1671;4301;2344;6380
411325;202009;1381;3962;1172;3600;193;587;659;2092;852;2679
411330;202009;3361;9090;2415;7337;545;1788;746;2282;1291;4070
411340;202009;850;2308;498;1519;74;241;161;464;235;705
411342;202009;1046;2527;605;1666;100;299;236;613;336;912
411345;202009;1064;2752;800;2312;60;191;573;1666;633;1857
411350;202009;2718;7357;1743;5354;448;1489;257;731;705;2220
411360;202009;703;1700;492;1358;68;186;160;428;228;614
411370;202009;56880;139154;40670;111474;2931;9725;24494;62633;27425;72358
411373;202009;1386;3527;1120;3125;96;325;603;1697;699;2022
411375;202009;1102;2782;795;2197;129;374;314;831;443;1205
411380;202009;1140;2634;759;1914;38;113;471;1096;509;1209
411390;202009;1516;4185;1175;3441;190;609;482;1246;672;1855
411400;202009;2269;5640;1693;4549;170;538;860;2202;1030;2740
411410;202009;2523;6976;1831;5463;405;1320;421;1197;826;2517
411420;202009;4225;10378;2272;6595;328;1087;409;911;737;1998
411430;202009;3461;9372;2601;7731;549;1778;910;2476;1459;4254
411435;202009;411;1155;253;808;51;160;77;198;128;358
411440;202009;2513;7015;2020;6077;413;1350;708;2062;1121;3412
411450;202009;2484;6659;1884;5652;248;746;992;3029;1240;3775
411460;202009;4186;10760;2595;7689;419;1474;471;1260;890;2734
411470;202009;761;1958;556;1552;106;317;210;529;316;846
411480;202009;4951;13120;3590;10550;699;2468;1308;3402;2007;5870
411490;202009;1609;4157;1223;3512;155;517;518;1341;673;1858
411500;202009;1311;3527;862;2559;154;501;168;402;322;903
411510;202009;2308;5883;1833;5056;393;1269;437;1200;830;2469
411520;202009;30512;74219;17272;48307;1998;6519;6594;16533;8592;23052
411530;202009;934;2454;557;1713;92;311;91;250;183;561
411535;202009;484;1403;294;943;32;114;84;219;116;333
411540;202009;2718;6652;1823;5013;167;537;917;2428;1084;2965
411545;202009;919;2631;758;2344;73;229;492;1533;565;1762
411550;202009;713;1797;501;1396;72;220;83;247;155;467
411560;202009;1964;5295;1100;3430;158;551;78;221;236;772
411570;202009;7580;17498;5045;13604;1118;3276;918;2470;2036;5746
411573;202009;757;2045;637;1857;99;298;324;926;423;1224
411575;202009;1999;5434;1467;4335;280;914;357;1035;637;1949
411580;202009;4727;10852;2820;7894;411;1403;512;1299;923;2702
411585;202009;636;1893;276;892;63;221;50;138;113;359
411590;202009;397;1092;272;819;39;112;136;384;175;496
411600;202009;303;773;192;597;39;123;56;163;95;286
411605;202009;1584;3669;989;2703;127;445;514;1367;641;1812
411610;202009;2573;6116;1795;4713;72;239;1193;2908;1265;3147
411620;202009;2811;7491;2370;6792;405;1225;1285;3670;1690;4895
411630;202009;770;2024;508;1510;78;283;186;492;264;775
411640;202009;466;1215;322;905;41;127;115;293;156;420
411650;202009;207;607;133;438;24;87;31;78;55;165
411660;202009;930;2357;672;1888;53;152;288;783;341;935
411670;202009;1374;3355;923;2463;101;288;432;1073;533;1361
411680;202009;1450;3863;1060;3089;135;448;471;1315;606;1763
411690;202009;3805;9691;2845;8007;607;1745;817;2436;1424;4181
411695;202009;659;2022;416;1354;49;174;174;530;223;704
411700;202009;1692;4357;1093;3207;232;738;167;464;399;1202
411705;202009;1918;5904;1611;5366;300;956;929;3307;1229;4263
411710;202009;1970;5008;1342;3833;304;884;255;716;559;1600
411720;202009;1063;2462;750;1912;155;406;281;682;436;1088
411721;202009;986;2496;729;2007;144;387;192;533;336;920
411722;202009;847;2241;477;1374;74;245;185;441;259;686
411725;202009;1180;3274;797;2517;186;630;171;536;357;1166
411727;202009;1499;4149;963;2981;224;723;175;502;399;1225
411729;202009;704;1702;436;1189;53;195;161;377;214;572
411730;202009;5246;13921;4027;11508;826;2527;1715;4816;2541;7343
411740;202009;538;1386;269;808;54;146;58;156;112;302
411745;202009;776;2195;510;1584;70;233;87;204;157;437
411750;202009;5413;14235;3920;11296;533;1664;1915;5178;2448;6842
411760;202009;6692;17903;5095;15090;1676;5167;990;3260;2666;8427
411770;202009;3027;8752;2188;6885;519;1741;329;961;848;2702
411780;202009;2781;7807;2362;7011;650;2013;791;2373;1441;4386
411790;202009;2823;6832;1503;4432;316;1069;251;636;567;1705
411800;202009;1022;2881;744;2253;130;409;149;426;279;835
411810;202009;1606;4142;1182;3283;203;578;552;1447;755;2025
411820;202009;11120;31941;8932;28025;2204;7413;3751;11467;5955;18880
411830;202009;582;1437;438;1196;83;247;96;280;179;527
411840;202009;12072;32108;8027;23633;1378;4386;2121;5726;3499;10112
411845;202009;554;1597;300;968;38;144;66;182;104;326
411850;202009;7275;18593;4875;14338;1216;4054;787;2106;2003;6160
411860;202009;688;1927;491;1507;77;246;122;336;199;582
411870;202009;591;1723;405;1297;91;326;99;282;190;608
411880;202009;2261;5665;1637;4641;223;723;575;1567;798;2290
411885;202009;1063;2714;748;2147;111;375;233;608;344;983
411890;202009;1371;3647;958;2870;158;534;107;304;265;838
411900;202009;818;2246;496;1546;112;389;83;224;195;613
411910;202009;963;2835;690;2245;175;643;251;747;426;1390
411915;202009;15464;37860;10202;28257;1488;4650;4062;10037;5550;14687
411920;202009;1096;3222;911;2818;196;704;329;939;525;1643
411925;202009;467;1228;329;976;71;241;129;357;200;598
411930;202009;4947;15182;4136;13626;1784;6386;265;1043;2049;7429
411940;202009;3279;9734;2497;7981;615;2036;782;2251;1397;4287
411950;202009;14079;37890;11486;33565;1599;5312;6698;18705;8297;24017
411960;202009;5858;15747;4603;13171;842;2664;1748;4725;2590;7389
411965;202009;469;1293;331;1011;48;160;145;410;193;570
411970;202009;1098;2546;842;2202;167;417;362;1079;529;1496
411980;202009;1459;3632;1042;2935;254;721;377;1025;631;1746
411990;202009;38548;100952;24155;74140;4496;15245;8220;24121;12716;39366
411995;202009;3405;8356;2560;7042;751;2311;694;1812;1445;4123
412000;202009;1917;4407;1338;3418;31;99;948;2267;979;2366
412010;202009;590;1837;431;1485;71;263;124;363;195;626
412015;202009;547;1534;443;1348;58;190;264;796;322;986
412020;202009;442;1217;269;835;41;149;108;306;149;455
412030;202009;612;1713;441;1389;75;243;128;386;203;629
412033;202009;925;2438;652;1870;85;251;239;592;324;843
412035;202009;756;2050;478;1531;51;201;259;782;310;983
412040;202009;588;1574;364;1124;56;160;64;194;120;354
412050;202009;1646;4097;1106;3087;220;695;272;756;492;1451
412060;202009;7351;21411;6090;18871;1600;5608;1714;5079;3314;10687
412065;202009;618;1696;450;1353;102;330;109;327;211;657
412070;202009;1157;2984;902;2477;111;329;372;949;483;1278
412080;202009;2160;6079;1424;4532;212;703;319;911;531;1614
412085;202009;309;747;106;326;11;35;19;46;30;81
412090;202009;5756;15054;4244;12187;1106;3313;1493;4360;2599;7673
412100;202009;1598;4367;1200;3623;361;1190;253;836;614;2026
412110;202009;823;2150;565;1630;81;239;184;496;265;735
412120;202009;1983;5746;1518;4815;296;1038;424;1146;720;2184
412125;202009;646;1826;451;1421;89;287;125;374;214;661
412130;202009;807;2049;549;1553;88;266;142;408;230;674
412135;202009;624;1661;284;861;42;130;97;261;139;391
412140;202009;1698;4125;1118;3103;205;700;230;592;435;1292
412150;202009;2768;7274;2334;6501;336;1078;1423;3716;1759;4794
412160;202009;934;2894;517;1762;91;333;85;257;176;590
412170;202009;4341;11905;3609;10714;741;2409;1467;4032;2208;6441
412175;202009;1299;3705;1073;3308;224;709;472;1472;696;2181
412180;202009;1639;4514;1176;3641;143;510;539;1537;682;2047
412190;202009;3357;8385;2461;6800;329;988;1068;2930;1397;3918
412200;202009;1707;5092;1216;3936;321;1146;198;582;519;1728
412210;202009;617;1483;362;1019;49;152;134;339;183;491
412215;202009;3298;8957;2580;7546;646;1846;1094;3523;1740;5369
412217;202009;971;2527;818;2254;55;163;545;1455;600;1618
412220;202009;5546;15525;4461;13481;1265;3729;1420;4611;2685;8340
412230;202009;2657;7829;2100;6723;351;1266;560;1554;911;2820
412240;202009;7269;18602;4534;13209;781;2459;1366;3604;2147;6063
412250;202009;2021;5210;1499;4214;355;1044;333;868;688;1912
412260;202009;1220;3285;873;2528;148;459;268;724;416;1183
412265;202009;890;2427;697;2090;149;465;281;801;430;1266
412270;202009;993;2708;628;1932;80;277;240;655;320;932
412280;202009;401;1128;311;977;62;207;95;275;157;482
412290;202009;1030;2624;698;2021;108;341;221;587;329;928
412300;202009;1668;4322;1145;3379;251;771;251;770;502;1541
412310;202009;760;2102;604;1788;96;336;220;596;316;932
412320;202009;850;2200;548;1566;57;193;179;514;236;707
412330;202009;1553;4188;1031;3161;195;665;343;1081;538;1746
412340;202009;1133;3175;691;2186;101;374;117;332;218;706
412350;202009;2820;7305;1772;5219;357;1110;311;836;668;1946
412360;202009;272;746;183;545;5;26;110;303;115;329
412370;202009;883;2508;592;1877;115;414;54;181;169;595
412380;202009;1522;4146;1066;3204;291;913;131;454;422;1367
412382;202009;514;1273;337;981;43;159;142;344;185;503
412385;202009;2189;5986;1777;5182;561;1547;551;1806;1112;3353
412390;202009;2454;5918;1962;5153;312;823;743;1974;1055;2797
412395;202009;680;1943;470;1457;58;159;199;632;257;791
412400;202009;924;2471;651;1938;127;418;179;529;306;947
412402;202009;2001;4949;1339;3819;324;961;179;516;503;1477
412405;202009;3026;7986;1961;5961;503;1812;69;189;572;2001
412410;202009;6012;15510;4400;12838;776;2628;1457;3997;2233;6625
412420;202009;532;1354;344;979;25;88;170;423;195;511
412430;202009;598;1498;309;894;35;117;120;324;155;441
412440;202009;2713;7399;1784;5567;437;1484;278;896;715;2380
412450;202009;441;1278;293;897;48;142;24;57;72;199
412460;202009;1008;2656;787;2274;144;453;366;1038;510;1491
412470;202009;1461;4725;1188;4088;302;1098;257;882;559;1980
412480;202009;1057;2797;686;1971;122;377;207;519;329;896
412490;202009;1304;3266;1039;2782;124;338;520;1309;644;1647
412500;202009;1908;4810;1418;3888;308;844;406;1060;714;1904
412510;202009;1930;5917;1314;4316;300;1056;134;356;434;1412
412520;202009;1223;3208;654;1949;155;450;53;160;208;610
412530;202009;718;1889;522;1483;80;251;112;320;192;571
412535;202009;793;2057;529;1542;87;277;116;283;203;560
412540;202009;1202;3054;858;2411;94;336;278;818;372;1154
412545;202009;678;1743;469;1304;72;204;171;463;243;667
412550;202009;32950;87898;22933;67517;3819;12268;9124;24482;12943;36750
412555;202009;296;781;195;556;21;60;57;126;78;186
412560;202009;4619;13525;3372;10562;583;1996;988;3090;1571;5086
412570;202009;4499;11344;2544;7522;528;1767;318;1026;846;2793
412575;202009;1015;2567;806;2200;100;300;433;1104;533;1404
412580;202009;1437;3773;1010;2942;86;303;534;1488;620;1791
412590;202009;420;1101;228;713;32;106;22;57;54;163
412600;202009;1593;4304;1191;3476;186;621;522;1414;708;2035
412610;202009;809;2114;567;1584;60;168;296;740;356;908
412620;202009;1264;3293;952;2808;189;633;272;752;461;1385
412625;202009;8843;23404;5307;16227;735;2548;345;938;1080;3486
412627;202009;1148;3209;721;2314;131;455;196;630;327;1085
412630;202009;2843;8302;2001;6444;387;1265;607;1784;994;3049
412635;202009;392;1079;266;793;38;131;94;231;132;362
412640;202009;1028;2718;567;1731;68;208;175;485;243;693
412650;202009;1674;4580;1334;3870;217;703;519;1312;736;2015
412660;202009;2407;6159;1669;4735;275;843;498;1253;773;2096
412665;202009;388;986;302;826;47;136;146;383;193;519
412667;202009;1713;4524;1271;3665;176;537;524;1450;700;1987
412670;202009;842;1997;562;1539;97;297;172;437;269;734
412680;202009;1932;5148;1317;3946;171;589;475;1262;646;1851
412690;202009;1097;2918;801;2330;130;408;309;846;439;1254
412700;202009;1960;5202;1609;4644;192;650;884;2465;1076;3115
412710;202009;5988;17424;4454;14057;873;3121;1279;3547;2152;6668
412720;202009;1168;3443;891;2822;145;486;176;472;321;958
412730;202009;2416;6399;1617;4769;310;1015;562;1552;872;2567
412740;202009;1887;5237;1267;3943;221;809;178;534;399;1343
412750;202009;3846;10137;3164;9144;308;1076;2082;5666;2390;6742
412760;202009;2905;7900;2404;7043;441;1464;1278;3515;1719;4979
412770;202009;10183;25689;5319;15995;740;2353;1248;3225;1988;5578
412780;202009;1182;3135;870;2554;190;603;338;969;528;1572
412785;202009;2056;4969;1432;3885;147;410;931;2469;1078;2879
412788;202009;1325;3704;1081;3276;288;875;462;1370;750;2245
412790;202009;1341;3543;747;2302;115;410;233;633;348;1043
412795;202009;1292;3333;674;2068;99;323;131;368;230;691
412796;202009;2202;6340;1801;5552;376;1227;591;1688;967;2915
412800;202009;3627;8767;2465;6611;282;873;1152;2731;1434;3604
412810;202009;11701;29664;7378;20832;890;2939;2874;7188;3764;10127
412820;202009;6414;17534;4473;13598;1081;3475;1279;3877;2360;7352
412830;202009;354;993;243;749;35;103;57;167;92;270
412840;202009;1852;4632;1305;3554;148;451;569;1407;717;1858
412850;202009;2831;7448;2028;6015;329;1050;844;2458;1173;3508
412853;202009;1521;3836;1256;3363;178;520;639;1527;817;2047
412855;202009;1240;3287;792;2328;135;471;232;635;367;1106
412860;202009;787;1924;535;1524;74;231;292;793;366;1024
412862;202009;698;1702;462;1302;87;250;194;520;281;770
412863;202009;1260;3780;1121;3521;218;709;625;1948;843;2657
412865;202009;720;1957;521;1549;134;403;147;456;281;859
412870;202009;852;2197;617;1810;167;556;121;382;288;938
412880;202009;840;2267;555;1673;91;321;94;251;185;572
420005;202009;415;1224;243;835;37;132;107;372;144;504
420010;202009;3295;8002;2178;6120;135;425;1597;4513;1732;4938
420020;202009;433;1364;282;974;44;179;62;175;106;354
420030;202009;73;246;53;203;16;71;18;61;34;132
420040;202009;520;1552;296;1050;59;233;17;45;76;278
420050;202009;732;1681;481;1227;73;216;297;679;370;895
420055;202009;159;486;89;315;19;86;27;81;46;167
420060;202009;102;274;57;169;11;34;14;32;25;66
420070;202009;689;2089;511;1709;107;373;200;646;307;1019
420075;202009;80;199;41;120;6;21;17;33;23;54
420080;202009;352;1018;276;842;75;249;106;318;181;567
420090;202009;423;1315;251;885;53;198;46;135;99;333
420100;202009;1230;3231;1017;2904;53;182;819;2307;872;2489
420110;202009;238;770;216;722;44;170;101;314;145;484
420120;202009;546;1475;362;1074;68;231;171;427;239;658
420125;202009;349;1077;245;840;61;222;98;322;159;544
420127;202009;267;716;99;322;14;51;26;80;40;131
420130;202009;3214;8848;2421;7478;366;1367;1163;3269;1529;4636
420140;202009;3480;9385;2436;7545;685;2405;332;1047;1017;3452
420150;202009;667;1694;457;1331;45;151;273;772;318;923
420160;202009;201;490;77;245;10;30;20;63;30;93
420165;202009;159;453;90;291;20;68;28;79;48;147
420170;202009;274;848;185;628;24;79;56;167;80;246
420180;202009;178;550;106;373;13;45;33;102;46;147
420190;202009;200;633;123;432;37;145;33;109;70;254
420195;202009;1398;3590;1003;2948;305;1068;112;244;417;1312
420200;202009;4371;10650;2587;7279;348;1214;1052;2552;1400;3766
420205;202009;1702;4575;1144;3470;163;524;637;1927;800;2451
420207;202009;1679;4393;1020;3133;197;695;406;1155;603;1850
420208;202009;317;893;183;642;58;221;46;153;104;374
420209;202009;155;518;92;316;21;76;29;97;50;173
420210;202009;3004;7680;1968;5981;347;1192;942;2778;1289;3970
420213;202009;761;2366;635;2102;141;504;312;1016;453;1520
420215;202009;186;563;127;428;31;114;26;82;57;196
420220;202009;252;725;151;500;26;103;70;205;96;308
420230;202009;4881;13319;3668;11005;557;1817;1934;5587;2491;7404
420240;202009;13294;36601;8288;25152;1071;3728;4087;10856;5158;14584
420243;202009;367;1050;287;885;46;165;171;501;217;666
420245;202009;1232;3168;867;2543;62;226;533;1496;595;1722
420250;202009;420;1179;344;1047;53;180;194;550;247;730
420253;202009;480;1183;340;980;36;124;192;545;228;669
420257;202009;163;419;103;311;18;68;52;155;70;223
420260;202009;1058;2780;766;2368;126;444;475;1434;601;1878
420270;202009;514;1344;252;738;34;111;115;330;149;441
420280;202009;1128;3393;856;2824;158;583;300;954;458;1537
420285;202009;117;240;49;143;11;45;10;21;21;66
420287;202009;429;1000;304;825;83;228;113;310;196;538
420290;202009;4636;13180;3533;10672;471;1654;2079;5771;2550;7425
420300;202009;7134;19981;4082;12862;756;2664;1216;3354;1972;6018
420310;202009;784;1808;385;1071;38;125;213;547;251;672
420315;202009;768;2166;528;1737;112;390;212;696;324;1086
420320;202009;4962;13569;3564;11168;1004;3487;908;2633;1912;6120
420325;202009;288;809;199;628;30;99;94;271;124;370
420330;202009;960;2793;606;2036;110;434;180;522;290;956
420340;202009;948;2626;702;2178;162;531;108;289;270;820
420350;202009;1133;2992;824;2431;70;239;572;1655;642;1894
420360;202009;2775;7627;1489;4805;281;986;128;417;409;1403
420370;202009;1077;2891;874;2561;84;284;599;1692;683;1976
420380;202009;4299;11286;2822;8620;596;1934;1054;3084;1650;5018
420390;202009;1065;2547;724;1858;130;405;299;518;429;923
420395;202009;1044;2954;704;2269;111;421;97;227;208;648
420400;202009;983;2774;671;2099;119;428;252;731;371;1159
420410;202009;547;1483;419;1212;45;135;283;799;328;934
420415;202009;283;835;216;687;55;197;80;256;135;453
420417;202009;596;1775;468;1499;128;415;163;539;291;954
420419;202009;140;490;107;410;37;149;8;30;45;179
420420;202009;10838;28004;7116;21202;1997;6765;1955;5272;3952;12037
420425;202009;647;1726;426;1278;40;138;207;599;247;737
420430;202009;3122;8378;1814;5490;424;1329;590;1646;1014;2975
420435;202009;246;631;116;377;15;51;56;174;71;225
420440;202009;726;1981;439;1358;113;391;171;489;284;880
420445;202009;263;643;168;471;29;81;77;206;106;287
420450;202009;686;1995;497;1586;90;343;178;492;268;835
420455;202009;1957;4805;1395;3941;197;658;682;1798;879;2456
420460;202009;8971;23881;6577;19434;967;3191;3367;9534;4334;12725
420470;202009;603;1575;320;1010;59;217;65;175;124;392
420475;202009;76;195;29;92;10;30;3;11;13;41
420480;202009;5341;13138;3199;9541;650;2127;1063;3158;1713;5285
420490;202009;349;969;252;773;53;183;100;296;153;479
420500;202009;1384;3835;877;2856;155;555;379;1228;534;1783
420510;202009;157;440;86;273;10;42;24;66;34;108
420515;202009;64;166;38;108;4;19;18;43;22;62
420517;202009;754;2069;653;1890;53;155;483;1413;536;1568
420519;202009;290;703;210;587;25;76;121;352;146;428
420520;202009;300;811;151;508;26;91;10;36;36;127
420530;202009;804;2337;545;1783;88;338;206;581;294;919
420535;202009;235;692;94;323;13;51;44;145;57;196
420540;202009;35249;83682;22169;61536;3295;10411;7724;18348;11019;28759
420543;202009;204;621;157;508;20;73;83;247;103;320
420545;202009;1097;3254;821;2645;150;528;321;934;471;1462
420550;202009;3400;9027;2120;6848;352;1314;862;2836;1214;4150
420555;202009;290;836;194;629;23;88;114;351;137;439
420560;202009;389;960;257;762;54;174;144;420;198;594
420570;202009;2197;6039;1712;5120;305;1047;748;2126;1053;3173
420580;202009;1837;4682;1303;3859;299;953;440;1344;739;2297
420590;202009;2749;7299;1571;4743;290;1054;418;952;708;2006
420600;202009;994;2882;748;2401;102;383;428;1309;530;1692
420610;202009;350;1009;192;643;45;158;65;227;110;385
420620;202009;728;1784;477;1367;103;314;192;541;295;855
420630;202009;885;2658;641;2054;84;299;378;1140;462;1439
420640;202009;485;1310;228;776;72;242;25;85;97;327
420650;202009;3477;9137;2068;6163;293;965;802;2049;1095;3014
420660;202009;431;1108;272;777;49;149;75;192;124;341
420665;202009;587;1529;369;1145;67;243;166;448;233;691
420670;202009;1285;3541;820;2587;142;544;304;843;446;1387
420675;202009;162;452;92;307;15;66;44;129;59;195
420680;202009;321;755;162;529;31;114;83;258;114;372
420690;202009;864;2544;511;1699;70;283;136;371;206;654
420700;202009;2531;6638;1868;5507;234;758;1053;2997;1287;3755
420710;202009;889;2577;674;2111;66;263;406;1164;472;1427
420720;202009;1197;3319;848;2700;172;581;410;1248;582;1829
420730;202009;2978;7722;2176;6388;354;1147;1163;3276;1517;4423
420740;202009;516;1552;301;1065;86;328;25;106;111;434
420750;202009;1910;5542;1232;3955;219;822;495;1447;714;2269
420757;202009;80;197;41;130;4;8;18;54;22;62
420760;202009;343;1013;164;512;36;122;44;119;80;241
420765;202009;456;1325;200;689;29;117;79;260;108;377
420768;202009;1329;3721;1138;3397;148;445;828;2458;976;2903
420770;202009;449;1210;219;743;39;150;89;277;128;427
420775;202009;275;832;187;621;39;146;53;146;92;292
420780;202009;914;2518;549;1712;113;386;98;262;211;648
420785;202009;189;498;131;373;13;45;67;159;80;204
420790;202009;990;3008;726;2462;118;471;390;1246;508;1717
420800;202009;642;1616;306;931;86;294;76;217;162;511
420810;202009;1392;4318;1119;3768;316;1211;371;1076;687;2287
420820;202009;11583;28820;8194;23249;1557;4968;3778;9815;5335;14783
420830;202009;3864;10117;2843;8232;511;1618;1234;3461;1745;5079
420840;202009;458;1334;212;772;58;233;26;83;84;316
420845;202009;2358;6014;1414;4291;263;975;573;1626;836;2601
420850;202009;1046;3356;635;2279;123;482;118;374;241;856
420860;202009;305;778;163;527;30;108;46;129;76;237
420870;202009;772;2137;571;1755;145;520;243;676;388;1196
420880;202009;1008;3097;777;2605;164;645;293;895;457;1540
420890;202009;7747;20888;4727;14638;698;2411;1691;4621;2389;7032
420895;202009;163;473;102;314;26;77;32;103;58;180
420900;202009;1477;3630;879;2570;119;423;412;1047;531;1470
420910;202009;28525;75111;17627;53874;2668;9273;7027;19128;9695;28401
420915;202009;519;1861;375;1443;55;212;199;786;254;998
420917;202009;342;842;175;482;29;85;86;234;115;319
420920;202009;78;208;29;103;1;2;6;24;7;26
420930;202009;15975;41733;11103;33088;2041;6773;4855;13707;6896;20480
420940;202009;2859;6999;1646;4886;404;1365;319;782;723;2147
420945;202009;132;373;103;309;25;85;42;115;67;200
420950;202009;336;976;182;604;27;111;47;141;74;252
420960;202009;991;2424;702;1926;125;408;306;730;431;1138
420970;202009;2359;6485;1650;5135;471;1530;440;1347;911;2877
420980;202009;267;883;230;805;113;402;61;225;174;627
420985;202009;300;861;144;514;35;137;45;141;80;278
420990;202009;305;942;166;593;30;110;35;116;65;226
421000;202009;531;1593;375;1244;80;281;101;301;181;582
421003;202009;472;1118;159;464;8;23;26;62;34;85
421005;202009;54;146;40;126;9;30;19;59;28;89
421010;202009;3168;8669;2283;7018;476;1648;630;1705;1106;3353
421020;202009;352;1097;270;945;44;184;138;457;182;641
421030;202009;718;2177;550;1819;166;621;170;516;336;1137
421040;202009;653;1540;411;1171;29;97;254;711;283;808
421050;202009;986;2638;638;1849;128;414;247;625;375;1039
421055;202009;172;464;94;284;15;50;57;157;72;207
421060;202009;626;1814;439;1388;78;289;207;579;285;868
421070;202009;633;1868;363;1189;72;255;113;351;185;606
421080;202009;493;1412;409;1253;44;157;249;755;293;912
421085;202009;365;1039;123;431;17;56;15;36;32;92
421090;202009;277;719;155;450;10;36;48;126;58;162
421100;202009;817;1822;340;1025;96;337;90;223;186;560
421105;202009;1515;4174;1031;3174;180;577;459;1337;639;1914
421110;202009;1051;2761;863;2518;22;68;634;1955;656;2023
421120;202009;971;2926;714;2346;112;400;227;680;339;1080
421125;202009;291;770;208;617;73;238;73;183;146;421
421130;202009;4788;13954;3923;12250;908;3256;1990;5798;2898;9054
421140;202009;333;907;192;596;34;108;61;171;95;279
421145;202009;431;1194;276;857;70;234;97;272;167;506
421150;202009;623;1684;395;1229;64;233;204;597;268;830
421160;202009;515;1377;365;1092;53;178;236;678;289;856
421165;202009;205;602;129;421;26;88;56;176;82;264
421170;202009;1061;2791;835;2440;138;389;503;1520;641;1909
421175;202009;981;2455;591;1844;115;394;252;759;367;1153
421180;202009;386;1001;210;641;41;155;84;226;125;381
421185;202009;316;848;212;631;28;94;124;365;152;459
421187;202009;270;819;168;558;30;99;57;180;87;279
421189;202009;346;1003;264;843;43;149;102;304;145;453
421190;202009;10839;29263;7248;22408;1346;4508;2611;7473;3957;11981
421200;202009;632;1833;511;1605;57;204;327;998;384;1202
421205;202009;184;486;135;404;25;93;59;153;84;246
421210;202009;1049;2689;611;1931;130;422;233;736;363;1158
421220;202009;1311;3919;1000;3262;233;832;304;905;537;1737
421223;202009;320;887;194;650;46;153;89;301;135;454
421225;202009;864;2541;723;2296;127;451;432;1359;559;1810
421227;202009;584;1714;385;1272;75;274;171;573;246;847
421230;202009;585;1534;370;1134;64;235;145;431;209;666
421240;202009;270;797;127;451;10;41;22;69;32;110
421250;202009;1931;4892;1365;3974;157;545;805;2224;962;2769
421260;202009;184;541;51;190;15;68;9;31;24;99
421265;202009;649;1700;573;1594;11;38;520;1429;531;1467
421270;202009;328;870;137;486;20;67;51;173;71;240
421280;202009;1780;4818;1320;4032;192;716;746;2150;938;2866
421290;202009;970;2621;501;1530;91;298;112;317;203;615
421300;202009;271;703;137;436;14;53;22;63;36;116
421310;202009;177;500;118;386;23;77;63;210;86;287
421315;202009;221;606;136;422;43;117;27;97;70;214
421320;202009;651;1977;337;1134;39;119;39;96;78;215
421330;202009;585;1743;419;1388;85;325;115;357;200;682
421335;202009;338;1030;277;922;67;252;114;361;181;613
421340;202009;1336;3691;947;2945;173;625;402;1144;575;1769
421350;202009;1431;3702;947;2854;185;636;397;1108;582;1744
421360;202009;2200;5926;1285;4044;239;893;488;1334;727;2227
421370;202009;642;2099;389;1404;73;263;115;364;188;627
421380;202009;792;2115;678;1931;90;292;401;1097;491;1389
421390;202009;166;454;59;206;14;42;21;64;35;106
421400;202009;306;974;218;765;37;144;113;379;150;523
421410;202009;208;568;90;318;22;87;27;79;49;166
421415;202009;183;541;105;331;20;64;20;58;40;122
421420;202009;532;1438;429;1246;46;148;271;766;317;914
421430;202009;100;306;74;244;8;28;19;57;27;85
421440;202009;591;1598;355;1165;70;226;154;490;224;716
421450;202009;427;1267;246;844;32;135;40;142;72;277
421460;202009;367;1091;199;726;26;104;37;110;63;214
421470;202009;250;727;147;498;31;107;52;188;83;295
421480;202009;2729;7325;1766;5392;373;1327;674;1859;1047;3186
421490;202009;116;400;70;267;7;29;17;43;24;72
421500;202009;2036;5988;1410;4694;378;1474;338;976;716;2450
421505;202009;276;789;227;719;35;125;145;445;180;570
421507;202009;414;1179;220;744;54;194;75;238;129;432
421510;202009;303;858;187;573;26;86;103;286;129;372
421520;202009;491;1273;315;881;26;77;191;488;217;565
421530;202009;300;894;173;603;28;125;52;148;80;273
421535;202009;380;998;232;733;36;136;119;356;155;492
421540;202009;283;662;135;407;19;61;47;123;66;184
421545;202009;666;1970;498;1662;113;444;235;733;348;1177
421550;202009;1994;5307;1601;4715;296;901;915;2687;1211;3588
421555;202009;164;500;68;241;9;35;8;19;17;54
421560;202009;83;271;56;208;10;36;18;62;28;98
421565;202009;878;2270;573;1779;145;495;154;483;299;978
421567;202009;426;1393;277;963;97;360;71;220;168;580
421568;202009;331;992;246;793;35;124;109;343;144;467
421569;202009;153;440;73;238;14;50;36;112;50;162
421570;202009;1105;2981;779;2362;181;619;215;603;396;1222
421575;202009;291;845;212;638;30;104;92;238;122;342
421580;202009;3863;10592;2489;7675;393;1415;970;2538;1363;3953
421590;202009;138;421;109;355;32;113;36;106;68;219
421600;202009;559;1504;380;1130;77;261;120;297;197;558
421605;202009;721;1848;508;1500;89;236;264;830;353;1066
421610;202009;1032;2797;680;2126;110;372;221;669;331;1041
421620;202009;3754;9924;2175;7009;459;1680;605;1844;1064;3524
421625;202009;131;364;55;177;13;44;13;40;26;84
421630;202009;2412;6291;1499;4491;261;939;522;1271;783;2210
421635;202009;252;683;181;532;16;51;114;308;130;359
421640;202009;694;1856;494;1545;95;339;212;644;307;983
421650;202009;2340;6377;1520;4827;349;1310;480;1289;829;2599
421660;202009;9662;26844;6711;21150;1046;3649;2943;8494;3989;12143
421670;202009;742;2127;520;1597;90;309;252;752;342;1061
421680;202009;1011;2757;759;2301;196;639;373;1033;569;1672
421690;202009;1261;3600;845;2709;163;594;299;949;462;1543
421700;202009;498;1468;316;1044;65;235;99;309;164;544
421710;202009;200;639;89;302;18;65;22;67;40;132
421715;202009;103;288;80;236;18;48;47;135;65;183
421720;202009;1830;4953;1058;3300;270;900;283;773;553;1673
421725;202009;241;593;125;386;20;64;52;128;72;192
421730;202009;401;1154;207;618;27;87;105;292;132;379
421740;202009;699;1976;480;1488;111;358;146;412;257;770
421750;202009;842;1986;378;1116;89;286;134;355;223;641
421755;202009;153;423;87;264;16;63;45;117;61;180
421760;202009;940;2438;618;1853;97;326;241;608;338;934
421770;202009;2360;6271;1692;5092;433;1289;604;1972;1037;3261
421775;202009;200;512;122;365;16;49;56;156;72;205
421780;202009;792;2337;507;1720;106;411;202;636;308;1047
421790;202009;786;2062;448;1443;94;312;219;683;313;995
421795;202009;182;494;131;377;24;81;48;126;72;207
421800;202009;2476;6708;1780;5399;228;804;1016;2921;1244;3725
421810;202009;601;1650;407;1282;48;183;237;725;285;908
421820;202009;915;2659;511;1659;102;379;159;404;261;783
421825;202009;1285;3641;1138;3411;125;395;795;2338;920;2733
421830;202009;1967;5831;1593;5124;329;1122;674;2109;1003;3231
421835;202009;208;510;127;372;26;87;34;87;60;174
421840;202009;207;665;136;495;29;111;34;115;63;226
421850;202009;367;1034;197;668;39;143;57;154;96;297
421860;202009;300;837;162;554;25;98;54;163;79;261
421870;202009;4087;10267;2925;8100;483;1593;1481;3637;1964;5230
421875;202009;274;812;115;369;18;63;34;89;52;152
421880;202009;570;1622;372;1172;94;350;88;269;182;619
421885;202009;206;595;125;405;29;92;29;84;58;176
421890;202009;822;2489;609;2052;114;462;316;988;430;1450
421895;202009;393;995;326;907;40;126;222;639;262;765
421900;202009;999;2621;727;2059;96;321;341;879;437;1200
421910;202009;291;857;197;635;31;129;54;141;85;270
421915;202009;364;1016;197;624;44;136;34;100;78;236
421917;202009;560;1306;312;984;113;385;75;248;188;633
421920;202009;366;1123;262;915;106;388;71;242;177;630
421930;202009;2532;6389;1284;3964;292;1030;419;1122;711;2152
421935;202009;393;1227;310;1045;61;214;170;559;231;773
421940;202009;354;1026;170;543;23;78;45;127;68;205
421950;202009;2925;7296;1601;4824;306;1011;398;1061;704;2072
421960;202009;170;441;88;283;18;72;19;53;37;125
421970;202009;1834;4691;1090;3193;218;760;413;1023;631;1783
421985;202009;276;737;158;505;16;52;62;184;78;236
422000;202009;1914;4966;1540;4349;164;548;1046;2905;1210;3453
430003;202009;568;1556;372;1187;65;222;163;522;228;744
430005;202009;260;680;163;506;31;101;74;219;105;320
430010;202009;1683;4065;1329;3516;139;410;935;2397;1074;2807
430020;202009;580;1321;434;1122;44;137;285;712;329;849
430030;202009;983;2317;535;1507;127;408;170;447;297;855
430040;202009;10252;24440;5998;16906;1585;4844;709;2122;2294;6966
430045;202009;503;1249;340;950;26;82;228;627;254;709
430047;202009;249;541;94;261;27;79;27;73;54;152
430050;202009;856;2162;491;1425;108;328;121;327;229;655
430055;202009;255;634;121;355;14;53;69;183;83;236
430057;202009;82;173;31;81;6;21;11;23;17;44
430060;202009;16842;44897;12893;38638;2705;8618;5939;17667;8644;26285
430063;202009;840;2334;664;1966;125;369;360;1067;485;1436
430064;202009;1007;2750;739;2195;218;659;284;832;502;1491
430066;202009;96;205;67;160;6;13;52;119;58;132
430070;202009;729;1844;96;309;7;26;16;43;23;69
430080;202009;845;2085;513;1431;81;271;268;645;349;916
430085;202009;842;1913;509;1377;101;286;214;565;315;851
430087;202009;708;1753;594;1601;69;181;404;1090;473;1271
430090;202009;547;1409;193;608;11;43;64;194;75;237
430100;202009;781;1863;462;1255;85;271;198;452;283;723
430105;202009;1158;3070;748;2358;123;446;360;1092;483;1538
430107;202009;165;482;96;303;20;72;27;71;47;143
430110;202009;2171;5402;1587;4530;258;787;853;2397;1111;3184
430120;202009;1168;3463;752;2413;133;456;340;1091;473;1547
430130;202009;3440;7897;2503;6567;896;2389;430;1380;1326;3769
430140;202009;937;2475;663;1957;170;472;320;921;490;1393
430150;202009;566;1445;305;923;66;219;104;301;170;520
430155;202009;249;633;112;341;18;51;22;63;40;114
430160;202009;19547;45508;15008;39034;1765;4970;8827;22726;10592;27696
430163;202009;2986;7059;2079;5605;88;292;1499;3956;1587;4248
430165;202009;303;745;85;275;14;31;14;39;28;70
430170;202009;942;2499;331;1147;54;197;45;145;99;342
430175;202009;642;1926;537;1696;135;438;250;773;385;1211
430180;202009;626;1508;493;1292;58;149;340;888;398;1037
430185;202009;598;1487;306;886;83;222;66;179;149;401
430187;202009;673;1520;474;1269;74;209;242;691;316;900
430190;202009;1383;3652;1108;3211;227;715;518;1428;745;2143
430192;202009;127;339;41;124;5;15;10;26;15;41
430195;202009;411;1218;62;217;6;17;11;33;17;50
430200;202009;1058;3141;842;2746;279;946;236;788;515;1734
430205;202009;457;1195;401;1097;14;49;345;915;359;964
430210;202009;5394;13705;3626;9949;629;1876;1250;2790;1879;4666
430215;202009;304;780;190;549;39;120;70;206;109;326
430220;202009;632;1568;186;623;23;87;41;105;64;192
430222;202009;182;505;133;400;15;54;45;127;60;181
430223;202009;244;637;189;545;16;50;121;344;137;394
430225;202009;17;34;11;25;1;2;7;16;8;18
430230;202009;1899;5128;1587;4645;138;453;1179;3378;1317;3831
430235;202009;336;954;218;691;48;172;69;191;117;363
430237;202009;509;1185;368;951;20;59;271;676;291;735
430240;202009;1267;2921;708;1938;84;279;380;949;464;1228
430245;202009;709;1998;542;1677;150;483;252;800;402;1283
430250;202009;889;2203;642;1813;219;664;40;102;259;766
430258;202009;130;340;95;272;7;13;51;149;58;162
430260;202009;657;1725;448;1321;62;204;246;722;308;926
430265;202009;214;611;138;456;30;93;42;143;72;236
430270;202009;2822;6963;2215;6011;393;1185;1318;3454;1711;4639
430280;202009;5002;11747;3432;9046;698;1861;1466;3808;2164;5669
430290;202009;2205;5041;1789;4550;49;163;1539;3823;1588;3986
430300;202009;9751;24640;7280;20281;1145;3519;3836;10385;4981;13904
430310;202009;11786;29133;7841;21722;1009;3123;3815;9795;4824;12918
430320;202009;1003;2599;537;1658;58;178;294;918;352;1096
430330;202009;684;1663;404;1101;72;210;172;418;244;628
430340;202009;713;1544;392;1058;54;155;231;605;285;760
430350;202009;7606;19170;5645;15646;768;2312;3293;8671;4061;10983
430355;202009;325;858;110;355;18;61;14;38;32;99
430360;202009;859;2014;544;1470;105;325;224;562;329;887
430367;202009;310;716;170;465;30;95;94;245;124;340
430370;202009;483;1296;222;674;40;133;60;153;100;286
430380;202009;704;1724;337;1044;77;278;98;286;175;564
430390;202009;3165;7644;1830;5148;343;1101;276;558;619;1659
430400;202009;1051;2236;805;1889;69;186;544;1226;613;1412
430410;202009;541;1302;369;1017;61;177;221;587;282;764
430420;202009;2586;7075;1968;5711;507;1552;860;2369;1367;3921
430430;202009;575;1468;267;826;62;184;59;197;121;381
430435;202009;1481;3741;1126;3164;205;615;568;1598;773;2213
430440;202009;3657;9982;2816;8488;301;1022;1696;5065;1997;6087
430450;202009;6687;16738;5264;14201;842;2518;2742;7078;3584;9596
430460;202009;31610;79811;23043;65560;4012;12671;11618;31498;15630;44169
430461;202009;282;728;88;273;12;40;33;87;45;127
430462;202009;242;654;135;434;19;64;53;166;72;230
430463;202009;5911;15417;4361;12638;867;2810;2003;5513;2870;8323
430465;202009;425;1086;345;943;56;175;213;560;269;735
430466;202009;4040;10142;3115;8635;755;2181;1437;3774;2192;5955
430467;202009;496;1186;353;955;48;155;192;476;240;631
430468;202009;1237;3049;954;2623;84;257;623;1674;707;1931
430469;202009;556;1500;68;219;7;23;13;24;20;47
430470;202009;5508;14042;3602;10601;1060;3429;923;2510;1983;5939
430471;202009;527;1493;425;1304;63;213;245;715;308;928
430480;202009;732;1963;423;1292;55;189;98;256;153;445
430485;202009;171;444;66;200;19;49;6;24;25;73
430490;202009;360;936;201;598;25;89;97;262;122;351
430495;202009;379;1003;240;731;34;108;116;334;150;442
430500;202009;974;2517;668;2001;222;729;178;479;400;1208
430510;202009;25239;65521;18075;51415;3005;9715;8349;21758;11354;31473
430511;202009;323;928;129;419;18;61;19;58;37;119
430512;202009;959;2155;740;1826;168;420;274;693;442;1113
430513;202009;762;1912;349;1019;50;158;174;480;224;638
430515;202009;369;1039;262;821;31;90;137;426;168;516
430517;202009;1165;3478;851;2742;160;518;392;1318;552;1836
430520;202009;1294;3289;665;1936;124;375;145;379;269;754
430530;202009;973;2421;379;1143;65;195;106;296;171;491
430535;202009;3470;8902;2492;7095;361;1079;1259;3438;1620;4517
430537;202009;322;1119;302;1062;20;64;241;850;261;914
430540;202009;618;1475;348;1005;60;170;161;467;221;637
430543;202009;777;1374;437;989;55;111;198;506;253;617
430544;202009;730;2044;508;1549;127;404;172;510;299;914
430545;202009;2256;5846;1667;4928;334;1024;828;2500;1162;3524
430550;202009;352;961;251;749;45;147;98;268;143;415
430558;202009;112;257;49;132;7;14;18;52;25;66
430560;202009;337;761;145;436;20;70;49;138;69;208
430570;202009;843;2052;590;1585;102;311;307;773;409;1084
430580;202009;822;2052;583;1672;149;455;248;705;397;1160
430583;202009;195;483;32;103;2;7;9;23;11;30
430585;202009;237;576;117;313;20;63;48;110;68;173
430587;202009;200;545;147;439;19;62;63;182;82;244
430590;202009;1387;3310;1137;2939;57;175;940;2375;997;2550
430593;202009;17;56;12;38;1;3;5;16;6;19
430595;202009;439;1110;121;396;9;34;23;57;32;91
430597;202009;445;1139;227;687;23;69;71;167;94;236
430600;202009;1983;5019;883;2490;164;499;234;592;398;1091
430605;202009;1226;3240;874;2570;111;384;405;1127;516;1511
430607;202009;530;1226;431;1066;27;72;314;768;341;840
430610;202009;5805;13525;3873;10560;1087;3357;850;2260;1937;5617
430613;202009;258;605;71;210;11;35;17;36;28;71
430620;202009;627;1514;453;1182;64;192;266;628;330;820
430630;202009;400;1107;111;364;18;59;24;71;42;130
430632;202009;473;1242;199;610;25;83;88;254;113;337
430635;202009;539;1269;398;1028;46;120;287;743;333;863
430637;202009;456;1111;354;957;43;133;221;567;264;700
430640;202009;1057;2746;649;1924;96;291;237;645;333;936
430642;202009;352;958;261;751;45;119;137;375;182;494
430645;202009;154;359;60;160;8;21;21;52;29;73
430650;202009;1594;4580;1269;4037;355;1130;571;1914;926;3044
430655;202009;275;693;166;466;25;81;81;196;106;277
430660;202009;5222;13295;3934;11113;856;2529;1698;4741;2554;7270
430670;202009;649;1570;491;1289;32;92;293;773;325;865
430673;202009;538;1208;215;611;37;107;84;219;121;326
430675;202009;239;686;56;197;8;28;24;84;32;112
430676;202009;4928;12145;3877;10533;475;1423;2466;6495;2941;7918
430680;202009;1012;2706;591;1833;158;494;141;422;299;916
430690;202009;2822;7643;2205;6513;756;2343;597;1679;1353;4022
430692;202009;220;672;165;570;12;39;123;437;135;476
430693;202009;944;2488;561;1717;105;375;145;401;250;776
430695;202009;433;1115;237;699;32;84;126;356;158;440
430697;202009;387;969;293;822;77;198;140;429;217;627
430700;202009;7076;17325;4114;11788;833;2614;889;2277;1722;4891
430705;202009;401;973;196;591;23;79;83;219;106;298
430710;202009;1631;3523;1131;2835;151;423;680;1671;831;2094
430720;202009;676;1634;346;1051;47;143;177;540;224;683
430730;202009;1015;2743;687;2118;99;296;362;1101;461;1397
430740;202009;616;1676;312;1026;52;176;78;271;130;447
430745;202009;363;991;227;694;44;157;70;180;114;337
430750;202009;1362;3448;942;2727;205;623;457;1298;662;1921
430755;202009;453;1097;279;745;21;59;160;393;181;452
430760;202009;2014;4923;1515;4149;349;1037;671;1744;1020;2781
430770;202009;6132;15241;4685;13066;596;1918;2983;8024;3579;9942
430780;202009;1826;4429;1037;3060;205;671;402;1130;607;1801
430781;202009;456;1265;244;759;32;96;73;193;105;289
430783;202009;357;813;213;593;19;60;132;344;151;404
430786;202009;34;119;24;87;3;13;3;13;6;26
430790;202009;4371;10589;3018;8259;342;1115;1851;4711;2193;5826
430800;202009;739;1719;540;1414;35;97;355;935;390;1032
430805;202009;356;950;217;642;16;58;137;381;153;439
430807;202009;477;1155;248;717;30;90;98;261;128;351
430810;202009;711;1691;298;885;35;130;133;365;168;495
430820;202009;1219;3255;716;2266;137;460;216;663;353;1123
430825;202009;246;621;87;232;11;29;28;68;39;97
430830;202009;1665;4731;1333;4091;64;218;958;2902;1022;3120
430840;202009;1018;2517;713;1994;102;295;475;1316;577;1611
430843;202009;150;347;66;173;4;13;31;77;35;90
430845;202009;455;1076;296;813;55;163;130;340;185;503
430850;202009;2253;5846;1511;4390;239;761;591;1728;830;2489
430860;202009;864;2002;373;1058;48;167;179;434;227;601
430865;202009;509;1261;376;1034;74;205;174;471;248;676
430870;202009;605;1573;255;798;41;153;81;213;122;366
430880;202009;1471;3331;984;2576;161;424;530;1361;691;1785
430885;202009;179;476;93;309;7;25;59;191;66;216
430890;202009;993;2456;654;1874;57;245;136;366;193;611
430900;202009;3077;6720;2116;5334;178;530;1407;3331;1585;3861
430905;202009;747;1894;464;1355;84;276;176;475;260;751
430910;202009;1597;4235;1120;3254;189;642;554;1428;743;2070
430912;202009;491;1367;328;1038;25;76;225;722;250;798
430915;202009;486;1467;369;1244;135;443;96;347;231;790
430920;202009;22662;57285;17083;47896;2297;7107;10260;27992;12557;35099
430925;202009;94;211;34;101;5;13;16;49;21;62
430930;202009;10088;23863;6318;17990;1223;3545;2589;7694;3812;11239
430940;202009;990;2586;590;1724;147;455;156;389;303;844
430950;202009;759;1772;483;1292;37;133;304;739;341;872
430955;202009;343;907;86;258;22;67;24;58;46;125
430957;202009;176;601;161;562;25;90;100;345;125;435
430960;202009;1308;3119;721;2032;156;469;310;844;466;1313
430965;202009;1612;3809;1239;3219;73;191;937;2496;1010;2687
430970;202009;349;835;169;480;22;70;82;206;104;276
430975;202009;496;1465;378;1191;82;277;198;592;280;869
430980;202009;388;882;226;607;27;90;107;260;134;350
430990;202009;529;1515;324;1021;42;133;157;495;199;628
430995;202009;566;1427;410;1171;46;145;229;636;275;781
431000;202009;1345;3157;541;1567;93;293;43;108;136;401
431010;202009;2161;5621;1352;4209;261;899;314;850;575;1749
431020;202009;7882;17118;4606;12149;1061;3165;1540;3527;2601;6692
431030;202009;327;900;159;539;25;91;23;77;48;168
431033;202009;3726;8685;2366;6535;520;1452;840;2340;1360;3792
431036;202009;339;745;75;216;8;29;25;54;33;83
431040;202009;881;2256;568;1691;85;286;257;703;342;989
431041;202009;460;1054;334;865;27;63;199;515;226;578
431043;202009;340;853;185;571;43;150;88;267;131;417
431046;202009;106;278;42;129;4;9;8;24;12;33
431050;202009;1356;3279;957;2626;181;543;462;1293;643;1836
431053;202009;636;1718;357;1103;77;278;115;302;192;580
431055;202009;584;1412;492;1271;58;135;349;902;407;1037
431057;202009;234;668;116;383;26;85;33;99;59;184
431060;202009;5380;13743;3581;10612;852;2774;978;2813;1830;5587
431065;202009;416;1032;293;822;50;154;137;377;187;531
431070;202009;431;1182;241;754;54;183;62;184;116;367
431075;202009;217;625;132;428;29;103;36;117;65;220
431080;202009;576;1560;390;1159;61;214;144;401;205;615
431085;202009;759;1957;474;1304;59;165;245;654;304;819
431087;202009;401;1136;323;971;22;63;225;699;247;762
431090;202009;413;962;161;487;29;96;45;141;74;237
431100;202009;3324;7276;2261;5853;325;851;1153;3041;1478;3892
431110;202009;1385;3166;928;2387;264;708;359;838;623;1546
431112;202009;584;1621;490;1435;68;227;303;852;371;1079
431113;202009;371;1012;319;910;50;162;197;543;247;705
431115;202009;944;2683;728;2277;100;389;418;1210;518;1599
431120;202009;2500;6725;1690;5086;488;1653;379;1034;867;2687
431123;202009;404;1088;257;770;44;116;142;445;186;561
431125;202009;1001;2825;762;2350;267;799;268;889;535;1688
431127;202009;201;525;60;195;7;23;13;38;20;61
431130;202009;2934;7438;2128;6077;303;990;1198;3321;1501;4311
431140;202009;5429;12705;3265;8620;393;1165;1512;3427;1905;4592
431142;202009;501;1328;369;1090;49;150;225;664;274;814
431150;202009;1026;2723;725;2159;137;445;317;905;454;1350
431160;202009;631;1805;417;1325;70;241;126;392;196;633
431162;202009;506;1218;283;812;30;99;156;413;186;512
431164;202009;176;398;41;121;10;30;5;11;15;41
431170;202009;459;1274;319;971;94;288;92;268;186;556
431171;202009;651;1524;525;1352;116;262;305;818;421;1080
431173;202009;392;1039;290;883;75;262;120;340;195;602
431175;202009;1246;2884;763;2052;124;343;289;725;413;1068
431177;202009;795;2142;608;1842;130;456;368;1057;498;1513
431179;202009;332;728;94;282;18;54;21;62;39;116
431180;202009;2144;5400;1299;3736;324;941;369;1033;693;1974
431190;202009;508;1315;253;748;31;102;94;226;125;328
431198;202009;356;1024;282;881;92;300;87;294;179;594
431200;202009;362;899;78;213;16;45;11;30;27;75
431205;202009;195;539;99;321;28;92;36;115;64;207
431210;202009;609;1484;486;1312;126;340;216;619;342;959
431213;202009;252;664;187;543;12;39;97;288;109;327
431215;202009;580;1370;256;738;24;68;128;353;152;421
431217;202009;153;395;102;302;12;38;54;149;66;187
431220;202009;531;1371;311;936;30;109;176;490;206;599
431225;202009;1489;3511;1132;2911;116;316;772;1990;888;2306
431230;202009;686;1958;529;1599;72;228;321;938;393;1166
431235;202009;154;391;23;80;4;10;5;21;9;31
431237;202009;308;972;251;838;49;177;129;412;178;589
431238;202009;27;71;22;61;6;22;8;13;14;35
431240;202009;4366;10702;3384;9153;467;1443;2019;5178;2486;6621
431242;202009;238;641;203;586;42;127;107;300;149;427
431244;202009;319;772;165;467;24;84;60;142;84;226
431245;202009;1274;2975;793;2129;75;216;418;1072;493;1288
431247;202009;271;688;156;447;28;89;64;158;92;247
431250;202009;1661;4141;1218;3537;265;813;628;1906;893;2719
431260;202009;242;666;159;508;23;86;56;169;79;255
431261;202009;236;712;187;631;14;53;104;334;118;387
431262;202009;366;1013;177;573;10;27;118;387;128;414
431265;202009;1572;3697;616;1792;79;272;216;549;295;821
431267;202009;283;734;176;494;8;35;126;316;134;351
431270;202009;2766;6188;1468;3996;337;942;485;1330;822;2272
431275;202009;120;347;61;198;24;74;12;42;36;116
431280;202009;235;636;73;236;5;16;6;12;11;28
431290;202009;309;903;200;622;37;132;37;81;74;213
431295;202009;69;174;20;62;3;8;5;16;8;24
431300;202009;286;735;53;165;5;17;13;27;18;44
431301;202009;310;867;67;211;7;18;8;23;15;41
431303;202009;577;1514;339;993;23;78;154;420;177;498
431306;202009;2270;5305;1356;3773;180;576;591;1446;771;2022
431308;202009;26;79;23;73;11;37;10;31;21;68
431310;202009;535;1500;373;1134;52;165;165;462;217;627
431320;202009;640;1750;322;1049;47;137;61;171;108;308
431330;202009;1696;3968;816;2325;147;474;327;843;474;1317
431333;202009;221;588;113;333;19;55;39;107;58;162
431335;202009;36;103;19;62;4;8;2;6;6;14
431337;202009;2573;6796;1862;5611;348;1187;969;2805;1317;3992
431339;202009;422;1091;307;874;85;250;122;344;207;594
431340;202009;18735;45199;12750;35099;2186;6683;5667;14600;7853;21283
431342;202009;424;913;307;740;23;48;261;631;284;679
431344;202009;388;980;228;673;9;30;122;346;131;376
431346;202009;237;580;91;289;15;53;25;76;40;129
431349;202009;637;1656;330;969;81;235;118;342;199;577
431350;202009;3948;10195;2883;8328;408;1343;1518;4215;1926;5558
431360;202009;562;1333;276;781;85;245;70;197;155;442
431365;202009;2044;4778;1615;4191;125;369;1214;3107;1339;3476
431370;202009;4339;10534;3065;8419;644;1851;1513;4261;2157;6112
431380;202009;777;2082;627;1839;40;130;438;1281;478;1411
431390;202009;2630;6400;1579;4511;168;577;779;1936;947;2513
431395;202009;1276;3161;896;2572;203;604;398;1176;601;1780
431400;202009;324;904;176;550;34;101;41;126;75;227
431402;202009;866;1927;624;1559;78;207;420;1021;498;1228
431403;202009;193;541;148;448;24;72;65;185;89;257
431405;202009;4529;11841;3445;10017;596;1934;1688;4639;2284;6573
431406;202009;542;1522;391;1206;77;229;202;642;279;871
431407;202009;438;1220;302;929;66;223;153;449;219;672
431410;202009;16126;40487;10408;30207;1543;5171;5182;14007;6725;19178
431413;202009;227;595;59;188;7;25;8;28;15;53
431415;202009;662;1619;410;1196;71;250;201;524;272;774
431417;202009;545;1207;368;933;55;159;206;511;261;670
431420;202009;1593;3560;1193;3001;163;420;675;1675;838;2095
431430;202009;546;1403;258;807;40;136;80;218;120;354
431440;202009;29677;69328;20341;54539;3474;10097;7948;19999;11422;30096
431442;202009;120;339;58;199;12;43;11;33;23;76
431445;202009;384;1069;117;372;16;44;9;25;25;69
431446;202009;264;777;197;639;36;130;98;304;134;434
431447;202009;725;1923;412;1247;84;280;140;428;224;708
431449;202009;766;1997;454;1344;88;242;178;540;266;782
431450;202009;2233;4584;1738;3883;84;201;1361;2968;1445;3169
431454;202009;35;110;29;95;8;24;9;28;17;52
431455;202009;612;1446;293;787;37;107;148;360;185;467
431460;202009;2834;6876;1981;5350;513;1462;535;1473;1048;2935
431470;202009;1395;3922;999;3074;192;598;434;1364;626;1962
431475;202009;252;679;49;173;5;18;6;13;11;31
431477;202009;410;1059;240;705;42;119;102;270;144;389
431478;202009;255;668;53;168;11;29;7;17;18;46
431480;202009;3205;7879;2503;6771;596;1606;1266;3476;1862;5082
431490;202009;108296;254333;81329;212683;5961;18448;58905;147962;64866;166410
431500;202009;468;1183;341;940;59;165;180;477;239;642
431505;202009;267;638;182;510;11;35;128;357;139;392
431507;202009;343;806;133;391;41;130;37;101;78;231
431510;202009;1564;4016;1042;2989;227;703;353;1013;580;1716
431513;202009;207;453;116;303;9;19;82;216;91;235
431514;202009;108;271;74;209;3;9;52;139;55;148
431515;202009;474;1167;340;924;79;221;163;437;242;658
431517;202009;59;177;47;146;6;17;22;65;28;82
431520;202009;410;997;156;486;23;83;67;178;90;261
431530;202009;4183;8859;2355;6127;534;1407;592;1558;1126;2965
431531;202009;207;512;124;351;13;39;57;146;70;185
431532;202009;558;1282;329;871;67;201;131;338;198;539
431535;202009;249;657;112;345;21;66;27;75;48;141
431540;202009;1778;5672;1647;5490;60;241;1333;4458;1393;4699
431545;202009;345;883;61;189;5;13;13;39;18;52
431550;202009;2056;5175;1500;4139;247;753;764;2013;1011;2766
431555;202009;647;1461;393;1032;27;84;234;605;261;689
431560;202009;22289;54015;15036;42557;3129;9261;5009;14954;8138;24215
431570;202009;4480;10766;3576;9447;449;1296;2493;6323;2942;7619
431575;202009;247;609;189;507;70;164;45;133;115;297
431580;202009;590;1512;352;1024;40;143;195;538;235;681
431590;202009;572;1583;431;1293;91;291;165;509;256;800
431595;202009;364;973;230;681;50;147;91;243;141;390
431600;202009;1407;3238;971;2606;229;669;386;1042;615;1711
431610;202009;1366;3500;927;2694;135;379;482;1435;617;1814
431620;202009;474;1214;217;630;35;101;85;235;120;336
431630;202009;1311;3242;609;1794;99;315;219;589;318;904
431640;202009;6233;14694;5240;13453;513;1350;3912;10097;4425;11447
431642;202009;552;1347;343;918;27;71;161;392;188;463
431643;202009;390;949;182;512;18;45;57;163;75;208
431645;202009;1807;4029;1391;3464;61;191;1116;2738;1177;2929
431647;202009;280;679;89;251;10;22;27;68;37;90
431650;202009;119;326;78;255;6;23;44;128;50;151
431660;202009;874;2320;432;1390;73;273;120;332;193;605
431670;202009;1138;2691;696;1885;109;312;353;898;462;1210
431673;202009;234;597;81;274;13;44;17;55;30;99
431675;202009;523;1313;112;375;11;42;23;65;34;107
431680;202009;7482;19101;5367;15116;1252;3683;2276;6256;3528;9939
431690;202009;23461;57117;15342;42472;3130;9281;6094;16670;9224;25951
431695;202009;162;388;102;299;23;78;52;131;75;209
431697;202009;452;1065;348;900;48;114;204;541;252;655
431700;202009;1316;3410;1101;3017;159;401;663;1810;822;2211
431710;202009;12780;30534;8817;24769;1523;4621;4396;12457;5919;17078
431720;202009;6319;15595;3682;10441;903;2710;735;1853;1638;4563
431725;202009;30;86;23;72;4;11;10;30;14;41
431730;202009;3908;9313;2395;6900;560;1721;740;2271;1300;3992
431740;202009;5057;11965;3274;8926;870;2751;836;1922;1706;4673
431750;202009;7336;18740;5520;15806;1222;3764;2340;6577;3562;10341
431755;202009;323;884;72;250;10;36;9;34;19;70
431760;202009;5339;11920;3560;9080;405;1178;2133;5131;2538;6309
431770;202009;1889;4405;1462;3835;96;285;1100;2810;1196;3095
431775;202009;199;513;102;310;20;58;15;40;35;98
431780;202009;2066;5100;1305;3673;214;678;552;1478;766;2156
431790;202009;800;2158;569;1708;99;290;252;741;351;1031
431795;202009;233;592;116;345;26;69;29;81;55;150
431800;202009;8156;19433;4965;14293;1282;4319;512;1552;1794;5871
431805;202009;299;706;92;299;11;38;25;79;36;117
431810;202009;3249;7655;2020;5404;380;1057;862;2207;1242;3264
431820;202009;2115;5680;1650;4927;457;1442;573;1789;1030;3231
431830;202009;9015;19353;6570;16096;1678;4861;1944;4723;3622;9584
431840;202009;2510;6570;1990;5716;313;912;1242;3579;1555;4491
431842;202009;533;1343;182;558;24;77;65;169;89;246
431843;202009;337;893;247;702;32;97;122;326;154;423
431844;202009;201;512;66;200;14;47;22;64;36;111
431845;202009;518;1363;358;1041;36;105;208;598;244;703
431846;202009;274;708;229;641;9;29;205;573;214;602
431848;202009;102;261;63;188;9;29;11;25;20;54
431849;202009;413;997;67;189;5;9;9;22;14;31
431850;202009;4101;11075;3124;9111;721;2277;1013;2921;1734;5198
431860;202009;651;1571;350;983;60;180;191;512;251;692
431861;202009;96;262;54;167;11;39;15;43;26;82
431862;202009;430;1360;351;1223;67;257;177;589;244;846
431870;202009;19635;49695;15745;43514;1852;5782;9720;25817;11572;31599
431880;202009;3946;10100;2757;7959;438;1450;1263;3449;1701;4899
431890;202009;4486;11225;2736;7875;771;2444;472;1510;1243;3954
431900;202009;973;2439;621;1795;101;325;318;864;419;1189
431910;202009;751;1801;272;761;42;120;85;192;127;312
431912;202009;471;1276;364;1086;75;231;201;598;276;829
431915;202009;1020;2513;798;2147;26;84;615;1620;641;1704
431920;202009;1214;2798;1000;2514;31;78;857;2145;888;2223
431930;202009;664;1759;443;1343;155;432;168;544;323;976
431935;202009;83;222;58;170;14;45;13;38;27;83
431936;202009;300;868;160;515;34;114;61;180;95;294
431937;202009;165;412;101;277;16;49;45;100;61;149
431940;202009;2969;7025;1690;4686;190;566;836;2224;1026;2790
431950;202009;1755;4619;1393;4022;442;1313;516;1456;958;2769
431960;202009;2928;7118;2120;5648;584;1640;545;1461;1129;3101
431970;202009;418;1049;166;474;36;99;47;117;83;216
431971;202009;83;209;32;102;2;8;4;8;6;16
431973;202009;474;1510;387;1343;39;141;282;976;321;1117
431975;202009;111;229;23;73;1;4;3;9;4;13
431980;202009;992;2579;761;2195;157;476;357;994;514;1470
431990;202009;5571;13299;3724;10624;467;1614;1843;5009;2310;6623
432000;202009;11199;26668;8111;21862;1974;5389;3451;9417;5425;14806
432010;202009;2173;5303;1584;4277;242;723;918;2331;1160;3054
432020;202009;1753;4499;1069;3067;233;704;434;1184;667;1888
432023;202009;505;1208;262;737;34;108;127;316;161;424
432026;202009;938;2626;685;2132;176;553;231;719;407;1272
432030;202009;360;889;202;565;21;62;118;322;139;384
432032;202009;343;878;234;661;29;93;127;335;156;428
432035;202009;643;1830;556;1680;172;527;232;725;404;1252
432040;202009;1031;2372;369;1127;61;206;127;348;188;554
432045;202009;162;447;98;316;24;75;32;111;56;186
432050;202009;488;1213;359;989;78;210;145;426;223;636
432055;202009;580;1561;376;1170;131;410;74;218;205;628
432057;202009;220;584;163;445;20;48;65;163;85;211
432060;202009;450;1086;140;433;33;111;44;118;77;229
432065;202009;213;592;149;450;33;99;60;179;93;278
432067;202009;732;2107;611;1840;58;192;457;1322;515;1514
432070;202009;1636;4304;1052;3145;232;770;343;915;575;1685
432080;202009;4556;10724;3462;8981;598;1807;1623;3968;2221;5775
432085;202009;339;872;229;702;61;191;90;287;151;478
432090;202009;1617;4051;1032;2933;187;576;499;1304;686;1880
432100;202009;948;2398;465;1425;97;324;87;222;184;546
432110;202009;2015;5358;1350;4146;326;1137;129;362;455;1499
432120;202009;2716;7319;2075;6206;396;1305;816;2326;1212;3631
432130;202009;2504;6387;2061;5734;593;1683;923;2615;1516;4298
432132;202009;182;516;107;350;21;69;50;141;71;210
432135;202009;1003;2346;657;1752;39;119;475;1252;514;1371
432140;202009;1599;4772;1198;3947;179;616;696;2288;875;2904
432143;202009;1377;3586;1050;3076;67;216;698;2034;765;2250
432145;202009;1617;4207;997;2904;144;455;353;884;497;1339
432146;202009;98;268;64;209;22;77;21;62;43;139
432147;202009;479;1354;277;912;91;324;70;197;161;521
432149;202009;440;1074;219;616;17;53;108;271;125;324
432150;202009;3091;7807;2248;6306;472;1451;883;2417;1355;3868
432160;202009;5095;13377;3714;11137;905;3024;1346;3814;2251;6838
432162;202009;255;559;35;98;8;20;6;15;14;35
432163;202009;119;292;24;64;0;0;3;4;3;4
432166;202009;605;1684;457;1374;92;303;149;404;241;707
432170;202009;1400;3736;898;2782;162;556;360;1022;522;1578
432180;202009;3011;7094;1638;4499;310;890;606;1461;916;2351
432183;202009;368;1075;247;786;59;207;67;195;126;402
432185;202009;807;2071;464;1392;40;137;235;657;275;794
432190;202009;1852;4466;1220;3441;192;610;656;1721;848;2331
432195;202009;892;2239;584;1683;169;451;198;610;367;1061
432200;202009;3223;8170;2306;6683;379;1113;1280;3753;1659;4866
432210;202009;387;1020;239;726;44;171;109;275;153;446
432215;202009;616;1803;557;1712;54;147;412;1288;466;1435
432218;202009;246;610;109;309;14;51;52;133;66;184
432220;202009;3480;8190;2558;6717;457;1272;1367;3516;1824;4788
432225;202009;90;256;68;211;10;33;40;124;50;157
432230;202009;711;1649;376;1017;39;108;170;411;209;519
432232;202009;483;1187;300;872;60;184;107;284;167;468
432234;202009;268;665;123;359;20;50;16;43;36;93
432235;202009;49;139;17;55;5;17;4;13;9;30
432237;202009;323;826;281;756;11;22;232;616;243;638
432240;202009;15435;38066;11064;32133;840;2571;6987;21310;7827;23881
432250;202009;5176;14753;3909;12205;1004;3291;1632;5034;2636;8325
432252;202009;440;1045;272;749;35;103;142;374;177;477
432253;202009;895;2722;558;1857;128;454;49;150;177;604
432254;202009;695;1631;182;537;31;94;37;102;68;196
432255;202009;109;277;56;171;3;9;27;74;30;83
432260;202009;4826;12327;3549;9891;1013;2914;1146;3050;2159;5964
432270;202009;1779;4954;1415;4246;416;1358;293;812;709;2170
432280;202009;1362;3385;703;2078;102;315;264;645;366;960
432285;202009;142;429;21;64;2;6;2;4;4;10
432290;202009;339;945;181;564;60;192;35;79;95;271
432300;202009;25696;64733;19010;53789;2751;8780;11024;30060;13775;38840
432310;202009;832;2228;596;1788;65;203;404;1204;469;1407
432320;202009;214;502;78;238;8;29;29;78;37;107
432330;202009;227;504;64;207;6;13;13;40;19;53
432335;202009;190;530;66;233;5;21;17;58;22;79
432340;202009;306;738;137;427;11;32;52;149;63;181
432345;202009;672;1527;590;1426;17;44;487;1161;504;1205
432350;202009;341;890;184;580;27;89;71;224;98;313
432360;202009;235;684;46;150;4;7;16;54;20;61
432370;202009;303;743;199;566;16;55;132;362;148;417
432375;202009;470;1176;344;926;63;164;174;473;237;637
432377;202009;175;556;31;107;6;27;5;15;11;42
432380;202009;1638;4320;1053;3243;179;634;532;1571;711;2205
500020;202009;2482;6438;1785;5252;156;547;1110;3158;1266;3705
500025;202009;1208;2945;744;2068;71;212;400;1057;471;1269
500060;202009;7836;21984;5303;16691;656;2131;3063;9910;3719;12041
500070;202009;4223;10902;2899;8624;542;1644;1239;3769;1781;5413
500080;202009;1600;3942;963;2744;180;565;372;933;552;1498
500085;202009;2039;5040;1383;3941;317;950;650;1783;967;2733
500090;202009;2136;5648;1428;4394;241;784;485;1589;726;2373
500100;202009;3557;9060;2691;7645;452;1457;1312;3530;1764;4987
500110;202009;7989;20344;5063;15638;1074;3642;1509;5497;2583;9139
500124;202009;2044;5962;1613;5226;262;786;851;2907;1113;3693
500150;202009;1325;2980;824;2251;138;394;340;914;478;1308
500190;202009;4768;12296;2991;8823;655;1967;734;2062;1389;4029
500200;202009;2283;5421;1656;4362;184;499;1004;2544;1188;3043
500210;202009;4586;11071;3243;9295;878;2470;1414;4171;2292;6641
500215;202009;1381;3835;987;3104;98;333;546;1699;644;2032
500220;202009;2613;7326;1656;5447;284;1011;412;1288;696;2299
500230;202009;2017;4718;1515;4017;176;432;1015;2675;1191;3107
500240;202009;3919;11519;2743;9036;410;1513;1099;3696;1509;5209
500260;202009;3242;6871;2037;5218;273;709;1076;2646;1349;3355
500270;202009;136771;320374;80978;225010;13376;40925;30093;78209;43469;119134
500280;202009;1325;3328;902;2669;132;407;485;1415;617;1822
500290;202009;3606;8510;2050;5890;320;1056;675;1736;995;2792
500295;202009;3472;8377;2151;6018;339;1045;835;2011;1174;3056
500310;202009;958;1990;641;1588;99;213;326;838;425;1051
500315;202009;3731;10288;2934;9081;248;805;2077;6540;2325;7345
500320;202009;19365;51839;13323;41788;3374;11145;4568;15203;7942;26348
500325;202009;4263;9514;2917;7718;228;636;1971;5265;2199;5901
500330;202009;6662;15176;4353;11783;377;1121;2329;6471;2706;7592
500345;202009;2079;5116;1384;4023;325;986;462;1321;787;2307
500348;202009;2356;6103;1781;5107;245;719;1018;2968;1263;3687
500350;202009;1309;3567;713;2248;92;290;289;871;381;1161
500370;202009;26121;66732;18238;53734;2382;8034;9626;27954;12008;35988
500375;202009;2415;6348;1578;4633;288;923;531;1455;819;2378
500380;202009;3371;8410;2277;6534;632;1968;515;1493;1147;3461
500390;202009;619;1261;365;948;54;172;218;538;272;710
500400;202009;1506;3811;993;2812;175;571;349;867;524;1438
500410;202009;2391;5882;1666;4791;181;511;955;2876;1136;3387
500430;202009;2578;6283;1724;5004;224;766;742;2265;966;3031
500440;202009;1215;2952;755;2228;116;377;283;888;399;1265
500450;202009;1484;3644;828;2451;141;445;214;587;355;1032
500460;202009;3604;9687;2178;6836;359;1287;682;2080;1041;3367
500470;202009;2428;6523;1457;4507;408;1407;315;849;723;2256
500480;202009;2099;6365;1770;5834;172;589;1309;4381;1481;4970
500490;202009;1065;2462;626;1803;127;447;172;498;299;945
500500;202009;4217;11243;2668;8684;918;3502;435;1452;1353;4954
500510;202009;681;1737;436;1271;28;96;264;743;292;839
500515;202009;1709;4356;1304;3706;139;434;817;2224;956;2658
500520;202009;3216;9845;2467;8450;637;2214;988;3621;1625;5835
500525;202009;872;2580;708;2325;58;202;451;1498;509;1700
500540;202009;4429;11489;2654;8335;689;2707;245;691;934;3398
500560;202009;5394;14633;4302;13254;284;894;3443;10790;3727;11684
500568;202009;4303;9399;2589;6849;624;1751;906;2431;1530;4182
500570;202009;7672;17847;4657;12697;838;2490;1749;4451;2587;6941
500580;202009;3009;7987;2175;6514;479;1488;1004;3035;1483;4523
500600;202009;3406;8459;2396;6854;539;1606;990;2885;1529;4491
500620;202009;7824;20448;5243;15524;1081;3352;1933;5523;3014;8875
500625;202009;548;1501;347;1067;66;208;92;263;158;471
500627;202009;763;1982;456;1429;77;262;146;452;223;714
500630;202009;6606;15228;3781;10509;770;2350;1114;3098;1884;5448
500635;202009;2884;9010;2231;8153;171;662;1533;6146;1704;6808
500640;202009;1704;3737;1118;2956;39;123;760;1983;799;2106
500660;202009;17607;45123;12021;36983;3751;13131;3005;9454;6756;22585
500690;202009;2308;6425;1486;4985;516;2006;77;194;593;2200
500710;202009;2801;7514;2146;6381;602;1898;679;1908;1281;3806
500720;202009;4806;12156;3107;9310;702;2222;929;2874;1631;5096
500730;202009;1073;2654;582;1749;115;329;140;457;255;786
500740;202009;4582;10859;3088;8480;406;1170;1590;4342;1996;5512
500750;202009;965;2459;641;1870;85;245;244;654;329;899
500755;202009;919;2397;504;1592;89;311;105;293;194;604
500769;202009;5087;12413;2738;7945;525;1718;381;898;906;2616
500770;202009;1460;3934;937;3000;164;602;316;1001;480;1603
500780;202009;1224;2962;781;2214;163;521;204;542;367;1063
500790;202009;7009;18614;5411;15937;1110;3520;2644;7829;3754;11349
500793;202009;2023;5202;1433;4169;353;1096;464;1245;817;2341
500795;202009;2702;6648;2182;5990;110;271;1740;5036;1850;5307
500797;202009;680;1722;445;1280;131;391;135;390;266;781
500800;202009;3222;7286;1935;5363;603;1977;209;619;812;2596
500830;202009;18252;45494;12349;34589;2562;7699;4468;11806;7030;19505
500840;202009;1388;3385;851;2372;103;293;337;884;440;1177
510010;202009;1790;4038;1184;3255;107;265;844;2360;951;2625
510020;202009;3341;8458;1764;5365;371;1227;409;1107;780;2334
510025;202009;6577;16037;3970;11743;585;1966;1633;4674;2218;6640
510030;202009;2504;5600;1648;4317;346;925;636;1626;982;2551
510035;202009;1205;3147;756;2429;84;294;450;1531;534;1825
510040;202009;2277;5065;1665;4269;174;432;1034;2769;1208;3201
510050;202009;2089;4389;1372;3460;155;425;954;2361;1109;2786
510060;202009;1293;3284;933;2707;196;626;267;728;463;1354
510080;202009;1215;3206;773;2453;265;867;211;582;476;1449
510100;202009;643;1504;444;1190;55;153;234;605;289;758
510120;202009;270;493;147;347;10;22;107;257;117;279
510125;202009;1998;4939;1558;4305;159;571;828;2141;987;2712
510130;202009;1419;3576;994;2895;211;672;310;928;521;1600
510140;202009;3062;7900;2081;6657;732;2739;740;2238;1472;4977
510160;202009;1694;4365;1233;3766;156;456;893;2796;1049;3252
510170;202009;4410;11639;3199;9675;779;2485;1247;3836;2026;6321
510180;202009;14636;32749;9188;24723;2000;5903;2744;8332;4744;14235
510185;202009;1698;4373;1099;3511;438;1426;279;1149;717;2575
510190;202009;2063;5873;1321;4617;365;1403;233;889;598;2292
510250;202009;16708;42083;12314;35486;2391;7229;6145;18396;8536;25625
510260;202009;1880;7919;1554;7325;260;1322;940;4832;1200;6154
510263;202009;3110;8656;1907;6184;320;1170;310;859;630;2029
510267;202009;4834;13681;2735;9008;499;1749;381;1121;880;2870
510268;202009;1245;3037;942;2580;110;286;618;1691;728;1977
510269;202009;986;2673;598;1933;143;509;184;550;327;1059
510270;202009;2886;8209;1968;6545;346;1290;813;2666;1159;3956
510279;202009;1735;4462;1067;3291;200;689;436;1302;636;1991
510285;202009;1115;2931;761;2319;241;820;162;445;403;1265
510300;202009;3610;9121;2638;7801;370;1133;1549;4793;1919;5926
510305;202009;1413;3880;851;2780;182;635;197;719;379;1354
510310;202009;904;2209;605;1705;169;495;171;506;340;1001
510320;202009;3598;8911;2442;6924;548;1705;616;1722;1164;3427
510325;202009;4232;12430;3135;10416;891;3139;932;3205;1823;6344
510330;202009;2651;7999;1782;6456;345;1257;658;2764;1003;4021
510335;202009;4783;13669;3598;11766;541;1915;2028;6791;2569;8706
510336;202009;440;1237;315;1036;52;171;158;575;210;746
510337;202009;1489;4312;948;3326;366;1412;185;656;551;2068
510340;202009;90688;201226;56888;151867;13767;43522;16701;41856;30468;85378
510343;202009;1002;2750;680;2151;121;437;286;859;407;1296
510345;202009;1244;3553;931;2937;155;488;420;1304;575;1792
510350;202009;2823;7259;1835;5575;397;1293;736;2169;1133;3462
510360;202009;1848;3837;1185;3057;69;135;817;2277;886;2412
510370;202009;1759;4939;1270;4100;182;647;733;2475;915;3122
510380;202009;559;1370;307;938;52;184;117;352;169;536
510385;202009;1209;4032;885;3424;90;407;559;2230;649;2637
510390;202009;1242;3288;836;2761;250;834;277;1076;527;1910
510395;202009;718;1617;478;1263;26;73;298;836;324;909
510410;202009;4683;13033;3386;10707;659;2174;1741;5711;2400;7885
510420;202009;2420;5083;1635;4037;135;353;1058;2603;1193;2956
510450;202009;426;1062;249;724;60;175;38;125;98;300
510452;202009;783;2174;558;1752;77;259;323;987;400;1246
510454;202009;934;2559;713;2178;76;234;438;1399;514;1633
510455;202009;925;2548;662;2017;110;360;269;763;379;1123
510460;202009;1746;4324;1235;3563;93;331;793;2199;886;2530
510480;202009;4561;10939;2969;8035;565;1693;1182;3129;1747;4822
510490;202009;1657;4276;1232;3742;175;530;801;2463;976;2993
510500;202009;1495;3740;920;2803;183;593;304;936;487;1529
510510;202009;3407;9905;2509;8296;601;2247;801;2772;1402;5019
510515;202009;5236;13386;3420;10122;800;2666;899;2325;1699;4991
510517;202009;1027;2994;779;2570;235;870;144;412;379;1282
510520;202009;2081;4229;1180;3102;93;240;599;1696;692;1936
510523;202009;1112;2734;822;2274;177;470;472;1349;649;1819
510525;202009;7249;19754;5377;16083;836;2765;2583;7319;3419;10084
510530;202009;553;1421;402;1197;29;93;256;748;285;841
510550;202009;2333;6885;1671;5722;387;1395;749;2567;1136;3962
510558;202009;2253;6025;1622;5023;224;665;746;2519;970;3184
510560;202009;1582;4525;933;3227;193;758;231;866;424;1624
510562;202009;5574;14402;4013;11585;940;2929;1339;4061;2279;6990
510590;202009;3131;7669;2213;6501;172;526;1568;4704;1740;5230
510600;202009;1378;3118;884;2401;160;439;398;1096;558;1535
510610;202009;2598;6263;1773;5180;173;572;1108;3252;1281;3824
510615;202009;2635;6537;1827;5235;303;907;977;2859;1280;3766
510617;202009;975;2937;746;2562;101;398;467;1666;568;2064
510618;202009;1227;3242;843;2575;189;632;386;1125;575;1757
510619;202009;750;1874;477;1412;64;198;137;377;201;575
510620;202009;1411;3163;656;1931;173;623;38;77;211;700
510621;202009;1538;4097;926;2913;199;705;293;852;492;1557
510622;202009;4478;12593;3010;9439;1005;3373;422;1216;1427;4589
510623;202009;2670;6565;1873;5306;452;1499;597;1633;1049;3132
510624;202009;1650;4143;768;2532;91;327;174;519;265;846
510625;202009;2840;6928;1510;4532;249;891;332;1010;581;1901
510626;202009;1483;3579;920;2676;250;848;212;617;462;1465
510627;202009;604;1563;335;1036;82;281;82;269;164;550
510628;202009;1441;3313;946;2649;192;571;359;990;551;1561
510629;202009;1544;4377;1133;3634;223;765;414;1325;637;2090
510630;202009;3265;9047;1885;6411;434;1576;336;1222;770;2798
510631;202009;578;1382;415;1137;14;38;315;893;329;931
510637;202009;3407;8170;2436;6765;612;1915;689;1927;1301;3842
510642;202009;5371;15231;4054;13223;974;3461;1759;5853;2733;9314
510645;202009;979;1883;575;1371;175;386;224;550;399;936
510650;202009;6956;17778;5493;16167;631;1677;3744;12209;4375;13886
510665;202009;1898;4086;1166;2901;245;585;431;1157;676;1742
510670;202009;432;926;250;665;25;67;138;376;163;443
510675;202009;6183;16964;4220;13281;1175;4070;786;2375;1961;6445
510677;202009;2071;5308;1418;4317;198;695;762;2255;960;2950
510680;202009;691;1765;380;1173;72;250;80;225;152;475
510682;202009;1499;4400;1086;3713;374;1416;243;801;617;2217
510685;202009;525;1530;374;1218;58;205;187;603;245;808
510700;202009;4063;9743;2824;7989;266;830;2069;5834;2335;6664
510704;202009;10633;24882;6931;18508;1527;4400;1759;4546;3286;8946
510706;202009;1991;5970;1404;4983;268;975;734;2827;1002;3802
510710;202009;2640;6570;1702;4802;374;1089;564;1533;938;2622
510715;202009;596;1316;431;1088;34;106;212;520;246;626
510718;202009;2356;5273;1362;3934;396;1148;464;1631;860;2779
510719;202009;441;932;255;687;22;61;148;377;170;438
510720;202009;878;2049;565;1575;93;296;266;700;359;996
510724;202009;813;2191;557;1707;81;260;303;905;384;1165
510726;202009;1038;1882;546;1286;63;163;262;626;325;789
510729;202009;597;1388;260;748;33;108;62;195;95;303
510730;202009;2890;6969;1922;5452;245;788;957;2655;1202;3443
510735;202009;995;2851;751;2505;75;314;550;1809;625;2123
510740;202009;944;2330;593;1674;106;301;265;738;371;1039
510757;202009;503;1544;394;1376;123;470;143;487;266;957
510760;202009;43506;95299;25808;68071;5233;15895;8144;19698;13377;35593
510770;202009;4213;9466;2849;7746;245;626;1925;5496;2170;6122
510774;202009;341;867;234;691;35;103;125;378;160;481
510775;202009;603;1601;383;1237;80;286;82;242;162;528
510776;202009;426;1063;299;827;72;197;100;298;172;495
510777;202009;1485;3959;1059;3404;149;549;673;2144;822;2693
510779;202009;671;1807;517;1558;57;165;294;966;351;1131
510780;202009;3703;9414;2700;7991;661;1931;1153;3872;1814;5803
510785;202009;1965;5197;1133;3668;296;1035;185;685;481;1720
510787;202009;2623;7403;1717;5503;544;1845;196;628;740;2473
510788;202009;588;1386;413;1116;66;186;195;598;261;784
510790;202009;17679;45392;10748;32545;2286;7750;1801;4859;4087;12609
510792;202009;9191;24976;5656;18136;1211;4391;954;2697;2165;7088
510794;202009;1204;3191;814;2521;251;859;155;425;406;1284
510795;202009;8094;21247;5243;16057;1182;4006;1379;4149;2561;8155
510800;202009;1664;4294;1079;3293;346;1071;137;405;483;1476
510805;202009;1486;4115;1027;3258;253;849;339;984;592;1833
510810;202009;618;1263;389;955;105;262;154;401;259;663
510820;202009;751;1429;415;1001;34;100;214;522;248;622
510830;202009;842;2037;603;1730;51;145;423;1296;474;1441
510835;202009;560;1345;365;1059;39;133;222;627;261;760
510840;202009;55216;116245;37312;94297;7311;17406;18180;51013;25491;68419
510850;202009;1792;4304;1015;3067;329;1135;131;364;460;1499
510860;202009;2315;6127;1425;4604;434;1638;114;356;548;1994
510880;202009;708;1990;531;1656;129;414;189;595;318;1009
510885;202009;566;1377;392;1132;81;256;128;362;209;618
510890;202009;642;1871;478;1590;108;380;214;713;322;1093
510895;202009;1272;3235;847;2543;169;602;366;1028;535;1630
520005;202009;2589;6567;1988;5829;577;1705;824;2778;1401;4483
520010;202009;2235;6352;1604;5155;394;1410;493;1409;887;2819
520013;202009;2752;7058;1793;5290;394;1194;515;1661;909;2855
520015;202009;505;1268;358;1049;82;248;143;439;225;687
520017;202009;1172;2958;869;2493;163;500;470;1324;633;1824
520020;202009;400;883;306;765;24;79;237;563;261;642
520025;202009;33101;92299;28273;85501;2859;9375;20252;60950;23111;70325
520030;202009;5666;14341;4515;12727;315;977;3197;8942;3512;9919
520050;202009;405;949;251;686;14;41;159;446;173;487
520055;202009;1802;4335;1157;3082;104;258;652;1693;756;1951
520060;202009;1411;3862;1012;3130;259;897;253;781;512;1678
520080;202009;1774;4598;1320;3979;231;701;645;2126;876;2827
520082;202009;908;2297;706;1961;75;200;380;1108;455;1308
520085;202009;814;2170;629;1867;112;338;307;896;419;1234
520090;202009;835;1637;571;1347;61;98;434;1081;495;1179
520110;202009;38169;102187;26219;82191;7908;28336;2322;6589;10230;34925
520120;202009;202;474;116;338;14;49;47;134;61;183
520130;202009;3646;8904;2842;7656;569;1544;1208;3354;1777;4898
520140;202009;40438;107610;27832;85965;9883;33160;3588;11511;13471;44671
520145;202009;602;1389;408;1113;62;195;243;611;305;806
520150;202009;624;1406;452;1197;74;195;244;659;318;854
520160;202009;746;1733;538;1404;107;269;234;655;341;924
520170;202009;4903;9848;3232;7933;178;502;2482;6036;2660;6538
520180;202009;2189;5937;1780;5348;323;1061;992;2963;1315;4024
520215;202009;1687;4056;1191;3290;279;833;410;1076;689;1909
520235;202009;593;1355;341;968;37;128;130;358;167;486
520250;202009;1550;3926;1065;3103;328;1029;246;782;574;1811
520260;202009;796;1848;504;1387;97;275;208;594;305;869
520280;202009;705;1720;545;1474;113;308;259;747;372;1055
520310;202009;1039;2258;676;1715;147;425;263;699;410;1124
520320;202009;1612;4323;1213;3680;156;511;660;1967;816;2478
520330;202009;3885;10388;2814;8648;415;1509;1476;4435;1891;5944
520340;202009;2436;5362;1519;4082;178;450;884;2490;1062;2940
520350;202009;2830;6739;2007;5499;590;1700;764;2123;1354;3823
520355;202009;1834;4974;1294;3899;436;1425;272;706;708;2131
520357;202009;740;1776;526;1462;30;77;390;1119;420;1196
520360;202009;706;1836;535;1556;142;435;155;482;297;917
520380;202009;1410;3493;826;2408;88;269;415;1137;503;1406
520390;202009;1010;2214;592;1693;161;500;202;623;363;1123
520393;202009;496;1181;327;917;39;125;149;390;188;515
520396;202009;834;2142;693;1919;39;129;515;1385;554;1514
520400;202009;1619;3940;1236;3420;160;486;836;2296;996;2782
520410;202009;1969;4432;1180;3215;198;585;453;1178;651;1763
520420;202009;366;843;284;718;21;57;223;541;244;598
520425;202009;1448;3535;800;2321;205;625;149;415;354;1040
520430;202009;2276;5219;1266;3629;232;776;45;122;277;898
520440;202009;2932;7069;1747;4980;427;1335;459;1239;886;2574
520450;202009;11882;28073;7822;21982;2434;7494;1523;4394;3957;11888
520455;202009;699;1907;507;1615;143;480;140;464;283;944
520460;202009;1012;2349;783;2058;73;167;629;1686;702;1853
520465;202009;771;1938;616;1729;78;258;436;1172;514;1430
520470;202009;2030;5229;1546;4583;478;1475;588;1865;1066;3340
520480;202009;925;2557;631;2048;191;643;144;489;335;1132
520485;202009;1539;4352;1285;3998;158;501;916;2846;1074;3347
520490;202009;3970;10904;2948;9254;1010;3275;1052;3444;2062;6719
520495;202009;1586;3472;1195;2941;51;127;963;2372;1014;2499
520500;202009;1196;3220;807;2453;192;630;320;973;512;1603
520505;202009;768;1681;531;1379;61;168;346;886;407;1054
520510;202009;7657;18952;5030;14873;1136;3760;1420;4498;2556;8258
520520;202009;1141;2862;838;2382;196;610;304;867;500;1477
520530;202009;2096;5825;1570;4961;416;1391;648;2125;1064;3516
520540;202009;2849;7451;1763;5312;319;1038;451;1270;770;2308
520545;202009;945;2453;703;2059;148;427;286;853;434;1280
520547;202009;800;2172;638;1902;152;455;321;965;473;1420
520549;202009;13545;35850;11174;32380;1473;4522;7586;21816;9059;26338
520551;202009;4501;12050;3734;10922;389;1335;2655;7590;3044;8925
520552;202009;813;2086;667;1899;140;394;383;1156;523;1550
520570;202009;522;1157;344;907;85;196;134;404;219;600
520580;202009;2189;4962;1651;4334;113;365;1218;3139;1331;3504
520590;202009;1253;3110;860;2482;268;785;226;668;494;1453
520620;202009;7937;21417;6191;18860;1557;4896;2734;8622;4291;13518
520630;202009;738;1881;512;1485;85;261;150;411;235;672
520640;202009;2347;5806;1785;4827;415;1106;750;2105;1165;3211
520650;202009;848;1975;623;1662;92;243;349;985;441;1228
520660;202009;533;1285;281;841;53;183;75;218;128;401
520670;202009;941;2520;787;2300;63;191;522;1501;585;1692
520680;202009;690;1746;515;1467;80;223;265;767;345;990
520690;202009;326;755;220;601;67;169;69;215;136;384
520710;202009;411;989;288;779;12;28;208;551;220;579
520725;202009;1499;3507;1014;2723;118;367;633;1631;751;1998
520735;202009;765;1863;499;1425;106;286;187;578;293;864
520740;202009;2085;4667;1559;4048;267;639;880;2475;1147;3114
520750;202009;654;1569;449;1239;79;209;217;606;296;815
520753;202009;1258;3337;951;2769;185;578;382;1044;567;1622
520760;202009;1192;2664;1045;2489;29;54;958;2318;987;2372
520780;202009;1485;3452;1049;2838;116;322;535;1434;651;1756
520790;202009;3382;8022;2378;6371;334;900;1291;3634;1625;4534
520800;202009;16226;41765;12536;36358;1886;5700;7322;21853;9208;27553
520810;202009;1318;2724;971;2328;158;392;620;1572;778;1964
520815;202009;565;1717;420;1422;77;289;118;410;195;699
520830;202009;1828;3834;1294;3233;52;104;1067;2649;1119;2753
520840;202009;2550;6807;2057;6167;860;2798;555;1777;1415;4575
520850;202009;639;1641;469;1388;158;545;124;373;282;918
520860;202009;6342;16988;4577;14110;1208;4032;1664;5054;2872;9086
520870;202009;105974;244427;70593;191624;15364;45224;25135;67013;40499;112237
520880;202009;6659;19095;5109;16320;1177;3949;1887;6065;3064;10014
520890;202009;3909;9365;2642;7378;509;1558;1155;3196;1664;4754
520910;202009;4539;11393;2852;8465;696;2221;672;1960;1368;4181
520915;202009;704;1963;414;1304;68;232;138;422;206;654
520920;202009;4338;9698;3026;8040;391;1081;1655;4593;2046;5674
520929;202009;685;1600;512;1346;64;136;269;758;333;894
520940;202009;954;2518;735;2212;43;137;537;1586;580;1723
520945;202009;474;1062;377;924;14;33;272;653;286;686
520960;202009;1035;2482;812;2141;178;407;449;1238;627;1645
520970;202009;2506;6851;1940;5935;476;1645;494;1624;970;3269
520980;202009;773;1865;561;1575;101;299;227;619;328;918
520990;202009;2967;7856;2367;7068;351;998;1546;4731;1897;5729
520993;202009;1139;2665;780;2103;116;353;439;1125;555;1478
520995;202009;2245;5658;1672;4853;262;768;654;1963;916;2731
521000;202009;8495;22096;5557;16798;1120;3521;1675;5034;2795;8555
521010;202009;3589;9313;2669;7717;258;745;1551;4448;1809;5193
521015;202009;791;1934;541;1499;43;135;338;893;381;1028
521020;202009;3210;8149;1862;5554;551;1844;134;421;685;2265
521030;202009;489;1071;325;821;69;155;134;367;203;522
521040;202009;7623;18615;5581;15375;1208;3474;2333;6574;3541;10048
521056;202009;921;2415;717;2109;224;653;193;638;417;1291
521060;202009;960;2547;706;2083;104;320;287;845;391;1165
521080;202009;1128;2414;572;1553;80;233;239;563;319;796
521090;202009;3220;8602;2163;6504;591;1902;271;857;862;2759
521100;202009;1750;4052;1234;3320;194;511;736;2005;930;2516
521120;202009;4618;10799;3318;9196;200;508;1624;5256;1824;5764
521130;202009;997;2234;553;1467;20;61;291;819;311;880
521140;202009;1251;3211;904;2603;112;340;438;1278;550;1618
521150;202009;12319;26857;7583;20093;1274;3921;3551;9610;4825;13531
521160;202009;633;1318;446;1045;49;111;293;664;342;775
521170;202009;1018;2366;732;1947;55;153;491;1271;546;1424
521180;202009;7209;19817;5899;17544;940;3042;3080;8864;4020;11906
521190;202009;10551;26156;6088;18639;1527;4984;1253;4085;2780;9069
521200;202009;700;1693;484;1340;48;143;276;763;324;906
521205;202009;624;1537;467;1287;16;53;352;923;368;976
521210;202009;682;1739;387;1148;76;240;72;162;148;402
521220;202009;3583;8709;2286;6672;390;1273;870;2521;1260;3794
521225;202009;387;819;280;703;53;129;156;399;209;528
521230;202009;1352;3426;1188;3224;376;1035;590;1712;966;2747
521250;202009;30853;81642;23741;71187;8718;27433;6888;22048;15606;49481
521260;202009;552;1268;397;1023;56;145;226;576;282;721
521270;202009;1815;4547;1574;4264;89;206;1194;3254;1283;3460
521280;202009;1779;4750;1316;3975;312;1043;555;1692;867;2735
521290;202009;480;1110;334;922;44;139;210;565;254;704
521295;202009;1113;2401;842;2104;64;115;689;1783;753;1898
521300;202009;1877;4581;1468;4003;276;703;911;2573;1187;3276
521305;202009;719;1706;510;1393;76;192;288;793;364;985
521308;202009;4753;12653;3284;9843;305;903;1919;5656;2224;6559
521310;202009;8168;20763;5614;16466;1211;3884;2333;6537;3544;10421
521340;202009;410;960;299;797;20;56;196;502;216;558
521350;202009;2019;5102;1514;4341;129;459;1069;2916;1198;3375
521370;202009;1227;3104;721;2226;206;731;91;307;297;1038
521375;202009;1295;3135;866;2520;196;568;268;870;464;1438
521377;202009;1493;3131;1085;2631;95;160;870;2221;965;2381
521380;202009;6126;16174;3920;12098;416;1405;1029;3405;1445;4810
521385;202009;646;1542;497;1351;56;142;285;835;341;977
521390;202009;708;1725;492;1403;142;446;180;541;322;987
521400;202009;2641;6060;2040;5329;223;567;1409;3784;1632;4351
521405;202009;1287;3284;926;2658;174;512;449;1275;623;1787
521410;202009;799;2133;591;1765;103;296;294;933;397;1229
521440;202009;1165;2915;830;2406;281;892;230;674;511;1566
521450;202009;3923;11568;2860;9505;758;2528;718;2564;1476;5092
521460;202009;5652;14756;3918;11676;1310;4087;897;2750;2207;6837
521470;202009;605;1630;360;1117;48;144;119;362;167;506
521480;202009;364;913;216;632;46;133;70;198;116;331
521483;202009;2421;5719;1665;4570;353;1039;660;1788;1013;2827
521486;202009;1773;4168;1315;3525;83;206;948;2538;1031;2744
521487;202009;407;994;285;823;43;124;142;423;185;547
521490;202009;903;2372;661;1977;38;137;448;1297;486;1434
521500;202009;2267;5469;1666;4532;102;342;1202;3174;1304;3516
521520;202009;723;1671;508;1355;74;208;209;568;283;776
521523;202009;11537;35113;9398;31632;2618;9665;2475;8634;5093;18299
521525;202009;1055;2381;779;1996;82;210;557;1417;639;1627
521530;202009;2251;5789;1322;3903;283;858;355;1054;638;1912
521540;202009;840;2100;567;1649;73;244;277;832;350;1076
521550;202009;1598;4012;845;2491;150;502;217;654;367;1156
521560;202009;4509;11729;3067;9776;457;1711;1541;5223;1998;6934
521565;202009;636;1520;484;1307;70;172;296;793;366;965
521570;202009;3389;9220;2218;6945;433;1594;201;667;634;2261
521580;202009;489;1176;281;819;40;118;90;240;130;358
521590;202009;643;1502;469;1255;81;239;270;706;351;945
521600;202009;383;1020;249;759;34;84;110;336;144;420
521630;202009;1659;3608;1002;2642;200;570;346;884;546;1454
521640;202009;1812;4170;1199;3291;259;747;414;1122;673;1869
521645;202009;546;1411;343;1040;82;237;111;338;193;575
521680;202009;1088;3281;832;2783;241;877;126;463;367;1340
521690;202009;538;1290;444;1166;60;168;280;722;340;890
521710;202009;3199;7910;2019;5983;363;1226;505;1391;868;2617
521720;202009;2192;5036;1403;3837;147;449;781;2152;928;2601
521730;202009;3564;9868;2700;8358;735;2687;766;1992;1501;4679
521740;202009;3849;9984;2869;8543;693;2223;1074;3343;1767;5566
521760;202009;14740;40117;11306;34804;2849;9705;4167;13467;7016;23172
521770;202009;3005;7144;1956;5451;579;1742;498;1399;1077;3141
521800;202009;6455;17161;4640;14124;1047;3250;1838;6069;2885;9319
521805;202009;484;1171;357;991;105;267;153;439;258;706
521810;202009;617;1443;433;1192;60;165;259;725;319;890
521830;202009;5469;15104;4306;13302;290;1089;3097;9381;3387;10470
521839;202009;735;1724;511;1363;85;260;277;657;362;917
521850;202009;5488;12712;3434;9650;581;1845;643;1739;1224;3584
521860;202009;1517;3995;1034;3146;186;620;318;951;504;1571
521870;202009;685;1903;488;1514;101;344;126;347;227;691
521878;202009;674;1728;454;1296;56;188;246;634;302;822
521880;202009;18595;45104;12459;35624;3128;9402;4367;12727;7495;22129
521890;202009;3046;7850;1986;5985;556;1825;368;1018;924;2843
521900;202009;1480;3449;821;2425;231;652;86;252;317;904
521910;202009;1238;2608;812;2109;74;191;452;1287;526;1478
521920;202009;476;1295;349;1074;64;220;149;438;213;658
521925;202009;750;1936;542;1632;83;261;297;886;380;1147
521930;202009;5410;12901;3528;10021;907;2408;1316;4172;2223;6580
521935;202009;1051;2491;697;1867;68;196;407;1029;475;1225
521940;202009;1339;2930;852;2265;198;586;339;879;537;1465
521945;202009;603;1613;486;1420;103;308;263;780;366;1088
521950;202009;749;1802;515;1433;122;344;207;558;329;902
521960;202009;715;1837;460;1361;55;177;241;663;296;840
521970;202009;2529;6167;2003;5536;164;452;1517;4243;1681;4695
521971;202009;756;1773;530;1441;152;406;150;417;302;823
521973;202009;1401;3595;1114;3167;41;118;869;2455;910;2573
521975;202009;11927;31253;9687;28114;1592;4813;5990;17465;7582;22278
521980;202009;2532;5875;1932;5076;151;388;1447;3898;1598;4286
521990;202009;1072;3015;845;2608;185;605;303;934;488;1539
522000;202009;2610;6812;2095;6173;311;904;1297;4014;1608;4918
522005;202009;340;820;252;685;52;133;124;349;176;482
522010;202009;3953;9585;2768;7670;609;1861;1025;2760;1634;4621
522015;202009;1008;2611;739;2198;232;669;267;832;499;1501
522020;202009;5495;13009;3564;9947;728;2125;1423;4109;2151;6234
522026;202009;771;2047;513;1577;91;308;182;515;273;823
522028;202009;422;1031;311;852;70;195;133;361;203;556
522040;202009;3083;6920;2170;5699;273;765;1454;3774;1727;4539
522045;202009;17364;48030;12739;39771;3012;10147;3486;10593;6498;20740
522050;202009;1094;2861;741;2249;200;680;256;690;456;1370
522060;202009;2919;7581;2011;6071;181;540;1158;3606;1339;4146
522068;202009;1815;4581;1413;4096;119;319;1108;3254;1227;3573
522070;202009;653;1569;525;1379;20;57;436;1125;456;1182
522100;202009;728;1857;488;1472;60;207;253;730;313;937
522108;202009;1009;2515;780;2188;55;187;618;1686;673;1873
522119;202009;1584;3861;1208;3362;198;566;622;1839;820;2405
522130;202009;394;1000;281;841;26;74;192;600;218;674
522140;202009;17516;46294;12110;36571;3134;10151;3235;9386;6369;19537
522145;202009;791;1936;527;1532;148;414;182;535;330;949
522150;202009;1063;2582;748;2062;206;567;221;640;427;1207
522155;202009;1087;2724;830;2318;163;406;462;1341;625;1747
522157;202009;592;1389;483;1249;27;87;382;989;409;1076
522160;202009;5953;15328;3805;11378;1033;3327;301;984;1334;4311
522170;202009;2611;6650;1947;5653;295;870;1095;3242;1390;4112
522180;202009;530;1222;340;886;60;165;83;233;143;398
522185;202009;18650;45887;13044;38164;5060;16114;2747;8721;7807;24835
522190;202009;766;1834;515;1398;96;274;198;522;294;796
522200;202009;1619;4582;1062;3510;220;790;189;567;409;1357
522205;202009;1689;3914;1282;3366;142;398;863;2267;1005;2665
522220;202009;1268;3123;931;2611;113;335;544;1554;657;1889
522230;202009;1120;2821;887;2486;202;685;435;1136;637;1821
530010;202009;170937;455971;136562;405131;21004;68323;79454;231994;100458;300317
110001;202008;3961;11092;2638;8592;602;2105;1019;3376;1621;5481
110002;202008;12853;33293;9058;26698;2498;7851;2410;7205;4908;15056
110003;202008;621;1821;434;1430;102;359;108;339;210;698
110004;202008;11387;29616;7501;22610;1555;5146;2250;6889;3805;12035
110005;202008;2518;6538;1699;5164;355;1177;449;1483;804;2660
110006;202008;1792;4979;1111;3525;196;714;216;651;412;1365
110007;202008;1208;3097;761;2336;242;794;186;704;428;1498
110008;202008;3298;9109;2406;7742;269;842;1592;5468;1861;6310
110009;202008;4319;12106;2751;9222;599;2128;1109;3751;1708;5879
110010;202008;7665;24548;5588;20429;1124;4195;2711;10728;3835;14923
110011;202008;6897;18358;4658;14268;1637;5265;654;2104;2291;7369
110012;202008;15761;39378;9191;27659;2118;6915;826;2648;2944;9563
110013;202008;5249;15264;3746;12157;1508;5166;461;1666;1969;6832
110014;202008;3860;10194;2629;7865;592;1890;1062;3091;1654;4981
110015;202008;5770;14854;3370;10121;739;2423;767;2120;1506;4543
110018;202008;3734;9405;2143;6601;411;1483;594;1809;1005;3292
110020;202008;75319;180073;53580;150078;11769;34043;21871;67593;33640;101636
110025;202008;5199;12531;3424;9440;715;2116;1508;4180;2223;6296
110026;202008;513;1283;369;1077;84;275;154;475;238;750
110028;202008;6836;17396;4071;12345;1027;3401;614;1889;1641;5290
110029;202008;1529;3745;887;2613;200;602;317;980;517;1582
110030;202008;12846;29571;7859;22104;1684;5543;1518;4641;3202;10184
110032;202008;3056;8671;1933;6265;604;1956;394;1376;998;3332
110033;202008;3623;11319;2787;9771;996;3541;690;2699;1686;6240
110034;202008;3413;7973;2238;6349;667;2133;760;2327;1427;4460
110037;202008;1652;4867;1228;4118;263;876;593;2038;856;2914
110040;202008;2968;8257;2111;6665;604;2064;643;1962;1247;4026
110045;202008;5001;14446;3713;12063;983;3447;1283;4249;2266;7696
110050;202008;1826;4921;1275;3965;495;1677;219;707;714;2384
110060;202008;898;2659;608;1967;208;726;76;244;284;970
110070;202008;1579;4997;1178;4109;374;1391;237;747;611;2138
110080;202008;6294;14646;4635;12677;629;1614;3021;8851;3650;10465
110090;202008;570;1533;407;1242;93;311;184;547;277;858
110092;202008;1172;3388;839;2762;149;505;417;1484;566;1989
110094;202008;2830;8440;2114;7065;886;3157;299;1003;1185;4160
110100;202008;1707;5038;1368;4379;372;1261;572;1861;944;3122
110110;202008;1706;4705;1178;3794;384;1276;272;954;656;2230
110120;202008;1327;3822;1003;3187;236;824;340;1043;576;1867
110130;202008;2707;6773;1693;4923;301;992;443;1230;744;2222
110140;202008;2070;6072;1388;4655;347;1227;360;1242;707;2469
110143;202008;1385;3783;941;2885;286;891;155;484;441;1375
110145;202008;898;2352;547;1693;126;408;194;616;320;1024
110146;202008;473;1225;333;1010;66;182;163;540;229;722
110147;202008;799;2074;501;1485;70;228;191;493;261;721
110148;202008;773;2108;438;1444;119;448;46;148;165;596
110149;202008;2980;8172;2044;6660;702;2428;447;1544;1149;3972
110150;202008;2784;6779;1830;5431;542;1771;447;1604;989;3375
110155;202008;740;2170;516;1631;112;381;176;522;288;903
110160;202008;1448;4519;1062;3652;312;1102;259;912;571;2014
110170;202008;2178;5584;1325;3957;245;775;680;1957;925;2732
110175;202008;1688;4719;1194;3847;182;640;524;1770;706;2410
110180;202008;1423;3900;980;3001;145;469;503;1532;648;2001
120001;202008;3275;9596;2676;8708;427;1450;1694;5674;2121;7124
120005;202008;1942;7421;1757;7157;152;683;1403;5802;1555;6485
120010;202008;5337;16061;4508;14818;428;1378;3274;11111;3702;12489
120013;202008;2169;7620;1912;7308;420;1541;1193;4881;1613;6422
120017;202008;2442;7960;2146;7508;340;1193;1367;5064;1707;6257
120020;202008;14999;58580;13754;56144;1083;5030;10829;44537;11912;49567
120025;202008;3126;8885;2497;8123;373;1197;1723;5809;2096;7006
120030;202008;6500;25645;6017;24729;430;2276;4660;19317;5090;21593
120032;202008;1705;7595;1611;7421;107;683;1332;6025;1439;6708
120033;202008;4090;15149;3845;14720;122;699;3363;12756;3485;13455
120034;202008;2664;9667;2272;8977;115;681;1877;7293;1992;7974
120035;202008;3741;14722;3545;14380;291;1413;2903;11774;3194;13187
120038;202008;2693;8646;2290;7981;532;1919;1226;4361;1758;6280
120039;202008;2026;8731;1892;8459;124;778;1525;6757;1649;7535
120040;202008;44543;139906;37746;128733;5348;19298;23459;81163;28807;100461
120042;202008;3317;12430;3050;11935;146;788;2549;9893;2695;10681
120043;202008;1384;5627;1260;5426;37;220;1156;4986;1193;5206
120045;202008;6214;15970;5384;15043;125;514;4899;13550;5024;14064
120050;202008;9363;33727;8548;32473;393;2082;7147;27200;7540;29282
120060;202008;9565;36992;8754;35785;386;2309;7627;30966;8013;33275
120070;202008;3161;10112;2728;9517;243;862;1969;7125;2212;7987
120080;202008;4252;13638;3774;12926;460;1663;2775;9680;3235;11343
130002;202008;3133;12205;2792;11709;198;820;2353;10084;2551;10904
130006;202008;2442;9034;2021;8273;179;755;1512;6245;1691;7000
130008;202008;2676;9331;2363;8870;69;370;2046;7680;2115;8050
130010;202008;3980;11540;3336;10799;83;238;3065;10071;3148;10309
130014;202008;3206;9445;2459;8209;427;1430;1509;5161;1936;6591
130020;202008;2896;11104;2581;10622;140;819;2062;8414;2202;9233
130030;202008;10253;32951;9312;31844;338;1105;8241;28655;8579;29760
130040;202008;4087;11951;3392;11020;193;588;2807;9246;3000;9834
130050;202008;7603;27797;6320;26093;159;827;5736;23918;5895;24745
130060;202008;7624;30071;6522;28615;424;2332;5394;23661;5818;25993
130063;202008;6465;20903;5744;20097;206;884;5217;18358;5423;19242
130068;202008;3857;13428;3258;12543;205;1158;2498;9509;2703;10667
130070;202008;7633;21413;6233;19880;290;886;5150;16960;5440;17846
130080;202008;7242;25856;6308;24770;249;1352;5378;21471;5627;22823
130083;202008;2784;9035;2460;8627;155;615;2085;7370;2240;7985
130090;202008;3576;11020;3164;10503;52;225;2805;9497;2857;9722
130100;202008;8127;24277;6907;22999;67;139;6508;22239;6575;22378
130110;202008;8656;24625;7097;22689;1037;2638;5142;17800;6179;20438
130115;202008;5307;16506;4560;15671;106;365;4013;14016;4119;14381
130120;202008;14319;50472;12585;48144;1087;4575;10203;39422;11290;43997
130130;202008;5442;17024;4189;15364;338;1349;3215;11925;3553;13274
130140;202008;7366;25607;6477;24582;188;1068;5695;21704;5883;22772
130150;202008;3651;13667;3429;13420;80;499;3144;12336;3224;12835
130160;202008;5188;18304;4426;17329;283;1142;3747;15012;4030;16154
130165;202008;3227;12225;3031;11978;118;525;2732;10895;2850;11420
130170;202008;11961;34684;9570;31877;709;2628;7704;26148;8413;28776
130180;202008;4498;14482;4261;14217;41;212;4115;13704;4156;13916
130185;202008;18598;45836;15157;42173;1010;1831;12729;37578;13739;39409
130190;202008;19002;62636;15235;57024;1729;6666;10779;41702;12508;48368
130195;202008;2492;9026;2008;8368;79;463;1687;7003;1766;7466
130200;202008;2606;7294;2142;6689;95;360;1782;5568;1877;5928
130210;202008;1360;5078;1223;4918;102;592;987;3866;1089;4458
130220;202008;2329;7985;1984;7534;52;292;1749;6658;1801;6950
130230;202008;4704;19150;4080;18257;223;1377;3518;15730;3741;17107
130240;202008;12297;36800;9958;33695;184;1100;8954;30286;9138;31386
130250;202008;26619;79180;22792;74856;1677;5013;18323;62659;20000;67672
130255;202008;4565;14980;3963;13925;155;686;3214;11290;3369;11976
130260;202008;266401;739967;216180;667019;58413;191203;99119;316468;157532;507671
130270;202008;9602;33881;7898;31227;1199;4732;5184;21409;6383;26141
130280;202008;3569;14372;3279;14048;90;454;3056;13247;3146;13701
130290;202008;13431;44627;11615;42288;677;2619;9795;36440;10472;39059
130300;202008;4780;16541;4347;15952;146;805;3786;13873;3932;14678
130310;202008;6336;21054;5494;19965;282;1257;4685;17042;4967;18299
130320;202008;3467;11244;2878;10476;371;1307;2094;7918;2465;9225
130330;202008;4662;14884;3757;13778;212;939;3205;11762;3417;12701
130340;202008;23976;74162;20607;70322;1491;4316;17268;61063;18759;65379
130350;202008;3997;14420;3593;13906;148;761;3182;12278;3330;13039
130353;202008;7650;20550;6136;18632;788;2262;4395;13888;5183;16150
130356;202008;5311;16829;4387;15383;771;2641;2654;9899;3425;12540
130360;202008;3003;9880;2592;9317;91;398;2306;8238;2397;8636
130370;202008;5779;22731;5018;21650;303;1677;4044;17385;4347;19062
130380;202008;7494;30936;6936;30142;409;2265;5877;25378;6286;27643
130390;202008;5872;24696;5193;23554;553;2844;3898;17781;4451;20625
130395;202008;2371;7482;2025;6918;188;667;1549;5303;1737;5970
130400;202008;2829;8704;2418;8152;103;311;2160;7411;2263;7722
130406;202008;11153;38781;9358;36572;1779;6949;6228;25344;8007;32293
130410;202008;4267;15103;3629;14020;1077;4396;1664;6599;2741;10995
130420;202008;13904;48437;11573;45505;950;4722;8976;35595;9926;40317
130423;202008;4394;13768;3836;13131;196;860;3356;11398;3552;12258
130426;202008;2809;11143;2612;10908;70;385;2409;10123;2479;10508
130430;202008;4296;12113;3719;11345;238;875;3133;9422;3371;10297
130440;202008;4875;15228;4169;14383;81;358;3863;13415;3944;13773
140002;202008;2218;6543;1925;6181;91;353;1618;5252;1709;5605
140005;202008;3337;9194;2910;8704;135;364;2484;7637;2619;8001
140010;202008;57530;152524;45882;135093;11387;35358;19752;59406;31139;94764
140015;202008;3883;11454;3289;10724;224;713;2868;9512;3092;10225
140017;202008;4456;12335;3861;11582;255;704;3169;9802;3424;10506
140020;202008;5314;15454;4563;14464;232;967;3760;11823;3992;12790
140023;202008;2507;7434;2051;6778;198;662;1560;5283;1758;5945
140028;202008;2055;5284;1736;4876;87;275;1403;3935;1490;4210
140030;202008;5312;13519;4690;12803;342;674;4081;11536;4423;12210
140040;202008;2584;10153;2369;9870;93;569;2140;8792;2233;9361
140045;202008;2605;9521;2188;8947;347;1231;1474;6505;1821;7736
140047;202008;6366;18029;5346;16536;589;1852;3845;12086;4434;13938
140050;202008;1460;4237;1226;3900;124;379;929;3034;1053;3413
140060;202008;1723;4514;1483;4159;117;294;1199;3442;1316;3736
140070;202008;1900;9868;1834;9742;122;849;1523;8013;1645;8862
150010;202008;45767;114126;41296;108383;972;2278;36976;97018;37948;99296
150013;202008;1981;5030;1646;4672;151;300;1279;3885;1430;4185
150020;202008;14542;43709;13437;42265;1470;3870;10958;35599;12428;39469
150030;202008;8907;33353;8092;32345;473;2018;7015;28314;7488;30332
150034;202008;4239;10367;3483;9435;235;576;2899;8038;3134;8614
150040;202008;16503;42653;14488;40425;1275;1966;12096;36735;13371;38701
150050;202008;6990;24336;6367;23510;131;576;5853;21841;5984;22417
150060;202008;22582;60905;18103;54114;2855;8697;11512;35206;14367;43903
150070;202008;6844;25337;5992;24315;234;1111;5341;21919;5575;23030
150080;202008;95214;212168;78784;189675;19043;50173;22605;66654;41648;116827
150085;202008;7839;22464;7082;21566;119;379;6647;20386;6766;20765
150090;202008;9952;36712;9352;35538;714;2708;7487;28710;8201;31418
150095;202008;5706;16619;4961;15688;273;601;4201;13894;4474;14495
150100;202008;2877;10080;2551;9527;201;659;1992;7622;2193;8281
150110;202008;4452;18188;4123;17807;192;874;3786;16486;3978;17360
150120;202008;8250;25419;7813;24897;263;664;6900;22776;7163;23440
150125;202008;760;2008;562;1739;98;366;335;1018;433;1384
150130;202008;22595;65340;19518;60670;3417;9507;12650;41757;16067;51264
150140;202008;259735;597432;218271;539941;32597;77953;126128;324791;158725;402744
150145;202008;4285;13235;3632;12222;934;2888;1950;7296;2884;10184
150150;202008;16270;41739;14172;39046;543;1644;11833;32592;12376;34236
150157;202008;3549;9628;2856;8729;302;912;2003;6425;2305;7337
150160;202008;3042;8967;2829;8657;539;1554;1755;5615;2294;7169
150170;202008;24722;80845;21568;75453;3934;12937;13200;49212;17134;62149
150172;202008;4892;13376;3927;12012;267;741;2978;9411;3245;10152
150175;202008;1630;5144;1359;4618;245;873;783;2694;1028;3567
150178;202008;10581;28369;8757;26243;215;532;7836;23827;8051;24359
150180;202008;22615;79693;20369;77100;1139;3689;17837;69272;18976;72961
150190;202008;6780;22753;6290;22137;252;1161;5582;19535;5834;20696
150195;202008;5145;16555;4855;16098;77;402;4481;14716;4558;15118
150200;202008;5896;17157;5390;16595;64;172;5101;15819;5165;15991
150210;202008;26510;91414;24687;88987;1736;6183;20388;75785;22124;81968
150215;202008;7701;21800;6620;20215;1188;3531;3931;12559;5119;16090
150220;202008;12668;35449;11060;33143;1098;3138;7639;23451;8737;26589
150230;202008;12292;34964;10812;32989;1144;3114;7468;23863;8612;26977
150240;202008;32809;90875;27142;81163;7344;22423;9428;28632;16772;51055
150250;202008;4270;16236;3971;15895;606;2336;3057;12598;3663;14934
150260;202008;2780;9016;2515;8611;156;506;2007;6974;2163;7480
150270;202008;8951;25546;6297;20824;2021;6988;1621;5752;3642;12740
150275;202008;6949;22075;6333;21216;242;922;5479;18306;5721;19228
150276;202008;2375;6249;2027;5837;259;666;1400;4445;1659;5111
150277;202008;5208;13561;4189;12376;319;842;3218;10153;3537;10995
150280;202008;6918;27719;6666;27311;471;1903;5671;23501;6142;25404
150285;202008;3302;11521;2888;10867;237;914;2122;8131;2359;9045
150290;202008;10496;28659;9465;27556;292;618;8554;25535;8846;26153
150293;202008;9471;23259;7205;20273;932;2654;4426;13103;5358;15757
150295;202008;7748;20784;5698;18008;1851;6243;1971;7158;3822;13401
150300;202008;2420;7188;2164;6865;36;126;1973;6295;2009;6421
150304;202008;4144;12224;3409;11087;601;1859;2083;7117;2684;8976
150307;202008;6160;19803;5670;18991;337;1141;4616;15627;4953;16768
150309;202008;6295;18859;5065;16737;875;2875;2841;9829;3716;12704
150310;202008;7324;29009;6972;28591;208;1173;6233;25780;6441;26953
150320;202008;9509;25885;8657;24640;419;1265;6698;19037;7117;20302
150330;202008;14154;45215;13040;43436;1265;3907;9807;33746;11072;37653
150340;202008;2569;7479;2274;7038;336;969;1556;4989;1892;5958
150345;202008;8167;23928;7321;22794;435;1418;6224;19469;6659;20887
150350;202008;9023;22597;8308;21670;703;1310;6845;18443;7548;19753
150360;202008;24512;67085;19603;60874;2075;5146;13885;46117;15960;51263
150370;202008;10868;32934;8909;30289;1015;2903;6463;23685;7478;26588
150375;202008;3600;14442;3240;13922;226;1088;2761;11970;2987;13058
150380;202008;11208;28577;9195;25941;118;442;8126;22943;8244;23385
150390;202008;8009;31874;7173;30557;1087;4044;5102;23034;6189;27078
150400;202008;6614;23556;6342;23048;296;1066;5517;20173;5813;21239
150405;202008;9272;24373;8090;22955;482;1133;6545;19176;7027;20309
150410;202008;1949;6141;1648;5625;225;674;1043;3685;1268;4359
150420;202008;40808;112244;31313;98179;8682;28592;10716;39148;19398;67740
150430;202008;8548;24889;7782;23898;889;2013;6045;19529;6934;21542
150440;202008;5724;18270;5197;17519;798;2346;3589;12762;4387;15108
150442;202008;26877;63492;22036;57416;2332;5923;15219;40562;17551;46485
150445;202008;6322;19544;5545;18363;208;733;4739;15725;4947;16458
150450;202008;5122;21874;4724;21329;364;1780;4058;18364;4422;20144
150460;202008;8423;27653;7693;26724;250;998;6582;23704;6832;24702
150470;202008;21939;56623;19536;53891;362;1008;18371;50709;18733;51717
150475;202008;4939;15463;4255;14427;167;622;3556;12204;3723;12826
150480;202008;13825;44495;12364;42305;2214;6801;8192;29989;10406;36790
150490;202008;8418;29110;7715;28242;284;1171;6827;25159;7111;26330
150495;202008;5314;18180;5073;17839;113;557;4607;16121;4720;16678
150497;202008;2889;9111;2312;8108;507;1805;1206;4560;1713;6365
150500;202008;3319;8498;2943;7970;242;582;2292;6225;2534;6807
150503;202008;4812;12343;3320;10399;983;3318;1065;3828;2048;7146
150506;202008;10461;30932;8776;28644;1877;5350;5429;19726;7306;25076
150510;202008;9980;36065;8613;33500;1281;4662;5611;23071;6892;27733
150520;202008;6990;27367;6685;26986;234;1395;5985;24083;6219;25478
150530;202008;12470;42442;10781;40017;1542;4623;7718;30635;9260;35258
150540;202008;4991;13610;4242;12495;233;620;3536;10487;3769;11107
150543;202008;7426;19843;6112;18190;498;1486;4677;14564;5175;16050
150548;202008;10157;31740;9134;30336;251;1036;8098;26949;8349;27985
150549;202008;2022;5980;1725;5568;47;195;1465;4744;1512;4939
150550;202008;20629;60248;17134;54430;4101;13266;7435;25251;11536;38517
150553;202008;29664;84959;23337;73579;6794;21765;8453;28485;15247;50250
150555;202008;1962;5190;1523;4502;152;352;1042;3246;1194;3598
150560;202008;1859;5647;1649;5231;271;824;979;3227;1250;4051
150563;202008;2561;7681;2151;6971;437;1508;1195;3909;1632;5417
150565;202008;4371;13927;3887;13169;100;435;3247;11103;3347;11538
150570;202008;6333;20113;5893;19498;275;1033;5095;16841;5370;17874
150580;202008;10605;41417;9115;39749;623;3160;7359;33321;7982;36481
150590;202008;8173;27993;6998;26597;177;1043;6356;24068;6533;25111
150600;202008;9762;32266;9053;31407;218;830;8373;29254;8591;30084
150610;202008;2945;8577;2621;8056;91;371;2202;6691;2293;7062
150611;202008;3232;9032;2858;8512;93;350;2521;7463;2614;7813
150613;202008;13512;37120;10170;31359;1887;6177;5002;15416;6889;21593
150616;202008;3492;9526;2536;7945;599;1956;1087;3385;1686;5341
150618;202008;6866;19842;5540;17792;489;1539;3583;12163;4072;13702
150619;202008;6492;18001;5371;16436;200;627;4520;14015;4720;14642
150620;202008;6825;22579;5863;20945;678;2301;3988;14687;4666;16988
150630;202008;6312;16991;5761;16309;417;1101;4792;13711;5209;14812
150635;202008;4853;13262;4069;12002;557;1530;2610;7992;3167;9522
150640;202008;2287;6684;2079;6428;38;103;1928;6045;1966;6148
150650;202008;11680;32386;10136;29895;2970;8288;4450;14367;7420;22655
150655;202008;5847;16680;5286;15863;207;630;4551;13667;4758;14297
150658;202008;4437;12501;3509;11108;536;1787;2122;7103;2658;8890
150660;202008;5766;16449;5115;15524;468;1351;3594;11196;4062;12547
150670;202008;8469;19500;6607;17398;661;1409;5166;14389;5827;15798
150680;202008;69722;202660;53521;176914;12810;41426;23899;89461;36709;130887
150690;202008;2870;7344;2475;6880;88;196;2209;6288;2297;6484
150700;202008;6237;18336;5560;17449;361;916;4404;14243;4765;15159
150710;202008;3812;12655;3456;12081;284;973;2615;9347;2899;10320
150715;202008;5012;14376;4093;12983;300;922;3207;10348;3507;11270
150720;202008;6970;24523;6460;23730;430;1676;5366;19974;5796;21650
150730;202008;12099;36590;10477;34291;1218;4110;7727;26025;8945;30135
150740;202008;4014;11142;3534;10386;297;723;2682;8071;2979;8794
150745;202008;5110;14483;4107;12997;823;2749;2598;8317;3421;11066
150746;202008;1650;5015;1498;4796;79;248;1230;3956;1309;4204
150747;202008;4942;15566;4339;14576;699;2055;2957;10436;3656;12491
150750;202008;3731;11574;3123;10646;222;817;2353;8292;2575;9109
150760;202008;11976;35164;10840;33587;1477;4183;7677;24546;9154;28729
150770;202008;6470;22904;6079;22459;186;554;5537;21099;5723;21653
150775;202008;946;2631;732;2342;134;474;399;1273;533;1747
150780;202008;4549;13635;4028;13027;154;442;3612;11991;3766;12433
150790;202008;5735;16124;4918;15246;234;541;3903;13514;4137;14055
150795;202008;14129;43408;12308;40584;3005;9357;7032;24731;10037;34088
150796;202008;3889;9448;3373;8855;187;444;2861;7629;3048;8073
150797;202008;3971;12254;3418;11463;144;374;2915;9970;3059;10344
150800;202008;13541;42205;12149;40346;1462;4557;9165;31478;10627;36035
150803;202008;7170;22833;6692;22082;389;1172;5665;18904;6054;20076
150805;202008;3506;10732;2969;9947;212;712;2328;7943;2540;8655
150808;202008;6097;17187;4462;14505;1736;6258;613;2278;2349;8536
150810;202008;21020;54792;15919;48653;3358;10458;8049;27285;11407;37743
150812;202008;5427;15174;4757;14068;427;1319;3511;10209;3938;11528
150815;202008;9607;28140;8018;26258;638;2072;6599;21990;7237;24062
150820;202008;12036;32920;10142;30535;1120;2862;7674;24250;8794;27112
150830;202008;11930;43403;11038;42313;427;1816;9557;37686;9984;39502
150835;202008;2382;7848;2016;7199;346;1209;1157;4201;1503;5410
150840;202008;7743;21582;6149;19017;1012;3369;3462;10615;4474;13984
160005;202008;1232;3356;1090;3179;66;225;917;2692;983;2917
160010;202008;2454;6447;2287;6264;20;105;2221;6011;2241;6116
160015;202008;2812;8199;2492;7804;70;236;2295;7213;2365;7449
160020;202008;2087;6685;1825;6357;158;526;1432;5161;1590;5687
160021;202008;1130;4281;1041;4170;61;340;864;3431;925;3771
160023;202008;1275;4482;1123;4228;120;415;787;3149;907;3564
160025;202008;1866;5655;1768;5543;12;38;1721;5416;1733;5454
160027;202008;9073;25115;8096;23861;645;1820;6514;19600;7159;21420
160030;202008;72020;203509;58161;184854;12353;36788;31447;110465;43800;147253
160040;202008;5807;19558;5280;18887;75;339;4945;17820;5020;18159
160050;202008;4825;14537;3776;13115;1419;4716;1307;5684;2726;10400
160053;202008;3804;11725;3442;11267;262;731;2819;9583;3081;10314
160055;202008;914;2647;877;2604;31;98;811;2409;842;2507
160060;202008;25067;66148;20280;60709;941;2954;16070;50532;17011;53486
160070;202008;2752;10373;2460;9921;198;785;1931;8047;2129;8832
160080;202008;3345;10635;2991;10237;31;164;2794;9632;2825;9796
170025;202008;609;1585;436;1324;68;213;226;711;294;924
170030;202008;1226;3717;944;3213;141;484;460;1619;601;2103
170035;202008;1485;3842;1097;3223;89;284;672;1984;761;2268
170040;202008;1903;5334;1498;4762;100;363;927;3062;1027;3425
170070;202008;1867;4345;1318;3642;79;250;783;2254;862;2504
170100;202008;2469;7023;2049;6322;208;580;1287;4118;1495;4698
170105;202008;743;2139;509;1643;136;384;168;572;304;956
170110;202008;968;2921;739;2485;124;429;349;1145;473;1574
170130;202008;1314;3923;936;3191;178;649;440;1535;618;2184
170190;202008;1422;3954;1023;3306;364;1263;166;698;530;1961
170200;202008;2055;4890;1322;3672;206;604;552;1518;758;2122
170210;202008;24888;67545;18785;57320;6420;21359;2348;8237;8768;29596
170215;202008;1338;3548;1059;3159;40;166;834;2477;874;2643
170220;202008;5835;18054;4870;16299;1328;4258;1976;7264;3304;11522
170230;202008;1230;3660;912;3034;268;908;161;589;429;1497
170240;202008;2626;7325;2026;6347;136;515;1437;4386;1573;4901
170255;202008;3953;11448;2799;9332;495;1690;1268;4343;1763;6033
170270;202008;968;2317;637;1847;40;110;371;1073;411;1183
170290;202008;2900;8552;2492;8020;120;394;1944;6454;2064;6848
170300;202008;2012;5379;1616;4787;185;538;1073;3237;1258;3775
170305;202008;630;1727;524;1545;67;233;269;782;336;1015
170307;202008;982;3295;786;2911;108;412;432;1620;540;2032
170310;202008;1590;3945;1095;3149;169;543;513;1476;682;2019
170320;202008;1017;2642;764;2233;65;208;487;1457;552;1665
170330;202008;916;2808;830;2676;40;185;691;2164;731;2349
170360;202008;516;1400;357;1130;25;89;233;700;258;789
170370;202008;1275;3419;910;2789;282;819;230;840;512;1659
170380;202008;1786;5128;1316;4388;90;360;770;2610;860;2970
170382;202008;539;1605;441;1434;31;126;321;1012;352;1138
170384;202008;1543;5498;1253;4929;251;1023;642;2572;893;3595
170386;202008;942;2551;580;1840;78;280;203;624;281;904
170388;202008;620;1764;432;1422;60;215;199;661;259;876
170389;202008;1032;3192;849;2893;42;169;625;2176;667;2345
170390;202008;1739;3960;1303;3425;44;103;1075;2908;1119;3011
170410;202008;572;1668;416;1377;34;140;252;805;286;945
170460;202008;376;979;299;854;40;108;187;553;227;661
170510;202008;920;2615;675;2173;41;159;440;1358;481;1517
170550;202008;6543;17453;4758;14535;1203;3946;1127;3721;2330;7667
170555;202008;1396;3769;1086;3281;67;209;538;1700;605;1909
170560;202008;1030;2876;770;2510;61;213;488;1689;549;1902
170600;202008;1302;3498;1055;3149;233;549;581;1905;814;2454
170610;202008;1644;4349;1176;3648;90;303;716;2199;806;2502
170625;202008;430;1169;267;836;45;138;88;262;133;400
170650;202008;1235;3647;962;3195;132;453;549;1898;681;2351
170700;202008;3346;9853;2484;8183;504;1684;1109;3752;1613;5436
170710;202008;1501;3920;1138;3342;150;482;710;2094;860;2576
170720;202008;1731;4358;1302;3662;234;664;668;1962;902;2626
170730;202008;1059;2861;786;2413;144;394;397;1298;541;1692
170740;202008;2064;6820;1773;6288;154;608;1287;4551;1441;5159
170755;202008;899;2473;619;1986;62;210;307;963;369;1173
170765;202008;1142;2958;790;2387;161;485;342;1080;503;1565
170770;202008;1853;5358;1505;4813;175;533;989;3264;1164;3797
170820;202008;3326;10018;2620;8715;524;1811;1202;4138;1726;5949
170825;202008;986;2283;792;2023;86;205;576;1481;662;1686
170830;202008;1419;3751;1157;3342;152;415;770;2290;922;2705
170900;202008;2763;8541;2313;7892;211;649;1812;6329;2023;6978
170930;202008;3722;10283;2831;8599;653;2101;933;2833;1586;4934
170950;202008;11315;31198;7756;24731;2166;7870;885;3079;3051;10949
170980;202008;462;1223;367;1077;23;84;255;710;278;794
171050;202008;1621;5072;1404;4696;47;214;1167;3884;1214;4098
171070;202008;1337;3816;1139;3523;306;940;491;1778;797;2718
171090;202008;1052;2589;834;2280;78;210;553;1493;631;1703
171110;202008;573;1529;401;1208;62;186;189;527;251;713
171150;202008;1109;2728;670;1976;64;220;406;1186;470;1406
171180;202008;803;2189;533;1670;99;284;218;689;317;973
171190;202008;1756;5890;1509;5455;238;940;905;3373;1143;4313
171195;202008;800;2555;637;2246;84;348;381;1322;465;1670
171200;202008;570;1587;425;1335;81;262;179;565;260;827
171215;202008;365;1014;299;898;34;115;207;601;241;716
171240;202008;761;2515;614;2226;34;181;413;1462;447;1643
171245;202008;667;1994;513;1674;46;179;317;988;363;1167
171250;202008;1021;2681;738;2255;132;428;336;1046;468;1474
171270;202008;474;1670;370;1447;78;303;164;697;242;1000
171280;202008;877;2638;685;2290;67;240;393;1369;460;1609
171320;202008;3972;11119;3043;9473;620;1918;1147;3758;1767;5676
171330;202008;2767;7574;2119;6440;423;1266;984;3122;1407;4388
171360;202008;1401;4051;1106;3616;78;281;791;2660;869;2941
171370;202008;694;1748;525;1509;50;141;356;1029;406;1170
171380;202008;1465;3989;1221;3646;120;337;876;2697;996;3034
171395;202008;962;2659;666;2101;59;232;408;1235;467;1467
171420;202008;1965;5748;1411;4626;241;849;638;2102;879;2951
171430;202008;1031;3031;849;2692;60;213;574;1749;634;1962
171488;202008;2329;6908;1823;6050;270;880;936;3276;1206;4156
171500;202008;990;2449;747;2081;43;113;574;1619;617;1732
171510;202008;815;2656;702;2437;44;196;488;1666;532;1862
171515;202008;470;1192;333;970;31;91;201;558;232;649
171525;202008;704;1984;528;1700;22;79;306;945;328;1024
171550;202008;345;994;258;851;32;119;144;466;176;585
171570;202008;1136;3444;949;3106;121;391;558;1882;679;2273
171575;202008;1820;4853;1163;3659;118;395;520;1643;638;2038
171610;202008;5809;16147;4330;13590;894;3170;1192;3997;2086;7167
171620;202008;2594;7329;2173;6715;102;392;1767;5479;1869;5871
171630;202008;959;2514;752;2229;106;314;510;1555;616;1869
171650;202008;2038;5789;1560;4977;390;1351;459;1612;849;2963
171660;202008;2390;6020;1619;4727;241;639;841;2503;1082;3142
171665;202008;1245;3485;960;3019;165;582;448;1429;613;2011
171670;202008;1923;5085;1465;4330;199;644;789;2346;988;2990
171700;202008;1211;3447;877;2831;114;360;465;1549;579;1909
171720;202008;799;2043;630;1781;55;176;452;1253;507;1429
171750;202008;1310;3671;887;2870;227;756;108;444;335;1200
171780;202008;1231;3141;877;2613;94;312;573;1669;667;1981
171790;202008;1395;4590;1144;4074;221;824;530;1927;751;2751
171800;202008;716;1978;535;1702;63;255;303;945;366;1200
171820;202008;11381;31822;8338;26504;2047;6750;2475;8526;4522;15276
171830;202008;1535;4917;1285;4468;123;524;826;2859;949;3383
171840;202008;770;2048;593;1768;24;74;392;1159;416;1233
171845;202008;649;1587;490;1351;49;171;313;836;362;1007
171850;202008;906;2971;770;2666;74;322;542;1821;616;2143
171855;202008;1043;3185;883;2894;71;236;543;1748;614;1984
171865;202008;372;1167;301;1043;49;189;149;493;198;682
171870;202008;824;2269;580;1819;69;214;297;949;366;1163
171875;202008;1286;3729;1018;3291;42;181;760;2453;802;2634
171880;202008;1163;3528;1019;3336;44;140;810;2717;854;2857
171884;202008;870;2465;640;2070;116;438;234;788;350;1226
171886;202008;1364;3764;967;3104;281;1023;192;626;473;1649
171888;202008;722;2005;493;1579;28;104;310;969;338;1073
171889;202008;379;1180;301;1021;65;240;120;404;185;644
171890;202008;1192;3305;856;2761;177;536;471;1570;648;2106
171900;202008;552;1889;403;1515;85;308;163;641;248;949
172000;202008;582;1715;485;1527;53;163;274;842;327;1005
172010;202008;995;3424;845;3116;71;296;521;1900;592;2196
172015;202008;382;1310;280;1098;70;280;109;446;179;726
172020;202008;2669;7617;2345;7190;170;576;1725;5481;1895;6057
172025;202008;709;1955;520;1643;34;130;382;1203;416;1333
172030;202008;1222;3611;1034;3307;55;218;803;2561;858;2779
172049;202008;1306;3129;880;2539;182;494;439;1394;621;1888
172065;202008;1441;3579;1109;3164;99;213;874;2684;973;2897
172080;202008;2361;6922;1900;6119;107;373;1270;4081;1377;4454
172085;202008;474;1286;306;924;48;138;114;327;162;465
172090;202008;4041;10074;3113;8847;127;380;2357;6773;2484;7153
172093;202008;491;1445;346;1180;21;103;199;645;220;748
172097;202008;700;1838;485;1459;64;200;215;656;279;856
172100;202008;49289;121725;34434;97965;6018;18987;12275;35829;18293;54816
172110;202008;1573;5758;1353;5411;130;547;987;4140;1117;4687
172120;202008;4969;14618;3880;12844;499;1735;2196;7480;2695;9215
172125;202008;368;988;274;829;25;83;160;462;185;545
172130;202008;640;1553;496;1324;26;85;347;845;373;930
172208;202008;2550;6263;2039;5602;187;429;1469;4155;1656;4584
172210;202008;2672;6785;2041;5975;324;1036;1163;3552;1487;4588
210005;202008;18836;54083;14315;46521;4141;14001;5423;18509;9564;32510
210010;202008;1921;5929;1730;5696;74;316;1501;4962;1575;5278
210015;202008;3303;9868;2917;9339;153;504;2407;7715;2560;8219
210020;202008;7346;17357;6215;16027;116;374;5651;14566;5767;14940
210030;202008;4706;15546;4331;14980;206;913;3723;12862;3929;13775
210040;202008;1813;4323;1596;4046;35;92;1362;3384;1397;3476
210043;202008;6181;17701;5211;16359;431;1262;3980;12815;4411;14077
210047;202008;6579;20418;5343;18764;136;693;4625;16227;4761;16920
210050;202008;2226;7520;1746;6621;156;693;1208;4563;1364;5256
210055;202008;1890;6044;1705;5762;69;268;1441;4891;1510;5159
210060;202008;7285;26624;6446;25114;689;2790;4439;17756;5128;20546
210070;202008;7115;20250;6655;19654;41;183;6300;18560;6341;18743
210080;202008;4290;14459;4066;14214;47;278;3738;13152;3785;13430
210083;202008;5559;16105;4560;15041;39;184;4319;14305;4358;14489
210087;202008;3033;8221;2612;7670;110;270;2236;6722;2346;6992
210090;202008;9299;29064;8645;27913;512;1341;7344;23999;7856;25340
210095;202008;6397;20542;5821;19808;252;1085;4835;16793;5087;17878
210100;202008;6803;20720;6055;19519;363;1303;4714;15248;5077;16551
210110;202008;2947;9584;2714;9305;65;365;2432;8281;2497;8646
210120;202008;22906;62728;18874;57418;1873;4654;12771;41434;14644;46088
210125;202008;4422;11793;3859;11131;720;1611;2760;8559;3480;10170
210130;202008;4371;11497;3612;10548;155;335;3060;9062;3215;9397
210135;202008;1446;4358;1240;4027;61;179;1002;3323;1063;3502
210140;202008;19161;50106;14641;44268;2765;8016;8191;26274;10956;34290
210150;202008;4409;10625;3907;9939;141;395;3323;8322;3464;8717
210160;202008;16577;48387;14265;45466;1250;4250;10064;33267;11314;37517
210170;202008;15116;46923;14034;45537;773;2180;12302;40386;13075;42566
210173;202008;2246;8636;2095;8368;103;584;1789;7114;1892;7698
210177;202008;3469;9492;3011;8935;133;271;2646;8143;2779;8414
210180;202008;1446;3879;1273;3674;29;77;1147;3325;1176;3402
210190;202008;5359;14416;4507;13270;74;340;3885;11296;3959;11636
210193;202008;1301;3794;1147;3547;31;140;862;2697;893;2837
210197;202008;2085;6488;1915;6252;145;486;1564;5180;1709;5666
210200;202008;7655;24605;6761;23111;401;1552;5343;18191;5744;19743
210203;202008;7079;20762;6036;19359;412;1389;4800;15711;5212;17100
210207;202008;3973;9668;3053;8690;157;335;2537;7445;2694;7780
210210;202008;8030;26160;7329;25197;137;829;6504;22179;6641;23008
210215;202008;2457;7771;2085;7208;109;570;1602;5479;1711;6049
210220;202008;6125;21228;5797;20723;182;1181;5066;17729;5248;18910
210230;202008;5133;15578;4641;14839;416;1079;3843;12629;4259;13708
210232;202008;11217;35245;9190;32155;1562;5456;5686;21295;7248;26751
210235;202008;3353;10096;2945;9535;167;671;2485;8040;2652;8711
210237;202008;2748;9007;2352;8547;35;208;2171;7888;2206;8096
210240;202008;2585;8189;2369;7803;79;311;1951;6312;2030;6623
210250;202008;5631;17143;5101;16468;80;461;4581;14719;4661;15180
210255;202008;2515;7687;2119;6983;292;994;1338;4402;1630;5396
210260;202008;5480;16356;4834;15415;239;914;4042;12787;4281;13701
210270;202008;4826;13359;4294;12700;109;494;3808;11181;3917;11675
210275;202008;3526;8884;3083;8339;75;189;2613;7086;2688;7275
210280;202008;5510;15766;4410;14056;260;1032;3203;10086;3463;11118
210290;202008;7227;19436;6449;18466;116;376;5977;17119;6093;17495
210300;202008;33361;90098;27019;81039;1881;5939;19294;59960;21175;65899
210310;202008;3072;7875;2711;7348;121;271;2366;6453;2487;6724
210312;202008;2674;6829;2351;6479;31;138;2203;6004;2234;6142
210315;202008;2956;8257;2522;7763;71;224;2260;7075;2331;7299
210317;202008;4056;12865;3667;12408;143;716;3233;10862;3376;11578
210320;202008;19007;57469;17342;55258;383;1861;15375;48746;15758;50607
210325;202008;3660;10277;3126;9582;105;311;2725;8546;2830;8857
210330;202008;24690;69372;19801;63066;5985;17173;9361;34661;15346;51834
210340;202008;10098;29645;8943;28083;730;2268;6787;21997;7517;24265
210350;202008;9180;26551;8008;25115;156;545;7105;22419;7261;22964
210355;202008;4271;14184;3751;13371;103;515;3169;11366;3272;11881
210360;202008;13586;42486;12096;40269;612;2803;9144;29901;9756;32704
210370;202008;10857;24385;8399;21778;250;423;7664;20378;7914;20801
210375;202008;3280;8703;2499;7650;651;2035;1104;3768;1755;5803
210380;202008;5417;13914;4669;13045;202;478;4003;11294;4205;11772
210390;202008;2578;9052;2376;8700;123;565;1991;7257;2114;7822
210400;202008;4452;13630;3944;13002;136;434;3528;11794;3664;12228
210405;202008;6898;18619;5543;16670;1054;2951;3111;9993;4165;12944
210407;202008;1968;6504;1639;5897;79;340;1316;4681;1395;5021
210408;202008;2523;9350;2358;9103;150;712;1875;7253;2025;7965
210409;202008;3791;13108;3462;12655;116;637;2840;10433;2956;11070
210410;202008;3456;10562;2934;9693;161;646;2206;7230;2367;7876
210420;202008;3847;12288;3477;11637;203;632;2906;9830;3109;10462
210430;202008;2236;6564;1981;6231;81;236;1692;5392;1773;5628
210440;202008;4376;11740;3781;10987;74;274;3433;9886;3507;10160
210450;202008;2420;7163;2073;6658;81;289;1709;5461;1790;5750
210455;202008;4313;11358;3279;10031;950;2931;1509;4894;2459;7825
210460;202008;3713;10534;3133;9789;68;287;2737;8489;2805;8776
210462;202008;1641;4975;1398;4577;36;146;1132;3751;1168;3897
210465;202008;2714;7840;2368;7373;80;283;1989;6159;2069;6442
210467;202008;5905;18842;5129;17815;308;1217;4234;14898;4542;16115
210470;202008;2038;5355;1449;4511;92;217;1106;3585;1198;3802
210480;202008;16352;47806;13465;44233;1139;3425;9873;35004;11012;38429
210490;202008;3687;9347;2970;8345;92;275;2487;6974;2579;7249
210500;202008;6273;24159;5744;23237;378;1841;4693;18890;5071;20731
210510;202008;5953;19654;5208;18848;127;554;4652;17127;4779;17681
210515;202008;3705;10905;3239;10370;263;953;2573;8390;2836;9343
210520;202008;2533;7237;2253;6871;71;250;1928;5824;1999;6074
210530;202008;53698;130772;41539;112681;6889;22946;11103;38072;17992;61018
210535;202008;3084;10465;2883;10144;161;589;2369;8430;2530;9019
210540;202008;14517;41970;12053;38501;1397;4123;8448;28289;9845;32412
210542;202008;6487;15006;5212;13614;335;552;4278;11975;4613;12527
210545;202008;2217;6869;2082;6650;42;177;1837;5806;1879;5983
210547;202008;3569;12758;3151;11928;298;1113;2338;9055;2636;10168
210550;202008;6153;18453;4852;16416;345;1333;3481;12069;3826;13402
210560;202008;3583;10871;3201;10255;125;393;2688;8544;2813;8937
210565;202008;1473;4802;1223;4433;73;391;927;3364;1000;3755
210570;202008;10430;28338;9260;26907;296;802;8152;24185;8448;24987
210580;202008;2979;7951;2459;7312;130;264;1966;6162;2096;6426
210590;202008;4284;12708;3700;11959;72;390;3292;10570;3364;10960
210592;202008;2635;7784;2405;7409;25;122;2036;6187;2061;6309
210594;202008;2496;6741;1902;5824;77;228;1404;4451;1481;4679
210596;202008;2530;8957;2265;8422;105;460;1850;6898;1955;7358
210598;202008;1822;5298;1683;5091;63;257;1470;4376;1533;4633
210600;202008;3059;8116;2465;7284;101;248;1906;5699;2007;5947
210610;202008;2693;7560;2307;7082;60;284;1956;5989;2016;6273
210620;202008;2784;7451;2312;6883;60;180;2053;6140;2113;6320
210630;202008;2987;10047;2725;9615;119;582;2247;7831;2366;8413
210632;202008;4388;14155;3884;13427;217;970;3068;10503;3285;11473
210635;202008;1734;6200;1631;6021;100;362;1347;5073;1447;5435
210637;202008;2428;8030;2108;7569;148;652;1580;5716;1728;6368
210640;202008;4565;16301;4274;15952;69;345;3888;14550;3957;14895
210650;202008;7370;21086;6679;20193;89;341;6042;18269;6131;18610
210660;202008;8112;24090;7156;22559;291;1186;6024;18678;6315;19864
210663;202008;2552;7454;2342;7207;146;356;1986;6304;2132;6660
210667;202008;1942;6295;1744;6003;55;224;1545;5370;1600;5594
210670;202008;4549;15167;4143;14529;122;571;3608;12584;3730;13155
210675;202008;5048;13629;4297;12660;186;460;3636;10968;3822;11428
210680;202008;4574;11096;3829;10195;119;217;3379;9111;3498;9328
210690;202008;7667;23392;6419;22011;242;1043;5682;19630;5924;20673
210700;202008;2722;7680;2144;6836;137;419;1564;5211;1701;5630
210710;202008;4868;15313;4265;14458;108;603;3711;12417;3819;13020
210720;202008;2908;9606;2593;9211;73;426;2244;7895;2317;8321
210725;202008;1296;4369;1131;4121;42;168;821;3124;863;3292
210730;202008;1181;3098;989;2828;49;129;833;2384;882;2513
210735;202008;4655;13592;3963;12668;188;561;3404;11144;3592;11705
210740;202008;5255;14121;4569;13348;92;309;3865;11299;3957;11608
210745;202008;4390;12002;4063;11584;112;358;3698;10494;3810;10852
210750;202008;23359;59431;20156;55393;1771;4500;13958;40613;15729;45113
210760;202008;5934;15623;5021;14659;30;66;4769;14064;4799;14130
210770;202008;6140;15738;5263;14720;67;291;4899;13599;4966;13890
210780;202008;7340;23091;6421;21555;564;1669;4994;17121;5558;18790
210790;202008;4204;13324;3774;12765;188;474;3101;11022;3289;11496
210800;202008;4884;13005;4173;12062;98;403;3671;10456;3769;10859
210805;202008;3923;14249;3726;13957;111;606;3274;12176;3385;12782
210810;202008;4841;14088;4386;13466;295;641;3601;11437;3896;12078
210820;202008;6899;19619;5730;17734;660;2106;3331;10660;3991;12766
210825;202008;6691;20770;6028;19889;257;860;5184;17348;5441;18208
210830;202008;7645;21555;6948;20701;343;784;6034;18443;6377;19227
210840;202008;3181;8472;2839;8010;60;201;2526;7035;2586;7236
210845;202008;6526;17562;5831;16806;26;100;5594;16218;5620;16318
210850;202008;5906;20048;4916;18571;241;1229;3846;14571;4087;15800
210860;202008;21101;54088;17543;49610;836;2039;14004;41777;14840;43816
210870;202008;7314;19050;5763;17274;230;626;5021;15170;5251;15796
210880;202008;4232;13065;3812;12565;192;786;3053;10003;3245;10789
210890;202008;3879;11388;3466;10887;244;662;2801;9123;3045;9785
210900;202008;4537;13237;3440;11151;1325;4602;537;1978;1862;6580
210905;202008;1992;5493;1647;5051;43;78;1499;4713;1542;4791
210910;202008;7244;21869;5996;19825;791;2641;3896;13041;4687;15682
210920;202008;3222;10548;2782;9965;82;459;2464;8732;2546;9191
210923;202008;1520;4549;1300;4197;78;288;927;3005;1005;3293
210927;202008;5195;16497;4563;15749;242;874;3725;13131;3967;14005
210930;202008;2480;8552;2175;7955;165;671;1622;5933;1787;6604
210940;202008;4059;11517;3760;11163;111;463;3424;10042;3535;10505
210945;202008;6473;18612;5799;17807;233;654;4857;15343;5090;15997
210950;202008;5176;14408;3974;12719;616;1553;2590;9060;3206;10613
210955;202008;1557;4936;1336;4552;132;466;932;3258;1064;3724
210960;202008;9021;26836;7750;24941;1256;3753;5006;16911;6262;20664
210970;202008;1333;4117;1057;3642;70;251;781;2639;851;2890
210975;202008;1739;5447;1555;5154;65;251;1243;4131;1308;4382
210980;202008;10157;23489;8895;22184;92;228;8409;21054;8501;21282
210990;202008;15985;45092;12568;40572;699;2481;9307;30891;10006;33372
211000;202008;14531;42374;12142;39424;758;2604;9368;31662;10126;34266
211003;202008;5610;16741;4716;15670;146;584;4056;13759;4202;14343
211010;202008;6372;22748;5707;21937;179;819;5051;19754;5230;20573
211020;202008;8190;23692;7083;22424;277;1055;5947;19355;6224;20410
211023;202008;1948;6329;1811;6147;91;324;1543;5232;1634;5556
211027;202008;3061;9793;2897;9535;194;530;2496;8300;2690;8830
211030;202008;3858;10626;3437;10114;226;504;2830;8593;3056;9097
211040;202008;4569;16529;4224;15917;133;754;3754;14016;3887;14770
211050;202008;9065;23601;8220;22500;84;287;7543;20656;7627;20943
211060;202008;6887;20881;6285;20067;144;609;5590;17837;5734;18446
211065;202008;2184;6093;1809;5617;106;330;1425;4563;1531;4893
211070;202008;7687;24398;6499;22588;512;1816;4979;17488;5491;19304
211080;202008;1303;3588;1038;3165;38;201;791;2269;829;2470
211085;202008;2063;5764;1754;5353;96;229;1497;4756;1593;4985
211090;202008;3167;8723;2856;8360;37;173;2649;7717;2686;7890
211100;202008;6702;16986;6185;16366;49;150;5717;15219;5766;15369
211102;202008;3040;10380;2774;9993;139;654;2399;8539;2538;9193
211105;202008;2364;7459;1956;6709;170;602;1392;4726;1562;5328
211107;202008;4618;14616;3931;13602;137;627;3126;11166;3263;11793
211110;202008;5831;16021;4514;14010;351;1028;3330;10549;3681;11577
211120;202008;44267;108358;36319;99076;4990;12415;23438;68469;28428;80884
211125;202008;2071;6163;1744;5659;43;159;1474;4807;1517;4966
211130;202008;188658;445420;163015;412149;23950;58381;75724;219099;99674;277480
211140;202008;4947;14669;4318;13848;214;603;3641;11802;3855;12405
211150;202008;9279;25486;7801;23558;340;973;6552;19941;6892;20914
211153;202008;2440;7127;1947;6513;250;881;1274;4440;1524;5321
211157;202008;1111;3509;924;3158;32;155;665;2263;697;2418
211160;202008;4067;11468;3190;10197;149;531;2391;7578;2540;8109
211163;202008;1620;5193;1474;4992;80;333;1268;4293;1348;4626
211167;202008;1522;4837;1421;4671;46;213;1228;3986;1274;4199
211170;202008;6428;15847;5964;15315;55;165;5662;14490;5717;14655
211172;202008;2511;6781;2149;6234;112;368;1639;4606;1751;4974
211174;202008;2830;8199;2558;7896;40;205;2387;7330;2427;7535
211176;202008;4238;12063;3286;10668;161;682;2598;8387;2759;9069
211178;202008;4614;10806;3969;10100;33;150;3768;9509;3801;9659
211180;202008;4038;13266;3738;12826;207;766;3128;10778;3335;11544
211190;202008;3056;8952;2589;8263;37;208;2287;7231;2324;7439
211195;202008;1401;3921;1194;3601;69;137;1005;3121;1074;3258
211200;202008;2136;6076;1703;5478;209;639;1178;3875;1387;4514
211210;202008;6229;19165;5625;18363;250;1056;4776;15429;5026;16485
211220;202008;36915;92927;30043;84443;2794;7353;22213;64177;25007;71530
211223;202008;5243;13783;4337;12590;380;1119;3159;9221;3539;10340
211227;202008;1758;5795;1583;5541;59;299;1239;4369;1298;4668
211230;202008;7549;21788;6584;20328;420;1122;5269;16663;5689;17785
211240;202008;8038;25653;7614;25107;135;745;7069;23053;7204;23798
211245;202008;6985;17604;6239;16831;86;211;6025;16279;6111;16490
211250;202008;13135;41183;11846;39424;675;2612;9658;31960;10333;34572
211260;202008;8014;25927;7135;24764;230;987;6370;22250;6600;23237
211270;202008;10449;33234;8928;31163;387;1771;7212;25348;7599;27119
211280;202008;12704;34947;11294;33160;927;2169;9055;27812;9982;29981
211285;202008;1789;5829;1575;5528;140;537;1143;4112;1283;4649
211290;202008;7414;22329;6666;21348;179;759;5738;18312;5917;19071
211300;202008;7793;22387;6874;20962;196;670;5836;17604;6032;18274
211400;202008;11470;32457;9309;29479;1039;3322;6226;20701;7265;24023
220005;202008;1837;4796;1660;4554;33;123;1401;3771;1434;3894
220010;202008;1488;4246;1213;3752;26;107;944;2895;970;3002
220020;202008;3650;10043;3148;9332;137;488;2591;7613;2728;8101
220025;202008;2240;5078;1923;4612;27;69;1608;3744;1635;3813
220027;202008;1276;3221;1088;2972;20;70;927;2485;947;2555
220030;202008;3341;8423;3123;8133;78;227;2763;7112;2841;7339
220040;202008;7160;21659;6221;19843;1447;4223;3241;10919;4688;15142
220045;202008;1477;4496;1210;4048;30;166;978;3209;1008;3375
220050;202008;4759;12835;4022;11862;60;285;3687;10742;3747;11027
220060;202008;2379;4987;1996;4547;24;57;1872;4253;1896;4310
220070;202008;2458;6167;2097;5643;71;150;1753;4744;1824;4894
220080;202008;734;2062;632;1911;23;86;540;1614;563;1700
220090;202008;1788;4278;1476;3838;20;66;1218;3289;1238;3355
220095;202008;644;1606;600;1559;26;43;540;1424;566;1467
220100;202008;1366;3764;1097;3335;44;158;877;2593;921;2751
220105;202008;2012;6238;1763;5745;116;426;1333;4324;1449;4750
220110;202008;3375;9297;3107;8836;37;190;2782;7799;2819;7989
220115;202008;2721;7869;2518;7598;73;232;2268;6813;2341;7045
220117;202008;1373;3293;1072;2878;8;40;902;2370;910;2410
220120;202008;12789;34205;11664;32806;76;271;10950;30775;11026;31046
220130;202008;1107;2973;941;2744;14;80;851;2454;865;2534
220140;202008;2131;4409;1793;4005;100;253;1576;3460;1676;3713
220150;202008;6331;18778;5781;17856;115;563;4904;14858;5019;15421
220155;202008;1157;3323;922;2888;36;121;645;1984;681;2105
220157;202008;1063;2600;902;2356;20;78;725;1831;745;1909
220160;202008;2850;7867;2453;7146;34;158;2031;5813;2065;5971
220170;202008;1578;4064;1345;3722;11;54;1211;3306;1222;3360
220173;202008;2152;5950;1734;5214;43;190;1382;4035;1425;4225
220177;202008;1978;5630;1871;5511;10;37;1849;5438;1859;5475
220180;202008;1137;2767;929;2417;4;21;717;1746;721;1767
220190;202008;6989;17398;5904;15912;374;1048;4402;12068;4776;13116
220191;202008;1552;4635;1409;4395;81;277;1001;3068;1082;3345
220192;202008;2052;5364;1492;4370;30;98;1202;3460;1232;3558
220194;202008;1727;4894;1525;4572;56;207;1252;3709;1308;3916
220196;202008;2012;5175;1818;4884;29;114;1563;4126;1592;4240
220198;202008;1289;3525;1085;3264;8;38;998;3023;1006;3061
220200;202008;5127;14734;4458;13868;95;394;3818;11859;3913;12253
220202;202008;2170;6083;1859;5573;29;151;1599;4717;1628;4868
220205;202008;2479;7116;2221;6652;48;187;1870;5521;1918;5708
220207;202008;786;2334;637;2079;61;207;399;1316;460;1523
220208;202008;1663;5101;1363;4522;165;602;812;2640;977;3242
220209;202008;1585;4488;1362;4095;22;93;1121;3336;1143;3429
220210;202008;1735;4224;1491;3845;12;55;1283;3225;1295;3280
220211;202008;1612;4090;1480;3907;16;65;1297;3436;1313;3501
220213;202008;1756;4693;1516;4277;30;108;1214;3339;1244;3447
220217;202008;2162;6447;2015;6277;47;103;1864;5929;1911;6032
220220;202008;10520;27336;8702;24530;573;1428;5863;17413;6436;18841
220225;202008;1039;2707;835;2440;6;36;778;2243;784;2279
220230;202008;5707;14159;4889;13029;162;381;4211;11292;4373;11673
220240;202008;3026;8688;2744;8205;112;357;2233;6684;2345;7041
220245;202008;1738;4060;1345;3567;10;44;1222;3269;1232;3313
220250;202008;2967;8290;2615;7845;17;89;2450;7322;2467;7411
220253;202008;1597;4314;1407;4001;63;212;1182;3280;1245;3492
220255;202008;1905;4476;1620;4074;33;142;1390;3373;1423;3515
220260;202008;4270;13121;3754;12166;162;606;2983;9664;3145;10270
220265;202008;1309;4169;1178;3995;34;169;965;3208;999;3377
220270;202008;6157;19532;5777;18830;208;1013;4829;15213;5037;16226
220271;202008;1505;3823;1303;3545;30;106;1141;3087;1171;3193
220272;202008;1765;5060;1570;4705;51;156;1187;3461;1238;3617
220273;202008;1237;3488;1030;3105;34;129;794;2355;828;2484
220275;202008;2285;5416;1815;4772;34;88;1594;4217;1628;4305
220277;202008;2146;5380;1832;4923;24;66;1551;4101;1575;4167
220280;202008;1660;3861;1373;3484;25;78;1156;2912;1181;2990
220285;202008;1437;3618;1225;3375;11;46;1126;3079;1137;3125
220290;202008;6616;18415;5212;16419;372;1278;3770;12165;4142;13443
220300;202008;1969;5662;1598;5172;36;188;1328;4284;1364;4472
220310;202008;3084;8212;2390;7396;40;195;2002;6170;2042;6365
220320;202008;3034;8883;2328;7540;77;370;1817;5698;1894;6068
220323;202008;1641;4768;1296;4207;53;210;1062;3384;1115;3594
220325;202008;1264;3730;1079;3421;22;110;897;2789;919;2899
220327;202008;1514;4272;1311;3941;43;183;1084;3168;1127;3351
220330;202008;4446;10601;3734;9738;57;178;3374;8736;3431;8914
220335;202008;1666;5032;1495;4815;32;107;1330;4300;1362;4407
220340;202008;1871;4910;1433;4169;59;191;975;2739;1034;2930
220342;202008;1157;3354;1030;3164;44;178;815;2476;859;2654
220345;202008;3111;6995;2400;5973;13;42;2178;5400;2191;5442
220350;202008;3304;8400;2616;7374;136;408;1860;5260;1996;5668
220360;202008;1241;3165;981;2737;19;54;780;2168;799;2222
220370;202008;8696;25141;7887;23844;163;713;6878;20529;7041;21242
220375;202008;1596;4522;1411;4296;2;13;1338;4096;1340;4109
220380;202008;1488;3519;1205;3114;15;38;1055;2701;1070;2739
220385;202008;860;2053;686;1731;7;21;595;1480;602;1501
220390;202008;10453;27009;7968;23127;2032;5783;2834;9175;4866;14958
220400;202008;1470;3478;1114;2934;23;69;853;2183;876;2252
220410;202008;1176;3217;946;2824;51;152;755;2216;806;2368
220415;202008;804;2051;673;1841;20;58;542;1460;562;1518
220420;202008;2039;5628;1634;4857;54;170;1257;3685;1311;3855
220430;202008;2476;6647;2323;6428;78;260;1977;5402;2055;5662
220435;202008;1762;4512;1525;4162;42;144;1261;3374;1303;3518
220440;202008;2387;7435;2039;6891;92;385;1713;5700;1805;6085
220450;202008;2500;6459;2034;5878;63;217;1722;4995;1785;5212
220455;202008;1286;3954;1219;3860;11;59;1085;3434;1096;3493
220460;202008;985;2404;914;2312;37;91;781;1955;818;2046
220465;202008;2339;7221;2059;6781;179;597;1508;5082;1687;5679
220470;202008;3551;9742;3178;9156;87;227;2586;7358;2673;7585
220480;202008;2791;7189;2241;6296;194;447;1469;4188;1663;4635
220490;202008;2479;6194;2138;5758;26;128;1864;4950;1890;5078
220500;202008;2795;7148;2428;6553;57;189;1984;5216;2041;5405
220510;202008;2570;7233;2018;6242;79;226;1578;4920;1657;5146
220515;202008;1647;3969;1505;3772;42;67;1307;3276;1349;3343
220520;202008;4928;12754;4441;12070;104;290;3859;10420;3963;10710
220525;202008;1330;3330;1145;3096;9;42;1051;2807;1060;2849
220527;202008;1296;3625;1105;3347;13;54;945;2914;958;2968
220530;202008;1436;3558;1230;3295;30;96;1126;2988;1156;3084
220535;202008;802;2205;750;2136;27;86;613;1736;640;1822
220540;202008;3214;10252;3005;9855;115;387;2572;8410;2687;8797
220545;202008;1404;4228;1285;4034;70;263;1066;3301;1136;3564
220550;202008;8623;26408;7613;24646;499;1734;5720;18363;6219;20097
220551;202008;1414;4007;1232;3695;28;119;1008;2957;1036;3076
220552;202008;1599;4608;1299;4075;26;129;1044;3157;1070;3286
220553;202008;1726;4443;1422;4043;58;106;1151;3404;1209;3510
220554;202008;906;2343;659;1939;48;112;427;1250;475;1362
220555;202008;2321;6840;2062;6492;41;170;1702;5472;1743;5642
220556;202008;1210;3492;1044;3175;57;228;751;2190;808;2418
220557;202008;1623;4942;1363;4405;66;250;1003;3143;1069;3393
220558;202008;1400;3592;1096;3173;17;75;946;2711;963;2786
220559;202008;1781;4359;1504;3935;9;22;1220;3231;1229;3253
220560;202008;1770;3950;1427;3513;38;73;1297;3216;1335;3289
220570;202008;7147;21300;6494;20381;446;1410;5150;16275;5596;17685
220580;202008;6927;18902;6329;17939;81;293;5728;16122;5809;16415
220585;202008;2007;6321;1667;5692;42;150;1366;4719;1408;4869
220590;202008;1331;3577;1085;3203;71;202;778;2319;849;2521
220595;202008;2545;6929;2303;6601;20;95;2054;5830;2074;5925
220600;202008;1397;3102;1173;2826;88;108;976;2440;1064;2548
220605;202008;1611;4714;1369;4281;19;116;1106;3351;1125;3467
220610;202008;2764;8037;2583;7766;33;145;2413;7236;2446;7381
220620;202008;7814;24138;7184;23285;173;905;6531;20922;6704;21827
220630;202008;371;1083;284;921;22;76;192;617;214;693
220635;202008;1659;5165;1458;4723;52;249;1116;3514;1168;3763
220640;202008;2476;6841;2109;6311;80;315;1707;5048;1787;5363
220650;202008;2054;5660;1779;5243;37;136;1424;4201;1461;4337
220660;202008;2618;8136;2225;7472;79;397;1858;6098;1937;6495
220665;202008;1222;3691;1027;3364;30;168;848;2702;878;2870
220667;202008;1607;4971;1441;4658;54;208;1171;3766;1225;3974
220669;202008;1607;4893;1538;4786;52;243;1359;4131;1411;4374
220670;202008;2189;5692;1755;5084;18;86;1524;4408;1542;4494
220672;202008;3232;7861;2605;7100;103;330;2302;6210;2405;6540
220675;202008;1257;3443;1120;3192;31;103;927;2608;958;2711
220680;202008;2695;7282;2570;7105;104;243;2347;6528;2451;6771
220690;202008;1579;4144;1391;3859;61;169;1100;3066;1161;3235
220695;202008;895;2459;823;2335;20;63;720;2028;740;2091
220700;202008;9928;24380;7967;21668;344;966;6076;16421;6420;17387
220710;202008;895;2467;656;2017;34;108;490;1479;524;1587
220720;202008;2114;5002;1902;4719;16;63;1655;4056;1671;4119
220730;202008;1316;3666;1104;3302;14;77;935;2733;949;2810
220735;202008;968;2254;755;1928;17;60;630;1549;647;1609
220740;202008;1373;3547;1099;3198;29;77;917;2720;946;2797
220750;202008;3843;9734;3352;9027;192;468;2895;7834;3087;8302
220755;202008;1315;3210;1092;2877;22;83;891;2286;913;2369
220760;202008;3125;8580;2728;8044;70;222;2448;7277;2518;7499
220770;202008;23198;68543;19508;62152;5892;19792;6760;22479;12652;42271
220775;202008;1159;2930;1029;2768;13;45;984;2631;997;2676
220777;202008;1603;4051;1214;3454;30;78;932;2667;962;2745
220779;202008;1295;3267;1113;3005;19;61;972;2607;991;2668
220780;202008;5589;14047;4854;12933;205;658;3962;10318;4167;10976
220785;202008;1483;3259;1298;3022;9;23;1251;2898;1260;2921
220790;202008;10184;28777;9138;27278;219;997;7660;22636;7879;23633
220793;202008;926;2425;733;2085;10;23;610;1761;620;1784
220795;202008;1392;3570;1222;3337;18;69;1088;2963;1106;3032
220800;202008;17974;39747;15200;36084;653;1487;11708;27771;12361;29258
220810;202008;3039;8355;2549;7481;55;161;2090;6083;2145;6244
220820;202008;4983;12980;4302;11989;276;673;3253;9058;3529;9731
220830;202008;7269;19250;6506;18194;238;785;5397;14865;5635;15650
220840;202008;12324;37621;10229;33313;2304;7183;4725;16055;7029;23238
220850;202008;3131;9659;2789;9233;60;318;2455;8144;2515;8462
220855;202008;691;1735;599;1612;15;50;542;1450;557;1500
220860;202008;1044;2595;903;2370;17;68;813;2103;830;2171
220865;202008;2442;6430;1912;5498;92;342;1392;3872;1484;4214
220870;202008;2957;8278;2464;7628;34;178;2265;6994;2299;7172
220880;202008;5313;12484;4563;11555;84;299;4151;10403;4235;10702
220885;202008;1403;4224;1155;3808;57;212;909;3049;966;3261
220887;202008;1573;3378;1310;3037;13;30;1215;2796;1228;2826
220890;202008;1416;4297;1238;4025;46;161;1026;3385;1072;3546
220900;202008;2030;4798;1693;4359;33;80;1477;3789;1510;3869
220910;202008;1519;4132;1270;3771;54;161;1050;3144;1104;3305
220915;202008;959;2591;775;2256;5;20;584;1647;589;1667
220920;202008;1425;4434;1227;4167;58;245;1007;3441;1065;3686
220930;202008;1738;4658;1457;4253;20;62;1356;3946;1376;4008
220935;202008;1090;3125;884;2694;24;98;579;1668;603;1766
220937;202008;1444;3813;1237;3494;25;90;979;2726;1004;2816
220940;202008;1545;4273;1238;3725;38;127;956;2846;994;2973
220945;202008;443;1536;382;1395;21;120;278;976;299;1096
220950;202008;1429;3275;931;2502;18;62;739;1921;757;1983
220955;202008;1618;4120;1346;3644;24;69;1148;3066;1172;3135
220960;202008;812;2051;603;1701;18;59;425;1137;443;1196
220965;202008;1780;4854;1550;4508;21;130;1345;3820;1366;3950
220970;202008;1944;4617;1424;3841;34;90;1187;3175;1221;3265
220975;202008;698;1970;595;1839;15;81;527;1568;542;1649
220980;202008;1147;3218;1016;3043;37;148;848;2512;885;2660
220985;202008;1223;3198;1060;2959;43;125;860;2331;903;2456
220987;202008;1426;4247;1242;3916;54;205;999;3132;1053;3337
220990;202008;1705;4648;1495;4341;19;103;1258;3588;1277;3691
220995;202008;1057;3210;855;2842;34;117;626;2074;660;2191
220997;202008;2372;7113;2188;6817;46;211;1959;6037;2005;6248
221000;202008;4482;12177;3952;11386;87;398;3365;9558;3452;9956
221005;202008;1471;3851;1340;3637;21;120;1160;3025;1181;3145
221010;202008;1240;2795;988;2489;19;57;852;2098;871;2155
221020;202008;1524;4652;1415;4446;21;79;1078;3349;1099;3428
221030;202008;1641;4057;1405;3771;22;63;1207;3285;1229;3348
221035;202008;1503;3929;1311;3669;23;30;1155;3328;1178;3358
221037;202008;673;1858;558;1658;8;25;394;1127;402;1152
221038;202008;517;1457;402;1248;12;42;281;871;293;913
221039;202008;865;2340;742;2132;22;98;598;1637;620;1735
221040;202008;4021;11943;3508;11024;155;544;2761;8669;2916;9213
221050;202008;3912;10204;3429;9590;68;243;3084;8610;3152;8853
221060;202008;8463;23462;6982;21112;265;727;5660;17271;5925;17998
221062;202008;1164;3751;986;3452;41;187;793;2740;834;2927
221063;202008;1072;2919;918;2697;56;185;710;2043;766;2228
221065;202008;2611;6698;2300;6139;20;80;2023;5301;2043;5381
221070;202008;3334;10349;2684;8985;290;967;1649;5644;1939;6611
221080;202008;3509;8604;2852;7635;62;226;2330;6125;2392;6351
221090;202008;1409;3604;1153;3185;8;28;990;2674;998;2702
221093;202008;1375;3857;1249;3598;128;355;849;2402;977;2757
221095;202008;888;2302;740;2072;11;35;619;1703;630;1738
221097;202008;842;2187;647;1840;24;70;476;1296;500;1366
221100;202008;116282;309806;96335;275429;10238;31356;62086;172554;72324;203910
221110;202008;9866;29333;9039;28256;146;737;8083;25011;8229;25748
221120;202008;4803;13154;4269;12294;158;472;3710;10671;3868;11143
221130;202008;5392;14005;4008;11305;771;2070;1927;5470;2698;7540
221135;202008;1658;4318;1488;4092;47;141;1314;3623;1361;3764
221140;202008;1336;3128;1121;2852;11;37;1008;2515;1019;2552
221150;202008;1124;2761;869;2312;22;97;673;1675;695;1772
221160;202008;727;1803;637;1685;14;18;518;1378;532;1396
221170;202008;996;2847;902;2676;20;68;777;2278;797;2346
230010;202008;3057;8000;2510;7054;38;140;2039;5604;2077;5744
230015;202008;3047;9783;2664;9025;173;656;1868;6295;2041;6951
230020;202008;12902;40524;12030;39183;328;1358;10201;33043;10529;34401
230030;202008;12974;32318;10802;29496;184;569;9458;25803;9642;26372
230040;202008;4453;11484;3684;10244;49;238;3074;8408;3123;8646
230050;202008;2794;8630;2100;6980;339;1086;936;3037;1275;4123
230060;202008;2371;6452;1877;5581;36;152;1476;4315;1512;4467
230070;202008;3953;10451;3173;8947;149;453;2234;6218;2383;6671
230075;202008;8955;28999;8180;27619;474;1991;6497;21645;6971;23636
230080;202008;3083;6432;2329;5502;6;18;2124;5037;2130;5055
230090;202008;4367;10675;3677;9581;175;447;2944;7623;3119;8070
230100;202008;17978;46570;15772;43566;1212;3401;11299;31396;12511;34797
230110;202008;12726;37682;10666;33629;1724;5418;5621;17847;7345;23265
230120;202008;7397;19830;6493;18342;522;1318;4771;13666;5293;14984
230125;202008;3144;8281;2552;7322;89;297;1960;5547;2049;5844
230130;202008;5746;17619;4633;15140;315;1090;3103;9980;3418;11070
230140;202008;3437;10282;2899;9155;102;414;2201;6796;2303;7210
230150;202008;1578;4722;1301;4105;197;530;761;2501;958;3031
230160;202008;6490;16791;5527;15275;197;679;4476;12160;4673;12839
230170;202008;6262;17729;5072;15282;303;896;3638;10791;3941;11687
230180;202008;1650;4537;1397;4063;20;89;1128;3175;1148;3264
230185;202008;4422;12463;3718;11284;254;858;2769;8368;3023;9226
230190;202008;13207;38336;11069;34364;1462;4732;6284;19352;7746;24084
230195;202008;5309;15570;4793;14577;361;1081;3631;11024;3992;12105
230200;202008;5033;13823;4204;12251;151;493;3207;9140;3358;9633
230205;202008;4127;12195;3607;11394;193;652;2714;8516;2907;9168
230210;202008;10366;24862;8706;22615;340;1123;6839;17424;7179;18547
230220;202008;13980;34974;12188;32375;620;1655;10015;26349;10635;28004
230230;202008;6892;20556;6108;18954;401;1217;4490;13937;4891;15154
230240;202008;13045;34723;11217;31600;273;1146;9246;25452;9519;26598
230250;202008;8959;25054;8330;24070;238;833;6660;18690;6898;19523
230260;202008;14761;43878;12733;40235;1747;5342;7235;23390;8982;28732
230270;202008;7621;20450;5797;16991;488;1387;3801;11225;4289;12612
230280;202008;20435;54371;16586;47845;477;2014;13057;36272;13534;38286
230290;202008;4866;13423;4016;11811;265;699;3026;8904;3291;9603
230300;202008;4829;12824;4357;12181;104;298;3804;10587;3908;10885
230310;202008;4605;13104;3875;11804;133;585;2791;8259;2924;8844
230320;202008;7782;22346;6528;20038;241;974;4991;14990;5232;15964
230330;202008;4681;12758;3677;10813;138;456;2756;7924;2894;8380
230340;202008;3647;11205;3097;10083;266;928;2078;6670;2344;7598
230350;202008;17851;49000;15589;45612;864;2881;10466;30853;11330;33734
230360;202008;2957;7779;2307;6630;142;394;1548;4409;1690;4803
230365;202008;3030;7516;2485;6702;52;245;2113;5610;2165;5855
230370;202008;58802;162852;49815;149405;7405;22437;29532;90015;36937;112452
230380;202008;6286;17464;4916;14920;131;531;3623;10759;3754;11290
230390;202008;3405;10051;2932;9279;94;400;2260;7064;2354;7464
230393;202008;3271;9651;2600;8277;86;439;1989;6083;2075;6522
230395;202008;5787;15717;5031;14442;322;865;3571;10278;3893;11143
230400;202008;5471;14998;4855;13981;99;500;3876;10840;3975;11340
230410;202008;14195;41681;11635;36928;887;3065;7960;25216;8847;28281
230420;202008;28979;79085;23401;69316;2847;8758;13100;38560;15947;47318
230423;202008;4690;13837;4073;12596;86;390;3329;10107;3415;10497
230425;202008;5566;17109;5048;16045;395;1322;3591;11352;3986;12674
230426;202008;2756;7215;1983;5705;28;106;1485;4190;1513;4296
230427;202008;1852;5214;1314;4072;66;214;861;2563;927;2777
230428;202008;9643;25662;8232;23516;1115;3143;4825;13760;5940;16903
230430;202008;4992;13953;3899;12036;151;524;2902;8821;3053;9345
230435;202008;5917;15454;4901;13638;603;1592;2958;8320;3561;9912
230440;202008;413562;1021411;341604;914952;34230;97254;218997;579708;253227;676962
230445;202008;4298;11340;3456;9883;182;519;2364;6601;2546;7120
230450;202008;3602;10315;3119;9600;241;927;2256;6722;2497;7649
230460;202008;2140;5929;1860;5480;59;233;1552;4541;1611;4774
230465;202008;4057;11333;3422;10108;101;402;2571;7294;2672;7696
230470;202008;11283;37096;10077;34863;886;3464;7125;24242;8011;27706
230480;202008;1450;4169;1233;3774;68;269;911;2678;979;2947
230490;202008;2527;7079;2108;6291;165;563;1320;3699;1485;4262
230495;202008;5725;16933;5031;15687;369;1376;3344;10288;3713;11664
230500;202008;9415;29936;8407;28075;271;1082;6838;22815;7109;23897
230510;202008;1626;4871;1262;4075;172;605;632;2003;804;2608
230520;202008;4542;12781;3913;11644;309;874;2755;8226;3064;9100
230523;202008;15622;45780;12392;38835;2809;8789;3192;10681;6001;19470
230526;202008;3718;10539;3155;9571;186;518;2301;7051;2487;7569
230530;202008;5416;16804;4533;15063;297;1096;3262;10708;3559;11804
230533;202008;4465;10619;3701;9397;92;263;3081;7694;3173;7957
230535;202008;5311;14723;4480;13314;237;707;3112;9374;3349;10081
230540;202008;16207;43855;13860;40372;279;1110;11415;32936;11694;34046
230550;202008;21053;55344;16826;48114;1509;4455;10730;30489;12239;34944
230560;202008;8103;19659;6513;17147;51;213;5593;14611;5644;14824
230565;202008;3033;8420;2538;7512;94;387;1919;5558;2013;5945
230570;202008;3457;8805;2934;8087;81;228;2402;6611;2483;6839
230580;202008;10948;28212;9325;25873;338;955;7687;21212;8025;22167
230590;202008;8909;25207;7345;22337;406;1434;5404;15915;5810;17349
230600;202008;3655;9456;2856;8041;73;213;1989;5624;2062;5837
230610;202008;6696;18389;5902;17050;456;1291;4625;13296;5081;14587
230620;202008;2125;5702;1607;4680;123;381;976;2742;1099;3123
230625;202008;8008;22603;6686;20171;2009;6256;1810;5904;3819;12160
230630;202008;10745;31828;9271;28871;1441;4255;5347;17060;6788;21315
230640;202008;27865;83657;25051;79181;1216;4766;19904;61997;21120;66763
230650;202008;5191;13966;4408;12601;129;509;3591;10033;3720;10542
230655;202008;9308;31304;8735;30291;630;2240;6939;24350;7569;26590
230660;202008;5974;17783;4871;15826;161;852;3948;12562;4109;13414
230670;202008;6223;14740;4528;12010;138;445;3646;9433;3784;9878
230680;202008;2639;7184;2228;6457;126;341;1607;4687;1733;5028
230690;202008;7139;21033;6123;19006;394;1392;3861;11756;4255;13148
230700;202008;10245;26141;8246;22456;314;841;6107;16337;6421;17178
230710;202008;6801;21366;5911;19447;624;2010;3952;12896;4576;14906
230720;202008;1894;5574;1530;4823;119;352;1025;3158;1144;3510
230725;202008;3988;11785;3563;11035;382;1354;2064;6276;2446;7630
230730;202008;56641;153108;44138;133839;9684;31793;14724;46974;24408;78767
230740;202008;6059;16675;5118;15157;131;457;4102;12105;4233;12562
230750;202008;8352;22176;6905;19776;159;564;5497;15343;5656;15907
230760;202008;11100;29152;9637;26944;505;1678;7279;19886;7784;21564
230763;202008;4827;13122;4030;11685;118;540;3242;9107;3360;9647
230765;202008;40920;110840;33807;99192;5241;15932;17009;49574;22250;65506
230770;202008;25495;62877;21227;57191;2164;5881;14043;37943;16207;43824
230780;202008;6382;22247;5803;20876;808;2863;3404;12591;4212;15454
230790;202008;3004;8623;2697;8118;109;450;2021;5918;2130;6368
230800;202008;8143;25784;7125;23716;872;3125;4178;13681;5050;16806
230810;202008;11346;33809;10115;31816;394;1443;7818;24148;8212;25591
230820;202008;3401;11064;2789;9699;257;1049;1658;5505;1915;6554
230830;202008;7546;20441;6399;18509;126;533;5291;14930;5417;15463
230835;202008;4246;10102;3223;8466;86;258;2604;6739;2690;6997
230837;202008;3127;9543;2720;8827;115;528;2153;6787;2268;7315
230840;202008;9057;26420;7765;24236;787;2341;5552;17479;6339;19820
230850;202008;9589;27656;8010;24514;351;1253;5794;17474;6145;18727
230860;202008;5230;13196;4319;11890;68;231;3802;10405;3870;10636
230870;202008;16550;40226;14137;36212;390;1104;11563;29103;11953;30207
230880;202008;2121;6387;1931;6067;50;262;1526;4666;1576;4928
230890;202008;4566;14518;4132;13641;322;1167;2996;9731;3318;10898
230900;202008;2974;8546;2532;7692;179;619;1709;5077;1888;5696
230910;202008;3130;8353;2511;7370;65;295;2033;5945;2098;6240
230920;202008;4597;12897;3853;11712;131;536;3030;9023;3161;9559
230930;202008;6521;18164;5441;16220;294;855;3797;11319;4091;12174
230940;202008;8057;20349;6914;18594;196;495;5771;15412;5967;15907
230945;202008;6466;18551;5532;16759;297;1065;3929;11686;4226;12751
230950;202008;6161;15541;5428;14537;96;253;4704;12617;4800;12870
230960;202008;13265;38380;11646;35338;1906;5741;5856;17971;7762;23712
230970;202008;13496;35705;11215;32129;1714;4861;6352;18483;8066;23344
230980;202008;2675;7788;2344;7205;340;992;1449;4590;1789;5582
230990;202008;1652;4625;1357;4034;65;275;965;2731;1030;3006
231000;202008;2482;6619;2010;5676;77;198;1480;4092;1557;4290
231010;202008;3557;8307;2795;6980;43;167;2428;5879;2471;6046
231020;202008;8031;25066;7144;23311;1313;3950;4041;13776;5354;17726
231025;202008;7481;20558;6475;18903;728;2073;4497;13256;5225;15329
231030;202008;7328;21693;5710;18280;932;2877;2962;9534;3894;12411
231040;202008;2930;8431;2545;7705;122;371;1988;5936;2110;6307
231050;202008;11654;29858;9355;25779;639;1718;6953;18732;7592;20450
231060;202008;2907;8128;2542;7543;61;205;2079;6164;2140;6369
231070;202008;7730;22401;6583;20393;694;2213;4266;13138;4960;15351
231080;202008;3942;11220;3345;10246;129;542;2532;7591;2661;8133
231085;202008;6764;16380;5339;14671;206;542;4181;11495;4387;12037
231090;202008;4518;11662;3310;9330;111;425;2259;6106;2370;6531
231095;202008;2281;6771;1778;5676;135;438;1182;3763;1317;4201
231100;202008;3144;9067;2590;8024;117;434;1936;5923;2053;6357
231110;202008;3589;10490;3259;9879;119;431;2441;7292;2560;7723
231120;202008;2245;6525;1847;5830;77;302;1327;4145;1404;4447
231123;202008;1881;4857;1562;4311;70;158;1138;3168;1208;3326
231126;202008;5520;15121;4450;13090;289;824;3193;9300;3482;10124
231130;202008;21196;54211;17583;49646;1012;3678;13026;36071;14038;39749
231135;202008;4141;11638;3409;10206;154;511;2434;7162;2588;7673
231140;202008;16393;46021;13017;40041;594;2444;9137;27393;9731;29837
231150;202008;5808;15729;4455;13166;673;2028;1987;6021;2660;8049
231160;202008;6214;18880;5435;17430;762;2319;3131;10289;3893;12608
231170;202008;4324;12638;3546;11141;185;675;2460;7468;2645;8143
231180;202008;14434;40751;11640;34844;3206;9270;3935;12318;7141;21588
231190;202008;3871;10920;3176;9643;67;295;2437;7208;2504;7503
231195;202008;4955;14912;4087;13092;251;915;2933;9311;3184;10226
231200;202008;7784;24223;6773;22166;194;975;5323;16884;5517;17859
231210;202008;4817;14075;4089;12859;183;681;3089;9525;3272;10206
231220;202008;12103;31394;9326;26117;394;1212;6835;18446;7229;19658
231230;202008;9211;29241;8081;27192;492;1919;5940;19983;6432;21902
231240;202008;11488;33472;10079;30785;1521;4508;6133;18957;7654;23465
231250;202008;2123;5458;1377;3809;101;288;839;2267;940;2555
231260;202008;3239;9118;2793;8409;268;792;1911;5879;2179;6671
231270;202008;6366;16638;5137;14627;149;589;3875;10755;4024;11344
231280;202008;1718;5350;1564;5064;91;305;1171;3762;1262;4067
231290;202008;37518;111651;31007;98324;5221;16382;14363;45340;19584;61722
231300;202008;4048;11175;3153;9374;203;664;2086;6067;2289;6731
231310;202008;7306;18805;5793;15996;480;1336;3974;10780;4454;12116
231320;202008;7796;21269;6076;18213;91;421;4743;13989;4834;14410
231325;202008;2430;6393;1992;5726;173;402;1334;3936;1507;4338
231330;202008;9438;28178;7719;24744;1372;4179;4132;13855;5504;18034
231335;202008;5686;14981;4799;13540;85;361;4216;11761;4301;12122
231340;202008;17349;53517;15518;50235;1288;4196;11307;37019;12595;41215
231350;202008;15774;42978;14285;40863;275;1009;12787;36210;13062;37219
231355;202008;4374;13000;3908;12119;233;781;3030;9294;3263;10075
231360;202008;7333;22118;6355;20409;260;943;5040;16122;5300;17065
231370;202008;2164;5950;1722;5167;35;113;1306;3910;1341;4023
231375;202008;4335;13463;3946;12818;135;612;3289;10538;3424;11150
231380;202008;5990;16278;5406;15470;182;483;4402;12782;4584;13265
231390;202008;3297;9614;2939;9019;121;464;2175;6501;2296;6965
231395;202008;4006;11722;3306;10591;417;1327;1938;6291;2355;7618
231400;202008;9622;27538;8038;24624;266;1125;6083;18223;6349;19348
231410;202008;14602;45266;13222;42961;594;2249;10664;34273;11258;36522
240010;202008;2605;6827;2023;5752;202;577;1200;3349;1402;3926
240020;202008;12465;34877;10421;31216;633;2347;6960;20539;7593;22886
240030;202008;2851;6956;2581;6535;87;251;2233;5616;2320;5867
240040;202008;813;2341;674;2069;33;129;467;1374;500;1503
240050;202008;3297;8806;2665;7662;46;147;2041;5760;2087;5907
240060;202008;1403;3755;1151;3299;23;86;939;2631;962;2717
240070;202008;2138;6196;1930;5765;177;567;1395;4053;1572;4620
240080;202008;2939;7909;2380;6874;54;213;1825;5166;1879;5379
240090;202008;2246;5506;1819;4780;18;50;1534;3989;1552;4039
240100;202008;10146;24973;8033;21107;208;632;6284;15950;6492;16582
240110;202008;4609;12949;3865;11591;189;682;2797;8228;2986;8910
240120;202008;3282;9087;2622;8272;184;616;1851;5991;2035;6607
240130;202008;3614;7541;3004;6746;29;86;2744;6078;2773;6164
240140;202008;1801;5381;1530;4849;156;548;1032;3239;1188;3787
240145;202008;6594;18249;5363;16134;820;2516;3021;9206;3841;11722
240150;202008;919;2687;806;2447;52;183;620;1822;672;2005
240160;202008;1447;4350;1205;3894;45;206;901;2922;946;3128
240165;202008;968;2638;801;2322;31;105;650;1850;681;1955
240170;202008;2513;6775;2102;6023;189;619;1431;3973;1620;4592
240180;202008;2968;8790;2361;7549;557;1680;1057;3599;1614;5279
240185;202008;1209;3785;1105;3604;53;214;915;2941;968;3155
240190;202008;1047;3110;895;2855;21;98;760;2439;781;2537
240200;202008;10925;27832;8668;23958;877;2639;4960;13376;5837;16015
240210;202008;3249;7987;2659;7054;25;134;2239;5759;2264;5893
240220;202008;7246;21603;6465;20377;326;1438;5094;15768;5420;17206
240230;202008;5827;14805;4654;12831;202;565;3694;10200;3896;10765
240240;202008;1816;5214;1126;3568;119;406;399;1137;518;1543
240250;202008;2939;7704;2581;7212;96;290;2162;6005;2258;6295
240260;202008;14069;41271;12107;37936;1708;4999;7509;24701;9217;29700
240270;202008;2266;6716;1973;6228;100;318;1429;4669;1529;4987
240280;202008;1684;4300;1426;3874;52;144;1141;3060;1193;3204
240290;202008;1188;3459;953;2932;29;134;678;1957;707;2091
240300;202008;2306;5854;1655;4654;70;215;1043;2862;1113;3077
240310;202008;8531;22482;6717;19224;893;2709;3482;9788;4375;12497
240320;202008;2030;5520;1497;4467;34;152;1121;3188;1155;3340
240325;202008;31483;83456;24881;71774;4346;12897;11090;32161;15436;45058
240330;202008;1754;4769;1341;3986;52;190;910;2563;962;2753
240340;202008;1975;4537;1603;3970;65;155;1309;3186;1374;3341
240350;202008;2176;5498;1937;5232;28;84;1755;4759;1783;4843
240360;202008;8873;24395;7881;22826;823;2406;5533;16193;6356;18599
240370;202008;1932;5059;1499;4173;67;197;1064;2876;1131;3073
240375;202008;903;2267;745;1970;27;98;609;1559;636;1657
240380;202008;2244;6358;1644;5003;142;410;956;2874;1098;3284
240390;202008;1041;2515;732;1926;28;61;468;1151;496;1212
240400;202008;1452;3535;1133;2980;36;127;798;1973;834;2100
240410;202008;561;1686;469;1480;38;146;297;883;335;1029
240420;202008;4551;15918;3999;14680;456;1980;2377;8547;2833;10527
240430;202008;3397;8726;2822;7713;177;559;2098;5554;2275;6113
240440;202008;2524;5496;2121;4939;132;254;1722;4023;1854;4277
240450;202008;4556;12343;3549;10431;350;1075;2096;5928;2446;7003
240460;202008;2874;8181;2588;7715;230;745;2012;5966;2242;6711
240470;202008;3638;10874;2761;9042;482;1479;1424;4893;1906;6372
240480;202008;576;1602;390;1183;33;104;181;533;214;637
240485;202008;2150;6033;1754;5297;120;373;1215;3674;1335;4047
240490;202008;1611;4119;1255;3459;85;199;923;2566;1008;2765
240500;202008;2145;5742;1871;5282;103;272;1505;4259;1608;4531
240510;202008;1690;4387;1481;4083;63;234;1226;3301;1289;3535
240520;202008;1460;3545;1131;3088;55;165;853;2334;908;2499
240530;202008;2173;6136;1953;5791;97;293;1605;4735;1702;5028
240540;202008;2274;5671;1982;5214;61;117;1714;4522;1775;4639
240550;202008;679;1917;613;1785;18;75;511;1444;529;1519
240560;202008;3298;8510;2768;7796;271;686;2011;5775;2282;6461
240570;202008;2848;7437;1875;5284;282;807;728;1919;1010;2726
240580;202008;8060;23424;7108;21654;553;1604;5663;17403;6216;19007
240590;202008;740;1919;640;1749;12;40;487;1297;499;1337
240600;202008;1773;4826;1303;3842;47;150;860;2447;907;2597
240610;202008;4206;11307;3549;10109;125;423;2713;7581;2838;8004
240615;202008;1270;3237;1001;2749;108;284;670;1809;778;2093
240620;202008;1845;5172;1583;4708;96;266;1265;3755;1361;4021
240630;202008;2088;5881;1882;5526;147;304;1328;4074;1475;4378
240640;202008;956;2541;753;2201;30;117;563;1618;593;1735
240650;202008;4043;11228;3470;10059;221;641;2644;7568;2865;8209
240660;202008;3094;7875;2745;7422;50;155;2487;6728;2537;6883
240670;202008;2446;6887;1958;5884;138;448;1270;3712;1408;4160
240680;202008;1636;4320;1312;3761;46;143;1000;2792;1046;2935
240690;202008;1001;2500;792;2149;16;69;629;1636;645;1705
240700;202008;2426;6982;1970;6123;56;199;1553;4744;1609;4943
240710;202008;16298;42000;13592;37333;1743;4672;8424;23138;10167;27810
240720;202008;5168;12682;4461;11691;390;1058;3266;8473;3656;9531
240725;202008;1126;3199;858;2659;38;126;568;1701;606;1827
240730;202008;2252;6295;1817;5435;60;219;1377;4037;1437;4256
240740;202008;1818;4872;1445;4142;45;174;1062;2885;1107;3059
240750;202008;2135;7030;1792;6295;263;1004;958;3402;1221;4406
240760;202008;1628;3803;1147;3056;63;91;877;2431;940;2522
240770;202008;3206;8830;2687;8079;128;469;2160;6407;2288;6876
240780;202008;4885;13358;3968;11822;543;1584;2413;7398;2956;8982
240790;202008;870;2463;721;2168;15;69;547;1599;562;1668
240800;202008;47236;113029;36599;96824;5027;13596;18841;49967;23868;63563
240810;202008;90162;232562;76055;208979;9275;26177;48473;131209;57748;157386
240820;202008;5838;17289;5046;15849;693;2144;3118;9963;3811;12107
240830;202008;8714;24750;7715;23244;264;1115;6370;18917;6634;20032
240840;202008;1116;2746;881;2368;29;74;630;1625;659;1699
240850;202008;1369;3701;978;2876;47;150;540;1528;587;1678
240860;202008;1301;3450;980;2870;15;76;729;2030;744;2106
240870;202008;1103;2796;830;2319;131;373;451;1286;582;1659
240880;202008;1259;3977;1113;3686;85;359;858;2762;943;3121
240890;202008;4400;11995;3328;9925;446;1444;1704;4885;2150;6329
240895;202008;2791;8572;2552;8192;145;457;2209;7155;2354;7612
240910;202008;3368;9115;2871;8209;55;195;2342;6577;2397;6772
240920;202008;899;2431;740;2171;67;180;422;1293;489;1473
240930;202008;3691;8359;3046;7568;199;290;2282;5986;2481;6276
240933;202008;1772;4276;1449;3803;40;157;1258;3245;1298;3402
240940;202008;6084;14974;4707;12619;540;1459;2813;7341;3353;8800
240950;202008;1025;3043;892;2796;25;107;726;2220;751;2327
240960;202008;688;2093;615;1946;30;107;471;1459;501;1566
240970;202008;1843;4723;1492;4121;57;207;1219;3257;1276;3464
240980;202008;3313;9827;2927;9130;112;483;2366;7255;2478;7738
240990;202008;2590;7272;2285;6673;264;846;1607;4531;1871;5377
241000;202008;951;2517;751;2145;28;75;555;1559;583;1634
241010;202008;2795;8900;2546;8361;164;644;1874;6066;2038;6710
241020;202008;2138;5648;1581;4528;134;384;1030;2898;1164;3282
241025;202008;1771;5037;1408;4352;49;202;1022;3112;1071;3314
241030;202008;2500;7765;1993;6681;224;763;1277;4290;1501;5053
241040;202008;2303;7222;2034;6760;97;434;1626;5353;1723;5787
241050;202008;1351;3747;1107;3307;33;125;810;2356;843;2481
241060;202008;751;2109;659;1913;27;87;465;1295;492;1382
241070;202008;665;1804;570;1639;13;40;448;1244;461;1284
241080;202008;1138;3199;862;2643;9;37;623;1884;632;1921
241090;202008;2014;5876;1636;5223;43;218;1293;4065;1336;4283
241100;202008;1167;3263;917;2748;68;209;598;1735;666;1944
241105;202008;980;2951;793;2596;251;799;258;881;509;1680
241110;202008;971;2718;727;2205;35;103;483;1411;518;1514
241120;202008;7635;21464;6461;19382;965;2830;3809;11746;4774;14576
241140;202008;3305;8693;2589;7261;151;432;1861;5098;2012;5530
241142;202008;778;2083;571;1681;25;86;342;949;367;1035
241150;202008;5927;15370;5213;14194;145;495;4276;11429;4421;11924
241160;202008;1142;3052;919;2644;134;389;589;1656;723;2045
241170;202008;1341;3408;1141;3061;29;109;954;2457;983;2566
241180;202008;1033;2640;748;2080;94;270;376;1035;470;1305
241190;202008;1151;3013;955;2622;18;73;695;1834;713;1907
241200;202008;19594;50976;16810;46402;2656;7334;9733;26904;12389;34238
241210;202008;1426;3792;1019;2968;119;379;579;1643;698;2022
241220;202008;8888;25944;7711;23935;1751;5368;3654;11798;5405;17166
241230;202008;2962;7707;2602;7138;105;320;2163;5862;2268;6182
241240;202008;1224;3399;760;2358;64;199;334;1038;398;1237
241250;202008;5428;15690;4333;13624;159;728;3141;9503;3300;10231
241255;202008;2259;7004;1989;6427;112;449;1517;4801;1629;5250
241260;202008;4949;12784;3880;10989;84;328;3072;8514;3156;8842
241270;202008;1741;4993;1428;4389;105;362;1026;3144;1131;3506
241280;202008;2190;5454;1870;4871;57;143;1591;4084;1648;4227
241290;202008;3405;8301;2515;6847;75;247;1977;5235;2052;5482
241300;202008;1488;3951;1185;3410;38;126;797;2235;835;2361
241310;202008;2149;5276;1844;4844;14;57;1572;4167;1586;4224
241320;202008;944;3053;804;2784;86;363;520;1774;606;2137
241330;202008;1750;4537;1368;4027;16;83;1188;3469;1204;3552
241335;202008;3245;9013;2864;8317;102;337;2365;6786;2467;7123
241340;202008;1570;4400;1213;3655;251;796;495;1454;746;2250
241350;202008;2088;5918;1822;5441;92;317;1416;4156;1508;4473
241355;202008;1309;3535;1070;3063;16;45;827;2359;843;2404
241360;202008;2058;5310;1543;4255;39;114;1103;2929;1142;3043
241370;202008;1343;3706;1036;3063;48;166;720;2038;768;2204
241380;202008;631;1770;485;1483;74;192;244;773;318;965
241390;202008;2774;8034;2461;7566;202;557;1888;5921;2090;6478
241400;202008;3577;9869;3176;9239;152;484;2573;7426;2725;7910
241410;202008;2409;7128;1961;6207;345;1117;993;3150;1338;4267
241415;202008;1669;4921;1359;4314;60;225;948;2957;1008;3182
241420;202008;2352;7326;2001;6719;466;1738;974;3266;1440;5004
241430;202008;609;1678;416;1242;18;59;257;736;275;795
241440;202008;7605;23248;6779;21779;359;1274;5354;17150;5713;18424
241445;202008;1116;2825;985;2655;22;56;872;2410;894;2466
241450;202008;2666;6577;2271;5935;395;877;1464;3985;1859;4862
241460;202008;3798;10243;3073;8705;196;587;2151;5950;2347;6537
241470;202008;1415;3714;1147;3320;25;92;954;2757;979;2849
241475;202008;1221;3406;955;2887;24;113;682;1970;706;2083
241480;202008;2948;9162;2419;7998;724;2372;801;2944;1525;5316
241490;202008;641;1505;523;1345;27;69;376;948;403;1017
241500;202008;802;2240;712;2123;3;10;656;1977;659;1987
250010;202008;2521;7535;2088;6642;59;238;1522;4733;1581;4971
250020;202008;1637;4335;1179;3443;44;86;842;2466;886;2552
250030;202008;6961;18936;6122;17606;530;1547;4549;12947;5079;14494
250040;202008;4014;12266;3458;11228;227;844;2503;8000;2730;8844
250050;202008;3622;9698;3262;9210;127;437;2659;7518;2786;7955
250053;202008;1177;3277;1065;3093;71;206;772;2255;843;2461
250057;202008;652;2317;607;2247;10;44;543;2043;553;2087
250060;202008;5502;14291;4932;13584;289;770;4064;11263;4353;12033
250070;202008;3966;11041;3355;9963;37;155;2692;7822;2729;7977
250073;202008;761;2017;619;1799;9;22;507;1438;516;1460
250077;202008;2211;5933;1651;5007;61;216;1246;3752;1307;3968
250080;202008;4892;12156;4144;11189;65;287;3619;9636;3684;9923
250090;202008;3322;8106;2896;7539;53;159;2491;6371;2544;6530
250100;202008;3674;11119;3305;10418;163;572;2591;8000;2754;8572
250110;202008;4896;13679;4398;12951;258;967;3422;9855;3680;10822
250115;202008;696;1801;502;1501;9;45;348;1035;357;1080
250120;202008;1820;5321;1525;4830;31;146;1202;3777;1233;3923
250130;202008;5523;15096;4660;13869;73;393;3952;11598;4025;11991
250135;202008;1197;3307;1041;3027;25;96;900;2595;925;2691
250140;202008;2252;6543;2088;6332;103;435;1794;5381;1897;5816
250150;202008;4791;14876;4294;14021;150;671;3426;10985;3576;11656
250153;202008;1406;3700;1168;3338;30;88;934;2648;964;2736
250157;202008;1729;5099;1566;4788;58;239;1247;3748;1305;3987
250160;202008;3915;9708;3116;8625;40;148;2740;7592;2780;7740
250170;202008;1848;4724;1644;4435;25;96;1433;3821;1458;3917
250180;202008;20197;48555;17178;44682;749;2337;13399;33975;14148;36312
250190;202008;4053;10770;3377;9753;318;960;2332;6570;2650;7530
250200;202008;1951;5174;1654;4758;63;197;1389;3999;1452;4196
250205;202008;864;2648;744;2461;15;74;615;2006;630;2080
250210;202008;1553;4679;1397;4426;73;318;1086;3381;1159;3699
250215;202008;1570;4298;1305;3911;77;261;776;2334;853;2595
250220;202008;660;1824;528;1626;26;100;348;1048;374;1148
250230;202008;1672;3738;1109;2865;17;60;922;2293;939;2353
250240;202008;2298;6975;2009;6439;40;202;1664;5246;1704;5448
250250;202008;4584;12694;3988;11819;86;301;3399;10091;3485;10392
250260;202008;1708;4730;1418;4231;50;128;1119;3316;1169;3444
250270;202008;1204;3608;1086;3462;59;205;806;2669;865;2874
250280;202008;3344;9270;2989;8737;108;312;2366;6929;2474;7241
250290;202008;1594;4195;1355;3851;22;69;1063;3023;1085;3092
250300;202008;5500;14619;4932;13955;185;827;4114;11229;4299;12056
250310;202008;1169;3193;966;2856;39;129;735;2148;774;2277
250320;202008;12083;26948;10375;24975;253;703;9273;22018;9526;22721
250330;202008;2407;6604;2014;6061;106;327;1628;4896;1734;5223
250340;202008;1100;2782;982;2632;11;28;900;2405;911;2433
250350;202008;4116;11442;3626;10617;201;479;2842;8588;3043;9067
250355;202008;1966;5918;1761;5634;27;142;1578;5018;1605;5160
250360;202008;1780;4896;1583;4627;39;146;1324;3837;1363;3983
250370;202008;13478;34683;11106;31086;241;904;9335;25749;9576;26653
250375;202008;1187;3088;950;2799;5;17;894;2657;899;2674
250380;202008;1611;4145;1473;3968;29;117;1294;3380;1323;3497
250390;202008;1846;4690;1540;4199;84;233;1224;3303;1308;3536
250400;202008;70352;172063;51297;142189;14247;42303;14529;42564;28776;84867
250403;202008;1738;4835;1547;4605;72;363;1192;3380;1264;3743
250407;202008;1240;3064;987;2688;72;153;692;1950;764;2103
250410;202008;649;1729;560;1575;4;9;465;1280;469;1289
250415;202008;1872;5209;1637;4829;32;145;1398;4097;1430;4242
250420;202008;1180;3336;1072;3182;25;96;957;2822;982;2918
250430;202008;6267;15363;5278;14032;137;423;4363;11361;4500;11784
250435;202008;1538;4284;1229;3738;11;53;940;2823;951;2876
250440;202008;4580;12064;3910;11216;67;190;3470;9954;3537;10144
250450;202008;1830;4804;1491;4337;29;103;1241;3625;1270;3728
250460;202008;7336;19832;6485;18569;326;996;5212;14854;5538;15850
250470;202008;1545;3970;1273;3552;50;158;999;2737;1049;2895
250480;202008;4041;10853;3421;10110;41;146;3016;8984;3057;9130
250485;202008;720;1621;527;1341;40;68;387;958;427;1026
250490;202008;5167;12241;4582;11570;174;519;4044;10023;4218;10542
250500;202008;1992;5487;1764;5090;72;233;1427;4117;1499;4350
250510;202008;5460;13665;4671;12614;76;200;4078;11110;4154;11310
250520;202008;1820;4911;1550;4516;123;394;1107;3198;1230;3592
250523;202008;2228;5475;1969;5147;68;282;1642;4140;1710;4422
250527;202008;1672;4304;1501;4110;24;76;1331;3664;1355;3740
250530;202008;634;1617;538;1483;5;11;476;1312;481;1323
250535;202008;1349;3953;1216;3695;26;111;995;2933;1021;3044
250540;202008;2953;6760;2458;6206;67;124;2151;5527;2218;5651
250550;202008;774;2465;675;2270;22;86;504;1663;526;1749
250560;202008;1750;4793;1544;4496;38;140;1303;3712;1341;3852
250570;202008;2650;7901;2266;7202;80;302;1789;5596;1869;5898
250580;202008;1052;2720;922;2538;47;177;774;2078;821;2255
250590;202008;816;2273;726;2144;19;65;594;1765;613;1830
250600;202008;8204;20896;6829;19113;236;734;5641;15673;5877;16407
250610;202008;2971;8327;2651;7858;117;439;2203;6447;2320;6886
250620;202008;788;2063;670;1864;10;30;496;1347;506;1377
250625;202008;2483;7130;2213;6683;42;221;1873;5490;1915;5711
250630;202008;10148;27984;8181;24511;862;2616;5213;15315;6075;17931
250640;202008;3445;9393;3090;8933;93;375;2647;7525;2740;7900
250650;202008;964;2303;804;2087;13;36;696;1780;709;1816
250660;202008;1637;4034;1309;3581;39;107;1076;2882;1115;2989
250670;202008;2324;7205;2110;6826;44;193;1837;5837;1881;6030
250680;202008;5815;13356;5183;12644;59;225;4805;11569;4864;11794
250690;202008;6819;15280;5757;13955;94;226;5100;12263;5194;12489
250700;202008;4276;11987;3724;11145;425;1254;2595;7744;3020;8998
250710;202008;4416;12590;3789;11727;275;954;2761;8543;3036;9497
250720;202008;2734;7281;2442;6865;36;178;2139;5944;2175;6122
250730;202008;4112;10887;3584;10189;102;421;3000;8278;3102;8699
250740;202008;1925;4789;1596;4350;97;219;1241;3410;1338;3629
250750;202008;104756;256413;88169;233081;7072;20267;63731;165241;70803;185508
250760;202008;2379;6120;2068;5615;89;267;1636;4305;1725;4572
250770;202008;4025;12071;3594;11492;385;1192;2579;8349;2964;9541
250780;202008;1736;4670;1441;4131;48;173;1117;3115;1165;3288
250790;202008;2455;7236;2114;6718;130;515;1438;4459;1568;4974
250800;202008;2452;6482;2131;5962;85;177;1725;4867;1810;5044
250810;202008;1277;3347;1054;3031;29;61;888;2591;917;2652
250820;202008;1989;5511;1828;5333;34;143;1665;4825;1699;4968
250830;202008;5857;17476;4800;15333;263;1014;3296;10206;3559;11220
250840;202008;760;2402;650;2182;14;56;490;1654;504;1710
250850;202008;1795;5317;1601;4971;33;157;1325;4009;1358;4166
250855;202008;948;2809;820;2584;55;198;614;1915;669;2113
250860;202008;3164;9335;2613;8399;440;1483;1528;4920;1968;6403
250870;202008;1043;2844;878;2566;31;116;719;2070;750;2186
250880;202008;1620;4131;1333;3715;73;211;1019;2834;1092;3045
250890;202008;10216;26438;9012;24811;413;1695;7188;18843;7601;20538
250900;202008;2848;7820;2454;7114;70;240;2078;5914;2148;6154
250905;202008;2414;6803;2213;6512;43;171;2013;5915;2056;6086
250910;202008;5909;14668;4856;13474;84;293;4222;11772;4306;12065
250915;202008;2162;5008;1505;4299;24;53;1310;3830;1334;3883
250920;202008;3529;8876;3090;8202;332;750;2265;6058;2597;6808
250930;202008;2261;5980;2035;5690;53;225;1763;4821;1816;5046
250933;202008;1161;3439;1024;3190;21;106;786;2379;807;2485
250937;202008;699;1867;571;1656;24;74;435;1283;459;1357
250939;202008;1759;4674;1529;4371;62;196;1191;3388;1253;3584
250940;202008;4029;10711;3530;10050;15;58;3142;8958;3157;9016
250950;202008;1720;4331;1380;3898;28;109;1126;3123;1154;3232
250960;202008;1125;3267;982;3039;27;141;801;2387;828;2528
250970;202008;8306;21210;7256;19527;224;688;6014;15888;6238;16576
250980;202008;2429;6426;2170;6039;34;146;1872;5075;1906;5221
250990;202008;2060;6195;1714;5586;54;255;1266;4075;1320;4330
251000;202008;2058;5759;1665;5079;38;163;1358;4107;1396;4270
251010;202008;2669;7404;2415;7024;19;78;2174;6321;2193;6399
251020;202008;1640;4438;1465;4160;33;148;1270;3532;1303;3680
251030;202008;1011;2683;827;2341;35;99;582;1627;617;1726
251040;202008;1827;5139;1532;4636;38;188;1236;3713;1274;3901
251050;202008;1062;2884;880;2529;49;162;622;1719;671;1881
251060;202008;1082;2309;813;1966;8;26;638;1518;646;1544
251065;202008;476;1300;368;1099;11;33;249;726;260;759
251070;202008;732;1883;622;1723;10;41;532;1443;542;1484
251080;202008;18602;47500;15082;42173;1836;5318;9701;27232;11537;32550
251090;202008;2772;7975;2328;7178;55;199;1860;5693;1915;5892
251100;202008;814;2578;726;2415;25;93;556;1777;581;1870
251110;202008;1698;4531;1439;4080;48;126;1091;3076;1139;3202
251120;202008;7321;20329;6151;18891;279;1015;4871;14959;5150;15974
251130;202008;3867;8653;3409;8142;60;166;3084;7329;3144;7495
251140;202008;4259;11846;3802;11203;75;311;3175;9245;3250;9556
251150;202008;2640;7673;2370;7238;100;417;1944;5808;2044;6225
251160;202008;2130;6224;1846;5809;39;189;1588;4901;1627;5090
251170;202008;1557;4230;1352;3959;32;111;1168;3403;1200;3514
251180;202008;2635;7018;2147;6326;168;498;1464;4292;1632;4790
251190;202008;4383;11396;3986;10947;45;248;3622;9747;3667;9995
251200;202008;4340;12679;3818;12001;73;309;3356;10573;3429;10882
251203;202008;949;3089;870;2912;21;102;655;2130;676;2232
251207;202008;1087;2956;838;2539;19;96;587;1735;606;1831
251210;202008;7618;19246;6213;17335;276;644;4746;13512;5022;14156
251220;202008;1180;2835;926;2497;54;122;710;1958;764;2080
251230;202008;4591;12717;3948;11604;114;424;3116;8918;3230;9342
251240;202008;3669;9959;3073;8961;164;443;2297;6605;2461;7048
251250;202008;10257;27562;8967;25389;728;2164;6628;18216;7356;20380
251260;202008;482;1378;438;1309;12;62;349;1009;361;1071
251270;202008;4257;13210;3814;12620;108;443;3109;10511;3217;10954
251272;202008;1339;3621;1202;3438;45;168;1012;2819;1057;2987
251274;202008;895;2476;713;2140;60;200;473;1357;533;1557
251275;202008;1214;3392;1034;3100;29;131;813;2370;842;2501
251276;202008;1320;3572;1147;3343;30;155;931;2616;961;2771
251278;202008;582;1601;520;1511;46;111;378;1128;424;1239
251280;202008;2227;6045;1988;5677;49;170;1665;4686;1714;4856
251290;202008;5888;13877;5310;13169;150;498;4632;11126;4782;11624
251300;202008;861;2510;778;2383;8;41;660;2017;668;2058
251310;202008;2705;7785;2349;7228;49;259;1884;5656;1933;5915
251315;202008;1701;5300;1552;5025;82;252;1175;3762;1257;4014
251320;202008;1615;4278;1158;3495;35;123;861;2552;896;2675
251330;202008;2111;4893;1717;4430;21;77;1548;4023;1569;4100
251335;202008;1091;3151;973;2966;25;114;849;2528;874;2642
251340;202008;3701;8921;2953;7918;118;356;2265;6038;2383;6394
251350;202008;1054;3032;945;2849;26;100;778;2306;804;2406
251360;202008;1832;5113;1475;4610;21;101;1244;3903;1265;4004
251365;202008;721;1957;568;1656;5;20;446;1286;451;1306
251370;202008;24619;64554;21052;59414;2857;8162;12761;36803;15618;44965
251380;202008;1206;3402;1049;3133;19;108;877;2543;896;2651
251385;202008;754;1927;577;1602;18;52;422;1132;440;1184
251390;202008;6465;18683;5682;17447;482;1524;3769;11615;4251;13139
251392;202008;974;2647;815;2405;28;115;632;1828;660;1943
251394;202008;610;1763;501;1570;19;85;373;1147;392;1232
251396;202008;665;1784;568;1613;14;40;401;1114;415;1154
251398;202008;966;2418;667;1905;18;70;490;1363;508;1433
251400;202008;1223;2976;972;2635;25;95;768;2003;793;2098
251410;202008;1505;3530;1223;3132;17;73;1040;2559;1057;2632
251420;202008;1908;5017;1545;4592;40;157;1225;3599;1265;3756
251430;202008;1544;4690;1386;4419;29;134;1200;3823;1229;3957
251440;202008;1106;3082;890;2679;37;99;706;2139;743;2238
251445;202008;1531;4270;1407;4098;36;121;1187;3405;1223;3526
251450;202008;4488;13070;3972;12298;85;336;3299;10122;3384;10458
251455;202008;858;2589;777;2443;23;97;615;1886;638;1983
251460;202008;885;2562;775;2393;15;53;636;1975;651;2028
251465;202008;453;1315;388;1196;7;28;288;864;295;892
251470;202008;1185;3247;882;2611;72;231;512;1444;584;1675
251480;202008;988;2609;803;2275;19;80;619;1669;638;1749
251490;202008;1881;4941;1487;4389;57;178;1105;3268;1162;3446
251500;202008;1938;5443;1776;5230;28;99;1603;4723;1631;4822
251510;202008;2647;7909;2185;6980;107;398;1482;4624;1589;5022
251520;202008;966;2546;731;2112;64;181;470;1325;534;1506
251530;202008;14688;35148;11770;31505;102;570;10394;27322;10496;27892
251540;202008;2986;8470;2691;7918;72;252;2245;6505;2317;6757
251550;202008;3769;8878;3009;7927;103;202;2505;6657;2608;6859
251560;202008;544;1644;475;1536;58;200;328;1029;386;1229
251570;202008;943;2647;762;2288;18;80;605;1765;623;1845
251580;202008;1890;4475;1683;4173;36;152;1467;3493;1503;3645
251590;202008;1567;3885;1315;3589;50;135;1096;2941;1146;3076
251593;202008;904;2633;807;2477;85;266;520;1572;605;1838
251597;202008;2108;5896;1895;5615;20;103;1686;4927;1706;5030
251600;202008;6408;17233;5595;15989;167;528;4622;13017;4789;13545
251610;202008;3227;9156;2754;8265;244;682;1880;5744;2124;6426
251615;202008;1244;3092;1003;2727;22;62;808;2143;830;2205
251620;202008;19037;43661;14648;38274;105;356;12535;33224;12640;33580
251630;202008;4710;11062;3773;9762;193;510;2834;7273;3027;7783
251640;202008;2150;5822;1900;5429;28;132;1648;4597;1676;4729
251650;202008;3958;10650;3456;9982;134;426;2930;8448;3064;8874
251660;202008;3464;10362;3038;9608;70;330;2541;7898;2611;8228
251670;202008;3994;11296;3553;10665;49;249;3160;9398;3209;9647
251675;202008;640;1836;578;1760;76;231;380;1176;456;1407
251680;202008;2504;6612;2079;6059;44;144;1679;4936;1723;5080
251690;202008;3100;8675;2610;7820;89;270;1950;5785;2039;6055
251700;202008;2083;5917;1738;5483;42;194;1472;4564;1514;4758
251710;202008;798;2062;546;1546;40;133;318;866;358;999
251720;202008;1307;3697;1046;3238;23;103;801;2407;824;2510
251740;202008;617;1717;495;1488;45;162;328;946;373;1108
260005;202008;29872;62865;24501;55941;1636;3672;18893;42360;20529;46032
260010;202008;10251;26782;8425;23804;460;1371;5010;14221;5470;15592
260020;202008;6832;15957;5792;14466;104;469;4896;12000;5000;12469
260030;202008;6818;17358;5748;15808;132;397;4668;12779;4800;13176
260040;202008;7607;19652;6337;17811;437;1217;4464;12740;4901;13957
260050;202008;13903;36009;11539;33380;181;708;10591;30684;10772;31392
260060;202008;4040;10034;3463;9100;200;476;2725;7178;2925;7654
260070;202008;10529;26393;8981;24153;328;1138;7252;18984;7580;20122
260080;202008;6511;14817;5670;13702;113;369;4770;11324;4883;11693
260090;202008;4634;11935;4103;11206;458;1275;2905;7942;3363;9217
260100;202008;3000;8079;2503;7344;53;266;2060;5939;2113;6205
260105;202008;5001;13630;4468;12911;122;433;3763;10732;3885;11165
260110;202008;22212;61272;19711;57627;922;3140;16245;46845;17167;49985
260120;202008;14524;38507;12169;34967;1428;4035;7781;22734;9209;26769
260130;202008;3082;7924;2740;7414;248;665;1992;5320;2240;5985
260140;202008;13052;29427;11217;27237;540;1466;9414;22518;9954;23984
260150;202008;3596;8303;3079;7664;84;251;2705;6659;2789;6910
260160;202008;6507;16935;5478;15679;88;309;4931;14258;5019;14567
260170;202008;20228;47674;17116;43419;898;2282;13665;34261;14563;36543
260180;202008;3488;9275;3011;8626;74;271;2588;7310;2662;7581
260190;202008;18280;36625;15325;33126;167;439;13595;28835;13762;29274
260200;202008;11144;26653;9546;24615;432;984;7966;20826;8398;21810
260210;202008;11845;33373;10005;30350;322;1211;7951;23969;8273;25180
260220;202008;10273;24754;9473;23734;167;552;8336;20584;8503;21136
260230;202008;10705;26203;9316;24356;193;636;7858;20181;8051;20817
260240;202008;2698;8064;2355;7406;97;328;1820;5678;1917;6006
260250;202008;2181;5732;1885;5259;114;265;1438;4006;1552;4271
260260;202008;13028;33691;11571;31458;362;1206;9174;24440;9536;25646
260270;202008;4278;10250;3753;9615;131;471;3140;7891;3271;8362
260280;202008;12689;38185;11365;36301;439;1907;9673;30452;10112;32359
260290;202008;40931;103063;35108;94592;3798;10435;23802;63880;27600;74315
260300;202008;9587;25848;8309;24105;192;867;6986;20200;7178;21067
260310;202008;5120;13101;4489;12290;310;780;3464;9636;3774;10416
260320;202008;7656;21998;6445;19935;255;818;5243;16215;5498;17033
260330;202008;2555;7803;2233;7147;69;257;1767;5510;1836;5767
260340;202008;2038;5443;1753;5011;25;109;1500;4198;1525;4307
260345;202008;25240;65277;21020;59108;3113;9327;11108;30706;14221;40033
260350;202008;5554;13056;4818;12200;67;199;4270;10758;4337;10957
260360;202008;2512;6544;2264;6089;45;194;1587;4164;1632;4358
260370;202008;5553;15850;4769;14529;231;791;3682;11148;3913;11939
260380;202008;4975;14651;4241;13444;161;546;3181;9983;3342;10529
260390;202008;4493;13410;3720;11821;215;680;2487;7766;2702;8446
260392;202008;3338;10689;2985;10239;116;694;2404;8241;2520;8935
260400;202008;18223;41956;15713;38659;472;1333;12383;29329;12855;30662
260410;202008;73210;177313;56443;153702;9942;28394;25284;71047;35226;99441
260415;202008;4433;11826;3819;10802;60;250;3114;8654;3174;8904
260420;202008;12718;26331;10763;24149;101;283;9975;22172;10076;22455
260430;202008;2714;8449;2331;7689;101;408;1662;5415;1763;5823
260440;202008;3730;9647;3291;8973;68;244;2762;7394;2830;7638
260450;202008;5737;14427;5120;13632;291;601;4218;11445;4509;12046
260460;202008;5214;15466;4428;14074;471;1669;2647;8266;3118;9935
260470;202008;4906;12917;4137;12019;81;196;3789;11174;3870;11370
260480;202008;3977;10561;3330;9634;217;769;2305;6676;2522;7445
260490;202008;5345;12245;4722;11326;34;141;4298;10127;4332;10268
260500;202008;6095;15279;5210;14033;456;1161;3651;9974;4107;11135
260510;202008;9814;24114;8201;21858;113;444;7230;19082;7343;19526
260515;202008;4294;11579;3335;9773;156;444;2238;6386;2394;6830
260520;202008;17103;39456;14898;36618;757;1829;12132;29442;12889;31271
260530;202008;9771;27840;8302;25564;142;673;7125;21635;7267;22308
260540;202008;7201;15551;6332;14449;147;345;5682;12880;5829;13225
260545;202008;63;194;35;121;2;7;14;45;16;52
260550;202008;3080;8457;2524;7546;113;448;1710;4992;1823;5440
260560;202008;5906;15084;4957;13716;122;470;4175;11319;4297;11789
260570;202008;7723;20907;6780;19627;373;1181;5332;15488;5705;16669
260580;202008;4466;10543;4012;9943;23;81;3682;9095;3705;9176
260590;202008;6705;15510;5617;14291;227;546;4663;12040;4890;12586
260600;202008;30879;79661;24998;70600;1112;3463;18872;52398;19984;55861
260610;202008;7301;18754;6519;17736;394;1143;4895;13238;5289;14381
260620;202008;16365;42246;14233;39165;1251;3892;10329;27825;11580;31717
260630;202008;2385;6415;1943;5707;35;149;1566;4493;1601;4642
260640;202008;21810;48956;18178;44777;843;2055;14623;35839;15466;37894
260650;202008;6224;16001;4955;14450;333;788;4070;12085;4403;12873
260660;202008;7016;18493;6046;17194;155;676;5174;14378;5329;15054
260670;202008;2235;5808;1876;5260;77;197;1375;3786;1452;3983
260680;202008;28787;68223;24186;61630;1677;4557;17085;42647;18762;47204
260690;202008;3535;9116;2935;8186;86;337;2301;6355;2387;6692
260700;202008;6098;17390;5685;16914;20;69;5499;16479;5519;16548
260710;202008;1363;3560;1171;3286;31;121;918;2571;949;2692
260720;202008;23763;58722;20319;54114;1975;5387;14663;38850;16638;44237
260730;202008;7761;22083;6756;20674;260;953;5635;16991;5895;17944
260740;202008;1335;3768;1120;3415;13;71;877;2735;890;2806
260750;202008;7176;19503;5979;18008;229;488;5225;16209;5454;16697
260760;202008;5711;13428;4904;12471;188;513;4032;10290;4220;10803
260765;202008;8060;23097;6994;21626;408;1689;4945;14969;5353;16658
260770;202008;3856;9797;3199;8711;120;382;2504;6735;2624;7117
260775;202008;5222;13848;4579;12868;187;689;3575;9696;3762;10385
260780;202008;3644;10742;3240;10092;279;1035;2085;6269;2364;7304
260790;202008;120613;268572;99458;240833;15154;35491;61242;148833;76396;184324
260795;202008;3007;7662;2570;7091;78;265;2005;5574;2083;5839
260800;202008;5406;12446;4799;11597;121;383;4206;9838;4327;10221
260805;202008;3653;10251;3072;9226;159;562;2309;6794;2468;7356
260810;202008;6505;17574;5695;16014;465;1223;4109;11334;4574;12557
260820;202008;4574;10508;4001;9809;101;368;3302;7895;3403;8263
260825;202008;2911;8647;2529;7980;107;383;1888;5884;1995;6267
260830;202008;4235;12262;3503;10926;452;1243;2228;7173;2680;8416
260840;202008;4188;10854;3727;10219;206;525;3087;8492;3293;9017
260845;202008;4377;11501;3882;10652;225;635;2911;7874;3136;8509
260850;202008;5133;13967;4266;12306;345;1070;2741;7640;3086;8710
260860;202008;3508;9853;2961;8911;102;360;2355;6908;2457;7268
260870;202008;4554;10887;3871;10052;67;249;3450;8841;3517;9090
260875;202008;7103;17356;5811;15464;569;1509;3934;10571;4503;12080
260880;202008;9754;27232;8432;24938;482;1461;6587;19451;7069;20912
260890;202008;13029;33374;11255;30655;596;1742;8219;21844;8815;23586
260900;202008;5405;14959;4435;13579;316;1031;2942;8989;3258;10020
260910;202008;3238;8707;2794;8033;98;315;2197;6266;2295;6581
260915;202008;5198;15109;4538;14338;61;272;4141;13105;4202;13377
260920;202008;3305;8122;2778;7554;99;254;2372;6518;2471;6772
260930;202008;3751;11733;3180;10706;178;723;2352;7724;2530;8447
260940;202008;14830;35014;12889;32316;1007;2455;9683;23978;10690;26433
260950;202008;7021;18613;5647;16231;364;1234;3653;10028;4017;11262
260960;202008;70827;157285;56690;139031;6252;15753;35934;87041;42186;102794
260970;202008;5638;14676;5008;13831;251;560;3762;10579;4013;11139
260980;202008;4540;13120;3996;12439;54;191;3643;11435;3697;11626
260990;202008;18207;49707;15375;45828;867;2812;11962;35324;12829;38136
261000;202008;16331;38184;13680;34799;376;1323;11033;27375;11409;28698
261010;202008;2391;6213;2086;5814;74;187;1811;5077;1885;5264
261020;202008;6134;16565;5250;15041;190;701;4253;11706;4443;12407
261030;202008;4050;11635;3502;10691;124;506;2768;8212;2892;8718
261040;202008;5241;15230;4218;13278;148;599;3151;9669;3299;10268
261050;202008;7804;20222;7080;19087;449;879;5400;14677;5849;15556
261060;202008;14234;35374;12348;33075;269;885;10292;27271;10561;28156
261070;202008;65312;141289;54002;126334;2861;6569;41247;94370;44108;100939
261080;202008;6747;16015;6148;15264;134;328;5660;14034;5794;14362
261090;202008;19354;45281;17197;42497;295;978;15091;36660;15386;37638
261100;202008;8416;23114;7271;21399;505;1587;5294;15607;5799;17194
261110;202008;66978;184739;55847;164725;7887;24502;32435;94581;40322;119083
261120;202008;3702;9219;3183;8513;87;222;2740;7338;2827;7560
261130;202008;7318;17807;6406;16573;116;353;5666;14549;5782;14902
261140;202008;3698;8455;3278;7891;180;455;2610;6190;2790;6645
261150;202008;5317;13820;4691;12874;72;269;4075;11058;4147;11327
261153;202008;1887;5673;1602;5117;57;205;1085;3484;1142;3689
261160;202008;212935;491603;171783;434306;41738;108889;70878;182374;112616;291263
261170;202008;6032;14989;5348;13964;315;750;4266;11073;4581;11823
261180;202008;9604;23766;8377;22149;455;1158;6092;16195;6547;17353
261190;202008;4614;13402;4114;12567;183;777;3227;9542;3410;10319
261200;202008;3408;7817;3031;7308;129;336;2551;6036;2680;6372
261210;202008;1916;4589;1625;4181;63;182;1366;3450;1429;3632
261220;202008;13797;38834;11422;34430;1430;4669;6502;19304;7932;23973
261230;202008;4016;11482;3355;10562;49;203;2792;8869;2841;9072
261240;202008;5392;13394;4710;12319;260;684;3853;9932;4113;10616
261245;202008;3631;10221;3042;9178;72;351;2421;7063;2493;7414
261247;202008;2943;8765;2433;7844;153;537;1658;5313;1811;5850
261250;202008;22548;51164;19512;47610;1746;3808;14799;37067;16545;40875
261255;202008;4091;11986;3306;10459;137;613;2424;7423;2561;8036
261260;202008;12759;34252;11002;31955;348;1430;9443;27050;9791;28480
261270;202008;4469;10911;3899;10181;191;534;3222;8290;3413;8824
261280;202008;2592;7135;2273;6588;69;243;1808;5094;1877;5337
261290;202008;2981;7629;2492;7071;69;272;2015;5758;2084;6030
261300;202008;12547;34610;10592;31283;588;2066;7696;22227;8284;24293
261310;202008;8813;22320;7503;20527;627;1925;5505;14688;6132;16613
261320;202008;5943;16772;5173;15503;79;347;4345;12824;4424;13171
261330;202008;5858;14285;5263;13507;124;440;4569;11502;4693;11942
261340;202008;4273;11846;3687;11091;134;493;3052;9074;3186;9567
261350;202008;8778;25460;7771;23778;126;582;6315;19037;6441;19619
261360;202008;8209;19701;6932;17892;242;688;5519;13869;5761;14557
261370;202008;23660;58885;19842;53569;2122;5636;12826;34875;14948;40511
261380;202008;4113;12314;3610;11430;453;1504;2360;7364;2813;8868
261390;202008;16843;47366;14157;42999;1215;4011;9400;28306;10615;32317
261400;202008;4641;14645;4024;13320;170;745;3006;9693;3176;10438
261410;202008;9649;23875;7917;21199;454;1297;6248;16332;6702;17629
261420;202008;7409;22014;6658;21083;775;2823;4684;14753;5459;17576
261430;202008;3430;9641;2876;8770;59;263;2393;7191;2452;7454
261440;202008;1478;4382;1227;3895;36;177;879;2662;915;2839
261450;202008;15024;40370;13242;37603;189;693;10947;31136;11136;31829
261460;202008;7531;20725;6643;19315;257;861;5323;15377;5580;16238
261470;202008;4187;10333;3641;9611;24;125;3137;8262;3161;8387
261480;202008;5089;15488;4368;14271;195;783;3372;10796;3567;11579
261485;202008;4952;14065;4253;12965;333;1111;3038;9115;3371;10226
261500;202008;5909;15045;5167;14038;384;926;3606;10182;3990;11108
261510;202008;1903;5609;1646;5180;62;229;1247;3946;1309;4175
261520;202008;2358;7215;2117;6715;69;244;1547;4883;1616;5127
261530;202008;12014;34970;9714;30731;906;3408;4949;15085;5855;18493
261540;202008;8149;23229;7312;22020;1064;3166;4159;13207;5223;16373
261550;202008;3698;9751;3189;8945;229;687;2278;6272;2507;6959
261560;202008;7798;23074;6736;21492;278;1066;5187;16552;5465;17618
261570;202008;3551;9446;2828;8284;194;678;1952;5601;2146;6279
261580;202008;6795;17668;5845;16382;110;516;5237;14459;5347;14975
261590;202008;2734;6934;2187;6157;72;236;1653;4622;1725;4858
261600;202008;5145;12915;4320;11672;299;727;3026;8400;3325;9127
261610;202008;2216;6233;1771;5424;98;358;1204;3647;1302;4005
261618;202008;2554;6305;2222;5817;65;175;1787;4652;1852;4827
261620;202008;4212;11764;3840;11219;816;2106;2417;7441;3233;9547
261630;202008;6336;17710;5356;15852;364;1284;3588;10185;3952;11469
261640;202008;37619;83889;31914;76798;1848;3534;24031;59632;25879;63166
261650;202008;4145;10213;3520;9386;149;472;2636;6972;2785;7444
270010;202008;4320;14399;3703;13338;168;946;2932;10249;3100;11195
270020;202008;3891;9674;3386;9021;129;438;2892;7527;3021;7965
270030;202008;34220;92086;28436;82739;3661;10399;18834;54874;22495;65273
270040;202008;10829;29006;9268;27152;369;1381;7675;22290;8044;23671
270050;202008;5544;12806;4712;11859;220;527;4115;10403;4335;10930
270060;202008;2172;5420;1802;4995;153;374;1427;4017;1580;4391
270070;202008;4685;13076;4066;12206;138;515;3403;10029;3541;10544
270080;202008;1459;3946;1218;3539;42;129;932;2601;974;2730
270090;202008;1767;5396;1580;5026;65;260;1290;4006;1355;4266
270100;202008;5473;14400;4706;13270;146;562;3917;10837;4063;11399
270110;202008;3250;7570;2613;6831;144;338;2064;5641;2208;5979
270120;202008;2769;7498;2390;6992;71;308;2014;5790;2085;6098
270130;202008;5101;13043;4401;12210;120;382;3798;10560;3918;10942
270135;202008;2037;4840;1723;4491;49;154;1558;4041;1607;4195
270140;202008;9703;22497;7746;19788;318;1102;6109;14854;6427;15956
270150;202008;2709;8092;2471;7751;2;13;2331;7295;2333;7308
270160;202008;6236;16670;5255;15568;71;332;4853;14365;4924;14697
270170;202008;3384;9857;2848;9106;177;837;2162;6617;2339;7454
270180;202008;2241;6906;2037;6641;39;190;1835;5938;1874;6128
270190;202008;1636;4858;1444;4619;36;183;1263;4005;1299;4188
270200;202008;2426;7325;2106;6891;112;425;1528;4969;1640;5394
270210;202008;5726;13447;4868;12486;76;322;4473;11289;4549;11611
270220;202008;1543;4002;1234;3564;207;622;705;2011;912;2633
270230;202008;9377;25831;7716;23254;646;2155;5477;16336;6123;18491
270235;202008;5675;17418;4881;16144;117;540;4019;13149;4136;13689
270240;202008;10581;29051;8511;26144;935;3117;5910;18186;6845;21303
270250;202008;2746;6927;2397;6422;191;501;1885;5049;2076;5550
270255;202008;4442;12669;3437;10823;110;451;2620;8119;2730;8570
270260;202008;5584;16375;5051;15498;100;507;4420;13240;4520;13747
270270;202008;1045;2694;863;2468;101;301;632;1786;733;2087
270280;202008;3955;9372;3115;8320;486;785;2167;6263;2653;7048
270290;202008;7417;23566;6629;22245;182;864;5744;19061;5926;19925
270300;202008;4235;10900;3277;9865;156;423;2535;7818;2691;8241
270310;202008;6935;19359;5940;17813;99;528;5063;14786;5162;15314
270320;202008;5556;16234;4823;14812;437;1379;3404;10198;3841;11577
270330;202008;3844;12541;3407;11875;258;1041;2608;9044;2866;10085
270340;202008;1601;4325;1382;4033;46;149;1171;3366;1217;3515
270350;202008;1900;4447;1559;4041;143;410;1106;2877;1249;3287
270360;202008;2610;6507;2321;6181;72;160;2138;5727;2210;5887
270370;202008;1393;4291;1263;4046;34;158;1054;3322;1088;3480
270375;202008;3123;7230;2586;6639;19;62;2427;6246;2446;6308
270380;202008;5449;15354;4573;14205;622;1861;2965;9584;3587;11445
270390;202008;1211;3028;983;2764;23;93;807;2266;830;2359
270400;202008;6266;16429;5237;14872;246;702;4064;11461;4310;12163
270410;202008;4613;13195;3967;12192;151;533;3288;10057;3439;10590
270420;202008;5518;16273;4943;15426;127;609;4278;13092;4405;13701
270430;202008;134797;319203;105721;281906;20933;58082;50124;135683;71057;193765
270440;202008;4708;12681;4046;11861;87;381;3513;10156;3600;10537
270450;202008;7068;18914;6182;17846;261;879;5164;15023;5425;15902
270460;202008;3798;8367;3259;7726;159;322;2918;6941;3077;7263
270470;202008;11065;30734;9572;28601;650;2147;7364;21970;8014;24117
270480;202008;2958;7824;2487;7137;95;371;2024;5663;2119;6034
270490;202008;957;2611;826;2451;48;155;660;1941;708;2096
270500;202008;4912;14941;4338;13986;288;1057;3379;10763;3667;11820
270510;202008;5578;14728;4690;13598;336;1332;3499;9657;3835;10989
270520;202008;3969;11261;3122;9808;635;2084;1290;4207;1925;6291
270530;202008;1267;3595;1077;3306;52;153;763;2376;815;2529
270540;202008;2216;6339;1903;5932;59;274;1650;5045;1709;5319
270550;202008;6719;17295;5337;15776;588;1411;3984;12246;4572;13657
270560;202008;2959;7680;2542;7118;132;426;2047;5674;2179;6100
270570;202008;4127;11521;3477;10546;116;369;2823;8512;2939;8881
270580;202008;2274;6401;2058;6085;98;289;1781;5220;1879;5509
270590;202008;1602;4791;1475;4626;15;78;1388;4324;1403;4402
270600;202008;2769;8463;2503;8067;47;243;2217;7063;2264;7306
270610;202008;3621;9465;3118;8803;68;263;2793;7799;2861;8062
270620;202008;1211;3704;1100;3484;34;152;940;2879;974;3031
270630;202008;17565;42695;15033;39198;583;1853;12621;32180;13204;34033
270640;202008;5390;15459;4647;14261;169;684;3773;11339;3942;12023
270642;202008;2516;8044;2224;7568;158;680;1702;5657;1860;6337
270644;202008;3603;8938;2944;8076;281;682;2199;6204;2480;6886
270650;202008;3147;9200;2751;8639;356;1204;1951;6075;2307;7279
270660;202008;2047;5146;1701;4645;81;283;1267;3407;1348;3690
270670;202008;16387;37356;13532;33853;395;1188;11507;28147;11902;29335
270680;202008;5564;13122;4951;12452;119;170;4630;11798;4749;11968
270690;202008;9125;22282;7593;20364;516;1354;5936;15902;6452;17256
270700;202008;519;1549;450;1435;30;123;323;1009;353;1132
270710;202008;5438;16358;4803;15374;227;969;3855;12110;4082;13079
270720;202008;3608;10527;3182;9809;63;339;2796;8448;2859;8787
270730;202008;8152;17988;7105;16862;242;483;5567;14678;5809;15161
270740;202008;2385;6219;2100;5883;91;309;1747;4823;1838;5132
270750;202008;5722;14991;4994;14061;80;376;4436;12410;4516;12786
270760;202008;3266;9171;2824;8575;49;252;2397;7187;2446;7439
270770;202008;20776;50490;16525;45297;2582;6398;10300;29797;12882;36195
270780;202008;1795;4990;1646;4777;83;296;1396;3985;1479;4281
270790;202008;1604;4426;1338;4054;97;316;982;2950;1079;3266
270800;202008;10850;29497;9707;27869;334;1207;8325;23535;8659;24742
270810;202008;3321;9443;2613;8237;170;655;1837;5690;2007;6345
270820;202008;1637;4898;1377;4479;54;261;1079;3417;1133;3678
270830;202008;5174;12284;4163;11039;165;545;3379;8808;3544;9353
270840;202008;8238;24433;7313;23120;176;959;6389;19690;6565;20649
270850;202008;9058;21377;7987;20094;645;1854;6598;16308;7243;18162
270860;202008;14379;31787;11340;28318;608;1405;9127;22758;9735;24163
270870;202008;2160;6092;1778;5466;233;696;1164;3662;1397;4358
270880;202008;8089;24139;7186;22773;218;937;5944;18492;6162;19429
270890;202008;2810;7577;2354;6926;180;552;1635;4806;1815;5358
270895;202008;3122;9515;2823;9122;72;392;2495;7894;2567;8286
270900;202008;1782;4586;1340;3870;36;107;1043;2978;1079;3085
270910;202008;3868;11156;3311;10274;91;314;2694;8270;2785;8584
270915;202008;9418;26882;7579;23866;644;2371;5166;15896;5810;18267
270920;202008;5086;15816;4588;14955;162;798;3774;11890;3936;12688
270930;202008;17292;40040;13376;35482;1874;4531;8959;24962;10833;29493
270940;202008;6567;17151;5567;15956;185;867;4535;12618;4720;13485
280010;202008;695;1903;543;1571;15;59;382;996;397;1055
280020;202008;4897;12315;4137;11109;475;1197;2791;7572;3266;8769
280030;202008;75674;177001;59424;153858;12471;32684;26399;71211;38870;103895
280040;202008;2903;8121;2518;7515;247;768;1690;5004;1937;5772
280050;202008;3836;10888;3284;10011;550;1748;1943;5911;2493;7659
280060;202008;5901;15421;4678;13517;883;2694;2177;6544;3060;9238
280067;202008;6951;17053;5892;15453;319;831;4317;11192;4636;12023
280070;202008;1922;5640;1784;5420;128;395;1468;4434;1596;4829
280100;202008;4003;10609;3359;9581;319;941;2299;6552;2618;7493
280110;202008;1379;3732;1199;3464;17;85;1054;2965;1071;3050
280120;202008;7601;21809;6760;20455;748;2101;4925;15275;5673;17376
280130;202008;9225;21425;8056;19745;413;1107;6528;15826;6941;16933
280140;202008;5456;13019;4786;12125;199;586;4063;10175;4262;10761
280150;202008;4233;10592;3653;9790;344;862;2791;7509;3135;8371
280160;202008;1226;3466;1021;3124;93;312;697;2077;790;2389
280170;202008;5177;13630;4618;12889;232;635;3729;10413;3961;11048
280190;202008;1299;2817;1129;2591;55;128;922;2075;977;2203
280200;202008;1265;3298;1038;2975;72;262;772;2164;844;2426
280210;202008;16685;41524;14446;38315;1530;4205;9229;24488;10759;28693
280220;202008;1758;4673;1505;4332;46;214;1237;3522;1283;3736
280230;202008;4319;10823;3614;9777;294;681;2557;6990;2851;7671
280240;202008;3316;8837;2956;8285;53;276;2534;6876;2587;7152
280250;202008;884;2168;715;1912;69;205;471;1218;540;1423
280260;202008;2228;5302;1969;4982;37;97;1786;4553;1823;4650
280270;202008;2376;6430;2088;5981;125;373;1711;4847;1836;5220
280280;202008;4211;12418;3726;11694;487;1309;2610;8582;3097;9891
280290;202008;18143;47717;15521;44024;1370;4127;10356;29641;11726;33768
280300;202008;11899;28678;10362;27022;291;837;7678;22026;7969;22863
280310;202008;1401;3574;1149;3143;37;126;864;2291;901;2417
280320;202008;8632;23220;7480;21489;895;2596;5008;14244;5903;16840
280330;202008;4723;11620;3996;10607;264;725;2923;7733;3187;8458
280340;202008;5480;11443;4571;10458;227;386;3956;9241;4183;9627
280350;202008;26108;60842;22830;56501;1130;2982;17965;43697;19095;46679
280360;202008;5789;15869;5026;14598;751;2213;2940;8672;3691;10885
280370;202008;2141;5290;1788;4705;62;167;1410;3651;1472;3818
280380;202008;996;2638;853;2440;77;221;579;1682;656;1903
280390;202008;3684;9025;3063;8043;144;361;2444;6374;2588;6735
280400;202008;3941;9906;3396;9142;531;1261;2055;5852;2586;7113
280410;202008;2266;6236;1813;5497;197;615;1041;3096;1238;3711
280420;202008;4311;11420;3948;10957;73;285;3621;9979;3694;10264
280430;202008;2065;4996;1798;4640;67;252;1458;3639;1525;3891
280440;202008;4283;11340;3742;10550;148;487;3150;8690;3298;9177
280445;202008;2329;5896;2071;5449;50;157;1559;3929;1609;4086
280450;202008;10316;23758;8921;21853;997;2058;5975;15278;6972;17336
280460;202008;6909;16290;6240;15351;330;797;5323;12932;5653;13729
280470;202008;1699;4770;1453;4329;66;226;1072;3112;1138;3338
280480;202008;42696;103435;36706;94885;2987;8313;26027;65859;29014;74172
280490;202008;3725;10534;3201;9621;94;403;2474;7193;2568;7596
280500;202008;1004;2386;855;2184;38;125;713;1785;751;1910
280510;202008;2564;6463;2216;5970;73;273;1726;4539;1799;4812
280520;202008;1613;4092;1404;3802;59;162;1122;3000;1181;3162
280530;202008;2446;6099;2101;5614;294;657;1466;4044;1760;4701
280540;202008;8945;23855;8115;22651;257;888;7101;19533;7358;20421
280550;202008;6673;15443;5469;13744;188;676;4502;10892;4690;11568
280560;202008;7195;19900;6720;19192;140;512;5914;16693;6054;17205
280570;202008;6464;15653;5238;14093;220;691;3931;10511;4151;11202
280580;202008;5696;15003;4929;13853;579;1435;3449;9889;4028;11324
280590;202008;2925;6561;2484;6055;110;414;1959;4586;2069;5000
280600;202008;3591;9460;3150;8839;173;540;2254;6330;2427;6870
280610;202008;2479;6065;2224;5682;140;354;1828;4631;1968;4985
280620;202008;5462;13282;4679;12250;418;919;3281;8959;3699;9878
280630;202008;3819;10681;3487;10211;165;603;2867;8293;3032;8896
280640;202008;2366;6324;2083;5998;57;177;1847;5324;1904;5501
280650;202008;1193;3113;956;2757;88;299;710;1955;798;2254
280660;202008;3710;8100;3170;7461;219;404;2628;6317;2847;6721
280670;202008;19805;44389;17007;40813;938;2346;13509;32188;14447;34534
280680;202008;2805;6668;2393;6088;229;424;1717;4451;1946;4875
280690;202008;970;2346;817;2145;52;118;640;1661;692;1779
280700;202008;1167;2921;1008;2682;27;101;796;2081;823;2182
280710;202008;15369;34339;12951;31595;522;965;10925;27408;11447;28373
280720;202008;2670;6060;2214;5525;59;183;1617;4176;1676;4359
280730;202008;1064;2728;951;2541;43;138;728;1876;771;2014
280740;202008;14125;34358;11982;31090;723;2051;8605;21732;9328;23783
280750;202008;3623;10037;3149;9216;191;621;2260;6496;2451;7117
280760;202008;6399;16903;5539;15573;572;1465;3643;10571;4215;12036
290010;202008;3194;6682;2082;4948;5;16;1709;3883;1714;3899
290020;202008;5377;14252;4860;13585;336;637;4086;11834;4422;12471
290030;202008;4595;10425;3690;9429;172;393;3121;8077;3293;8470
290035;202008;5189;11238;4289;10068;365;551;3396;8331;3761;8882
290040;202008;4227;10264;3577;9479;108;288;2808;7845;2916;8133
290050;202008;2040;6556;1699;5806;117;482;1131;3770;1248;4252
290060;202008;1343;3200;990;2643;84;250;643;1703;727;1953
290070;202008;37467;81450;32059;74693;1776;4328;24923;57412;26699;61740
290080;202008;5319;15466;4548;14309;458;1555;3173;10075;3631;11630
290090;202008;2161;4136;1518;3448;17;53;1385;3119;1402;3172
290100;202008;9808;25495;7906;22625;1293;3469;4278;12853;5571;16322
290110;202008;5230;13728;4626;12782;330;933;3335;9118;3665;10051
290115;202008;3971;11409;3326;10239;224;760;2463;7507;2687;8267
290120;202008;6539;16023;5488;14572;135;467;4713;12289;4848;12756
290130;202008;4725;11412;3673;10046;163;471;2851;7774;3014;8245
290135;202008;4236;9921;3446;8626;196;491;2674;6524;2870;7015
290140;202008;4552;11845;3474;10394;98;364;2916;8668;3014;9032
290150;202008;2469;6336;2121;5902;139;382;1634;4582;1773;4964
290160;202008;3398;7702;2999;7152;280;580;2356;5644;2636;6224
290170;202008;3389;8509;2986;8066;111;306;2661;7254;2772;7560
290180;202008;2978;8115;2448;7239;87;312;1989;5824;2076;6136
290190;202008;4257;11837;3719;11102;144;569;3058;9001;3202;9570
290195;202008;2353;5806;1873;5172;27;136;1583;4330;1610;4466
290200;202008;4122;11411;3337;10101;187;626;2506;7505;2693;8131
290205;202008;3474;8920;3039;8255;138;478;2352;6171;2490;6649
290210;202008;12989;36055;11464;33733;873;2352;8829;26423;9702;28775
290220;202008;2888;7125;2528;6658;122;336;2059;5404;2181;5740
290225;202008;3231;6873;2481;6079;159;281;2061;5158;2220;5439
290230;202008;2445;6437;2221;6169;31;98;1998;5538;2029;5636
290240;202008;3740;9364;2968;8378;75;259;2496;7036;2571;7295
290250;202008;3957;11484;3300;10506;106;365;2711;8750;2817;9115
290260;202008;5508;13326;4572;11967;171;552;3805;9716;3976;10268
290265;202008;3524;10186;2846;8869;201;632;2019;6281;2220;6913
290270;202008;11063;37404;10315;36119;556;2414;8269;28663;8825;31077
290280;202008;6155;18271;5298;16548;299;1055;3816;11738;4115;12793
290290;202008;10018;28922;8059;25305;802;2716;5263;16305;6065;19021
290300;202008;4240;11491;3108;9341;158;513;2225;6656;2383;7169
290310;202008;1599;3925;1263;3514;55;230;974;2620;1029;2850
290320;202008;24594;63854;19368;55803;4260;12070;9175;27893;13435;39963
290323;202008;3780;10268;3275;9480;105;332;2587;7457;2692;7789
290327;202008;4115;11947;3494;10732;253;730;2495;7629;2748;8359
290330;202008;2211;4618;1710;4078;47;85;1514;3670;1561;3755
290340;202008;5768;14315;4433;12671;442;1311;3188;9253;3630;10564
290350;202008;4757;13098;3926;11688;279;842;2802;8385;3081;9227
290360;202008;5068;13254;4433;12424;132;356;3806;10773;3938;11129
290370;202008;5260;12768;3841;10883;156;409;2769;8004;2925;8413
290380;202008;5601;14850;4688;13605;113;272;4021;11898;4134;12170
290390;202008;14634;41352;12089;37326;1299;3953;7861;24688;9160;28641
290395;202008;2851;8219;2286;7237;67;316;1744;5426;1811;5742
290400;202008;3796;10149;3027;8882;81;347;2309;6593;2390;6940
290405;202008;4681;13528;3985;12316;298;956;2731;8625;3029;9581
290410;202008;5764;15542;4401;13343;118;524;3297;9739;3415;10263
290420;202008;3002;8330;2475;7490;71;251;1908;5732;1979;5983
290430;202008;3196;8702;2613;7790;228;710;1767;5198;1995;5908
290440;202008;2905;7132;2075;5813;47;121;1458;4151;1505;4272
290450;202008;3531;8914;2742;7708;148;398;1996;5703;2144;6101
290460;202008;11910;33379;9968;29657;1999;6050;4405;13100;6404;19150
290470;202008;4576;11212;3354;9516;392;1222;1899;5470;2291;6692
290475;202008;6537;18882;5499;17036;91;503;4485;13593;4576;14096
290480;202008;1792;4529;1461;4041;81;278;1009;2660;1090;2938
290485;202008;4529;13139;3989;12382;98;506;3408;10385;3506;10891
290490;202008;9248;21598;8247;20236;498;1111;6450;16070;6948;17181
290500;202008;4055;12092;3099;10014;537;1816;1350;4241;1887;6057
290510;202008;3496;8682;2897;7900;74;248;2499;6774;2573;7022
290515;202008;3681;10116;3169;9426;43;131;2842;8609;2885;8740
290520;202008;11605;32883;8934;27702;595;1984;5420;16590;6015;18574
290530;202008;5019;14259;4209;12937;133;509;3546;10847;3679;11356
290540;202008;3387;8870;3015;8440;52;175;2780;7752;2832;7927
290550;202008;4310;11234;3720;10538;11;59;3419;9794;3430;9853
290560;202008;6458;16629;4874;14270;417;1498;3189;9039;3606;10537
290570;202008;44908;109689;39659;102988;2474;6615;31849;82143;34323;88758
290580;202008;7818;22712;6716;21101;599;1841;4913;15821;5512;17662
290590;202008;7114;21733;5986;19708;142;575;4831;15973;4973;16548
290600;202008;18998;52419;16714;48685;687;2122;13454;39065;14141;41187
290610;202008;2606;8036;2025;6842;93;385;1418;4732;1511;5117
290620;202008;6378;17858;5493;16401;198;570;4613;13750;4811;14320
290630;202008;9278;22331;7337;19822;549;1477;5659;15417;6208;16894
290640;202008;2810;7191;2147;6226;86;254;1548;4584;1634;4838
290650;202008;13203;32584;11644;30817;2559;6466;7213;19973;9772;26439
290660;202008;3667;9337;3038;8417;52;145;2291;6550;2343;6695
290670;202008;6799;18665;5710;16863;375;1047;4325;12948;4700;13995
290680;202008;10870;30041;9094;27394;197;1055;7502;22116;7699;23171
290682;202008;4809;12305;4146;11420;126;295;3500;9739;3626;10034
290685;202008;3498;7869;2494;6420;204;486;1532;4225;1736;4711
290687;202008;6651;17849;5373;15753;707;1998;3421;10298;4128;12296
290689;202008;2855;7870;2181;6620;200;655;1482;4471;1682;5126
290690;202008;5560;14359;4487;12838;306;941;3245;9146;3551;10087
290700;202008;2639;7183;2317;6774;71;240;1947;5711;2018;5951
290710;202008;8298;23276;7085;21583;156;626;5968;18198;6124;18824
290720;202008;18519;50429;16795;47807;934;2944;13451;37808;14385;40752
290730;202008;7113;16782;6042;15529;297;593;4750;12422;5047;13015
290740;202008;1039;2783;796;2386;35;114;655;1967;690;2081
290750;202008;11127;27646;9598;25177;636;1795;7108;18102;7744;19897
290755;202008;2100;5897;1678;5124;91;285;1161;3573;1252;3858
290760;202008;3767;10903;3020;9466;183;533;2041;6598;2224;7131
290770;202008;2651;8364;2419;8072;49;248;2028;6821;2077;7069
290780;202008;8279;20370;7134;18867;277;606;5567;15078;5844;15684
290790;202008;4715;12926;4081;12016;163;469;3362;10038;3525;10507
290800;202008;7140;14782;5040;12309;292;679;3734;9195;4026;9874
290810;202008;5416;14138;4323;12526;110;354;3257;9646;3367;10000
290820;202008;4855;13108;4344;12368;182;524;3275;9453;3457;9977
290830;202008;4487;10148;3970;9505;29;81;3496;8268;3525;8349
290840;202008;17171;45189;14678;41311;1903;4402;9408;28170;11311;32572
290850;202008;6688;16003;5977;15237;208;517;5121;13188;5329;13705
290860;202008;6181;17624;5368;16677;215;713;4517;14309;4732;15022
290870;202008;4813;13163;3617;10880;154;476;2540;7579;2694;8055
290880;202008;1396;3467;1112;3094;74;179;764;2223;838;2402
290890;202008;9330;18700;8344;17592;153;325;7830;16440;7983;16765
290900;202008;2404;6230;1828;5225;103;246;1138;3223;1241;3469
290910;202008;5167;12314;3934;10436;49;156;3332;8756;3381;8912
290920;202008;5174;12886;4693;12327;78;125;4387;11702;4465;11827
290930;202008;7659;21294;6108;18581;195;825;4774;14155;4969;14980
290940;202008;3707;10335;3041;9369;159;574;2433;7490;2592;8064
290950;202008;1472;3672;1195;3251;66;186;833;2276;899;2462
290960;202008;5484;14333;4902;13607;184;453;4126;11521;4310;11974
290970;202008;3363;9842;2733;8695;108;392;2096;6670;2204;7062
290980;202008;12166;29076;10156;25974;797;2222;6322;15708;7119;17930
290990;202008;9714;25556;8539;23639;256;1031;7166;19148;7422;20179
291000;202008;3445;8884;2664;7890;116;359;2171;6497;2287;6856
291005;202008;15350;37598;13485;35152;1225;2915;10493;27577;11718;30492
291010;202008;3080;9265;2485;7991;120;435;1635;5118;1755;5553
291020;202008;1248;3080;997;2631;22;74;723;1800;745;1874
291030;202008;2517;6108;1742;4766;110;275;1073;2858;1183;3133
291040;202008;5397;14788;4482;13486;157;609;3514;10537;3671;11146
291050;202008;7699;19959;6549;18360;628;1980;4765;13105;5393;15085
291060;202008;5981;18217;5066;16984;316;1375;3843;12795;4159;14170
291070;202008;16081;42919;13342;38528;414;1417;10863;31187;11277;32604
291072;202008;24788;63287;17717;51076;3234;9642;7528;21953;10762;31595
291075;202008;5459;13363;4885;12476;102;274;4072;10208;4174;10482
291077;202008;1612;4191;1247;3552;55;121;875;2492;930;2613
291080;202008;107420;264409;83875;231061;24938;70559;22631;67577;47569;138136
291085;202008;5641;14209;4731;12798;181;543;3924;10588;4105;11131
291090;202008;2012;3794;1444;3156;46;103;1164;2501;1210;2604
291100;202008;3225;6999;2209;5785;101;270;1684;4372;1785;4642
291110;202008;5982;17637;5056;16049;318;1296;3838;11725;4156;13021
291120;202008;7587;18460;6376;16912;300;862;4913;12995;5213;13857
291125;202008;2206;3861;1656;3250;97;144;1334;2673;1431;2817
291130;202008;3251;9196;2381;7475;64;287;1770;5381;1834;5668
291140;202008;4925;13192;3572;10732;449;1189;2197;6626;2646;7815
291150;202008;2501;5403;1920;4747;5;17;1811;4470;1816;4487
291160;202008;5127;13932;4218;12620;370;1178;2821;8369;3191;9547
291165;202008;2183;5882;1633;4811;27;119;1194;3409;1221;3528
291170;202008;21132;53259;17568;47220;937;2751;11582;30592;12519;33343
291180;202008;6353;14615;4620;12270;262;672;3565;9472;3827;10144
291185;202008;3097;8282;2703;7642;89;268;2079;5893;2168;6161
291190;202008;7656;18718;6282;16946;290;912;4960;13333;5250;14245
291200;202008;2798;7631;2062;6239;93;292;1263;3680;1356;3972
291210;202008;7095;15126;5290;13046;135;434;3911;9704;4046;10138
291220;202008;4089;11540;3669;10910;179;645;2907;8534;3086;9179
291230;202008;4475;9571;3366;8356;37;98;3032;7601;3069;7699
291240;202008;4246;10815;3618;9762;64;222;3101;8242;3165;8464
291250;202008;3433;10045;2656;8615;155;493;1707;5567;1862;6060
291260;202008;1438;3359;1173;3015;30;94;960;2480;990;2574
291270;202008;5419;13942;4180;12115;635;1844;2599;7705;3234;9549
291280;202008;2646;6404;1972;5414;145;430;1265;3411;1410;3841
291290;202008;5888;15392;4522;13263;338;1073;3110;9029;3448;10102
291300;202008;3856;10352;2974;8903;111;399;2263;6675;2374;7074
291310;202008;5149;13612;4373;12197;119;377;3690;10153;3809;10530
291320;202008;6132;16958;4746;14369;1061;3004;2332;7501;3393;10505
291330;202008;1781;4504;1469;3994;79;212;1095;2946;1174;3158
291340;202008;4294;11088;3465;9641;78;247;2623;7187;2701;7434
291345;202008;2945;8772;2668;8339;111;390;2237;6992;2348;7382
291350;202008;6898;16964;5345;15073;58;188;4635;13309;4693;13497
291360;202008;37736;85768;29455;75787;2791;7285;19226;50599;22017;57884
291370;202008;8093;21931;7130;20437;526;1590;5282;14878;5808;16468
291380;202008;3422;9277;2992;8685;100;409;2489;7170;2589;7579
291390;202008;13310;28390;10298;25050;449;1064;8510;20709;8959;21773
291400;202008;13975;35570;11446;31738;1543;3752;6748;20197;8291;23949
291410;202008;2960;7734;2289;6588;35;148;1680;4757;1715;4905
291420;202008;1935;4746;1502;4206;28;115;1303;3633;1331;3748
291430;202008;2773;7809;2390;7170;77;339;1921;5585;1998;5924
291440;202008;6416;18291;5511;16789;333;1076;4282;13054;4615;14130
291450;202008;9436;22807;7748;20856;76;129;6808;18910;6884;19039
291460;202008;15778;41479;13766;38465;685;2120;10353;28731;11038;30851
291465;202008;9411;22978;7390;20657;136;608;6387;17719;6523;18327
291470;202008;16900;37513;14073;34316;746;1605;10434;26222;11180;27827
291480;202008;41667;92123;30490;76797;3586;9320;16091;40597;19677;49917
291490;202008;5623;13891;4834;12989;141;450;4352;11633;4493;12083
291500;202008;5030;12232;4160;11075;69;304;3778;10006;3847;10310
291510;202008;4318;10628;3200;9211;52;294;2670;7615;2722;7909
291520;202008;4584;10335;3438;8822;182;492;2634;6704;2816;7196
291530;202008;2346;5341;1645;4415;321;787;911;2693;1232;3480
291535;202008;3435;9981;3038;9279;172;472;2335;7299;2507;7771
291540;202008;2301;5087;1572;4208;65;215;1289;3393;1354;3608
291550;202008;5660;12912;4396;11306;383;827;2998;7895;3381;8722
291560;202008;18692;43890;13368;36841;1300;3452;7990;22922;9290;26374
291570;202008;2427;5733;1906;5094;59;160;1557;4327;1616;4487
291580;202008;6338;16289;4977;14462;223;710;3686;10640;3909;11350
291590;202008;2182;5255;1889;4912;76;267;1669;4243;1745;4510
291600;202008;5592;12847;4288;10852;379;1017;2919;7152;3298;8169
291610;202008;5673;14804;5087;14152;80;301;4662;12944;4742;13245
291620;202008;3171;7021;2329;6098;105;269;1816;4854;1921;5123
291630;202008;3335;7433;2485;6314;291;802;1750;4363;2041;5165
291640;202008;15975;39191;12061;33534;1730;4674;5429;15671;7159;20345
291650;202008;9550;23602;8415;22251;570;1046;7076;19204;7646;20250
291660;202008;2098;5107;1516;4204;126;411;988;2586;1114;2997
291670;202008;2068;5421;1743;4954;104;258;1311;3789;1415;4047
291680;202008;4174;10165;3368;8993;291;803;2374;6285;2665;7088
291685;202008;4741;11229;3780;9999;231;474;2848;7830;3079;8304
291690;202008;4196;9214;2881;7295;236;479;2179;5578;2415;6057
291700;202008;8682;24917;7586;22986;324;1179;6168;18338;6492;19517
291710;202008;5373;12650;3947;10649;215;670;2878;7618;3093;8288
291720;202008;4535;13650;3757;12090;434;1467;2420;7641;2854;9108
291730;202008;6389;16202;5477;15011;264;801;4530;12342;4794;13143
291733;202008;2896;7334;2432;6718;60;168;1764;5119;1824;5287
291735;202008;2941;7717;2330;6632;72;164;1769;5012;1841;5176
291740;202008;3951;10146;2920;8231;93;249;2072;5757;2165;6006
291750;202008;19716;46798;15987;41340;1555;3920;10746;28152;12301;32072
291760;202008;10367;29718;8090;26044;2435;8882;2214;7106;4649;15988
291770;202008;7160;19092;5943;16996;351;1077;4463;12434;4814;13511
291780;202008;5166;13619;4640;12880;85;321;4080;11197;4165;11518
291790;202008;2784;7569;2517;7223;238;570;1882;5597;2120;6167
291800;202008;29424;73796;21820;62408;3449;9573;10663;31725;14112;41298
291810;202008;10712;25196;8890;22963;275;701;7516;19563;7791;20264
291820;202008;3833;10027;3311;9352;91;312;2661;7522;2752;7834
291830;202008;4492;10531;3665;9423;193;415;2892;7466;3085;7881
291835;202008;6526;19427;5103;16677;534;1858;3247;10754;3781;12612
291840;202008;48170;131035;41541;120734;4324;13365;29090;84066;33414;97431
291845;202008;2560;6550;2004;5863;112;339;1618;4787;1730;5126
291850;202008;3908;11137;3200;9951;258;759;2279;7273;2537;8032
291855;202008;2224;4305;1719;3744;41;93;1548;3381;1589;3474
291860;202008;2239;5825;1555;4507;45;124;1054;2944;1099;3068
291870;202008;1290;3228;858;2480;45;130;584;1657;629;1787
291875;202008;2932;8742;2524;7887;63;259;1849;5606;1912;5865
291880;202008;5656;15870;4777;14379;221;643;3565;10789;3786;11432
291890;202008;1668;3377;1071;2686;131;306;713;1795;844;2101
291900;202008;1232;2953;935;2492;21;86;737;1905;758;1991
291905;202008;2502;6332;2020;5564;79;283;1537;4079;1616;4362
291910;202008;2992;7441;2542;6902;55;193;2186;6065;2241;6258
291915;202008;7488;21067;6084;18700;221;772;4579;14245;4800;15017
291920;202008;26790;69056;22532;63100;2159;6592;15654;42993;17813;49585
291930;202008;2529;6778;2158;6260;241;709;1441;4214;1682;4923
291940;202008;3911;9913;2602;7685;195;569;1532;4501;1727;5070
291950;202008;9246;27697;7842;24978;291;1094;5435;17106;5726;18200
291955;202008;15605;39106;13857;36858;1171;3253;10801;28814;11972;32067
291960;202008;3063;8060;2540;7345;119;362;1977;5848;2096;6210
291970;202008;4544;11398;3789;10448;142;483;2844;7862;2986;8345
291980;202008;9727;27584;7650;23941;1041;3023;4569;14687;5610;17710
291990;202008;2321;5938;1895;5428;28;116;1756;5028;1784;5144
291992;202008;3987;9545;3162;8478;237;537;2496;6833;2733;7370
291995;202008;2113;5790;1731;5175;54;242;1305;3793;1359;4035
292000;202008;2659;6197;2160;5596;99;363;1683;4302;1782;4665
292010;202008;5755;13386;4676;11845;171;524;3879;9628;4050;10152
292020;202008;4604;13235;3803;11812;209;746;2737;8239;2946;8985
292030;202008;1843;5606;1678;5298;75;265;1060;3287;1135;3552
292040;202008;4459;11306;3446;9791;231;587;2631;7636;2862;8223
292045;202008;4023;10500;2972;8951;32;87;2624;8065;2656;8152
292050;202008;6616;18345;5304;16012;253;865;3400;10105;3653;10970
292060;202008;11490;26304;10505;25079;489;1094;9169;21687;9658;22781
292070;202008;5813;14987;5055;14083;297;833;4326;11989;4623;12822
292080;202008;3122;7826;2573;7114;79;262;2277;6255;2356;6517
292090;202008;4653;10004;3293;8366;256;667;2470;6321;2726;6988
292100;202008;11168;26921;9531;24863;960;2611;6631;17268;7591;19879
292105;202008;3570;8741;3105;8109;99;232;2553;6686;2652;6918
292110;202008;6007;14555;4231;11725;979;2756;1943;5400;2922;8156
292120;202008;6992;17751;5739;15661;358;1033;4353;11674;4711;12707
292130;202008;3459;8199;2837;7429;106;313;2224;5756;2330;6069
292140;202008;5084;11952;4249;10684;315;791;3374;8450;3689;9241
292145;202008;2379;6817;1999;6166;61;157;1538;4806;1599;4963
292150;202008;14183;38502;12267;35358;323;1232;9939;28256;10262;29488
292160;202008;2976;7170;2237;6216;41;113;1824;5309;1865;5422
292170;202008;8450;22317;7019;19978;341;1136;5315;14813;5656;15949
292180;202008;2893;7866;2112;6410;171;509;1294;3866;1465;4375
292190;202008;2973;7773;2533;7096;91;315;1986;5506;2077;5821
292200;202008;8490;20976;6336;17921;1045;3058;3283;9578;4328;12636
292205;202008;3881;10645;3350;9854;56;254;2927;8567;2983;8821
292210;202008;6536;15124;5262;13523;90;389;4729;12016;4819;12405
292220;202008;2163;5161;1896;4751;48;138;1502;3641;1550;3779
292225;202008;3219;9344;2814;8725;73;337;2377;7240;2450;7577
292230;202008;8602;20422;7678;19254;158;524;6632;16348;6790;16872
292240;202008;4772;13726;4136;12576;302;901;2890;8811;3192;9712
292250;202008;5851;14971;5253;14066;423;1106;3920;10456;4343;11562
292260;202008;3428;8861;3023;8333;93;249;2630;7259;2723;7508
292265;202008;3390;9135;2833;8293;75;317;2246;6448;2321;6765
292270;202008;4424;10029;3511;8945;112;269;2920;7440;3032;7709
292273;202008;2785;5888;2207;5185;53;89;1619;4078;1672;4167
292275;202008;1646;4262;1289;3780;58;164;971;2901;1029;3065
292280;202008;2642;6221;2119;5617;82;166;1793;4888;1875;5054
292285;202008;2561;6152;2043;5455;77;166;1660;4475;1737;4641
292290;202008;7438;19597;5871;17395;168;644;4795;14165;4963;14809
292300;202008;10509;26083;8263;23066;753;2244;5755;16112;6508;18356
292303;202008;2961;8386;2567;7759;82;200;2143;6534;2225;6734
292305;202008;2327;6197;2145;5946;44;202;1939;5275;1983;5477
292310;202008;6737;16868;5796;15731;148;494;5041;13549;5189;14043
292320;202008;6143;16691;4868;14325;268;874;3541;10145;3809;11019
292330;202008;2733;6002;2192;5393;97;195;1706;4367;1803;4562
292335;202008;4756;12291;4220;11524;208;490;3565;9825;3773;10315
292340;202008;5617;15609;4621;13692;226;674;3414;10040;3640;10714
292350;202008;2512;6768;2085;6180;77;285;1678;4997;1755;5282
292360;202008;4972;13167;4115;11720;234;752;2898;8088;3132;8840
292370;202008;10556;24380;9051;22420;129;415;8391;20526;8520;20941
292380;202008;6807;18891;6078;17590;390;1138;4626;13266;5016;14404
292390;202008;4549;8703;3339;7292;111;201;2925;6407;3036;6608
292400;202008;22639;63769;19498;58774;1913;5837;13329;40433;15242;46270
292405;202008;4475;10812;3768;9700;96;244;3116;7915;3212;8159
292410;202008;2225;5260;1847;4781;66;146;1627;4239;1693;4385
292420;202008;3465;10440;3145;9930;111;554;2700;8292;2811;8846
292430;202008;4903;14558;3684;12323;282;977;2401;8029;2683;9006
292440;202008;8454;26759;7801;25776;128;643;6978;22969;7106;23612
292450;202008;4024;11432;3146;9721;83;317;2456;7537;2539;7854
292460;202008;4897;13388;3994;11847;333;943;2872;8536;3205;9479
292465;202008;2700;6871;2292;6349;92;195;1518;4636;1610;4831
292467;202008;1909;5340;1681;5030;240;637;1162;3617;1402;4254
292470;202008;2986;7559;2306;6502;57;120;1793;5067;1850;5187
292480;202008;6352;14982;5110;13471;78;301;4621;12077;4699;12378
292490;202008;2106;5388;1760;4875;123;271;1324;3768;1447;4039
292500;202008;6658;18079;5307;15676;504;1563;3429;9986;3933;11549
292510;202008;13297;35698;10337;30964;535;1879;7209;21532;7744;23411
292520;202008;7016;17415;6211;16258;449;1211;4830;12530;5279;13741
292525;202008;5957;14116;4850;12873;123;287;4182;11295;4305;11582
292530;202008;28713;75833;21943;64239;5226;15459;8525;25549;13751;41008
292540;202008;4447;8151;3466;7103;119;202;3112;6403;3231;6605
292550;202008;8443;21632;6435;19221;485;1409;4540;14476;5025;15885
292560;202008;4413;10913;3832;10150;85;236;3171;8472;3256;8708
292570;202008;3618;9496;3027;8397;81;289;2535;6865;2616;7154
292575;202008;6950;19710;6359;18923;376;1090;5112;15381;5488;16471
292580;202008;7580;18985;6255;17029;132;441;5282;14231;5414;14672
292590;202008;7378;19598;6289;17702;261;840;5234;14464;5495;15304
292593;202008;2863;7082;2360;6237;68;174;1979;5174;2047;5348
292595;202008;5429;14322;4634;13348;149;499;3904;11179;4053;11678
292600;202008;10975;29660;9419;27276;306;900;7491;21759;7797;22659
292610;202008;4164;10822;3512;9670;201;466;2632;7348;2833;7814
292620;202008;6460;17545;5349;16205;127;287;4874;15072;5001;15359
292630;202008;8601;20927;6888;18188;698;1843;4437;11783;5135;13626
292640;202008;8233;24057;7128;22216;201;781;5073;15952;5274;16733
292650;202008;4481;10980;4033;10395;109;290;3664;9346;3773;9636
292660;202008;11489;30696;9697;28062;452;1461;7412;21442;7864;22903
292665;202008;2180;6367;1884;5979;65;191;1585;5109;1650;5300
292670;202008;3601;9628;2751;8041;117;370;1867;5344;1984;5714
292680;202008;3978;10420;3129;8941;190;497;2287;6426;2477;6923
292690;202008;2657;6768;1826;5410;199;548;1076;3343;1275;3891
292700;202008;9860;26631;8559;24650;726;1861;5896;17574;6622;19435
292710;202008;2516;7618;2331;7363;43;143;2118;6721;2161;6864
292720;202008;9017;21403;7615;19787;209;574;6050;16004;6259;16578
292730;202008;4598;10385;4295;10020;274;448;3665;8754;3939;9202
292740;202008;326820;784497;280465;717530;38925;99675;174587;444761;213512;544436
292750;202008;6206;16544;5418;15394;232;664;4179;12060;4411;12724
292760;202008;3912;11210;3392;10285;224;768;2475;7444;2699;8212
292770;202008;6317;16333;5088;14609;781;2299;3246;9588;4027;11887
292780;202008;2133;4200;1575;3519;48;138;1272;2690;1320;2828
292790;202008;4084;8639;3113;7585;153;373;2598;6384;2751;6757
292800;202008;11371;28278;9701;25751;302;846;8099;21224;8401;22070
292805;202008;3620;8617;2826;7573;102;320;2227;5917;2329;6237
292810;202008;10687;27904;8415;24347;214;897;6335;17752;6549;18649
292820;202008;7429;20373;5393;16954;431;1441;3744;11578;4175;13019
292830;202008;2885;6784;2468;6268;92;272;2089;5317;2181;5589
292840;202008;8740;22691;7378;20838;146;542;6450;17909;6596;18451
292850;202008;2522;6627;2105;6009;148;444;1478;4190;1626;4634
292860;202008;17222;37581;15423;35449;411;1006;13350;30296;13761;31302
292870;202008;18025;44350;15424;40700;944;2531;10546;27539;11490;30070
292880;202008;11020;29873;9371;27407;268;1105;7393;20911;7661;22016
292890;202008;7090;19495;6255;18286;183;739;5473;15876;5656;16615
292895;202008;3058;6500;2210;5238;104;249;1779;4178;1883;4427
292900;202008;2597;6953;2355;6581;61;238;1935;5246;1996;5484
292905;202008;4355;11164;3440;9822;137;454;2539;7168;2676;7622
292910;202008;4909;13248;4453;12587;214;604;3407;9567;3621;10171
292920;202008;9750;26596;8990;25512;255;958;7777;21679;8032;22637
292925;202008;5448;15309;4543;13682;219;648;3281;9789;3500;10437
292930;202008;6507;18989;5584;17286;470;1622;3576;10788;4046;12410
292935;202008;2476;6154;1911;5523;23;126;1715;4970;1738;5096
292937;202008;2774;6919;2363;6359;52;152;1998;5400;2050;5552
292940;202008;2839;7179;2264;6327;177;407;1641;4767;1818;5174
292950;202008;9556;24106;8343;22319;530;1227;6300;16831;6830;18058
292960;202008;5245;12618;4383;11388;129;333;3504;9015;3633;9348
292970;202008;3810;10875;3360;10190;82;386;2798;8512;2880;8898
292975;202008;4491;9511;3972;8928;128;218;3619;8227;3747;8445
292980;202008;3307;7932;2641;6951;87;276;2152;5559;2239;5835
292990;202008;11436;31201;9515;27787;647;1974;6955;20005;7602;21979
293000;202008;2684;6263;2292;5669;42;143;1832;4533;1874;4676
293010;202008;18013;45900;14467;40309;1934;5559;8813;24536;10747;30095
293015;202008;8374;25455;6542;21862;430;1547;4368;14849;4798;16396
293020;202008;9817;28340;8822;26920;136;592;7942;24288;8078;24880
293030;202008;5270;13854;3993;11859;102;341;2764;8428;2866;8769
293040;202008;4332;11398;3641;10416;72;278;3182;9072;3254;9350
293050;202008;22655;55121;19964;51157;1076;2779;15060;38104;16136;40883
293060;202008;3512;9298;2836;8033;233;693;1961;5459;2194;6152
293070;202008;25406;60699;21637;55936;1996;5418;15576;40309;17572;45727
293075;202008;3495;11014;3018;10193;154;675;2407;8133;2561;8808
293076;202008;3564;8680;3228;8283;55;146;2877;7450;2932;7596
293077;202008;6127;16894;4967;15017;432;1432;3232;10005;3664;11437
293080;202008;4743;13922;4073;12774;94;434;3295;10138;3389;10572
293090;202008;3252;9383;2477;8096;207;661;1599;5293;1806;5954
293100;202008;5812;15366;4798;13545;223;651;3766;10519;3989;11170
293105;202008;3747;11838;3267;10858;231;799;2302;7594;2533;8393
293110;202008;2405;5964;1981;5339;68;242;1618;4252;1686;4494
293120;202008;4388;11885;3898;11112;110;289;3253;9286;3363;9575
293130;202008;3676;10089;3202;9465;78;294;2750;8052;2828;8346
293135;202008;30977;71944;22818;61114;3424;9968;10831;29336;14255;39304
293140;202008;2401;5291;2070;4885;62;145;1743;4112;1805;4257
293150;202008;5509;16223;4519;14340;335;1067;3095;9877;3430;10944
293160;202008;3865;9343;3277;8705;246;406;2723;7605;2969;8011
293170;202008;4946;10262;4297;9459;116;250;3755;8230;3871;8480
293180;202008;4390;12250;3609;10820;89;346;2859;8369;2948;8715
293190;202008;14095;38112;12372;35613;144;635;10979;31382;11123;32017
293200;202008;8413;20798;6696;18086;195;690;5354;14188;5549;14878
293210;202008;5194;13719;4437;12555;272;773;3420;9651;3692;10424
293220;202008;5042;12941;3676;10603;852;2456;1460;4324;2312;6780
293230;202008;3863;9896;2834;8419;207;695;1935;5797;2142;6492
293240;202008;4535;11932;3623;10444;66;158;2745;8243;2811;8401
293245;202008;3841;10321;3439;9744;143;478;2931;8174;3074;8652
293250;202008;5962;13719;4846;12286;141;357;4057;10297;4198;10654
293260;202008;4618;12207;3806;10941;161;475;2610;7550;2771;8025
293270;202008;7240;15920;5696;14267;398;602;4468;12036;4866;12638
293280;202008;4508;11845;3916;11008;234;581;3047;8664;3281;9245
293290;202008;14469;41833;12712;39089;1690;5270;8341;25983;10031;31253
293300;202008;5788;13964;4954;12744;281;727;3607;9302;3888;10029
293305;202008;4091;9661;3558;9003;50;123;3211;8132;3261;8255
293310;202008;2119;5387;1777;4856;55;162;1405;3792;1460;3954
293315;202008;4149;9758;3407;8642;203;448;2804;7117;3007;7565
293317;202008;2648;6182;2334;5749;142;268;1851;4579;1993;4847
293320;202008;12213;29143;10808;27573;257;720;9665;24516;9922;25236
293325;202008;1790;4392;1389;3854;201;543;841;2380;1042;2923
293330;202008;58051;163484;47019;143857;8671;27413;21733;66724;30404;94137
293340;202008;2213;6187;1820;5493;82;274;1295;3852;1377;4126
293345;202008;3560;9524;2844;8454;367;845;1830;5971;2197;6816
293350;202008;6610;18873;5693;17779;61;308;5187;16399;5248;16707
293360;202008;15519;38499;13144;35332;294;1219;11571;30535;11865;31754
310010;202008;951;2140;612;1666;50;178;230;571;280;749
310020;202008;2678;7184;1976;5931;438;1429;425;1213;863;2642
310030;202008;1921;5374;1473;4594;214;740;944;2833;1158;3573
310040;202008;896;2330;708;2011;31;136;488;1295;519;1431
310050;202008;1491;4456;1249;4068;129;533;818;2556;947;3089
310060;202008;3161;8915;2734;8346;78;322;2268;6838;2346;7160
310070;202008;345;782;241;634;9;19;178;465;187;484
310080;202008;692;1827;492;1464;73;242;225;631;298;873
310090;202008;4717;12445;3855;11041;290;887;2818;7934;3108;8821
310100;202008;3518;9634;2933;8658;78;357;2380;6820;2458;7177
310110;202008;4611;12090;3577;10270;765;2400;1559;4289;2324;6689
310120;202008;642;1564;405;1184;43;151;238;644;281;795
310130;202008;371;958;308;865;26;105;227;598;253;703
310140;202008;270;781;191;649;39;152;71;215;110;367
310150;202008;5442;14287;4011;11631;523;1736;1905;5200;2428;6936
310160;202008;7753;19300;5482;15538;1051;3286;1930;5521;2981;8807
310163;202008;1029;3025;819;2625;181;665;276;814;457;1479
310170;202008;9255;23409;7351;20420;625;1791;5194;14412;5819;16203
310180;202008;1795;4436;1310;3637;165;505;769;2063;934;2568
310190;202008;2574;7439;2073;6523;456;1617;346;1009;802;2626
310200;202008;1878;5518;1360;4513;185;710;639;2076;824;2786
310205;202008;1117;3061;857;2651;144;500;392;1189;536;1689
310210;202008;2613;6974;2123;6115;123;376;1529;4303;1652;4679
310220;202008;1259;3410;965;2837;90;285;637;1799;727;2084
310230;202008;2235;6130;1790;5295;224;741;1123;3100;1347;3841
310240;202008;968;2937;814;2663;50;187;582;1862;632;2049
310250;202008;1046;2772;840;2432;18;74;579;1666;597;1740
310260;202008;3186;8149;2050;6164;579;2031;601;1417;1180;3448
310270;202008;2723;6662;2148;5883;99;318;1753;4792;1852;5110
310280;202008;2465;5664;1900;4846;267;710;1101;2704;1368;3414
310285;202008;1853;5847;1536;5280;168;650;938;3193;1106;3843
310290;202008;1135;2973;925;2598;207;672;482;1209;689;1881
310300;202008;1513;4353;1283;3963;137;515;758;2193;895;2708
310310;202008;302;725;198;544;33;94;101;275;134;369
310320;202008;524;1324;356;1054;23;89;201;564;224;653
310330;202008;484;1142;287;794;42;133;118;295;160;428
310340;202008;7916;21006;6329;18337;869;2448;3187;9476;4056;11924
310350;202008;12788;30663;8699;24050;1584;4689;3938;10494;5522;15183
310360;202008;491;1111;372;957;14;38;247;643;261;681
310370;202008;1284;3955;1081;3563;210;754;356;1212;566;1966
310375;202008;874;2155;614;1766;96;287;329;942;425;1229
310380;202008;403;909;222;619;36;105;99;258;135;363
310390;202008;440;1304;343;1116;78;272;97;270;175;542
310400;202008;10207;24585;7284;20193;702;2257;4453;12046;5155;14303
310410;202008;893;2561;581;1977;89;330;218;694;307;1024
310420;202008;4411;11350;2989;8622;402;1307;1243;3309;1645;4616
310430;202008;1506;4082;982;3101;217;754;337;933;554;1687
310440;202008;661;1713;455;1337;42;151;243;668;285;819
310445;202008;1383;3892;1000;3129;58;196;715;2197;773;2393
310450;202008;4697;11712;3515;9855;136;515;2672;7269;2808;7784
310460;202008;1708;4492;1237;3622;202;640;433;1187;635;1827
310470;202008;3758;8181;2908;7072;290;682;2052;5125;2342;5807
310480;202008;960;2461;745;2114;81;246;476;1311;557;1557
310490;202008;2814;7584;2191;6564;229;853;1244;3500;1473;4353
310500;202008;1352;3797;1010;3211;175;642;544;1663;719;2305
310510;202008;2114;5478;1368;4086;243;824;510;1511;753;2335
310520;202008;1193;3094;856;2491;139;390;447;1302;586;1692
310530;202008;732;1834;465;1348;69;245;158;373;227;618
310540;202008;2962;8424;2449;7538;551;1798;1116;3299;1667;5097
310550;202008;1264;3206;884;2553;78;281;504;1350;582;1631
310560;202008;14788;38249;10449;30646;1512;5092;4459;11821;5971;16913
310570;202008;1028;2669;811;2368;53;189;601;1725;654;1914
310590;202008;4067;10742;3236;9200;200;671;1880;5049;2080;5720
310600;202008;1304;3852;1061;3354;145;517;543;1601;688;2118
310610;202008;468;1263;293;977;110;377;43;126;153;503
310620;202008;171909;434093;123804;347317;17813;57998;60362;153612;78175;211610
310630;202008;4528;12287;3532;10339;317;996;2234;6340;2551;7336
310640;202008;1086;3194;886;2799;182;628;367;1107;549;1735
310650;202008;2374;6744;1708;5451;168;570;993;3075;1161;3645
310660;202008;1307;3478;1067;3156;32;106;903;2651;935;2757
310665;202008;1421;3627;1142;3219;31;114;921;2625;952;2739
310670;202008;57901;147999;48660;132171;4520;14100;33506;86592;38026;100692
310680;202008;768;1778;627;1582;18;64;535;1294;553;1358
310690;202008;1944;5062;1394;4126;108;364;788;2221;896;2585
310700;202008;488;1068;387;948;22;69;306;724;328;793
310710;202008;5599;15773;4075;13531;878;3479;739;2209;1617;5688
310720;202008;1022;2357;797;2073;33;106;604;1529;637;1635
310730;202008;9932;26472;8495;24200;337;1209;6409;17910;6746;19119
310740;202008;6266;17045;4320;12976;670;2238;1590;4341;2260;6579
310750;202008;1231;2926;903;2453;110;328;465;1189;575;1517
310760;202008;614;1585;432;1299;37;113;230;716;267;829
310770;202008;1103;2954;759;2426;78;304;395;1168;473;1472
310780;202008;4293;10318;3544;9317;74;213;2874;7585;2948;7798
310790;202008;1786;5627;1542;5102;351;1239;255;755;606;1994
310800;202008;2280;6718;1645;5419;357;1409;105;279;462;1688
310810;202008;1249;3059;1015;2671;43;122;725;1834;768;1956
310820;202008;1156;2964;713;2216;169;554;157;501;326;1055
310825;202008;2581;7702;2055;6836;70;408;1657;5315;1727;5723
310830;202008;1861;5209;1302;4091;246;891;543;1606;789;2497
310840;202008;2035;5485;1477;4547;345;1222;364;968;709;2190
310850;202008;1472;4015;1226;3672;45;229;955;2726;1000;2955
310855;202008;3049;8037;2353;6914;156;563;1693;4825;1849;5388
310860;202008;6928;19969;5515;17180;536;1772;3382;10619;3918;12391
310870;202008;965;2310;754;2008;57;144;555;1486;612;1630
310880;202008;983;2950;771;2518;106;358;441;1400;547;1758
310890;202008;2240;6364;1431;4724;263;938;223;623;486;1561
310900;202008;3878;10762;2633;8020;383;1227;1110;3159;1493;4386
310910;202008;2068;5061;1441;4055;118;402;294;779;412;1181
310920;202008;1909;4957;1439;4232;199;636;820;2364;1019;3000
310925;202008;944;2550;757;2248;69;242;515;1444;584;1686
310930;202008;5704;14924;4032;12184;768;2372;1850;5832;2618;8204
310940;202008;6713;15825;5386;13895;187;589;4130;10365;4317;10954
310945;202008;1313;3428;1029;2965;160;494;523;1477;683;1971
310950;202008;1903;5625;1233;4100;226;842;405;1165;631;2007
310960;202008;742;1983;406;1264;71;258;78;220;149;478
310970;202008;1129;3329;792;2598;203;737;142;428;345;1165
310980;202008;272;654;177;512;19;65;109;305;128;370
310990;202008;1322;3646;1026;3129;164;539;526;1574;690;2113
311000;202008;3985;11040;2887;9192;709;2437;1182;3636;1891;6073
311010;202008;892;2555;716;2200;212;725;303;901;515;1626
311020;202008;1093;2770;688;2030;43;129;373;1082;416;1211
311030;202008;1685;4131;1162;3272;211;665;525;1405;736;2070
311040;202008;278;871;226;756;68;237;71;225;139;462
311050;202008;2841;6921;2093;5832;357;1153;1061;2820;1418;3973
311060;202008;3204;8131;2346;6509;330;1055;967;2431;1297;3486
311070;202008;2308;5721;1664;4712;170;632;916;2412;1086;3044
311080;202008;1150;2592;922;2229;61;182;717;1644;778;1826
311090;202008;2010;6371;1563;5520;356;1391;469;1608;825;2999
311100;202008;2378;6735;1383;4660;258;990;241;720;499;1710
311110;202008;3637;7416;2034;5191;367;995;747;1961;1114;2956
311115;202008;1375;3056;1146;2746;62;154;932;2199;994;2353
311120;202008;6620;17289;5019;14408;714;2330;1904;4844;2618;7174
311130;202008;1881;4852;1423;4220;106;398;821;2353;927;2751
311140;202008;1424;3475;1104;3034;81;265;752;2025;833;2290
311150;202008;1475;4669;1140;4008;181;712;608;2075;789;2787
311160;202008;3770;10776;2632;8618;659;2382;787;2464;1446;4846
311170;202008;890;2231;701;1980;40;115;443;1325;483;1440
311180;202008;1369;3085;852;2316;163;487;377;1019;540;1506
311190;202008;869;2395;665;1998;116;398;268;699;384;1097
311200;202008;2035;5458;1461;4361;271;894;532;1434;803;2328
311205;202008;864;2581;698;2246;47;212;440;1336;487;1548
311210;202008;1001;2920;868;2741;109;311;630;2043;739;2354
311220;202008;726;2018;605;1803;48;163;383;1081;431;1244
311230;202008;7675;23027;5783;19151;1032;3566;2179;7357;3211;10923
311240;202008;1027;2674;788;2330;168;531;324;957;492;1488
311250;202008;1109;3214;854;2724;189;579;323;985;512;1564
311260;202008;2687;6594;1714;4891;274;890;728;1896;1002;2786
311265;202008;1316;3400;965;2808;42;157;660;1878;702;2035
311270;202008;2964;8825;2573;8171;157;693;1867;5650;2024;6343
311280;202008;1074;2742;494;1565;98;361;49;131;147;492
311290;202008;1854;5618;1685;5264;148;484;1140;3546;1288;4030
311300;202008;4654;12979;3789;11524;199;839;2987;8873;3186;9712
311310;202008;571;1580;480;1420;47;145;287;817;334;962
311320;202008;3178;9621;2699;8586;383;1450;1282;3673;1665;5123
311330;202008;5102;13316;4028;11569;447;1399;2236;6541;2683;7940
311340;202008;10485;29216;8259;25234;2136;7098;2289;6614;4425;13712
311350;202008;2435;5962;1724;4660;160;471;927;2250;1087;2721
311360;202008;1128;2740;710;2103;197;661;233;666;430;1327
311370;202008;4656;11180;3398;9204;141;554;2270;5780;2411;6334
311380;202008;365;1088;264;876;67;214;111;395;178;609
311390;202008;1744;5244;1376;4729;599;2301;335;1045;934;3346
311400;202008;1513;4133;1092;3311;166;529;400;1070;566;1599
311410;202008;1693;4927;1343;4398;203;766;761;2434;964;3200
311420;202008;1497;4360;1045;3417;192;712;257;692;449;1404
311430;202008;4042;10622;2681;7930;500;1534;865;2522;1365;4056
311440;202008;2775;7715;2053;6476;483;1803;511;1524;994;3327
311450;202008;1703;5058;1218;4146;319;1231;328;963;647;2194
311455;202008;1001;2211;658;1701;169;439;256;706;425;1145
311460;202008;483;1489;320;1137;63;294;88;261;151;555
311470;202008;506;1565;338;1165;79;319;51;166;130;485
311480;202008;1041;2672;855;2389;46;134;660;1839;706;1973
311490;202008;251;740;186;608;32;128;87;250;119;378
311500;202008;458;1128;356;981;21;66;241;642;262;708
311510;202008;3226;8345;2185;6532;308;1034;913;2559;1221;3593
311520;202008;626;1751;548;1600;70;261;307;874;377;1135
311530;202008;8741;20336;5465;15038;1323;4040;1433;3732;2756;7772
311535;202008;786;2148;511;1574;82;258;177;503;259;761
311540;202008;482;1524;426;1415;79;295;283;906;362;1201
311545;202008;2003;5730;1705;5264;96;347;1319;4017;1415;4364
311547;202008;1458;3705;1257;3394;46;122;856;2339;902;2461
311550;202008;2742;7644;2162;6578;301;1045;936;2701;1237;3746
311560;202008;297;649;187;486;73;181;41;99;114;280
311570;202008;1657;3797;1165;3119;36;103;923;2514;959;2617
311580;202008;2148;3983;1410;3114;148;302;941;2080;1089;2382
311590;202008;492;1299;391;1145;63;212;218;628;281;840
311600;202008;1748;3931;1455;3544;61;150;1244;2993;1305;3143
311610;202008;2248;7219;1853;6380;193;735;1056;3570;1249;4305
311615;202008;3212;8949;2595;7920;114;418;2036;6099;2150;6517
311620;202008;437;1110;378;1046;9;33;323;885;332;918
311630;202008;1336;3650;1084;3130;104;336;706;1957;810;2293
311640;202008;641;1746;505;1509;65;230;234;634;299;864
311650;202008;1913;4864;1567;4325;160;486;1005;2690;1165;3176
311660;202008;2892;8108;2129;6639;381;1324;601;1580;982;2904
311670;202008;1540;4017;1124;3270;168;551;454;1315;622;1866
311680;202008;2136;6088;1586;5056;167;534;1057;3356;1224;3890
311690;202008;612;1300;477;1129;39;74;349;879;388;953
311700;202008;2204;5288;1710;4603;26;128;1442;3756;1468;3884
311710;202008;1507;4310;1083;3553;253;909;398;1287;651;2196
311720;202008;414;1218;329;1059;28;107;178;564;206;671
311730;202008;3761;9628;2395;7001;701;2201;473;1425;1174;3626
311740;202008;869;2276;727;2106;66;183;591;1762;657;1945
311750;202008;3828;11424;3042;9984;427;1514;1719;5435;2146;6949
311760;202008;638;1790;521;1578;69;252;262;686;331;938
311770;202008;2059;5901;1601;5072;244;820;752;2301;996;3121
311780;202008;1323;3762;891;2888;158;585;267;742;425;1327
311783;202008;2267;6070;1818;5289;39;181;1468;4090;1507;4271
311787;202008;761;2187;569;1733;84;281;247;642;331;923
311790;202008;1467;3940;955;3007;235;821;256;751;491;1572
311800;202008;4757;14259;3834;12248;804;2796;660;1809;1464;4605
311810;202008;942;2836;743;2481;54;201;492;1622;546;1823
311820;202008;784;1893;578;1577;67;217;360;922;427;1139
311830;202008;8336;23793;5628;17907;1556;5367;691;2157;2247;7524
311840;202008;3567;8991;2866;7986;255;758;2103;5806;2358;6564
311850;202008;362;953;294;825;13;41;197;531;210;572
311860;202008;58889;147866;44807;123869;6479;19303;25003;65948;31482;85251
311870;202008;1887;4970;1272;3860;226;786;492;1334;718;2120
311880;202008;6189;16017;5158;14590;276;702;3887;11213;4163;11915
311890;202008;1671;3992;1281;3427;92;291;917;2323;1009;2614
311900;202008;739;1905;553;1653;63;222;348;1010;411;1232
311910;202008;4129;10575;3091;9216;547;1605;1557;4790;2104;6395
311920;202008;2092;5506;1661;4881;120;314;1048;3185;1168;3499
311930;202008;3819;8887;2712;7312;833;2451;801;1984;1634;4435
311940;202008;15425;40207;11335;32455;1608;5058;5179;13800;6787;18858
311950;202008;2326;6206;1735;5209;111;397;1033;3152;1144;3549
311960;202008;490;1199;393;1054;23;87;254;624;277;711
311970;202008;421;1344;308;1058;51;209;73;217;124;426
311980;202008;446;1202;230;768;23;80;79;260;102;340
311990;202008;542;1253;339;950;66;234;145;358;211;592
311995;202008;960;2627;483;1538;22;72;69;149;91;221
312000;202008;755;1878;566;1598;55;147;355;1020;410;1167
312010;202008;957;2619;737;2249;50;174;473;1365;523;1539
312015;202008;1350;3966;1186;3697;48;212;958;2918;1006;3130
312020;202008;1563;4770;1185;3957;251;892;299;930;550;1822
312030;202008;1986;4929;1727;4642;20;76;1610;4320;1630;4396
312040;202008;852;2476;590;1957;68;235;267;851;335;1086
312050;202008;1193;3678;951;3208;215;856;295;878;510;1734
312060;202008;843;2083;553;1722;137;424;267;850;404;1274
312070;202008;898;2576;641;2064;48;173;353;1073;401;1246
312080;202008;2629;6460;1949;5446;106;344;1273;3402;1379;3746
312083;202008;871;2251;635;1880;52;189;426;1218;478;1407
312087;202008;2470;6408;1985;5648;46;141;1550;4446;1596;4587
312090;202008;10219;26518;7879;22796;1153;3685;3980;11159;5133;14844
312100;202008;1553;4466;1204;3826;107;424;702;2122;809;2546
312110;202008;1029;3156;851;2792;185;701;311;914;496;1615
312120;202008;978;2642;647;2032;166;603;200;514;366;1117
312125;202008;1712;4407;1424;3987;113;368;1059;2848;1172;3216
312130;202008;1020;2464;761;2032;60;177;343;836;403;1013
312140;202008;681;1953;555;1702;116;396;237;667;353;1063
312150;202008;447;1247;379;1107;13;56;271;740;284;796
312160;202008;8699;23615;6578;19823;810;2821;3257;9312;4067;12133
312170;202008;893;2420;673;1990;36;134;443;1271;479;1405
312180;202008;1391;3695;1095;3128;158;461;556;1535;714;1996
312190;202008;663;1822;475;1456;82;278;162;461;244;739
312200;202008;4521;12298;3553;10726;1087;3279;1229;3829;2316;7108
312210;202008;1365;3034;979;2474;36;107;737;1816;773;1923
312220;202008;1618;5000;1394;4579;102;361;884;2909;986;3270
312230;202008;13143;33938;8650;25710;2050;6885;1707;4345;3757;11230
312235;202008;1955;4931;1537;4307;90;304;1099;2988;1189;3292
312240;202008;684;2239;518;1889;118;463;144;515;262;978
312245;202008;2650;6809;2159;6061;61;169;1765;4924;1826;5093
312247;202008;951;2309;680;1912;119;352;353;1008;472;1360
312250;202008;980;2594;623;1876;84;274;235;681;319;955
312260;202008;929;2485;736;2186;37;151;562;1607;599;1758
312270;202008;702;1911;530;1575;26;107;306;828;332;935
312280;202008;415;1225;323;1059;96;324;44;133;140;457
312290;202008;739;2168;590;1900;107;390;202;624;309;1014
312300;202008;968;2920;645;2126;158;569;121;328;279;897
312310;202008;957;2871;762;2456;118;406;347;1069;465;1475
312320;202008;1974;5063;1426;4086;329;999;330;898;659;1897
312330;202008;840;2480;668;2116;60;214;409;1268;469;1482
312340;202008;261;680;184;550;44;156;78;204;122;360
312350;202008;246;495;172;415;15;46;118;270;133;316
312352;202008;1597;4776;1416;4451;86;278;868;2902;954;3180
312360;202008;2722;7860;1985;6431;395;1408;645;1983;1040;3391
312370;202008;1875;4824;1512;4209;175;539;896;2375;1071;2914
312380;202008;2126;4798;1746;4320;4;12;1564;3830;1568;3842
312385;202008;1211;3305;943;2817;139;447;448;1334;587;1781
312390;202008;1854;5337;1376;4429;201;745;518;1521;719;2266
312400;202008;2823;8050;2314;7156;699;2318;734;2260;1433;4578
312410;202008;11561;31825;9356;28085;1626;5081;5116;15164;6742;20245
312420;202008;3689;9988;3058;8943;563;1817;1633;4640;2196;6457
312430;202008;7748;20646;6308;18031;396;1324;4444;12378;4840;13702
312440;202008;914;2939;720;2493;356;1309;98;308;454;1617
312450;202008;1179;3458;898;2971;251;882;295;1017;546;1899
312460;202008;436;1144;299;931;47;152;152;490;199;642
312470;202008;471;1120;294;812;33;100;110;269;143;369
312480;202008;1036;2567;722;2107;99;320;355;980;454;1300
312490;202008;2089;5092;1601;4368;204;584;857;2276;1061;2860
312500;202008;997;2426;812;2168;51;176;564;1481;615;1657
312510;202008;3686;9740;2605;7684;655;1870;685;2054;1340;3924
312520;202008;173;471;131;400;34;111;58;174;92;285
312530;202008;582;1427;498;1325;16;56;439;1171;455;1227
312540;202008;1555;4351;1039;3282;142;486;576;1764;718;2250
312550;202008;776;2046;588;1668;47;151;376;976;423;1127
312560;202008;1931;4970;1535;4344;72;223;1166;3300;1238;3523
312570;202008;2157;5270;1613;4581;460;1358;618;1835;1078;3193
312580;202008;617;1701;435;1314;56;198;197;547;253;745
312590;202008;1597;4629;1265;3967;87;405;793;2295;880;2700
312595;202008;1951;5724;1630;5171;261;782;968;3233;1229;4015
312600;202008;1176;2820;663;1836;115;397;128;401;243;798
312610;202008;6645;16785;4352;12481;643;2018;1513;4005;2156;6023
312620;202008;2522;6474;1859;5541;55;236;1467;4468;1522;4704
312630;202008;283;810;200;660;38;145;78;247;116;392
312640;202008;509;1387;352;1117;40;134;135;440;175;574
312650;202008;2030;5195;1377;3963;64;206;974;2671;1038;2877
312660;202008;1350;3250;1011;2676;97;277;679;1739;776;2016
312670;202008;4914;12926;4067;11569;181;736;2951;8021;3132;8757
312675;202008;1257;3290;1023;2945;60;193;824;2346;884;2539
312680;202008;1369;3859;1183;3571;53;225;973;2850;1026;3075
312690;202008;2899;6108;2254;5331;49;136;1883;4456;1932;4592
312695;202008;960;2597;794;2306;40;92;620;1805;660;1897
312700;202008;2093;5512;1507;4435;152;519;842;2345;994;2864
312705;202008;1406;3338;1194;3022;15;51;1087;2730;1102;2781
312707;202008;1377;3984;1056;3395;67;309;682;2070;749;2379
312710;202008;6457;14785;3754;10521;948;2863;1063;3072;2011;5935
312720;202008;1074;2844;803;2413;105;336;492;1435;597;1771
312730;202008;1623;3824;1143;3155;93;290;662;1759;755;2049
312733;202008;1368;3604;1037;2971;37;144;711;1932;748;2076
312735;202008;706;1901;592;1677;70;221;345;877;415;1098
312737;202008;795;1804;553;1447;68;196;351;876;419;1072
312738;202008;652;1662;465;1352;47;155;259;714;306;869
312740;202008;432;1066;250;753;49;165;65;152;114;317
312750;202008;1566;4512;1160;3747;209;712;492;1507;701;2219
312760;202008;1769;5194;1245;4107;223;793;454;1427;677;2220
312770;202008;44759;106918;27865;77885;5703;17112;9255;25261;14958;42373
312780;202008;2409;7185;2036;6582;244;834;1304;4211;1548;5045
312790;202008;246;582;129;398;7;38;41;105;48;143
312800;202008;4791;13534;3609;11263;883;2919;1238;3766;2121;6685
312810;202008;1559;4137;1026;3276;254;905;364;1056;618;1961
312820;202008;1759;4674;1392;4029;46;175;1043;2935;1089;3110
312825;202008;1337;3130;1158;2896;20;73;991;2424;1011;2497
312830;202008;2837;7935;1668;5504;339;1275;413;1283;752;2558
312840;202008;1326;3585;1048;3107;92;354;559;1536;651;1890
312850;202008;918;2236;648;1837;23;95;395;1030;418;1125
312860;202008;1142;2945;763;2347;193;632;177;500;370;1132
312870;202008;6092;16348;3700;11724;625;2129;849;2507;1474;4636
312880;202008;1421;3527;1093;2970;37;123;651;1773;688;1896
312890;202008;2253;5595;1621;4543;115;309;821;2346;936;2655
312900;202008;1202;3054;973;2760;155;487;450;1393;605;1880
312910;202008;1643;2989;854;1947;166;317;322;763;488;1080
312920;202008;996;2652;681;2122;117;422;285;815;402;1237
312930;202008;2320;5695;1778;4884;404;1138;784;2179;1188;3317
312940;202008;954;2621;742;2305;76;286;375;1101;451;1387
312950;202008;3097;7671;1999;5872;516;1652;629;1784;1145;3436
312960;202008;1791;4723;1502;4275;67;183;1172;3415;1239;3598
312965;202008;1628;4516;1352;4075;113;355;934;2762;1047;3117
312970;202008;1343;3750;1046;3262;149;564;607;1765;756;2329
312980;202008;23915;65384;19199;56818;3737;12057;9113;25271;12850;37328
312990;202008;490;1218;310;902;54;176;152;413;206;589
313000;202008;482;1373;359;1143;29;124;208;614;237;738
313005;202008;2491;7152;2086;6459;162;486;1467;4516;1629;5002
313010;202008;5023;13765;3990;12075;704;2327;2332;6908;3036;9235
313020;202008;1047;3133;723;2376;132;470;143;390;275;860
313030;202008;1103;2557;736;2014;85;279;476;1235;561;1514
313040;202008;796;2435;658;2155;44;184;389;1212;433;1396
313050;202008;1756;4802;1217;3983;201;789;397;1157;598;1946
313055;202008;1897;5083;1675;4760;58;185;1444;4086;1502;4271
313060;202008;966;2308;695;1846;180;579;131;311;311;890
313065;202008;1634;4853;1425;4506;49;189;1097;3380;1146;3569
313070;202008;946;2486;708;2070;74;233;410;1167;484;1400
313080;202008;390;1081;286;879;51;182;104;270;155;452
313090;202008;5063;13411;4283;12147;338;1099;2865;8039;3203;9138
313100;202008;1333;3436;1025;2992;27;114;780;2216;807;2330
313110;202008;1472;3865;1065;3155;96;354;597;1656;693;2010
313115;202008;2629;7555;2110;6531;273;938;1103;3208;1376;4146
313120;202008;3738;8813;2713;7461;225;717;1755;4782;1980;5499
313130;202008;30796;79339;23346;65602;2522;8030;13215;35018;15737;43048
313140;202008;613;1326;363;965;29;71;242;648;271;719
313150;202008;1350;3773;997;3121;299;1018;213;598;512;1616
313160;202008;1160;2898;907;2508;27;100;677;1815;704;1915
313170;202008;11227;31724;7981;25676;1349;4755;3180;9623;4529;14378
313180;202008;2070;5458;1460;4251;184;563;832;2375;1016;2938
313190;202008;4289;12270;3121;9882;573;1962;1071;3159;1644;5121
313200;202008;1075;2968;932;2719;15;55;789;2232;804;2287
313210;202008;3783;10988;3058;9677;369;1310;1815;5523;2184;6833
313220;202008;1753;4586;1153;3391;166;551;464;1205;630;1756
313230;202008;2963;8266;2433;7611;45;163;2032;6510;2077;6673
313240;202008;9732;23717;6010;17679;1003;3397;2528;6895;3531;10292
313250;202008;6225;18126;4614;14710;837;2720;2014;6262;2851;8982
313260;202008;635;1662;454;1332;63;245;217;580;280;825
313270;202008;5795;14320;4615;12653;569;1513;3108;8680;3677;10193
313280;202008;465;1298;297;950;36;130;130;390;166;520
313290;202008;946;2919;687;2448;214;825;216;766;430;1591
313300;202008;1597;4247;1145;3428;291;956;273;701;564;1657
313310;202008;1164;3429;895;2861;143;545;253;683;396;1228
313320;202008;2120;5607;1522;4631;266;924;619;1899;885;2823
313330;202008;4061;10622;3059;9101;171;639;1971;5836;2142;6475
313340;202008;1399;3136;983;2560;89;244;683;1765;772;2009
313350;202008;2791;7759;1769;5405;232;766;623;1693;855;2459
313360;202008;1470;3545;1012;2816;157;538;527;1343;684;1881
313370;202008;1432;4008;1184;3518;134;471;666;1823;800;2294
313375;202008;1768;4605;1090;3328;194;641;238;674;432;1315
313380;202008;6263;15614;4455;12296;783;2424;2091;5122;2874;7546
313390;202008;800;2560;692;2379;49;233;462;1519;511;1752
313400;202008;3702;9109;2839;7908;155;470;2178;5982;2333;6452
313410;202008;1309;3396;1005;2853;51;174;747;2067;798;2241
313420;202008;15658;34719;7955;21736;1797;5464;1140;3055;2937;8519
313430;202008;959;2809;730;2335;129;506;308;854;437;1360
313440;202008;6201;13463;4038;10600;388;1056;2467;6491;2855;7547
313450;202008;734;1957;512;1518;83;261;177;449;260;710
313460;202008;2091;5944;1653;5251;333;1200;777;2327;1110;3527
313470;202008;2887;7337;2269;6428;246;700;1483;4250;1729;4950
313480;202008;1010;2887;564;1876;71;266;171;513;242;779
313490;202008;2608;6281;1245;3827;321;1107;229;683;550;1790
313500;202008;516;1427;384;1143;45;136;157;429;202;565
313505;202008;10015;26387;8522;24349;341;1196;6857;19580;7198;20776
313507;202008;1467;3792;1191;3363;34;141;950;2606;984;2747
313510;202008;13701;37631;10694;31809;1296;4035;5007;14574;6303;18609
313520;202008;14169;39851;11235;34780;600;2242;8354;25260;8954;27502
313530;202008;520;1535;389;1250;48;163;153;446;201;609
313535;202008;2362;6517;1956;5730;264;701;1191;3504;1455;4205
313540;202008;765;2258;610;1885;109;344;255;729;364;1073
313545;202008;1145;3756;955;3360;153;564;508;1732;661;2296
313550;202008;1733;5269;1420;4532;309;1102;719;2191;1028;3293
313560;202008;2667;5244;1986;4415;58;104;1676;3753;1734;3857
313570;202008;996;2892;813;2561;201;664;321;974;522;1638
313580;202008;5676;14728;4347;12496;500;1527;2510;7299;3010;8826
313590;202008;1025;2876;823;2590;204;677;378;1263;582;1940
313600;202008;3996;10629;3319;9574;91;372;2782;7869;2873;8241
313610;202008;1058;2644;849;2296;93;282;539;1376;632;1658
313620;202008;5574;14686;4336;12409;547;1747;2480;6835;3027;8582
313630;202008;8689;20846;6093;16933;602;1937;3681;10005;4283;11942
313640;202008;1108;2488;705;1971;146;440;321;892;467;1332
313650;202008;1716;5111;1354;4491;95;375;888;2977;983;3352
313652;202008;738;2323;662;2165;110;383;411;1310;521;1693
313655;202008;1125;2860;886;2552;46;139;689;1979;735;2118
313657;202008;1170;3120;922;2730;39;151;675;1888;714;2039
313660;202008;899;2507;729;2200;78;281;450;1285;528;1566
313665;202008;4792;12735;3721;10829;405;1318;2307;6384;2712;7702
313670;202008;49339;120207;31199;89357;4597;14454;13758;37218;18355;51672
313680;202008;1007;2696;825;2401;61;207;550;1551;611;1758
313690;202008;803;2474;617;2128;153;584;162;541;315;1125
313695;202008;1813;4923;1372;4186;86;276;914;2805;1000;3081
313700;202008;2887;9193;2485;8654;248;877;1850;6487;2098;7364
313710;202008;1413;3237;1010;2698;75;206;670;1811;745;2017
313720;202008;5536;15222;3801;11574;582;1961;1563;4340;2145;6301
313730;202008;1313;2959;990;2519;81;176;647;1658;728;1834
313740;202008;1669;5911;1374;5145;315;1356;258;826;573;2182
313750;202008;2002;5323;1529;4482;272;887;726;1993;998;2880
313753;202008;2213;5239;1472;4037;146;439;816;2162;962;2601
313760;202008;5274;14487;3966;11956;797;2651;1754;4910;2551;7561
313770;202008;3970;11096;3138;9755;203;666;2318;7290;2521;7956
313780;202008;3988;10575;2864;8684;232;833;826;2567;1058;3400
313790;202008;493;1519;440;1421;52;190;244;764;296;954
313800;202008;1380;3139;998;2598;127;377;529;1305;656;1682
313810;202008;1596;4065;1265;3594;53;204;967;2667;1020;2871
313820;202008;17589;44436;10957;30431;1740;5096;3012;8063;4752;13159
313830;202008;384;1097;269;830;47;161;91;255;138;416
313835;202008;912;2680;752;2384;60;245;426;1264;486;1509
313840;202008;7049;18286;5253;15295;1278;3959;1101;3281;2379;7240
313850;202008;981;2385;777;2109;144;473;367;882;511;1355
313860;202008;2547;6829;1892;5592;303;1014;788;2135;1091;3149
313862;202008;1353;2848;646;1806;41;119;311;868;352;987
313865;202008;2561;6798;2108;6055;84;257;1583;4458;1667;4715
313867;202008;1326;3958;1096;3534;154;483;667;2212;821;2695
313868;202008;1699;5224;1392;4599;45;221;1059;3387;1104;3608
313870;202008;764;2063;551;1670;91;286;211;581;302;867
313880;202008;1694;4408;1237;3630;166;549;579;1506;745;2055
313890;202008;2022;4395;1510;3727;47;159;1116;2677;1163;2836
313900;202008;4114;11884;2932;9455;756;2683;703;2060;1459;4743
313910;202008;649;1895;490;1594;105;365;103;325;208;690
313920;202008;2910;8954;2423;7933;500;1605;1190;3946;1690;5551
313925;202008;1575;3974;1253;3402;188;496;809;2184;997;2680
313930;202008;4623;13905;3728;12273;289;1089;2395;7769;2684;8858
313940;202008;8842;25472;6345;21091;773;3168;1518;5595;2291;8763
313950;202008;5182;11437;3764;9686;409;1317;2234;5736;2643;7053
313960;202008;5792;13951;3867;10709;703;2212;1339;3383;2042;5595
313970;202008;1501;4053;1252;3632;22;71;796;2256;818;2327
313980;202008;1332;3437;865;2699;132;478;343;1005;475;1483
313990;202008;1911;6045;1356;4767;339;1384;427;1298;766;2682
314000;202008;9586;24569;7996;21839;573;2020;5346;14370;5919;16390
314010;202008;1471;3517;1146;3073;45;153;869;2251;914;2404
314015;202008;1955;5406;1482;4589;192;695;803;2424;995;3119
314020;202008;468;1276;312;1008;71;274;61;212;132;486
314030;202008;799;2296;631;1973;59;186;334;1025;393;1211
314040;202008;617;1658;491;1423;74;240;263;736;337;976
314050;202008;1827;4854;1323;3916;149;525;712;1959;861;2484
314053;202008;1787;5316;1432;4608;279;893;749;2496;1028;3389
314055;202008;2253;6071;1894;5507;43;163;1549;4497;1592;4660
314060;202008;1301;3412;974;2893;33;127;690;2020;723;2147
314070;202008;4682;12800;3631;10881;736;2195;1593;4718;2329;6913
314080;202008;2098;5416;1431;4272;187;659;613;1644;800;2303
314085;202008;2109;5947;1716;5332;221;724;965;3049;1186;3773
314090;202008;4612;12363;3941;11374;248;909;2470;7262;2718;8171
314100;202008;3112;7399;2396;6406;42;121;1799;4826;1841;4947
314110;202008;4691;13211;3799;11485;430;1526;2162;6089;2592;7615
314120;202008;772;1804;317;951;65;239;73;200;138;439
314130;202008;611;1575;377;1156;22;94;235;710;257;804
314140;202008;4525;12795;3555;10939;480;1552;1780;5388;2260;6940
314150;202008;1490;3706;1086;3011;81;238;723;1944;804;2182
314160;202008;2198;5775;1594;4658;218;701;674;1970;892;2671
314170;202008;924;2603;741;2239;44;164;483;1373;527;1537
314180;202008;5407;15019;4352;13301;361;1193;2618;8016;2979;9209
314190;202008;619;1529;435;1254;80;268;201;512;281;780
314200;202008;2963;8250;2423;7321;151;514;1719;5048;1870;5562
314210;202008;2008;5250;1600;4501;181;519;789;2176;970;2695
314220;202008;1396;3777;992;3062;211;741;365;1026;576;1767
314225;202008;1072;3008;880;2699;75;196;638;2011;713;2207
314230;202008;774;1997;632;1818;78;251;404;1192;482;1443
314240;202008;1039;2784;795;2403;189;601;301;916;490;1517
314250;202008;498;1393;304;985;48;150;111;332;159;482
314260;202008;943;2553;733;2264;163;547;400;1205;563;1752
314270;202008;3278;9267;2685;8337;78;327;1967;6057;2045;6384
314280;202008;3448;7973;2290;6198;263;787;1243;3205;1506;3992
314290;202008;4429;11461;3608;9990;300;855;2458;6677;2758;7532
314300;202008;1924;5479;1249;4022;245;866;421;1284;666;2150
314310;202008;4104;10606;2700;8194;858;2857;434;1162;1292;4019
314315;202008;914;3131;779;2852;52;245;546;1926;598;2171
314320;202008;2983;8082;1939;6096;349;1200;720;2166;1069;3366
314330;202008;49588;138561;37158;116229;9856;32251;7614;25116;17470;57367
314340;202008;2461;6078;1500;4342;280;931;382;945;662;1876
314345;202008;1441;4220;1163;3712;147;473;692;2193;839;2666
314350;202008;819;2231;526;1691;119;402;122;339;241;741
314360;202008;565;1631;341;1136;53;199;110;331;163;530
314370;202008;737;1948;589;1725;42;146;400;1119;442;1265
314380;202008;1140;3084;755;2387;167;596;162;483;329;1079
314390;202008;13754;34608;8866;25636;1567;4921;2923;7519;4490;12440
314400;202008;3976;11796;2984;9875;764;2606;1097;3774;1861;6380
314410;202008;2705;7521;1855;5933;249;921;620;2093;869;3014
314420;202008;832;2050;598;1661;38;145;395;1032;433;1177
314430;202008;7839;19109;5432;15038;818;2377;2525;6657;3343;9034
314435;202008;1795;4751;1409;4099;62;233;1029;2911;1091;3144
314437;202008;903;2309;655;1889;69;217;321;915;390;1132
314440;202008;617;1758;432;1375;123;429;86;227;209;656
314450;202008;1394;3718;1163;3359;116;392;676;1866;792;2258
314460;202008;3231;9801;2327;7875;595;2132;544;1768;1139;3900
314465;202008;2201;6353;1862;5702;55;215;1430;4230;1485;4445
314467;202008;918;2397;768;2153;24;70;616;1681;640;1751
314470;202008;2254;6428;1827;5557;317;1045;846;2413;1163;3458
314480;202008;6489;18431;4656;14557;775;2711;1715;4721;2490;7432
314490;202008;1074;2844;784;2240;67;191;483;1345;550;1536
314500;202008;1721;4129;1222;3428;310;857;423;1232;733;2089
314505;202008;2031;4960;1649;4414;100;275;1202;3134;1302;3409
314510;202008;1908;4984;1332;4084;267;926;600;1793;867;2719
314520;202008;5003;15284;3656;12427;741;2754;458;1386;1199;4140
314530;202008;5374;17252;4805;16150;310;1294;3531;11587;3841;12881
314535;202008;2504;6536;2012;5818;87;319;1536;4396;1623;4715
314537;202008;1086;3072;832;2662;43;170;599;1876;642;2046
314540;202008;389;963;260;743;18;58;149;409;167;467
314545;202008;1902;4512;1698;4274;29;84;1481;3820;1510;3904
314550;202008;655;1607;485;1362;37;133;276;703;313;836
314560;202008;4351;13033;3201;10427;494;1804;1108;3257;1602;5061
314570;202008;298;822;217;669;27;99;94;290;121;389
314580;202008;459;1366;361;1167;92;299;122;390;214;689
314585;202008;656;2046;494;1685;70;291;208;684;278;975
314587;202008;2005;5432;1507;4632;204;594;854;2703;1058;3297
314590;202008;4038;10966;2903;8811;390;1338;1277;3561;1667;4899
314600;202008;1920;5202;1122;3660;227;791;133;398;360;1189
314610;202008;8792;21916;6118;17918;1004;3506;2585;7718;3589;11224
314620;202008;2236;5225;1757;4618;42;141;1460;3812;1502;3953
314625;202008;1528;4172;1305;3864;31;179;1122;3243;1153;3422
314630;202008;5371;13556;4386;12245;101;419;3671;10226;3772;10645
314640;202008;683;1621;492;1323;70;218;273;678;343;896
314650;202008;839;1927;510;1415;49;155;279;683;328;838
314655;202008;1603;4394;1129;3533;172;541;556;1730;728;2271
314660;202008;322;729;206;519;14;30;134;325;148;355
314670;202008;1611;3688;1107;2968;17;53;731;1934;748;1987
314675;202008;1691;4485;1436;4054;76;252;1117;3065;1193;3317
314690;202008;2055;5717;1573;4992;414;1463;540;1675;954;3138
314700;202008;10189;28370;6610;21368;1276;4574;2016;6292;3292;10866
314710;202008;7796;21766;5591;17081;923;3113;1973;5247;2896;8360
314720;202008;2139;6279;1467;4887;303;1131;371;1151;674;2282
314730;202008;2278;5934;1629;4741;250;812;684;1822;934;2634
314740;202008;2912;8224;2238;6992;292;976;1125;3427;1417;4403
314750;202008;292;790;223;650;27;92;134;351;161;443
314760;202008;1942;5774;1257;4198;206;787;323;841;529;1628
314770;202008;1101;3212;588;1896;48;173;179;532;227;705
314780;202008;352;824;236;650;42;141;128;308;170;449
314790;202008;10748;28639;7371;22346;1527;5298;2594;7244;4121;12542
314795;202008;1508;3975;1268;3552;29;119;1008;2719;1037;2838
314800;202008;10797;27428;6555;19509;1211;3961;1679;4422;2890;8383
314810;202008;8608;22901;6181;18616;1565;5028;1997;5892;3562;10920
314820;202008;1227;2939;953;2531;53;200;615;1555;668;1755
314830;202008;1509;4562;1258;4086;219;807;613;1917;832;2724
314840;202008;839;2639;662;2352;48;238;469;1595;517;1833
314850;202008;2071;4805;1678;4300;45;143;1456;3741;1501;3884
314860;202008;3156;9298;2603;8283;195;797;1788;5535;1983;6332
314870;202008;6313;15921;4767;13856;280;904;3521;10318;3801;11222
314875;202008;1751;5216;1520;4910;120;309;1213;4014;1333;4323
314880;202008;821;2012;626;1710;32;88;374;1033;406;1121
314890;202008;419;1245;316;1025;50;183;129;392;179;575
314900;202008;733;1962;568;1669;82;280;252;689;334;969
314910;202008;1667;4690;1236;3989;208;778;613;1863;821;2641
314915;202008;2190;6462;1825;5819;118;387;1203;3773;1321;4160
314920;202008;469;1211;298;950;7;22;197;646;204;668
314930;202008;5473;15353;4085;12733;687;2378;1630;4707;2317;7085
314940;202008;396;995;324;872;35;89;206;527;241;616
314950;202008;523;1309;344;1006;26;100;181;467;207;567
314960;202008;845;2006;647;1678;29;94;460;1121;489;1215
314970;202008;971;2814;742;2334;140;479;327;939;467;1418
314980;202008;1495;3814;1096;3227;200;676;515;1481;715;2157
314990;202008;2463;7079;1712;5370;340;1145;363;1024;703;2169
314995;202008;1579;4421;1243;3805;37;162;826;2392;863;2554
315000;202008;1116;2815;791;2318;64;202;521;1505;585;1707
315010;202008;377;1034;285;876;45;162;137;401;182;563
315015;202008;2257;6330;1949;5809;188;628;1289;3776;1477;4404
315020;202008;795;2315;554;1764;70;279;236;689;306;968
315030;202008;595;1586;403;1227;90;278;84;227;174;505
315040;202008;807;2265;652;1992;85;281;400;1211;485;1492
315050;202008;1225;3170;883;2621;55;198;463;1342;518;1540
315053;202008;1096;2855;833;2391;52;162;487;1334;539;1496
315057;202008;1742;5240;1413;4661;139;462;944;3140;1083;3602
315060;202008;561;1690;414;1404;79;273;110;365;189;638
315070;202008;524;1378;356;1080;85;283;91;260;176;543
315080;202008;2937;8217;2245;6879;241;823;1417;4125;1658;4948
315090;202008;793;2367;578;1950;86;310;225;732;311;1042
315100;202008;1327;3873;862;2808;141;546;380;1085;521;1631
315110;202008;1852;4459;1337;3664;131;352;666;1885;797;2237
315120;202008;12188;28312;8945;23404;1174;2869;4850;13118;6024;15987
315130;202008;1591;4322;1313;3831;139;464;541;1487;680;1951
315140;202008;2929;8103;2251;6871;397;1311;1129;3268;1526;4579
315150;202008;4322;10337;3011;8224;462;1481;1405;3718;1867;5199
315160;202008;1764;4299;1157;3321;246;751;525;1490;771;2241
315170;202008;1369;4338;935;3279;219;849;219;728;438;1577
315180;202008;17152;41460;9140;26598;1229;4060;2937;7489;4166;11549
315190;202008;2208;4818;1706;4158;196;472;1245;3068;1441;3540
315200;202008;3877;10993;2777;9001;795;2774;732;2265;1527;5039
315210;202008;8526;22092;5763;16222;673;2064;2867;7299;3540;9363
315213;202008;1120;2922;961;2701;22;76;793;2182;815;2258
315217;202008;2795;8047;2116;6902;89;434;1469;4573;1558;5007
315220;202008;8553;23173;6692;19851;1141;3595;2852;8463;3993;12058
315230;202008;3080;7161;2569;6496;201;283;1948;5277;2149;5560
315240;202008;2439;7143;2047;6447;460;1499;982;3105;1442;4604
315250;202008;12851;34558;9165;27542;1448;4707;3904;11174;5352;15881
315260;202008;919;2522;481;1579;77;255;40;108;117;363
315270;202008;825;2357;582;1890;81;282;207;575;288;857
315280;202008;2908;7252;1712;5077;423;1364;267;766;690;2130
315290;202008;1169;2853;682;2072;192;657;200;573;392;1230
315300;202008;624;1522;427;1234;83;269;219;634;302;903
315310;202008;1256;3527;927;2894;76;271;516;1523;592;1794
315320;202008;651;1903;453;1499;68;267;194;589;262;856
315330;202008;749;2548;410;1623;65;301;128;450;193;751
315340;202008;2981;7191;2132;5975;284;823;1124;3137;1408;3960
315350;202008;1555;4243;1204;3694;174;622;669;2016;843;2638
315360;202008;1708;5035;1276;4116;200;687;512;1544;712;2231
315370;202008;471;1359;371;1154;71;218;146;444;217;662
315380;202008;193;569;141;456;39;136;30;68;69;204
315390;202008;1068;3024;845;2599;142;507;395;1118;537;1625
315400;202008;4017;10946;3138;9348;439;1372;1692;4841;2131;6213
315410;202008;2370;5442;1778;4587;475;1322;267;718;742;2040
315415;202008;1373;3738;1097;3315;228;811;427;1296;655;2107
315420;202008;1403;3949;953;3075;178;602;183;569;361;1171
315430;202008;3571;8686;2499;7058;443;1472;1083;2853;1526;4325
315440;202008;1038;2741;831;2401;62;213;498;1357;560;1570
315445;202008;1954;4701;1384;3893;87;291;1002;2772;1089;3063
315450;202008;2218;6176;1795;5478;231;688;1104;3368;1335;4056
315460;202008;36548;101578;30002;89690;4573;15493;16232;45597;20805;61090
315470;202008;625;1758;444;1313;32;103;254;717;286;820
315480;202008;1165;3351;813;2585;156;526;263;805;419;1331
315490;202008;2944;7403;2028;5917;294;880;741;2081;1035;2961
315500;202008;525;1400;320;951;43;149;160;416;203;565
315510;202008;1230;3217;1038;2944;24;103;902;2514;926;2617
315520;202008;978;2711;786;2378;52;192;591;1742;643;1934
315530;202008;607;1700;474;1464;132;468;229;652;361;1120
315540;202008;1444;3866;1001;3040;101;367;458;1343;559;1710
315550;202008;1909;4966;1230;3698;254;880;303;888;557;1768
315560;202008;6226;18906;5235;17078;300;947;3485;11609;3785;12556
315570;202008;2041;5519;1623;4812;96;335;921;2670;1017;3005
315580;202008;2831;6683;2118;5559;291;891;815;2023;1106;2914
315590;202008;891;2260;684;1930;72;250;381;992;453;1242
315600;202008;2465;7712;1767;6319;272;925;896;3375;1168;4300
315610;202008;958;2437;706;1969;107;375;319;767;426;1142
315620;202008;506;1347;379;1157;45;163;217;670;262;833
315630;202008;1042;2763;773;2268;131;400;352;944;483;1344
315640;202008;351;871;261;759;30;112;156;431;186;543
315645;202008;993;2557;672;2023;158;517;172;497;330;1014
315650;202008;1723;4149;1375;3664;35;112;1118;2887;1153;2999
315660;202008;2432;5989;1821;4933;103;310;1294;3384;1397;3694
315670;202008;13575;37067;10273;31042;2021;6404;4628;13412;6649;19816
315680;202008;3121;8974;2275;7354;290;1069;1191;3673;1481;4742
315690;202008;3352;8146;1975;5757;431;1273;588;1840;1019;3113
315700;202008;8023;22131;5989;18018;957;3052;2673;7701;3630;10753
315710;202008;1830;4530;1284;3702;42;180;910;2517;952;2697
315720;202008;4271;11906;3584;10665;176;714;2551;7268;2727;7982
315725;202008;2150;5610;1631;4717;182;505;1016;3077;1198;3582
315727;202008;564;1459;424;1230;57;203;172;467;229;670
315730;202008;560;1763;491;1610;87;322;171;518;258;840
315733;202008;1143;2898;803;2312;117;407;312;852;429;1259
315737;202008;1160;3261;904;2754;27;111;653;1905;680;2016
315740;202008;824;2289;653;1943;71;247;419;1162;490;1409
315750;202008;1265;3328;989;2879;93;289;597;1768;690;2057
315760;202008;1119;2675;986;2501;39;113;832;2068;871;2181
315765;202008;1901;5040;1560;4591;27;122;1371;4002;1398;4124
315770;202008;1023;2827;781;2481;321;1126;160;424;481;1550
315780;202008;29343;79749;24490;71171;1340;4829;17018;47236;18358;52065
315790;202008;3534;10929;2990;9882;391;1361;1770;5935;2161;7296
315800;202008;1255;4368;920;3494;125;553;305;1021;430;1574
315810;202008;1301;3218;1056;2795;58;200;811;2045;869;2245
315820;202008;2568;6940;2080;6227;188;652;1434;4269;1622;4921
315830;202008;1183;3507;803;2685;85;311;282;868;367;1179
315840;202008;844;2029;585;1572;45;140;289;706;334;846
315850;202008;1161;3436;905;2969;183;646;445;1374;628;2020
315860;202008;472;1358;328;1092;69;247;98;288;167;535
315870;202008;460;1210;368;1065;16;56;266;733;282;789
315880;202008;1079;2804;708;2138;101;370;165;464;266;834
315890;202008;1680;4794;1345;4324;331;1171;663;2097;994;3268
315895;202008;6227;16727;4644;13606;453;1478;2422;6586;2875;8064
315900;202008;811;2077;696;1910;58;177;526;1400;584;1577
315910;202008;501;1416;421;1287;57;191;293;875;350;1066
315920;202008;1463;3682;794;2408;122;446;250;688;372;1134
315930;202008;1086;2430;724;1915;139;347;304;833;443;1180
315935;202008;788;2376;615;2038;119;414;214;702;333;1116
315940;202008;598;1662;477;1473;52;168;250;745;302;913
315950;202008;1155;3183;949;2848;84;246;726;2177;810;2423
315960;202008;5137;14454;3309;10719;961;3503;281;584;1242;4087
315970;202008;613;1626;482;1452;61;200;315;952;376;1152
315980;202008;4296;9269;2332;6051;418;1149;860;2042;1278;3191
315990;202008;3619;9182;2805;7785;265;791;1599;4293;1864;5084
316000;202008;580;1467;431;1250;52;187;205;555;257;742
316010;202008;840;2219;618;1841;41;139;380;1050;421;1189
316020;202008;922;2813;732;2429;100;389;407;1258;507;1647
316030;202008;2702;7613;2032;6407;235;757;1286;4108;1521;4865
316040;202008;2382;6718;1738;5510;309;1105;437;1198;746;2303
316045;202008;2082;5359;1912;5154;76;148;1648;4571;1724;4719
316050;202008;368;1025;283;881;31;107;161;459;192;566
316060;202008;668;1671;485;1400;17;74;336;928;353;1002
316070;202008;5237;14577;4240;12680;734;2272;1994;5801;2728;8073
316080;202008;721;2265;561;1937;141;505;80;253;221;758
316090;202008;404;1153;296;933;39;137;144;426;183;563
316095;202008;1274;3957;1012;3291;268;914;328;1034;596;1948
316100;202008;2430;7075;1750;5629;312;1102;651;1906;963;3008
316105;202008;816;2151;666;1907;35;122;454;1334;489;1456
316110;202008;13523;39124;11246;35238;820;2967;7587;23459;8407;26426
316120;202008;1195;3402;762;2371;118;383;233;597;351;980
316130;202008;1277;2877;815;2114;62;190;474;1194;536;1384
316140;202008;1198;3179;770;2384;96;328;376;1134;472;1462
316150;202008;1907;4152;1533;3644;174;536;643;1455;817;1991
316160;202008;970;2661;796;2357;40;143;546;1566;586;1709
316165;202008;853;2126;648;1795;92;299;345;894;437;1193
316170;202008;1161;2848;871;2412;50;177;606;1601;656;1778
316180;202008;1380;3890;929;2953;147;562;165;483;312;1045
316190;202008;2734;7745;1582;4970;230;749;589;1636;819;2385
316200;202008;3234;9266;2403;7796;583;2004;584;1824;1167;3828
316210;202008;4430;12988;3174;10132;1151;3979;187;502;1338;4481
316220;202008;585;1772;390;1325;93;359;41;160;134;519
316225;202008;1554;3524;1157;2883;54;200;871;2013;925;2213
316230;202008;409;1113;312;944;38;118;173;533;211;651
316240;202008;5568;16048;4866;14829;369;1208;3667;11004;4036;12212
316245;202008;2943;9568;2645;9053;121;702;2047;6675;2168;7377
316250;202008;10261;24546;7436;20054;1565;4671;2727;7205;4292;11876
316255;202008;2937;8117;2553;7494;115;358;1915;5690;2030;6048
316257;202008;1379;3335;992;2651;125;343;565;1434;690;1777
316260;202008;2119;5344;1622;4508;210;572;838;2394;1048;2966
316265;202008;1127;3021;872;2591;22;81;637;1839;659;1920
316270;202008;3657;11312;3124;10120;496;1732;1500;4622;1996;6354
316280;202008;2863;8149;2435;7340;319;1048;1367;3996;1686;5044
316290;202008;3381;9278;2690;8013;294;1029;1150;3303;1444;4332
316292;202008;4962;13198;3964;11521;501;1586;2555;7138;3056;8724
316294;202008;824;2441;614;2070;117;449;165;516;282;965
316295;202008;3149;8795;2550;7742;144;532;1788;5156;1932;5688
316300;202008;1002;2837;813;2536;47;167;597;1837;644;2004
316310;202008;797;2138;514;1626;107;399;88;229;195;628
316320;202008;660;1846;512;1610;57;216;233;709;290;925
316330;202008;1089;2827;823;2350;54;189;619;1702;673;1891
316340;202008;1009;2723;751;2251;73;290;427;1204;500;1494
316350;202008;1274;3582;1051;3225;89;298;736;2233;825;2531
316360;202008;619;1640;504;1445;51;154;362;1023;413;1177
316370;202008;4932;13134;3609;10710;676;2303;1353;3558;2029;5861
316380;202008;1718;4117;1344;3581;52;117;933;2491;985;2608
316390;202008;805;2144;570;1731;227;783;95;257;322;1040
316400;202008;1174;3283;754;2442;113;397;248;740;361;1137
316410;202008;1108;3081;924;2810;57;188;730;2168;787;2356
316420;202008;1940;5280;1674;4929;42;152;1380;3990;1422;4142
316430;202008;834;2207;526;1656;93;323;163;480;256;803
316440;202008;825;2509;649;2188;112;437;161;488;273;925
316443;202008;534;1469;391;1198;98;353;82;230;180;583
316447;202008;1954;5230;1709;4821;28;108;1472;4073;1500;4181
316450;202008;2108;6434;1600;5371;214;778;954;3115;1168;3893
316460;202008;1187;3003;949;2614;131;403;597;1545;728;1948
316470;202008;6785;19368;4796;15157;785;2836;1854;5336;2639;8172
316480;202008;200;548;166;499;45;132;76;224;121;356
316490;202008;326;867;230;696;40;124;82;209;122;333
316500;202008;1169;3624;770;2659;163;619;174;574;337;1193
316510;202008;742;2416;595;2130;110;410;290;1037;400;1447
316520;202008;1249;3071;959;2598;117;404;491;1190;608;1594
316530;202008;1103;2873;798;2323;80;315;414;1054;494;1369
316540;202008;833;2163;643;1875;110;367;307;811;417;1178
316550;202008;1350;3931;1152;3546;53;189;896;2739;949;2928
316553;202008;4294;12678;3014;9528;468;1651;1097;3068;1565;4719
316555;202008;2475;7908;2239;7578;115;414;1844;6291;1959;6705
316556;202008;538;1312;387;1050;29;78;216;531;245;609
316557;202008;1032;3206;885;2962;295;1067;290;943;585;2010
316560;202008;329;908;226;754;51;216;71;198;122;414
316570;202008;1229;3556;1009;3143;249;790;357;1150;606;1940
316580;202008;383;812;220;544;36;107;109;252;145;359
316590;202008;1332;3434;933;2653;186;463;460;1284;646;1747
316600;202008;932;2871;792;2586;123;421;415;1336;538;1757
316610;202008;601;1869;487;1684;57;252;287;964;344;1216
316620;202008;2037;5424;1781;5062;89;270;1403;3978;1492;4248
316630;202008;1543;4640;1255;4088;323;1071;503;1768;826;2839
316640;202008;141;369;109;320;16;53;51;124;67;177
316650;202008;1025;3247;819;2920;77;289;510;1851;587;2140
316660;202008;181;456;78;243;7;26;13;36;20;62
316670;202008;1783;4516;1303;3729;305;951;478;1336;783;2287
316680;202008;2280;5762;1669;4606;101;305;1259;3377;1360;3682
316690;202008;1388;3919;1038;3280;182;626;467;1434;649;2060
316695;202008;1017;2955;832;2619;29;121;575;1780;604;1901
316700;202008;401;937;330;847;16;53;256;623;272;676
316710;202008;3037;9930;2319;8416;465;1809;914;3289;1379;5098
316720;202008;20282;55352;14742;44660;2596;8401;6242;17951;8838;26352
316730;202008;427;1159;344;997;45;152;169;465;214;617
316740;202008;740;2170;639;2004;73;263;397;1250;470;1513
316750;202008;388;1160;297;985;63;239;135;418;198;657
316760;202008;3492;11114;2845;9810;1130;4230;614;1995;1744;6225
316770;202008;1596;3664;1221;3136;25;75;994;2623;1019;2698
316780;202008;566;1679;436;1417;166;606;67;184;233;790
316790;202008;694;1874;489;1463;98;321;147;393;245;714
316800;202008;6183;17395;4928;15090;521;1800;2527;7476;3048;9276
316805;202008;1001;2218;806;2005;57;160;621;1557;678;1717
316810;202008;624;1743;422;1322;78;284;219;643;297;927
316820;202008;304;727;170;487;10;32;81;217;91;249
316830;202008;744;1992;590;1746;77;254;359;1033;436;1287
316840;202008;2731;7074;2175;6123;192;673;1492;3990;1684;4663
316850;202008;1911;5023;1360;4000;223;698;590;1671;813;2369
316860;202008;18940;48696;13856;41064;2239;7705;6285;18163;8524;25868
316870;202008;7798;21272;5765;17322;862;2850;2583;7234;3445;10084
316880;202008;843;2286;682;2059;135;454;321;920;456;1374
316890;202008;1144;2524;672;1888;94;339;407;1039;501;1378
316900;202008;2301;6170;1765;5084;340;1071;552;1476;892;2547
316905;202008;522;1553;421;1353;108;377;165;540;273;917
316910;202008;893;2340;538;1702;137;472;44;130;181;602
316920;202008;1751;4297;1212;3479;230;720;539;1483;769;2203
316930;202008;7551;21785;5528;18055;1255;4376;1475;4560;2730;8936
316935;202008;3992;10814;2886;8726;521;1705;1154;3328;1675;5033
316940;202008;6413;18818;4884;15610;754;2684;1923;5671;2677;8355
316950;202008;1869;4382;1452;3813;42;135;1206;3121;1248;3256
316960;202008;5056;11399;3628;9434;346;990;2453;6226;2799;7216
316970;202008;3701;10521;3210;9596;503;1573;1358;3883;1861;5456
316980;202008;665;1991;502;1673;164;617;59;205;223;822
316990;202008;11599;31079;8336;24416;2143;6833;1280;3372;3423;10205
317000;202008;2519;7428;2211;6976;171;499;1628;5182;1799;5681
317005;202008;2573;7280;2027;6157;326;1055;1067;3165;1393;4220
317010;202008;24328;57004;14910;42493;2986;9402;5600;16398;8586;25800
317020;202008;63619;150816;36310;103169;6589;20571;11189;29316;17778;49887
317030;202008;710;1890;550;1669;17;80;418;1243;435;1323
317040;202008;11055;27907;7647;21981;1683;5246;2708;7983;4391;13229
317043;202008;859;1928;609;1577;52;136;441;1133;493;1269
317047;202008;1182;2833;815;2240;87;246;507;1340;594;1586
317050;202008;1165;3570;808;2735;108;391;340;1011;448;1402
317052;202008;2377;6631;1912;5871;279;854;1168;3608;1447;4462
317057;202008;1801;4346;1310;3540;34;133;845;2259;879;2392
317060;202008;500;1310;310;926;38;117;130;341;168;458
317065;202008;1170;3414;950;2986;60;197;589;1745;649;1942
317070;202008;7487;20622;5255;16292;988;3442;1540;4516;2528;7958
317075;202008;921;2375;663;1930;109;351;301;797;410;1148
317080;202008;6027;14134;4421;11558;1188;3344;1438;3614;2626;6958
317090;202008;4626;13575;4099;12707;306;908;3029;9450;3335;10358
317100;202008;2683;6365;1695;4720;388;1121;610;1671;998;2792
317103;202008;2182;5830;1849;5316;78;360;1426;3924;1504;4284
317107;202008;1431;3797;1086;3132;79;274;658;1692;737;1966
317110;202008;713;1642;356;1086;54;192;120;382;174;574
317115;202008;1087;3102;922;2794;55;150;621;1888;676;2038
317120;202008;14100;38092;11211;33364;1130;3972;6753;19259;7883;23231
317130;202008;11161;25882;7022;19064;1132;3425;2350;6317;3482;9742
317140;202008;852;2052;654;1758;40;110;442;1228;482;1338
317150;202008;998;2366;745;2050;32;92;584;1586;616;1678
317160;202008;3532;8554;2300;6570;177;548;1268;3703;1445;4251
317170;202008;1830;4535;1321;3672;213;706;546;1313;759;2019
317180;202008;1959;6110;1440;4856;282;1010;367;1158;649;2168
317190;202008;1208;3253;892;2759;107;345;516;1581;623;1926
317200;202008;5277;13789;4014;11594;1034;3220;857;2274;1891;5494
317210;202008;1163;2853;905;2494;27;108;668;1869;695;1977
317220;202008;245;758;207;685;49;165;77;269;126;434
320010;202008;4510;13108;3598;11277;359;1250;2322;7095;2681;8345
320013;202008;1947;5295;1308;4018;212;668;581;1847;793;2515
320016;202008;3002;7683;2337;6661;172;459;1762;5044;1934;5503
320020;202008;3953;10250;2883;8386;632;2030;1013;3054;1645;5084
320030;202008;1750;4855;1128;3600;211;725;397;1215;608;1940
320035;202008;1886;5186;1535;4573;381;1251;654;1899;1035;3150
320040;202008;4023;11393;3305;10059;469;1518;1849;5448;2318;6966
320050;202008;1757;3997;1503;3629;187;543;895;2071;1082;2614
320060;202008;12465;34326;9298;28098;1420;4747;4411;12600;5831;17347
320070;202008;1517;4271;1053;3308;187;650;382;1144;569;1794
320080;202008;5687;14562;3967;11167;823;2453;1440;3837;2263;6290
320090;202008;8532;22647;5576;16506;1228;3880;2014;5554;3242;9434
320100;202008;2988;8160;2425;7170;414;1367;1248;3671;1662;5038
320110;202008;2075;4830;1377;3696;199;555;657;1694;856;2249
320115;202008;1783;5744;1513;5286;641;2365;416;1503;1057;3868
320120;202008;23266;59426;15968;46166;2316;7258;7308;20068;9624;27326
320130;202008;44923;125160;36686;110133;4840;16017;21311;62123;26151;78140
320140;202008;3595;9827;2363;7392;348;1251;937;2902;1285;4153
320150;202008;13473;34883;9477;27133;2403;7587;1627;4155;4030;11742
320160;202008;5944;16597;4349;13487;705;2398;1997;6064;2702;8462
320170;202008;1650;4724;1174;3758;316;992;445;1513;761;2505
320180;202008;688;2184;551;1913;212;780;145;465;357;1245
320190;202008;2773;8852;2116;7378;513;1901;551;1816;1064;3717
320200;202008;1274;3417;857;2644;193;651;322;994;515;1645
320210;202008;4358;11100;3331;9308;530;1619;1764;4715;2294;6334
320220;202008;2781;7343;2089;6196;366;1173;1049;2944;1415;4117
320225;202008;1347;4188;944;3224;337;1250;192;638;529;1888
320230;202008;4999;13769;3778;11695;832;2833;1481;4409;2313;7242
320240;202008;15940;40579;11766;33787;2823;8846;3882;10863;6705;19709
320245;202008;3037;9006;2392;7689;884;2989;452;1427;1336;4416
320250;202008;2299;6432;1537;4629;336;1130;461;1216;797;2346
320255;202008;1802;5665;1543;5189;423;1455;730;2559;1153;4014
320260;202008;1418;3973;840;2681;175;617;205;559;380;1176
320265;202008;2505;7686;2019;6682;918;3247;343;1129;1261;4376
320270;202008;2205;6327;1664;5270;405;1374;626;1998;1031;3372
320280;202008;7060;18825;5658;16387;1225;3807;2568;7167;3793;10974
320290;202008;1368;4066;878;2861;234;835;233;705;467;1540
320300;202008;3608;10954;2859;9397;817;2899;671;2062;1488;4961
320305;202008;5105;14486;3933;12143;751;2519;1902;5673;2653;8192
320310;202008;2123;5882;1447;4432;262;843;644;1885;906;2728
320313;202008;2422;6092;1552;4436;313;1020;402;1048;715;2068
320316;202008;1463;4123;1182;3645;182;577;720;2232;902;2809
320320;202008;22175;58073;15572;46519;3606;11261;5686;17059;9292;28320
320330;202008;2934;7991;2261;6771;430;1289;1178;3592;1608;4881
320332;202008;7012;19027;5530;16372;1328;4234;2467;7220;3795;11454
320334;202008;1765;5022;1225;3902;270;1019;295;732;565;1751
320335;202008;1420;4209;989;3200;234;854;248;729;482;1583
320340;202008;4791;11966;3949;10735;499;1494;2306;6321;2805;7815
320350;202008;5402;13370;3789;10446;468;1388;2002;5233;2470;6621
320360;202008;1436;3638;1057;2920;120;333;532;1408;652;1741
320370;202008;2601;7968;1897;6421;576;2050;603;2013;1179;4063
320380;202008;2534;6792;2096;6072;241;756;1324;3719;1565;4475
320390;202008;7102;19228;5213;15417;1071;3401;2109;5844;3180;9245
320400;202008;3299;9313;2481;7565;701;2270;868;2534;1569;4804
320405;202008;4699;12392;3527;10369;559;1795;1664;4773;2223;6568
320410;202008;4844;12546;3628;10560;646;1834;1804;5474;2450;7308
320420;202008;3283;8585;2482;7215;706;2282;443;1288;1149;3570
320425;202008;2101;5048;1583;4174;100;291;1041;2655;1141;2946
320430;202008;3083;7686;2406;6452;309;908;1540;3984;1849;4892
320435;202008;2160;6730;1701;5819;604;2185;517;1787;1121;3972
320440;202008;1477;4056;1074;3277;161;515;484;1428;645;1943
320450;202008;1636;4717;1268;4016;270;969;569;1678;839;2647
320455;202008;4222;12724;2827;9416;712;2542;687;2058;1399;4600
320460;202008;2130;6252;1493;4893;365;1264;387;1178;752;2442
320465;202008;1262;3574;941;2952;136;439;509;1597;645;2036
320470;202008;3742;10286;2614;7893;590;1880;630;1693;1220;3573
320480;202008;1686;4641;1364;4095;192;655;802;2342;994;2997
320490;202008;21332;55976;15664;45923;2673;8555;6445;18693;9118;27248
320495;202008;1289;3514;877;2713;195;687;322;951;517;1638
320500;202008;52381;139359;41563;120573;5768;18151;23998;66706;29766;84857
320501;202008;4416;12776;3249;10646;901;3297;1064;3433;1965;6730
320503;202008;2416;6872;1539;5039;409;1468;440;1369;849;2837
320506;202008;2631;7795;1882;6138;558;1975;174;565;732;2540
320510;202008;10124;27389;8144;23927;908;3075;5032;14293;5940;17368
320515;202008;1783;4858;1368;4015;369;1182;467;1309;836;2491
320517;202008;2180;6534;1724;5546;541;1903;508;1602;1049;3505
320520;202008;36027;93389;26644;77452;4664;14945;11247;31555;15911;46500
320530;202008;32169;85025;25190;72561;2364;8015;15852;43151;18216;51166
330010;202008;21977;58618;17892;51740;2429;7579;11416;32191;13845;39770
330015;202008;1489;3660;1151;3140;201;618;619;1603;820;2221
330020;202008;20030;49861;16733;45059;2391;7230;11513;30252;13904;37482
330022;202008;1898;5074;1451;4294;249;756;839;2464;1088;3220
330023;202008;5033;11937;3583;9892;594;1815;1979;5331;2573;7146
330025;202008;6870;15900;3953;10966;906;2784;811;2138;1717;4922
330030;202008;10305;27496;7738;23237;842;2916;4714;13516;5556;16432
330040;202008;14657;38100;11532;32754;1097;3510;7692;20960;8789;24470
330045;202008;85192;200455;69528;180532;5324;13754;54925;142076;60249;155830
330050;202008;2485;6588;1807;5427;359;1166;875;2503;1234;3669
330060;202008;5219;13681;4029;11537;782;2491;1677;4419;2459;6910
330070;202008;22663;57285;18099;50573;2858;8503;10633;29489;13491;37992
330080;202008;8850;22312;7497;20381;931;2700;5187;13911;6118;16611
330090;202008;3525;7341;2391;5764;160;411;1636;3942;1796;4353
330093;202008;2737;6544;2040;5551;123;362;1554;4200;1677;4562
330095;202008;1281;3594;980;3026;79;290;601;1724;680;2014
330100;202008;70629;186789;59838;170673;3637;12371;45628;128135;49265;140506
330110;202008;2088;5810;1665;5090;275;924;926;2723;1201;3647
330115;202008;2568;6174;1789;4949;243;773;1013;2688;1256;3461
330120;202008;3554;7946;2635;6755;223;642;1820;4487;2043;5129
330130;202008;4316;11714;3502;10463;481;1515;2182;6470;2663;7985
330140;202008;3789;9787;2982;8615;416;1348;1903;5361;2319;6709
330150;202008;2154;5734;1624;4887;286;907;808;2377;1094;3284
330160;202008;1374;3714;1019;3084;179;584;541;1559;720;2143
330170;202008;108551;268681;86409;238518;11637;31801;57692;161343;69329;193144
330180;202008;1980;4763;1513;4103;99;307;1043;2751;1142;3058
330185;202008;9670;24308;8029;22006;491;1659;6393;17081;6884;18740
330187;202008;4287;10881;3300;9268;466;1416;1917;5337;2383;6753
330190;202008;33604;81188;28197;73681;1952;5526;22291;57518;24243;63044
330200;202008;15920;40333;12830;36502;2517;6824;7969;23370;10486;30194
330205;202008;2126;5216;1591;4350;96;314;1097;2874;1193;3188
330210;202008;3457;8624;2475;6874;360;1100;1212;3119;1572;4219
330220;202008;12037;29792;8365;23596;1740;5505;2949;7681;4689;13186
330225;202008;3973;9925;2985;8400;197;672;2153;5895;2350;6567
330227;202008;17451;41895;14525;38315;591;1729;12407;32365;12998;34094
330230;202008;2140;4613;1368;3643;120;344;807;2164;927;2508
330240;202008;23858;61844;19412;54829;2403;7447;12742;35099;15145;42546
330245;202008;1719;4213;1011;2949;203;598;388;1119;591;1717
330250;202008;38271;97544;31432;87399;5465;15594;19048;52864;24513;68458
330260;202008;4828;11675;3608;10004;349;1100;2513;6732;2862;7832
330270;202008;29544;65185;18020;46878;2924;8146;7363;18491;10287;26637
330280;202008;2370;6211;1767;5177;193;624;1038;2932;1231;3556
330285;202008;24200;57728;18956;50149;1491;4644;13887;35447;15378;40091
330290;202008;3841;9293;3062;8251;327;973;2160;5639;2487;6612
330300;202008;5825;13665;4184;11277;310;956;2915;7705;3225;8661
330310;202008;2712;6645;1901;5282;126;312;1255;3493;1381;3805
330320;202008;16746;39466;12660;34337;1447;3885;9076;24765;10523;28650
330330;202008;38863;84680;29654;72260;2676;7213;21224;50613;23900;57826
330340;202008;15944;38445;11445;31372;1741;5396;5943;15347;7684;20743
330350;202008;139295;320988;113853;289801;7304;19357;93062;235562;100366;254919
330360;202008;7476;18070;6388;16735;207;550;5417;14123;5624;14673
330370;202008;4966;14138;3774;12090;888;2911;1544;5168;2432;8079
330380;202008;5430;14502;4046;12011;697;2390;2001;5659;2698;8049
330385;202008;3958;11345;3197;10209;756;2664;1536;4854;2292;7518
330390;202008;26352;70939;19832;59553;2769;9561;11387;32233;14156;41794
330395;202008;3205;7897;2627;7138;160;505;1900;5052;2060;5557
330400;202008;3390;8868;2855;8016;157;552;2140;5660;2297;6212
330410;202008;3244;8638;2275;6918;436;1459;1004;2896;1440;4355
330411;202008;2787;7519;2136;6284;147;510;1479;4181;1626;4691
330412;202008;1537;4334;1234;3834;131;480;763;2224;894;2704
330414;202008;24143;60342;19420;53854;1571;4568;14368;39390;15939;43958
330415;202008;4228;11479;3248;9773;327;1055;1927;5745;2254;6800
330420;202008;11650;28670;8037;22799;963;3112;4177;11032;5140;14144
330430;202008;9615;23087;7967;20789;328;1087;6226;15743;6554;16830
330440;202008;2521;6749;1876;5648;306;1076;1057;3033;1363;4109
330450;202008;1368;3849;1068;3334;137;464;592;1812;729;2276
330452;202008;17313;43737;13766;38282;1715;5406;8806;23635;10521;29041
330455;202008;559417;1318932;425525;1125542;59959;169224;269672;701210;329631;870434
330460;202008;1188;3230;874;2762;155;527;467;1435;622;1962
330470;202008;4847;12083;3455;9910;1112;3296;1008;2984;2120;6280
330475;202008;9559;24697;7682;22253;1190;3965;4907;13892;6097;17857
330480;202008;5917;15294;4946;13869;410;1279;3428;9344;3838;10623
330490;202008;113066;258801;90799;228828;10044;26439;64845;161842;74889;188281
330500;202008;7383;18159;6118;16415;616;1852;4429;11706;5045;13558
330510;202008;40452;99730;29625;84313;4888;14937;17927;50309;22815;65246
330513;202008;1234;3174;968;2799;207;638;471;1374;678;2012
330515;202008;2490;6544;1968;5801;369;1175;1092;3138;1461;4313
330520;202008;11306;29766;9090;26250;1195;3817;5551;15626;6746;19443
330530;202008;1698;4090;1240;3388;250;747;566;1517;816;2264
330540;202008;2880;7626;2205;6452;509;1549;947;2681;1456;4230
330550;202008;9069;23392;6875;20479;1916;6238;2789;8179;4705;14417
330555;202008;18138;38088;14950;34330;836;2133;12100;28005;12936;30138
330560;202008;4152;11100;3322;9699;506;1519;1972;5611;2478;7130
330570;202008;2730;7469;2280;6771;351;1125;1465;4308;1816;5433
330575;202008;5479;14134;4684;12765;284;885;3745;9875;4029;10760
330580;202008;17473;46496;13373;39025;2415;7651;6430;17927;8845;25578
330590;202008;1453;3923;1193;3588;220;659;737;2255;957;2914
330600;202008;11905;31127;9613;27425;900;3016;6139;16967;7039;19983
330610;202008;9229;24545;7345;21544;576;1990;5103;14581;5679;16571
330615;202008;2105;5707;1623;5040;307;974;995;3155;1302;4129
330620;202008;4022;11465;3130;9904;701;2401;1316;3909;2017;6310
330630;202008;24443;61093;19053;52622;1383;4522;13550;36142;14933;40664
350010;202008;2044;5226;1019;3044;218;704;180;388;398;1092
350020;202008;701;1797;395;1210;48;153;157;441;205;594
350030;202008;3567;9941;2605;8244;650;2251;1063;3196;1713;5447
350040;202008;726;2073;409;1386;54;207;137;360;191;567
350050;202008;1294;3198;833;2390;193;642;272;630;465;1272
350055;202008;918;2393;703;2053;76;243;408;1129;484;1372
350060;202008;190;483;112;325;13;45;52;154;65;199
350070;202008;3429;9027;2139;6665;432;1505;657;1841;1089;3346
350075;202008;589;1721;438;1427;178;611;41;140;219;751
350080;202008;661;1708;419;1270;59;202;172;464;231;666
350090;202008;585;1385;351;973;71;212;149;384;220;596
350100;202008;2330;6144;1591;4821;127;476;980;2783;1107;3259
350110;202008;484;1225;329;947;17;59;191;542;208;601
350115;202008;1278;3701;1042;3199;185;624;538;1500;723;2124
350120;202008;678;1563;368;984;36;113;193;449;229;562
350130;202008;3107;8185;2412;6906;416;1225;1193;3251;1609;4476
350140;202008;774;2183;509;1650;48;212;276;826;324;1038
350150;202008;516;1575;420;1387;93;301;119;362;212;663
350160;202008;11022;27539;7278;20714;928;3000;4369;11758;5297;14758
350170;202008;2220;6342;1760;5327;323;1053;781;2179;1104;3232
350180;202008;1036;2567;521;1560;115;356;86;232;201;588
350190;202008;2863;8080;1948;6122;363;1301;800;2144;1163;3445
350200;202008;454;1282;352;1088;18;62;227;658;245;720
350210;202008;5841;13326;3912;10375;506;1451;2398;6117;2904;7568
350220;202008;2863;7851;1906;5933;417;1371;624;1764;1041;3135
350230;202008;1023;2628;835;2351;156;471;464;1262;620;1733
350240;202008;649;1884;412;1326;87;282;101;304;188;586
350250;202008;2414;6879;1792;5841;611;2187;365;1182;976;3369
350260;202008;840;1982;536;1454;58;179;324;844;382;1023
350270;202008;4493;12088;3543;10258;548;1737;1863;5033;2411;6770
350275;202008;2365;6325;1829;5473;300;1005;1051;2993;1351;3998
350280;202008;19070;42721;11133;29797;1872;5309;4346;11090;6218;16399
350290;202008;3190;8771;2124;6540;376;1272;848;2418;1224;3690
350300;202008;643;1740;471;1411;68;208;242;679;310;887
350310;202008;893;2576;650;2076;113;415;248;715;361;1130
350315;202008;587;1462;383;1118;23;78;197;532;220;610
350320;202008;15062;38566;10908;31166;2331;7357;4055;10721;6386;18078
350330;202008;14094;34626;9866;26465;1068;3171;6174;15521;7242;18692
350335;202008;367;1035;282;876;37;132;133;388;170;520
350340;202008;1165;2984;694;2111;118;405;276;753;394;1158
350350;202008;744;1883;567;1684;71;250;336;979;407;1229
350360;202008;1085;3206;824;2657;219;720;250;820;469;1540
350370;202008;616;1535;420;1177;151;407;125;354;276;761
350380;202008;4391;11989;3065;9301;881;2647;760;2357;1641;5004
350390;202008;10543;27875;8199;23842;1765;5333;3698;10424;5463;15757
350395;202008;437;1127;223;708;20;61;83;239;103;300
350400;202008;8037;19743;5518;15579;1355;4133;1526;4233;2881;8366
350410;202008;9750;27111;6994;21732;1470;5124;2660;7595;4130;12719
350420;202008;724;1945;502;1461;83;271;123;306;206;577
350430;202008;664;1792;532;1578;70;246;319;861;389;1107
350440;202008;2033;5098;1635;4490;127;371;1067;2869;1194;3240
350450;202008;6638;18171;5104;15493;1120;3713;2108;5991;3228;9704
350460;202008;1738;4496;889;2758;158;519;212;592;370;1111
350470;202008;256;646;197;546;11;35;137;365;148;400
350480;202008;998;2493;632;1844;125;445;148;336;273;781
350490;202008;1942;5081;1376;4150;323;1003;408;1135;731;2138
350500;202008;680;1800;512;1487;67;208;255;699;322;907
350510;202008;1166;3030;864;2481;94;304;508;1399;602;1703
350520;202008;2122;6460;1622;5469;266;994;720;2190;986;3184
350530;202008;2782;6951;2030;5544;230;702;1200;3071;1430;3773
350535;202008;1420;3866;1222;3589;170;566;761;2159;931;2725
350540;202008;1923;4595;1414;3832;169;480;883;2310;1052;2790
350550;202008;8376;20626;5761;16299;626;2112;3352;8809;3978;10921
350560;202008;3915;10996;3081;9485;304;999;1903;5662;2207;6661
350570;202008;24260;67613;19370;58058;3654;11998;9723;27917;13377;39915
350580;202008;2097;5660;1213;3762;310;1055;219;552;529;1607
350590;202008;5009;13565;3628;10463;488;1598;2119;5645;2607;7243
350600;202008;36055;83090;22033;58586;3241;9734;10354;25279;13595;35013
350610;202008;6813;18662;4850;14702;850;2818;2238;6393;3088;9211
350620;202008;414;1052;260;816;28;90;148;449;176;539
350630;202008;1451;3770;1053;3052;74;277;682;1846;756;2123
350635;202008;9175;22579;6857;18974;985;2991;4089;10828;5074;13819
350640;202008;925;2472;482;1503;72;230;140;381;212;611
350650;202008;8397;22363;5688;16985;1107;3551;2089;5801;3196;9352
350660;202008;4590;12007;3502;10193;583;1717;1805;5254;2388;6971
350670;202008;1831;4861;1490;4360;155;466;998;2920;1153;3386
350680;202008;1121;3017;739;2309;141;449;293;864;434;1313
350690;202008;1267;3277;884;2634;150;484;472;1359;622;1843
350700;202008;4784;12075;3329;9803;635;2133;1438;3990;2073;6123
350710;202008;2823;7726;2371;6922;406;1372;1293;3487;1699;4859
350715;202008;813;2333;663;2059;71;286;357;1019;428;1305
350720;202008;155;409;111;333;17;49;35;88;52;137
350730;202008;613;1638;513;1463;29;110;382;1023;411;1133
350740;202008;1639;4363;1110;3288;203;646;367;996;570;1642
350745;202008;592;1499;320;972;40;150;123;336;163;486
350750;202008;9795;25426;7358;21203;1297;4325;3314;8533;4611;12858
350760;202008;14688;36525;10499;29256;2233;6871;4273;10725;6506;17596
350770;202008;965;2415;598;1763;38;121;383;1109;421;1230
350775;202008;671;1575;456;1251;46;132;219;598;265;730
350780;202008;2162;5277;1515;4335;255;839;542;1777;797;2616
350790;202008;1733;4624;1080;3397;218;744;317;817;535;1561
350800;202008;3465;9947;2958;9049;250;879;2040;6042;2290;6921
350810;202008;2767;6760;2148;5862;324;851;1176;3278;1500;4129
350820;202008;926;2176;521;1435;53;177;258;636;311;813
350830;202008;867;2419;481;1547;76;242;144;405;220;647
350840;202008;3268;9518;2418;7891;547;1955;1061;3171;1608;5126
350850;202008;7129;19762;5502;16823;1097;3635;2560;7449;3657;11084
350860;202008;3592;9602;3062;8878;116;422;2330;6687;2446;7109
350870;202008;2591;7283;1883;6131;260;952;1036;3280;1296;4232
350880;202008;1315;3757;1021;3174;267;857;281;840;548;1697
350890;202008;528;1362;330;950;50;150;123;330;173;480
350900;202008;7174;19435;4506;13719;1006;3367;1475;4097;2481;7464
350910;202008;907;2221;773;2013;95;261;554;1417;649;1678
350920;202008;11856;29278;9920;26109;436;1416;8037;20353;8473;21769
350925;202008;4306;11723;3043;9408;585;1954;1424;4058;2009;6012
350930;202008;1506;3927;1026;2972;86;253;638;1819;724;2072
350940;202008;2268;5973;1731;5087;182;598;1089;3073;1271;3671
350945;202008;836;2348;618;1920;94;341;324;921;418;1262
350950;202008;86840;223386;66085;184198;8759;26898;40154;106698;48913;133596
350960;202008;6412;17349;4943;14575;594;2017;2945;8218;3539;10235
350970;202008;3600;10094;2569;8100;757;2668;522;1400;1279;4068
350980;202008;642;1770;514;1538;134;420;231;687;365;1107
350990;202008;1751;4884;1275;4098;313;1119;439;1323;752;2442
350995;202008;781;2424;696;2251;52;206;489;1510;541;1716
351000;202008;2847;7389;1967;5799;350;1091;726;2088;1076;3179
351010;202008;332;820;219;623;29;99;116;315;145;414
351015;202008;813;2440;643;2072;102;359;295;854;397;1213
351020;202008;8800;23890;6670;20214;1389;4292;3189;9436;4578;13728
351030;202008;2799;8321;2228;7156;320;1131;1193;3745;1513;4876
351040;202008;4968;12300;4126;11021;215;698;3361;8734;3576;9432
351050;202008;17214;41914;12144;33907;2438;7206;5260;14484;7698;21690
351060;202008;48713;122476;36816;101882;3831;11678;24567;65738;28398;77416
351070;202008;1431;3536;763;2355;184;621;131;392;315;1013
351080;202008;2786;6725;1973;5750;213;737;1306;3620;1519;4357
351090;202008;322;945;228;767;51;175;64;212;115;387
351100;202008;2638;7128;1677;5175;380;1222;471;1513;851;2735
351110;202008;6256;15900;3986;11701;664;2149;1691;4655;2355;6804
351120;202008;787;1980;520;1533;61;195;202;571;263;766
351130;202008;1189;3109;538;1707;101;317;137;415;238;732
351140;202008;2098;5980;1550;4890;314;1107;642;1809;956;2916
351150;202008;2561;7349;1702;5422;290;1014;662;1887;952;2901
351160;202008;1130;3501;835;2802;180;645;215;618;395;1263
351170;202008;1371;3744;1176;3388;94;291;836;2331;930;2622
351190;202008;1005;2786;650;2047;117;375;231;669;348;1044
351200;202008;1623;3880;1195;3235;99;306;841;2142;940;2448
351210;202008;1546;3810;947;2661;79;264;555;1442;634;1706
351220;202008;3261;9206;2767;8382;312;987;1830;5485;2142;6472
351230;202008;1754;4753;1276;3906;225;793;570;1586;795;2379
351240;202008;2427;6209;1461;4166;317;972;540;1365;857;2337
351250;202008;1063;2831;616;1921;84;278;220;676;304;954
351260;202008;925;2333;659;1842;130;368;250;659;380;1027
351270;202008;447;1190;369;1055;37;131;228;568;265;699
351280;202008;3848;10100;2900;8304;538;1573;1369;3786;1907;5359
351290;202008;1244;3060;846;2371;119;363;498;1340;617;1703
351300;202008;17866;48571;12065;37222;2164;7239;5149;15239;7313;22478
351310;202008;3424;8350;2571;7024;182;634;1878;4850;2060;5484
351320;202008;959;2742;709;2210;136;463;249;681;385;1144
351330;202008;488;1154;401;994;24;71;287;641;311;712
351340;202008;6324;18000;5021;15683;1209;3947;2195;6829;3404;10776
351350;202008;11444;28609;9371;25329;1007;2922;6807;17890;7814;20812
351360;202008;3799;10154;3101;9094;749;2355;1209;3273;1958;5628
351370;202008;2062;5755;1368;4296;324;1097;430;1231;754;2328
351380;202008;48372;116886;33838;91266;4342;12583;19282;49669;23624;62252
351385;202008;339;899;154;476;30;90;43;123;73;213
351390;202008;1391;3403;841;2585;123;447;477;1370;600;1817
351400;202008;918;2574;753;2230;123;374;460;1324;583;1698
351410;202008;2585;7217;1825;5716;326;1051;707;2166;1033;3217
351420;202008;415;977;229;648;27;74;137;361;164;435
351430;202008;945;2546;725;2180;57;172;500;1460;557;1632
351440;202008;3428;8987;2207;6472;404;1234;616;1554;1020;2788
351450;202008;1712;4535;1101;3377;223;742;174;411;397;1153
351460;202008;827;2161;633;1842;153;442;335;963;488;1405
351470;202008;1207;3051;923;2573;87;300;598;1563;685;1863
351480;202008;2468;7277;1923;6298;364;1317;811;2483;1175;3800
351490;202008;2002;5626;1693;5065;75;302;1363;3929;1438;4231
351492;202008;352;948;286;806;8;24;214;587;222;611
351495;202008;186;482;136;381;17;43;73;203;90;246
351500;202008;37524;92312;27800;75794;4222;12339;16398;42745;20620;55084
351510;202008;12923;32182;9292;25823;1146;3635;5750;15212;6896;18847
351512;202008;476;1292;334;982;58;168;117;314;175;482
351515;202008;3207;7148;1949;5161;341;1023;563;1570;904;2593
351518;202008;2378;5992;1501;4408;204;673;826;2198;1030;2871
351519;202008;714;1964;434;1406;88;284;66;201;154;485
351520;202008;1270;3137;525;1592;58;197;217;577;275;774
351530;202008;355;936;207;616;29;89;81;185;110;274
351535;202008;1885;4583;1327;3626;206;620;700;1793;906;2413
351540;202008;2445;6086;1628;4643;311;1033;582;1458;893;2491
351550;202008;7047;17421;4660;13052;474;1527;2635;6852;3109;8379
351560;202008;448;1282;342;1068;82;287;104;296;186;583
351565;202008;217;615;173;536;42;150;45;116;87;266
351570;202008;21143;56572;15911;45829;1689;5311;9859;27120;11548;32431
351580;202008;247;637;136;419;12;41;58;185;70;226
351590;202008;511;1151;271;737;21;74;156;387;177;461
351600;202008;1340;3553;1022;2958;94;290;621;1696;715;1986
351610;202008;767;1807;485;1315;25;71;278;711;303;782
351620;202008;23001;60635;16507;49341;2708;9170;7451;20093;10159;29263
351630;202008;27893;73129;22212;63213;3201;9611;13748;37842;16949;47453
351640;202008;17192;45403;13261;38085;1292;4256;8945;24610;10237;28866
351650;202008;374;989;169;549;20;70;50;136;70;206
351660;202008;745;2091;460;1445;86;284;67;168;153;452
351670;202008;5949;15924;3800;11235;812;2395;1622;4511;2434;6906
351680;202008;429;1220;270;865;45;143;67;180;112;323
351685;202008;420;1199;334;1059;90;288;104;307;194;595
351690;202008;1101;2770;616;1805;84;275;259;682;343;957
351700;202008;1364;3382;967;2682;163;468;525;1375;688;1843
351710;202008;749;2016;531;1595;51;175;279;753;330;928
351720;202008;1400;3635;912;2768;145;471;369;1056;514;1527
351730;202008;935;2445;769;2183;56;201;498;1340;554;1541
351740;202008;3551;8902;2748;7357;492;1430;1358;3348;1850;4778
351750;202008;1343;3516;816;2572;154;502;307;944;461;1446
351760;202008;3314;9344;2404;7496;494;1755;878;2457;1372;4212
351770;202008;1741;5167;1412;4524;269;916;730;2272;999;3188
351780;202008;1253;3161;733;2177;106;362;257;722;363;1084
351790;202008;1358;3230;1054;2823;170;466;620;1665;790;2131
351800;202008;525;1211;255;705;23;63;99;236;122;299
351810;202008;1045;2738;846;2428;42;123;609;1663;651;1786
351820;202008;2576;7179;1768;5604;463;1609;406;1182;869;2791
351830;202008;4520;12115;3440;10234;322;1154;2148;6062;2470;7216
351840;202008;8525;23564;6313;19416;913;3134;3264;9377;4177;12511
351850;202008;1568;4233;1011;3149;168;601;344;916;512;1517
351860;202008;2756;7934;2102;6703;359;1221;1120;3622;1479;4843
351870;202008;23652;60412;17465;50201;4455;13246;7056;20614;11511;33860
351880;202008;130510;336150;96649;277286;22013;69785;43874;119352;65887;189137
351885;202008;891;2393;696;2061;66;242;455;1277;521;1519
351890;202008;821;2123;516;1603;115;380;89;223;204;603
351900;202008;1094;2916;843;2541;123;365;472;1421;595;1786
351905;202008;429;1168;301;919;25;86;140;372;165;458
351907;202008;21144;55280;16229;46435;1884;5955;10405;28622;12289;34577
351910;202008;1548;4051;1070;3006;73;225;618;1570;691;1795
351920;202008;868;2293;652;1873;102;338;291;756;393;1094
351925;202008;897;2365;693;1989;84;277;376;994;460;1271
351930;202008;3230;9030;2886;8398;584;1710;1921;5511;2505;7221
351940;202008;1093;2809;777;2247;123;385;385;1097;508;1482
351950;202008;1680;3822;1226;3145;60;181;860;2121;920;2302
351960;202008;5229;13171;3761;10539;831;2499;1679;4368;2510;6867
351970;202008;7170;21224;5635;18498;884;3233;3076;9781;3960;13014
351980;202008;993;2335;622;1730;86;273;356;914;442;1187
351990;202008;1417;3330;1008;2737;54;204;488;1196;542;1400
352000;202008;2593;7359;2220;6591;252;859;1463;4064;1715;4923
352010;202008;2253;6015;1792;5236;463;1486;384;1146;847;2632
352020;202008;1435;3930;1091;3343;167;555;527;1526;694;2081
352030;202008;5791;15226;4449;13003;836;2670;2198;6206;3034;8876
352040;202008;2876;7691;1916;5716;278;922;714;1826;992;2748
352042;202008;2955;7218;1897;5517;377;1240;806;2243;1183;3483
352044;202008;2068;5518;1161;3758;179;656;250;748;429;1404
352050;202008;12387;32948;7907;24008;1988;6901;1507;3819;3495;10720
352060;202008;705;1886;506;1514;74;240;225;618;299;858
352070;202008;912;1837;579;1392;61;157;282;605;343;762
352080;202008;486;1223;282;814;30;104;102;263;132;367
352090;202008;1478;4319;1208;3774;135;498;588;1657;723;2155
352100;202008;3448;9677;2784;8416;598;1979;1218;3538;1816;5517
352110;202008;594;1731;453;1446;94;314;181;535;275;849
352115;202008;498;1355;407;1214;50;178;242;702;292;880
352120;202008;891;2624;729;2293;86;271;432;1266;518;1537
352130;202008;2003;5594;1333;3957;206;644;534;1469;740;2113
352140;202008;1186;3214;828;2510;147;480;393;1143;540;1623
352150;202008;860;2269;655;1916;84;265;449;1276;533;1541
352160;202008;991;2442;706;1990;75;263;398;1066;473;1329
352170;202008;3030;8084;2372;6765;326;1046;1431;3785;1757;4831
352180;202008;2513;6789;1917;5681;453;1511;572;1487;1025;2998
352190;202008;1228;3295;959;2878;175;493;463;1456;638;1949
352200;202008;337;1021;233;808;32;121;86;287;118;408
352210;202008;19564;46189;15256;40482;1012;2990;11796;30728;12808;33718
352215;202008;629;1629;540;1502;66;203;349;941;415;1144
352220;202008;20742;51325;14084;39322;2640;8004;6367;16422;9007;24426
352230;202008;14027;40559;10729;34284;2581;9146;3920;11537;6501;20683
352240;202008;10559;27120;7979;22780;1729;5574;3459;9083;5188;14657
352250;202008;23217;64831;18354;56301;3035;9942;10805;32584;13840;42526
352260;202008;4802;12053;3216;8959;471;1514;1819;4557;2290;6071
352265;202008;915;2527;804;2371;51;176;610;1750;661;1926
352270;202008;1457;4338;1066;3486;231;824;374;1149;605;1973
352280;202008;2464;6219;1854;5321;199;701;1094;2893;1293;3594
352290;202008;1146;3319;916;2862;125;441;494;1399;619;1840
352300;202008;902;2448;595;1790;81;280;314;882;395;1162
352310;202008;44996;119306;33130;98264;8195;24931;14135;42128;22330;67059
352320;202008;6576;17295;5003;14211;768;2474;2659;6806;3427;9280
352330;202008;2216;5860;1651;5059;284;1018;884;2538;1168;3556
352340;202008;5731;15052;4181;12220;651;2167;2124;5727;2775;7894
352350;202008;2147;6093;1657;5003;180;668;902;2442;1082;3110
352360;202008;1243;3304;1014;2907;83;293;762;2099;845;2392
352370;202008;1066;3003;920;2765;21;85;747;2201;768;2286
352380;202008;842;2294;623;1894;126;395;222;635;348;1030
352390;202008;15040;36800;10081;28144;1640;5006;5521;14549;7161;19555
352400;202008;3512;9665;2855;8433;621;2130;1460;3993;2081;6123
352410;202008;3215;8238;2408;6882;220;755;1488;4054;1708;4809
352420;202008;842;2035;593;1670;111;329;223;592;334;921
352430;202008;7924;19666;5622;15625;1184;3731;2603;6814;3787;10545
352440;202008;17882;48288;13165;39140;3196;9849;4910;14213;8106;24062
352450;202008;780;1911;389;1230;54;191;133;397;187;588
352460;202008;2968;8220;2026;6463;408;1434;796;2380;1204;3814
352470;202008;3394;8523;2538;7138;296;941;1519;4039;1815;4980
352480;202008;3983;9416;2618;6974;415;1273;1290;3082;1705;4355
352490;202008;733;2102;582;1829;98;330;286;852;384;1182
352500;202008;10311;26563;6897;20141;2913;9370;749;1229;3662;10599
352510;202008;3717;10005;2759;8328;571;1872;1286;3692;1857;5564
352520;202008;2828;7398;2180;6293;397;1295;1227;3216;1624;4511
352530;202008;10240;26504;6698;19629;1189;4005;2158;5367;3347;9372
352540;202008;568;1674;408;1309;65;237;137;387;202;624
352550;202008;1004;2794;696;2198;134;465;233;661;367;1126
352560;202008;580;1606;436;1320;80;255;202;571;282;826
352570;202008;2262;6472;1389;4529;332;1171;127;338;459;1509
352580;202008;665;1718;549;1516;48;159;373;979;421;1138
352585;202008;321;855;229;691;17;67;139;383;156;450
352590;202008;13247;34779;9187;26984;2371;7606;4001;10910;6372;18516
352600;202008;1965;5260;1517;4421;155;485;945;2612;1100;3097
352610;202008;2912;8162;2177;6867;435;1556;887;2623;1322;4179
352620;202008;5621;14411;4264;12441;1237;3703;1627;4781;2864;8484
352630;202008;819;2034;603;1708;110;358;278;717;388;1075
352640;202008;2994;7706;2124;6145;211;650;1220;3382;1431;4032
352650;202008;603;1695;414;1284;58;210;150;440;208;650
352660;202008;1086;3159;883;2746;110;353;499;1517;609;1870
352670;202008;9719;26046;6301;19202;1576;5159;1530;4362;3106;9521
352680;202008;3270;9709;2257;7378;354;1399;1117;3280;1471;4679
352690;202008;27082;67851;20836;57137;1365;4460;14693;38584;16058;43044
352700;202008;574;1421;420;1208;152;498;94;259;246;757
352710;202008;5177;13318;3636;10497;848;2688;1516;4019;2364;6707
352720;202008;7774;21209;5991;17846;2478;7534;1289;3593;3767;11127
352725;202008;598;1429;330;942;21;54;161;437;182;491
352730;202008;5000;14512;4469;13250;523;1689;2137;5605;2660;7294
352740;202008;2315;5439;1698;4525;173;545;1043;2603;1216;3148
352750;202008;412;1016;243;712;38;122;102;258;140;380
352760;202008;1668;4614;1275;3827;107;307;729;2208;836;2515
352770;202008;870;2340;581;1775;120;380;229;669;349;1049
352780;202008;616;1749;434;1390;90;279;121;383;211;662
352790;202008;446;1188;306;903;34;113;116;308;150;421
352800;202008;1258;3895;875;2974;240;845;111;330;351;1175
352810;202008;1157;2733;720;1956;95;278;442;1128;537;1406
352820;202008;508;1406;356;1143;77;246;74;248;151;494
352830;202008;581;1467;259;789;22;69;59;145;81;214
352840;202008;4000;11402;3263;10079;1091;3598;1083;3249;2174;6847
352850;202008;10838;26401;7281;20583;1935;5973;2320;5899;4255;11872
352860;202008;1010;2787;738;2279;139;465;282;826;421;1291
352870;202008;863;2148;607;1625;38;127;405;1022;443;1149
352880;202008;1743;4113;1220;3195;181;493;709;1776;890;2269
352885;202008;297;822;218;680;22;78;130;384;152;462
352890;202008;701;1675;435;1122;41;118;261;602;302;720
352900;202008;17831;46480;11649;34211;1939;6071;5141;14183;7080;20254
352910;202008;434;1156;231;721;24;84;68;187;92;271
352920;202008;2655;6781;1909;5491;138;431;1299;3630;1437;4061
352930;202008;5803;15655;4267;12651;773;2529;2002;5492;2775;8021
352940;202008;22135;60355;15834;47009;3270;10657;6573;18343;9843;29000
352950;202008;534;1418;320;1021;91;289;61;178;152;467
352960;202008;743;1969;409;1258;68;227;118;314;186;541
352965;202008;235;661;146;480;45;144;34;102;79;246
352970;202008;2961;7073;2236;5877;240;676;1460;3783;1700;4459
352980;202008;1370;3642;1081;3202;261;842;545;1568;806;2410
352990;202008;4060;11428;3156;9924;640;2218;1548;4659;2188;6877
353000;202008;471;1297;254;792;38;123;57;148;95;271
353010;202008;2599;6356;1702;4768;344;1111;710;1796;1054;2907
353020;202008;3640;9337;2077;6065;296;966;706;1914;1002;2880
353030;202008;4526;11415;3082;8866;695;2187;885;2418;1580;4605
353040;202008;629;1447;442;1172;74;198;242;612;316;810
353050;202008;5149;14733;3609;11569;701;2443;1621;4957;2322;7400
353060;202008;48467;123448;39631;109299;2757;9155;29601;78756;32358;87911
353070;202008;9353;26718;6704;21054;1301;4483;2728;7916;4029;12399
353080;202008;4038;11197;2688;8569;513;1850;1037;2908;1550;4758
353090;202008;584;1736;443;1439;31;110;287;899;318;1009
353100;202008;307;827;137;438;28;97;38;95;66;192
353110;202008;7569;20282;6086;18119;1231;3759;3210;9847;4441;13606
353120;202008;400;990;291;811;41;137;134;328;175;465
353130;202008;2434;5700;1529;4206;390;1194;514;1274;904;2468
353140;202008;2718;6723;1939;5378;113;371;1356;3596;1469;3967
353150;202008;1552;3792;1083;3014;204;584;480;1267;684;1851
353160;202008;597;1549;426;1261;74;227;177;479;251;706
353170;202008;534;1434;400;1244;84;290;172;523;256;813
353180;202008;9785;23957;7610;20425;672;2000;5671;14787;6343;16787
353190;202008;3231;8741;2561;7399;316;981;1543;4194;1859;5175
353200;202008;1917;5052;980;3096;161;565;241;682;402;1247
353205;202008;361;1096;309;983;53;177;154;472;207;649
353210;202008;928;2145;580;1571;29;91;382;1013;411;1104
353215;202008;388;1074;300;909;44;145;145;402;189;547
353220;202008;739;2011;457;1408;96;292;63;184;159;476
353230;202008;830;2283;641;1979;180;611;248;706;428;1317
353240;202008;2331;6310;1884;5561;267;907;1102;3114;1369;4021
353250;202008;1283;2864;776;2017;102;305;439;1065;541;1370
353260;202008;1191;2723;645;1828;94;302;302;807;396;1109
353270;202008;684;1762;571;1559;50;158;392;1007;442;1165
353280;202008;702;1904;488;1506;126;390;127;379;253;769
353282;202008;1793;5012;1494;4457;155;529;945;2655;1100;3184
353284;202008;362;835;185;500;21;78;83;190;104;268
353286;202008;171;432;103;321;13;40;34;100;47;140
353290;202008;1477;3922;910;2761;149;451;298;825;447;1276
353300;202008;1923;5129;1389;4085;225;750;623;1640;848;2390
353310;202008;393;952;280;743;19;67;191;475;210;542
353320;202008;660;1612;545;1447;9;39;474;1243;483;1282
353325;202008;675;1961;463;1498;97;304;170;529;267;833
353330;202008;538;1375;364;1045;44;131;201;541;245;672
353340;202008;2850;7683;1964;5942;405;1363;872;2457;1277;3820
353350;202008;3559;9066;2424;6820;532;1628;712;1744;1244;3372
353360;202008;634;1775;485;1488;57;180;282;847;339;1027
353370;202008;565;1632;468;1480;35;114;330;1010;365;1124
353380;202008;279;847;229;746;24;85;124;368;148;453
353390;202008;6217;15334;4633;12671;499;1550;2705;6969;3204;8519
353400;202008;436;1184;324;969;55;195;123;306;178;501
353410;202008;529;1426;397;1190;72;218;224;677;296;895
353420;202008;424;1110;244;711;60;164;19;43;79;207
353430;202008;2225;6135;1675;5117;367;1224;728;2093;1095;3317
353440;202008;64305;173733;45998;138127;7568;24715;24272;69034;31840;93749
353450;202008;373;941;250;726;35;121;118;309;153;430
353460;202008;3228;8735;2271;6868;165;574;1044;3038;1209;3612
353470;202008;7696;20183;5437;15992;894;3030;2364;6331;3258;9361
353475;202008;1514;3924;1041;2945;159;492;516;1349;675;1841
353480;202008;1602;4304;1266;3708;62;227;884;2502;946;2729
353490;202008;1101;2898;724;2166;106;352;325;914;431;1266
353500;202008;1047;2453;773;2043;162;434;427;1125;589;1559
353510;202008;771;2322;554;1788;138;494;141;379;279;873
353520;202008;1067;2798;669;2064;83;284;308;881;391;1165
353530;202008;2412;6381;1867;5394;258;844;989;2652;1247;3496
353540;202008;2041;5464;1649;4844;259;789;978;2823;1237;3612
353550;202008;5804;14848;4628;12961;760;2233;2625;7099;3385;9332
353560;202008;2240;6044;1645;5109;456;1547;462;1286;918;2833
353570;202008;592;1536;438;1288;48;152;258;710;306;862
353580;202008;2112;5547;1572;4495;333;964;748;2085;1081;3049
353590;202008;706;1847;459;1370;92;291;189;559;281;850
353600;202008;1723;4228;1282;3453;159;433;711;1863;870;2296
353610;202008;560;1666;398;1345;87;356;117;354;204;710
353620;202008;2642;7066;1847;5678;368;1261;599;1684;967;2945
353625;202008;500;1238;331;938;22;75;208;575;230;650
353630;202008;1285;3967;1066;3473;236;861;374;1110;610;1971
353640;202008;1388;3540;1099;3101;149;436;622;1745;771;2181
353650;202008;7850;20887;5806;16989;608;2009;3510;9648;4118;11657
353657;202008;392;1013;277;815;30;95;130;355;160;450
353660;202008;1268;2697;859;2150;388;979;192;461;580;1440
353670;202008;4066;11272;3115;9387;612;2078;1522;4254;2134;6332
353680;202008;694;1795;505;1517;81;267;278;788;359;1055
353690;202008;434;1120;190;588;22;67;38;103;60;170
353700;202008;2045;5326;1668;4691;121;387;1226;3315;1347;3702
353710;202008;5270;11754;3096;7884;321;852;1791;4092;2112;4944
353715;202008;429;1133;254;798;10;41;83;243;93;284
353720;202008;1990;5258;1527;4566;213;706;885;2593;1098;3299
353730;202008;4424;11593;3281;9526;492;1651;1658;4392;2150;6043
353740;202008;2013;5314;1387;4202;342;1126;454;1229;796;2355
353750;202008;835;2494;582;1992;140;521;109;371;249;892
353760;202008;12427;29012;9358;24809;1808;4921;5115;13295;6923;18216
353770;202008;731;2179;414;1390;72;265;59;172;131;437
353780;202008;5137;14378;4018;12195;806;2749;1934;5406;2740;8155
353790;202008;2534;7709;1830;6212;523;1983;386;1130;909;3113
353800;202008;18025;47048;13885;40293;1992;6168;7753;22417;9745;28585
353810;202008;1152;3079;729;2186;111;373;303;861;414;1234
353820;202008;1732;4665;1194;3569;252;818;384;1074;636;1892
353830;202008;620;1571;455;1296;81;239;198;536;279;775
353850;202008;1621;4501;1232;3742;266;800;441;1317;707;2117
353860;202008;2602;7180;1968;6057;477;1663;860;2398;1337;4061
353870;202008;29311;76927;20495;59518;2673;8784;10735;28345;13408;37129
353880;202008;3135;8613;2467;7329;199;688;1538;4389;1737;5077
353890;202008;2627;5689;1745;4458;132;367;1218;2948;1350;3315
353900;202008;750;2093;531;1653;81;279;210;602;291;881
353910;202008;2311;6389;1900;5729;198;705;1296;3827;1494;4532
353920;202008;1815;5034;1270;3966;298;1056;326;833;624;1889
353930;202008;4259;11321;2876;8749;504;1760;1183;3158;1687;4918
353940;202008;1072;3033;718;2323;127;424;246;738;373;1162
353950;202008;3198;8680;2434;7270;438;1433;1355;3761;1793;5194
353960;202008;703;1840;469;1388;92;296;195;546;287;842
353970;202008;663;1597;488;1331;46;141;327;868;373;1009
353980;202008;16347;41287;12636;34688;857;2726;9056;23791;9913;26517
353990;202008;891;2173;522;1497;86;264;238;652;324;916
354000;202008;2472;5967;1357;3831;304;901;236;641;540;1542
354010;202008;357;931;253;761;46;150;138;400;184;550
354020;202008;3460;9523;2682;7899;669;2121;1086;2921;1755;5042
354025;202008;723;2006;468;1484;66;236;126;377;192;613
354030;202008;484;1061;250;669;51;149;122;306;173;455
354040;202008;805;1868;509;1379;22;72;379;993;401;1065
354050;202008;944;2629;638;2071;145;494;202;652;347;1146
354060;202008;3316;9398;2263;7175;516;1758;821;2387;1337;4145
354070;202008;3613;9570;2430;7242;427;1461;1013;2581;1440;4042
354075;202008;2611;7588;2005;6443;255;932;1137;3554;1392;4486
354080;202008;1363;3713;886;2769;191;632;221;620;412;1252
354085;202008;428;891;331;762;0;0;249;528;249;528
354090;202008;1635;4577;1392;4058;79;247;1083;3083;1162;3330
354100;202008;19290;52529;13082;41576;2875;9856;4983;15693;7858;25549
354105;202008;1486;3749;1000;2851;129;377;463;1241;592;1618
354110;202008;472;1310;320;1026;46;153;114;368;160;521
354120;202008;1381;3717;911;2708;185;602;308;798;493;1400
354130;202008;5422;14260;3542;10637;898;2881;214;421;1112;3302
354140;202008;19275;47261;12845;35361;2211;6728;5492;13939;7703;20667
354150;202008;3016;7148;2232;5893;493;1332;884;2278;1377;3610
354160;202008;2904;8415;2119;6811;610;2110;587;1715;1197;3825
354165;202008;649;1926;492;1615;83;313;252;781;335;1094
354170;202008;1799;4968;1494;4384;86;292;969;2712;1055;3004
354180;202008;388;1077;276;836;51;163;109;296;160;459
354190;202008;1483;4145;1026;3197;66;229;473;1408;539;1637
354200;202008;868;2120;671;1822;70;212;435;1118;505;1330
354210;202008;789;2074;625;1792;39;140;459;1239;498;1379
354220;202008;3128;8362;2299;6706;377;1172;1177;3269;1554;4441
354230;202008;758;1875;598;1677;43;155;438;1180;481;1335
354240;202008;1638;4555;1092;3442;187;644;326;911;513;1555
354250;202008;552;1324;340;993;96;285;82;254;178;539
354260;202008;8088;21492;6062;17908;1254;3945;2493;7101;3747;11046
354270;202008;1031;3077;823;2671;186;577;321;1015;507;1592
354280;202008;790;1981;670;1805;60;196;424;1051;484;1247
354290;202008;926;2933;773;2607;131;435;390;1339;521;1774
354300;202008;3573;10479;3017;9444;835;2605;1156;3603;1991;6208
354310;202008;719;2119;582;1835;135;447;221;650;356;1097
354320;202008;988;2400;628;1771;103;327;237;589;340;916
354323;202008;458;1112;303;828;37;79;130;347;167;426
354325;202008;1383;4117;961;3155;150;485;360;1143;510;1628
354330;202008;9514;24111;6266;17430;745;2412;3684;9510;4429;11922
354340;202008;32042;80455;21331;61599;3394;11015;10876;29889;14270;40904
354350;202008;1185;3055;937;2627;88;269;636;1707;724;1976
354360;202008;597;1535;343;1104;68;228;73;232;141;460
354370;202008;995;2866;787;2519;129;448;451;1422;580;1870
354380;202008;711;1881;508;1542;90;354;128;305;218;659
354390;202008;13662;33125;8734;24398;1648;4892;3571;9470;5219;14362
354400;202008;1549;4952;1162;4035;195;742;431;1467;626;2209
354410;202008;5811;15724;4355;12773;902;2863;1960;5438;2862;8301
354420;202008;1476;3865;1069;3120;140;439;655;1817;795;2256
354425;202008;2696;6543;1893;5148;434;1188;826;2233;1260;3421
354430;202008;1499;4010;1145;3434;126;440;672;1885;798;2325
354440;202008;551;1474;358;1075;57;191;157;431;214;622
354450;202008;419;1107;229;740;35;114;72;211;107;325
354460;202008;872;2192;567;1646;74;230;313;879;387;1109
354470;202008;474;1209;312;886;20;64;155;390;175;454
354480;202008;1210;2745;778;2049;69;187;524;1316;593;1503
354490;202008;818;2422;587;1907;94;330;271;823;365;1153
354500;202008;2078;5836;1696;5240;519;1703;406;1278;925;2981
354510;202008;728;2030;571;1718;54;176;311;844;365;1020
354515;202008;334;967;246;783;40;146;102;312;142;458
354520;202008;6976;19112;4835;14450;701;2412;2666;7377;3367;9789
354530;202008;4236;12088;3217;10041;760;2415;1242;3899;2002;6314
354540;202008;1318;3479;944;2807;219;686;358;1064;577;1750
354550;202008;570;1484;444;1243;65;206;253;665;318;871
354560;202008;2178;5262;1162;3293;140;400;575;1524;715;1924
354570;202008;1212;3039;484;1382;77;227;60;170;137;397
354580;202008;8772;22969;5589;16895;853;2813;2771;8036;3624;10849
354600;202008;1890;5032;1437;4173;156;532;937;2564;1093;3096
354610;202008;439;1133;244;731;25;74;115;327;140;401
354620;202008;443;1241;272;900;51;195;99;296;150;491
354625;202008;311;838;168;542;31;102;23;47;54;149
354630;202008;2008;5994;1598;5135;567;1913;280;819;847;2732
354640;202008;3219;9232;2342;7455;407;1411;857;2528;1264;3939
354650;202008;881;2294;698;1990;56;157;431;1212;487;1369
354660;202008;3698;8614;1898;5569;174;627;906;2415;1080;3042
354670;202008;1069;2986;725;2277;154;514;262;748;416;1262
354680;202008;5274;13794;3943;11589;910;2801;1947;5824;2857;8625
354690;202008;504;1607;359;1277;77;285;97;336;174;621
354700;202008;863;2312;611;1820;84;265;299;846;383;1111
354710;202008;472;1271;339;1008;41;131;139;353;180;484
354720;202008;283;687;125;372;41;129;28;82;69;211
354730;202008;9809;27558;7297;22679;1040;3543;4093;12227;5133;15770
354740;202008;316;853;126;415;17;66;21;58;38;124
354750;202008;2573;6609;1637;4830;262;842;737;1962;999;2804
354760;202008;2077;5575;1427;4310;346;1149;452;1209;798;2358
354765;202008;380;1016;145;474;23;79;30;84;53;163
354770;202008;2339;5797;1705;4709;324;987;799;2057;1123;3044
354780;202008;54212;137605;40554;110461;4433;13655;25322;64618;29755;78273
354790;202008;960;2647;739;2277;80;273;446;1313;526;1586
354800;202008;2586;6634;2012;5752;500;1462;869;2331;1369;3793
354805;202008;1333;3056;894;2408;99;268;530;1327;629;1595
354810;202008;651;1911;366;1294;45;188;82;270;127;458
354820;202008;957;2725;675;2172;114;411;197;508;311;919
354830;202008;451;1112;282;803;55;168;96;257;151;425
354840;202008;935;2306;555;1542;51;153;319;827;370;980
354850;202008;21395;55527;14623;43166;1669;5695;8669;24198;10338;29893
354860;202008;1744;4931;1046;3398;176;628;305;899;481;1527
354870;202008;57471;145187;43921;119858;4807;14485;27300;70370;32107;84855
354880;202008;5891;14559;2797;7907;321;1053;1097;2520;1418;3573
354890;202008;16416;40893;12596;34418;1718;5311;7469;19690;9187;25001
354900;202008;405;1010;250;733;41;132;71;181;112;313
354910;202008;5492;14365;3266;10301;741;2468;554;1671;1295;4139
354920;202008;491;1323;235;802;29;115;50;171;79;286
354925;202008;293;838;171;555;21;75;41;111;62;186
354930;202008;403;948;235;663;17;55;119;309;136;364
354940;202008;2304;6910;1608;5338;550;1955;290;878;840;2833
354950;202008;1489;3829;1179;3394;62;251;872;2362;934;2613
354960;202008;917;2445;689;2096;53;193;400;1147;453;1340
354970;202008;4212;11719;3252;10050;360;1260;2088;6245;2448;7505
354980;202008;33181;78382;21998;59041;2375;7643;13392;33320;15767;40963
354990;202008;66077;166750;49045;135445;4097;13152;31958;83042;36055;96194
354995;202008;2831;6420;2123;5476;149;457;1575;3886;1724;4343
355000;202008;1580;3941;1180;3362;185;621;570;1488;755;2109
355010;202008;3794;10301;2235;6958;747;2401;241;780;988;3181
355020;202008;3644;10225;2658;8455;611;2130;981;2927;1592;5057
355030;202008;1375518;3373021;976842;2593783;149315;435446;487080;1190555;636395;1626001
355040;202008;2895;7232;2241;6363;323;917;1539;4393;1862;5310
355050;202008;979;2303;700;1885;175;522;270;662;445;1184
355060;202008;6087;16485;4373;13220;726;2545;2115;5798;2841;8343
355070;202008;8985;23165;7163;20207;846;2749;4570;12126;5416;14875
355080;202008;919;2616;559;1917;110;412;77;211;187;623
355090;202008;1110;3202;829;2703;214;696;256;852;470;1548
355100;202008;22481;58804;17168;50777;2801;8758;10156;29741;12957;38499
355110;202008;832;2341;596;1956;180;666;107;319;287;985
355120;202008;697;1826;492;1522;37;132;213;618;250;750
355130;202008;878;1957;417;1110;28;87;244;609;272;696
355140;202008;1913;4353;1600;3915;98;285;1316;3116;1414;3401
355150;202008;4255;11261;3343;9628;398;1280;2097;5789;2495;7069
355160;202008;2014;5521;1438;4462;365;1233;342;1005;707;2238
355170;202008;10278;26046;7933;22066;1503;4550;4218;11313;5721;15863
355180;202008;2795;7527;1956;6092;414;1424;702;1997;1116;3421
355190;202008;1852;4853;1440;4204;347;1005;757;2345;1104;3350
355200;202008;822;2534;686;2309;183;680;282;901;465;1581
355210;202008;2888;7892;2238;6549;425;1417;1134;3097;1559;4514
355220;202008;44201;117572;34367;98441;8102;24715;14006;37105;22108;61820
355230;202008;1154;2889;621;1828;109;302;218;602;327;904
355240;202008;23817;62896;16349;47817;2242;7124;8732;24057;10974;31181
355250;202008;37539;100516;27261;80264;6829;21221;10111;28331;16940;49552
355255;202008;693;1740;359;1107;59;205;138;407;197;612
355260;202008;1449;3578;1037;2877;138;466;592;1504;730;1970
355270;202008;1186;3518;904;2924;210;702;304;903;514;1605
355280;202008;30703;78700;21464;60932;3040;9364;10531;28060;13571;37424
355290;202008;865;2389;645;1975;136;401;262;775;398;1176
355300;202008;1286;3761;985;3123;182;653;340;1005;522;1658
355310;202008;969;2688;729;2284;101;309;396;1256;497;1565
355320;202008;536;1413;395;1153;77;258;158;374;235;632
355330;202008;2840;7191;2131;5975;142;522;1602;4262;1744;4784
355340;202008;4065;8978;3110;7701;400;890;1916;4860;2316;5750
355350;202008;1304;3775;959;3103;205;685;340;1090;545;1775
355360;202008;1167;2987;891;2578;120;379;533;1523;653;1902
355365;202008;362;958;187;640;40;125;31;110;71;235
355370;202008;5362;13696;4094;11688;978;2609;1804;5662;2782;8271
355380;202008;2859;7662;2125;6267;391;1245;764;1961;1155;3206
355385;202008;1454;3825;1182;3417;114;402;746;1974;860;2376
355390;202008;834;2277;591;1734;138;438;228;605;366;1043
355395;202008;1993;5450;1361;4148;232;760;490;1328;722;2088
355400;202008;9039;26008;7082;22071;1745;6191;2492;6938;4237;13129
355410;202008;22350;61129;13683;43378;2911;10200;3475;10777;6386;20977
355420;202008;628;2014;507;1772;149;566;121;413;270;979
355430;202008;3768;9601;2807;7839;654;1789;1269;3522;1923;5311
355440;202008;793;2163;473;1480;85;280;138;401;223;681
355450;202008;3082;7982;1955;5721;357;1124;802;2119;1159;3243
355460;202008;494;1206;308;900;45;170;139;360;184;530
355465;202008;414;1092;319;934;50;159;164;462;214;621
355470;202008;1078;2778;605;1833;165;563;190;511;355;1074
355475;202008;353;838;280;731;17;37;205;522;222;559
355480;202008;3794;10508;3081;9444;421;1494;2031;6050;2452;7544
355490;202008;953;2561;513;1593;38;132;277;791;315;923
355495;202008;800;2275;576;1856;71;266;211;611;282;877
355500;202008;6593;17108;3809;11523;590;1975;1271;3544;1861;5519
355510;202008;1316;3204;813;2340;112;381;354;902;466;1283
355520;202008;371;824;167;491;30;84;49;137;79;221
355530;202008;406;945;143;427;19;69;50;131;69;200
355535;202008;504;1388;377;1175;76;297;170;472;246;769
355540;202008;10653;26754;8642;23851;1334;4004;5550;14820;6884;18824
355550;202008;620;1836;503;1618;68;247;270;814;338;1061
355560;202008;1113;2860;593;1849;130;459;37;116;167;575
355570;202008;248;710;136;445;25;84;32;103;57;187
355580;202008;1206;2947;780;2224;142;446;318;847;460;1293
355590;202008;170;425;130;358;19;57;79;207;98;264
355600;202008;1482;3594;982;2758;180;543;396;1089;576;1632
355610;202008;1745;4310;1149;3271;132;418;611;1656;743;2074
355620;202008;4703;12515;3470;10097;394;1391;1945;5206;2339;6597
355630;202008;2289;6310;1577;4941;259;847;773;2387;1032;3234
355635;202008;881;2575;642;2102;118;429;189;551;307;980
355640;202008;2962;8286;1942;6204;379;1307;584;1793;963;3100
355645;202008;4221;11874;3053;9809;451;1566;1628;5126;2079;6692
355650;202008;6597;17780;5123;15035;1401;4274;1695;4484;3096;8758
355660;202008;1311;3390;895;2616;139;453;307;889;446;1342
355670;202008;3520;9443;2271;6650;293;1004;1128;2883;1421;3887
355680;202008;2759;7580;1181;3873;314;1082;125;433;439;1515
355690;202008;795;2359;503;1750;115;436;19;45;134;481
355695;202008;243;684;141;457;13;62;25;55;38;117
355700;202008;7219;20732;5809;17550;1001;3197;3081;8817;4082;12014
355710;202008;8828;20864;5642;15000;860;2546;2605;6155;3465;8701
355715;202008;483;1288;251;765;52;174;51;136;103;310
355720;202008;1482;4155;1160;3572;190;628;622;1784;812;2412
355730;202008;911;2528;737;2194;135;442;332;896;467;1338
410010;202008;1231;3438;920;2767;190;619;191;564;381;1183
410020;202008;1014;3101;782;2553;278;855;173;598;451;1453
410030;202008;1510;4177;1275;3804;170;569;701;2083;871;2652
410040;202008;12325;34085;8929;27665;1954;6454;2813;8105;4767;14559
410045;202008;875;2313;609;1815;84;284;223;621;307;905
410050;202008;2371;5927;1587;4540;305;951;516;1387;821;2338
410060;202008;2067;5855;1586;4872;358;1178;502;1487;860;2665
410070;202008;1927;4889;1405;3922;232;722;554;1412;786;2134
410080;202008;1360;3648;955;2889;219;689;300;917;519;1606
410090;202008;1095;2803;932;2540;94;246;555;1586;649;1832
410100;202008;1831;5305;1197;3751;174;622;156;468;330;1090
410105;202008;488;1228;276;819;35;109;90;250;125;359
410110;202008;3186;8039;2205;6143;281;848;1004;2618;1285;3466
410115;202008;596;1531;431;1242;58;186;167;455;225;641
410120;202008;2568;7301;2231;6757;493;1652;1135;3298;1628;4950
410130;202008;1221;3306;1055;2990;197;653;537;1401;734;2054
410140;202008;16115;38954;10210;28288;1870;5693;2678;6701;4548;12394
410150;202008;16736;39357;8265;22690;1403;4264;1968;4884;3371;9148
410160;202008;2828;7847;2248;6821;511;1692;780;2369;1291;4061
410165;202008;736;1959;600;1682;55;187;358;928;413;1115
410170;202008;2749;7140;1789;5075;409;1268;129;376;538;1644
410180;202008;14590;40600;11070;33335;1509;4960;5828;16392;7337;21352
410185;202008;445;1289;309;948;57;185;92;256;149;441
410190;202008;2214;5498;1575;4357;330;937;418;1106;748;2043
410200;202008;5365;12399;2922;8121;467;1503;444;1179;911;2682
410210;202008;3069;7720;1886;5533;298;997;646;1615;944;2612
410220;202008;521;1344;331;981;57;183;81;233;138;416
410230;202008;1685;4499;1277;3663;175;579;665;1753;840;2332
410240;202008;4982;13195;3395;10104;819;2696;325;871;1144;3567
410250;202008;2668;6328;1955;5162;154;508;953;2436;1107;2944
410260;202008;1857;4649;1136;3272;191;567;494;1397;685;1964
410270;202008;460;1223;328;992;49;164;120;351;169;515
410275;202008;661;1859;454;1422;64;214;193;563;257;777
410280;202008;2281;6123;1484;4500;233;777;580;1622;813;2399
410290;202008;3277;9202;2212;6896;595;1841;579;1798;1174;3639
410300;202008;640;1628;501;1398;42;130;256;674;298;804
410302;202008;380;945;199;600;25;85;96;281;121;366
410304;202008;1240;3219;1032;2833;112;301;618;1655;730;1956
410305;202008;1775;4221;1202;3386;133;422;744;2014;877;2436
410310;202008;2502;7118;1969;6066;338;1133;908;2787;1246;3920
410315;202008;675;1617;355;1095;127;390;81;258;208;648
410320;202008;1059;2937;712;2212;116;407;125;367;241;774
410322;202008;580;1517;318;933;32;105;165;448;197;553
410330;202008;1513;3694;1030;2776;173;503;292;780;465;1283
410335;202008;839;2275;645;1906;97;310;286;784;383;1094
410337;202008;854;2073;594;1562;71;194;250;624;321;818
410340;202008;502;1409;339;1004;31;104;170;428;201;532
410345;202008;2432;6297;1226;3630;253;786;332;864;585;1650
410347;202008;744;1899;541;1525;46;153;179;510;225;663
410350;202008;1446;3651;1031;2936;143;422;425;1150;568;1572
410360;202008;4331;10566;3310;8788;387;1124;1808;4611;2195;5735
410370;202008;13306;35892;8551;24518;1018;3213;3620;9170;4638;12383
410380;202008;1577;3993;1155;3218;164;466;388;996;552;1462
410390;202008;2628;6706;1713;5018;387;1264;525;1400;912;2664
410395;202008;907;2602;737;2240;145;468;295;896;440;1364
410400;202008;6469;17044;4774;13687;710;2167;2327;6280;3037;8447
410405;202008;831;2011;612;1686;110;345;269;687;379;1032
410410;202008;1252;3370;1168;3235;166;539;730;2093;896;2632
410420;202008;10149;27948;7663;22965;1231;4163;3048;8166;4279;12329
410425;202008;3207;8990;2155;6782;362;1228;786;2238;1148;3466
410430;202008;13085;32819;9015;25294;1421;4378;3175;8320;4596;12698
410440;202008;2286;6838;1944;6188;292;1044;1021;3191;1313;4235
410442;202008;2212;6726;1836;5904;530;1778;579;1770;1109;3548
410445;202008;2262;6577;1643;5353;317;1183;368;1268;685;2451
410450;202008;1430;3580;1050;2960;202;633;381;1006;583;1639
410460;202008;1997;4953;1530;4209;166;461;761;2027;927;2488
410465;202008;2681;7765;2088;6618;387;1294;746;2203;1133;3497
410470;202008;2022;5619;1413;4465;361;1316;221;743;582;2059
410480;202008;36979;87702;19268;56014;3075;10051;4173;10386;7248;20437
410490;202008;11014;30672;7799;23927;1445;4811;3048;8786;4493;13597
410500;202008;1858;4886;1290;3771;276;916;374;969;650;1885
410510;202008;1856;4585;1209;3364;241;663;338;940;579;1603
410520;202008;3018;9504;2667;8776;915;3095;923;3116;1838;6211
410530;202008;1652;4080;795;2273;98;282;197;458;295;740
410540;202008;2734;7393;1874;5632;278;906;863;2495;1141;3401
410550;202008;7399;19833;4808;14048;825;2625;1325;3346;2150;5971
410560;202008;1440;3816;1058;3012;237;740;366;911;603;1651
410570;202008;2475;6818;1816;5626;484;1774;205;665;689;2439
410580;202008;25435;66276;18298;53062;3532;10985;7725;20920;11257;31905
410590;202008;1528;4376;1014;3141;141;461;290;777;431;1238
410600;202008;1809;4792;1371;3944;301;825;468;1398;769;2223
410610;202008;718;1895;528;1525;60;209;228;617;288;826
410620;202008;2377;6841;1568;4917;339;1167;259;738;598;1905
410630;202008;2450;6453;1583;4661;303;1008;320;779;623;1787
410640;202008;4647;10881;3106;8189;682;2101;408;1071;1090;3172
410645;202008;1046;2979;845;2710;264;875;364;1188;628;2063
410650;202008;2241;6085;1529;4625;308;1002;537;1501;845;2503
410655;202008;898;2154;626;1670;26;82;324;824;350;906
410657;202008;652;1753;397;1191;52;187;142;355;194;542
410660;202008;3386;8724;1914;5488;350;1050;495;1334;845;2384
410670;202008;1057;2627;627;1788;126;376;222;571;348;947
410680;202008;2610;7907;1845;5947;447;1494;337;1106;784;2600
410685;202008;532;1357;396;1123;93;310;157;392;250;702
410690;202008;130790;319492;85595;234919;13521;42501;32742;78917;46263;121418
410700;202008;2488;6298;2061;5616;309;864;1045;2781;1354;3645
410710;202008;870;2192;567;1619;93;273;226;598;319;871
410712;202008;636;1839;522;1613;132;448;192;565;324;1013
410715;202008;802;2332;485;1607;69;231;171;540;240;771
410720;202008;3135;7984;2438;6628;327;1052;529;1402;856;2454
410725;202008;1088;2686;613;1786;112;362;91;220;203;582
410730;202008;635;1688;480;1403;110;369;97;270;207;639
410740;202008;927;2596;673;2101;91;314;264;813;355;1127
410750;202008;1753;4451;1376;3740;202;616;628;1624;830;2240
410752;202008;370;938;184;553;28;86;81;227;109;313
410753;202008;303;926;205;700;31;121;44;140;75;261
410754;202008;1090;2796;899;2503;57;122;611;1811;668;1933
410755;202008;588;1519;404;1147;56;172;174;432;230;604
410760;202008;3576;9197;2545;7305;651;2142;568;1481;1219;3623
410765;202008;13284;37109;10249;31056;1730;5734;2202;5901;3932;11635
410770;202008;1056;2516;733;1969;65;189;369;993;434;1182
410773;202008;1246;3355;1082;3105;112;362;666;1849;778;2211
410775;202008;1484;3683;1285;3383;66;202;857;2202;923;2404
410780;202008;626;1546;408;1117;66;197;111;281;177;478
410785;202008;727;1900;558;1613;92;298;195;573;287;871
410790;202008;784;2212;630;1910;169;562;64;139;233;701
410800;202008;3404;7496;2735;6522;52;169;1793;4154;1845;4323
410810;202008;422;1129;331;950;23;73;171;441;194;514
410820;202008;886;2498;451;1398;93;303;85;227;178;530
410830;202008;35764;86984;24270;67525;4853;15510;8878;22953;13731;38463
410832;202008;1016;2635;806;2261;87;272;479;1268;566;1540
410840;202008;8184;20890;4794;14344;903;2919;1209;3390;2112;6309
410845;202008;1147;2859;894;2474;167;493;375;1018;542;1511
410850;202008;2210;6393;1912;5837;303;1020;954;2816;1257;3836
410855;202008;775;1936;508;1426;47;130;237;615;284;745
410860;202008;4339;10686;3379;9103;346;1088;1899;4831;2245;5919
410865;202008;1397;4086;1204;3694;138;475;717;2230;855;2705
410870;202008;1273;3427;1044;3029;85;268;701;2013;786;2281
410880;202008;4572;12271;3200;9712;552;1776;464;1536;1016;3312
410890;202008;958;2741;698;2223;155;546;179;562;334;1108
410895;202008;996;3174;848;2848;254;941;187;582;441;1523
410900;202008;856;2258;586;1725;101;312;112;267;213;579
410910;202008;384;902;226;604;13;47;130;308;143;355
410920;202008;859;2050;589;1603;76;228;292;772;368;1000
410930;202008;1641;4218;1115;3282;264;915;232;663;496;1578
410940;202008;22421;61356;15986;49528;3290;11314;4913;14874;8203;26188
410950;202008;1902;5579;1680;5232;49;190;1398;4301;1447;4491
410960;202008;7545;18873;5072;14630;1175;3738;1900;5426;3075;9164
410965;202008;1109;2803;753;2121;88;270;422;1172;510;1442
410970;202008;3947;10607;2733;8238;619;2237;369;923;988;3160
410975;202008;1347;3354;1020;2829;112;334;496;1361;608;1695
410980;202008;7278;18260;4635;13440;536;1746;2011;5299;2547;7045
410990;202008;1415;3441;936;2687;226;749;304;841;530;1590
411000;202008;630;1665;419;1252;55;197;125;310;180;507
411005;202008;456;1177;276;793;47;150;82;207;129;357
411007;202008;2273;6344;1845;5592;430;1384;652;1952;1082;3336
411010;202008;4180;12551;3275;10681;833;2951;357;1053;1190;4004
411020;202008;2236;6398;1830;5654;536;1714;501;1512;1037;3226
411030;202008;767;1890;537;1419;34;120;303;702;337;822
411040;202008;979;2444;498;1383;57;185;170;414;227;599
411050;202008;1887;5883;1521;5058;398;1426;227;661;625;2087
411060;202008;1860;4831;1169;3485;265;926;192;508;457;1434
411065;202008;384;1000;258;755;36;116;113;305;149;421
411070;202008;7149;18255;5625;15673;776;2408;2751;7381;3527;9789
411080;202008;2081;5517;1629;4707;418;1377;325;915;743;2292
411090;202008;850;2226;551;1642;48;171;154;432;202;603
411095;202008;2755;6341;1399;3801;167;474;339;838;506;1312
411100;202008;1185;3056;818;2391;83;280;267;803;350;1083
411110;202008;632;1632;280;878;35;111;18;38;53;149
411120;202008;1275;3540;1051;3109;322;1103;226;606;548;1709
411125;202008;5213;15146;4602;13980;1002;2991;2199;7016;3201;10007
411130;202008;709;1901;498;1504;97;263;176;572;273;835
411140;202008;2240;6937;1888;6174;552;1949;490;1562;1042;3511
411150;202008;3838;9827;2559;7227;506;1661;254;524;760;2185
411155;202008;957;2438;554;1674;78;224;234;674;312;898
411160;202008;354;814;233;652;32;99;51;143;83;242
411170;202008;718;2138;541;1724;129;408;179;551;308;959
411180;202008;5485;14440;4207;12157;619;2002;2038;5516;2657;7518
411190;202008;1681;4302;1237;3496;210;631;473;1205;683;1836
411200;202008;4921;13344;3392;10417;851;2902;659;1733;1510;4635
411210;202008;3176;7076;2062;5230;356;1009;675;1610;1031;2619
411220;202008;844;2189;587;1688;136;429;165;451;301;880
411230;202008;871;2294;614;1797;124;388;231;657;355;1045
411240;202008;1565;3771;1016;2749;108;340;493;1222;601;1562
411250;202008;2215;5888;1608;4780;315;1071;504;1446;819;2517
411260;202008;340;898;218;645;28;88;85;221;113;309
411270;202008;2056;5469;1515;4375;205;624;764;2022;969;2646
411275;202008;1437;3306;980;2552;142;448;445;1067;587;1515
411280;202008;1321;3569;867;2686;231;731;121;359;352;1090
411290;202008;809;2127;515;1545;51;140;269;836;320;976
411295;202008;1216;3066;855;2345;102;300;378;970;480;1270
411300;202008;1027;2571;639;1815;61;189;295;730;356;919
411310;202008;867;2015;658;1707;50;127;289;737;339;864
411320;202008;5474;14178;3954;11415;673;2086;1659;4272;2332;6358
411325;202008;1382;3962;1172;3599;193;587;660;2094;853;2681
411330;202008;3346;9048;2409;7318;542;1786;747;2285;1289;4071
411340;202008;842;2292;497;1517;74;241;160;465;234;706
411342;202008;1037;2506;603;1661;100;298;236;615;336;913
411345;202008;1049;2725;788;2290;61;194;565;1657;626;1851
411350;202008;2693;7320;1730;5336;448;1502;255;726;703;2228
411360;202008;701;1702;490;1356;66;183;161;431;227;614
411370;202008;56024;137232;39956;109812;2879;9583;24060;61755;26939;71338
411373;202008;1381;3516;1117;3120;96;325;603;1698;699;2023
411375;202008;1102;2775;797;2198;129;374;316;836;445;1210
411380;202008;1125;2613;748;1893;36;101;460;1083;496;1184
411390;202008;1511;4166;1170;3423;184;593;486;1261;670;1854
411400;202008;2256;5615;1683;4527;171;541;853;2191;1024;2732
411410;202008;2502;6915;1813;5410;402;1309;414;1183;816;2492
411420;202008;4163;10233;2234;6493;325;1081;402;897;727;1978
411430;202008;3425;9281;2571;7646;543;1769;896;2423;1439;4192
411435;202008;410;1154;254;811;51;160;77;198;128;358
411440;202008;2511;6996;2017;6059;413;1336;716;2092;1129;3428
411450;202008;2477;6636;1880;5640;246;744;997;3044;1243;3788
411460;202008;4152;10670;2566;7612;419;1476;466;1242;885;2718
411470;202008;758;1955;550;1544;101;306;208;530;309;836
411480;202008;4911;13036;3556;10473;698;2457;1290;3376;1988;5833
411490;202008;1604;4147;1219;3504;155;516;512;1330;667;1846
411500;202008;1290;3483;849;2523;149;484;170;414;319;898
411510;202008;2293;5859;1816;5022;393;1269;429;1189;822;2458
411520;202008;30231;73572;17082;47882;1984;6475;6488;16320;8472;22795
411530;202008;931;2442;556;1710;94;318;89;240;183;558
411535;202008;479;1387;290;929;31;109;83;213;114;322
411540;202008;2716;6643;1820;5003;167;537;919;2435;1086;2972
411545;202008;916;2623;757;2340;73;229;491;1531;564;1760
411550;202008;708;1787;496;1386;70;216;82;244;152;460
411560;202008;1952;5264;1099;3418;157;547;79;224;236;771
411570;202008;7522;17394;5001;13517;1113;3264;903;2433;2016;5697
411573;202008;756;2044;638;1862;99;303;326;930;425;1233
411575;202008;1993;5427;1467;4339;283;917;361;1053;644;1970
411580;202008;4669;10722;2775;7784;408;1405;500;1273;908;2678
411585;202008;637;1889;273;885;63;221;50;139;113;360
411590;202008;393;1085;267;811;35;103;136;386;171;489
411600;202008;302;767;191;591;39;123;56;162;95;285
411605;202008;1571;3643;980;2685;124;434;515;1376;639;1810
411610;202008;2544;6085;1792;4709;72;239;1192;2911;1264;3150
411620;202008;2787;7440;2351;6749;405;1224;1275;3651;1680;4875
411630;202008;759;1990;500;1483;77;281;184;486;261;767
411640;202008;466;1221;323;914;44;141;117;298;161;439
411650;202008;203;592;131;430;24;87;30;76;54;163
411660;202008;927;2340;670;1873;53;157;290;780;343;937
411670;202008;1363;3338;915;2449;102;297;425;1058;527;1355
411680;202008;1446;3858;1056;3084;137;455;466;1303;603;1758
411690;202008;3766;9613;2816;7950;605;1752;813;2437;1418;4189
411695;202008;658;2016;415;1349;49;176;174;529;223;705
411700;202008;1674;4330;1074;3176;221;708;164;462;385;1170
411705;202008;1897;5865;1594;5336;295;945;918;3292;1213;4237
411710;202008;1957;4989;1333;3821;295;864;259;732;554;1596
411720;202008;1057;2457;746;1912;150;403;285;685;435;1088
411721;202008;978;2485;721;1997;145;396;180;501;325;897
411722;202008;839;2221;471;1356;69;229;181;430;250;659
411725;202008;1174;3280;797;2531;185;626;175;568;360;1194
411727;202008;1492;4127;956;2958;220;715;175;503;395;1218
411729;202008;691;1665;430;1164;49;181;164;384;213;565
411730;202008;5211;13854;4000;11453;823;2521;1700;4778;2523;7299
411740;202008;538;1386;269;806;54;145;59;158;113;303
411745;202008;774;2190;512;1591;73;243;84;194;157;437
411750;202008;5347;14080;3880;11201;527;1647;1893;5126;2420;6773
411760;202008;6651;17812;5074;15046;1673;5151;994;3274;2667;8425
411770;202008;3001;8674;2170;6826;519;1739;326;956;845;2695
411780;202008;2764;7780;2345;6983;642;1999;794;2383;1436;4382
411790;202008;2812;6809;1493;4416;317;1075;244;620;561;1695
411800;202008;1015;2862;741;2247;131;408;151;434;282;842
411810;202008;1597;4123;1182;3283;203;578;548;1433;751;2011
411820;202008;11067;31808;8884;27906;2193;7383;3741;11454;5934;18837
411830;202008;582;1438;437;1192;83;249;96;279;179;528
411840;202008;11980;31936;7955;23504;1380;4411;2087;5643;3467;10054
411845;202008;554;1600;301;975;37;143;67;188;104;331
411850;202008;7236;18496;4854;14274;1228;4072;792;2118;2020;6190
411860;202008;674;1894;480;1484;73;234;123;339;196;573
411870;202008;591;1725;405;1298;89;314;99;282;188;596
411880;202008;2253;5660;1633;4644;224;727;568;1553;792;2280
411885;202008;1056;2700;742;2135;105;360;236;621;341;981
411890;202008;1355;3601;947;2837;160;541;104;297;264;838
411900;202008;811;2231;493;1539;110;377;82;227;192;604
411910;202008;951;2803;683;2229;174;639;241;717;415;1356
411915;202008;15318;37507;10083;27961;1481;4634;3983;9852;5464;14486
411920;202008;1093;3218;906;2807;196;704;326;930;522;1634
411925;202008;466;1228;328;976;71;241;128;354;199;595
411930;202008;4903;15116;4103;13566;1768;6364;270;1059;2038;7423
411940;202008;3254;9697;2480;7970;617;2060;772;2229;1389;4289
411950;202008;13967;37629;11398;33355;1597;5306;6632;18569;8229;23875
411960;202008;5820;15697;4575;13139;845;2677;1732;4699;2577;7376
411965;202008;466;1287;330;1005;49;164;141;394;190;558
411970;202008;1091;2535;836;2193;167;413;361;1078;528;1491
411980;202008;1458;3630;1041;2933;253;724;380;1035;633;1759
411990;202008;38396;100661;24069;73978;4487;15231;8191;24059;12678;39290
411995;202008;3371;8283;2533;6976;744;2297;691;1803;1435;4100
412000;202008;1919;4418;1343;3439;31;99;949;2276;980;2375
412010;202008;586;1825;425;1469;69;255;121;354;190;609
412015;202008;543;1527;438;1336;55;180;262;794;317;974
412020;202008;444;1229;271;847;42;155;110;316;152;471
412030;202008;616;1717;437;1384;74;241;126;388;200;629
412033;202008;918;2421;650;1865;86;255;235;584;321;839
412035;202008;758;2050;479;1530;52;204;260;783;312;987
412040;202008;583;1563;364;1121;55;155;65;198;120;353
412050;202008;1637;4092;1097;3080;226;721;267;748;493;1469
412060;202008;7297;21309;6046;18782;1597;5618;1717;5084;3314;10702
412065;202008;614;1687;445;1340;102;330;108;326;210;656
412070;202008;1154;2981;903;2479;112;331;371;941;483;1272
412080;202008;2126;5998;1394;4442;210;703;301;852;511;1555
412085;202008;308;745;106;325;11;35;20;50;31;85
412090;202008;5747;15038;4241;12182;1110;3321;1485;4343;2595;7664
412100;202008;1586;4343;1187;3595;349;1153;257;854;606;2007
412110;202008;812;2124;555;1605;81;241;184;503;265;744
412120;202008;1960;5701;1504;4788;296;1040;437;1195;733;2235
412125;202008;641;1819;447;1412;90;291;124;371;214;662
412130;202008;803;2040;546;1548;85;259;142;408;227;667
412135;202008;624;1660;283;858;42;130;96;259;138;389
412140;202008;1686;4104;1108;3080;199;676;232;607;431;1283
412150;202008;2725;7209;2296;6446;334;1083;1388;3663;1722;4746
412160;202008;933;2883;515;1753;93;339;84;256;177;595
412170;202008;4320;11873;3600;10704;735;2396;1467;4032;2202;6428
412175;202008;1282;3689;1060;3302;222;716;464;1464;686;2180
412180;202008;1636;4506;1177;3636;144;518;540;1532;684;2050
412190;202008;3346;8365;2456;6796;329;989;1067;2934;1396;3923
412200;202008;1694;5051;1209;3912;324;1153;196;577;520;1730
412210;202008;610;1469;359;1015;50;158;132;335;182;493
412215;202008;3297;8942;2585;7543;644;1837;1097;3536;1741;5373
412217;202008;964;2516;814;2249;54;162;544;1454;598;1616
412220;202008;5987;16489;4750;14203;1270;3729;1470;4727;2740;8456
412230;202008;2650;7831;2096;6732;354;1289;562;1556;916;2845
412240;202008;7159;18354;4478;13076;780;2457;1354;3591;2134;6048
412250;202008;2017;5209;1498;4222;356;1057;334;869;690;1926
412260;202008;1207;3243;860;2490;149;462;266;717;415;1179
412265;202008;891;2426;699;2092;147;458;284;809;431;1267
412270;202008;990;2703;628;1930;81;283;241;656;322;939
412280;202008;401;1127;311;976;62;207;96;276;158;483
412290;202008;1025;2617;693;2013;107;340;223;598;330;938
412300;202008;1656;4272;1135;3335;249;770;250;763;499;1533
412310;202008;756;2090;606;1791;96;333;219;596;315;929
412320;202008;850;2203;548;1569;58;199;180;516;238;715
412330;202008;1536;4145;1014;3121;196;672;336;1059;532;1731
412340;202008;1130;3170;690;2183;100;372;116;330;216;702
412350;202008;2794;7240;1755;5171;353;1094;314;846;667;1940
412360;202008;271;743;181;540;5;26;109;302;114;328
412370;202008;876;2490;588;1865;116;417;50;163;166;580
412380;202008;1513;4121;1059;3185;286;895;134;466;420;1361
412382;202008;511;1270;333;976;45;161;137;334;182;495
412385;202008;2161;5935;1749;5127;548;1523;543;1782;1091;3305
412390;202008;2425;5859;1945;5117;312;819;743;1979;1055;2798
412395;202008;679;1942;470;1460;58;159;199;633;257;792
412400;202008;916;2448;648;1926;126;416;177;522;303;938
412402;202008;1960;4840;1297;3708;319;949;169;489;488;1438
412405;202008;3003;7917;1941;5900;497;1793;65;179;562;1972
412410;202008;5955;15378;4362;12741;780;2633;1438;3954;2218;6587
412420;202008;530;1350;342;976;25;88;167;417;192;505
412430;202008;598;1498;309;894;34;114;120;324;154;438
412440;202008;2694;7343;1776;5542;440;1487;279;898;719;2385
412450;202008;435;1266;290;891;47;140;25;61;72;201
412460;202008;1007;2655;787;2274;144;453;366;1038;510;1491
412470;202008;1461;4740;1190;4106;298;1081;261;904;559;1985
412480;202008;1045;2776;676;1956;125;388;201;509;326;897
412490;202008;1297;3271;1034;2784;122;332;520;1318;642;1650
412500;202008;1891;4776;1405;3855;303;822;410;1079;713;1901
412510;202008;1909;5868;1305;4295;296;1048;129;348;425;1396
412520;202008;1212;3179;641;1918;153;449;55;167;208;616
412530;202008;712;1878;519;1475;80;248;110;313;190;561
412535;202008;794;2061;532;1551;85;268;114;280;199;548
412540;202008;1206;3072;863;2429;97;345;279;824;376;1169
412545;202008;680;1753;473;1317;68;191;180;485;248;676
412550;202008;32565;86972;22662;66848;3800;12230;8985;24199;12785;36429
412555;202008;295;782;194;557;20;59;57;126;77;185
412560;202008;4605;13482;3361;10526;583;1994;986;3080;1569;5074
412570;202008;4457;11302;2519;7503;522;1768;314;1023;836;2791
412575;202008;1008;2554;801;2189;97;292;435;1111;532;1403
412580;202008;1435;3768;1008;2937;85;300;536;1499;621;1799
412590;202008;420;1104;229;716;32;106;23;58;55;164
412600;202008;1577;4283;1172;3446;188;634;506;1377;694;2011
412610;202008;801;2094;565;1582;59;168;292;731;351;899
412620;202008;1250;3262;944;2785;188;631;274;762;462;1393
412625;202008;8755;23161;5268;16104;734;2549;346;939;1080;3488
412627;202008;1146;3207;719;2310;134;466;193;624;327;1090
412630;202008;2833;8286;1997;6432;387;1262;610;1798;997;3060
412635;202008;387;1063;262;779;38;131;92;225;130;356
412640;202008;1027;2714;565;1723;69;210;172;476;241;686
412650;202008;1651;4535;1313;3832;212;687;510;1303;722;1990
412660;202008;2388;6102;1655;4691;274;834;497;1255;771;2089
412665;202008;384;985;296;819;45;136;143;380;188;516
412667;202008;1693;4465;1254;3612;177;541;508;1407;685;1948
412670;202008;840;1987;561;1531;96;293;174;439;270;732
412680;202008;1905;5088;1299;3898;172;596;464;1228;636;1824
412690;202008;1093;2900;798;2314;129;404;310;844;439;1248
412700;202008;1958;5198;1608;4640;192;649;882;2461;1074;3110
412710;202008;5931;17278;4410;13949;872;3129;1260;3506;2132;6635
412720;202008;1165;3433;889;2815;143;482;177;473;320;955
412730;202008;2393;6356;1594;4721;298;984;549;1526;847;2510
412740;202008;1860;5177;1247;3892;220;805;170;518;390;1323
412750;202008;3841;10113;3165;9139;307;1071;2083;5659;2390;6730
412760;202008;2883;7847;2383;6994;438;1448;1269;3500;1707;4948
412770;202008;10058;25366;5237;15759;736;2331;1214;3134;1950;5465
412780;202008;1176;3115;863;2530;192;611;339;972;531;1583
412785;202008;2032;4929;1415;3857;144;403;915;2442;1059;2845
412788;202008;1321;3700;1080;3276;293;893;459;1362;752;2255
412790;202008;1333;3530;740;2288;120;425;230;624;350;1049
412795;202008;1284;3311;669;2053;99;323;130;366;229;689
412796;202008;2201;6343;1797;5547;376;1226;588;1684;964;2910
412800;202008;3585;8667;2434;6529;280;861;1126;2674;1406;3535
412810;202008;11550;29326;7262;20556;883;2919;2824;7095;3707;10014
412820;202008;6391;17487;4458;13570;1075;3462;1278;3888;2353;7350
412830;202008;355;995;245;756;36;109;59;172;95;281
412840;202008;1839;4614;1292;3534;143;443;566;1410;709;1853
412850;202008;2824;7434;2025;6010;329;1049;843;2460;1172;3509
412853;202008;1516;3821;1252;3349;178;520;636;1520;814;2040
412855;202008;1238;3289;791;2328;136;474;232;635;368;1109
412860;202008;783;1917;531;1517;73;229;294;801;367;1030
412862;202008;696;1700;461;1302;87;250;193;521;280;771
412863;202008;1255;3787;1118;3531;206;664;650;2042;856;2706
412865;202008;715;1946;518;1543;130;386;150;472;280;858
412870;202008;850;2193;615;1810;168;559;120;381;288;940
412880;202008;834;2253;552;1665;91;319;93;248;184;567
420005;202008;410;1206;239;820;34;123;106;365;140;488
420010;202008;3285;7990;2173;6117;134;423;1590;4502;1724;4925
420020;202008;435;1367;282;973;45;183;64;177;109;360
420030;202008;73;247;53;204;17;73;17;60;34;133
420040;202008;520;1556;295;1049;59;234;17;45;76;279
420050;202008;728;1685;479;1233;73;219;293;676;366;895
420055;202008;158;486;88;314;21;94;27;81;48;175
420060;202008;102;275;57;170;11;34;14;32;25;66
420070;202008;685;2088;509;1712;108;380;198;648;306;1028
420075;202008;80;198;41;119;6;21;17;33;23;54
420080;202008;345;998;271;828;70;233;106;320;176;553
420090;202008;414;1289;245;870;52;194;45;134;97;328
420100;202008;1223;3224;1011;2899;53;187;812;2293;865;2480
420110;202008;237;762;215;714;44;170;100;306;144;476
420120;202008;539;1455;355;1054;68;230;167;426;235;656
420125;202008;345;1062;242;831;61;222;98;323;159;545
420127;202008;264;712;98;319;14;51;26;80;40;131
420130;202008;3191;8796;2402;7431;368;1374;1158;3258;1526;4632
420140;202008;3459;9346;2421;7517;679;2392;332;1047;1011;3439
420150;202008;666;1694;457;1332;45;151;274;776;319;927
420160;202008;201;490;77;245;10;30;20;63;30;93
420165;202008;156;447;89;289;20;70;28;77;48;147
420170;202008;269;833;182;615;22;70;56;165;78;235
420180;202008;177;555;106;379;14;49;30;92;44;141
420190;202008;200;633;123;432;37;145;33;109;70;254
420195;202008;1390;3568;996;2925;306;1069;113;245;419;1314
420200;202008;4321;10517;2544;7166;343;1191;1028;2501;1371;3692
420205;202008;1695;4579;1140;3478;166;532;631;1923;797;2455
420207;202008;1670;4368;1014;3114;198;698;403;1151;601;1849
420208;202008;316;893;183;644;57;220;47;156;104;376
420209;202008;154;516;91;314;21;76;29;97;50;173
420210;202008;2953;7558;1925;5872;346;1189;913;2714;1259;3903
420213;202008;759;2360;633;2096;140;501;311;1013;451;1514
420215;202008;184;561;125;426;31;115;26;82;57;197
420220;202008;250;730;150;506;25;101;68;203;93;304
420230;202008;4807;13140;3609;10866;550;1798;1902;5529;2452;7327
420240;202008;13116;36137;8154;24783;1055;3676;4014;10704;5069;14380
420243;202008;367;1056;287;891;46;164;171;502;217;666
420245;202008;1222;3152;859;2529;63;229;526;1484;589;1713
420250;202008;422;1183;346;1052;53;180;194;550;247;730
420253;202008;480;1183;340;980;36;124;192;545;228;669
420257;202008;162;418;102;310;19;70;51;153;70;223
420260;202008;1056;2787;762;2372;127;448;471;1439;598;1887
420270;202008;505;1324;245;721;32;104;113;330;145;434
420280;202008;1112;3349;841;2784;159;596;287;907;446;1503
420285;202008;116;235;48;138;10;41;10;20;20;61
420287;202008;425;989;301;816;81;222;110;303;191;525
420290;202008;4614;13133;3517;10631;469;1648;2077;5776;2546;7424
420300;202008;7076;19871;4046;12792;752;2660;1186;3291;1938;5951
420310;202008;787;1813;388;1076;40;127;214;550;254;677
420315;202008;762;2148;524;1722;113;389;209;691;322;1080
420320;202008;4935;13535;3550;11151;1004;3507;904;2617;1908;6124
420325;202008;282;791;194;611;30;99;91;262;121;361
420330;202008;954;2775;600;2018;109;434;177;512;286;946
420340;202008;946;2620;700;2175;163;535;108;290;271;825
420350;202008;1129;2987;820;2426;70;239;570;1653;640;1892
420360;202008;2756;7590;1477;4777;283;994;129;419;412;1413
420370;202008;1068;2880;863;2545;84;285;588;1669;672;1954
420380;202008;4279;11242;2809;8592;589;1914;1046;3071;1635;4985
420390;202008;1063;2536;723;1851;130;405;299;518;429;923
420395;202008;1025;2915;694;2246;109;417;97;231;206;648
420400;202008;974;2755;663;2082;119;427;246;723;365;1150
420410;202008;544;1476;419;1213;45;136;282;796;327;932
420415;202008;282;834;215;686;56;200;81;258;137;458
420417;202008;587;1757;463;1495;127;414;164;543;291;957
420419;202008;139;488;106;408;37;149;8;30;45;179
420420;202008;10761;27843;7077;21104;1993;6756;1944;5257;3937;12013
420425;202008;646;1721;424;1272;41;141;206;596;247;737
420430;202008;3091;8308;1793;5440;421;1331;580;1616;1001;2947
420435;202008;244;624;115;373;17;60;54;167;71;227
420440;202008;723;1979;435;1351;112;387;172;494;284;881
420445;202008;263;647;167;471;30;86;78;212;108;298
420450;202008;668;1943;482;1541;88;338;179;498;267;836
420455;202008;1947;4801;1386;3940;195;662;684;1826;879;2488
420460;202008;8848;23576;6480;19185;958;3170;3303;9370;4261;12540
420470;202008;600;1567;318;1004;59;217;64;171;123;388
420475;202008;76;196;30;94;10;30;3;11;13;41
420480;202008;5340;13143;3195;9537;650;2130;1063;3163;1713;5293
420490;202008;350;978;253;782;53;183;101;305;154;488
420500;202008;1380;3831;875;2860;155;565;377;1225;532;1790
420510;202008;157;440;85;270;10;42;24;66;34;108
420515;202008;64;166;38;108;4;19;18;43;22;62
420517;202008;751;2067;651;1890;52;153;483;1419;535;1572
420519;202008;290;703;210;587;25;76;121;352;146;428
420520;202008;299;807;151;506;26;91;11;37;37;128
420530;202008;794;2308;537;1755;88;337;201;564;289;901
420535;202008;235;690;94;321;12;46;42;133;54;179
420540;202008;34998;83017;21981;61008;3281;10369;7620;18081;10901;28450
420543;202008;202;614;155;501;20;72;82;244;102;316
420545;202008;1085;3225;812;2625;150;530;318;928;468;1458
420550;202008;3391;9021;2114;6848;347;1301;865;2858;1212;4159
420555;202008;290;834;194;627;23;84;113;348;136;432
420560;202008;388;958;256;760;53;172;144;420;197;592
420570;202008;2168;5970;1686;5057;303;1046;733;2090;1036;3136
420580;202008;1834;4664;1298;3839;296;945;441;1342;737;2287
420590;202008;2722;7201;1554;4673;284;1034;414;944;698;1978
420600;202008;988;2867;745;2390;103;388;424;1294;527;1682
420610;202008;350;1008;192;642;44;155;65;226;109;381
420620;202008;726;1782;476;1365;103;315;191;540;294;855
420630;202008;877;2641;633;2038;86;304;370;1124;456;1428
420640;202008;478;1292;223;761;72;241;22;75;94;316
420650;202008;3476;9144;2066;6167;292;956;799;2051;1091;3007
420660;202008;429;1104;269;771;50;149;73;187;123;336
420665;202008;583;1527;367;1146;66;240;165;452;231;692
420670;202008;1278;3514;814;2567;140;531;304;851;444;1382
420675;202008;163;459;93;314;15;66;45;136;60;202
420680;202008;323;763;164;537;32;121;84;259;116;380
420690;202008;864;2545;513;1706;71;285;136;373;207;658
420700;202008;2532;6653;1873;5527;236;768;1052;2998;1288;3766
420710;202008;873;2533;661;2074;67;272;395;1132;462;1404
420720;202008;1191;3311;844;2695;176;592;408;1247;584;1839
420730;202008;2962;7682;2165;6355;352;1142;1160;3263;1512;4405
420740;202008;514;1551;298;1059;86;328;25;106;111;434
420750;202008;1904;5517;1228;3936;217;813;494;1442;711;2255
420757;202008;80;197;41;130;4;8;18;54;22;62
420760;202008;341;1008;162;507;36;122;43;118;79;240
420765;202008;456;1325;200;689;29;117;79;260;108;377
420768;202008;1324;3712;1134;3389;148;445;828;2463;976;2908
420770;202008;452;1217;221;749;39;150;91;284;130;434
420775;202008;273;826;183;610;39;147;51;141;90;288
420780;202008;908;2505;547;1712;113;390;96;255;209;645
420785;202008;189;498;131;373;13;45;67;159;80;204
420790;202008;987;3004;722;2456;117;469;387;1245;504;1714
420800;202008;634;1594;299;912;85;295;72;203;157;498
420810;202008;1386;4304;1115;3757;316;1213;369;1073;685;2286
420820;202008;11421;28396;8055;22858;1542;4939;3717;9633;5259;14572
420830;202008;3799;9962;2793;8107;505;1605;1206;3396;1711;5001
420840;202008;459;1340;213;776;63;257;25;77;88;334
420845;202008;2347;6000;1402;4276;264;988;566;1617;830;2605
420850;202008;1032;3313;626;2246;117;465;114;358;231;823
420860;202008;301;772;161;525;31;112;45;128;76;240
420870;202008;768;2132;569;1754;143;516;242;675;385;1191
420880;202008;995;3061;771;2590;159;632;295;907;454;1539
420890;202008;7738;20910;4730;14679;702;2428;1677;4595;2379;7023
420895;202008;163;473;102;314;26;77;32;103;58;180
420900;202008;1469;3613;871;2556;117;417;405;1029;522;1446
420910;202008;28008;73766;17236;52796;2627;9139;6832;18718;9459;27857
420915;202008;519;1867;375;1449;55;212;198;787;253;999
420917;202008;342;842;175;481;30;87;86;234;116;321
420920;202008;75;196;27;93;0;0;5;16;5;16
420930;202008;15983;41763;11112;33122;2046;6799;4859;13725;6905;20524
420940;202008;2830;6934;1628;4836;406;1375;310;751;716;2126
420945;202008;131;371;103;309;25;85;42;115;67;200
420950;202008;330;960;178;591;27;111;45;134;72;245
420960;202008;989;2416;704;1923;123;402;309;733;432;1135
420970;202008;2341;6457;1635;5109;462;1507;438;1348;900;2855
420980;202008;267;882;230;804;115;408;61;225;176;633
420985;202008;298;853;142;506;35;137;45;138;80;275
420990;202008;301;937;163;584;30;106;34;109;64;215
421000;202008;529;1581;373;1232;81;284;101;301;182;585
421003;202008;471;1123;160;473;9;26;26;68;35;94
421005;202008;54;148;41;129;9;30;19;59;28;89
421010;202008;3101;8494;2220;6855;463;1631;586;1591;1049;3222
421020;202008;352;1097;270;945;44;184;138;457;182;641
421030;202008;719;2189;552;1832;168;634;169;514;337;1148
421040;202008;649;1529;407;1160;27;92;252;705;279;797
421050;202008;980;2624;631;1833;128;415;240;604;368;1019
421055;202008;172;463;93;282;13;44;58;161;71;205
421060;202008;619;1784;434;1362;79;287;204;568;283;855
421070;202008;629;1856;358;1175;71;252;112;348;183;600
421080;202008;492;1409;408;1250;44;157;249;755;293;912
421085;202008;365;1040;123;431;17;54;15;36;32;90
421090;202008;242;620;151;438;10;36;50;131;60;167
421100;202008;809;1808;335;1013;98;342;86;213;184;555
421105;202008;1507;4164;1026;3166;181;574;459;1348;640;1922
421110;202008;1047;2757;859;2514;22;68;633;1957;655;2025
421120;202008;934;2844;691;2283;107;390;224;670;331;1060
421125;202008;291;770;208;617;73;238;73;183;146;421
421130;202008;4751;13896;3887;12181;912;3278;1959;5735;2871;9013
421140;202008;332;909;192;596;33;104;59;165;92;269
421145;202008;428;1190;273;853;69;236;98;275;167;511
421150;202008;624;1688;397;1237;64;233;206;605;270;838
421160;202008;514;1375;365;1093;52;175;236;679;288;854
421165;202008;202;595;127;420;25;88;55;175;80;263
421170;202008;1054;2774;831;2428;137;389;499;1506;636;1895
421175;202008;979;2457;587;1843;114;400;252;769;366;1169
421180;202008;380;982;205;623;37;142;81;220;118;362
421185;202008;310;831;208;619;26;89;123;362;149;451
421187;202008;270;820;169;560;31;103;57;180;88;283
421189;202008;345;1000;263;840;43;149;102;303;145;452
421190;202008;10669;28839;7125;22083;1334;4504;2528;7230;3862;11734
421200;202008;623;1815;503;1588;56;204;322;987;378;1191
421205;202008;184;486;135;404;25;93;59;153;84;246
421210;202008;1043;2676;605;1921;129;419;231;737;360;1156
421220;202008;1303;3905;996;3251;231;826;304;907;535;1733
421223;202008;323;900;197;663;46;153;92;314;138;467
421225;202008;864;2541;723;2296;127;451;431;1358;558;1809
421227;202008;584;1716;385;1274;75;274;171;575;246;849
421230;202008;582;1528;367;1128;64;233;144;430;208;663
421240;202008;269;797;126;451;11;45;20;65;31;110
421250;202008;1914;4851;1354;3947;156;548;794;2190;950;2738
421260;202008;184;541;51;190;15;68;9;31;24;99
421265;202008;641;1677;569;1580;8;27;524;1443;532;1470
421270;202008;325;861;135;480;19;63;51;173;70;236
421280;202008;1745;4749;1290;3962;191;717;729;2111;920;2828
421290;202008;964;2608;496;1513;89;290;115;325;204;615
421300;202008;272;702;138;435;13;50;22;63;35;113
421310;202008;177;500;118;386;23;77;63;210;86;287
421315;202008;221;607;136;423;43;117;27;97;70;214
421320;202008;647;1967;336;1133;40;124;39;96;79;220
421330;202008;578;1724;416;1379;86;331;114;358;200;689
421335;202008;333;1015;274;911;66;249;115;370;181;619
421340;202008;1330;3676;942;2928;173;628;401;1137;574;1765
421350;202008;1423;3681;939;2833;185;641;393;1093;578;1734
421360;202008;2185;5886;1269;4002;237;898;487;1331;724;2229
421370;202008;626;2048;377;1362;69;252;105;329;174;581
421380;202008;787;2104;674;1924;91;293;397;1091;488;1384
421390;202008;165;448;58;200;14;42;20;59;34;101
421400;202008;301;969;214;760;37;145;110;373;147;518
421410;202008;207;565;90;318;22;87;28;82;50;169
421415;202008;181;538;105;333;19;58;21;63;40;121
421420;202008;529;1431;427;1240;45;141;269;763;314;904
421430;202008;101;309;75;247;8;28;20;60;28;88
421440;202008;590;1599;356;1171;70;229;156;498;226;727
421450;202008;429;1274;246;845;32;135;40;142;72;277
421460;202008;364;1084;198;723;25;100;38;114;63;214
421470;202008;248;726;145;497;31;107;51;185;82;292
421480;202008;2701;7258;1749;5355;367;1314;671;1861;1038;3175
421490;202008;115;396;69;263;7;29;16;40;23;69
421500;202008;2032;5988;1409;4706;380;1486;335;970;715;2456
421505;202008;276;789;227;719;35;125;145;445;180;570
421507;202008;413;1177;220;744;54;192;75;241;129;433
421510;202008;303;859;187;574;27;89;102;284;129;373
421520;202008;491;1276;313;880;25;76;190;487;215;563
421530;202008;299;891;171;596;29;130;51;146;80;276
421535;202008;379;994;231;729;35;134;119;356;154;490
421540;202008;284;664;135;407;19;61;47;123;66;184
421545;202008;662;1964;492;1651;110;439;234;731;344;1170
421550;202008;1988;5296;1598;4706;295;896;912;2675;1207;3571
421555;202008;163;496;67;236;9;35;8;19;17;54
421560;202008;80;261;54;201;10;36;17;57;27;93
421565;202008;877;2268;573;1780;146;500;154;483;300;983
421567;202008;423;1389;274;959;97;360;67;213;164;573
421568;202008;329;984;245;789;35;124;109;342;144;466
421569;202008;152;439;73;238;14;50;36;112;50;162
421570;202008;1090;2957;770;2347;179;620;214;603;393;1223
421575;202008;289;839;211;634;30;104;92;238;122;342
421580;202008;3800;10437;2450;7567;388;1403;962;2526;1350;3929
421590;202008;137;420;110;359;34;123;29;78;63;201
421600;202008;554;1498;377;1126;77;261;118;293;195;554
421605;202008;721;1864;509;1517;88;235;266;848;354;1083
421610;202008;1028;2796;671;2110;112;379;218;663;330;1042
421620;202008;3751;9921;2169;7002;462;1694;601;1838;1063;3532
421625;202008;127;352;56;179;13;44;13;39;26;83
421630;202008;2370;6220;1463;4429;259;937;501;1240;760;2177
421635;202008;249;678;178;527;17;54;110;300;127;354
421640;202008;693;1855;494;1547;95;339;212;645;307;984
421650;202008;2309;6285;1495;4751;349;1316;469;1253;818;2569
421660;202008;9574;26638;6630;20956;1032;3609;2902;8415;3934;12024
421670;202008;727;2101;507;1579;87;300;250;761;337;1061
421680;202008;1003;2751;752;2296;194;640;368;1028;562;1668
421690;202008;1245;3579;839;2705;162;599;300;954;462;1553
421700;202008;489;1448;309;1028;66;239;98;306;164;545
421710;202008;199;633;88;296;18;65;23;70;41;135
421715;202008;103;288;80;236;18;48;47;135;65;183
421720;202008;1822;4930;1054;3291;269;907;281;762;550;1669
421725;202008;238;583;123;377;21;72;52;123;73;195
421730;202008;402;1157;209;624;27;87;106;295;133;382
421740;202008;687;1942;470;1457;110;359;139;389;249;748
421750;202008;836;1977;375;1112;89;289;134;358;223;647
421755;202008;152;422;87;265;16;63;45;118;61;181
421760;202008;929;2417;609;1834;98;326;237;607;335;933
421770;202008;2357;6266;1693;5093;435;1293;606;1975;1041;3268
421775;202008;201;514;123;367;16;49;56;156;72;205
421780;202008;782;2313;501;1704;105;406;200;636;305;1042
421790;202008;764;1981;435;1395;96;321;218;680;314;1001
421795;202008;182;494;131;377;24;81;48;126;72;207
421800;202008;2439;6622;1750;5329;224;796;995;2870;1219;3666
421810;202008;600;1653;407;1286;48;184;238;730;286;914
421820;202008;900;2620;505;1642;102;380;156;397;258;777
421825;202008;1283;3648;1139;3424;126;401;798;2353;924;2754
421830;202008;1961;5826;1588;5118;325;1109;674;2114;999;3223
421835;202008;207;509;126;371;24;84;35;92;59;176
421840;202008;208;667;137;497;29;111;35;117;64;228
421850;202008;361;1008;192;648;36;127;56;152;92;279
421860;202008;299;836;159;547;23;94;53;162;76;256
421870;202008;4038;10165;2884;8017;482;1591;1436;3541;1918;5132
421875;202008;268;802;111;362;17;62;32;86;49;148
421880;202008;555;1582;363;1151;93;348;86;265;179;613
421885;202008;205;592;125;404;30;94;28;83;58;177
421890;202008;817;2471;605;2037;114;464;312;977;426;1441
421895;202008;393;995;326;907;40;126;222;639;262;765
421900;202008;979;2562;711;2012;96;317;334;867;430;1184
421910;202008;291;857;198;634;31;125;57;153;88;278
421915;202008;363;1018;196;626;45;142;31;89;76;231
421917;202008;561;1308;312;985;113;388;75;248;188;636
421920;202008;365;1122;262;916;107;393;70;236;177;629
421930;202008;2507;6324;1262;3903;289;1021;408;1087;697;2108
421935;202008;391;1227;309;1046;60;215;171;562;231;777
421940;202008;349;1005;165;522;24;83;43;117;67;200
421950;202008;2911;7264;1593;4814;308;1032;395;1050;703;2082
421960;202008;170;441;89;286;18;71;19;53;37;124
421970;202008;1814;4652;1071;3154;218;755;397;982;615;1737
421985;202008;277;742;159;509;16;52;62;185;78;237
422000;202008;1906;4959;1534;4343;162;540;1045;2907;1207;3447
430003;202008;562;1538;367;1170;64;218;158;506;222;724
430005;202008;260;678;164;505;31;101;73;215;104;316
430010;202008;1682;4068;1330;3522;139;411;937;2406;1076;2817
430020;202008;582;1326;435;1126;45;139;285;714;330;853
430030;202008;981;2312;535;1508;129;415;168;441;297;856
430040;202008;10184;24351;5947;16836;1574;4835;698;2107;2272;6942
430045;202008;499;1237;338;944;25;79;227;624;252;703
430047;202008;249;541;94;261;27;79;27;73;54;152
430050;202008;850;2140;486;1405;108;327;121;327;229;654
430055;202008;249;617;116;342;14;53;65;173;79;226
430057;202008;82;173;31;81;6;21;11;23;17;44
430060;202008;16681;44527;12770;38342;2675;8526;5874;17526;8549;26052
430063;202008;840;2335;664;1966;126;373;359;1063;485;1436
430064;202008;992;2718;729;2175;217;661;280;821;497;1482
430066;202008;95;203;67;160;6;13;52;119;58;132
430070;202008;732;1857;96;312;7;26;18;52;25;78
430080;202008;841;2077;515;1436;81;271;271;655;352;926
430085;202008;832;1895;501;1362;100;284;210;563;310;847
430087;202008;660;1650;557;1509;62;160;386;1056;448;1216
430090;202008;537;1375;186;581;11;43;63;190;74;233
430100;202008;776;1850;461;1252;83;268;207;475;290;743
430105;202008;1152;3062;746;2355;126;459;358;1091;484;1550
430107;202008;163;475;93;294;19;69;26;68;45;137
430110;202008;2133;5339;1554;4477;246;762;838;2376;1084;3138
430120;202008;1154;3427;745;2399;128;433;340;1096;468;1529
430130;202008;3426;7878;2495;6555;896;2387;429;1382;1325;3769
430140;202008;904;2423;633;1909;161;462;300;884;461;1346
430150;202008;561;1440;303;925;64;212;104;306;168;518
430155;202008;247;623;111;334;18;51;23;64;41;115
430160;202008;19351;45221;14831;38763;1744;4957;8728;22605;10472;27562
430163;202008;2933;6983;2047;5554;89;293;1465;3898;1554;4191
430165;202008;303;747;85;277;14;31;14;39;28;70
430170;202008;929;2463;331;1153;53;198;47;150;100;348
430175;202008;641;1930;536;1700;134;434;251;782;385;1216
430180;202008;628;1517;495;1301;58;149;342;897;400;1046
430185;202008;580;1444;296;859;79;215;65;174;144;389
430187;202008;667;1509;468;1258;75;212;240;689;315;901
430190;202008;1377;3640;1105;3205;225;707;519;1431;744;2138
430192;202008;127;339;41;124;5;15;10;26;15;41
430195;202008;409;1212;60;210;5;14;11;33;16;47
430200;202008;1054;3144;840;2754;277;947;239;802;516;1749
430205;202008;453;1181;396;1082;13;41;342;912;355;953
430210;202008;5327;13555;3575;9819;621;1846;1246;2812;1867;4658
430215;202008;305;783;191;552;39;120;71;209;110;329
430220;202008;633;1569;187;626;23;87;41;105;64;192
430222;202008;177;494;129;391;14;51;46;132;60;183
430223;202008;241;633;187;542;16;50;119;341;135;391
430225;202008;17;34;11;25;1;2;7;16;8;18
430230;202008;1868;5086;1564;4611;135;444;1166;3375;1301;3819
430235;202008;329;934;215;683;48;176;67;184;115;360
430237;202008;509;1200;370;969;20;60;271;688;291;748
430240;202008;1247;2886;698;1921;85;288;372;934;457;1222
430245;202008;707;1995;539;1670;150;484;252;800;402;1284
430250;202008;888;2207;641;1817;220;675;41;104;261;779
430258;202008;130;340;96;275;7;13;51;154;58;167
430260;202008;645;1704;439;1307;61;198;243;717;304;915
430265;202008;212;604;138;455;30;93;42;142;72;235
430270;202008;2804;6936;2198;5984;402;1212;1293;3403;1695;4615
430280;202008;4976;11697;3411;8998;707;1889;1454;3790;2161;5679
430290;202008;2178;5018;1766;4534;47;161;1516;3802;1563;3963
430300;202008;9628;24419;7185;20111;1133;3481;3786;10336;4919;13817
430310;202008;11711;29004;7783;21620;1004;3123;3777;9733;4781;12856
430320;202008;990;2572;526;1632;61;183;288;909;349;1092
430330;202008;676;1644;405;1101;73;215;173;418;246;633
430340;202008;711;1540;390;1054;55;157;228;598;283;755
430350;202008;7510;19015;5568;15519;770;2321;3222;8552;3992;10873
430355;202008;324;857;109;354;18;61;14;38;32;99
430360;202008;854;2007;543;1468;105;325;222;557;327;882
430367;202008;308;710;169;461;30;95;94;245;124;340
430370;202008;477;1288;218;669;40;133;59;152;99;285
430380;202008;700;1713;334;1031;75;274;99;287;174;561
430390;202008;3114;7534;1791;5066;335;1081;271;554;606;1635
430400;202008;1045;2231;802;1888;68;183;546;1234;614;1417
430410;202008;533;1290;364;1007;57;167;221;589;278;756
430420;202008;2580;7077;1964;5716;515;1578;850;2348;1365;3926
430430;202008;572;1460;265;819;62;184;59;194;121;378
430435;202008;1469;3735;1120;3166;202;609;570;1618;772;2227
430440;202008;3637;9963;2804;8476;294;1012;1689;5052;1983;6064
430450;202008;6612;16607;5211;14114;816;2455;2737;7112;3553;9567
430460;202008;31236;79090;22752;64979;3983;12623;11408;31072;15391;43695
430461;202008;283;731;87;272;12;40;32;86;44;126
430462;202008;239;650;133;430;19;64;52;165;71;229
430463;202008;5841;15289;4314;12547;858;2789;1976;5460;2834;8249
430465;202008;413;1064;345;944;54;169;215;565;269;734
430466;202008;4017;10107;3098;8605;753;2184;1430;3765;2183;5949
430467;202008;496;1189;355;963;47;153;194;484;241;637
430468;202008;1223;3022;943;2599;83;254;615;1657;698;1911
430469;202008;555;1498;68;218;6;19;13;24;19;43
430470;202008;5466;13927;3579;10532;1051;3406;915;2494;1966;5900
430471;202008;521;1479;420;1293;62;214;243;709;305;923
430480;202008;739;1967;417;1275;57;196;96;253;153;449
430485;202008;171;444;66;200;19;49;6;24;25;73
430490;202008;362;944;203;606;26;94;98;265;124;359
430495;202008;377;997;237;723;33;105;115;332;148;437
430500;202008;966;2498;660;1980;217;718;179;479;396;1197
430510;202008;24884;64765;17785;50753;2975;9648;8177;21398;11152;31046
430511;202008;323;929;129;419;18;61;19;58;37;119
430512;202008;951;2141;734;1817;165;413;273;693;438;1106
430513;202008;760;1909;348;1017;50;158;172;476;222;634
430515;202008;368;1037;261;819;31;90;139;436;170;526
430517;202008;1147;3453;840;2731;156;505;393;1328;549;1833
430520;202008;1279;3268;654;1921;120;367;141;377;261;744
430530;202008;968;2414;375;1136;66;199;108;304;174;503
430535;202008;3441;8820;2467;7023;358;1077;1252;3419;1610;4496
430537;202008;320;1113;300;1056;20;64;241;849;261;913
430540;202008;615;1476;348;1011;61;173;159;465;220;638
430543;202008;764;1353;424;968;55;111;196;503;251;614
430544;202008;719;2016;502;1530;125;397;173;512;298;909
430545;202008;2243;5805;1655;4881;331;1005;823;2500;1154;3505
430550;202008;351;957;251;750;46;150;100;274;146;424
430558;202008;111;255;48;130;7;14;18;52;25;66
430560;202008;336;756;143;429;21;71;48;137;69;208
430570;202008;835;2030;581;1561;100;305;304;762;404;1067
430580;202008;817;2039;578;1659;144;442;249;707;393;1149
430583;202008;195;483;32;103;2;7;9;23;11;30
430585;202008;234;570;115;309;19;61;49;112;68;173
430587;202008;199;547;146;441;19;62;62;184;81;246
430590;202008;1384;3305;1133;2933;55;167;939;2377;994;2544
430593;202008;16;54;11;36;1;3;5;16;6;19
430595;202008;433;1097;116;385;10;40;19;46;29;86
430597;202008;441;1137;227;690;23;69;72;170;95;239
430600;202008;1969;4984;873;2461;162;492;235;590;397;1082
430605;202008;1169;3118;845;2501;107;377;398;1114;505;1491
430607;202008;530;1226;430;1065;28;74;312;765;340;839
430610;202008;5746;13387;3826;10443;1070;3315;846;2241;1916;5556
430613;202008;257;600;71;207;11;35;16;35;27;70
430620;202008;618;1493;451;1177;64;192;264;623;328;815
430630;202008;401;1109;112;366;18;59;24;71;42;130
430632;202008;472;1240;199;610;25;83;88;254;113;337
430635;202008;535;1266;395;1028;48;126;282;737;330;863
430637;202008;455;1108;352;952;41;128;220;565;261;693
430640;202008;1057;2760;648;1934;94;288;237;651;331;939
430642;202008;352;958;261;751;44;116;138;377;182;493
430645;202008;155;364;59;158;8;21;20;51;28;72
430650;202008;1583;4558;1260;4022;348;1114;576;1926;924;3040
430655;202008;273;689;165;463;24;79;81;196;105;275
430660;202008;5195;13256;3909;11073;853;2528;1686;4730;2539;7258
430670;202008;646;1566;488;1285;33;96;291;773;324;869
430673;202008;531;1200;209;601;37;109;80;211;117;320
430675;202008;239;686;56;197;8;28;24;84;32;112
430676;202008;4890;12082;3849;10483;473;1415;2442;6455;2915;7870
430680;202008;936;2518;567;1762;152;477;139;423;291;900
430690;202008;2812;7619;2201;6502;751;2329;596;1677;1347;4006
430692;202008;220;675;166;574;12;39;124;442;136;481
430693;202008;941;2482;559;1712;105;375;145;403;250;778
430695;202008;428;1107;236;698;32;83;124;355;156;438
430697;202008;385;965;291;818;73;191;143;435;216;626
430700;202008;6993;17159;4059;11679;834;2622;865;2246;1699;4868
430705;202008;399;968;194;583;23;79;83;219;106;298
430710;202008;1620;3512;1127;2834;147;414;680;1678;827;2092
430720;202008;674;1629;345;1048;48;145;176;541;224;686
430730;202008;1012;2745;690;2132;97;287;363;1111;460;1398
430740;202008;612;1660;311;1014;54;182;77;265;131;447
430745;202008;362;993;227;697;44;157;70;180;114;337
430750;202008;1348;3425;932;2710;202;613;461;1318;663;1931
430755;202008;448;1086;276;738;21;59;159;392;180;451
430760;202008;2009;4919;1511;4146;349;1039;671;1746;1020;2785
430770;202008;6060;15079;4624;12930;588;1896;2949;7957;3537;9853
430780;202008;1816;4413;1030;3050;200;663;403;1136;603;1799
430781;202008;456;1266;244;759;32;96;73;193;105;289
430783;202008;355;820;212;601;20;68;130;342;150;410
430786;202008;35;124;25;92;4;16;3;13;7;29
430790;202008;4312;10508;2968;8184;336;1100;1815;4665;2151;5765
430800;202008;741;1728;542;1423;35;97;358;945;393;1042
430805;202008;357;955;217;645;16;58;137;384;153;442
430807;202008;469;1149;244;713;29;87;96;262;125;349
430810;202008;704;1667;292;862;35;131;131;360;166;491
430820;202008;1202;3213;702;2232;138;462;210;653;348;1115
430825;202008;242;608;85;223;14;36;25;62;39;98
430830;202008;1663;4740;1331;4100;64;219;955;2909;1019;3128
430840;202008;1017;2508;713;1989;102;295;476;1311;578;1606
430843;202008;136;315;60;162;3;11;30;73;33;84
430845;202008;447;1061;290;803;56;167;124;327;180;494
430850;202008;2254;5852;1511;4393;237;759;595;1740;832;2499
430860;202008;864;2002;373;1058;48;167;179;434;227;601
430865;202008;509;1262;376;1035;73;201;175;476;248;677
430870;202008;603;1571;256;802;40;150;82;217;122;367
430880;202008;1455;3297;976;2563;160;427;523;1348;683;1775
430885;202008;179;476;93;309;7;25;59;191;66;216
430890;202008;981;2436;647;1861;56;242;138;371;194;613
430900;202008;3051;6669;2095;5281;178;528;1387;3283;1565;3811
430905;202008;736;1874;456;1338;83;274;172;464;255;738
430910;202008;1593;4219;1118;3244;189;642;552;1420;741;2062
430912;202008;490;1365;327;1036;25;76;224;720;249;796
430915;202008;474;1438;359;1218;127;424;96;344;223;768
430920;202008;22580;57149;17021;47778;2290;7105;10227;27936;12517;35041
430925;202008;94;211;34;101;5;13;16;49;21;62
430930;202008;10067;23829;6307;17976;1219;3543;2586;7692;3805;11235
430940;202008;979;2557;579;1695;147;460;153;382;300;842
430950;202008;753;1759;479;1283;38;136;299;727;337;863
430955;202008;343;909;86;261;22;68;25;62;47;130
430957;202008;176;600;161;561;25;90;100;344;125;434
430960;202008;1304;3114;720;2032;156;470;310;846;466;1316
430965;202008;1612;3812;1238;3221;73;191;936;2497;1009;2688
430970;202008;349;835;169;480;22;68;82;207;104;275
430975;202008;495;1469;377;1194;81;275;196;589;277;864
430980;202008;386;879;224;604;28;91;106;259;134;350
430990;202008;530;1519;325;1025;42;133;159;501;201;634
430995;202008;559;1413;403;1159;45;141;222;622;267;763
431000;202008;1336;3123;535;1544;93;293;43;108;136;401
431010;202008;2146;5567;1339;4166;266;914;297;793;563;1707
431020;202008;7886;17095;4594;12113;1054;3143;1542;3530;2596;6673
431030;202008;318;874;155;524;25;91;22;71;47;162
431033;202008;3691;8626;2342;6496;516;1453;829;2321;1345;3774
431036;202008;340;745;78;224;8;24;23;53;31;77
431040;202008;877;2249;565;1688;85;286;256;705;341;991
431041;202008;459;1058;335;871;28;68;201;519;229;587
431043;202008;335;842;182;562;41;143;87;265;128;408
431046;202008;105;274;41;125;4;9;9;29;13;38
431050;202008;1328;3227;939;2598;179;540;465;1307;644;1847
431053;202008;637;1725;359;1112;76;272;114;301;190;573
431055;202008;581;1423;489;1282;58;140;346;908;404;1048
431057;202008;234;668;116;383;26;85;33;99;59;184
431060;202008;5312;13628;3536;10510;847;2768;952;2762;1799;5530
431065;202008;413;1025;290;815;50;155;138;379;188;534
431070;202008;430;1182;241;756;55;188;62;184;117;372
431075;202008;216;623;133;433;30;108;36;117;66;225
431080;202008;575;1552;390;1152;61;214;147;407;208;621
431085;202008;751;1942;467;1290;60;167;238;640;298;807
431087;202008;401;1136;323;971;22;63;225;699;247;762
431090;202008;408;955;158;479;28;95;44;137;72;232
431100;202008;3327;7282;2263;5858;325;851;1154;3043;1479;3894
431110;202008;1372;3145;916;2364;267;718;346;816;613;1534
431112;202008;581;1617;488;1432;67;225;302;849;369;1074
431113;202008;365;1000;313;898;48;156;192;533;240;689
431115;202008;939;2684;724;2281;99;382;415;1216;514;1598
431120;202008;2461;6685;1659;5044;492;1690;373;1026;865;2716
431123;202008;405;1094;257;774;46;119;140;444;186;563
431125;202008;986;2792;749;2322;266;794;263;882;529;1676
431127;202008;201;525;60;195;7;23;13;38;20;61
431130;202008;2917;7424;2113;6065;305;1001;1186;3309;1491;4310
431140;202008;5298;12467;3168;8443;379;1129;1456;3348;1835;4477
431142;202008;498;1325;366;1086;48;147;223;663;271;810
431150;202008;1017;2709;720;2153;132;425;314;902;446;1327
431160;202008;632;1808;419;1329;70;241;127;394;197;635
431162;202008;506;1217;282;810;29;96;155;413;184;509
431164;202008;175;397;40;119;10;30;5;11;15;41
431170;202008;458;1274;319;974;96;295;89;259;185;554
431171;202008;648;1519;523;1349;113;257;307;822;420;1079
431173;202008;391;1038;290;884;75;260;120;343;195;603
431175;202008;1231;2851;749;2019;123;339;285;721;408;1060
431177;202008;787;2135;599;1831;129;455;361;1048;490;1503
431179;202008;332;728;94;282;18;54;21;62;39;116
431180;202008;2111;5329;1277;3686;323;934;359;1017;682;1951
431190;202008;491;1274;250;744;29;94;95;231;124;325
431198;202008;351;1015;281;883;103;345;79;269;182;614
431200;202008;361;897;78;213;16;45;11;30;27;75
431205;202008;195;540;99;322;26;87;37;118;63;205
431210;202008;600;1474;477;1302;123;337;215;624;338;961
431213;202008;251;664;186;542;11;37;97;289;108;326
431215;202008;576;1358;252;727;23;66;128;356;151;422
431217;202008;151;391;101;300;11;34;55;153;66;187
431220;202008;530;1372;310;936;30;109;175;488;205;597
431225;202008;1486;3513;1130;2914;112;302;778;2020;890;2322
431230;202008;685;1948;529;1587;70;223;323;938;393;1161
431235;202008;153;389;23;80;4;10;5;21;9;31
431237;202008;309;976;252;842;49;177;130;416;179;593
431238;202008;27;71;22;61;6;22;8;13;14;35
431240;202008;4324;10631;3348;9092;472;1455;1983;5112;2455;6567
431242;202008;238;641;203;586;42;127;107;300;149;427
431244;202008;319;772;166;469;24;84;61;144;85;228
431245;202008;1273;2972;792;2128;74;214;419;1074;493;1288
431247;202008;266;676;151;435;28;89;60;148;88;237
431250;202008;1655;4124;1215;3526;263;807;626;1897;889;2704
431260;202008;231;635;149;478;23;84;49;150;72;234
431261;202008;236;713;187;632;14;53;104;335;118;388
431262;202008;366;1013;177;573;10;27;118;387;128;414
431265;202008;1566;3686;611;1782;77;268;216;548;293;816
431267;202008;281;733;174;493;8;35;124;315;132;350
431270;202008;2755;6188;1460;3999;338;959;480;1319;818;2278
431275;202008;119;342;60;193;24;74;11;37;35;111
431280;202008;235;634;73;234;6;23;6;12;12;35
431290;202008;308;893;198;609;38;134;38;82;76;216
431295;202008;69;174;20;62;3;8;5;16;8;24
431300;202008;286;735;53;165;5;17;13;27;18;44
431301;202008;308;867;67;215;8;20;6;18;14;38
431303;202008;570;1502;336;991;24;85;152;416;176;501
431306;202008;2242;5245;1328;3711;185;598;580;1426;765;2024
431308;202008;26;79;23;73;11;37;10;31;21;68
431310;202008;532;1491;371;1128;51;162;165;462;216;624
431320;202008;632;1728;319;1038;45;129;60;168;105;297
431330;202008;1680;3926;810;2307;148;479;324;835;472;1314
431333;202008;220;584;112;330;19;55;39;108;58;163
431335;202008;36;103;19;62;4;8;2;6;6;14
431337;202008;2574;6804;1863;5617;348;1189;970;2808;1318;3997
431339;202008;409;1062;296;851;84;248;120;340;204;588
431340;202008;18653;45031;12697;34973;2177;6662;5628;14522;7805;21184
431342;202008;419;896;306;736;23;48;261;631;284;679
431344;202008;389;983;229;676;10;36;124;352;134;388
431346;202008;237;580;91;289;15;53;25;76;40;129
431349;202008;634;1654;327;967;80;234;117;340;197;574
431350;202008;3909;10122;2854;8269;406;1343;1507;4208;1913;5551
431360;202008;559;1323;274;773;85;244;69;193;154;437
431365;202008;2021;4732;1594;4151;123;364;1198;3081;1321;3445
431370;202008;4327;10527;3056;8416;640;1841;1509;4260;2149;6101
431380;202008;775;2079;625;1836;39;128;436;1278;475;1406
431390;202008;2613;6359;1569;4479;166;568;776;1933;942;2501
431395;202008;1268;3153;889;2566;204;609;390;1162;594;1771
431400;202008;323;902;175;548;33;99;41;126;74;225
431402;202008;856;1915;615;1549;75;203;414;1014;489;1217
431403;202008;191;534;145;438;24;72;65;184;89;256
431405;202008;4469;11699;3397;9899;593;1938;1665;4584;2258;6522
431406;202008;537;1512;386;1196;75;227;202;642;277;869
431407;202008;438;1220;302;929;66;223;153;449;219;672
431410;202008;15897;40049;10219;29824;1523;5125;5069;13820;6592;18945
431413;202008;225;595;59;191;7;25;8;28;15;53
431415;202008;662;1625;409;1200;73;259;198;519;271;778
431417;202008;544;1202;368;930;55;159;208;514;263;673
431420;202008;1577;3530;1177;2970;167;434;662;1656;829;2090
431430;202008;547;1405;259;812;42;142;79;218;121;360
431440;202008;29578;69169;20280;54430;3473;10088;7914;19953;11387;30041
431442;202008;115;322;55;187;10;33;10;29;20;62
431445;202008;384;1071;118;378;15;42;9;27;24;69
431446;202008;264;776;197;638;36;130;98;303;134;433
431447;202008;716;1901;410;1240;84;281;141;430;225;711
431449;202008;755;1979;449;1332;88;243;181;554;269;797
431450;202008;2225;4572;1743;3893;86;207;1364;2971;1450;3178
431454;202008;33;103;27;88;7;22;9;28;16;50
431455;202008;608;1443;293;789;36;105;148;360;184;465
431460;202008;2803;6844;1967;5339;517;1478;535;1472;1052;2950
431470;202008;1392;3914;998;3070;194;603;434;1363;628;1966
431475;202008;252;679;49;173;5;18;6;13;11;31
431477;202008;406;1053;238;702;44;127;98;259;142;386
431478;202008;255;668;53;168;11;29;7;17;18;46
431480;202008;3162;7815;2472;6728;582;1595;1258;3463;1840;5058
431490;202008;107942;253706;81090;212244;5950;18428;58768;147804;64718;166232
431500;202008;467;1180;340;937;59;165;182;483;241;648
431505;202008;268;641;183;513;11;35;129;360;140;395
431507;202008;339;798;131;387;41;130;36;99;77;229
431510;202008;1555;3999;1036;2980;224;695;354;1018;578;1713
431513;202008;204;443;115;298;9;19;81;211;90;230
431514;202008;106;266;73;206;3;9;52;141;55;150
431515;202008;472;1166;337;922;76;218;164;440;240;658
431517;202008;61;182;48;149;7;20;22;65;29;85
431520;202008;410;997;157;487;23;83;68;179;91;262
431530;202008;4133;8784;2325;6085;536;1417;567;1507;1103;2924
431531;202008;208;514;124;351;13;39;57;146;70;185
431532;202008;551;1269;327;870;67;202;129;333;196;535
431535;202008;246;654;112;347;22;70;27;75;49;145
431540;202008;1762;5663;1633;5483;56;235;1327;4462;1383;4697
431545;202008;342;882;65;200;6;15;14;43;20;58
431550;202008;2050;5175;1497;4138;248;755;760;2006;1008;2761
431555;202008;647;1466;401;1049;27;84;236;608;263;692
431560;202008;22158;53775;14934;42366;3107;9215;4967;14867;8074;24082
431570;202008;4403;10607;3507;9302;412;1206;2467;6278;2879;7484
431575;202008;246;608;188;506;68;162;46;134;114;296
431580;202008;584;1508;347;1022;40;146;191;530;231;676
431590;202008;575;1590;434;1300;91;291;168;513;259;804
431595;202008;362;972;230;684;48;142;92;247;140;389
431600;202008;1387;3183;952;2552;227;659;377;1025;604;1684
431610;202008;1362;3496;926;2694;135;380;480;1430;615;1810
431620;202008;474;1211;217;628;36;105;85;235;121;340
431630;202008;1309;3240;609;1795;99;319;218;583;317;902
431640;202008;6222;14713;5233;13476;514;1356;3902;10109;4416;11465
431642;202008;545;1336;340;917;25;65;163;407;188;472
431643;202008;386;937;181;508;18;45;56;159;74;204
431645;202008;1798;4013;1387;3454;61;191;1111;2726;1172;2917
431647;202008;276;671;86;245;9;20;26;67;35;87
431650;202008;117;319;76;248;5;19;44;128;49;147
431660;202008;869;2307;430;1385;72;271;119;329;191;600
431670;202008;1136;2693;693;1884;105;301;351;899;456;1200
431673;202008;234;597;81;274;13;44;17;55;30;99
431675;202008;522;1308;111;371;11;41;23;65;34;106
431680;202008;7428;18998;5324;15043;1239;3657;2264;6236;3503;9893
431690;202008;23250;56697;15161;42126;3105;9224;5992;16489;9097;25713
431695;202008;162;388;102;299;23;78;52;131;75;209
431697;202008;447;1053;344;892;48;114;203;539;251;653
431700;202008;1314;3409;1099;3014;157;398;667;1819;824;2217
431710;202008;12667;30329;8717;24592;1518;4616;4331;12347;5849;16963
431720;202008;6266;15485;3644;10360;898;2704;721;1814;1619;4518
431725;202008;31;88;24;74;4;11;10;30;14;41
431730;202008;3885;9279;2375;6869;556;1716;732;2260;1288;3976
431740;202008;5012;11892;3235;8857;866;2754;825;1900;1691;4654
431750;202008;7274;18623;5475;15719;1217;3771;2327;6559;3544;10330
431755;202008;323;884;72;250;9;35;10;35;19;70
431760;202008;5304;11850;3521;9001;405;1184;2100;5067;2505;6251
431770;202008;1877;4386;1449;3813;96;287;1088;2787;1184;3074
431775;202008;199;517;102;315;20;60;15;41;35;101
431780;202008;2033;5043;1284;3638;212;675;541;1458;753;2133
431790;202008;795;2144;567;1700;100;292;253;744;353;1036
431795;202008;231;586;114;339;25;66;29;81;54;147
431800;202008;8111;19377;4935;14258;1283;4331;515;1562;1798;5893
431805;202008;296;696;91;294;8;30;31;96;39;126
431810;202008;3235;7626;2008;5381;378;1055;861;2207;1239;3262
431820;202008;2113;5684;1648;4931;457;1442;570;1791;1027;3233
431830;202008;8971;19287;6535;16040;1654;4791;1969;4810;3623;9601
431840;202008;2498;6562;1978;5708;310;904;1228;3560;1538;4464
431842;202008;533;1349;182;565;25;81;63;173;88;254
431843;202008;331;881;242;691;31;101;120;315;151;416
431844;202008;200;512;65;200;14;47;22;67;36;114
431845;202008;518;1358;360;1042;32;90;211;607;243;697
431846;202008;274;708;229;641;9;29;205;573;214;602
431848;202008;103;265;64;192;9;29;12;29;21;58
431849;202008;413;998;66;191;5;9;8;21;13;30
431850;202008;4077;11028;3106;9075;722;2281;993;2892;1715;5173
431860;202008;649;1567;348;979;59;177;192;518;251;695
431861;202008;96;262;54;167;11;39;15;43;26;82
431862;202008;433;1373;354;1236;67;257;180;602;247;859
431870;202008;19392;49240;15545;43123;1848;5772;9566;25533;11414;31305
431880;202008;3941;10101;2750;7948;439;1455;1256;3437;1695;4892
431890;202008;4476;11211;2727;7862;768;2434;473;1520;1241;3954
431900;202008;961;2417;614;1781;99;320;314;857;413;1177
431910;202008;750;1798;272;763;42;119;86;197;128;316
431912;202008;468;1274;362;1085;74;234;202;599;276;833
431915;202008;1016;2508;792;2139;27;86;611;1615;638;1701
431920;202008;1207;2803;996;2522;30;74;856;2159;886;2233
431930;202008;662;1758;444;1351;151;419;175;571;326;990
431935;202008;82;222;56;169;15;49;11;34;26;83
431936;202008;299;864;161;517;34;114;62;182;96;296
431937;202008;165;412;101;277;16;49;46;101;62;150
431940;202008;2955;6992;1684;4665;186;552;836;2226;1022;2778
431950;202008;1744;4604;1385;4012;443;1314;513;1459;956;2773
431960;202008;2905;7081;2100;5611;578;1624;538;1444;1116;3068
431970;202008;414;1040;164;469;36;100;46;115;82;215
431971;202008;83;214;33;108;2;8;4;8;6;16
431973;202008;473;1508;388;1345;39;141;283;979;322;1120
431975;202008;111;229;23;73;1;4;3;9;4;13
431980;202008;992;2588;761;2204;157;476;356;998;513;1474
431990;202008;5545;13260;3700;10584;476;1653;1813;4932;2289;6585
432000;202008;11118;26518;8039;21714;1946;5332;3448;9410;5394;14742
432010;202008;2157;5276;1567;4246;240;719;910;2323;1150;3042
432020;202008;1748;4489;1071;3078;228;684;442;1210;670;1894
432023;202008;505;1208;262;737;34;108;127;316;161;424
432026;202008;936;2628;683;2134;175;554;232;724;407;1278
432030;202008;359;886;202;564;21;63;118;320;139;383
432032;202008;340;873;233;661;29;93;127;337;156;430
432035;202008;643;1831;556;1681;172;527;231;724;403;1251
432040;202008;1031;2372;369;1127;61;206;127;348;188;554
432045;202008;159;441;96;312;22;70;33;115;55;185
432050;202008;484;1211;355;986;79;218;144;423;223;641
432055;202008;581;1562;376;1170;131;410;74;218;205;628
432057;202008;221;591;164;450;21;51;68;171;89;222
432060;202008;450;1087;140;434;32;108;44;117;76;225
432065;202008;215;595;151;453;34;101;61;180;95;281
432067;202008;725;2095;605;1830;59;198;452;1313;511;1511
432070;202008;1627;4297;1045;3139;234;775;335;906;569;1681
432080;202008;4517;10663;3437;8934;598;1819;1615;3960;2213;5779
432085;202008;339;872;229;702;61;191;90;287;151;478
432090;202008;1559;3934;1007;2874;186;569;489;1295;675;1864
432100;202008;930;2374;459;1410;95;313;91;231;186;544
432110;202008;2008;5348;1347;4141;324;1130;129;361;453;1491
432120;202008;2704;7303;2064;6194;393;1300;811;2316;1204;3616
432130;202008;2496;6377;2054;5728;589;1681;922;2617;1511;4298
432132;202008;181;514;107;350;21;69;50;141;71;210
432135;202008;998;2339;655;1751;38;118;470;1242;508;1360
432140;202008;1586;4744;1191;3933;180;633;694;2283;874;2916
432143;202008;1374;3585;1048;3076;67;216;697;2031;764;2247
432145;202008;1593;4153;988;2876;143;451;345;861;488;1312
432146;202008;98;268;64;209;22;77;21;62;43;139
432147;202008;476;1345;275;906;91;324;71;200;162;524
432149;202008;439;1072;219;615;17;53;108;271;125;324
432150;202008;3061;7760;2223;6266;467;1450;873;2405;1340;3855
432160;202008;5069;13329;3690;11091;906;3031;1335;3795;2241;6826
432162;202008;256;563;36;102;8;20;7;19;15;39
432163;202008;119;292;24;64;0;0;3;4;3;4
432166;202008;604;1686;456;1373;91;298;150;407;241;705
432170;202008;1378;3666;882;2730;162;555;344;970;506;1525
432180;202008;2982;7070;1634;4501;312;906;596;1444;908;2350
432183;202008;366;1066;243;773;58;203;66;190;124;393
432185;202008;797;2055;461;1388;40;136;244;690;284;826
432190;202008;1830;4422;1193;3393;193;615;624;1665;817;2280
432195;202008;886;2230;577;1672;165;446;198;608;363;1054
432200;202008;3197;8129;2279;6637;379;1124;1260;3720;1639;4844
432210;202008;385;1014;237;720;43;163;107;273;150;436
432215;202008;615;1802;555;1710;54;147;411;1289;465;1436
432218;202008;247;612;110;311;15;53;52;133;67;186
432220;202008;3453;8150;2546;6702;449;1254;1370;3529;1819;4783
432225;202008;90;256;68;211;10;33;40;124;50;157
432230;202008;708;1646;374;1013;39;108;169;410;208;518
432232;202008;483;1184;300;865;60;183;108;282;168;465
432234;202008;268;663;123;357;21;51;15;40;36;91
432235;202008;49;139;17;55;5;17;4;13;9;30
432237;202008;322;826;280;756;11;22;231;613;242;635
432240;202008;15340;37954;10989;32056;831;2575;6945;21280;7776;23855
432250;202008;5105;14606;3866;12120;995;3276;1609;4993;2604;8269
432252;202008;440;1045;272;749;35;103;142;374;177;477
432253;202008;887;2717;555;1866;131;468;48;147;179;615
432254;202008;688;1616;176;519;27;82;33;88;60;170
432255;202008;109;276;56;170;3;9;27;73;30;82
432260;202008;4780;12254;3517;9842;1006;2908;1135;3032;2141;5940
432270;202008;1742;4881;1381;4176;409;1340;283;797;692;2137
432280;202008;1343;3340;685;2024;99;307;256;625;355;932
432285;202008;142;429;21;64;2;6;2;4;4;10
432290;202008;336;941;181;564;60;191;34;77;94;268
432300;202008;25595;64532;18933;53637;2744;8771;10958;29928;13702;38699
432310;202008;824;2211;591;1772;62;192;402;1204;464;1396
432320;202008;214;502;78;238;8;29;29;78;37;107
432330;202008;226;501;63;204;6;13;12;37;18;50
432335;202008;182;504;63;220;5;21;15;50;20;71
432340;202008;306;738;137;427;11;32;52;149;63;181
432345;202008;669;1533;588;1433;18;48;484;1163;502;1211
432350;202008;340;889;184;582;27;89;73;231;100;320
432360;202008;235;684;46;150;4;7;16;54;20;61
432370;202008;303;745;199;566;15;51;134;370;149;421
432375;202008;471;1182;345;932;63;164;174;473;237;637
432377;202008;178;561;32;109;7;28;5;15;12;43
432380;202008;1627;4308;1046;3237;180;637;527;1570;707;2207
500020;202008;2478;6432;1782;5246;157;551;1109;3158;1266;3709
500025;202008;1203;2944;746;2077;71;212;401;1061;472;1273
500060;202008;7788;21905;5264;16616;653;2130;3037;9855;3690;11985
500070;202008;4207;10880;2891;8612;537;1635;1237;3770;1774;5405
500080;202008;1578;3895;954;2730;182;578;366;916;548;1494
500085;202008;2033;5044;1380;3951;319;960;648;1782;967;2742
500090;202008;2132;5644;1428;4398;245;803;488;1596;733;2399
500100;202008;3544;9036;2680;7626;451;1452;1305;3521;1756;4973
500110;202008;7973;20324;5052;15623;1072;3644;1516;5523;2588;9167
500124;202008;2027;5942;1605;5223;256;781;848;2908;1104;3689
500150;202008;1313;2975;811;2240;139;403;334;910;473;1313
500190;202008;4741;12250;2981;8814;641;1937;751;2136;1392;4073
500200;202008;2260;5370;1647;4337;184;500;998;2524;1182;3024
500210;202008;4572;11091;3232;9319;870;2472;1410;4180;2280;6652
500215;202008;1373;3822;981;3095;95;329;542;1691;637;2020
500220;202008;2575;7227;1629;5383;276;991;401;1261;677;2252
500230;202008;2019;4730;1516;4025;177;435;1015;2679;1192;3114
500240;202008;3889;11460;2722;8990;412;1524;1086;3672;1498;5196
500260;202008;3219;6836;2021;5191;271;706;1063;2619;1334;3325
500270;202008;136180;319317;80520;224112;13338;40887;29843;77817;43181;118704
500280;202008;1312;3313;892;2655;126;395;485;1417;611;1812
500290;202008;3582;8469;2032;5859;319;1062;664;1714;983;2776
500295;202008;3428;8298;2116;5950;332;1029;811;1972;1143;3001
500310;202008;960;1997;643;1595;100;215;327;843;427;1058
500315;202008;3700;10251;2907;9052;244;793;2057;6522;2301;7315
500320;202008;19293;51748;13291;41767;3362;11118;4556;15203;7918;26321
500325;202008;4241;9468;2898;7676;225;627;1965;5255;2190;5882
500330;202008;6655;15173;4356;11796;370;1107;2342;6511;2712;7618
500345;202008;2065;5074;1371;3988;326;990;458;1315;784;2305
500348;202008;2331;6045;1775;5090;242;712;1014;2960;1256;3672
500350;202008;1295;3532;710;2244;90;284;287;867;377;1151
500370;202008;25781;66089;17976;53193;2354;7993;9465;27657;11819;35650
500375;202008;2415;6355;1583;4651;293;935;527;1447;820;2382
500380;202008;3358;8396;2266;6517;631;1966;525;1530;1156;3496
500390;202008;618;1258;363;944;55;177;216;531;271;708
500400;202008;1497;3790;990;2803;177;582;347;858;524;1440
500410;202008;2388;5872;1668;4786;184;519;954;2869;1138;3388
500430;202008;2559;6256;1708;4977;220;751;733;2254;953;3005
500440;202008;1210;2942;754;2228;116;377;284;891;400;1268
500450;202008;1472;3628;823;2437;140;442;215;592;355;1034
500460;202008;3606;9703;2179;6851;359;1290;685;2099;1044;3389
500470;202008;2422;6516;1454;4503;406;1405;315;848;721;2253
500480;202008;2094;6357;1768;5832;175;598;1304;4370;1479;4968
500490;202008;1051;2427;614;1772;126;443;168;488;294;931
500500;202008;4198;11211;2660;8666;931;3566;441;1476;1372;5042
500510;202008;681;1742;437;1276;29;100;264;745;293;845
500515;202008;1709;4366;1303;3715;138;433;820;2238;958;2671
500520;202008;3188;9782;2450;8410;636;2214;981;3600;1617;5814
500525;202008;860;2558;704;2318;56;195;448;1495;504;1690
500540;202008;4414;11471;2643;8315;687;2704;243;685;930;3389
500560;202008;5392;14641;4306;13271;282;884;3450;10815;3732;11699
500568;202008;4290;9366;2581;6821;622;1750;905;2423;1527;4173
500570;202008;7601;17710;4602;12591;834;2483;1710;4369;2544;6852
500580;202008;2979;7936;2157;6480;475;1483;998;3017;1473;4500
500600;202008;3386;8421;2389;6840;536;1592;989;2888;1525;4480
500620;202008;7762;20350;5187;15422;1081;3366;1891;5447;2972;8813
500625;202008;543;1484;343;1053;64;209;92;258;156;467
500627;202008;765;1983;456;1426;77;262;148;457;225;719
500630;202008;6575;15173;3764;10472;767;2342;1106;3077;1873;5419
500635;202008;2870;8997;2223;8146;166;652;1538;6171;1704;6823
500640;202008;1696;3728;1114;2952;39;124;758;1981;797;2105
500660;202008;17474;44919;11934;36828;3724;13069;2986;9465;6710;22534
500690;202008;2292;6391;1482;4967;518;2019;76;189;594;2208
500710;202008;2777;7467;2128;6345;601;1893;666;1880;1267;3773
500720;202008;4780;12104;3085;9277;704;2243;922;2864;1626;5107
500730;202008;1068;2639;579;1737;113;323;140;452;253;775
500740;202008;4546;10811;3072;8462;404;1159;1587;4363;1991;5522
500750;202008;958;2456;634;1860;82;243;241;649;323;892
500755;202008;908;2377;495;1573;85;298;104;293;189;591
500769;202008;5044;12338;2712;7898;522;1714;382;906;904;2620
500770;202008;1462;3950;940;3018;166;616;318;1008;484;1624
500780;202008;1209;2927;772;2190;159;509;203;537;362;1046
500790;202008;7006;18623;5413;15952;1113;3532;2645;7836;3758;11368
500793;202008;2019;5196;1428;4161;357;1115;463;1242;820;2357
500795;202008;2686;6641;2172;5990;108;273;1738;5051;1846;5324
500797;202008;676;1716;443;1280;128;383;135;392;263;775
500800;202008;3177;7194;1893;5269;580;1911;209;633;789;2544
500830;202008;18161;45346;12284;34491;2558;7710;4443;11783;7001;19493
500840;202008;1377;3360;843;2354;101;290;337;885;438;1175
510010;202008;1786;4034;1181;3252;108;279;841;2353;949;2632
510020;202008;3329;8427;1751;5334;371;1214;398;1093;769;2307
510025;202008;6528;15953;3946;11707;581;1962;1633;4686;2214;6648
510030;202008;2494;5592;1639;4310;343;921;636;1635;979;2556
510035;202008;1201;3134;755;2420;84;294;449;1524;533;1818
510040;202008;2277;5068;1665;4273;173;431;1034;2771;1207;3202
510050;202008;2077;4370;1360;3437;152;417;948;2351;1100;2768
510060;202008;1294;3285;934;2707;196;624;267;725;463;1349
510080;202008;1210;3193;770;2445;267;877;210;577;477;1454
510100;202008;642;1503;443;1188;55;153;233;602;288;755
510120;202008;269;489;147;345;10;22;107;255;117;277
510125;202008;2001;4947;1561;4313;159;571;831;2149;990;2720
510130;202008;1412;3552;983;2864;205;653;308;920;513;1573
510140;202008;3037;7848;2062;6614;735;2760;726;2187;1461;4947
510160;202008;1696;4364;1238;3769;159;463;899;2809;1058;3272
510170;202008;4389;11597;3183;9644;778;2493;1236;3815;2014;6308
510180;202008;14527;32541;9105;24548;1987;5885;2720;8282;4707;14167
510185;202008;1686;4352;1096;3506;439;1430;282;1165;721;2595
510190;202008;2048;5849;1315;4602;361;1387;230;886;591;2273
510250;202008;16592;41893;12240;35361;2346;7100;6160;18528;8506;25628
510260;202008;1878;7913;1552;7321;261;1326;940;4832;1201;6158
510263;202008;3085;8574;1890;6137;315;1154;298;832;613;1986
510267;202008;4803;13608;2721;8974;497;1738;378;1117;875;2855
510268;202008;1239;3025;935;2566;110;286;614;1685;724;1971
510269;202008;990;2686;603;1948;145;517;185;551;330;1068
510270;202008;2864;8173;1955;6518;348;1285;803;2649;1151;3934
510279;202008;1730;4459;1068;3296;200;689;438;1310;638;1999
510285;202008;1114;2921;758;2304;240;818;161;438;401;1256
510300;202008;3607;9122;2640;7809;369;1132;1548;4793;1917;5925
510305;202008;1413;3881;852;2784;183;638;196;717;379;1355
510310;202008;906;2213;606;1708;170;498;171;506;341;1004
510320;202008;3592;8904;2443;6930;552;1718;616;1726;1168;3444
510325;202008;4205;12383;3118;10388;887;3128;941;3245;1828;6373
510330;202008;2643;7991;1781;6461;346;1258;661;2780;1007;4038
510335;202008;4739;13591;3571;11721;541;1914;2018;6799;2559;8713
510336;202008;440;1237;315;1036;52;171;158;575;210;746
510337;202008;1484;4303;947;3325;365;1407;184;655;549;2062
510340;202008;90038;199933;56399;150789;13627;43231;16555;41541;30182;84772
510343;202008;1002;2753;681;2155;122;438;286;860;408;1298
510345;202008;1234;3536;926;2928;156;491;418;1301;574;1792
510350;202008;2794;7211;1819;5546;388;1266;732;2171;1120;3437
510360;202008;1845;3832;1182;3052;69;135;815;2275;884;2410
510370;202008;1743;4914;1255;4075;177;636;731;2476;908;3112
510380;202008;555;1370;306;938;54;190;116;349;170;539
510385;202008;1200;4009;877;3399;90;409;554;2212;644;2621
510390;202008;1243;3292;837;2765;250;834;277;1076;527;1910
510395;202008;711;1611;474;1260;26;73;295;833;321;906
510410;202008;4663;13011;3371;10694;655;2166;1732;5698;2387;7864
510420;202008;2407;5066;1629;4029;133;351;1055;2598;1188;2949
510450;202008;424;1055;248;719;60;175;38;125;98;300
510452;202008;755;2109;536;1696;73;251;306;942;379;1193
510454;202008;932;2560;712;2183;76;233;437;1402;513;1635
510455;202008;918;2536;657;2007;108;356;266;757;374;1113
510460;202008;1735;4292;1225;3536;93;331;783;2165;876;2496
510480;202008;4515;10846;2948;7985;568;1710;1163;3081;1731;4791
510490;202008;1649;4262;1224;3727;174;526;796;2456;970;2982
510500;202008;1489;3735;916;2801;181;593;306;946;487;1539
510510;202008;3379;9865;2487;8258;602;2250;787;2754;1389;5004
510515;202008;5222;13386;3408;10123;801;2669;892;2326;1693;4995
510517;202008;1027;2995;778;2572;237;873;144;417;381;1290
510520;202008;2064;4204;1171;3087;89;232;599;1700;688;1932
510523;202008;1096;2704;813;2253;175;466;465;1332;640;1798
510525;202008;7146;19484;5330;15949;820;2714;2573;7296;3393;10010
510530;202008;553;1421;402;1197;29;93;256;748;285;841
510550;202008;2327;6893;1669;5736;385;1390;749;2586;1134;3976
510558;202008;2246;6023;1627;5035;222;660;755;2551;977;3211
510560;202008;1584;4531;934;3231;192;754;233;874;425;1628
510562;202008;5541;14348;3980;11531;930;2913;1341;4081;2271;6994
510590;202008;3116;7652;2210;6498;172;525;1573;4725;1745;5250
510600;202008;1381;3121;886;2403;160;438;400;1100;560;1538
510610;202008;2590;6247;1769;5168;171;568;1110;3255;1281;3823
510615;202008;2615;6510;1807;5206;304;911;962;2841;1266;3752
510617;202008;976;2937;747;2562;101;398;468;1666;569;2064
510618;202008;1221;3227;835;2555;189;636;385;1120;574;1756
510619;202008;746;1876;475;1419;66;207;135;382;201;589
510620;202008;1405;3161;649;1927;171;625;35;74;206;699
510621;202008;1517;4046;913;2880;197;690;285;840;482;1530
510622;202008;4436;12531;2996;9419;1007;3390;421;1211;1428;4601
510623;202008;2658;6541;1865;5288;447;1483;599;1644;1046;3127
510624;202008;1647;4142;768;2535;91;322;176;527;267;849
510625;202008;2822;6893;1498;4503;248;889;332;1011;580;1900
510626;202008;1478;3558;916;2658;250;840;212;611;462;1451
510627;202008;602;1559;334;1034;82;281;83;273;165;554
510628;202008;1438;3322;945;2660;194;585;354;982;548;1567
510629;202008;1541;4371;1134;3638;225;772;416;1329;641;2101
510630;202008;3246;9020;1878;6402;435;1589;336;1222;771;2811
510631;202008;577;1387;417;1148;14;38;317;904;331;942
510637;202008;3391;8140;2423;6740;609;1914;684;1914;1293;3828
510642;202008;5342;15181;4031;13182;978;3476;1731;5795;2709;9271
510645;202008;973;1880;573;1371;176;389;223;548;399;937
510650;202008;6927;17728;5474;16126;632;1669;3737;12190;4369;13859
510665;202008;1894;4078;1163;2894;243;583;430;1154;673;1737
510670;202008;432;924;250;663;25;66;140;381;165;447
510675;202008;6119;16807;4162;13120;1188;4131;748;2261;1936;6392
510677;202008;2059;5288;1411;4305;201;711;756;2238;957;2949
510680;202008;689;1763;380;1178;72;249;80;229;152;478
510682;202008;1491;4396;1086;3723;375;1423;244;806;619;2229
510685;202008;524;1529;374;1218;58;205;187;603;245;808
510700;202008;4048;9713;2811;7960;264;819;2061;5825;2325;6644
510704;202008;10569;24769;6888;18420;1518;4378;1762;4571;3280;8949
510706;202008;1958;5898;1383;4931;265;960;731;2836;996;3796
510710;202008;2628;6552;1694;4790;372;1090;566;1536;938;2626
510715;202008;594;1314;429;1086;34;106;211;520;245;626
510718;202008;2336;5238;1348;3903;396;1155;456;1611;852;2766
510719;202008;440;931;255;687;22;61;149;379;171;440
510720;202008;877;2047;564;1573;93;297;265;697;358;994
510724;202008;809;2181;555;1701;82;262;301;899;383;1161
510726;202008;1040;1884;547;1287;63;163;263;627;326;790
510729;202008;595;1386;259;749;32;107;63;198;95;305
510730;202008;2886;6966;1919;5452;248;799;951;2644;1199;3443
510735;202008;995;2856;752;2511;75;314;551;1817;626;2131
510740;202008;938;2312;588;1657;102;289;261;728;363;1017
510757;202008;500;1537;391;1369;123;476;141;478;264;954
510760;202008;43416;95167;25776;68032;5228;15890;8119;19659;13347;35549
510770;202008;4204;9485;2842;7769;241;608;1933;5558;2174;6166
510774;202008;341;869;233;691;37;110;121;367;158;477
510775;202008;604;1603;384;1241;80;283;84;252;164;535
510776;202008;417;1046;295;821;71;196;97;290;168;486
510777;202008;1483;3957;1057;3403;146;543;676;2155;822;2698
510779;202008;669;1796;514;1546;58;166;290;953;348;1119
510780;202008;3662;9350;2675;7954;652;1913;1145;3861;1797;5774
510785;202008;1967;5202;1134;3672;296;1035;185;685;481;1720
510787;202008;2611;7384;1712;5496;550;1868;196;631;746;2499
510788;202008;586;1394;410;1121;65;188;194;603;259;791
510790;202008;17459;44973;10575;32182;2233;7627;1751;4749;3984;12376
510792;202008;9128;24829;5641;18103;1206;4380;958;2710;2164;7090
510794;202008;1204;3202;813;2527;249;853;155;427;404;1280
510795;202008;8037;21107;5182;15908;1173;3985;1353;4078;2526;8063
510800;202008;1658;4277;1073;3283;353;1106;129;376;482;1482
510805;202008;1486;4125;1026;3261;248;838;338;985;586;1823
510810;202008;618;1263;389;955;105;262;154;401;259;663
510820;202008;750;1427;414;999;34;100;214;522;248;622
510830;202008;836;2028;596;1720;51;145;417;1285;468;1430
510835;202008;554;1336;359;1050;37;126;220;628;257;754
510840;202008;54233;114554;36788;93212;7240;17276;18032;50767;25272;68043
510850;202008;1784;4285;1006;3045;329;1139;126;350;455;1489
510860;202008;2301;6107;1418;4594;433;1639;115;361;548;2000
510880;202008;702;1977;528;1648;126;407;188;596;314;1003
510885;202008;561;1371;388;1127;80;256;127;361;207;617
510890;202008;635;1857;473;1577;107;379;214;713;321;1092
510895;202008;1272;3246;847;2554;166;596;368;1037;534;1633
520005;202008;2569;6521;1972;5786;572;1688;818;2756;1390;4444
520010;202008;2221;6321;1590;5123;391;1406;482;1374;873;2780
520013;202008;2752;7060;1796;5296;397;1205;512;1649;909;2854
520015;202008;503;1265;356;1047;82;252;142;436;224;688
520017;202008;1160;2951;866;2497;157;479;473;1348;630;1827
520020;202008;397;879;304;762;23;77;237;565;260;642
520025;202008;32983;92141;28208;85410;2826;9304;20231;60970;23057;70274
520030;202008;5631;14326;4485;12720;307;961;3181;8964;3488;9925
520050;202008;404;946;250;683;14;41;158;443;172;484
520055;202008;1782;4307;1147;3077;99;250;654;1710;753;1960
520060;202008;1387;3818;994;3097;254;878;246;770;500;1648
520080;202008;1772;4595;1318;3979;234;712;644;2126;878;2838
520082;202008;903;2289;700;1950;80;207;370;1085;450;1292
520085;202008;812;2174;627;1871;114;347;303;890;417;1237
520090;202008;830;1627;567;1338;57;91;435;1081;492;1172
520110;202008;38033;101940;26139;82059;7907;28393;2319;6586;10226;34979
520120;202008;201;474;115;335;14;49;46;131;60;180
520130;202008;3613;8847;2817;7613;558;1533;1200;3337;1758;4870
520140;202008;40079;106807;27619;85380;9840;33044;3569;11468;13409;44512
520145;202008;602;1392;408;1116;62;195;242;610;304;805
520150;202008;623;1404;451;1195;74;196;243;656;317;852
520160;202008;744;1729;535;1399;104;262;236;661;340;923
520170;202008;4899;9843;3233;7934;178;502;2482;6036;2660;6538
520180;202008;2177;5912;1771;5327;324;1065;985;2947;1309;4012
520215;202008;1681;4045;1190;3290;276;828;412;1076;688;1904
520235;202008;592;1353;340;966;37;128;129;355;166;483
520250;202008;1540;3927;1055;3104;330;1051;247;783;577;1834
520260;202008;791;1836;502;1382;94;269;207;587;301;856
520280;202008;704;1728;545;1484;117;323;257;747;374;1070
520310;202008;1029;2244;670;1708;148;431;262;699;410;1130
520320;202008;1601;4288;1206;3658;151;503;663;1972;814;2475
520330;202008;3868;10363;2803;8633;415;1519;1470;4421;1885;5940
520340;202008;2430;5365;1513;4086;176;445;885;2510;1061;2955
520350;202008;2819;6720;1993;5471;592;1708;754;2102;1346;3810
520355;202008;1825;4968;1286;3890;430;1410;285;748;715;2158
520357;202008;739;1778;525;1464;29;75;392;1125;421;1200
520360;202008;703;1832;533;1553;141;432;154;480;295;912
520380;202008;1407;3485;823;2401;88;269;418;1146;506;1415
520390;202008;1003;2203;590;1692;161;500;202;623;363;1123
520393;202008;492;1177;326;916;39;124;149;390;188;514
520396;202008;834;2143;694;1921;39;129;515;1384;554;1513
520400;202008;1586;3880;1206;3362;154;469;813;2262;967;2731
520410;202008;1960;4423;1175;3213;197;581;449;1175;646;1756
520420;202008;365;837;283;712;21;57;223;540;244;597
520425;202008;1447;3534;800;2324;206;628;149;415;355;1043
520430;202008;2272;5208;1263;3622;234;784;44;120;278;904
520440;202008;2912;7039;1737;4969;420;1326;456;1236;876;2562
520450;202008;11817;27939;7761;21844;2421;7460;1513;4375;3934;11835
520455;202008;693;1888;501;1597;143;480;140;463;283;943
520460;202008;1010;2347;781;2056;73;167;626;1683;699;1850
520465;202008;769;1938;614;1729;77;257;435;1173;512;1430
520470;202008;2029;5229;1545;4583;478;1476;589;1871;1067;3347
520480;202008;920;2552;630;2047;191;644;147;497;338;1141
520485;202008;1536;4342;1282;3989;160;508;912;2834;1072;3342
520490;202008;3925;10808;2905;9163;1002;3273;1044;3443;2046;6716
520495;202008;1582;3462;1192;2932;51;127;960;2363;1011;2490
520500;202008;1197;3223;810;2462;189;614;326;998;515;1612
520505;202008;766;1675;530;1374;59;160;345;882;404;1042
520510;202008;7627;18895;5000;14810;1136;3769;1389;4430;2525;8199
520520;202008;1138;2860;839;2388;196;612;302;862;498;1474
520530;202008;2082;5802;1559;4943;413;1382;642;2118;1055;3500
520540;202008;2841;7449;1760;5317;323;1053;446;1261;769;2314
520545;202008;940;2442;699;2049;145;418;283;844;428;1262
520547;202008;795;2159;632;1888;152;455;318;958;470;1413
520549;202008;13468;35765;11113;32319;1472;4562;7528;21722;9000;26284
520551;202008;4488;12048;3722;10923;388;1338;2647;7594;3035;8932
520552;202008;813;2086;667;1899;140;394;383;1156;523;1550
520570;202008;521;1156;343;906;84;195;135;405;219;600
520580;202008;2183;4961;1644;4331;114;371;1213;3139;1327;3510
520590;202008;1237;3087;852;2469;264;775;227;674;491;1449
520620;202008;7916;21403;6177;18858;1555;4891;2737;8645;4292;13536
520630;202008;727;1858;502;1463;85;263;146;400;231;663
520640;202008;2341;5792;1780;4815;416;1109;747;2096;1163;3205
520650;202008;843;1960;618;1648;92;241;346;978;438;1219
520660;202008;533;1288;280;841;54;187;74;218;128;405
520670;202008;936;2511;783;2292;62;187;518;1492;580;1679
520680;202008;686;1740;512;1462;80;223;265;767;345;990
520690;202008;323;747;218;595;65;163;69;215;134;378
520710;202008;412;992;289;782;12;28;209;554;221;582
520725;202008;1494;3500;1013;2724;114;358;635;1639;749;1997
520735;202008;762;1859;499;1425;106;286;187;578;293;864
520740;202008;2077;4670;1554;4054;270;649;877;2476;1147;3125
520750;202008;649;1566;445;1238;73;198;218;612;291;810
520753;202008;1254;3324;947;2755;181;556;384;1054;565;1610
520760;202008;1192;2665;1045;2490;29;54;958;2319;987;2373
520780;202008;1484;3451;1046;2836;116;323;534;1434;650;1757
520790;202008;3362;7983;2366;6349;326;891;1297;3657;1623;4548
520800;202008;16139;41609;12475;36243;1883;5704;7293;21794;9176;27498
520810;202008;1311;2718;965;2323;157;392;615;1564;772;1956
520815;202008;566;1722;420;1425;76;286;120;418;196;704
520830;202008;1819;3832;1289;3236;50;107;1063;2647;1113;2754
520840;202008;2536;6790;2043;6147;858;2808;548;1761;1406;4569
520850;202008;636;1637;466;1384;157;543;122;371;279;914
520860;202008;6321;16961;4561;14092;1206;4025;1656;5054;2862;9079
520870;202008;105122;242756;69971;190343;15268;45102;24910;66580;40178;111682
520880;202008;6613;18998;5080;16254;1175;3949;1884;6066;3059;10015
520890;202008;3880;9305;2620;7330;512;1570;1139;3161;1651;4731
520910;202008;4526;11372;2843;8442;699;2234;665;1942;1364;4176
520915;202008;703;1957;412;1297;70;240;139;423;209;663
520920;202008;4328;9684;3016;8025;379;1041;1664;4632;2043;5673
520929;202008;685;1598;513;1345;65;139;266;750;331;889
520940;202008;954;2517;735;2211;42;133;538;1588;580;1721
520945;202008;473;1061;378;925;15;36;271;651;286;687
520960;202008;1030;2478;807;2137;173;400;453;1247;626;1647
520970;202008;2492;6828;1933;5927;479;1658;494;1626;973;3284
520980;202008;772;1863;560;1573;101;299;226;617;327;916
520990;202008;2958;7852;2358;7061;344;988;1544;4734;1888;5722
520993;202008;1134;2654;776;2094;114;347;438;1124;552;1471
520995;202008;2236;5645;1664;4843;265;783;652;1961;917;2744
521000;202008;8461;22044;5531;16763;1121;3529;1661;5015;2782;8544
521010;202008;3582;9308;2663;7715;258;751;1547;4443;1805;5194
521015;202008;783;1922;538;1495;42;133;338;895;380;1028
521020;202008;3183;8094;1844;5512;542;1816;131;418;673;2234
521030;202008;486;1066;323;817;68;153;133;366;201;519
521040;202008;7578;18541;5550;15329;1198;3451;2337;6593;3535;10044
521056;202008;917;2408;713;2102;223;649;195;648;418;1297
521060;202008;950;2519;695;2051;100;309;284;834;384;1143
521080;202008;1113;2387;559;1526;74;217;235;558;309;775
521090;202008;3209;8575;2155;6488;592;1908;273;864;865;2772
521100;202008;1726;4012;1214;3284;195;517;715;1965;910;2482
521120;202008;4614;10789;3315;9189;200;510;1625;5258;1825;5768
521130;202008;998;2237;554;1470;20;61;292;822;312;883
521140;202008;1251;3209;905;2605;113;348;439;1275;552;1623
521150;202008;12288;26812;7555;20061;1267;3906;3544;9615;4811;13521
521160;202008;631;1312;444;1039;49;111;292;661;341;772
521170;202008;1010;2359;726;1940;55;151;492;1291;547;1442
521180;202008;7162;19721;5862;17460;944;3048;3049;8785;3993;11833
521190;202008;10481;25983;6032;18483;1533;5016;1220;3978;2753;8994
521200;202008;699;1700;484;1349;49;145;275;766;324;911
521205;202008;622;1537;466;1288;16;53;350;922;366;975
521210;202008;682;1739;387;1148;78;249;72;162;150;411
521220;202008;3577;8712;2282;6677;392;1290;863;2506;1255;3796
521225;202008;387;822;280;706;53;129;156;401;209;530
521230;202008;1336;3392;1171;3189;373;1031;585;1699;958;2730
521250;202008;30663;81358;23601;70972;8702;27471;6857;22017;15559;49488
521260;202008;550;1268;395;1023;55;143;225;575;280;718
521270;202008;1807;4553;1571;4276;87;204;1197;3286;1284;3490
521280;202008;1765;4724;1304;3949;309;1036;546;1673;855;2709
521290;202008;480;1113;335;926;45;145;210;560;255;705
521295;202008;1099;2370;827;2070;63;114;676;1753;739;1867
521300;202008;1857;4555;1452;3983;271;699;908;2576;1179;3275
521305;202008;717;1701;509;1390;75;189;290;798;365;987
521308;202008;4748;12657;3282;9852;307;906;1918;5672;2225;6578
521310;202008;8158;20749;5604;16450;1211;3889;2322;6512;3533;10401
521340;202008;409;958;298;795;20;56;196;502;216;558
521350;202008;2017;5105;1514;4346;128;460;1070;2923;1198;3383
521370;202008;1221;3082;716;2208;203;723;90;302;293;1025
521375;202008;1293;3138;866;2526;197;572;267;868;464;1440
521377;202008;1493;3132;1085;2632;95;160;870;2222;965;2382
521380;202008;6097;16125;3912;12088;410;1385;1040;3443;1450;4828
521385;202008;646;1548;496;1356;56;142;284;839;340;981
521390;202008;709;1728;493;1406;143;450;179;539;322;989
521400;202008;2627;6060;2029;5332;224;581;1404;3788;1628;4369
521405;202008;1282;3272;923;2652;177;520;447;1269;624;1789
521410;202008;797;2129;589;1761;104;296;294;935;398;1231
521440;202008;1161;2910;825;2400;279;889;229;673;508;1562
521450;202008;3905;11530;2845;9468;746;2501;732;2601;1478;5102
521460;202008;5631;14729;3912;11677;1315;4111;898;2756;2213;6867
521470;202008;605;1630;360;1117;48;144;119;362;167;506
521480;202008;363;912;216;632;46;133;70;198;116;331
521483;202008;2407;5707;1667;4574;356;1046;657;1786;1013;2832
521486;202008;1769;4162;1312;3520;81;208;947;2533;1028;2741
521487;202008;406;984;285;816;44;128;145;423;189;551
521490;202008;899;2373;661;1985;36;130;455;1324;491;1454
521500;202008;2267;5482;1664;4540;101;339;1201;3183;1302;3522
521520;202008;722;1672;508;1357;73;205;210;573;283;778
521523;202008;11430;34903;9317;31460;2565;9516;2487;8685;5052;18201
521525;202008;1042;2367;767;1984;74;198;553;1415;627;1613
521530;202008;2241;5768;1308;3872;279;858;348;1032;627;1890
521540;202008;841;2107;569;1657;74;248;277;835;351;1083
521550;202008;1596;4010;844;2490;151;502;217;656;368;1158
521560;202008;4484;11709;3052;9768;456;1716;1542;5231;1998;6947
521565;202008;634;1518;484;1308;73;178;294;790;367;968
521570;202008;3384;9203;2214;6935;436;1605;202;670;638;2275
521580;202008;484;1166;279;819;40;120;88;236;128;356
521590;202008;642;1500;469;1255;82;241;270;707;352;948
521600;202008;378;1007;247;753;34;84;107;327;141;411
521630;202008;1656;3609;1001;2648;203;584;349;895;552;1479
521640;202008;1799;4152;1188;3276;255;737;412;1123;667;1860
521645;202008;545;1413;344;1048;82;237;110;336;192;573
521680;202008;1084;3270;828;2772;239;873;124;456;363;1329
521690;202008;532;1284;439;1160;60;169;278;723;338;892
521710;202008;3188;7896;2013;5973;361;1218;504;1397;865;2615
521720;202008;2179;5016;1394;3824;142;434;782;2158;924;2592
521730;202008;3544;9833;2687;8336;738;2696;753;1966;1491;4662
521740;202008;3837;9990;2859;8557;696;2239;1075;3364;1771;5603
521760;202008;14662;40004;11255;34726;2859;9782;4141;13372;7000;23154
521770;202008;2969;7092;1942;5427;576;1739;494;1390;1070;3129
521800;202008;6417;17095;4609;14068;1033;3215;1839;6076;2872;9291
521805;202008;477;1159;354;984;106;269;151;434;257;703
521810;202008;609;1429;426;1180;62;171;252;709;314;880
521830;202008;5465;15098;4303;13295;288;1078;3097;9389;3385;10467
521839;202008;730;1718;507;1357;82;252;277;663;359;915
521850;202008;5461;12653;3411;9594;577;1828;626;1690;1203;3518
521860;202008;1513;3991;1030;3143;186;624;320;961;506;1585
521870;202008;683;1899;487;1511;100;342;126;346;226;688
521878;202008;672;1726;453;1294;57;193;245;630;302;823
521880;202008;18476;44863;12365;35422;3103;9389;4348;12678;7451;22067
521890;202008;3039;7840;1979;5975;559;1834;362;1002;921;2836
521900;202008;1473;3446;818;2424;230;654;90;266;320;920
521910;202008;1234;2604;810;2108;73;189;452;1289;525;1478
521920;202008;475;1301;350;1080;63;221;148;435;211;656
521925;202008;741;1924;533;1620;81;257;292;882;373;1139
521930;202008;5398;12877;3519;10002;902;2397;1316;4174;2218;6571
521935;202008;1044;2474;690;1846;65;185;411;1043;476;1228
521940;202008;1336;2933;853;2273;200;589;338;882;538;1471
521945;202008;592;1588;480;1401;102;306;261;774;363;1080
521950;202008;746;1797;512;1428;122;345;206;556;328;901
521960;202008;714;1835;459;1359;55;177;241;663;296;840
521970;202008;2522;6156;1998;5528;164;449;1520;4257;1684;4706
521971;202008;755;1775;530;1444;153;412;150;416;303;828
521973;202008;1389;3572;1101;3141;41;119;854;2420;895;2539
521975;202008;11840;31072;9625;27974;1560;4732;5989;17481;7549;22213
521980;202008;2532;5890;1931;5090;150;385;1449;3919;1599;4304
521990;202008;1068;3007;841;2599;180;592;302;935;482;1527
522000;202008;2602;6801;2087;6162;304;887;1301;4030;1605;4917
522005;202008;337;808;253;682;49;127;125;349;174;476
522010;202008;3920;9509;2742;7610;609;1865;1016;2749;1625;4614
522015;202008;1006;2606;739;2197;232;670;267;831;499;1501
522020;202008;5475;12976;3559;9941;732;2142;1415;4089;2147;6231
522026;202008;766;2036;509;1568;91;306;179;513;270;819
522028;202008;422;1038;311;859;69;198;133;362;202;560
522040;202008;3058;6883;2159;5675;266;742;1452;3776;1718;4518
522045;202008;17317;47918;12705;39684;3004;10129;3473;10562;6477;20691
522050;202008;1091;2858;736;2239;196;672;258;694;454;1366
522060;202008;2893;7546;1988;6040;173;517;1146;3599;1319;4116
522068;202008;1815;4583;1413;4098;119;319;1108;3255;1227;3574
522070;202008;645;1550;518;1361;20;57;432;1115;452;1172
522100;202008;731;1866;490;1480;60;207;255;738;315;945
522108;202008;998;2503;771;2178;55;193;611;1676;666;1869
522119;202008;1579;3856;1203;3357;197;564;622;1842;819;2406
522130;202008;392;996;279;837;26;74;190;596;216;670
522140;202008;17426;46134;12048;36447;3132;10179;3213;9326;6345;19505
522145;202008;788;1941;525;1537;149;427;186;555;335;982
522150;202008;1063;2584;750;2066;207;565;221;640;428;1205
522155;202008;1080;2712;824;2307;162;407;457;1329;619;1736
522157;202008;586;1379;479;1243;27;87;379;987;406;1074
522160;202008;5948;15321;3802;11376;1032;3323;302;990;1334;4313
522170;202008;2612;6659;1948;5663;297;876;1094;3246;1391;4122
522180;202008;523;1208;340;888;62;173;84;237;146;410
522185;202008;18516;45604;12937;37914;5006;15944;2773;8791;7779;24735
522190;202008;766;1836;516;1401;96;274;198;524;294;798
522200;202008;1621;4582;1064;3511;221;795;187;557;408;1352
522205;202008;1681;3897;1277;3356;138;384;866;2280;1004;2664
522220;202008;1262;3107;928;2600;109;321;545;1561;654;1882
522230;202008;1119;2828;888;2496;199;679;437;1144;636;1823
530010;202008;170081;454344;135924;403832;20993;68384;78986;231105;99979;299489
110001;202007;3934;11025;2615;8532;594;2079;1015;3368;1609;5447
110002;202007;12623;32784;8854;26232;2463;7772;2356;7082;4819;14854
110003;202007;616;1801;429;1410;103;363;105;327;208;690
110004;202007;11258;29354;7426;22452;1551;5126;2221;6842;3772;11968
110005;202007;2501;6500;1689;5141;359;1192;449;1478;808;2670
110006;202007;1770;4925;1092;3477;199;729;207;620;406;1349
110007;202007;1206;3086;758;2328;240;793;185;699;425;1492
110008;202007;3287;9099;2397;7733;271;859;1586;5446;1857;6305
110009;202007;4314;12106;2748;9222;599;2130;1110;3756;1709;5886
110010;202007;7573;24407;5514;20305;1112;4166;2678;10687;3790;14853
110011;202007;6839;18236;4621;14190;1636;5272;654;2108;2290;7380
110012;202007;15568;38963;9076;27371;2114;6899;816;2644;2930;9543
110013;202007;5169;15090;3735;12127;1510;5174;461;1665;1971;6839
110014;202007;3823;10125;2600;7803;589;1890;1052;3075;1641;4965
110015;202007;5637;14565;3282;9915;729;2403;729;2036;1458;4439
110018;202007;3727;9389;2134;6579;407;1474;597;1814;1004;3288
110020;202007;74821;179242;53186;149373;11664;33863;21739;67311;33403;101174
110025;202007;5159;12450;3398;9379;713;2105;1494;4153;2207;6258
110026;202007;508;1274;364;1066;83;271;153;474;236;745
110028;202007;6815;17367;4059;12334;1021;3386;613;1887;1634;5273
110029;202007;1516;3716;875;2585;195;588;312;970;507;1558
110030;202007;12762;29401;7817;21997;1684;5548;1519;4647;3203;10195
110032;202007;3027;8616;1916;6229;602;1948;395;1378;997;3326
110033;202007;3620;11324;2786;9777;995;3538;692;2707;1687;6245
110034;202007;3404;7964;2234;6344;675;2153;757;2323;1432;4476
110037;202007;1621;4801;1203;4060;259;877;584;2015;843;2892
110040;202007;2941;8187;2091;6606;597;2036;641;1974;1238;4010
110045;202007;4965;14354;3710;12052;992;3472;1290;4268;2282;7740
110050;202007;1804;4864;1254;3910;495;1678;216;694;711;2372
110060;202007;893;2650;605;1962;207;718;77;248;284;966
110070;202007;1577;5000;1178;4115;374;1391;235;742;609;2133
110080;202007;6285;14633;4624;12663;619;1599;3024;8861;3643;10460
110090;202007;560;1513;398;1223;90;303;181;544;271;847
110092;202007;1160;3361;834;2749;148;501;415;1480;563;1981
110094;202007;2813;8404;2101;7037;885;3163;296;996;1181;4159
110100;202007;1695;5009;1358;4358;371;1261;569;1853;940;3114
110110;202007;1699;4699;1176;3796;382;1275;271;949;653;2224
110120;202007;1323;3820;1002;3192;232;814;342;1056;574;1870
110130;202007;2666;6674;1678;4876;313;1036;491;1374;804;2410
110140;202007;2046;6022;1374;4628;342;1211;354;1229;696;2440
110143;202007;1382;3776;939;2879;285;881;154;484;439;1365
110145;202007;893;2339;548;1698;126;408;194;617;320;1025
110146;202007;472;1216;334;1007;65;180;163;536;228;716
110147;202007;792;2056;495;1469;70;229;187;486;257;715
110148;202007;768;2096;432;1427;118;440;47;153;165;593
110149;202007;2960;8149;2034;6652;703;2432;449;1560;1152;3992
110150;202007;2762;6739;1822;5406;541;1769;448;1604;989;3373
110155;202007;736;2159;514;1623;112;381;174;519;286;900
110160;202007;1451;4533;1065;3666;312;1102;260;918;572;2020
110170;202007;2173;5572;1322;3945;242;764;682;1960;924;2724
110175;202007;1680;4703;1188;3839;182;643;525;1775;707;2418
110180;202007;1418;3887;976;2989;147;476;497;1512;644;1988
120001;202007;3268;9595;2675;8716;430;1462;1693;5676;2123;7138
120005;202007;1944;7433;1759;7169;152;683;1405;5814;1557;6497
120010;202007;5325;16031;4495;14785;421;1361;3271;11110;3692;12471
120013;202007;2165;7609;1909;7298;417;1535;1191;4873;1608;6408
120017;202007;2432;8032;2138;7583;342;1211;1364;5123;1706;6334
120020;202007;14984;58581;13743;56155;1083;5035;10819;44539;11902;49574
120025;202007;3126;8891;2496;8128;372;1197;1722;5811;2094;7008
120030;202007;6500;25645;6017;24729;430;2276;4660;19317;5090;21593
120032;202007;1693;7592;1600;7419;109;698;1321;6011;1430;6709
120033;202007;4073;15121;3828;14690;124;713;3346;12723;3470;13436
120034;202007;2659;9662;2269;8977;114;680;1876;7292;1990;7972
120035;202007;3720;14693;3529;14360;291;1416;2891;11758;3182;13174
120038;202007;2698;8666;2294;7998;529;1909;1231;4380;1760;6289
120039;202007;2026;8732;1892;8460;124;778;1525;6758;1649;7536
120040;202007;44522;139982;37734;128817;5344;19305;23457;81251;28801;100556
120042;202007;3299;12397;3030;11898;147;796;2526;9841;2673;10637
120043;202007;1381;5611;1257;5409;35;214;1155;4975;1190;5189
120045;202007;6218;15982;5389;15056;125;514;4904;13563;5029;14077
120050;202007;9351;33693;8539;32442;388;2055;7144;27193;7532;29248
120060;202007;9559;36971;8749;35765;379;2282;7631;30979;8010;33261
120070;202007;3151;10113;2719;9519;241;856;1962;7129;2203;7985
120080;202007;4232;13610;3754;12898;462;1675;2760;9662;3222;11337
130002;202007;3086;12138;2750;11646;195;836;2322;10028;2517;10864
130006;202007;2426;9014;2005;8252;183;790;1501;6231;1684;7021
130008;202007;2677;9341;2365;8881;69;370;2047;7689;2116;8059
130010;202007;3970;11542;3327;10805;80;222;3053;10074;3133;10296
130014;202007;3146;9322;2417;8111;424;1432;1476;5096;1900;6528
130020;202007;2885;11077;2573;10601;139;811;2063;8437;2202;9248
130030;202007;10185;32892;9254;31797;331;1103;8193;28628;8524;29731
130040;202007;4043;11898;3360;10983;198;614;2777;9207;2975;9821
130050;202007;7598;27795;6319;26095;159;830;5735;23921;5894;24751
130060;202007;7560;29908;6473;28473;427;2354;5356;23539;5783;25893
130063;202007;6423;20851;5709;20053;208;889;5177;18305;5385;19194
130068;202007;3817;13381;3221;12501;209;1186;2456;9426;2665;10612
130070;202007;7627;21407;6228;19876;290;886;5142;16946;5432;17832
130080;202007;7123;25687;6214;24625;249;1376;5299;21328;5548;22704
130083;202007;2773;9039;2449;8630;151;612;2084;7388;2235;8000
130090;202007;3557;10989;3151;10478;54;236;2795;9470;2849;9706
130100;202007;8117;24271;6899;22995;64;134;6505;22240;6569;22374
130110;202007;8623;24611;7083;22699;1023;2597;5145;17846;6168;20443
130115;202007;5303;16500;4561;15674;105;360;4029;14079;4134;14439
130120;202007;14275;50383;12557;48081;1086;4578;10192;39410;11278;43988
130130;202007;5370;16933;4131;15292;307;1264;3190;11935;3497;13199
130140;202007;7364;25613;6480;24597;186;1058;5706;21752;5892;22810
130150;202007;3647;13662;3426;13416;81;507;3143;12332;3224;12839
130160;202007;5162;18256;4409;17290;273;1130;3742;14984;4015;16114
130165;202007;3227;12232;3032;11986;117;522;2732;10898;2849;11420
130170;202007;11890;34581;9509;31791;701;2626;7652;26056;8353;28682
130180;202007;4498;14485;4261;14220;41;212;4115;13707;4156;13919
130185;202007;18556;45817;15134;42175;1007;1827;12727;37607;13734;39434
130190;202007;18861;62417;15139;56861;1716;6695;10728;41582;12444;48277
130195;202007;2492;9028;2008;8370;78;461;1688;7007;1766;7468
130200;202007;2592;7292;2132;6689;96;373;1773;5558;1869;5931
130210;202007;1342;5009;1205;4849;101;585;970;3799;1071;4384
130220;202007;2323;7982;1982;7535;52;292;1746;6658;1798;6950
130230;202007;4640;19067;4024;18184;225;1409;3460;15612;3685;17021
130240;202007;12284;36776;9944;33669;184;1099;8945;30277;9129;31376
130250;202007;26557;79181;22752;74888;1678;5087;18285;62619;19963;67706
130255;202007;4493;14867;3905;13839;155;708;3165;11210;3320;11918
130260;202007;265045;737797;215166;665337;58114;190708;98910;316163;157024;506871
130270;202007;9590;33862;7889;31212;1185;4659;5247;21710;6432;26369
130280;202007;3551;14372;3260;14046;91;460;3036;13238;3127;13698
130290;202007;13339;44491;11534;42164;668;2598;9733;36369;10401;38967
130300;202007;4740;16517;4312;15933;147;811;3755;13858;3902;14669
130310;202007;6305;21021;5468;19938;284;1270;4658;16997;4942;18267
130320;202007;3445;11199;2859;10436;366;1293;2087;7908;2453;9201
130330;202007;4643;14869;3745;13765;207;923;3202;11770;3409;12693
130340;202007;23803;74041;20447;70218;1477;4339;17145;60976;18622;65315
130350;202007;3995;14422;3592;13908;147;752;3183;12291;3330;13043
130353;202007;7622;20512;6119;18612;787;2257;4386;13884;5173;16141
130356;202007;5286;16781;4367;15348;768;2640;2653;9915;3421;12555
130360;202007;2989;9844;2580;9284;93;412;2297;8205;2390;8617
130370;202007;5762;22688;5006;21608;303;1687;4046;17383;4349;19070
130380;202007;7397;30666;6848;29891;396;2222;5818;25229;6214;27451
130390;202007;5835;24611;5161;23477;544;2821;3879;17731;4423;20552
130395;202007;2354;7454;2013;6895;186;661;1540;5287;1726;5948
130400;202007;2807;8686;2406;8147;91;260;2162;7471;2253;7731
130406;202007;11110;38753;9341;36576;1771;6959;6238;25396;8009;32355
130410;202007;4244;15035;3607;13951;1070;4374;1655;6570;2725;10944
130420;202007;13792;48300;11510;45431;928;4637;8991;35825;9919;40462
130423;202007;4361;13722;3811;13097;192;856;3338;11378;3530;12234
130426;202007;2801;11118;2607;10888;71;395;2404;10099;2475;10494
130430;202007;4284;12113;3711;11349;239;884;3125;9424;3364;10308
130440;202007;4853;15216;4149;14375;84;372;3840;13391;3924;13763
140002;202007;2197;6504;1912;6151;89;341;1613;5250;1702;5591
140005;202007;3332;9177;2906;8688;134;358;2483;7632;2617;7990
140010;202007;57127;151682;45562;134400;11321;35209;19660;59198;30981;94407
140015;202007;3864;11443;3274;10719;224;713;2853;9504;3077;10217
140017;202007;4440;12335;3850;11590;256;710;3161;9809;3417;10519
140020;202007;5310;15466;4563;14483;229;956;3764;11850;3993;12806
140023;202007;2509;7436;2052;6779;198;662;1561;5284;1759;5946
140028;202007;2056;5290;1737;4882;87;275;1404;3941;1491;4216
140030;202007;5293;13503;4674;12790;339;671;4069;11526;4408;12197
140040;202007;2581;10162;2365;9877;93;575;2138;8797;2231;9372
140045;202007;2604;9499;2186;8923;347;1234;1482;6522;1829;7756
140047;202007;6320;17951;5313;16476;597;1890;3813;12015;4410;13905
140050;202007;1454;4229;1221;3894;120;373;929;3036;1049;3409
140060;202007;1702;4472;1461;4115;113;287;1183;3411;1296;3698
140070;202007;1897;9864;1831;9733;122;849;1522;8016;1644;8865
150010;202007;45650;113946;41209;108243;967;2273;36921;96939;37888;99212
150013;202007;1966;5009;1634;4654;153;307;1272;3875;1425;4182
150020;202007;14519;43671;13417;42232;1456;3844;10959;35604;12415;39448
150030;202007;8902;33354;8087;32346;468;2012;7016;28322;7484;30334
150034;202007;4221;10335;3465;9403;233;577;2886;8012;3119;8589
150040;202007;16461;42612;14458;40394;1254;1942;12094;36738;13348;38680
150050;202007;6983;24355;6360;23529;132;584;5844;21850;5976;22434
150060;202007;22246;60275;17819;53585;2801;8601;11335;34888;14136;43489
150070;202007;6769;25235;5923;24218;227;1112;5289;21845;5516;22957
150080;202007;95015;211914;78726;189616;19047;50181;22621;66723;41668;116904
150085;202007;7764;22358;7014;21467;120;388;6578;20283;6698;20671
150090;202007;9902;36694;9307;35530;704;2717;7456;28704;8160;31421
150095;202007;5686;16614;4946;15688;271;597;4190;13898;4461;14495
150100;202007;2875;10078;2549;9525;202;661;1990;7620;2192;8281
150110;202007;4440;18193;4112;17815;189;880;3780;16496;3969;17376
150120;202007;8214;25405;7788;24890;261;666;6886;22781;7147;23447
150125;202007;752;1998;559;1734;97;362;333;1014;430;1376
150130;202007;22421;65007;19389;60420;3373;9417;12627;41731;16000;51148
150140;202007;256160;591132;215322;534481;32129;77087;124767;322537;156896;399624
150145;202007;4270;13202;3621;12200;925;2860;1959;7322;2884;10182
150150;202007;16247;41750;14155;39060;541;1639;11819;32618;12360;34257
150157;202007;3538;9606;2845;8707;300;905;2001;6422;2301;7327
150160;202007;3037;8965;2825;8658;539;1556;1754;5616;2293;7172
150170;202007;24627;80646;21491;75286;3915;12901;13181;49189;17096;62090
150172;202007;4877;13358;3913;11997;268;743;2967;9395;3235;10138
150175;202007;1627;5140;1354;4609;246;876;778;2684;1024;3560
150178;202007;10537;28321;8731;26214;213;530;7814;23805;8027;24335
150180;202007;22566;79631;20331;77049;1119;3668;17821;69238;18940;72906
150190;202007;6762;22772;6277;22159;253;1160;5570;19556;5823;20716
150195;202007;5126;16544;4865;16137;70;380;4513;14823;4583;15203
150200;202007;5895;17162;5390;16601;64;172;5101;15825;5165;15997
150210;202007;26393;91190;24577;88766;1712;6149;20323;75638;22035;81787
150215;202007;7679;21756;6600;20175;1186;3530;3923;12539;5109;16069
150220;202007;12593;35312;10998;33032;1080;3100;7611;23417;8691;26517
150230;202007;12222;34907;10757;32950;1133;3086;7456;23906;8589;26992
150240;202007;32433;90087;26831;80472;7305;22363;9303;28340;16608;50703
150250;202007;4259;16237;3962;15897;604;2342;3048;12582;3652;14924
150260;202007;2773;9016;2512;8614;155;501;2007;6986;2162;7487
150270;202007;8904;25438;6252;20732;1999;6927;1634;5802;3633;12729
150275;202007;6923;22032;6320;21191;241;923;5486;18344;5727;19267
150276;202007;2373;6250;2027;5840;260;669;1398;4440;1658;5109
150277;202007;5195;13551;4185;12379;315;832;3223;10174;3538;11006
150280;202007;6869;27661;6618;27249;472;1917;5618;23410;6090;25327
150285;202007;3298;11518;2886;10869;236;913;2123;8137;2359;9050
150290;202007;10489;28676;9461;27577;289;615;8555;25560;8844;26175
150293;202007;9423;23193;7170;20223;928;2649;4410;13085;5338;15734
150295;202007;7717;20727;5676;17970;1850;6238;1973;7168;3823;13406
150300;202007;2421;7192;2165;6869;36;126;1974;6299;2010;6425
150304;202007;4131;12208;3401;11078;603;1861;2080;7110;2683;8971
150307;202007;6162;19791;5670;18976;339;1143;4624;15642;4963;16785
150309;202007;6249;18797;5034;16701;875;2872;2828;9816;3703;12688
150310;202007;7301;28990;6949;28572;207;1173;6212;25760;6419;26933
150320;202007;9502;25881;8652;24639;420;1268;6697;19043;7117;20311
150330;202007;14146;45205;13033;43429;1264;3910;9803;33742;11067;37652
150340;202007;2557;7454;2265;7016;333;960;1555;4983;1888;5943
150345;202007;8162;23908;7316;22774;434;1411;6220;19451;6654;20862
150350;202007;9006;22574;8294;21651;700;1307;6843;18445;7543;19752
150360;202007;24454;67031;19570;60842;2059;5134;13882;46120;15941;51254
150370;202007;10822;32844;8875;30218;1007;2889;6449;23656;7456;26545
150375;202007;3581;14398;3221;13874;225;1088;2743;11914;2968;13002
150380;202007;11174;28541;9167;25912;118;442;8102;22925;8220;23367
150390;202007;7988;31833;7165;30539;1087;4044;5101;23034;6188;27078
150400;202007;6578;23497;6311;22995;288;1049;5496;20135;5784;21184
150405;202007;9277;24388;8096;22973;484;1137;6548;19185;7032;20322
150410;202007;1941;6144;1642;5632;223;689;1040;3680;1263;4369
150420;202007;40715;112128;31271;98135;8677;28587;10714;39156;19391;67743
150430;202007;8516;24845;7753;23859;878;1998;6028;19499;6906;21497
150440;202007;5693;18224;5173;17483;768;2272;3614;12843;4382;15115
150442;202007;26769;63357;21972;57337;2312;5906;15187;40515;17499;46421
150445;202007;6314;19530;5537;18349;207;729;4732;15718;4939;16447
150450;202007;5101;21846;4713;21311;363;1790;4053;18341;4416;20131
150460;202007;8409;27638;7684;26714;250;998;6575;23694;6825;24692
150470;202007;21927;56616;19529;53889;362;1010;18364;50706;18726;51716
150475;202007;4925;15442;4247;14419;163;614;3551;12201;3714;12815
150480;202007;13759;44440;12299;42243;2213;6874;8139;29874;10352;36748
150490;202007;8418;29095;7722;28233;287;1175;6833;25166;7120;26341
150495;202007;5304;18183;5067;17847;111;555;4601;16124;4712;16679
150497;202007;2886;9109;2313;8115;507;1807;1209;4571;1716;6378
150500;202007;3304;8474;2935;7956;242;579;2288;6220;2530;6799
150503;202007;4818;12361;3326;10416;986;3326;1067;3838;2053;7164
150506;202007;10458;30930;8774;28642;1878;5352;5430;19731;7308;25083
150510;202007;9921;35999;8562;33443;1264;4633;5598;23060;6862;27693
150520;202007;6985;27326;6678;26943;231;1393;5979;24037;6210;25430
150530;202007;12464;42437;10777;40013;1540;4618;7718;30637;9258;35255
150540;202007;4992;13613;4243;12497;233;620;3537;10489;3770;11109
150543;202007;7422;19849;6112;18202;496;1484;4682;14581;5178;16065
150548;202007;10137;31696;9120;30303;253;1039;8083;26912;8336;27951
150549;202007;2016;5969;1723;5567;46;193;1465;4746;1511;4939
150550;202007;20307;59509;16888;53848;4038;13128;7369;25125;11407;38253
150553;202007;29300;84164;23070;72965;6732;21632;8356;28270;15088;49902
150555;202007;1944;5164;1521;4507;143;329;1045;3259;1188;3588
150560;202007;1847;5618;1638;5205;270;821;970;3203;1240;4024
150563;202007;2547;7648;2139;6942;429;1490;1195;3906;1624;5396
150565;202007;4368;13938;3887;13183;101;438;3246;11113;3347;11551
150570;202007;6334;20117;5894;19502;275;1033;5097;16846;5372;17879
150580;202007;10575;41356;9098;39702;621;3171;7362;33306;7983;36477
150590;202007;8164;27984;6989;26588;177;1042;6347;24063;6524;25105
150600;202007;9756;32273;9045;31412;216;828;8369;29269;8585;30097
150610;202007;2915;8549;2598;8035;90;373;2187;6685;2277;7058
150611;202007;3227;9027;2854;8508;93;349;2521;7469;2614;7818
150613;202007;13426;36948;10105;31220;1874;6152;4980;15386;6854;21538
150616;202007;3476;9496;2523;7918;600;1957;1079;3368;1679;5325
150618;202007;6853;19823;5530;17777;490;1542;3575;12147;4065;13689
150619;202007;6388;17876;5281;16329;187;632;4465;13939;4652;14571
150620;202007;6824;22564;5868;20945;666;2261;4008;14751;4674;17012
150630;202007;6299;16981;5748;16298;419;1101;4782;13710;5201;14811
150635;202007;4793;13140;4018;11907;555;1521;2574;7923;3129;9444
150640;202007;2286;6680;2078;6423;38;103;1927;6041;1965;6144
150650;202007;11676;32390;10137;29905;2972;8293;4450;14371;7422;22664
150655;202007;5843;16675;5283;15856;207;630;4552;13668;4759;14298
150658;202007;4432;12495;3505;11106;533;1784;2123;7110;2656;8894
150660;202007;5757;16431;5110;15512;466;1347;3594;11191;4060;12538
150670;202007;8457;19487;6599;17389;656;1404;5168;14390;5824;15794
150680;202007;69400;202075;53323;176540;12769;41361;23853;89362;36622;130723
150690;202007;2881;7382;2485;6917;95;217;2212;6306;2307;6523
150700;202007;6212;18286;5538;17411;358;919;4394;14216;4752;15135
150710;202007;3803;12641;3448;12068;280;958;2614;9362;2894;10320
150715;202007;4998;14358;4088;12978;299;920;3207;10353;3506;11273
150720;202007;6941;24482;6433;23691;426;1670;5350;19953;5776;21623
150730;202007;12065;36544;10443;34245;1210;4093;7705;26000;8915;30093
150740;202007;4004;11155;3533;10414;298;716;2684;8105;2982;8821
150745;202007;5092;14456;4094;12977;823;2759;2590;8300;3413;11059
150746;202007;1643;4998;1493;4783;78;248;1225;3942;1303;4190
150747;202007;4938;15566;4335;14577;701;2074;2954;10421;3655;12495
150750;202007;3717;11546;3117;10632;221;815;2355;8298;2576;9113
150760;202007;11965;35152;10839;33591;1479;4189;7676;24551;9155;28740
150770;202007;6429;22855;6038;22410;185;558;5497;21051;5682;21609
150775;202007;944;2626;730;2337;134;474;397;1268;531;1742
150780;202007;4541;13619;4020;13012;152;440;3609;11985;3761;12425
150790;202007;5704;16108;4887;15232;225;514;3905;13549;4130;14063
150795;202007;14060;43285;12252;40472;2990;9334;7007;24685;9997;34019
150796;202007;3880;9442;3365;8850;184;439;2858;7631;3042;8070
150797;202007;3955;12219;3409;11438;143;370;2911;9950;3054;10320
150800;202007;13508;42153;12126;40306;1458;4551;9164;31479;10622;36030
150803;202007;7095;22720;6632;21995;371;1146;5632;18867;6003;20013
150805;202007;3497;10716;2962;9934;211;715;2322;7927;2533;8642
150808;202007;6067;17100;4440;14430;1727;6231;613;2273;2340;8504
150810;202007;20867;54547;15786;48437;3308;10351;8009;27219;11317;37570
150812;202007;5358;15063;4700;13977;413;1295;3479;10154;3892;11449
150815;202007;9505;27973;7931;26106;614;2035;6552;21912;7166;23947
150820;202007;12015;32907;10133;30542;1113;2851;7676;24267;8789;27118
150830;202007;11925;43451;11036;42362;424;1813;9573;37763;9997;39576
150835;202007;2366;7825;2009;7187;343;1203;1152;4190;1495;5393
150840;202007;7699;21515;6116;18964;1003;3345;3442;10590;4445;13935
160005;202007;1217;3344;1077;3169;63;222;907;2682;970;2904
160010;202007;2456;6458;2289;6275;20;106;2223;6021;2243;6127
160015;202007;2806;8200;2488;7807;70;236;2291;7216;2361;7452
160020;202007;2087;6686;1825;6358;157;523;1433;5165;1590;5688
160021;202007;1120;4265;1033;4159;63;346;854;3407;917;3753
160023;202007;1268;4474;1119;4225;120;414;786;3153;906;3567
160025;202007;1866;5666;1769;5555;12;38;1722;5428;1734;5466
160027;202007;9070;25107;8094;23854;645;1822;6513;19594;7158;21416
160030;202007;71557;202617;57750;184058;12249;36604;31339;110280;43588;146884
160040;202007;5752;19511;5226;18844;71;333;4894;17775;4965;18108
160050;202007;4807;14512;3761;13095;1412;4713;1307;5682;2719;10395
160053;202007;3778;11673;3420;11225;258;733;2802;9547;3060;10280
160055;202007;914;2650;877;2607;31;98;811;2412;842;2510
160060;202007;24959;66125;20186;60698;926;2942;16014;50536;16940;53478
160070;202007;2753;10388;2461;9936;198;787;1932;8059;2130;8846
160080;202007;3341;10631;2988;10234;31;164;2792;9630;2823;9794
170025;202007;608;1581;433;1318;68;213;224;707;292;920
170030;202007;1226;3716;942;3205;144;496;457;1605;601;2101
170035;202007;1483;3840;1095;3221;89;281;670;1983;759;2264
170040;202007;1902;5332;1498;4762;99;360;927;3062;1026;3422
170070;202007;1855;4324;1306;3622;76;237;782;2258;858;2495
170100;202007;2461;7008;2041;6309;202;567;1287;4124;1489;4691
170105;202007;735;2126;504;1637;134;381;170;578;304;959
170110;202007;969;2924;740;2487;124;429;350;1147;474;1576
170130;202007;1316;3926;938;3194;178;649;441;1534;619;2183
170190;202007;1402;3912;1006;3273;358;1242;169;709;527;1951
170200;202007;2050;4889;1317;3669;209;615;543;1499;752;2114
170210;202007;24854;67507;18747;57275;6418;21362;2344;8241;8762;29603
170215;202007;1331;3541;1053;3154;39;160;834;2488;873;2648
170220;202007;5804;18007;4851;16275;1325;4275;1968;7242;3293;11517
170230;202007;1227;3655;911;3035;267;905;163;598;430;1503
170240;202007;2616;7327;2016;6349;137;518;1426;4377;1563;4895
170255;202007;3943;11436;2790;9320;493;1682;1263;4338;1756;6020
170270;202007;962;2311;634;1846;38;109;372;1079;410;1188
170290;202007;2887;8537;2479;8005;118;386;1936;6449;2054;6835
170300;202007;2001;5366;1606;4774;178;519;1074;3252;1252;3771
170305;202007;627;1725;521;1543;68;236;266;777;334;1013
170307;202007;971;3272;776;2888;102;391;430;1627;532;2018
170310;202007;1583;3935;1088;3139;169;543;509;1471;678;2014
170320;202007;1011;2641;762;2237;65;208;489;1470;554;1678
170330;202007;913;2805;828;2676;40;185;689;2164;729;2349
170360;202007;510;1389;351;1119;24;87;229;693;253;780
170370;202007;1266;3409;902;2776;280;814;227;840;507;1654
170380;202007;1781;5121;1316;4392;91;363;771;2614;862;2977
170382;202007;536;1596;437;1423;29;117;319;1010;348;1127
170384;202007;1545;5507;1254;4935;250;1022;643;2576;893;3598
170386;202007;939;2548;580;1840;78;282;203;621;281;903
170388;202007;618;1762;430;1418;60;215;197;657;257;872
170389;202007;1032;3192;849;2893;42;169;625;2176;667;2345
170390;202007;1733;3964;1297;3430;46;106;1064;2901;1110;3007
170410;202007;570;1665;413;1373;34;141;252;809;286;950
170460;202007;375;979;298;854;38;99;189;564;227;663
170510;202007;912;2612;668;2170;42;171;435;1349;477;1520
170550;202007;6493;17352;4715;14452;1190;3916;1128;3735;2318;7651
170555;202007;1392;3768;1082;3279;60;195;540;1708;600;1903
170560;202007;1025;2875;763;2507;59;216;487;1691;546;1907
170600;202007;1299;3494;1053;3147;232;547;580;1904;812;2451
170610;202007;1643;4351;1177;3652;89;301;720;2207;809;2508
170625;202007;431;1176;268;844;45;142;86;255;131;397
170650;202007;1232;3646;960;3197;135;468;546;1888;681;2356
170700;202007;3338;9847;2480;8185;504;1690;1105;3747;1609;5437
170710;202007;1495;3914;1134;3338;151;485;708;2089;859;2574
170720;202007;1727;4349;1306;3672;199;559;716;2101;915;2660
170730;202007;1051;2844;779;2397;142;391;392;1283;534;1674
170740;202007;2056;6804;1766;6273;154;608;1280;4533;1434;5141
170755;202007;897;2472;618;1986;61;209;307;963;368;1172
170765;202007;1143;2967;791;2396;162;490;342;1082;504;1572
170770;202007;1849;5353;1501;4808;175;533;986;3260;1161;3793
170820;202007;3317;9997;2616;8701;522;1804;1207;4149;1729;5953
170825;202007;979;2273;784;2012;84;203;571;1475;655;1678
170830;202007;1414;3749;1153;3341;149;410;770;2295;919;2705
170900;202007;2740;8517;2294;7874;200;636;1805;6323;2005;6959
170930;202007;3709;10264;2830;8606;654;2113;932;2835;1586;4948
170950;202007;11215;30962;7691;24565;2149;7823;890;3097;3039;10920
170980;202007;456;1214;361;1068;16;65;259;727;275;792
171050;202007;1613;5055;1397;4680;48;220;1162;3872;1210;4092
171070;202007;1324;3800;1125;3506;297;932;491;1775;788;2707
171090;202007;1047;2583;830;2273;77;208;552;1496;629;1704
171110;202007;573;1529;401;1208;62;186;189;527;251;713
171150;202007;1108;2728;670;1978;64;220;406;1185;470;1405
171180;202007;797;2173;528;1655;96;277;217;689;313;966
171190;202007;1741;5864;1495;5430;237;942;893;3348;1130;4290
171195;202007;801;2567;638;2258;85;358;382;1332;467;1690
171200;202007;563;1578;419;1324;79;255;179;568;258;823
171215;202007;361;1008;295;891;34;114;202;593;236;707
171240;202007;757;2496;610;2207;33;173;413;1462;446;1635
171245;202007;652;1958;501;1642;45;172;307;964;352;1136
171250;202007;1019;2675;738;2253;133;430;336;1045;469;1475
171270;202007;469;1655;367;1436;78;304;162;689;240;993
171280;202007;875;2633;683;2286;67;236;392;1374;459;1610
171320;202007;3959;11117;3032;9472;617;1912;1142;3756;1759;5668
171330;202007;2751;7542;2107;6417;422;1272;987;3141;1409;4413
171360;202007;1396;4047;1101;3611;78;281;791;2662;869;2943
171370;202007;691;1745;523;1507;50;141;354;1027;404;1168
171380;202007;1464;4007;1221;3661;115;324;881;2723;996;3047
171395;202007;960;2658;664;2099;58;231;407;1234;465;1465
171420;202007;1962;5749;1411;4633;239;846;640;2111;879;2957
171430;202007;1026;3019;846;2681;60;208;575;1753;635;1961
171488;202007;2311;6872;1807;6015;266;867;931;3258;1197;4125
171500;202007;986;2441;743;2073;43;117;573;1615;616;1732
171510;202007;811;2647;698;2431;43;190;487;1670;530;1860
171515;202007;469;1190;331;966;30;88;200;556;230;644
171525;202007;700;1983;526;1701;20;75;307;952;327;1027
171550;202007;344;993;257;850;31;114;145;471;176;585
171570;202007;1133;3442;945;3101;119;383;555;1882;674;2265
171575;202007;1818;4852;1158;3649;117;394;522;1650;639;2044
171610;202007;5784;16110;4311;13560;894;3171;1190;4000;2084;7171
171620;202007;2591;7325;2171;6715;100;385;1769;5490;1869;5875
171630;202007;953;2507;748;2225;107;316;505;1548;612;1864
171650;202007;2031;5779;1553;4966;387;1346;459;1614;846;2960
171660;202007;2361;5972;1603;4704;235;634;831;2487;1066;3121
171665;202007;1246;3488;961;3022;165;582;449;1431;614;2013
171670;202007;1915;5073;1459;4320;200;652;787;2343;987;2995
171700;202007;1204;3434;872;2826;114;363;465;1548;579;1911
171720;202007;792;2026;622;1762;56;178;447;1242;503;1420
171750;202007;1306;3662;885;2868;227;758;107;445;334;1203
171780;202007;1225;3116;872;2595;92;301;574;1675;666;1976
171790;202007;1393;4588;1143;4072;220;822;531;1929;751;2751
171800;202007;716;1976;535;1700;63;255;304;947;367;1202
171820;202007;11316;31685;8288;26385;2036;6712;2477;8544;4513;15256
171830;202007;1504;4853;1258;4412;110;485;816;2856;926;3341
171840;202007;767;2040;593;1764;24;74;391;1152;415;1226
171845;202007;648;1584;489;1348;49;171;313;836;362;1007
171850;202007;895;2949;759;2642;69;307;537;1815;606;2122
171855;202007;1043;3192;884;2904;72;240;544;1755;616;1995
171865;202007;370;1164;300;1042;50;195;147;485;197;680
171870;202007;819;2267;576;1820;68;215;295;950;363;1165
171875;202007;1280;3726;1011;3285;43;189;762;2461;805;2650
171880;202007;1162;3534;1019;3343;43;139;812;2726;855;2865
171884;202007;867;2459;638;2065;116;438;233;784;349;1222
171886;202007;1362;3770;966;3111;283;1035;191;627;474;1662
171888;202007;717;2004;485;1571;30;115;306;967;336;1082
171889;202007;380;1182;302;1023;65;241;121;405;186;646
171890;202007;1189;3305;855;2764;178;544;471;1572;649;2116
171900;202007;551;1886;402;1512;84;305;163;640;247;945
172000;202007;574;1696;479;1513;50;153;273;840;323;993
172010;202007;993;3425;843;3117;72;303;517;1887;589;2190
172015;202007;384;1321;280;1103;70;279;110;451;180;730
172020;202007;2637;7554;2312;7124;164;551;1715;5478;1879;6029
172025;202007;707;1950;518;1637;34;130;380;1196;414;1326
172030;202007;1220;3604;1036;3307;54;212;806;2565;860;2777
172049;202007;1303;3122;877;2531;182;498;438;1386;620;1884
172065;202007;1438;3577;1105;3161;101;217;869;2678;970;2895
172080;202007;2345;6884;1888;6090;104;367;1263;4062;1367;4429
172085;202007;475;1289;306;922;48;138;115;329;163;467
172090;202007;4025;10075;3099;8849;122;380;2350;6775;2472;7155
172093;202007;485;1427;341;1167;21;103;198;642;219;745
172097;202007;685;1808;475;1438;63;198;210;644;273;842
172100;202007;49044;121292;34275;97658;6027;19051;12322;36044;18349;55095
172110;202007;1571;5759;1350;5408;130;546;984;4134;1114;4680
172120;202007;4964;14611;3879;12848;500;1738;2194;7472;2694;9210
172125;202007;367;985;274;829;25;83;160;462;185;545
172130;202007;639;1553;495;1324;26;85;344;841;370;926
172208;202007;2540;6247;2034;5594;185;428;1467;4148;1652;4576
172210;202007;2665;6772;2038;5966;325;1038;1160;3541;1485;4579
210005;202007;18783;54003;14287;46485;4143;14028;5417;18511;9560;32539
210010;202007;1921;5929;1730;5696;74;316;1501;4962;1575;5278
210015;202007;3298;9862;2941;9396;110;308;2587;8364;2697;8672
210020;202007;7329;17316;6241;16048;111;359;5708;14690;5819;15049
210030;202007;4699;15530;4328;14971;199;888;3738;12910;3937;13798
210040;202007;1792;4282;1619;4068;24;39;1532;3885;1556;3924
210043;202007;6116;17585;5168;16271;432;1283;3954;12764;4386;14047
210047;202007;6580;20445;5342;18787;130;659;4633;16298;4763;16957
210050;202007;2221;7515;1741;6617;156;699;1213;4595;1369;5294
210055;202007;1878;6025;1695;5745;70;273;1432;4870;1502;5143
210060;202007;7277;26583;6447;25098;696;2839;4479;17898;5175;20737
210070;202007;7116;20292;6657;19697;40;182;6301;18600;6341;18782
210080;202007;4290;14476;4064;14229;47;279;3729;13137;3776;13416
210083;202007;5542;16078;4556;15033;40;190;4324;14329;4364;14519
210087;202007;3034;8235;2624;7703;105;236;2273;6860;2378;7096
210090;202007;9176;28818;8527;27670;500;1333;7244;23778;7744;25111
210095;202007;6367;20468;5799;19745;242;1048;4859;16878;5101;17926
210100;202007;6792;20699;6072;19569;324;1130;4892;15850;5216;16980
210110;202007;2950;9640;2723;9370;50;296;2500;8565;2550;8861
210120;202007;22814;62631;18809;57343;1864;4653;12753;41434;14617;46087
210125;202007;4415;11788;3861;11141;722;1622;2785;8644;3507;10266
210130;202007;4367;11493;3614;10554;155;333;3070;9097;3225;9430
210135;202007;1446;4355;1242;4028;62;180;1004;3326;1066;3506
210140;202007;19056;49921;14567;44128;2746;7996;8164;26224;10910;34220
210150;202007;4411;10632;3924;9965;139;383;3425;8613;3564;8996
210160;202007;16519;48271;14226;45383;1254;4257;10090;33371;11344;37628
210170;202007;15056;46818;13986;45447;763;2176;12291;40366;13054;42542
210173;202007;2244;8630;2097;8367;96;558;1804;7182;1900;7740
210177;202007;3463;9481;3011;8933;123;241;2660;8184;2783;8425
210180;202007;1442;3875;1271;3672;25;66;1150;3335;1175;3401
210190;202007;5328;14391;4487;13261;74;349;3873;11301;3947;11650
210193;202007;1288;3764;1136;3522;32;147;863;2703;895;2850
210197;202007;2069;6480;1901;6248;142;477;1557;5192;1699;5669
210200;202007;7636;24552;6756;23086;404;1561;5374;18316;5778;19877
210203;202007;7073;20763;6039;19374;402;1337;4866;15973;5268;17310
210207;202007;3954;9665;3042;8696;144;315;2545;7482;2689;7797
210210;202007;8029;26174;7342;25238;133;809;6603;22554;6736;23363
210215;202007;2450;7752;2081;7192;82;421;1730;5960;1812;6381
210220;202007;6110;21187;5785;20689;179;1171;5066;17734;5245;18905
210230;202007;5110;15529;4618;14790;405;1052;3836;12622;4241;13674
210232;202007;11139;35121;9130;32061;1528;5367;5694;21362;7222;26729
210235;202007;3350;10069;2943;9509;157;645;2487;8023;2644;8668
210237;202007;2737;9028;2344;8570;33;202;2166;7919;2199;8121
210240;202007;2585;8215;2373;7839;79;311;1972;6404;2051;6715
210250;202007;5614;17132;5097;16485;73;432;4606;14841;4679;15273
210255;202007;2509;7675;2115;6974;281;950;1352;4463;1633;5413
210260;202007;5458;16338;4827;15420;212;786;4135;13168;4347;13954
210270;202007;4804;13354;4276;12697;110;488;3790;11182;3900;11670
210275;202007;3521;8910;3104;8409;65;144;2780;7625;2845;7769
210280;202007;5512;15782;4413;14074;259;1038;3205;10097;3464;11135
210290;202007;7215;19430;6445;18467;111;364;5979;17133;6090;17497
210300;202007;33326;90044;27005;81015;1875;5920;19328;60070;21203;65990
210310;202007;3064;7868;2704;7344;121;270;2361;6452;2482;6722
210312;202007;2660;6818;2339;6470;31;138;2191;5995;2222;6133
210315;202007;2952;8260;2522;7770;56;156;2305;7241;2361;7397
210317;202007;4043;12860;3656;12405;118;620;3270;11011;3388;11631
210320;202007;18876;57293;17230;55107;382;1874;15279;48609;15661;50483
210325;202007;3634;10258;3115;9580;93;276;2767;8691;2860;8967
210330;202007;24623;69259;19756;62984;5974;17156;9361;34669;15335;51825
210340;202007;10051;29555;8909;28008;717;2240;6789;21990;7506;24230
210350;202007;9173;26565;8003;25127;157;552;7107;22443;7264;22995
210355;202007;4257;14233;3738;13422;102;510;3172;11456;3274;11966
210360;202007;13502;42359;12028;40168;609;2793;9100;29875;9709;32668
210370;202007;10792;24295;8358;21717;245;409;7657;20405;7902;20814
210375;202007;3255;8656;2482;7616;644;2011;1107;3785;1751;5796
210380;202007;5407;13904;4663;13038;201;477;3999;11290;4200;11767
210390;202007;2572;9042;2372;8694;118;540;2011;7338;2129;7878
210400;202007;4422;13613;3918;12990;129;418;3514;11807;3643;12225
210405;202007;6877;18605;5535;16674;1054;2956;3111;9997;4165;12953
210407;202007;1960;6496;1633;5892;75;327;1319;4708;1394;5035
210408;202007;2506;9324;2348;9094;146;697;1924;7471;2070;8168
210409;202007;3772;13081;3444;12628;111;623;2841;10472;2952;11095
210410;202007;3436;10535;2916;9669;156;634;2209;7259;2365;7893
210420;202007;3838;12276;3471;11634;204;635;2908;9858;3112;10493
210430;202007;2236;6567;1991;6255;81;233;1708;5436;1789;5669
210440;202007;4369;11719;3792;10994;66;232;3499;10093;3565;10325
210450;202007;2416;7161;2070;6657;81;295;1710;5472;1791;5767
210455;202007;4287;11295;3255;9974;944;2925;1511;4907;2455;7832
210460;202007;3701;10515;3130;9787;64;268;2779;8639;2843;8907
210462;202007;1638;4974;1394;4574;36;146;1132;3757;1168;3903
210465;202007;2707;7829;2365;7367;68;231;2028;6304;2096;6535
210467;202007;5879;18803;5104;17777;303;1220;4218;14866;4521;16086
210470;202007;2033;5347;1444;4505;94;221;1104;3590;1198;3811
210480;202007;16333;47799;13455;44239;1136;3421;9882;35047;11018;38468
210490;202007;3676;9339;2962;8339;87;261;2493;7011;2580;7272
210500;202007;6272;24160;5750;23258;362;1796;4736;19037;5098;20833
210510;202007;5936;19618;5192;18812;126;555;4644;17116;4770;17671
210515;202007;3684;10876;3225;10352;133;487;2751;8982;2884;9469
210520;202007;2521;7219;2258;6888;71;247;1982;6012;2053;6259
210530;202007;53239;129819;41209;111943;6814;22801;11049;37993;17863;60794
210535;202007;3074;10450;2873;10130;158;567;2374;8469;2532;9036
210540;202007;14445;41832;12015;38424;1391;4123;8458;28339;9849;32462
210542;202007;6449;14970;5187;13592;330;537;4280;12019;4610;12556
210545;202007;2214;6864;2081;6648;42;178;1835;5801;1877;5979
210547;202007;3553;12740;3136;11913;300;1132;2323;9025;2623;10157
210550;202007;6126;18427;4839;16409;338;1315;3558;12384;3896;13699
210560;202007;3543;10798;3161;10183;124;394;2652;8484;2776;8878
210565;202007;1472;4803;1226;4438;55;297;980;3572;1035;3869
210570;202007;10391;28290;9231;26870;276;756;8206;24365;8482;25121
210580;202007;2965;7930;2447;7293;131;271;1966;6164;2097;6435
210590;202007;4276;12706;3692;11955;71;385;3289;10588;3360;10973
210592;202007;2634;7787;2425;7452;25;121;2135;6504;2160;6625
210594;202007;2489;6723;1897;5806;74;221;1404;4449;1478;4670
210596;202007;2519;8939;2257;8409;103;455;1841;6878;1944;7333
210598;202007;1814;5283;1675;5076;50;208;1491;4456;1541;4664
210600;202007;3048;8095;2460;7273;103;258;1916;5736;2019;5994
210610;202007;2693;7560;2307;7082;60;284;1956;5989;2016;6273
210620;202007;2764;7428;2299;6871;60;183;2053;6176;2113;6359
210630;202007;2982;10042;2724;9617;110;557;2262;7878;2372;8435
210632;202007;4375;14150;3872;13425;206;941;3091;10617;3297;11558
210635;202007;1728;6187;1626;6007;99;363;1355;5103;1454;5466
210637;202007;2407;7994;2091;7541;144;627;1577;5738;1721;6365
210640;202007;4564;16323;4273;15974;69;345;3885;14564;3954;14909
210650;202007;7359;21069;6696;20237;86;332;6188;18743;6274;19075
210660;202007;8065;24014;7134;22524;261;1068;6137;19072;6398;20140
210663;202007;2544;7442;2334;7195;146;357;1979;6296;2125;6653
210667;202007;1940;6309;1744;6022;35;142;1581;5522;1616;5664
210670;202007;4524;15119;4122;14487;113;538;3606;12610;3719;13148
210675;202007;5042;13618;4297;12654;185;453;3641;10979;3826;11432
210680;202007;4548;11069;3832;10205;117;186;3472;9431;3589;9617
210690;202007;7644;23371;6409;22007;241;1047;5680;19642;5921;20689
210700;202007;2712;7666;2149;6856;141;446;1585;5281;1726;5727
210710;202007;4870;15333;4273;14487;109;610;3725;12469;3834;13079
210720;202007;2908;9608;2607;9233;64;371;2308;8114;2372;8485
210725;202007;1292;4370;1128;4123;41;171;822;3133;863;3304
210730;202007;1180;3094;991;2829;50;130;833;2382;883;2512
210735;202007;4639;13595;3955;12683;181;544;3406;11178;3587;11722
210740;202007;5248;14171;4565;13401;95;321;3869;11370;3964;11691
210745;202007;4368;11976;4051;11572;111;348;3715;10578;3826;10926
210750;202007;23187;59047;20026;55066;1694;4340;13962;40597;15656;44937
210760;202007;5913;15610;5001;14647;29;65;4751;14053;4780;14118
210770;202007;6129;15733;5268;14740;67;288;4920;13674;4987;13962
210780;202007;7262;23020;6358;21511;537;1616;5017;17316;5554;18932
210790;202007;4198;13317;3768;12758;188;474;3101;11025;3289;11499
210800;202007;4875;12979;4168;12041;91;378;3695;10518;3786;10896
210805;202007;3917;14261;3720;13969;107;586;3283;12240;3390;12826
210810;202007;4832;14078;4402;13523;291;630;3653;11614;3944;12244
210820;202007;6883;19581;5724;17720;670;2134;3379;10826;4049;12960
210825;202007;6674;20761;6022;19895;251;844;5206;17434;5457;18278
210830;202007;7641;21566;6944;20712;343;786;6029;18445;6372;19231
210840;202007;3176;8461;2839;8009;61;202;2526;7035;2587;7237
210845;202007;6492;17507;5828;16785;21;87;5615;16240;5636;16327
210850;202007;5902;20051;4917;18581;237;1202;3865;14655;4102;15857
210860;202007;20995;54035;17470;49601;798;1959;14053;42069;14851;44028
210870;202007;7300;19034;5753;17263;233;647;5010;15150;5243;15797
210880;202007;4237;13059;3823;12572;189;766;3091;10110;3280;10876
210890;202007;3859;11371;3457;10889;236;634;2811;9177;3047;9811
210900;202007;4488;13153;3400;11087;1332;4651;554;2051;1886;6702
210905;202007;1988;5491;1645;5051;43;78;1500;4717;1543;4795
210910;202007;7220;21819;5987;19810;788;2648;3924;13143;4712;15791
210920;202007;3215;10568;2778;9991;74;424;2492;8874;2566;9298
210923;202007;1516;4542;1299;4196;71;244;956;3118;1027;3362
210927;202007;5192;16500;4568;15761;228;830;3771;13269;3999;14099
210930;202007;2474;8544;2170;7948;168;679;1626;5956;1794;6635
210940;202007;4055;11519;3760;11170;109;446;3455;10154;3564;10600
210945;202007;6406;18504;5744;17716;225;638;4826;15290;5051;15928
210950;202007;5170;14389;3978;12724;614;1554;2600;9083;3214;10637
210955;202007;1550;4920;1332;4538;130;462;935;3262;1065;3724
210960;202007;8941;26669;7669;24761;1253;3775;4962;16786;6215;20561
210970;202007;1325;4096;1052;3631;67;235;800;2716;867;2951
210975;202007;1732;5438;1550;5148;56;216;1250;4165;1306;4381
210980;202007;10152;23491;8887;22182;77;188;8433;21121;8510;21309
210990;202007;15877;44928;12515;40495;703;2498;9318;30968;10021;33466
211000;202007;14437;42230;12132;39417;698;2393;9631;32554;10329;34947
211003;202007;5590;16726;4699;15660;140;561;4052;13795;4192;14356
211010;202007;6387;22947;5729;22146;147;678;5132;20175;5279;20853
211020;202007;8183;23684;7077;22418;229;920;5989;19488;6218;20408
211023;202007;1945;6330;1809;6151;89;322;1543;5238;1632;5560
211027;202007;3061;9794;2897;9535;192;524;2504;8324;2696;8848
211030;202007;3860;10630;3439;10118;226;504;2832;8597;3058;9101
211040;202007;4560;16524;4218;15916;110;685;3778;14109;3888;14794
211050;202007;9050;23602;8215;22519;87;303;7559;20725;7646;21028
211060;202007;6869;20897;6280;20101;121;517;5760;18432;5881;18949
211065;202007;2183;6087;1813;5620;98;295;1454;4641;1552;4936
211070;202007;7654;24339;6470;22542;504;1797;4988;17560;5492;19357
211080;202007;1298;3575;1032;3151;38;201;792;2276;830;2477
211085;202007;2056;5754;1749;5342;95;225;1495;4751;1590;4976
211090;202007;3167;8724;2857;8362;37;173;2648;7712;2685;7885
211100;202007;6677;16962;6166;16352;50;156;5697;15199;5747;15355
211102;202007;3036;10384;2778;10009;129;613;2430;8659;2559;9272
211105;202007;2354;7447;1956;6723;165;583;1418;4844;1583;5427
211107;202007;4611;14609;3929;13606;129;580;3210;11462;3339;12042
211110;202007;5805;15983;4491;13969;351;1023;3312;10524;3663;11547
211120;202007;43917;107756;36041;98578;4877;12196;23359;68335;28236;80531
211125;202007;2053;6088;1730;5597;36;149;1480;4804;1516;4953
211130;202007;187415;443313;162099;410467;23666;57960;75345;218313;99011;276273
211140;202007;4929;14635;4301;13818;210;595;3634;11789;3844;12384
211150;202007;9223;25466;7758;23560;335;978;6533;19988;6868;20966
211153;202007;2433;7129;1979;6584;274;955;1316;4623;1590;5578
211157;202007;1102;3500;918;3159;34;165;661;2260;695;2425
211160;202007;4056;11442;3180;10170;145;517;2391;7574;2536;8091
211163;202007;1621;5196;1475;4995;79;330;1273;4309;1352;4639
211167;202007;1516;4822;1420;4669;33;147;1280;4181;1313;4328
211170;202007;6419;15849;5962;15329;53;160;5671;14541;5724;14701
211172;202007;2496;6738;2159;6235;112;366;1668;4679;1780;5045
211174;202007;2831;8201;2559;7898;40;205;2388;7332;2428;7537
211176;202007;4221;12047;3271;10654;150;646;2605;8443;2755;9089
211178;202007;4602;10799;3965;10103;33;150;3772;9537;3805;9687
211180;202007;4011;13199;3716;12767;202;746;3125;10792;3327;11538
211190;202007;3050;8947;2584;8258;35;198;2289;7248;2324;7446
211195;202007;1392;3910;1187;3594;65;139;1002;3116;1067;3255
211200;202007;2129;6061;1697;5464;207;631;1180;3889;1387;4520
211210;202007;6216;19128;5627;18346;252;1045;4823;15568;5075;16613
211220;202007;36762;92685;29918;84238;2796;7402;22137;64098;24933;71500
211223;202007;5206;13710;4314;12535;367;1111;3177;9270;3544;10381
211227;202007;1755;5816;1586;5570;49;258;1283;4543;1332;4801
211230;202007;7509;21728;6547;20269;402;1080;5268;16694;5670;17774
211240;202007;8042;25681;7618;25135;136;751;7072;23075;7208;23826
211245;202007;6990;17635;6244;16862;88;213;6028;16308;6116;16521
211250;202007;13056;41047;11783;39322;628;2497;9691;32129;10319;34626
211260;202007;7967;25829;7102;24686;210;908;6376;22299;6586;23207
211270;202007;10414;33220;8920;31189;383;1751;7239;25497;7622;27248
211280;202007;12595;34804;11200;33032;924;2162;8973;27692;9897;29854
211285;202007;1774;5812;1561;5512;141;543;1140;4132;1281;4675
211290;202007;7419;22343;6671;21362;179;759;5743;18326;5922;19085
211300;202007;7775;22331;6881;20975;184;622;5942;17955;6126;18577
211400;202007;11366;32231;9232;29303;997;3181;6267;20890;7264;24071
220005;202007;1837;4803;1660;4561;35;131;1399;3773;1434;3904
220010;202007;1477;4225;1205;3735;26;107;940;2879;966;2986
220020;202007;3626;10001;3128;9295;134;483;2580;7594;2714;8077
220025;202007;2230;5060;1915;4596;28;70;1600;3727;1628;3797
220027;202007;1268;3205;1082;2960;20;70;921;2473;941;2543
220030;202007;3327;8387;3111;8099;77;227;2759;7090;2836;7317
220040;202007;7065;21432;6146;19654;1413;4145;3229;10900;4642;15045
220045;202007;1475;4491;1209;4045;30;166;976;3203;1006;3369
220050;202007;4756;12829;4020;11857;61;287;3687;10741;3748;11028
220060;202007;2373;4980;1997;4547;24;57;1873;4254;1897;4311
220070;202007;2456;6169;2093;5639;71;150;1751;4745;1822;4895
220080;202007;724;2047;622;1896;25;95;530;1596;555;1691
220090;202007;1774;4258;1462;3818;20;66;1210;3278;1230;3344
220095;202007;643;1606;599;1559;26;43;540;1427;566;1470
220100;202007;1365;3760;1092;3321;45;160;873;2583;918;2743
220105;202007;2009;6234;1760;5741;115;428;1329;4312;1444;4740
220110;202007;3360;9273;3093;8813;39;199;2776;7797;2815;7996
220115;202007;2706;7842;2505;7574;72;229;2263;6810;2335;7039
220117;202007;1365;3284;1067;2872;11;55;897;2359;908;2414
220120;202007;12713;34113;11598;32727;76;271;10885;30698;10961;30969
220130;202007;1100;2969;935;2741;14;80;846;2453;860;2533
220140;202007;2131;4409;1793;4005;101;255;1575;3458;1676;3713
220150;202007;6328;18778;5780;17857;117;574;4901;14852;5018;15426
220155;202007;1156;3319;923;2889;35;120;648;1989;683;2109
220157;202007;1055;2583;895;2341;21;83;722;1826;743;1909
220160;202007;2826;7828;2437;7120;34;160;2022;5798;2056;5958
220170;202007;1560;4056;1331;3721;13;66;1194;3294;1207;3360
220173;202007;2141;5941;1726;5210;43;190;1380;4050;1423;4240
220177;202007;1975;5639;1868;5520;10;37;1846;5447;1856;5484
220180;202007;1129;2755;920;2404;4;21;712;1744;716;1765
220190;202007;6942;17325;5862;15847;375;1051;4373;12024;4748;13075
220191;202007;1515;4542;1371;4296;77;270;998;3058;1075;3328
220192;202007;2047;5368;1492;4383;28;92;1201;3469;1229;3561
220194;202007;1723;4894;1524;4578;57;212;1251;3714;1308;3926
220196;202007;2002;5158;1809;4868;28;112;1555;4113;1583;4225
220198;202007;1286;3528;1083;3268;8;38;996;3025;1004;3063
220200;202007;5106;14690;4437;13819;97;401;3806;11834;3903;12235
220202;202007;2158;6058;1852;5555;28;150;1595;4708;1623;4858
220205;202007;2479;7115;2219;6649;48;187;1872;5529;1920;5716
220207;202007;786;2333;636;2074;61;207;399;1316;460;1523
220208;202007;1653;5085;1349;4495;159;583;812;2647;971;3230
220209;202007;1582;4481;1361;4095;24;97;1119;3336;1143;3433
220210;202007;1701;4181;1464;3814;12;55;1256;3192;1268;3247
220211;202007;1601;4075;1470;3894;13;58;1292;3434;1305;3492
220213;202007;1745;4664;1510;4258;30;108;1211;3328;1241;3436
220217;202007;2154;6445;2007;6275;46;103;1858;5931;1904;6034
220220;202007;10478;27278;8661;24469;565;1407;5858;17425;6423;18832
220225;202007;1030;2692;829;2431;6;36;773;2236;779;2272
220230;202007;5693;14140;4881;13019;161;381;4207;11285;4368;11666
220240;202007;2997;8623;2716;8138;110;353;2210;6626;2320;6979
220245;202007;1736;4056;1342;3561;10;44;1219;3263;1229;3307
220250;202007;2959;8284;2608;7840;17;90;2442;7311;2459;7401
220253;202007;1580;4292;1389;3977;61;210;1173;3266;1234;3476
220255;202007;1889;4485;1609;4092;36;158;1373;3359;1409;3517
220260;202007;4237;13062;3729;12121;156;595;2966;9632;3122;10227
220265;202007;1309;4170;1176;3990;34;169;966;3212;1000;3381
220270;202007;6147;19513;5772;18822;208;1013;4827;15214;5035;16227
220271;202007;1495;3802;1296;3528;29;104;1138;3081;1167;3185
220272;202007;1764;5060;1568;4702;51;156;1186;3460;1237;3616
220273;202007;1227;3462;1020;3079;33;128;788;2338;821;2466
220275;202007;2267;5400;1801;4761;34;88;1579;4206;1613;4294
220277;202007;2135;5369;1824;4916;24;68;1550;4110;1574;4178
220280;202007;1656;3856;1368;3478;26;79;1153;2910;1179;2989
220285;202007;1432;3614;1221;3372;11;46;1122;3076;1133;3122
220290;202007;6510;18244;5121;16265;369;1283;3714;12082;4083;13365
220300;202007;1966;5666;1595;5176;35;184;1326;4289;1361;4473
220310;202007;3051;8177;2360;7368;39;196;1976;6143;2015;6339
220320;202007;3016;8862;2311;7515;81;389;1803;5680;1884;6069
220323;202007;1632;4754;1287;4193;55;212;1056;3379;1111;3591
220325;202007;1262;3719;1077;3411;22;110;899;2794;921;2904
220327;202007;1502;4255;1302;3930;43;183;1077;3161;1120;3344
220330;202007;4410;10567;3691;9695;59;184;3334;8691;3393;8875
220335;202007;1668;5046;1498;4831;32;107;1333;4316;1365;4423
220340;202007;1853;4885;1419;4156;60;196;966;2739;1026;2935
220342;202007;1149;3346;1023;3158;46;188;809;2473;855;2661
220345;202007;3101;6980;2395;5963;13;42;2173;5389;2186;5431
220350;202007;3288;8375;2603;7353;135;408;1852;5243;1987;5651
220360;202007;1240;3162;979;2733;19;54;778;2164;797;2218
220370;202007;8677;25105;7862;23795;161;715;6865;20500;7026;21215
220375;202007;1596;4525;1411;4299;2;13;1338;4099;1340;4112
220380;202007;1486;3517;1206;3115;16;40;1055;2698;1071;2738
220385;202007;855;2047;681;1725;7;21;592;1480;599;1501
220390;202007;10341;26797;7888;22969;2010;5724;2832;9177;4842;14901
220400;202007;1466;3470;1111;2930;23;69;851;2178;874;2247
220410;202007;1166;3193;936;2801;52;155;752;2213;804;2368
220415;202007;801;2047;670;1836;20;61;539;1452;559;1513
220420;202007;2030;5617;1631;4853;54;166;1254;3680;1308;3846
220430;202007;2451;6600;2301;6381;77;260;1965;5377;2042;5637
220435;202007;1745;4490;1512;4148;40;132;1249;3368;1289;3500
220440;202007;2387;7435;2040;6897;92;385;1714;5705;1806;6090
220450;202007;2490;6435;2025;5857;62;213;1719;4990;1781;5203
220455;202007;1287;3961;1220;3867;11;59;1086;3441;1097;3500
220460;202007;981;2397;912;2309;37;91;777;1948;814;2039
220465;202007;2340;7229;2060;6789;181;604;1508;5086;1689;5690
220470;202007;3495;9631;3131;9063;83;215;2551;7301;2634;7516
220480;202007;2759;7154;2213;6264;181;421;1459;4186;1640;4607
220490;202007;2477;6199;2137;5764;26;128;1862;4953;1888;5081
220500;202007;2779;7114;2418;6533;56;184;1980;5208;2036;5392
220510;202007;2555;7204;2005;6217;81;235;1573;4913;1654;5148
220515;202007;1640;3958;1498;3761;38;61;1305;3272;1343;3333
220520;202007;4920;12748;4431;12060;102;286;3851;10414;3953;10700
220525;202007;1317;3313;1132;3079;9;42;1041;2796;1050;2838
220527;202007;1295;3620;1106;3345;12;53;949;2921;961;2974
220530;202007;1436;3558;1230;3295;30;96;1126;2988;1156;3084
220535;202007;802;2205;750;2136;27;86;613;1736;640;1822
220540;202007;3199;10221;2993;9832;115;399;2564;8394;2679;8793
220545;202007;1391;4203;1275;4014;68;261;1060;3294;1128;3555
220550;202007;8580;26297;7572;24541;500;1745;5700;18320;6200;20065
220551;202007;1403;3985;1223;3676;29;125;1000;2939;1029;3064
220552;202007;1600;4613;1300;4080;26;129;1044;3158;1070;3287
220553;202007;1725;4441;1420;4040;57;105;1150;3402;1207;3507
220554;202007;902;2333;655;1926;49;113;423;1243;472;1356
220555;202007;2302;6801;2043;6450;44;183;1688;5438;1732;5621
220556;202007;1202;3477;1041;3167;57;228;747;2180;804;2408
220557;202007;1605;4904;1348;4376;65;252;994;3130;1059;3382
220558;202007;1394;3589;1093;3173;18;78;945;2715;963;2793
220559;202007;1760;4335;1486;3915;9;22;1202;3212;1211;3234
220560;202007;1768;3953;1426;3518;38;73;1295;3217;1333;3290
220570;202007;7128;21271;6476;20355;446;1413;5139;16259;5585;17672
220580;202007;6926;18909;6328;17944;79;291;5733;16137;5812;16428
220585;202007;2004;6309;1666;5685;42;150;1365;4713;1407;4863
220590;202007;1322;3570;1081;3205;71;203;775;2318;846;2521
220595;202007;2526;6891;2288;6570;20;98;2037;5796;2057;5894
220600;202007;1390;3096;1166;2820;85;105;971;2435;1056;2540
220605;202007;1607;4695;1367;4268;19;116;1106;3347;1125;3463
220610;202007;2735;7993;2552;7720;33;145;2383;7191;2416;7336
220620;202007;7789;24127;7167;23285;172;905;6521;20931;6693;21836
220630;202007;371;1083;284;921;22;76;192;617;214;693
220635;202007;1636;5126;1438;4690;53;254;1095;3469;1148;3723
220640;202007;2475;6829;2109;6299;81;322;1707;5031;1788;5353
220650;202007;2053;5659;1779;5243;37;136;1424;4201;1461;4337
220660;202007;2610;8125;2218;7461;81;413;1854;6090;1935;6503
220665;202007;1212;3668;1019;3344;31;173;845;2689;876;2862
220667;202007;1592;4952;1425;4638;57;227;1166;3766;1223;3993
220669;202007;1606;4895;1537;4788;51;242;1359;4134;1410;4376
220670;202007;2176;5674;1743;5071;16;82;1515;4396;1531;4478
220672;202007;3215;7826;2593;7073;104;336;2294;6193;2398;6529
220675;202007;1250;3431;1115;3183;31;103;927;2610;958;2713
220680;202007;2680;7272;2558;7099;100;236;2340;6527;2440;6763
220690;202007;1576;4143;1390;3861;60;170;1101;3069;1161;3239
220695;202007;895;2458;823;2334;20;63;720;2027;740;2090
220700;202007;9889;24310;7931;21602;341;949;6049;16381;6390;17330
220710;202007;895;2468;653;2008;34;109;487;1474;521;1583
220720;202007;2105;4987;1896;4707;15;62;1652;4048;1667;4110
220730;202007;1311;3655;1100;3298;14;77;932;2729;946;2806
220735;202007;956;2229;747;1909;17;59;626;1542;643;1601
220740;202007;1371;3547;1096;3197;29;77;914;2719;943;2796
220750;202007;3835;9725;3342;9015;190;465;2889;7828;3079;8293
220755;202007;1311;3210;1090;2880;22;83;889;2289;911;2372
220760;202007;3098;8570;2703;8039;72;236;2420;7261;2492;7497
220770;202007;22948;68005;19298;61685;5858;19747;6717;22372;12575;42119
220775;202007;1155;2930;1025;2768;12;43;982;2636;994;2679
220777;202007;1603;4051;1214;3454;30;78;932;2667;962;2745
220779;202007;1295;3266;1116;3008;19;61;974;2610;993;2671
220780;202007;5571;14036;4838;12924;204;659;3945;10306;4149;10965
220785;202007;1464;3239;1279;3003;8;20;1235;2885;1243;2905
220790;202007;10061;28569;9024;27087;216;989;7583;22531;7799;23520
220793;202007;917;2410;725;2072;10;23;604;1750;614;1773
220795;202007;1389;3565;1218;3331;17;71;1084;2956;1101;3027
220800;202007;17840;39554;15079;35905;647;1494;11623;27639;12270;29133
220810;202007;3020;8315;2537;7460;54;164;2085;6070;2139;6234
220820;202007;4980;12980;4300;11988;276;673;3251;9059;3527;9732
220830;202007;7250;19247;6500;18207;235;777;5392;14876;5627;15653
220840;202007;12206;37354;10119;33067;2276;7129;4680;15945;6956;23074
220850;202007;3121;9633;2782;9214;59;312;2449;8126;2508;8438
220855;202007;691;1735;597;1606;14;49;543;1451;557;1500
220860;202007;1043;2596;902;2370;16;67;814;2106;830;2173
220865;202007;2434;6430;1906;5501;92;340;1392;3891;1484;4231
220870;202007;2933;8273;2446;7629;35;183;2250;6996;2285;7179
220880;202007;5297;12466;4551;11543;81;296;4145;10400;4226;10696
220885;202007;1390;4227;1145;3813;57;227;909;3063;966;3290
220887;202007;1561;3363;1298;3023;13;30;1203;2783;1216;2813
220890;202007;1401;4275;1227;4010;44;157;1017;3375;1061;3532
220900;202007;2024;4797;1689;4361;33;80;1474;3795;1507;3875
220910;202007;1516;4135;1268;3775;54;166;1050;3144;1104;3310
220915;202007;957;2586;774;2253;5;20;580;1639;585;1659
220920;202007;1411;4411;1215;4148;58;245;998;3430;1056;3675
220930;202007;1733;4652;1454;4250;20;62;1352;3941;1372;4003
220935;202007;1086;3122;885;2703;23;92;579;1673;602;1765
220937;202007;1433;3799;1231;3487;23;84;977;2728;1000;2812
220940;202007;1539;4259;1232;3709;39;130;952;2835;991;2965
220945;202007;443;1542;382;1401;21;120;279;982;300;1102
220950;202007;1426;3273;928;2497;18;62;737;1916;755;1978
220955;202007;1606;4113;1337;3642;25;74;1136;3050;1161;3124
220960;202007;811;2046;602;1698;17;57;426;1140;443;1197
220965;202007;1776;4851;1549;4509;21;130;1343;3817;1364;3947
220970;202007;1918;4600;1404;3827;35;87;1168;3166;1203;3253
220975;202007;691;1975;588;1844;16;93;521;1571;537;1664
220980;202007;1144;3213;1013;3038;38;152;848;2513;886;2665
220985;202007;1215;3184;1053;2948;41;123;855;2322;896;2445
220987;202007;1421;4239;1237;3908;56;211;995;3125;1051;3336
220990;202007;1701;4639;1492;4334;19;103;1255;3582;1274;3685
220995;202007;1053;3209;851;2840;35;121;624;2072;659;2193
220997;202007;2371;7102;2188;6808;46;211;1959;6030;2005;6241
221000;202007;4474;12179;3944;11386;87;404;3361;9566;3448;9970
221005;202007;1472;3852;1341;3638;22;122;1161;3028;1183;3150
221010;202007;1224;2777;976;2475;19;57;846;2099;865;2156
221020;202007;1502;4595;1391;4384;22;84;1067;3327;1089;3411
221030;202007;1635;4052;1401;3768;23;69;1204;3288;1227;3357
221035;202007;1496;3922;1304;3662;23;30;1149;3322;1172;3352
221037;202007;668;1851;553;1652;7;24;390;1122;397;1146
221038;202007;515;1451;401;1243;12;42;282;871;294;913
221039;202007;866;2344;744;2140;20;87;602;1654;622;1741
221040;202007;4012;11923;3502;11012;153;535;2765;8689;2918;9224
221050;202007;3907;10210;3424;9597;67;240;3081;8620;3148;8860
221060;202007;8404;23336;6941;21021;253;704;5649;17250;5902;17954
221062;202007;1162;3749;986;3453;41;187;791;2732;832;2919
221063;202007;1064;2905;913;2687;57;187;707;2039;764;2226
221065;202007;2606;6706;2296;6149;21;84;2017;5303;2038;5387
221070;202007;3322;10334;2668;8958;283;949;1643;5638;1926;6587
221080;202007;3500;8594;2845;7628;62;226;2325;6128;2387;6354
221090;202007;1406;3606;1150;3187;9;34;986;2671;995;2705
221093;202007;1368;3841;1244;3585;127;354;849;2403;976;2757
221095;202007;886;2296;738;2066;10;33;618;1699;628;1732
221097;202007;841;2187;647;1841;23;68;476;1298;499;1366
221100;202007;115305;307571;95533;273545;10189;31277;61697;171818;71886;203095
221110;202007;9844;29302;9018;28225;147;744;8064;24979;8211;25723
221120;202007;4783;13117;4248;12257;158;472;3693;10648;3851;11120
221130;202007;5349;13927;3961;11211;764;2052;1906;5453;2670;7505
221135;202007;1642;4300;1477;4079;46;140;1305;3610;1351;3750
221140;202007;1324;3115;1112;2842;11;37;999;2508;1010;2545
221150;202007;1117;2745;865;2304;23;100;668;1664;691;1764
221160;202007;724;1799;635;1682;13;16;519;1382;532;1398
221170;202007;995;2846;901;2675;20;68;777;2279;797;2347
230010;202007;3052;7982;2507;7042;37;137;2040;5605;2077;5742
230015;202007;3021;9737;2641;8982;170;656;1857;6277;2027;6933
230020;202007;12896;40549;12031;39221;326;1351;10217;33125;10543;34476
230030;202007;12923;32270;10762;29462;180;565;9429;25794;9609;26359
230040;202007;4432;11461;3668;10232;46;226;3070;8427;3116;8653
230050;202007;2789;8626;2101;6991;336;1077;938;3041;1274;4118
230060;202007;2365;6440;1871;5569;37;159;1470;4299;1507;4458
230070;202007;3927;10409;3153;8915;146;449;2217;6194;2363;6643
230075;202007;8933;28953;8159;27576;474;1990;6485;21630;6959;23620
230080;202007;3082;6436;2329;5505;7;24;2125;5041;2132;5065
230090;202007;4330;10635;3647;9549;173;439;2916;7594;3089;8033
230100;202007;17779;46228;15599;43256;1165;3325;11217;31229;12382;34554
230110;202007;12691;37618;10647;33596;1720;5395;5622;17867;7342;23262
230120;202007;7325;19714;6438;18256;510;1282;4741;13652;5251;14934
230125;202007;3133;8235;2542;7279;88;294;1953;5515;2041;5809
230130;202007;5740;17597;4631;15129;309;1082;3122;10018;3431;11100
230140;202007;3432;10264;2900;9152;102;414;2203;6795;2305;7209
230150;202007;1571;4706;1297;4096;195;532;759;2490;954;3022
230160;202007;6476;16790;5514;15277;199;690;4466;12160;4665;12850
230170;202007;6243;17684;5063;15256;312;916;3629;10760;3941;11676
230180;202007;1641;4524;1386;4042;21;99;1120;3161;1141;3260
230185;202007;4403;12440;3700;11264;256;868;2756;8357;3012;9225
230190;202007;13151;38216;11023;34263;1455;4728;6265;19314;7720;24042
230195;202007;5274;15516;4769;14556;338;1018;3643;11089;3981;12107
230200;202007;5014;13787;4191;12231;149;484;3194;9118;3343;9602
230205;202007;4057;12089;3545;11297;187;652;2670;8448;2857;9100
230210;202007;10362;24878;8703;22627;341;1128;6844;17466;7185;18594
230220;202007;13961;34958;12172;32362;621;1655;10004;26340;10625;27995
230230;202007;6837;20491;6076;18917;396;1218;4475;13922;4871;15140
230240;202007;13028;34683;11215;31585;275;1159;9249;25442;9524;26601
230250;202007;8925;24975;8297;23994;235;824;6638;18643;6873;19467
230260;202007;14658;43731;12666;40148;1713;5279;7228;23439;8941;28718
230270;202007;7586;20409;5763;16949;479;1369;3795;11237;4274;12606
230280;202007;20378;54267;16550;47766;473;1995;13023;36209;13496;38204
230290;202007;4837;13388;3992;11777;261;696;3014;8906;3275;9602
230300;202007;4826;12826;4355;12183;106;308;3802;10581;3908;10889
230310;202007;4607;13110;3877;11810;133;585;2792;8264;2925;8849
230320;202007;7732;22251;6481;19945;237;963;4961;14950;5198;15913
230330;202007;4681;12758;3676;10812;138;456;2752;7914;2890;8370
230340;202007;3608;11134;3064;10025;269;936;2047;6612;2316;7548
230350;202007;17729;48811;15481;45428;867;2907;10394;30734;11261;33641
230360;202007;2923;7722;2274;6571;143;401;1524;4370;1667;4771
230365;202007;3021;7518;2477;6705;51;245;2104;5604;2155;5849
230370;202007;58598;162589;49640;149163;7380;22416;29418;89855;36798;112271
230380;202007;6281;17427;4915;14892;130;527;3627;10751;3757;11278
230390;202007;3398;10051;2928;9282;95;411;2260;7075;2355;7486
230393;202007;3249;9626;2581;8251;87;449;1976;6073;2063;6522
230395;202007;5778;15693;5028;14434;315;845;3577;10296;3892;11141
230400;202007;5469;14995;4854;13980;98;497;3888;10871;3986;11368
230410;202007;14187;41677;11628;36921;886;3059;7956;25216;8842;28275
230420;202007;28773;78801;23223;69072;2833;8735;12962;38358;15795;47093
230423;202007;4655;13781;4041;12547;87;391;3303;10079;3390;10470
230425;202007;5533;17046;5019;15986;389;1315;3576;11329;3965;12644
230426;202007;2739;7207;1972;5708;26;102;1474;4184;1500;4286
230427;202007;1852;5210;1317;4074;62;204;870;2579;932;2783
230428;202007;9631;25657;8227;23526;1114;3158;4821;13744;5935;16902
230430;202007;4976;13932;3906;12078;149;524;2913;8877;3062;9401
230435;202007;5836;15315;4836;13518;576;1529;2949;8311;3525;9840
230440;202007;410534;1016371;339050;910510;34143;97198;216832;575970;250975;673168
230445;202007;4289;11328;3446;9864;182;523;2358;6602;2540;7125
230450;202007;3587;10302;3110;9598;241;926;2256;6741;2497;7667
230460;202007;2121;5903;1845;5465;57;231;1542;4535;1599;4766
230465;202007;4032;11295;3405;10084;99;393;2555;7273;2654;7666
230470;202007;11280;37102;10074;34866;879;3458;7135;24268;8014;27726
230480;202007;1447;4164;1230;3768;71;281;906;2665;977;2946
230490;202007;2512;7051;2095;6267;164;562;1312;3684;1476;4246
230495;202007;5718;16936;5023;15686;363;1369;3338;10293;3701;11662
230500;202007;9343;29836;8354;28011;271;1088;6795;22750;7066;23838
230510;202007;1623;4861;1258;4062;173;609;627;1985;800;2594
230520;202007;4509;12758;3888;11632;309;875;2735;8213;3044;9088
230523;202007;15492;45559;12314;38702;2785;8752;3173;10654;5958;19406
230526;202007;3698;10510;3140;9552;183;515;2291;7034;2474;7549
230530;202007;5368;16719;4498;14999;297;1107;3223;10630;3520;11737
230533;202007;4441;10603;3685;9390;88;257;3066;7688;3154;7945
230535;202007;5308;14728;4474;13312;228;683;3129;9431;3357;10114
230540;202007;16179;43789;13842;40322;275;1104;11408;32909;11683;34013
230550;202007;20844;54998;16659;47836;1494;4428;10615;30318;12109;34746
230560;202007;8077;19653;6494;17147;50;209;5578;14620;5628;14829
230565;202007;3016;8383;2522;7475;91;371;1908;5531;1999;5902
230570;202007;3456;8803;2934;8087;81;228;2405;6623;2486;6851
230580;202007;10935;28200;9320;25869;338;953;7685;21218;8023;22171
230590;202007;8844;25104;7291;22249;396;1426;5373;15868;5769;17294
230600;202007;3625;9423;2833;8013;70;210;1976;5614;2046;5824
230610;202007;6660;18324;5868;16991;451;1273;4604;13274;5055;14547
230620;202007;2116;5688;1600;4668;122;376;975;2746;1097;3122
230625;202007;7928;22427;6618;20003;1972;6190;1804;5870;3776;12060
230630;202007;10737;31827;9273;28886;1443;4263;5354;17082;6797;21345
230640;202007;27747;83453;24940;78988;1214;4796;19819;61823;21033;66619
230650;202007;5145;13914;4371;12555;134;543;3557;9992;3691;10535
230655;202007;9243;31221;8675;30220;613;2193;6910;24346;7523;26539
230660;202007;5970;17775;4874;15833;159;842;3961;12602;4120;13444
230670;202007;6195;14712;4510;11998;133;437;3633;9427;3766;9864
230680;202007;2633;7179;2225;6456;125;345;1606;4687;1731;5032
230690;202007;7133;21033;6121;19010;388;1376;3857;11747;4245;13123
230700;202007;10202;26079;8223;22419;314;842;6091;16300;6405;17142
230710;202007;6768;21309;5895;19434;613;2000;3963;12946;4576;14946
230720;202007;1892;5573;1529;4825;118;349;1027;3168;1145;3517
230725;202007;3889;11624;3472;10890;382;1352;1985;6118;2367;7470
230730;202007;56418;152578;43934;133342;9634;31643;14706;46931;24340;78574
230740;202007;6030;16638;5099;15142;129;461;4098;12124;4227;12585
230750;202007;8300;22113;6867;19727;159;571;5470;15321;5629;15892
230760;202007;11063;29090;9610;26904;502;1669;7256;19853;7758;21522
230763;202007;4800;13110;4011;11679;119;554;3231;9120;3350;9674
230765;202007;40679;110346;33598;98760;5195;15839;16874;49268;22069;65107
230770;202007;25441;62817;21182;57133;2155;5858;14025;37939;16180;43797
230780;202007;6344;22167;5774;20824;801;2841;3396;12582;4197;15423
230790;202007;2982;8597;2676;8097;111;451;2004;5908;2115;6359
230800;202007;8057;25611;7055;23572;833;3022;4201;13783;5034;16805
230810;202007;11337;33784;10110;31800;393;1447;7815;24131;8208;25578
230820;202007;3379;11001;2780;9668;252;1043;1661;5515;1913;6558
230830;202007;7512;20388;6372;18466;128;542;5264;14897;5392;15439
230835;202007;4239;10101;3222;8477;85;255;2601;6741;2686;6996
230837;202007;3104;9496;2699;8781;108;502;2147;6794;2255;7296
230840;202007;8971;26258;7693;24101;772;2301;5521;17448;6293;19749
230850;202007;9487;27484;7930;24385;360;1304;5730;17348;6090;18652
230860;202007;5199;13165;4299;11874;63;217;3797;10426;3860;10643
230870;202007;16419;40084;14018;36084;373;1080;11481;29040;11854;30120
230880;202007;2107;6379;1920;6067;42;232;1527;4700;1569;4932
230890;202007;4554;14510;4124;13637;321;1166;2993;9727;3314;10893
230900;202007;2972;8548;2529;7692;177;613;1710;5088;1887;5701
230910;202007;3124;8324;2505;7343;65;300;2035;5939;2100;6239
230920;202007;4584;12894;3845;11713;132;539;3020;9008;3152;9547
230930;202007;6469;18085;5396;16157;289;839;3761;11275;4050;12114
230940;202007;7992;20304;6863;18568;198;504;5720;15383;5918;15887
230945;202007;6448;18536;5521;16758;301;1075;3921;11696;4222;12771
230950;202007;6163;15552;5429;14544;94;244;4708;12640;4802;12884
230960;202007;13157;38183;11547;35152;1868;5668;5848;17987;7716;23655
230970;202007;13429;35557;11160;32007;1720;4876;6315;18405;8035;23281
230980;202007;2654;7770;2326;7190;341;1004;1443;4580;1784;5584
230990;202007;1627;4577;1346;4011;63;269;965;2737;1028;3006
231000;202007;2474;6598;2006;5666;77;198;1480;4098;1557;4296
231010;202007;3527;8262;2773;6949;43;167;2403;5835;2446;6002
231020;202007;7983;25041;7103;23285;1295;3919;4021;13764;5316;17683
231025;202007;7443;20520;6442;18874;716;2059;4474;13223;5190;15282
231030;202007;7223;21485;5624;18102;884;2752;2939;9516;3823;12268
231040;202007;2902;8390;2520;7672;117;366;1973;5917;2090;6283
231050;202007;11622;29847;9337;25793;637;1715;6936;18738;7573;20453
231060;202007;2895;8105;2530;7519;61;206;2071;6152;2132;6358
231070;202007;7720;22383;6574;20378;695;2217;4256;13115;4951;15332
231080;202007;3940;11224;3345;10252;128;537;2541;7621;2669;8158
231085;202007;6746;16369;5325;14663;201;533;4178;11508;4379;12041
231090;202007;4508;11657;3311;9344;112;432;2266;6140;2378;6572
231095;202007;2281;6768;1778;5673;136;440;1181;3759;1317;4199
231100;202007;3140;9063;2586;8020;117;434;1933;5920;2050;6354
231110;202007;3563;10447;3232;9831;122;442;2419;7260;2541;7702
231120;202007;2216;6469;1826;5791;72;283;1316;4123;1388;4406
231123;202007;1874;4845;1565;4315;68;151;1143;3176;1211;3327
231126;202007;5476;15045;4416;13036;272;790;3181;9297;3453;10087
231130;202007;21116;54104;17514;49536;994;3658;12982;35984;13976;39642
231135;202007;4136;11627;3405;10193;148;495;2435;7160;2583;7655
231140;202007;16359;46001;12992;40029;583;2432;9131;27389;9714;29821
231150;202007;5762;15666;4423;13113;670;2010;1980;6025;2650;8035
231160;202007;6191;18833;5414;17385;758;2317;3126;10297;3884;12614
231170;202007;4320;12637;3547;11150;188;686;2460;7474;2648;8160
231180;202007;14369;40616;11599;34754;3195;9242;3925;12290;7120;21532
231190;202007;3858;10883;3167;9615;67;300;2433;7194;2500;7494
231195;202007;4924;14882;4064;13081;236;878;2927;9334;3163;10212
231200;202007;7749;24216;6741;22168;196;994;5291;16866;5487;17860
231210;202007;4810;14068;4085;12858;182;681;3092;9541;3274;10222
231220;202007;12016;31249;9274;26032;394;1231;6799;18391;7193;19622
231230;202007;9173;29195;8050;27159;489;1916;5920;19972;6409;21888
231240;202007;11389;33269;9992;30604;1508;4496;6074;18824;7582;23320
231250;202007;2113;5445;1370;3796;98;273;836;2272;934;2545
231260;202007;3218;9086;2777;8388;262;784;1901;5863;2163;6647
231270;202007;6364;16643;5134;14630;149;593;3883;10806;4032;11399
231280;202007;1716;5339;1563;5054;90;303;1172;3757;1262;4060
231290;202007;37445;111489;30939;98150;5198;16327;14335;45272;19533;61599
231300;202007;4034;11170;3140;9364;204;664;2075;6068;2279;6732
231310;202007;7218;18663;5730;15907;470;1311;3941;10764;4411;12075
231320;202007;7755;21246;6043;18199;88;420;4720;13994;4808;14414
231325;202007;2421;6389;1981;5720;168;393;1328;3933;1496;4326
231330;202007;9382;28083;7674;24672;1373;4202;4101;13785;5474;17987
231335;202007;5676;14973;4791;13534;83;353;4218;11786;4301;12139
231340;202007;17210;53334;15397;50075;1272;4187;11215;36875;12487;41062
231350;202007;15741;42924;14259;40820;275;1006;12766;36195;13041;37201
231355;202007;4354;12974;3891;12097;233;781;3013;9275;3246;10056
231360;202007;7257;21993;6287;20294;247;915;5006;16093;5253;17008
231370;202007;2149;5926;1716;5156;35;112;1309;3927;1344;4039
231375;202007;4337;13470;3949;12827;135;611;3294;10557;3429;11168
231380;202007;5985;16251;5400;15440;183;487;4396;12757;4579;13244
231390;202007;3293;9608;2936;9014;122;481;2176;6500;2298;6981
231395;202007;3984;11684;3291;10567;413;1324;1936;6290;2349;7614
231400;202007;9614;27537;8032;24623;267;1127;6077;18228;6344;19355
231410;202007;14557;45198;13185;42904;589;2256;10634;34207;11223;36463
240010;202007;2588;6790;2006;5716;198;569;1194;3336;1392;3905
240020;202007;12424;34786;10395;31158;633;2345;6955;20527;7588;22872
240030;202007;2849;6951;2580;6533;88;256;2235;5614;2323;5870
240040;202007;807;2328;669;2058;33;129;466;1377;499;1506
240050;202007;3277;8774;2656;7647;48;151;2036;5753;2084;5904
240060;202007;1394;3732;1147;3285;23;86;939;2626;962;2712
240070;202007;2136;6196;1929;5767;177;570;1395;4057;1572;4627
240080;202007;2930;7893;2375;6866;52;205;1826;5172;1878;5377
240090;202007;2239;5494;1814;4773;18;50;1532;3988;1550;4038
240100;202007;10099;24888;8003;21047;205;628;6265;15918;6470;16546
240110;202007;4605;12938;3866;11591;189;682;2799;8235;2988;8917
240120;202007;3272;9070;2616;8261;182;610;1848;5988;2030;6598
240130;202007;3612;7536;3005;6747;29;86;2745;6079;2774;6165
240140;202007;1799;5379;1530;4850;157;550;1032;3241;1189;3791
240145;202007;6595;18254;5364;16139;820;2516;3020;9205;3840;11721
240150;202007;919;2689;806;2449;52;183;621;1828;673;2011
240160;202007;1445;4350;1205;3894;45;206;900;2920;945;3126
240165;202007;963;2631;799;2318;31;105;649;1849;680;1954
240170;202007;2500;6739;2091;5989;189;621;1426;3954;1615;4575
240180;202007;2966;8792;2361;7549;556;1680;1059;3606;1615;5286
240185;202007;1201;3774;1099;3595;53;214;911;2940;964;3154
240190;202007;1041;3099;890;2846;21;99;755;2429;776;2528
240200;202007;10888;27779;8647;23927;875;2642;4948;13355;5823;15997
240210;202007;3230;7965;2642;7033;25;134;2227;5750;2252;5884
240220;202007;7226;21571;6447;20345;328;1444;5077;15739;5405;17183
240230;202007;5811;14781;4647;12822;196;554;3691;10191;3887;10745
240240;202007;1840;5271;1145;3612;116;396;424;1193;540;1589
240250;202007;2929;7682;2577;7202;96;290;2161;6004;2257;6294
240260;202007;14070;41287;12110;37954;1709;5000;7511;24715;9220;29715
240270;202007;2263;6717;1971;6228;99;319;1432;4675;1531;4994
240280;202007;1681;4301;1423;3875;53;145;1139;3062;1192;3207
240290;202007;1188;3457;953;2929;30;137;679;1957;709;2094
240300;202007;2293;5827;1646;4633;66;203;1040;2853;1106;3056
240310;202007;8502;22413;6696;19166;889;2701;3475;9772;4364;12473
240320;202007;2021;5502;1489;4451;33;149;1113;3175;1146;3324
240325;202007;31358;83247;24798;71628;4333;12870;11049;32097;15382;44967
240330;202007;1753;4767;1337;3976;54;198;909;2564;963;2762
240340;202007;1967;4523;1596;3958;64;152;1303;3177;1367;3329
240350;202007;2170;5489;1936;5230;28;84;1754;4757;1782;4841
240360;202007;8789;24220;7810;22670;819;2409;5487;16093;6306;18502
240370;202007;1920;5044;1489;4158;64;190;1057;2870;1121;3060
240375;202007;901;2265;742;1964;27;98;608;1553;635;1651
240380;202007;2243;6355;1642;4996;142;410;955;2870;1097;3280
240390;202007;1025;2498;722;1919;27;59;455;1135;482;1194
240400;202007;1439;3517;1125;2970;34;123;792;1963;826;2086
240410;202007;561;1686;469;1480;38;146;298;885;336;1031
240420;202007;4546;15911;3993;14667;453;1969;2378;8557;2831;10526
240430;202007;3369;8699;2801;7695;173;553;2083;5545;2256;6098
240440;202007;2511;5476;2112;4927;137;265;1709;4002;1846;4267
240450;202007;4542;12317;3542;10419;347;1068;2098;5943;2445;7011
240460;202007;2860;8157;2574;7692;230;746;1996;5934;2226;6680
240470;202007;3635;10864;2758;9031;483;1482;1422;4886;1905;6368
240480;202007;576;1598;390;1183;33;104;181;532;214;636
240485;202007;2138;6018;1743;5282;122;381;1210;3671;1332;4052
240490;202007;1607;4117;1255;3462;83;196;925;2572;1008;2768
240500;202007;2145;5742;1871;5284;103;272;1507;4266;1610;4538
240510;202007;1677;4345;1471;4045;61;223;1223;3288;1284;3511
240520;202007;1451;3532;1125;3078;52;162;852;2331;904;2493
240530;202007;2156;6119;1937;5775;92;283;1593;4728;1685;5011
240540;202007;2269;5671;1980;5219;61;122;1715;4525;1776;4647
240550;202007;679;1917;613;1785;18;75;511;1444;529;1519
240560;202007;3296;8511;2766;7797;269;683;2013;5781;2282;6464
240570;202007;2827;7387;1864;5247;286;816;724;1908;1010;2724
240580;202007;8062;23432;7109;21659;552;1602;5665;17410;6217;19012
240590;202007;738;1917;640;1751;11;38;487;1297;498;1335
240600;202007;1775;4829;1305;3844;46;149;863;2451;909;2600
240610;202007;4190;11293;3532;10092;126;429;2704;7577;2830;8006
240615;202007;1261;3212;995;2731;104;274;670;1808;774;2082
240620;202007;1836;5155;1579;4700;93;258;1264;3752;1357;4010
240630;202007;2084;5880;1880;5529;148;311;1326;4077;1474;4388
240640;202007;948;2527;751;2197;30;115;562;1617;592;1732
240650;202007;4030;11205;3469;10060;218;641;2651;7588;2869;8229
240660;202007;3093;7892;2744;7439;50;155;2485;6743;2535;6898
240670;202007;2440;6868;1954;5873;138;448;1267;3703;1405;4151
240680;202007;1630;4313;1309;3763;46;143;997;2790;1043;2933
240690;202007;1001;2500;792;2149;16;69;629;1636;645;1705
240700;202007;2423;6980;1968;6121;56;199;1551;4743;1607;4942
240710;202007;16205;41838;13518;37200;1734;4651;8364;23042;10098;27693
240720;202007;5156;12665;4454;11680;387;1052;3267;8479;3654;9531
240725;202007;1123;3185;856;2647;36;121;571;1704;607;1825
240730;202007;2235;6257;1804;5401;61;221;1371;4023;1432;4244
240740;202007;1796;4823;1435;4113;43;163;1058;2876;1101;3039
240750;202007;2134;7027;1792;6295;263;1007;959;3404;1222;4411
240760;202007;1615;3790;1137;3049;63;96;869;2422;932;2518
240770;202007;3201;8796;2682;8045;128;468;2154;6377;2282;6845
240780;202007;4865;13332;3946;11790;538;1567;2415;7414;2953;8981
240790;202007;867;2455;718;2156;15;69;545;1588;560;1657
240800;202007;46829;112253;36278;96195;4973;13507;18667;49616;23640;63123
240810;202007;89454;231348;75431;207866;9238;26139;47970;130280;57208;156419
240820;202007;5813;17240;5024;15806;689;2127;3103;9940;3792;12067
240830;202007;8703;24734;7710;23241;252;1084;6383;18957;6635;20041
240840;202007;1116;2746;881;2368;29;74;630;1625;659;1699
240850;202007;1360;3689;973;2873;46;146;536;1523;582;1669
240860;202007;1295;3444;977;2871;15;75;726;2029;741;2104
240870;202007;1103;2797;830;2319;131;373;451;1286;582;1659
240880;202007;1256;3965;1110;3676;84;356;858;2760;942;3116
240890;202007;4377;11945;3314;9894;441;1428;1701;4879;2142;6307
240895;202007;2784;8567;2546;8189;141;453;2210;7169;2351;7622
240910;202007;3359;9097;2863;8192;54;189;2337;6571;2391;6760
240920;202007;894;2428;737;2171;67;185;422;1295;489;1480
240930;202007;3678;8338;3037;7554;197;285;2279;5980;2476;6265
240933;202007;1769;4277;1447;3806;41;163;1256;3247;1297;3410
240940;202007;6083;14981;4705;12621;539;1458;2814;7344;3353;8802
240950;202007;1019;3033;888;2792;25;107;722;2214;747;2321
240960;202007;686;2088;614;1943;30;107;472;1459;502;1566
240970;202007;1839;4717;1488;4115;56;206;1219;3260;1275;3466
240980;202007;3305;9809;2923;9119;112;483;2362;7244;2474;7727
240990;202007;2575;7240;2273;6646;266;852;1597;4510;1863;5362
241000;202007;948;2517;750;2147;28;75;554;1561;582;1636
241010;202007;2779;8875;2532;8340;157;628;1869;6062;2026;6690
241020;202007;2137;5646;1580;4526;133;383;1030;2899;1163;3282
241025;202007;1768;5034;1404;4346;49;202;1020;3109;1069;3311
241030;202007;2495;7765;1989;6680;221;759;1278;4296;1499;5055
241040;202007;2287;7207;2021;6752;97;432;1616;5350;1713;5782
241050;202007;1345;3731;1105;3296;33;125;810;2348;843;2473
241060;202007;751;2110;659;1914;27;87;465;1295;492;1382
241070;202007;664;1803;570;1637;12;39;449;1243;461;1282
241080;202007;1133;3179;856;2624;9;36;620;1872;629;1908
241090;202007;2013;5873;1638;5225;43;218;1294;4066;1337;4284
241100;202007;1166;3261;918;2752;67;206;599;1740;666;1946
241105;202007;974;2942;791;2594;251;799;257;881;508;1680
241110;202007;957;2700;715;2192;33;104;473;1395;506;1499
241120;202007;7624;21446;6456;19376;958;2811;3810;11751;4768;14562
241140;202007;3298;8680;2589;7256;153;438;1865;5105;2018;5543
241142;202007;776;2079;570;1681;25;86;341;949;366;1035
241150;202007;5921;15361;5212;14192;145;495;4276;11430;4421;11925
241160;202007;1138;3047;916;2640;133;388;589;1659;722;2047
241170;202007;1331;3388;1135;3050;28;109;949;2444;977;2553
241180;202007;1033;2641;747;2079;95;274;377;1038;472;1312
241190;202007;1139;2995;950;2618;18;73;692;1834;710;1907
241200;202007;19409;50666;16657;46148;2618;7251;9677;26858;12295;34109
241210;202007;1424;3790;1016;2964;119;380;579;1643;698;2023
241220;202007;8844;25865;7672;23864;1743;5362;3635;11775;5378;17137
241230;202007;2934;7654;2583;7105;104;321;2148;5841;2252;6162
241240;202007;1224;3399;760;2358;64;199;334;1038;398;1237
241250;202007;5399;15642;4312;13584;160;735;3124;9470;3284;10205
241255;202007;2257;7004;1988;6430;112;450;1516;4801;1628;5251
241260;202007;4913;12736;3847;10949;80;322;3047;8485;3127;8807
241270;202007;1740;4992;1429;4392;104;360;1025;3137;1129;3497
241280;202007;2184;5441;1867;4865;57;143;1588;4077;1645;4220
241290;202007;3405;8297;2520;6855;75;248;1988;5258;2063;5506
241300;202007;1481;3936;1182;3400;38;126;798;2236;836;2362
241310;202007;2142;5269;1838;4838;14;57;1566;4159;1580;4216
241320;202007;943;3049;803;2780;86;363;520;1775;606;2138
241330;202007;1750;4543;1368;4033;16;83;1188;3475;1204;3558
241335;202007;3236;9004;2856;8310;103;343;2357;6779;2460;7122
241340;202007;1565;4397;1209;3653;254;807;494;1453;748;2260
241350;202007;2082;5898;1821;5429;91;314;1417;4150;1508;4464
241355;202007;1303;3521;1065;3051;16;45;825;2354;841;2399
241360;202007;2053;5304;1538;4249;38;115;1103;2931;1141;3046
241370;202007;1342;3707;1036;3065;48;166;721;2041;769;2207
241380;202007;628;1764;485;1485;74;192;243;773;317;965
241390;202007;2756;8009;2448;7550;197;546;1888;5930;2085;6476
241400;202007;3567;9851;3170;9225;155;492;2572;7423;2727;7915
241410;202007;2405;7110;1956;6189;344;1107;991;3145;1335;4252
241415;202007;1663;4900;1354;4292;60;226;949;2953;1009;3179
241420;202007;2316;7253;1977;6666;462;1737;971;3264;1433;5001
241430;202007;609;1677;415;1237;18;59;257;737;275;796
241440;202007;7550;23142;6740;21713;359;1291;5327;17087;5686;18378
241445;202007;1114;2825;984;2656;22;56;872;2412;894;2468
241450;202007;2645;6543;2258;5916;392;872;1465;3989;1857;4861
241460;202007;3793;10231;3067;8687;196;587;2150;5939;2346;6526
241470;202007;1405;3699;1138;3304;25;92;950;2756;975;2848
241475;202007;1202;3371;941;2860;23;112;676;1961;699;2073
241480;202007;2926;9100;2404;7948;721;2361;799;2939;1520;5300
241490;202007;636;1501;520;1344;26;68;374;947;400;1015
241500;202007;801;2258;711;2141;3;10;659;2006;662;2016
250010;202007;2522;7540;2089;6647;59;238;1523;4738;1582;4976
250020;202007;1618;4315;1163;3426;37;77;834;2460;871;2537
250030;202007;6956;18911;6117;17584;534;1566;4552;12944;5086;14510
250040;202007;4007;12257;3452;11223;227;844;2500;8000;2727;8844
250050;202007;3611;9684;3253;9199;128;439;2648;7500;2776;7939
250053;202007;1174;3265;1063;3084;71;206;773;2255;844;2461
250057;202007;653;2325;609;2257;10;44;544;2050;554;2094
250060;202007;5479;14256;4914;13556;290;777;4048;11235;4338;12012
250070;202007;3956;11026;3352;9961;37;155;2696;7842;2733;7997
250073;202007;761;2017;619;1799;9;22;507;1438;516;1460
250077;202007;2203;5916;1649;4998;61;216;1247;3751;1308;3967
250080;202007;4881;12133;4133;11166;65;286;3611;9624;3676;9910
250090;202007;3323;8113;2898;7547;53;159;2493;6377;2546;6536
250100;202007;3639;11060;3278;10377;159;564;2567;7957;2726;8521
250110;202007;4893;13679;4395;12946;259;970;3420;9852;3679;10822
250115;202007;689;1793;500;1502;9;45;347;1039;356;1084
250120;202007;1816;5315;1521;4825;30;142;1202;3785;1232;3927
250130;202007;5503;15070;4640;13840;72;386;3931;11567;4003;11953
250135;202007;1197;3308;1040;3027;25;96;900;2597;925;2693
250140;202007;2255;6556;2094;6351;105;439;1801;5396;1906;5835
250150;202007;4791;14894;4295;14040;135;622;3462;11116;3597;11738
250153;202007;1406;3700;1169;3339;30;88;935;2649;965;2737
250157;202007;1715;5086;1556;4782;56;233;1238;3738;1294;3971
250160;202007;3912;9705;3114;8625;40;148;2739;7590;2779;7738
250170;202007;1843;4716;1642;4431;24;95;1433;3819;1457;3914
250180;202007;20133;48496;17124;44637;738;2312;13358;33937;14096;36249
250190;202007;4038;10760;3363;9742;316;959;2324;6565;2640;7524
250200;202007;1943;5161;1649;4748;61;190;1384;3989;1445;4179
250205;202007;863;2653;743;2462;17;85;614;2002;631;2087
250210;202007;1554;4690;1398;4437;73;318;1087;3392;1160;3710
250215;202007;1556;4265;1294;3883;75;257;776;2336;851;2593
250220;202007;659;1825;529;1632;27;103;347;1047;374;1150
250230;202007;1668;3733;1109;2865;17;60;922;2292;939;2352
250240;202007;2298;6974;2010;6439;40;202;1665;5248;1705;5450
250250;202007;4573;12660;3976;11775;82;292;3399;10071;3481;10363
250260;202007;1703;4731;1412;4228;50;135;1116;3321;1166;3456
250270;202007;1204;3608;1086;3462;59;205;806;2669;865;2874
250280;202007;3338;9254;2981;8718;108;307;2363;6920;2471;7227
250290;202007;1593;4196;1355;3853;22;69;1063;3025;1085;3094
250300;202007;5495;14604;4926;13939;185;827;4109;11214;4294;12041
250310;202007;1160;3176;957;2839;38;126;728;2135;766;2261
250320;202007;11995;26838;10293;24876;250;697;9200;21929;9450;22626
250330;202007;2407;6602;2014;6059;106;327;1628;4895;1734;5222
250340;202007;1097;2777;979;2627;11;28;897;2400;908;2428
250350;202007;4105;11419;3623;10609;200;483;2842;8579;3042;9062
250355;202007;1965;5912;1760;5627;27;142;1577;5011;1604;5153
250360;202007;1775;4885;1578;4617;39;146;1322;3838;1361;3984
250370;202007;13426;34605;11061;31025;239;895;9287;25679;9526;26574
250375;202007;1187;3089;951;2801;5;17;895;2659;900;2676
250380;202007;1601;4130;1465;3957;27;114;1285;3361;1312;3475
250390;202007;1846;4680;1541;4188;84;233;1225;3292;1309;3525
250400;202007;69764;170905;50863;141260;14114;41920;14556;42698;28670;84618
250403;202007;1739;4844;1549;4615;73;366;1192;3384;1265;3750
250407;202007;1227;3045;983;2679;72;153;692;1946;764;2099
250410;202007;642;1716;556;1567;4;9;464;1280;468;1289
250415;202007;1873;5206;1637;4824;32;145;1409;4124;1441;4269
250420;202007;1178;3331;1072;3184;25;96;957;2824;982;2920
250430;202007;6252;15325;5269;14000;138;428;4356;11334;4494;11762
250435;202007;1534;4272;1227;3729;11;53;941;2823;952;2876
250440;202007;4580;12067;3911;11221;69;193;3469;9955;3538;10148
250450;202007;1823;4803;1487;4340;29;103;1238;3627;1267;3730
250460;202007;7340;19832;6489;18571;327;999;5217;14856;5544;15855
250470;202007;1543;3969;1271;3549;51;161;997;2730;1048;2891
250480;202007;4039;10850;3420;10108;41;146;3016;8986;3057;9132
250485;202007;718;1618;527;1341;39;66;387;957;426;1023
250490;202007;5167;12243;4581;11570;173;518;4044;10023;4217;10541
250500;202007;1988;5477;1761;5081;72;233;1428;4116;1500;4349
250510;202007;5454;13652;4667;12604;75;199;4076;11103;4151;11302
250520;202007;1821;4921;1551;4526;123;394;1105;3199;1228;3593
250523;202007;2228;5470;1969;5143;67;281;1645;4139;1712;4420
250527;202007;1673;4306;1502;4112;24;76;1332;3666;1356;3742
250530;202007;633;1618;537;1484;5;11;475;1313;480;1324
250535;202007;1350;3950;1217;3692;26;111;998;2935;1024;3046
250540;202007;2950;6761;2455;6207;66;123;2150;5529;2216;5652
250550;202007;773;2463;675;2270;22;86;504;1663;526;1749
250560;202007;1739;4774;1533;4477;35;137;1294;3691;1329;3828
250570;202007;2634;7886;2254;7191;79;299;1777;5581;1856;5880
250580;202007;1050;2711;922;2533;47;177;774;2075;821;2252
250590;202007;816;2273;726;2144;19;65;594;1765;613;1830
250600;202007;8190;20861;6825;19090;236;734;5643;15665;5879;16399
250610;202007;2970;8314;2650;7845;118;442;2204;6445;2322;6887
250620;202007;780;2051;663;1852;10;30;490;1338;500;1368
250625;202007;2478;7137;2209;6691;43;229;1873;5508;1916;5737
250630;202007;10106;27927;8138;24457;854;2602;5197;15314;6051;17916
250640;202007;3427;9355;3077;8901;89;366;2643;7512;2732;7878
250650;202007;955;2282;797;2069;13;36;691;1771;704;1807
250660;202007;1634;4026;1309;3579;38;105;1078;2879;1116;2984
250670;202007;2324;7207;2110;6828;44;193;1837;5839;1881;6032
250680;202007;5807;13333;5176;12622;59;225;4798;11547;4857;11772
250690;202007;6815;15273;5753;13948;93;225;5103;12266;5196;12491
250700;202007;4271;11969;3719;11126;425;1255;2591;7721;3016;8976
250710;202007;4405;12578;3780;11720;271;939;2760;8550;3031;9489
250720;202007;2733;7277;2443;6863;36;178;2139;5937;2175;6115
250730;202007;4113;10895;3584;10196;102;421;3002;8292;3104;8713
250740;202007;1915;4779;1585;4338;90;212;1236;3403;1326;3615
250750;202007;104346;255776;87849;232584;7040;20249;63512;164926;70552;185175
250760;202007;2367;6104;2059;5602;84;256;1636;4319;1720;4575
250770;202007;4017;12061;3590;11487;386;1201;2579;8349;2965;9550
250780;202007;1733;4661;1439;4123;49;175;1113;3102;1162;3277
250790;202007;2448;7229;2108;6711;130;515;1435;4457;1565;4972
250800;202007;2453;6481;2132;5961;85;177;1728;4873;1813;5050
250810;202007;1269;3339;1048;3026;28;60;884;2588;912;2648
250820;202007;1978;5483;1818;5306;32;139;1660;4813;1692;4952
250830;202007;5826;17387;4780;15275;263;1019;3295;10203;3558;11222
250840;202007;759;2397;649;2177;14;56;491;1655;505;1711
250850;202007;1788;5312;1595;4967;33;157;1319;4002;1352;4159
250855;202007;945;2803;818;2578;55;198;613;1911;668;2109
250860;202007;3160;9329;2611;8395;440;1487;1528;4916;1968;6403
250870;202007;1040;2839;875;2561;30;113;719;2071;749;2184
250880;202007;1615;4119;1330;3707;73;211;1017;2829;1090;3040
250890;202007;10175;26405;8975;24776;408;1709;7166;18822;7574;20531
250900;202007;2818;7783;2434;7090;67;236;2061;5890;2128;6126
250905;202007;2406;6793;2206;6503;43;171;2007;5907;2050;6078
250910;202007;5901;14665;4851;13474;81;288;4221;11778;4302;12066
250915;202007;2162;5013;1506;4305;24;53;1311;3836;1335;3889
250920;202007;3525;8858;3086;8184;334;757;2263;6048;2597;6805
250930;202007;2255;5970;2031;5684;53;218;1762;4827;1815;5045
250933;202007;1158;3435;1021;3185;21;106;785;2378;806;2484
250937;202007;699;1867;571;1656;24;74;435;1283;459;1357
250939;202007;1753;4666;1522;4360;62;196;1191;3389;1253;3585
250940;202007;4004;10681;3510;10028;17;62;3121;8934;3138;8996
250950;202007;1718;4328;1381;3899;26;95;1137;3164;1163;3259
250960;202007;1125;3270;982;3042;26;140;799;2381;825;2521
250970;202007;8294;21181;7243;19495;222;680;6013;15885;6235;16565
250980;202007;2427;6414;2170;6029;34;146;1872;5066;1906;5212
250990;202007;2061;6196;1714;5587;54;255;1266;4075;1320;4330
251000;202007;2056;5751;1665;5075;37;159;1359;4109;1396;4268
251010;202007;2668;7410;2415;7029;19;78;2179;6345;2198;6423
251020;202007;1635;4429;1462;4154;32;146;1270;3534;1302;3680
251030;202007;1004;2659;822;2323;33;94;580;1614;613;1708
251040;202007;1829;5146;1533;4641;38;188;1237;3715;1275;3903
251050;202007;1060;2881;882;2535;48;157;629;1743;677;1900
251060;202007;1076;2298;809;1958;8;26;640;1521;648;1547
251065;202007;476;1297;367;1095;11;33;249;724;260;757
251070;202007;728;1876;619;1715;10;41;530;1440;540;1481
251080;202007;18516;47290;15033;42031;1815;5269;9726;27294;11541;32563
251090;202007;2773;7976;2329;7179;55;199;1861;5694;1916;5893
251100;202007;805;2556;717;2393;23;89;549;1761;572;1850
251110;202007;1696;4534;1439;4089;47;125;1091;3085;1138;3210
251120;202007;7281;20265;6117;18835;267;995;4864;14954;5131;15949
251130;202007;3865;8649;3407;8139;58;164;3086;7335;3144;7499
251140;202007;4247;11826;3795;11191;75;315;3172;9239;3247;9554
251150;202007;2639;7671;2369;7236;100;418;1944;5808;2044;6226
251160;202007;2132;6234;1848;5819;39;189;1590;4911;1629;5100
251170;202007;1557;4231;1351;3959;32;111;1168;3405;1200;3516
251180;202007;2632;7017;2148;6329;168;498;1464;4293;1632;4791
251190;202007;4384;11397;3988;10950;44;247;3626;9753;3670;10000
251200;202007;4333;12652;3812;11977;73;309;3355;10567;3428;10876
251203;202007;936;3029;861;2866;22;103;653;2116;675;2219
251207;202007;1083;2948;836;2534;19;96;585;1732;604;1828
251210;202007;7581;19208;6183;17302;273;641;4725;13485;4998;14126
251220;202007;1180;2835;926;2497;54;122;710;1958;764;2080
251230;202007;4588;12710;3947;11603;115;425;3114;8916;3229;9341
251240;202007;3651;9927;3059;8931;159;429;2294;6606;2453;7035
251250;202007;10253;27546;8959;25370;723;2154;6629;18215;7352;20369
251260;202007;480;1372;437;1305;12;62;348;1005;360;1067
251270;202007;4254;13195;3816;12611;109;449;3114;10511;3223;10960
251272;202007;1340;3622;1202;3437;45;168;1013;2820;1058;2988
251274;202007;894;2472;714;2143;61;202;473;1356;534;1558
251275;202007;1213;3389;1034;3098;29;131;813;2368;842;2499
251276;202007;1318;3570;1145;3341;31;161;930;2615;961;2776
251278;202007;579;1593;518;1504;46;111;377;1125;423;1236
251280;202007;2222;6034;1984;5667;50;171;1662;4680;1712;4851
251290;202007;5879;13866;5301;13158;148;493;4628;11126;4776;11619
251300;202007;857;2507;775;2383;8;41;658;2019;666;2060
251310;202007;2705;7778;2350;7221;49;259;1887;5650;1936;5909
251315;202007;1697;5289;1548;5014;82;252;1175;3760;1257;4012
251320;202007;1612;4268;1154;3480;37;129;861;2548;898;2677
251330;202007;2111;4891;1717;4428;21;77;1549;4025;1570;4102
251335;202007;1082;3136;966;2953;25;114;845;2523;870;2637
251340;202007;3692;8906;2948;7908;117;352;2264;6036;2381;6388
251350;202007;1055;3036;946;2853;26;100;779;2310;805;2410
251360;202007;1826;5098;1472;4600;21;99;1243;3903;1264;4002
251365;202007;720;1956;567;1654;6;23;445;1282;451;1305
251370;202007;24494;64369;20961;59271;2822;8076;12767;36861;15589;44937
251380;202007;1205;3400;1051;3137;19;108;879;2547;898;2655
251385;202007;745;1917;569;1593;15;43;423;1144;438;1187
251390;202007;6430;18609;5658;17392;470;1491;3758;11591;4228;13082
251392;202007;973;2643;814;2401;27;111;632;1825;659;1936
251394;202007;610;1763;501;1570;18;81;375;1154;393;1235
251396;202007;665;1786;568;1615;14;41;402;1116;416;1157
251398;202007;960;2410;666;1906;18;72;492;1365;510;1437
251400;202007;1219;2974;973;2642;25;95;774;2029;799;2124
251410;202007;1473;3488;1205;3108;18;76;1029;2555;1047;2631
251420;202007;1904;5010;1541;4584;37;150;1224;3599;1261;3749
251430;202007;1513;4634;1359;4366;27;122;1175;3780;1202;3902
251440;202007;1099;3078;885;2679;36;98;703;2140;739;2238
251445;202007;1527;4266;1404;4095;36;121;1184;3402;1220;3523
251450;202007;4490;13083;3974;12311;85;336;3302;10136;3387;10472
251455;202007;855;2587;776;2446;22;99;615;1889;637;1988
251460;202007;882;2551;773;2384;16;55;635;1971;651;2026
251465;202007;450;1312;385;1193;7;28;287;866;294;894
251470;202007;1179;3247;880;2620;70;225;509;1445;579;1670
251480;202007;988;2608;803;2274;19;80;619;1668;638;1748
251490;202007;1881;4941;1488;4392;57;178;1106;3269;1163;3447
251500;202007;1935;5437;1774;5225;28;99;1611;4752;1639;4851
251510;202007;2645;7905;2183;6976;106;397;1482;4624;1588;5021
251520;202007;967;2546;731;2111;63;179;474;1337;537;1516
251530;202007;14663;35108;11753;31475;103;576;10387;27312;10490;27888
251540;202007;2976;8459;2683;7910;75;263;2234;6487;2309;6750
251550;202007;3766;8876;3009;7930;102;201;2507;6663;2609;6864
251560;202007;544;1645;475;1537;58;200;327;1025;385;1225
251570;202007;942;2642;763;2285;18;80;607;1764;625;1844
251580;202007;1885;4466;1679;4165;36;152;1464;3487;1500;3639
251590;202007;1567;3885;1315;3589;50;135;1096;2941;1146;3076
251593;202007;903;2630;806;2474;85;266;520;1573;605;1839
251597;202007;2108;5892;1895;5611;20;103;1687;4927;1707;5030
251600;202007;6403;17228;5592;15987;167;532;4625;13029;4792;13561
251610;202007;3219;9137;2755;8269;251;698;1910;5832;2161;6530
251615;202007;1239;3083;999;2720;24;66;801;2127;825;2193
251620;202007;18935;43581;14570;38221;106;363;12465;33178;12571;33541
251630;202007;4702;11049;3772;9760;193;510;2839;7284;3032;7794
251640;202007;2144;5818;1895;5427;27;131;1645;4597;1672;4728
251650;202007;3934;10583;3438;9924;124;402;2925;8429;3049;8831
251660;202007;3461;10356;3035;9600;70;330;2540;7897;2610;8227
251670;202007;3979;11266;3542;10641;49;249;3154;9386;3203;9635
251675;202007;640;1834;578;1758;76;231;382;1177;458;1408
251680;202007;2502;6614;2079;6065;43;141;1678;4938;1721;5079
251690;202007;3100;8677;2610;7821;89;270;1951;5789;2040;6059
251700;202007;2080;5906;1738;5475;42;194;1475;4563;1517;4757
251710;202007;793;2050;540;1532;41;137;314;860;355;997
251720;202007;1304;3688;1047;3235;23;103;801;2403;824;2506
251740;202007;616;1716;494;1485;45;162;328;946;373;1108
260005;202007;29696;62603;24371;55752;1608;3633;18816;42247;20424;45880
260010;202007;10225;26762;8414;23812;464;1394;5008;14226;5472;15620
260020;202007;6782;15924;5765;14462;108;488;4872;11997;4980;12485
260030;202007;6788;17343;5720;15797;135;413;4645;12765;4780;13178
260040;202007;7562;19622;6298;17779;436;1210;4427;12709;4863;13919
260050;202007;13890;35992;11507;33347;181;708;10558;30646;10739;31354
260060;202007;4015;9995;3443;9068;200;475;2708;7150;2908;7625
260070;202007;10500;26337;8961;24112;327;1139;7243;18967;7570;20106
260080;202007;6507;14808;5675;13705;112;363;4778;11328;4890;11691
260090;202007;4636;11941;4104;11211;457;1274;2907;7946;3364;9220
260100;202007;3001;8084;2503;7348;53;266;2060;5943;2113;6209
260105;202007;4997;13626;4468;12919;125;441;3760;10732;3885;11173
260110;202007;22167;61207;19673;57578;926;3156;16209;46792;17135;49948
260120;202007;14408;38301;12069;34786;1417;4026;7726;22622;9143;26648
260130;202007;3072;7898;2738;7406;249;666;1992;5318;2241;5984
260140;202007;13007;29360;11185;27182;536;1463;9389;22481;9925;23944
260150;202007;3596;8305;3079;7666;83;247;2707;6669;2790;6916
260160;202007;6487;16947;5471;15705;87;312;4925;14282;5012;14594
260170;202007;20166;47575;17069;43339;894;2281;13633;34210;14527;36491
260180;202007;3482;9262;3009;8619;73;267;2587;7307;2660;7574
260190;202007;18233;36567;15301;33106;165;437;13569;28806;13734;29243
260200;202007;11131;26612;9542;24584;434;985;7960;20796;8394;21781
260210;202007;11819;33330;9985;30317;322;1221;7944;23968;8266;25189
260220;202007;10240;24716;9449;23711;168;556;8318;20573;8486;21129
260230;202007;10696;26204;9313;24363;194;637;7853;20183;8047;20820
260240;202007;2671;7995;2331;7343;104;353;1802;5637;1906;5990
260250;202007;2176;5730;1887;5276;114;262;1439;4016;1553;4278
260260;202007;13004;33666;11558;31442;363;1211;9172;24448;9535;25659
260270;202007;4265;10230;3741;9595;132;474;3132;7879;3264;8353
260280;202007;12656;38131;11334;36254;439;1918;9650;30418;10089;32336
260290;202007;40445;102156;34701;93804;3714;10261;23557;63432;27271;73693
260300;202007;9572;25833;8294;24093;189;859;6977;20202;7166;21061
260310;202007;5074;13043;4454;12245;302;776;3445;9615;3747;10391
260320;202007;7644;21965;6437;19907;255;815;5239;16204;5494;17019
260330;202007;2547;7790;2225;7132;67;254;1762;5502;1829;5756
260340;202007;2030;5417;1745;4988;28;128;1495;4182;1523;4310
260345;202007;25020;64819;20828;58681;3063;9229;11060;30629;14123;39858
260350;202007;5520;13020;4791;12171;67;194;4246;10741;4313;10935
260360;202007;2514;6548;2265;6092;46;200;1589;4166;1635;4366
260370;202007;5544;15837;4763;14521;231;798;3676;11129;3907;11927
260380;202007;4945;14604;4214;13401;153;547;3162;9935;3315;10482
260390;202007;4472;13358;3707;11785;212;670;2488;7769;2700;8439
260392;202007;3328;10683;2981;10240;116;694;2402;8247;2518;8941
260400;202007;18143;41847;15647;38564;470;1336;12321;29219;12791;30555
260410;202007;73055;177089;56381;153607;9926;28362;25281;71061;35207;99423
260415;202007;4488;12094;3875;11072;61;256;3170;8918;3231;9174
260420;202007;12698;26326;10747;24151;99;281;9962;22176;10061;22457
260430;202007;2705;8438;2325;7682;102;410;1659;5420;1761;5830
260440;202007;3715;9630;3278;8953;68;244;2753;7381;2821;7625
260450;202007;5723;14397;5116;13619;294;603;4210;11426;4504;12029
260460;202007;5198;15429;4416;14046;471;1670;2642;8254;3113;9924
260470;202007;4909;12926;4139;12027;81;196;3791;11182;3872;11378
260480;202007;3965;10544;3320;9617;215;777;2303;6670;2518;7447
260490;202007;5326;12224;4708;11315;34;141;4284;10113;4318;10254
260500;202007;6092;15272;5207;14025;455;1159;3650;9972;4105;11131
260510;202007;9743;24005;8137;21765;115;459;7174;19003;7289;19462
260515;202007;4191;11428;3260;9656;144;427;2204;6358;2348;6785
260520;202007;17096;39443;14895;36614;759;1837;12128;29427;12887;31264
260530;202007;9756;27823;8295;25562;145;687;7110;21609;7255;22296
260540;202007;7176;15519;6315;14426;147;340;5667;12865;5814;13205
260545;202007;62;197;32;118;2;7;14;45;16;52
260550;202007;3036;8397;2486;7494;114;464;1678;4943;1792;5407
260560;202007;5896;15090;4962;13747;126;494;4176;11329;4302;11823
260570;202007;7710;20902;6770;19624;374;1182;5327;15500;5701;16682
260580;202007;4453;10526;4000;9927;21;73;3673;9087;3694;9160
260590;202007;6693;15494;5613;14284;226;544;4663;12033;4889;12577
260600;202007;30807;79556;24945;70518;1102;3441;18842;52366;19944;55807
260610;202007;7274;18678;6497;17669;391;1138;4880;13186;5271;14324
260620;202007;16289;42139;14165;39065;1246;3882;10284;27774;11530;31656
260630;202007;2381;6407;1942;5704;35;149;1568;4498;1603;4647
260640;202007;21596;48649;18047;44568;844;2059;14503;35651;15347;37710
260650;202007;6051;15809;4806;14284;192;636;4075;12099;4267;12735
260660;202007;7013;18499;6044;17203;155;676;5171;14384;5326;15060
260670;202007;2222;5783;1864;5236;75;190;1371;3789;1446;3979
260680;202007;28576;67777;23999;61218;1671;4538;16967;42408;18638;46946
260690;202007;3518;9095;2923;8169;87;340;2294;6353;2381;6693
260700;202007;6085;17443;5678;16975;20;69;5494;16545;5514;16614
260710;202007;1356;3559;1165;3286;31;121;914;2573;945;2694
260720;202007;23623;58470;20196;53888;1953;5337;14581;38699;16534;44036
260730;202007;7682;21973;6685;20579;261;981;5571;16873;5832;17854
260740;202007;1335;3772;1119;3415;12;64;880;2749;892;2813
260750;202007;7131;19454;5952;17977;206;469;5225;16203;5431;16672
260760;202007;5696;13409;4889;12452;185;513;4023;10278;4208;10791
260765;202007;8038;23051;6979;21589;405;1676;4936;14950;5341;16626
260770;202007;3834;9761;3185;8685;116;368;2500;6726;2616;7094
260775;202007;5210;13826;4567;12845;185;688;3561;9668;3746;10356
260780;202007;3617;10694;3220;10058;277;1043;2072;6246;2349;7289
260790;202007;119831;267169;98826;239643;15001;35203;60965;148369;75966;183572
260795;202007;2986;7638;2557;7075;77;259;1995;5563;2072;5822
260800;202007;5397;12435;4798;11605;123;385;4206;9846;4329;10231
260805;202007;3629;10225;3052;9203;160;568;2286;6762;2446;7330
260810;202007;6478;17524;5669;15964;456;1218;4097;11301;4553;12519
260820;202007;4557;10470;3980;9769;100;360;3284;7860;3384;8220
260825;202007;2911;8651;2529;7984;106;382;1889;5889;1995;6271
260830;202007;4222;12232;3497;10908;455;1252;2228;7174;2683;8426
260840;202007;4164;10836;3706;10202;204;526;3075;8492;3279;9018
260845;202007;4351;11449;3862;10610;226;630;2891;7845;3117;8475
260850;202007;5099;13911;4233;12241;346;1074;2729;7626;3075;8700
260860;202007;3502;9838;2958;8902;102;360;2355;6908;2457;7268
260870;202007;4551;10887;3870;10054;67;249;3449;8843;3516;9092
260875;202007;7054;17303;5775;15429;566;1520;3904;10516;4470;12036
260880;202007;9727;27181;8411;24895;482;1457;6583;19452;7065;20909
260890;202007;13018;33361;11259;30666;596;1743;8223;21853;8819;23596
260900;202007;5392;14941;4420;13556;311;1019;2936;8984;3247;10003
260910;202007;3226;8699;2785;8028;98;314;2187;6258;2285;6572
260915;202007;5207;15120;4542;14344;64;275;4142;13108;4206;13383
260920;202007;3283;8097;2749;7521;91;238;2350;6494;2441;6732
260930;202007;3727;11686;3160;10666;178;728;2333;7686;2511;8414
260940;202007;14740;34906;12811;32222;991;2434;9636;23920;10627;26354
260950;202007;6947;18467;5587;16115;359;1220;3610;9961;3969;11181
260960;202007;70350;156497;56320;138391;6192;15632;35775;86820;41967;102452
260970;202007;5575;14587;4951;13744;239;543;3745;10560;3984;11103
260980;202007;4536;13115;3992;12433;53;189;3640;11436;3693;11625
260990;202007;18041;49483;15239;45655;857;2815;11843;35153;12700;37968
261000;202007;16247;38059;13610;34699;372;1322;10985;27312;11357;28634
261010;202007;2390;6211;2085;5812;76;197;1808;5065;1884;5262
261020;202007;6133;16569;5252;15050;190;701;4256;11717;4446;12418
261030;202007;4039;11613;3490;10669;124;509;2763;8211;2887;8720
261040;202007;5233;15224;4210;13268;148;599;3142;9657;3290;10256
261050;202007;7769;20181;7051;19053;443;875;5374;14635;5817;15510
261060;202007;14171;35289;12295;33003;271;886;10245;27222;10516;28108
261070;202007;64882;140621;53667;125798;2799;6475;41043;94075;43842;100550
261080;202007;6737;16011;6140;15262;133;322;5654;14039;5787;14361
261090;202007;19235;45138;17082;42359;288;968;14986;36536;15274;37504
261100;202007;8354;23038;7227;21359;499;1584;5267;15571;5766;17155
261110;202007;66128;183134;55205;163449;7810;24368;32040;93865;39850;118233
261120;202007;3697;9214;3180;8511;87;222;2737;7341;2824;7563
261130;202007;7310;17794;6402;16566;116;353;5666;14554;5782;14907
261140;202007;3667;8405;3258;7857;171;443;2603;6173;2774;6616
261150;202007;5315;13819;4689;12873;71;268;4076;11062;4147;11330
261153;202007;1882;5658;1603;5114;57;205;1088;3488;1145;3693
261160;202007;211099;488527;170226;431596;41299;107994;70363;181612;111662;289606
261170;202007;6028;14986;5347;13965;316;755;4264;11072;4580;11827
261180;202007;9571;23711;8351;22099;449;1166;6085;16163;6534;17329
261190;202007;4589;13377;4090;12535;186;791;3205;9514;3391;10305
261200;202007;3382;7775;3012;7275;130;339;2535;6009;2665;6348
261210;202007;1913;4583;1620;4169;62;179;1363;3446;1425;3625
261220;202007;13786;38816;11415;34425;1427;4665;6495;19282;7922;23947
261230;202007;4023;11488;3362;10567;52;211;2801;8877;2853;9088
261240;202007;5353;13355;4678;12294;252;670;3847;9961;4099;10631
261245;202007;3582;10122;3011;9110;73;352;2398;7017;2471;7369
261247;202007;2926;8716;2418;7801;154;539;1647;5287;1801;5826
261250;202007;22502;51103;19474;47559;1736;3783;14780;37046;16516;40829
261255;202007;4072;11953;3293;10434;138;623;2418;7410;2556;8033
261260;202007;12709;34184;10954;31892;347;1423;9391;26970;9738;28393
261270;202007;4451;10883;3884;10158;189;530;3215;8282;3404;8812
261280;202007;2590;7131;2271;6584;70;247;1808;5094;1878;5341
261290;202007;2976;7625;2490;7070;68;273;2016;5761;2084;6034
261300;202007;12460;34503;10509;31169;585;2067;7630;22123;8215;24190
261310;202007;8789;22288;7478;20492;629;1937;5487;14669;6116;16606
261320;202007;5940;16768;5172;15501;79;347;4346;12827;4425;13174
261330;202007;5852;14264;5258;13488;123;439;4568;11491;4691;11930
261340;202007;4271;11875;3684;11118;136;503;3042;9073;3178;9576
261350;202007;8780;25460;7775;23781;123;574;6325;19059;6448;19633
261360;202007;8177;19646;6904;17844;240;686;5497;13834;5737;14520
261370;202007;23516;58616;19735;53352;2099;5595;12775;34779;14874;40374
261380;202007;4084;12270;3584;11388;449;1498;2342;7333;2791;8831
261390;202007;16712;47103;14046;42767;1205;3988;9328;28174;10533;32162
261400;202007;4618;14613;4003;13295;168;739;2993;9691;3161;10430
261410;202007;9581;23772;7865;21122;458;1306;6188;16238;6646;17544
261420;202007;7378;21979;6632;21051;773;2832;4665;14721;5438;17553
261430;202007;3423;9624;2871;8755;60;266;2386;7165;2446;7431
261440;202007;1478;4378;1227;3891;37;182;879;2655;916;2837
261450;202007;14986;40300;13213;37546;190;694;10933;31115;11123;31809
261460;202007;7504;20695;6625;19303;207;744;5370;15514;5577;16258
261470;202007;4188;10335;3642;9613;24;125;3138;8264;3162;8389
261480;202007;5062;15463;4346;14256;190;774;3365;10811;3555;11585
261485;202007;4938;14040;4247;12956;336;1118;3031;9098;3367;10216
261500;202007;5899;15036;5156;14028;381;923;3603;10180;3984;11103
261510;202007;1901;5608;1644;5179;60;223;1245;3944;1305;4167
261520;202007;2351;7209;2111;6710;69;248;1539;4865;1608;5113
261530;202007;11950;34862;9675;30668;908;3421;4910;14977;5818;18398
261540;202007;8149;23243;7312;22032;1062;3164;4164;13223;5226;16387
261550;202007;3681;9726;3179;8934;226;678;2276;6279;2502;6957
261560;202007;7800;23081;6738;21499;279;1069;5189;16558;5468;17627
261570;202007;3549;9448;2831;8296;197;689;1951;5599;2148;6288
261580;202007;6745;17594;5801;16315;108;511;5194;14394;5302;14905
261590;202007;2721;6903;2178;6134;70;226;1650;4618;1720;4844
261600;202007;5146;12916;4320;11672;299;727;3026;8401;3325;9128
261610;202007;2210;6220;1769;5417;98;358;1204;3645;1302;4003
261618;202007;2545;6296;2218;5815;64;178;1783;4643;1847;4821
261620;202007;4191;11704;3822;11169;833;2155;2381;7339;3214;9494
261630;202007;6327;17693;5348;15836;366;1291;3583;10177;3949;11468
261640;202007;37471;83672;31795;76622;1833;3513;23972;59542;25805;63055
261650;202007;4129;10197;3510;9371;149;475;2640;6983;2789;7458
270010;202007;4301;14371;3689;13319;166;938;2919;10234;3085;11172
270020;202007;3887;9677;3388;9030;128;441;2900;7547;3028;7988
270030;202007;33888;91355;28154;82110;3650;10390;18620;54419;22270;64809
270040;202007;10814;28987;9258;27147;368;1385;7669;22286;8037;23671
270050;202007;5521;12765;4697;11829;209;511;4116;10404;4325;10915
270060;202007;2167;5402;1800;4982;154;375;1423;4001;1577;4376
270070;202007;4668;13034;4051;12167;136;510;3394;10009;3530;10519
270080;202007;1447;3918;1206;3509;42;129;926;2592;968;2721
270090;202007;1764;5385;1578;5018;68;271;1285;3987;1353;4258
270100;202007;5467;14397;4704;13276;146;566;3919;10848;4065;11414
270110;202007;3236;7563;2604;6827;138;336;2067;5648;2205;5984
270120;202007;2769;7497;2390;6991;70;307;2015;5790;2085;6097
270130;202007;5087;13010;4394;12184;123;391;3786;10519;3909;10910
270135;202007;2039;4842;1724;4492;49;154;1559;4042;1608;4196
270140;202007;9671;22417;7717;19720;309;1070;6097;14840;6406;15910
270150;202007;2705;8083;2470;7745;3;19;2329;7282;2332;7301
270160;202007;6219;16695;5245;15600;71;346;4847;14396;4918;14742
270170;202007;3377;9841;2840;9088;177;842;2155;6603;2332;7445
270180;202007;2228;6886;2027;6626;40;191;1824;5919;1864;6110
270190;202007;1636;4859;1444;4619;36;183;1263;4005;1299;4188
270200;202007;2423;7317;2104;6884;112;424;1527;4966;1639;5390
270210;202007;5728;13457;4873;12500;75;319;4477;11298;4552;11617
270220;202007;1534;3978;1224;3540;203;606;704;2008;907;2614
270230;202007;9327;25764;7671;23190;635;2129;5461;16322;6096;18451
270235;202007;5660;17386;4870;16119;116;535;4012;13135;4128;13670
270240;202007;10546;28974;8477;26067;921;3088;5908;18185;6829;21273
270250;202007;2723;6873;2378;6374;187;490;1870;5012;2057;5502
270255;202007;4441;12665;3436;10819;109;450;2620;8116;2729;8566
270260;202007;5583;16380;5052;15506;99;506;4420;13244;4519;13750
270270;202007;1044;2691;860;2463;100;299;631;1785;731;2084
270280;202007;3952;9369;3117;8321;484;784;2169;6259;2653;7043
270290;202007;7411;23558;6623;22239;182;865;5739;19057;5921;19922
270300;202007;4184;10813;3241;9799;149;402;2521;7798;2670;8200
270310;202007;6918;19343;5926;17805;100;535;5048;14771;5148;15306
270320;202007;5546;16201;4816;14790;435;1377;3402;10186;3837;11563
270330;202007;3834;12536;3401;11875;258;1042;2601;9039;2859;10081
270340;202007;1602;4332;1383;4040;46;149;1172;3373;1218;3522
270350;202007;1898;4444;1558;4039;143;410;1106;2876;1249;3286
270360;202007;2596;6483;2309;6159;72;162;2124;5696;2196;5858
270370;202007;1379;4261;1251;4018;34;158;1043;3300;1077;3458
270375;202007;3111;7240;2575;6650;18;51;2417;6264;2435;6315
270380;202007;5427;15324;4558;14190;619;1875;2959;9570;3578;11445
270390;202007;1205;3019;980;2760;23;93;806;2266;829;2359
270400;202007;6235;16352;5215;14804;241;689;4058;11425;4299;12114
270410;202007;4599;13197;3958;12200;152;541;3280;10066;3432;10607
270420;202007;5490;16230;4925;15403;125;606;4266;13081;4391;13687
270430;202007;134047;317830;105153;280791;20854;57934;49913;135369;70767;193303
270440;202007;4704;12675;4044;11861;88;383;3514;10164;3602;10547
270450;202007;6968;18707;6103;17666;252;867;5111;14880;5363;15747
270460;202007;3802;8376;3263;7735;159;322;2921;6948;3080;7270
270470;202007;11017;30649;9532;28523;651;2151;7329;21901;7980;24052
270480;202007;2948;7814;2478;7130;94;370;2020;5675;2114;6045
270490;202007;954;2613;825;2456;47;153;661;1949;708;2102
270500;202007;4892;14902;4324;13960;288;1063;3365;10726;3653;11789
270510;202007;5568;14712;4683;13586;334;1330;3498;9658;3832;10988
270520;202007;3949;11227;3110;9786;640;2085;1284;4200;1924;6285
270530;202007;1260;3585;1072;3298;52;153;760;2372;812;2525
270540;202007;2214;6352;1901;5946;59;274;1648;5056;1707;5330
270550;202007;6697;17226;5315;15709;579;1393;3976;12214;4555;13607
270560;202007;2953;7674;2539;7116;132;426;2044;5672;2176;6098
270570;202007;4107;11471;3462;10506;113;365;2818;8498;2931;8863
270580;202007;2264;6387;2050;6074;95;284;1774;5210;1869;5494
270590;202007;1600;4795;1473;4630;16;81;1387;4330;1403;4411
270600;202007;2768;8457;2503;8062;47;243;2219;7061;2266;7304
270610;202007;3613;9465;3111;8802;68;263;2786;7799;2854;8062
270620;202007;1211;3707;1101;3488;34;152;939;2879;973;3031
270630;202007;17481;42532;14963;39054;572;1838;12588;32113;13160;33951
270640;202007;5375;15438;4633;14241;163;666;3761;11321;3924;11987
270642;202007;2515;8046;2223;7570;158;684;1702;5658;1860;6342
270644;202007;3591;8926;2936;8070;275;675;2197;6203;2472;6878
270650;202007;3139;9187;2743;8624;357;1206;1947;6065;2304;7271
270660;202007;2031;5123;1685;4622;79;299;1263;3405;1342;3704
270670;202007;16359;37301;13512;33808;402;1208;11489;28114;11891;29322
270680;202007;5528;13094;4917;12426;118;173;4597;11769;4715;11942
270690;202007;9089;22219;7562;20311;525;1372;5907;15865;6432;17237
270700;202007;512;1533;446;1422;31;126;323;1008;354;1134
270710;202007;5430;16346;4796;15365;223;962;3856;12117;4079;13079
270720;202007;3583;10484;3158;9767;64;345;2772;8401;2836;8746
270730;202007;8113;17925;7069;16803;234;470;5569;14655;5803;15125
270740;202007;2382;6210;2097;5874;91;309;1744;4814;1835;5123
270750;202007;5703;14963;4982;14040;81;377;4429;12403;4510;12780
270760;202007;3263;9173;2821;8576;49;252;2395;7191;2444;7443
270770;202007;20612;50136;16380;44976;2538;6297;10249;29706;12787;36003
270780;202007;1785;4969;1639;4759;86;304;1387;3963;1473;4267
270790;202007;1586;4391;1323;4022;98;318;964;2907;1062;3225
270800;202007;10715;29350;9583;27738;334;1218;8219;23414;8553;24632
270810;202007;3311;9415;2606;8213;169;651;1830;5665;1999;6316
270820;202007;1639;4904;1379;4483;54;261;1082;3423;1136;3684
270830;202007;5169;12281;4161;11040;165;545;3379;8816;3544;9361
270840;202007;8217;24401;7301;23103;171;944;6387;19695;6558;20639
270850;202007;9031;21345;7963;20064;636;1841;6588;16300;7224;18141
270860;202007;14285;31663;11272;28217;597;1384;9095;22740;9692;24124
270870;202007;2151;6071;1773;5451;232;693;1164;3664;1396;4357
270880;202007;8071;24091;7173;22735;220;939;5929;18448;6149;19387
270890;202007;2785;7532;2332;6881;178;551;1625;4788;1803;5339
270895;202007;3098;9469;2802;9079;73;393;2474;7851;2547;8244
270900;202007;1782;4576;1338;3860;37;107;1037;2964;1074;3071
270910;202007;3871;11171;3315;10292;92;319;2699;8287;2791;8606
270915;202007;9361;26783;7550;23802;652;2404;5144;15836;5796;18240
270920;202007;5058;15777;4564;14920;161;794;3750;11852;3911;12646
270930;202007;17208;39875;13308;35335;1872;4538;8935;24881;10807;29419
270940;202007;6534;17093;5542;15906;185;874;4514;12573;4699;13447
280010;202007;691;1899;543;1576;16;65;380;990;396;1055
280020;202007;4870;12262;4129;11091;476;1189;2783;7565;3259;8754
280030;202007;75120;176004;58955;152972;12385;32519;26197;70840;38582;103359
280040;202007;2897;8112;2515;7510;245;770;1694;5010;1939;5780
280050;202007;3830;10870;3281;9999;549;1746;1943;5909;2492;7655
280060;202007;5881;15391;4670;13508;882;2688;2176;6545;3058;9233
280067;202007;6926;17015;5874;15429;315;831;4304;11161;4619;11992
280070;202007;1920;5640;1782;5420;127;394;1468;4436;1595;4830
280100;202007;3998;10605;3356;9578;316;936;2299;6553;2615;7489
280110;202007;1379;3733;1199;3465;17;85;1054;2966;1071;3051
280120;202007;7591;21796;6754;20447;745;2093;4928;15290;5673;17383
280130;202007;9218;21419;8053;19742;413;1107;6525;15822;6938;16929
280140;202007;5426;12973;4759;12082;197;584;4041;10139;4238;10723
280150;202007;4227;10581;3646;9778;339;857;2789;7504;3128;8361
280160;202007;1226;3469;1021;3126;93;312;699;2085;792;2397
280170;202007;5178;13624;4621;12885;233;639;3727;10401;3960;11040
280190;202007;1296;2819;1126;2593;55;128;920;2077;975;2205
280200;202007;1265;3301;1038;2978;73;268;772;2166;845;2434
280210;202007;16617;41407;14403;38223;1524;4193;9212;24447;10736;28640
280220;202007;1756;4676;1502;4333;47;218;1234;3519;1281;3737
280230;202007;4266;10751;3578;9730;287;678;2542;6973;2829;7651
280240;202007;3314;8831;2955;8280;53;276;2538;6888;2591;7164
280250;202007;878;2156;710;1901;69;205;470;1215;539;1420
280260;202007;2214;5281;1961;4969;36;96;1780;4545;1816;4641
280270;202007;2344;6398;2060;5953;118;373;1698;4841;1816;5214
280280;202007;4208;12413;3724;11694;486;1311;2608;8579;3094;9890
280290;202007;18113;47677;15492;43984;1359;4114;10350;29637;11709;33751
280300;202007;11839;28618;10303;26961;290;835;7673;22032;7963;22867
280310;202007;1395;3570;1145;3139;35;123;866;2298;901;2421
280320;202007;8627;23225;7475;21494;895;2597;5007;14246;5902;16843
280330;202007;4686;11557;3967;10554;264;734;2907;7698;3171;8432
280340;202007;5471;11439;4565;10458;225;385;3953;9247;4178;9632
280350;202007;25913;60551;22661;56247;1126;2986;17820;43485;18946;46471
280360;202007;5778;15844;5018;14575;748;2204;2942;8673;3690;10877
280370;202007;2125;5261;1772;4678;56;161;1406;3639;1462;3800
280380;202007;983;2631;840;2433;76;220;571;1678;647;1898
280390;202007;3683;9029;3065;8051;142;357;2449;6387;2591;6744
280400;202007;3928;9880;3385;9117;523;1248;2053;5846;2576;7094
280410;202007;2244;6183;1805;5471;198;618;1042;3098;1240;3716
280420;202007;4309;11427;3947;10966;73;284;3620;9990;3693;10274
280430;202007;2066;4997;1801;4645;67;252;1461;3645;1528;3897
280440;202007;4251;11308;3712;10515;146;491;3120;8640;3266;9131
280445;202007;2320;5879;2064;5437;48;152;1555;3924;1603;4076
280450;202007;10308;23740;8918;21840;986;2028;6000;15336;6986;17364
280460;202007;6898;16285;6232;15350;331;800;5318;12937;5649;13737
280470;202007;1693;4767;1452;4335;64;220;1072;3121;1136;3341
280480;202007;42529;103193;36576;94707;2964;8279;25949;65759;28913;74038
280490;202007;3704;10483;3181;9570;89;389;2464;7169;2553;7558
280500;202007;997;2382;853;2189;37;129;710;1782;747;1911
280510;202007;2559;6466;2212;5968;75;282;1724;4537;1799;4819
280520;202007;1610;4087;1402;3799;59;164;1124;3007;1183;3171
280530;202007;2441;6095;2097;5612;290;649;1467;4051;1757;4700
280540;202007;8940;23866;8113;22667;259;895;7098;19544;7357;20439
280550;202007;6649;15415;5448;13721;184;656;4486;10887;4670;11543
280560;202007;7166;19865;6690;19151;138;510;5886;16655;6024;17165
280570;202007;6452;15637;5227;14084;215;675;3931;10517;4146;11192
280580;202007;5678;14984;4909;13831;574;1426;3432;9871;4006;11297
280590;202007;2924;6558;2486;6057;109;411;1964;4591;2073;5002
280600;202007;3583;9445;3146;8831;171;538;2257;6340;2428;6878
280610;202007;2474;6055;2220;5673;140;355;1829;4633;1969;4988
280620;202007;5446;13260;4666;12234;416;910;3264;8930;3680;9840
280630;202007;3809;10676;3476;10204;164;597;2858;8282;3022;8879
280640;202007;2367;6326;2084;6000;57;177;1849;5327;1906;5504
280650;202007;1192;3110;954;2750;88;299;709;1952;797;2251
280660;202007;3710;8102;3170;7463;216;400;2630;6321;2846;6721
280670;202007;19744;44272;16964;40724;923;2317;13516;32207;14439;34524
280680;202007;2800;6661;2390;6085;229;423;1716;4452;1945;4875
280690;202007;957;2335;809;2139;51;117;633;1655;684;1772
280700;202007;1168;2923;1009;2684;27;101;797;2083;824;2184
280710;202007;15324;34305;12921;31577;521;975;10917;27425;11438;28400
280720;202007;2666;6051;2210;5516;58;182;1614;4170;1672;4352
280730;202007;1062;2719;950;2533;42;131;731;1883;773;2014
280740;202007;14121;34357;11984;31099;720;2038;8608;21749;9328;23787
280750;202007;3606;10020;3133;9200;185;623;2249;6476;2434;7099
280760;202007;6384;16898;5536;15578;570;1464;3642;10581;4212;12045
290010;202007;3186;6674;2078;4948;5;16;1702;3873;1707;3889
290020;202007;5375;14259;4859;13593;336;637;4086;11843;4422;12480
290030;202007;4565;10413;3671;9428;175;406;3101;8067;3276;8473
290035;202007;5173;11222;4278;10058;368;556;3381;8317;3749;8873
290040;202007;4209;10243;3563;9461;108;288;2806;7840;2914;8128
290050;202007;2024;6516;1698;5806;116;476;1134;3779;1250;4255
290060;202007;1337;3195;984;2636;83;252;640;1696;723;1948
290070;202007;37437;81423;32040;74679;1772;4320;24908;57399;26680;61719
290080;202007;5317;15477;4549;14323;459;1560;3176;10089;3635;11649
290090;202007;2160;4131;1519;3447;18;61;1385;3110;1403;3171
290100;202007;9800;25502;7905;22637;1291;3468;4279;12864;5570;16332
290110;202007;5226;13721;4622;12775;328;930;3335;9121;3663;10051
290115;202007;3950;11370;3309;10213;223;756;2456;7503;2679;8259
290120;202007;6517;16000;5473;14558;136;467;4692;12258;4828;12725
290130;202007;4724;11408;3672;10042;161;470;2851;7770;3012;8240
290135;202007;4210;9893;3428;8608;192;489;2655;6490;2847;6979
290140;202007;4543;11862;3467;10416;99;368;2907;8684;3006;9052
290150;202007;2470;6340;2121;5905;139;383;1635;4585;1774;4968
290160;202007;3378;7683;2979;7130;282;587;2334;5617;2616;6204
290170;202007;3387;8506;2982;8061;111;306;2659;7252;2770;7558
290180;202007;2974;8126;2446;7253;84;302;1989;5847;2073;6149
290190;202007;4255;11838;3719;11110;144;569;3058;9012;3202;9581
290195;202007;2353;5806;1873;5172;27;136;1583;4330;1610;4466
290200;202007;4123;11417;3338;10107;187;626;2506;7510;2693;8136
290205;202007;3466;8908;3034;8251;127;440;2363;6212;2490;6652
290210;202007;12972;36030;11455;33719;877;2357;8814;26390;9691;28747
290220;202007;2880;7117;2520;6650;122;336;2052;5397;2174;5733
290225;202007;3232;6875;2482;6081;159;281;2062;5160;2221;5441
290230;202007;2440;6433;2217;6165;30;94;1995;5540;2025;5634
290240;202007;3731;9370;2962;8384;71;255;2494;7048;2565;7303
290250;202007;3954;11481;3297;10500;105;359;2715;8766;2820;9125
290260;202007;5489;13303;4553;11945;167;541;3788;9694;3955;10235
290265;202007;3519;10177;2843;8865;198;635;2020;6275;2218;6910
290270;202007;11066;37424;10320;36141;528;2318;8303;28784;8831;31102
290280;202007;6140;18230;5290;16521;297;1048;3812;11727;4109;12775
290290;202007;10002;28904;8052;25303;803;2731;5266;16320;6069;19051
290300;202007;4237;11484;3108;9340;158;512;2226;6659;2384;7171
290310;202007;1599;3925;1263;3514;55;230;974;2620;1029;2850
290320;202007;24425;63535;19220;55509;4219;11994;9120;27779;13339;39773
290323;202007;3783;10281;3279;9494;104;331;2590;7469;2694;7800
290327;202007;4093;11904;3475;10690;245;707;2482;7604;2727;8311
290330;202007;2205;4625;1708;4089;47;85;1513;3681;1560;3766
290340;202007;5743;14285;4411;12642;440;1306;3180;9250;3620;10556
290350;202007;4728;13061;3902;11659;272;829;2793;8389;3065;9218
290360;202007;5061;13245;4429;12415;135;370;3808;10778;3943;11148
290370;202007;5244;12744;3837;10879;155;409;2770;8017;2925;8426
290380;202007;5586;14835;4685;13604;113;272;4020;11905;4133;12177
290390;202007;14597;41258;12060;37249;1291;3930;7851;24659;9142;28589
290395;202007;2846;8210;2282;7229;66;312;1744;5427;1810;5739
290400;202007;3784;10127;3022;8871;82;351;2307;6586;2389;6937
290405;202007;4675;13526;3981;12316;297;953;2727;8623;3024;9576
290410;202007;5748;15537;4394;13355;111;510;3311;9801;3422;10311
290420;202007;2986;8311;2463;7480;71;252;1900;5728;1971;5980
290430;202007;3180;8675;2601;7770;226;706;1758;5183;1984;5889
290440;202007;2903;7131;2074;5815;46;119;1457;4154;1503;4273
290450;202007;3507;8888;2726;7697;140;389;1992;5713;2132;6102
290460;202007;11787;33083;9868;29412;1977;6001;4393;13062;6370;19063
290470;202007;4582;11232;3358;9530;391;1221;1902;5478;2293;6699
290475;202007;6508;18831;5472;16987;92;509;4461;13546;4553;14055
290480;202007;1791;4526;1461;4038;82;281;1009;2658;1091;2939
290485;202007;4519;13129;3983;12377;100;518;3404;10382;3504;10900
290490;202007;9251;21609;8250;20247;500;1114;6450;16077;6950;17191
290500;202007;4048;12083;3096;10010;541;1831;1348;4239;1889;6070
290510;202007;3493;8669;2897;7893;74;248;2498;6763;2572;7011
290515;202007;3663;10089;3153;9401;42;129;2831;8596;2873;8725
290520;202007;11568;32820;8905;27653;591;1980;5412;16581;6003;18561
290530;202007;5002;14226;4198;12915;134;515;3538;10831;3672;11346
290540;202007;3388;8872;3015;8441;52;175;2780;7753;2832;7928
290550;202007;4309;11237;3719;10541;11;59;3419;9803;3430;9862
290560;202007;6460;16638;4876;14279;418;1505;3190;9041;3608;10546
290570;202007;44768;109446;39539;102775;2455;6558;31754;81996;34209;88554
290580;202007;7810;22695;6709;21085;597;1838;4908;15804;5505;17642
290590;202007;7094;21728;5971;19717;144;589;4819;15987;4963;16576
290600;202007;18888;52260;16623;48559;684;2098;13381;39000;14065;41098
290610;202007;2589;8013;2010;6822;94;394;1407;4716;1501;5110
290620;202007;6378;17863;5496;16409;198;570;4616;13758;4814;14328
290630;202007;9274;22334;7334;19825;548;1480;5660;15420;6208;16900
290640;202007;2804;7187;2144;6225;86;254;1549;4582;1635;4836
290650;202007;13146;32507;11594;30747;2553;6471;7168;19894;9721;26365
290660;202007;3654;9310;3029;8397;50;140;2291;6555;2341;6695
290670;202007;6779;18628;5696;16835;374;1050;4314;12925;4688;13975
290680;202007;10857;30014;9087;27377;197;1057;7501;22111;7698;23168
290682;202007;4801;12293;4142;11415;126;295;3499;9745;3625;10040
290685;202007;3491;7854;2488;6406;204;486;1531;4219;1735;4705
290687;202007;6645;17830;5369;15733;712;2008;3419;10281;4131;12289
290689;202007;2842;7851;2173;6613;200;667;1483;4481;1683;5148
290690;202007;5559;14355;4486;12834;303;936;3248;9153;3551;10089
290700;202007;2638;7180;2316;6771;71;240;1946;5706;2017;5946
290710;202007;8298;23289;7091;21607;155;623;5977;18238;6132;18861
290720;202007;18497;50403;16777;47784;931;2936;13442;37818;14373;40754
290730;202007;7075;16747;6011;15503;292;588;4744;12428;5036;13016
290740;202007;1038;2783;797;2392;34;113;657;1973;691;2086
290750;202007;11124;27639;9599;25181;636;1795;7111;18110;7747;19905
290755;202007;2101;5900;1679;5127;91;285;1162;3576;1253;3861
290760;202007;3762;10888;3018;9458;183;536;2041;6595;2224;7131
290770;202007;2642;8359;2413;8071;50;249;2022;6820;2072;7069
290780;202007;8259;20327;7115;18823;272;600;5565;15072;5837;15672
290790;202007;4708;12906;4078;12005;163;467;3360;10033;3523;10500
290800;202007;7135;14764;5036;12288;292;686;3732;9176;4024;9862
290810;202007;5417;14148;4326;12538;111;355;3258;9653;3369;10008
290820;202007;4855;13108;4344;12368;182;524;3275;9453;3457;9977
290830;202007;4488;10151;3971;9508;29;81;3498;8273;3527;8354
290840;202007;17114;45087;14642;41249;1896;4391;9404;28169;11300;32560
290850;202007;6679;16000;5969;15235;207;516;5111;13179;5318;13695
290860;202007;6174;17616;5362;16670;213;711;4516;14311;4729;15022
290870;202007;4787;13125;3605;10858;149;466;2536;7578;2685;8044
290880;202007;1396;3467;1112;3094;74;179;764;2223;838;2402
290890;202007;9302;18679;8324;17580;153;329;7809;16425;7962;16754
290900;202007;2386;6209;1809;5195;101;245;1128;3207;1229;3452
290910;202007;5151;12299;3926;10435;49;156;3325;8756;3374;8912
290920;202007;5079;12805;4613;12263;42;90;4349;11681;4391;11771
290930;202007;7657;21295;6107;18581;196;830;4772;14151;4968;14981
290940;202007;3698;10322;3035;9360;158;578;2429;7480;2587;8058
290950;202007;1462;3657;1189;3242;62;178;835;2287;897;2465
290960;202007;5482;14336;4899;13604;183;456;4127;11526;4310;11982
290970;202007;3358;9840;2729;8696;107;393;2094;6670;2201;7063
290980;202007;12163;29084;10154;25983;797;2222;6322;15716;7119;17938
290990;202007;9641;25497;8481;23608;255;1044;7108;19088;7363;20132
291000;202007;3424;8864;2648;7875;112;352;2164;6494;2276;6846
291005;202007;15309;37539;13452;35103;1215;2903;10481;27558;11696;30461
291010;202007;3073;9261;2480;7993;119;435;1627;5102;1746;5537
291020;202007;1248;3082;997;2633;22;74;723;1802;745;1876
291030;202007;2513;6101;1738;4759;110;277;1074;2857;1184;3134
291040;202007;5390;14783;4479;13485;156;608;3513;10538;3669;11146
291050;202007;7692;19957;6544;18361;627;1984;4764;13111;5391;15095
291060;202007;5964;18192;5055;16967;313;1364;3839;12800;4152;14164
291070;202007;15996;42812;13279;38453;418;1462;10818;31140;11236;32602
291072;202007;24756;63264;17698;51065;3229;9627;7515;21937;10744;31564
291075;202007;5452;13366;4880;12479;102;274;4070;10215;4172;10489
291077;202007;1606;4180;1243;3544;54;120;873;2486;927;2606
291080;202007;105360;260318;82361;227817;24625;69907;22401;67081;47026;136988
291085;202007;5635;14187;4728;12790;182;557;3925;10590;4107;11147
291090;202007;2011;3787;1446;3153;46;103;1165;2497;1211;2600
291100;202007;3222;7005;2207;5792;101;270;1681;4375;1782;4645
291110;202007;5954;17595;5029;16010;317;1296;3814;11695;4131;12991
291120;202007;7588;18465;6376;16916;300;862;4912;12997;5212;13859
291125;202007;2198;3854;1651;3247;98;148;1332;2679;1430;2827
291130;202007;3249;9194;2380;7475;65;293;1767;5371;1832;5664
291140;202007;4907;13174;3563;10727;446;1178;2188;6611;2634;7789
291150;202007;2488;5382;1909;4728;5;17;1799;4447;1804;4464
291160;202007;5126;13932;4218;12622;370;1178;2821;8370;3191;9548
291165;202007;2159;5846;1618;4791;28;123;1188;3408;1216;3531
291170;202007;21042;53164;17504;47121;938;2759;11534;30513;12472;33272
291180;202007;6322;14574;4598;12242;262;673;3547;9454;3809;10127
291185;202007;3090;8287;2698;7648;90;274;2076;5907;2166;6181
291190;202007;7603;18651;6234;16886;294;927;4914;13261;5208;14188
291200;202007;2788;7609;2052;6221;94;298;1255;3668;1349;3966
291210;202007;7070;15089;5273;13017;135;439;3908;9698;4043;10137
291220;202007;4087;11539;3666;10908;179;645;2904;8529;3083;9174
291230;202007;4470;9570;3363;8357;37;98;3029;7601;3066;7699
291240;202007;4220;10763;3615;9755;64;222;3101;8242;3165;8464
291250;202007;3426;10051;2654;8635;159;507;1707;5579;1866;6086
291260;202007;1433;3346;1169;3003;29;93;959;2477;988;2570
291270;202007;5413;13938;4173;12106;634;1840;2594;7697;3228;9537
291280;202007;2625;6384;1956;5401;141;426;1266;3423;1407;3849
291290;202007;5883;15385;4520;13258;338;1073;3106;9024;3444;10097
291300;202007;3851;10348;2967;8893;111;405;2259;6666;2370;7071
291310;202007;5143;13613;4371;12203;119;386;3690;10157;3809;10543
291320;202007;6131;16965;4748;14384;1060;3003;2332;7511;3392;10514
291330;202007;1779;4492;1468;3983;80;214;1094;2937;1174;3151
291340;202007;4289;11081;3457;9628;78;247;2626;7197;2704;7444
291345;202007;2948;8788;2671;8355;111;391;2241;7010;2352;7401
291350;202007;6892;16951;5344;15066;60;197;4635;13303;4695;13500
291360;202007;37642;85637;29366;75652;2757;7242;19198;50544;21955;57786
291370;202007;8057;21853;7099;20372;519;1563;5266;14847;5785;16410
291380;202007;3417;9271;2988;8680;101;414;2483;7158;2584;7572
291390;202007;13282;28372;10274;25034;439;1056;8497;20698;8936;21754
291400;202007;13959;35557;11436;31734;1540;3749;6748;20210;8288;23959
291410;202007;2950;7713;2281;6569;33;140;1679;4755;1712;4895
291420;202007;1919;4729;1489;4192;29;117;1289;3617;1318;3734
291430;202007;2763;7799;2381;7163;77;341;1916;5581;1993;5922
291440;202007;6392;18259;5491;16765;327;1060;4275;13057;4602;14117
291450;202007;9374;22772;7695;20833;74;127;6754;18882;6828;19009
291460;202007;15703;41325;13718;38354;681;2120;10340;28699;11021;30819
291465;202007;9401;22981;7381;20661;135;602;6377;17724;6512;18326
291470;202007;16776;37340;13970;34167;741;1598;10363;26125;11104;27723
291480;202007;41553;91915;30400;76618;3547;9252;16077;40584;19624;49836
291490;202007;5623;13900;4834;12998;141;450;4352;11642;4493;12092
291500;202007;5005;12203;4135;11044;69;305;3754;9978;3823;10283
291510;202007;4317;10624;3200;9207;52;294;2671;7613;2723;7907
291520;202007;4576;10330;3432;8818;181;493;2631;6704;2812;7197
291530;202007;2327;5314;1628;4392;310;761;917;2722;1227;3483
291535;202007;3427;9975;3033;9278;170;470;2335;7301;2505;7771
291540;202007;2304;5092;1574;4211;66;219;1290;3395;1356;3614
291550;202007;5654;12909;4389;11302;383;827;2997;7897;3380;8724
291560;202007;18674;43876;13353;36827;1289;3428;8003;22955;9292;26383
291570;202007;2419;5733;1898;5091;58;158;1552;4330;1610;4488
291580;202007;6312;16235;4965;14423;221;703;3687;10639;3908;11342
291590;202007;2169;5225;1879;4887;72;261;1665;4229;1737;4490
291600;202007;5584;12844;4280;10846;381;1027;2914;7150;3295;8177
291610;202007;5670;14811;5084;14159;80;301;4659;12951;4739;13252
291620;202007;3174;7024;2329;6098;105;269;1817;4853;1922;5122
291630;202007;3328;7434;2481;6318;292;817;1746;4356;2038;5173
291640;202007;15850;39005;11954;33362;1714;4652;5381;15609;7095;20261
291650;202007;9538;23591;8404;22241;563;1042;7075;19205;7638;20247
291660;202007;2100;5123;1518;4217;129;426;987;2584;1116;3010
291670;202007;2067;5418;1743;4952;103;255;1311;3788;1414;4043
291680;202007;4169;10163;3366;8994;291;804;2371;6285;2662;7089
291685;202007;4718;11186;3766;9968;230;471;2845;7825;3075;8296
291690;202007;4191;9210;2878;7294;233;474;2179;5579;2412;6053
291700;202007;8644;24888;7549;22956;322;1179;6140;18320;6462;19499
291710;202007;5335;12607;3913;10611;214;674;2852;7585;3066;8259
291720;202007;4513;13620;3743;12076;408;1388;2436;7707;2844;9095
291730;202007;6391;16215;5478;15023;266;810;4531;12349;4797;13159
291733;202007;2894;7332;2430;6716;60;168;1763;5118;1823;5286
291735;202007;2936;7700;2327;6621;73;167;1769;5011;1842;5178
291740;202007;3916;10070;2893;8181;87;232;2064;5749;2151;5981
291750;202007;19595;46555;15893;41138;1527;3869;10720;28083;12247;31952
291760;202007;10340;29673;8067;26006;2433;8887;2205;7090;4638;15977
291770;202007;7122;19020;5920;16957;347;1070;4441;12389;4788;13459
291780;202007;5162;13618;4637;12877;85;321;4076;11192;4161;11513
291790;202007;2768;7545;2502;7200;234;561;1875;5590;2109;6151
291800;202007;29266;73467;21683;62102;3411;9487;10622;31644;14033;41131
291810;202007;10628;25124;8830;22918;268;685;7503;19579;7771;20264
291820;202007;3806;9991;3284;9317;91;305;2637;7498;2728;7803
291830;202007;4473;10523;3651;9421;190;423;2897;7500;3087;7923
291835;202007;6517;19410;5100;16673;533;1855;3245;10751;3778;12606
291840;202007;48105;130967;41497;120699;4321;13374;29060;84039;33381;97413
291845;202007;2545;6533;1991;5848;112;344;1604;4765;1716;5109
291850;202007;3908;11138;3200;9952;258;759;2279;7274;2537;8033
291855;202007;2222;4308;1718;3747;41;93;1547;3384;1588;3477
291860;202007;2241;5824;1556;4506;46;126;1054;2940;1100;3066
291870;202007;1287;3221;855;2474;46;133;582;1654;628;1787
291875;202007;2923;8728;2517;7877;64;262;1846;5606;1910;5868
291880;202007;5648;15850;4771;14366;218;638;3565;10783;3783;11421
291890;202007;1667;3382;1073;2694;130;304;715;1802;845;2106
291900;202007;1223;2939;929;2484;21;86;734;1906;755;1992
291905;202007;2497;6317;2018;5556;78;281;1535;4071;1613;4352
291910;202007;2975;7433;2529;6898;53;190;2176;6062;2229;6252
291915;202007;7472;21020;6075;18668;221;769;4581;14250;4802;15019
291920;202007;26712;68936;22467;63006;2155;6587;15599;42914;17754;49501
291930;202007;2526;6777;2155;6256;240;707;1439;4214;1679;4921
291940;202007;3900;9901;2594;7676;196;579;1522;4484;1718;5063
291950;202007;9225;27639;7826;24932;291;1093;5433;17094;5724;18187
291955;202007;15611;39132;13865;36887;1173;3261;10807;28831;11980;32092
291960;202007;3058;8056;2537;7343;119;362;1978;5850;2097;6212
291970;202007;4548;11408;3793;10458;141;480;2847;7871;2988;8351
291980;202007;9722;27580;7649;23950;1014;2951;4599;14781;5613;17732
291990;202007;2318;5931;1892;5421;28;116;1755;5028;1783;5144
291992;202007;3968;9520;3146;8457;228;525;2489;6823;2717;7348
291995;202007;2102;5775;1723;5166;53;236;1301;3793;1354;4029
292000;202007;2652;6193;2157;5594;98;361;1681;4299;1779;4660
292010;202007;5746;13382;4672;11847;170;524;3872;9619;4042;10143
292020;202007;4593;13227;3794;11804;205;737;2740;8267;2945;9004
292030;202007;1842;5600;1677;5292;74;261;1060;3285;1134;3546
292040;202007;4429;11282;3428;9790;228;591;2613;7618;2841;8209
292045;202007;4014;10500;2966;8962;33;93;2619;8073;2652;8166
292050;202007;6613;18347;5303;16013;252;863;3400;10104;3652;10967
292060;202007;11476;26292;10492;25068;488;1093;9163;21687;9651;22780
292070;202007;5811;14983;5055;14081;297;833;4326;11987;4623;12820
292080;202007;3124;7837;2575;7125;79;262;2279;6266;2358;6528
292090;202007;4653;10002;3293;8364;257;668;2470;6322;2727;6990
292100;202007;11156;26896;9517;24836;956;2604;6627;17252;7583;19856
292105;202007;3543;8721;3082;8094;100;238;2530;6663;2630;6901
292110;202007;5973;14520;4207;11696;979;2772;1931;5381;2910;8153
292120;202007;6960;17686;5712;15606;358;1033;4340;11652;4698;12685
292130;202007;3443;8175;2828;7415;103;302;2225;5767;2328;6069
292140;202007;5077;11942;4242;10672;316;795;3369;8442;3685;9237
292145;202007;2378;6815;1998;6164;62;161;1537;4803;1599;4964
292150;202007;14093;38393;12202;35297;316;1203;9940;28412;10256;29615
292160;202007;2969;7169;2235;6221;41;113;1822;5311;1863;5424
292170;202007;8439;22289;7007;19953;340;1132;5306;14803;5646;15935
292180;202007;2871;7824;2102;6394;166;498;1295;3874;1461;4372
292190;202007;2973;7772;2534;7097;91;315;1988;5508;2079;5823
292200;202007;8482;20978;6331;17931;1047;3066;3285;9593;4332;12659
292205;202007;3883;10656;3353;9866;56;254;2929;8576;2985;8830
292210;202007;6537;15130;5263;13529;90;389;4730;12022;4820;12411
292220;202007;2151;5147;1886;4738;49;139;1494;3630;1543;3769
292225;202007;3218;9346;2813;8727;73;337;2375;7238;2448;7575
292230;202007;8589;20410;7667;19242;157;521;6623;16338;6780;16859
292240;202007;4743;13686;4107;12537;299;896;2872;8786;3171;9682
292250;202007;5848;14961;5249;14053;426;1114;3915;10443;4341;11557
292260;202007;3425;8859;3020;8331;93;249;2628;7259;2721;7508
292265;202007;3390;9136;2833;8295;75;317;2247;6450;2322;6767
292270;202007;4421;10019;3509;8936;114;280;2916;7425;3030;7705
292273;202007;2777;5873;2202;5174;54;90;1616;4071;1670;4161
292275;202007;1645;4257;1289;3774;58;164;971;2897;1029;3061
292280;202007;2636;6220;2113;5616;80;162;1791;4895;1871;5057
292285;202007;2554;6146;2039;5451;77;166;1656;4471;1733;4637
292290;202007;7422;19599;5857;17397;163;618;4789;14195;4952;14813
292300;202007;10385;25896;8158;22903;758;2272;5662;15952;6420;18224
292303;202007;2953;8378;2561;7755;78;196;2141;6531;2219;6727
292305;202007;2326;6198;2147;5951;44;202;1946;5294;1990;5496
292310;202007;6714;16826;5781;15700;150;501;5031;13531;5181;14032
292320;202007;6109;16637;4838;14273;264;876;3522;10113;3786;10989
292330;202007;2732;5997;2193;5391;97;195;1707;4365;1804;4560
292335;202007;4745;12268;4211;11503;206;486;3560;9814;3766;10300
292340;202007;5617;15610;4621;13693;226;674;3414;10040;3640;10714
292350;202007;2493;6736;2071;6158;76;282;1671;4986;1747;5268
292360;202007;4940;13112;4091;11669;227;735;2892;8072;3119;8807
292370;202007;10552;24385;9050;22428;130;420;8389;20525;8519;20945
292380;202007;6797;18885;6075;17592;388;1132;4622;13266;5010;14398
292390;202007;4537;8685;3333;7281;109;198;2919;6389;3028;6587
292400;202007;22595;63695;19462;58713;1915;5858;13312;40400;15227;46258
292405;202007;4444;10777;3743;9670;96;244;3097;7896;3193;8140
292410;202007;2218;5251;1844;4777;65;144;1626;4238;1691;4382
292420;202007;3457;10431;3140;9926;110;552;2697;8293;2807;8845
292430;202007;4884;14515;3677;12296;279;967;2401;8026;2680;8993
292440;202007;8431;26744;7783;25774;128;647;6964;22967;7092;23614
292450;202007;4024;11434;3146;9722;83;317;2456;7538;2539;7855
292460;202007;4898;13394;3995;11853;333;943;2873;8542;3206;9485
292465;202007;2679;6846;2273;6327;91;193;1517;4639;1608;4832
292467;202007;1909;5334;1681;5024;239;634;1162;3612;1401;4246
292470;202007;2979;7551;2303;6502;55;118;1793;5071;1848;5189
292480;202007;6337;14969;5098;13462;76;295;4621;12103;4697;12398
292490;202007;2089;5371;1745;4862;121;273;1314;3754;1435;4027
292500;202007;6634;18024;5290;15633;505;1564;3421;9972;3926;11536
292510;202007;13257;35637;10319;30932;527;1862;7203;21531;7730;23393
292520;202007;7013;17410;6209;16254;449;1211;4828;12526;5277;13737
292525;202007;5928;14097;4820;12852;121;281;4159;11292;4280;11573
292530;202007;28404;75273;21664;63708;5194;15442;8342;25113;13536;40555
292540;202007;4434;8148;3457;7106;113;185;3111;6432;3224;6617
292550;202007;8419;21600;6422;19205;479;1405;4540;14476;5019;15881
292560;202007;4402;10912;3820;10148;83;231;3166;8478;3249;8709
292570;202007;3614;9491;3024;8385;82;297;2534;6858;2616;7155
292575;202007;6945;19682;6355;18897;377;1091;5111;15363;5488;16454
292580;202007;7561;18964;6239;17011;134;454;5266;14212;5400;14666
292590;202007;7359;19541;6282;17684;257;829;5238;14470;5495;15299
292593;202007;2852;7050;2354;6217;68;174;1975;5159;2043;5333
292595;202007;5416;14312;4624;13341;148;497;3898;11175;4046;11672
292600;202007;10949;29615;9397;27238;305;899;7473;21729;7778;22628
292610;202007;4126;10773;3478;9626;190;442;2618;7338;2808;7780
292620;202007;6438;17523;5332;16191;124;282;4866;15070;4990;15352
292630;202007;8573;20891;6878;18176;698;1849;4432;11773;5130;13622
292640;202007;8202;24014;7103;22179;200;788;5064;15944;5264;16732
292650;202007;4478;10983;4030;10399;109;290;3661;9349;3770;9639
292660;202007;11470;30659;9688;28043;452;1461;7415;21453;7867;22914
292665;202007;2170;6369;1875;5982;67;199;1577;5109;1644;5308
292670;202007;3581;9570;2737;7998;115;364;1863;5335;1978;5699
292680;202007;3976;10418;3128;8940;191;498;2287;6427;2478;6925
292690;202007;2646;6757;1819;5405;196;542;1075;3351;1271;3893
292700;202007;9838;26596;8541;24621;723;1857;5896;17578;6619;19435
292710;202007;2501;7611;2317;7357;44;151;2103;6706;2147;6857
292720;202007;9008;21381;7611;19772;209;572;6050;15999;6259;16571
292730;202007;4577;10366;4276;10007;271;446;3653;8752;3924;9198
292740;202007;326604;784242;280326;717364;38926;99695;174477;444649;213403;544344
292750;202007;6186;16522;5400;15373;226;654;4171;12056;4397;12710
292760;202007;3906;11195;3385;10265;224;768;2471;7436;2695;8204
292770;202007;6250;16232;5031;14532;768;2276;3202;9523;3970;11799
292780;202007;2130;4194;1570;3510;46;136;1271;2685;1317;2821
292790;202007;4088;8648;3116;7594;153;372;2600;6391;2753;6763
292800;202007;11351;28241;9685;25727;300;845;8092;21220;8392;22065
292805;202007;3612;8622;2818;7579;102;321;2221;5920;2323;6241
292810;202007;10676;27875;8408;24328;211;887;6329;17736;6540;18623
292820;202007;7428;20366;5393;16949;432;1442;3746;11577;4178;13019
292830;202007;2882;6783;2467;6269;91;271;2089;5319;2180;5590
292840;202007;8734;22674;7378;20828;148;547;6454;17914;6602;18461
292850;202007;2505;6610;2099;6007;147;443;1477;4192;1624;4635
292860;202007;17213;37558;15419;35431;410;1005;13350;30287;13760;31292
292870;202007;17992;44283;15403;40651;936;2510;10534;27511;11470;30021
292880;202007;11016;29863;9370;27400;268;1105;7391;20901;7659;22006
292890;202007;7060;19458;6223;18243;184;744;5445;15841;5629;16585
292895;202007;3014;6446;2179;5204;96;235;1757;4156;1853;4391
292900;202007;2597;6953;2355;6581;61;238;1935;5246;1996;5484
292905;202007;4349;11152;3434;9810;136;453;2535;7161;2671;7614
292910;202007;4906;13249;4450;12588;214;604;3405;9572;3619;10176
292920;202007;9725;26562;8970;25489;251;946;7764;21666;8015;22612
292925;202007;5444;15300;4539;13672;217;643;3283;9793;3500;10436
292930;202007;6499;18981;5580;17281;466;1607;3576;10790;4042;12397
292935;202007;2465;6162;1900;5531;23;126;1703;4976;1726;5102
292937;202007;2773;6925;2365;6370;48;144;2011;5429;2059;5573
292940;202007;2837;7165;2263;6314;176;403;1641;4758;1817;5161
292950;202007;9556;24110;8343;22323;529;1226;6301;16836;6830;18062
292960;202007;5242;12615;4383;11391;129;333;3503;9015;3632;9348
292970;202007;3809;10874;3360;10189;83;387;2801;8521;2884;8908
292975;202007;4487;9509;3970;8928;128;219;3617;8225;3745;8444
292980;202007;3303;7923;2638;6944;87;276;2149;5550;2236;5826
292990;202007;11417;31140;9509;27758;647;1985;6963;20017;7610;22002
293000;202007;2638;6222;2258;5642;42;143;1799;4503;1841;4646
293010;202007;18000;45890;14458;40296;1930;5548;8819;24556;10749;30104
293015;202007;8345;25377;6521;21800;429;1556;4379;14865;4808;16421
293020;202007;9810;28343;8818;26926;135;588;7939;24299;8074;24887
293030;202007;5268;13853;3994;11864;99;329;2770;8449;2869;8778
293040;202007;4283;11339;3598;10366;72;278;3141;9022;3213;9300
293050;202007;22458;54892;19806;50990;1037;2733;14974;38040;16011;40773
293060;202007;3500;9273;2835;8030;233;695;1962;5466;2195;6161
293070;202007;25187;60370;21434;55620;1977;5382;15417;40051;17394;45433
293075;202007;3464;10982;2994;10172;156;688;2381;8095;2537;8783
293076;202007;3556;8664;3223;8271;55;146;2874;7440;2929;7586
293077;202007;6113;16871;4956;14996;425;1413;3227;9990;3652;11403
293080;202007;4706;13866;4045;12734;91;430;3276;10118;3367;10548
293090;202007;3232;9354;2461;8074;202;653;1604;5338;1806;5991
293100;202007;5790;15329;4782;13519;223;654;3754;10498;3977;11152
293105;202007;3748;11838;3268;10858;231;799;2303;7594;2534;8393
293110;202007;2402;5958;1979;5335;68;242;1617;4251;1685;4493
293120;202007;4375;11860;3888;11094;113;299;3241;9258;3354;9557
293130;202007;3676;10091;3202;9465;76;290;2753;8060;2829;8350
293135;202007;30907;71880;22760;61059;3413;9964;10813;29326;14226;39290
293140;202007;2392;5279;2065;4878;61;144;1740;4107;1801;4251
293150;202007;5493;16203;4505;14316;335;1072;3089;9863;3424;10935
293160;202007;3859;9344;3270;8705;247;410;2718;7604;2965;8014
293170;202007;4947;10265;4298;9462;116;250;3756;8233;3872;8483
293180;202007;4369;12226;3593;10805;89;343;2846;8363;2935;8706
293190;202007;14043;38063;12322;35567;144;637;10929;31331;11073;31968
293200;202007;8396;20783;6687;18086;197;709;5356;14195;5553;14904
293210;202007;5183;13696;4431;12548;270;768;3419;9664;3689;10432
293220;202007;5036;12934;3670;10595;851;2455;1458;4321;2309;6776
293230;202007;3862;9896;2833;8419;207;695;1936;5801;2143;6496
293240;202007;4535;11935;3623;10446;66;158;2745;8245;2811;8403
293245;202007;3832;10297;3431;9721;141;471;2928;8162;3069;8633
293250;202007;5949;13692;4836;12264;140;356;4055;10284;4195;10640
293260;202007;4582;12161;3778;10908;153;468;2596;7538;2749;8006
293270;202007;7238;15929;5695;14277;394;599;4471;12047;4865;12646
293280;202007;4505;11853;3914;11018;232;579;3046;8669;3278;9248
293290;202007;14425;41796;12667;39046;1697;5313;8304;25933;10001;31246
293300;202007;5769;13939;4939;12728;278;722;3605;9304;3883;10026
293305;202007;4089;9662;3558;9007;50;123;3211;8136;3261;8259
293310;202007;2114;5376;1776;4854;55;163;1403;3787;1458;3950
293315;202007;4113;9709;3380;8604;198;439;2789;7101;2987;7540
293317;202007;2637;6164;2325;5732;141;270;1842;4557;1983;4827
293320;202007;12132;29052;10726;27481;260;724;9578;24410;9838;25134
293325;202007;1790;4395;1389;3857;201;543;842;2383;1043;2926
293330;202007;57366;162085;46466;142673;8609;27307;21445;66134;30054;93441
293340;202007;2211;6185;1821;5498;81;272;1296;3856;1377;4128
293345;202007;3548;9503;2836;8441;365;842;1831;5972;2196;6814
293350;202007;6610;18873;5693;17779;61;308;5187;16399;5248;16707
293360;202007;15520;38504;13146;35339;295;1220;11572;30541;11867;31761
310010;202007;949;2135;609;1660;49;176;229;567;278;743
310020;202007;2657;7145;1955;5895;433;1412;417;1198;850;2610
310030;202007;1921;5380;1473;4600;214;744;944;2835;1158;3579
310040;202007;894;2330;708;2014;29;129;487;1297;516;1426
310050;202007;1492;4463;1251;4077;131;537;818;2557;949;3094
310060;202007;3158;8910;2734;8348;78;321;2270;6843;2348;7164
310070;202007;344;781;240;633;8;18;178;465;186;483
310080;202007;685;1811;485;1448;71;237;222;622;293;859
310090;202007;4685;12413;3828;11013;286;882;2794;7907;3080;8789
310100;202007;3495;9616;2914;8644;79;366;2365;6814;2444;7180
310110;202007;4605;12088;3573;10270;765;2405;1553;4281;2318;6686
310120;202007;642;1565;405;1185;43;151;239;646;282;797
310130;202007;372;960;309;867;26;105;228;600;254;705
310140;202007;260;747;185;621;36;138;73;221;109;359
310150;202007;5410;14223;3981;11574;515;1721;1884;5156;2399;6877
310160;202007;7683;19148;5431;15422;1041;3255;1915;5486;2956;8741
310163;202007;1028;3027;818;2627;182;668;276;814;458;1482
310170;202007;9205;23348;7307;20358;615;1772;5162;14359;5777;16131
310180;202007;1790;4428;1310;3633;164;502;772;2068;936;2570
310190;202007;2546;7364;2048;6462;452;1603;342;1006;794;2609
310200;202007;1864;5487;1347;4478;190;723;625;2043;815;2766
310205;202007;1111;3053;851;2641;145;503;386;1176;531;1679
310210;202007;2602;6952;2109;6078;120;366;1528;4301;1648;4667
310220;202007;1250;3390;958;2825;89;283;631;1789;720;2072
310230;202007;2210;6074;1773;5254;218;721;1114;3082;1332;3803
310240;202007;960;2920;805;2645;47;181;578;1854;625;2035
310250;202007;1040;2764;835;2426;18;74;577;1665;595;1739
310260;202007;3141;8047;2008;6056;579;2041;565;1328;1144;3369
310270;202007;2717;6666;2144;5889;100;330;1746;4782;1846;5112
310280;202007;2437;5609;1875;4795;264;710;1077;2649;1341;3359
310285;202007;1854;5849;1537;5282;168;650;939;3195;1107;3845
310290;202007;1128;2961;918;2586;208;678;477;1199;685;1877
310300;202007;1501;4334;1271;3943;136;513;756;2193;892;2706
310310;202007;301;724;199;548;33;94;102;280;135;374
310320;202007;523;1322;354;1049;23;89;201;561;224;650
310330;202007;484;1142;286;790;42;133;118;295;160;428
310340;202007;7842;20919;6272;18271;867;2452;3140;9400;4007;11852
310350;202007;12642;30345;8582;23773;1624;4852;3825;10216;5449;15068
310360;202007;491;1115;373;963;13;37;250;651;263;688
310370;202007;1276;3934;1069;3535;205;739;355;1210;560;1949
310375;202007;870;2148;611;1762;95;282;329;943;424;1225
310380;202007;401;903;220;613;36;105;97;252;133;357
310390;202007;436;1296;340;1113;79;279;96;269;175;548
310400;202007;10082;24280;7167;19907;699;2253;4359;11800;5058;14053
310410;202007;891;2556;580;1973;89;330;219;697;308;1027
310420;202007;4321;11105;2914;8423;386;1266;1211;3229;1597;4495
310430;202007;1494;4052;966;3066;215;752;329;919;544;1671
310440;202007;659;1707;452;1329;42;151;241;666;283;817
310445;202007;1374;3880;998;3130;58;195;713;2197;771;2392
310450;202007;4687;11696;3508;9843;135;514;2668;7259;2803;7773
310460;202007;1682;4424;1217;3572;200;634;426;1169;626;1803
310470;202007;3749;8169;2898;7059;286;673;2047;5126;2333;5799
310480;202007;952;2444;739;2103;80;245;476;1314;556;1559
310490;202007;2812;7580;2192;6566;229;853;1243;3494;1472;4347
310500;202007;1352;3806;1011;3222;175;643;544;1667;719;2310
310510;202007;2096;5433;1352;4049;239;813;500;1487;739;2300
310520;202007;1187;3093;855;2492;142;402;444;1293;586;1695
310530;202007;724;1814;457;1326;66;235;157;372;223;607
310540;202007;2967;8438;2453;7551;551;1798;1120;3312;1671;5110
310550;202007;1260;3203;880;2550;80;286;499;1347;579;1633
310560;202007;14671;38019;10355;30453;1517;5126;4402;11688;5919;16814
310570;202007;1026;2664;809;2363;53;189;600;1722;653;1911
310590;202007;4051;10706;3223;9163;197;658;1877;5048;2074;5706
310600;202007;1303;3856;1063;3369;146;519;543;1609;689;2128
310610;202007;464;1227;289;939;71;247;111;337;182;584
310620;202007;171269;432666;123253;346056;17839;58098;59959;152740;77798;210838
310630;202007;4484;12187;3503;10274;315;992;2225;6328;2540;7320
310640;202007;1044;3090;850;2706;173;600;354;1079;527;1679
310650;202007;2364;6729;1700;5440;163;555;991;3080;1154;3635
310660;202007;1308;3480;1067;3156;32;106;903;2651;935;2757
310665;202007;1410;3611;1133;3207;30;111;917;2620;947;2731
310670;202007;57225;146585;48060;130867;4473;14010;33129;85874;37602;99884
310680;202007;763;1779;622;1583;17;62;531;1296;548;1358
310690;202007;1939;5057;1390;4120;108;364;785;2219;893;2583
310700;202007;486;1065;385;945;21;67;306;725;327;792
310710;202007;5501;15594;4025;13435;877;3486;718;2166;1595;5652
310720;202007;1018;2355;794;2071;36;116;600;1521;636;1637
310730;202007;9814;26286;8411;24073;313;1156;6354;17835;6667;18991
310740;202007;6097;16654;4177;12629;663;2225;1509;4156;2172;6381
310750;202007;1217;2892;887;2418;107;317;453;1169;560;1486
310760;202007;583;1511;417;1257;35;106;225;704;260;810
310770;202007;1096;2935;755;2412;78;302;389;1162;467;1464
310780;202007;4265;10319;3519;9321;69;205;2862;7618;2931;7823
310790;202007;1774;5589;1536;5079;353;1247;249;735;602;1982
310800;202007;2255;6645;1628;5363;357;1414;103;279;460;1693
310810;202007;1248;3062;1014;2674;43;122;723;1834;766;1956
310820;202007;1129;2910;694;2177;163;539;159;508;322;1047
310825;202007;2553;7678;2038;6825;71;414;1638;5287;1709;5701
310830;202007;1847;5178;1290;4060;250;905;541;1599;791;2504
310840;202007;2003;5413;1444;4471;344;1217;360;971;704;2188
310850;202007;1473;4022;1227;3679;45;229;956;2733;1001;2962
310855;202007;3031;8011;2341;6897;156;560;1683;4814;1839;5374
310860;202007;6905;19926;5499;17149;533;1762;3380;10623;3913;12385
310870;202007;958;2294;748;1993;58;150;553;1481;611;1631
310880;202007;980;2942;767;2502;106;357;443;1404;549;1761
310890;202007;2239;6367;1432;4729;264;941;224;623;488;1564
310900;202007;3843;10690;2603;7957;377;1219;1100;3145;1477;4364
310910;202007;2044;5020;1421;4022;116;403;290;768;406;1171
310920;202007;1896;4933;1430;4218;199;636;810;2346;1009;2982
310925;202007;943;2547;755;2244;69;242;514;1439;583;1681
310930;202007;5712;14940;4036;12197;770;2377;1850;5832;2620;8209
310940;202007;6696;15803;5377;13887;180;582;4126;10358;4306;10940
310945;202007;1313;3427;1029;2964;159;490;524;1480;683;1970
310950;202007;1898;5616;1232;4100;235;876;408;1182;643;2058
310960;202007;737;1967;406;1263;71;258;79;222;150;480
310970;202007;1120;3303;786;2581;199;720;142;430;341;1150
310980;202007;271;653;175;508;19;65;108;304;127;369
310990;202007;1320;3645;1023;3125;164;539;527;1578;691;2117
311000;202007;3983;11040;2886;9195;707;2431;1184;3646;1891;6077
311010;202007;878;2537;702;2179;208;719;297;888;505;1607
311020;202007;1080;2755;682;2028;40;116;370;1088;410;1204
311030;202007;1664;4074;1145;3223;204;648;524;1397;728;2045
311040;202007;276;865;226;755;69;241;70;220;139;461
311050;202007;2793;6829;2054;5758;354;1145;1035;2776;1389;3921
311060;202007;3177;8075;2322;6453;332;1064;953;2396;1285;3460
311070;202007;2305;5718;1660;4708;171;639;911;2397;1082;3036
311080;202007;1139;2563;916;2208;57;173;712;1628;769;1801
311090;202007;2000;6346;1554;5497;350;1369;469;1606;819;2975
311100;202007;2371;6715;1377;4647;252;975;246;738;498;1713
311110;202007;3620;7386;2024;5169;368;1002;749;1968;1117;2970
311115;202007;1364;3053;1139;2748;63;164;928;2209;991;2373
311120;202007;6499;16974;4916;14138;720;2367;1863;4719;2583;7086
311130;202007;1862;4819;1407;4189;108;408;812;2337;920;2745
311140;202007;1406;3440;1089;3004;80;261;735;1988;815;2249
311150;202007;1471;4659;1140;4007;181;712;609;2078;790;2790
311160;202007;3695;10595;2570;8466;648;2361;767;2421;1415;4782
311170;202007;893;2239;704;1988;40;115;443;1325;483;1440
311180;202007;1370;3082;852;2312;163;486;377;1017;540;1503
311190;202007;868;2394;664;1995;116;397;267;698;383;1095
311200;202007;2013;5411;1444;4321;271;892;527;1421;798;2313
311205;202007;863;2590;698;2258;47;212;438;1335;485;1547
311210;202007;1000;2914;868;2738;111;314;627;2033;738;2347
311220;202007;726;2018;605;1803;48;163;383;1081;431;1244
311230;202007;7603;22877;5729;19037;1030;3603;2147;7263;3177;10866
311240;202007;1024;2666;785;2322;168;529;326;963;494;1492
311250;202007;1070;3105;824;2632;175;536;321;978;496;1514
311260;202007;2667;6543;1696;4848;271;880;729;1901;1000;2781
311265;202007;1314;3396;964;2804;43;163;659;1873;702;2036
311270;202007;2950;8790;2561;8138;157;693;1861;5637;2018;6330
311280;202007;1076;2745;495;1567;98;361;49;132;147;493
311290;202007;1855;5620;1686;5266;148;484;1143;3554;1291;4038
311300;202007;4631;12951;3771;11504;197;838;2976;8871;3173;9709
311310;202007;570;1576;479;1416;47;144;287;817;334;961
311320;202007;3148;9548;2673;8515;389;1463;1261;3621;1650;5084
311330;202007;5063;13250;4002;11520;437;1377;2221;6504;2658;7881
311340;202007;10387;29013;8187;25087;2120;7059;2245;6523;4365;13582
311350;202007;2409;5917;1709;4636;156;469;922;2243;1078;2712
311360;202007;1124;2742;705;2105;199;672;232;665;431;1337
311370;202007;4641;11147;3389;9177;142;549;2267;5776;2409;6325
311380;202007;359;1079;261;873;63;203;111;398;174;601
311390;202007;1728;5217;1361;4704;591;2294;331;1033;922;3327
311400;202007;1496;4092;1083;3294;162;508;398;1077;560;1585
311410;202007;1665;4879;1328;4376;200;758;758;2448;958;3206
311420;202007;1462;4262;1019;3349;189;706;251;680;440;1386
311430;202007;3997;10535;2645;7854;496;1535;847;2480;1343;4015
311440;202007;2738;7651;2021;6415;472;1778;511;1533;983;3311
311450;202007;1694;5036;1209;4124;318;1227;328;967;646;2194
311455;202007;993;2195;653;1689;167;435;257;707;424;1142
311460;202007;472;1468;317;1138;64;299;86;258;150;557
311470;202007;501;1553;339;1168;78;312;49;158;127;470
311480;202007;1041;2672;856;2391;46;134;660;1838;706;1972
311490;202007;251;740;186;608;32;128;87;250;119;378
311500;202007;452;1113;350;967;20;60;238;639;258;699
311510;202007;3199;8306;2160;6490;308;1040;902;2544;1210;3584
311520;202007;623;1743;547;1596;70;261;306;869;376;1130
311530;202007;8706;20258;5438;14977;1315;4030;1433;3728;2748;7758
311535;202007;781;2139;506;1567;83;266;175;500;258;766
311540;202007;479;1515;425;1412;77;288;284;910;361;1198
311545;202007;2002;5728;1706;5266;97;348;1319;4016;1416;4364
311547;202007;1457;3706;1256;3395;45;121;860;2349;905;2470
311550;202007;2721;7592;2153;6544;303;1050;935;2696;1238;3746
311560;202007;294;644;186;485;73;181;40;96;113;277
311570;202007;1659;3809;1168;3131;38;110;924;2519;962;2629
311580;202007;2146;3982;1408;3111;147;302;942;2082;1089;2384
311590;202007;488;1294;387;1140;62;210;215;622;277;832
311600;202007;1736;3883;1449;3513;60;145;1244;2975;1304;3120
311610;202007;2223;7188;1834;6360;196;746;1038;3546;1234;4292
311615;202007;3205;8939;2587;7907;114;418;2031;6094;2145;6512
311620;202007;436;1109;376;1043;9;33;321;882;330;915
311630;202007;1334;3647;1082;3127;105;338;703;1950;808;2288
311640;202007;627;1705;496;1478;64;225;227;615;291;840
311650;202007;1888;4823;1551;4302;156;475;1001;2693;1157;3168
311660;202007;2867;8042;2107;6573;377;1319;591;1545;968;2864
311670;202007;1534;4004;1121;3266;165;540;459;1340;624;1880
311680;202007;2138;6093;1587;5060;166;532;1059;3362;1225;3894
311690;202007;611;1296;477;1126;39;74;349;876;388;950
311700;202007;2204;5291;1712;4609;26;128;1442;3756;1468;3884
311710;202007;1506;4306;1081;3545;254;911;401;1293;655;2204
311720;202007;412;1210;329;1058;28;107;178;564;206;671
311730;202007;3755;9615;2394;6995;699;2202;473;1419;1172;3621
311740;202007;865;2269;723;2099;66;184;587;1754;653;1938
311750;202007;3818;11405;3034;9966;421;1502;1717;5433;2138;6935
311760;202007;637;1788;518;1573;69;259;264;690;333;949
311770;202007;2054;5894;1597;5061;245;825;750;2299;995;3124
311780;202007;1300;3712;876;2852;160;589;266;743;426;1332
311783;202007;2242;6043;1805;5282;41;190;1455;4081;1496;4271
311787;202007;759;2175;573;1742;84;278;252;657;336;935
311790;202007;1459;3927;946;2989;235;821;253;752;488;1573
311800;202007;4732;14206;3815;12201;803;2802;661;1816;1464;4618
311810;202007;931;2818;734;2465;55;209;481;1597;536;1806
311820;202007;777;1882;574;1568;68;219;358;919;426;1138
311830;202007;8296;23719;5602;17858;1553;5364;693;2169;2246;7533
311840;202007;3541;8962;2842;7959;257;765;2078;5772;2335;6537
311850;202007;361;948;293;820;13;41;195;523;208;564
311860;202007;58078;146104;44140;122400;6435;19229;24570;65081;31005;84310
311870;202007;1865;4926;1262;3836;213;736;497;1371;710;2107
311880;202007;6166;15963;5139;14538;275;697;3876;11185;4151;11882
311890;202007;1651;3963;1263;3402;92;291;899;2296;991;2587
311900;202007;733;1888;548;1638;64;229;348;1006;412;1235
311910;202007;4128;10573;3090;9214;547;1604;1556;4788;2103;6392
311920;202007;2088;5510;1657;4883;120;315;1042;3178;1162;3493
311930;202007;3780;8813;2678;7243;823;2424;800;1994;1623;4418
311940;202007;15257;39858;11234;32236;1595;5025;5131;13683;6726;18708
311950;202007;2301;6167;1717;5176;115;408;1029;3147;1144;3555
311960;202007;488;1195;392;1051;22;84;255;626;277;710
311970;202007;421;1345;307;1056;51;209;72;215;123;424
311980;202007;443;1198;226;761;22;77;77;254;99;331
311990;202007;541;1251;338;949;67;237;145;358;212;595
311995;202007;959;2626;484;1540;21;70;69;149;90;219
312000;202007;748;1868;560;1585;54;150;352;1014;406;1164
312010;202007;954;2621;735;2252;52;182;468;1358;520;1540
312015;202007;1344;3960;1182;3697;48;214;955;2918;1003;3132
312020;202007;1551;4740;1171;3921;251;893;295;923;546;1816
312030;202007;1982;4927;1722;4639;20;76;1606;4319;1626;4395
312040;202007;849;2471;587;1952;67;233;266;853;333;1086
312050;202007;1182;3658;943;3191;215;858;293;875;508;1733
312060;202007;847;2096;556;1734;138;426;267;854;405;1280
312070;202007;893;2569;637;2060;48;177;350;1067;398;1244
312080;202007;2622;6453;1944;5444;107;347;1266;3392;1373;3739
312083;202007;862;2239;632;1878;52;190;423;1211;475;1401
312087;202007;2461;6395;1981;5641;45;138;1550;4448;1595;4586
312090;202007;10126;26359;7793;22642;1150;3698;3934;11081;5084;14779
312100;202007;1548;4457;1201;3825;106;416;699;2126;805;2542
312110;202007;1021;3136;847;2784;190;724;306;898;496;1622
312120;202007;949;2588;628;1992;164;599;187;488;351;1087
312125;202007;1710;4400;1424;3984;112;367;1060;2850;1172;3217
312130;202007;1009;2436;753;2009;60;177;341;829;401;1006
312140;202007;673;1942;546;1681;109;376;243;687;352;1063
312150;202007;448;1251;379;1107;13;56;271;740;284;796
312160;202007;8611;23452;6500;19677;795;2791;3207;9224;4002;12015
312170;202007;887;2405;669;1977;37;137;441;1262;478;1399
312180;202007;1381;3671;1090;3118;154;452;551;1521;705;1973
312190;202007;654;1796;467;1430;81;276;160;452;241;728
312200;202007;4505;12250;3540;10692;1079;3252;1229;3833;2308;7085
312210;202007;1349;3011;966;2453;36;111;729;1809;765;1920
312220;202007;1619;5003;1395;4582;102;361;885;2910;987;3271
312230;202007;12928;33460;8472;25277;2012;6784;1678;4295;3690;11079
312235;202007;1919;4882;1515;4273;87;298;1086;2973;1173;3271
312240;202007;685;2241;519;1891;118;463;144;515;262;978
312245;202007;2643;6805;2154;6060;63;176;1758;4919;1821;5095
312247;202007;948;2308;678;1913;121;362;351;1002;472;1364
312250;202007;976;2587;625;1886;81;263;239;703;320;966
312260;202007;926;2481;735;2186;37;151;561;1608;598;1759
312270;202007;696;1895;527;1562;25;106;307;830;332;936
312280;202007;412;1215;322;1054;94;319;45;134;139;453
312290;202007;723;2130;577;1868;106;391;196;606;302;997
312300;202007;965;2926;643;2129;157;566;122;338;279;904
312310;202007;944;2841;749;2424;118;406;342;1060;460;1466
312320;202007;1966;5056;1418;4078;328;997;326;891;654;1888
312330;202007;842;2493;669;2128;62;222;410;1275;472;1497
312340;202007;261;680;184;550;44;156;78;204;122;360
312350;202007;247;498;173;418;15;46;119;273;134;319
312352;202007;1596;4775;1416;4450;85;274;869;2905;954;3179
312360;202007;2671;7724;1947;6315;385;1375;623;1923;1008;3298
312370;202007;1848;4774;1498;4185;175;546;882;2350;1057;2896
312380;202007;2116;4791;1737;4315;6;25;1556;3821;1562;3846
312385;202007;1203;3294;938;2815;137;437;447;1340;584;1777
312390;202007;1850;5329;1373;4421;202;755;519;1522;721;2277
312400;202007;2799;7998;2292;7106;697;2312;734;2264;1431;4576
312410;202007;11480;31664;9293;27959;1608;5038;5097;15143;6705;20181
312420;202007;3649;9944;3028;8913;554;1793;1624;4659;2178;6452
312430;202007;7695;20561;6270;17966;396;1320;4419;12342;4815;13662
312440;202007;907;2919;714;2476;353;1297;95;300;448;1597
312450;202007;1176;3454;894;2961;249;880;296;1022;545;1902
312460;202007;435;1140;299;930;44;147;155;495;199;642
312470;202007;469;1118;293;811;33;100;110;269;143;369
312480;202007;1036;2571;722;2110;100;323;357;981;457;1304
312490;202007;2078;5071;1591;4348;201;571;857;2288;1058;2859
312500;202007;984;2415;800;2158;53;185;552;1463;605;1648
312510;202007;3663;9685;2594;7656;654;1865;687;2069;1341;3934
312520;202007;171;467;129;397;34;111;55;168;89;279
312530;202007;583;1435;499;1333;16;56;440;1179;456;1235
312540;202007;1544;4338;1029;3263;142;492;567;1740;709;2232
312550;202007;774;2043;588;1670;46;148;376;977;422;1125
312560;202007;1929;4970;1535;4347;71;222;1166;3299;1237;3521
312570;202007;2138;5232;1597;4548;456;1357;613;1826;1069;3183
312580;202007;616;1700;434;1313;56;198;197;547;253;745
312590;202007;1585;4611;1259;3958;83;387;790;2299;873;2686
312595;202007;1939;5705;1619;5154;262;788;962;3223;1224;4011
312600;202007;1166;2804;652;1818;114;395;121;384;235;779
312610;202007;6519;16456;4257;12217;640;2018;1470;3889;2110;5907
312620;202007;2522;6481;1859;5548;55;236;1468;4476;1523;4712
312630;202007;283;814;199;663;38;146;78;249;116;395
312640;202007;507;1381;350;1111;40;134;134;437;174;571
312650;202007;2027;5192;1376;3965;66;210;970;2668;1036;2878
312660;202007;1337;3235;1004;2671;94;276;676;1735;770;2011
312670;202007;4883;12870;4047;11530;181;745;2938;7993;3119;8738
312675;202007;1233;3270;998;2922;60;196;799;2316;859;2512
312680;202007;1367;3862;1183;3576;53;228;972;2850;1025;3078
312690;202007;2888;6103;2244;5327;51;146;1871;4442;1922;4588
312695;202007;960;2598;794;2306;40;92;620;1805;660;1897
312700;202007;2088;5504;1503;4424;149;511;843;2343;992;2854
312705;202007;1397;3338;1185;3022;15;51;1078;2730;1093;2781
312707;202007;1363;3961;1050;3384;64;301;681;2074;745;2375
312710;202007;6453;14780;3749;10514;948;2859;1063;3079;2011;5938
312720;202007;1059;2819;793;2396;106;339;486;1429;592;1768
312730;202007;1615;3807;1137;3144;96;300;658;1749;754;2049
312733;202007;1365;3603;1036;2974;37;144;710;1935;747;2079
312735;202007;697;1879;585;1660;67;213;342;871;409;1084
312737;202007;783;1783;544;1430;68;194;347;868;415;1062
312738;202007;648;1657;464;1351;47;155;257;710;304;865
312740;202007;430;1053;247;739;52;177;65;149;117;326
312750;202007;1565;4514;1160;3751;209;715;492;1508;701;2223
312760;202007;1768;5193;1245;4107;223;793;454;1427;677;2220
312770;202007;44329;106054;27572;77232;5682;17094;9095;24936;14777;42030
312780;202007;2404;7179;2033;6579;244;840;1301;4201;1545;5041
312790;202007;242;579;129;399;7;38;41;105;48;143
312800;202007;4760;13472;3586;11211;881;2910;1230;3753;2111;6663
312810;202007;1543;4099;1009;3232;252;900;356;1041;608;1941
312820;202007;1751;4664;1383;4018;42;163;1043;2951;1085;3114
312825;202007;1327;3113;1150;2882;20;73;982;2405;1002;2478
312830;202007;2814;7880;1647;5448;342;1287;404;1256;746;2543
312840;202007;1300;3540;1021;3059;89;351;539;1503;628;1854
312850;202007;909;2222;641;1824;24;101;387;1012;411;1113
312860;202007;1134;2921;761;2340;195;640;174;491;369;1131
312870;202007;6062;16308;3686;11712;632;2145;820;2441;1452;4586
312880;202007;1419;3532;1093;2979;36;120;654;1786;690;1906
312890;202007;2241;5582;1611;4529;113;307;819;2343;932;2650
312900;202007;1187;3008;962;2726;145;453;464;1437;609;1890
312910;202007;1639;2989;854;1951;166;314;322;768;488;1082
312920;202007;993;2645;680;2118;116;420;285;814;401;1234
312930;202007;2302;5665;1767;4869;400;1140;782;2177;1182;3317
312940;202007;946;2590;733;2274;75;283;373;1095;448;1378
312950;202007;3095;7666;1999;5869;516;1654;628;1782;1144;3436
312960;202007;1783;4725;1497;4280;66;175;1172;3430;1238;3605
312965;202007;1613;4494;1343;4062;112;353;932;2762;1044;3115
312970;202007;1331;3719;1034;3231;147;560;597;1741;744;2301
312980;202007;23592;64668;18942;56247;3662;11864;9029;25176;12691;37040
312990;202007;492;1232;311;913;56;183;151;417;207;600
313000;202007;479;1370;359;1145;29;124;209;620;238;744
313005;202007;2486;7143;2084;6455;163;489;1467;4513;1630;5002
313010;202007;4983;13688;3957;12009;701;2329;2316;6874;3017;9203
313020;202007;1037;3125;715;2371;130;465;139;389;269;854
313030;202007;1084;2524;726;1991;79;269;471;1222;550;1491
313040;202007;795;2431;657;2151;44;184;389;1212;433;1396
313050;202007;1746;4793;1211;3979;203;796;398;1162;601;1958
313055;202007;1888;5064;1667;4742;57;185;1438;4068;1495;4253
313060;202007;946;2267;679;1815;179;584;129;306;308;890
313065;202007;1629;4856;1421;4510;47;182;1096;3394;1143;3576
313070;202007;936;2467;701;2055;72;224;407;1167;479;1391
313080;202007;388;1076;284;874;49;175;103;265;152;440
313090;202007;5032;13369;4260;12119;336;1096;2849;8028;3185;9124
313100;202007;1323;3421;1015;2979;28;115;772;2208;800;2323
313110;202007;1467;3854;1063;3147;96;354;595;1652;691;2006
313115;202007;2610;7514;2099;6510;271;934;1099;3195;1370;4129
313120;202007;3738;8816;2714;7465;225;717;1755;4783;1980;5500
313130;202007;30423;78627;23062;65048;2501;7993;13049;34729;15550;42722
313140;202007;605;1314;357;954;30;73;238;644;268;717
313150;202007;1344;3768;991;3116;303;1034;218;618;521;1652
313160;202007;1151;2885;899;2497;27;100;673;1814;700;1914
313170;202007;11036;31269;7835;25278;1340;4745;3109;9426;4449;14171
313180;202007;2062;5441;1453;4236;182;559;830;2366;1012;2925
313190;202007;4233;12131;3081;9775;570;1959;1052;3113;1622;5072
313200;202007;1070;2961;930;2718;15;55;787;2231;802;2286
313210;202007;3736;10897;3022;9611;357;1284;1802;5505;2159;6789
313220;202007;1734;4552;1137;3361;165;549;458;1201;623;1750
313230;202007;2951;8245;2425;7599;46;172;2028;6498;2074;6670
313240;202007;9640;23509;5952;17539;999;3391;2509;6854;3508;10245
313250;202007;6181;18030;4590;14671;836;2716;1990;6218;2826;8934
313260;202007;617;1616;439;1295;61;240;216;579;277;819
313270;202007;5737;14260;4563;12598;564;1525;3067;8632;3631;10157
313280;202007;460;1287;296;948;35;124;129;389;164;513
313290;202007;937;2897;685;2443;215;832;216;763;431;1595
313300;202007;1574;4192;1120;3368;288;946;261;679;549;1625
313310;202007;1137;3346;872;2790;141;537;242;658;383;1195
313320;202007;2099;5572;1506;4601;262;914;620;1904;882;2818
313330;202007;4043;10580;3048;9070;173;652;1971;5831;2144;6483
313340;202007;1395;3127;981;2555;87;239;683;1768;770;2007
313350;202007;2697;7568;1729;5314;233;771;610;1663;843;2434
313360;202007;1454;3518;1002;2800;159;545;518;1325;677;1870
313370;202007;1409;3947;1169;3475;133;477;666;1826;799;2303
313375;202007;1743;4547;1068;3276;190;630;231;663;421;1293
313380;202007;6231;15545;4429;12229;788;2441;2069;5064;2857;7505
313390;202007;800;2564;691;2380;49;233;462;1522;511;1755
313400;202007;3694;9108;2837;7919;159;481;2176;5996;2335;6477
313410;202007;1309;3397;1005;2854;51;174;748;2070;799;2244
313420;202007;15416;34195;7762;21280;1741;5308;1121;3017;2862;8325
313430;202007;946;2769;716;2293;126;495;302;845;428;1340
313440;202007;6192;13453;4035;10598;387;1052;2466;6496;2853;7548
313450;202007;719;1930;498;1483;79;252;177;451;256;703
313460;202007;2076;5917;1640;5229;331;1197;769;2312;1100;3509
313470;202007;2861;7298;2247;6392;248;705;1468;4229;1716;4934
313480;202007;1002;2863;555;1853;70;258;166;502;236;760
313490;202007;2534;6118;1193;3699;307;1070;204;629;511;1699
313500;202007;510;1422;382;1145;45;136;156;431;201;567
313505;202007;9926;26212;8438;24185;340;1196;6784;19433;7124;20629
313507;202007;1463;3795;1188;3369;33;134;947;2613;980;2747
313510;202007;13625;37469;10633;31671;1278;4000;4993;14553;6271;18553
313520;202007;14103;39757;11174;34685;594;2230;8292;25141;8886;27371
313530;202007;520;1536;387;1246;48;163;151;442;199;605
313535;202007;2356;6518;1956;5739;264;702;1191;3508;1455;4210
313540;202007;762;2251;606;1873;108;336;253;732;361;1068
313545;202007;1145;3755;953;3353;153;564;508;1730;661;2294
313550;202007;1727;5260;1413;4517;314;1122;714;2174;1028;3296
313560;202007;2654;5233;1973;4404;60;113;1663;3739;1723;3852
313570;202007;983;2860;804;2535;199;658;321;974;520;1632
313580;202007;5607;14639;4295;12428;484;1483;2472;7254;2956;8737
313590;202007;1014;2857;813;2572;202;668;370;1252;572;1920
313600;202007;3989;10624;3313;9570;95;387;2776;7863;2871;8250
313610;202007;1050;2634;844;2287;92;281;537;1375;629;1656
313620;202007;5529;14582;4302;12327;542;1724;2451;6778;2993;8502
313630;202007;8619;20708;6038;16809;599;1931;3639;9912;4238;11843
313640;202007;1094;2477;696;1964;147;449;312;871;459;1320
313650;202007;1711;5103;1350;4484;94;372;888;2979;982;3351
313652;202007;738;2325;662;2167;109;376;412;1319;521;1695
313655;202007;1125;2860;886;2552;46;139;689;1979;735;2118
313657;202007;1170;3122;922;2732;39;151;675;1889;714;2040
313660;202007;888;2478;718;2170;79;285;445;1272;524;1557
313665;202007;4741;12625;3661;10686;407;1330;2268;6309;2675;7639
313670;202007;48882;119216;30829;88521;4582;14448;13510;36653;18092;51101
313680;202007;1007;2696;825;2401;61;207;550;1551;611;1758
313690;202007;801;2473;616;2129;154;592;161;535;315;1127
313695;202007;1796;4901;1361;4174;86;280;911;2795;997;3075
313700;202007;2891;9211;2488;8671;248;878;1853;6502;2101;7380
313710;202007;1375;3183;988;2667;73;203;662;1801;735;2004
313720;202007;5441;14969;3734;11381;588;1988;1521;4228;2109;6216
313730;202007;1314;2962;991;2522;81;179;648;1657;729;1836
313740;202007;1642;5840;1350;5078;312;1350;244;783;556;2133
313750;202007;1990;5295;1519;4455;271;887;721;1975;992;2862
313753;202007;2196;5205;1461;4018;142;425;813;2163;955;2588
313760;202007;5171;14229;3872;11716;790;2635;1692;4756;2482;7391
313770;202007;3927;11018;3095;9673;201;665;2281;7216;2482;7881
313780;202007;3973;10575;2853;8687;231;833;826;2576;1057;3409
313790;202007;486;1507;434;1412;50;187;242;761;292;948
313800;202007;1362;3118;983;2578;124;378;526;1309;650;1687
313810;202007;1584;4046;1259;3584;52;201;964;2666;1016;2867
313820;202007;17550;44344;10928;30342;1729;5071;3008;8048;4737;13119
313830;202007;381;1086;266;820;48;164;89;252;137;416
313835;202007;909;2670;747;2369;58;238;422;1255;480;1493
313840;202007;6962;18097;5167;15100;1265;3925;1088;3251;2353;7176
313850;202007;981;2391;778;2116;142;470;371;893;513;1363
313860;202007;2525;6794;1878;5568;299;1011;782;2121;1081;3132
313862;202007;1354;2849;646;1806;41;119;311;868;352;987
313865;202007;2531;6744;2083;6012;81;252;1569;4439;1650;4691
313867;202007;1310;3910;1082;3483;150;469;664;2201;814;2670
313868;202007;1691;5206;1385;4583;45;221;1057;3385;1102;3606
313870;202007;763;2060;551;1668;91;285;211;582;302;867
313880;202007;1678;4385;1230;3623;168;565;580;1506;748;2071
313890;202007;2023;4396;1512;3730;46;153;1120;2687;1166;2840
313900;202007;4086;11836;2910;9414;749;2666;700;2067;1449;4733
313910;202007;645;1892;487;1592;102;358;104;329;206;687
313920;202007;2906;8958;2422;7941;500;1612;1191;3952;1691;5564
313925;202007;1576;3978;1255;3405;189;501;811;2186;1000;2687
313930;202007;4602;13871;3712;12251;287;1079;2386;7759;2673;8838
313940;202007;8728;25222;6275;20925;781;3203;1494;5508;2275;8711
313950;202007;5144;11397;3726;9647;411;1329;2212;5703;2623;7032
313960;202007;5770;13922;3850;10685;711;2242;1327;3362;2038;5604
313970;202007;1495;4040;1248;3624;22;71;792;2247;814;2318
313980;202007;1330;3433;865;2703;132;479;343;1005;475;1484
313990;202007;1897;6032;1348;4760;344;1401;415;1273;759;2674
314000;202007;9482;24348;7922;21673;571;2013;5286;14256;5857;16269
314010;202007;1465;3521;1141;3077;45;153;866;2260;911;2413
314015;202007;1921;5336;1454;4535;188;696;784;2383;972;3079
314020;202007;461;1251;303;982;66;258;60;208;126;466
314030;202007;798;2296;630;1972;59;186;333;1024;392;1210
314040;202007;617;1660;490;1424;74;245;263;735;337;980
314050;202007;1795;4768;1296;3843;152;536;690;1904;842;2440
314053;202007;1783;5313;1428;4602;277;888;746;2492;1023;3380
314055;202007;2253;6072;1895;5509;43;163;1549;4497;1592;4660
314060;202007;1301;3411;974;2892;33;127;690;2019;723;2146
314070;202007;4639;12705;3596;10797;736;2200;1576;4682;2312;6882
314080;202007;2075;5376;1412;4239;185;657;599;1609;784;2266
314085;202007;2079;5900;1687;5287;229;756;957;3057;1186;3813
314090;202007;4578;12308;3912;11324;242;902;2460;7246;2702;8148
314100;202007;3113;7401;2397;6410;42;121;1801;4830;1843;4951
314110;202007;4668;13169;3775;11436;425;1503;2156;6093;2581;7596
314120;202007;773;1808;318;955;65;239;73;200;138;439
314130;202007;607;1567;373;1148;22;94;232;704;254;798
314140;202007;4481;12732;3521;10876;475;1549;1759;5331;2234;6880
314150;202007;1486;3697;1083;3004;80;235;722;1944;802;2179
314160;202007;2176;5719;1576;4611;214;692;673;1973;887;2665
314170;202007;924;2603;741;2239;43;163;485;1377;528;1540
314180;202007;5387;14988;4339;13290;360;1192;2614;8019;2974;9211
314190;202007;619;1531;435;1256;81;271;201;512;282;783
314200;202007;2945;8210;2408;7290;149;514;1710;5030;1859;5544
314210;202007;1997;5230;1584;4474;181;523;787;2178;968;2701
314220;202007;1366;3710;973;3019;209;742;360;1023;569;1765
314225;202007;1068;3003;877;2697;74;192;635;2010;709;2202
314230;202007;765;1972;625;1799;78;254;401;1181;479;1435
314240;202007;1025;2767;786;2391;191;607;297;917;488;1524
314250;202007;502;1402;307;996;47;146;113;335;160;481
314260;202007;937;2545;726;2255;161;539;401;1212;562;1751
314270;202007;3279;9280;2687;8353;78;327;1968;6069;2046;6396
314280;202007;3404;7881;2253;6118;263;794;1221;3154;1484;3948
314290;202007;4414;11445;3594;9974;293;841;2448;6659;2741;7500
314300;202007;1901;5441;1228;3985;250;899;400;1224;650;2123
314310;202007;4089;10578;2694;8176;858;2858;434;1166;1292;4024
314315;202007;900;3109;767;2834;49;235;541;1928;590;2163
314320;202007;2955;8034;1918;6060;344;1186;720;2187;1064;3373
314330;202007;49367;138113;37032;115952;9835;32213;7592;25065;17427;57278
314340;202007;2437;6020;1483;4297;278;926;377;932;655;1858
314345;202007;1400;4140;1132;3652;153;497;659;2106;812;2603
314350;202007;812;2208;521;1676;114;387;121;335;235;722
314360;202007;559;1610;335;1118;51;192;108;322;159;514
314370;202007;736;1945;588;1722;43;148;399;1117;442;1265
314380;202007;1132;3069;752;2383;166;596;162;487;328;1083
314390;202007;13536;34164;8794;25494;1594;5022;2906;7531;4500;12553
314400;202007;3957;11765;2971;9854;763;2606;1094;3775;1857;6381
314410;202007;2687;7483;1845;5905;248;910;618;2097;866;3007
314420;202007;830;2042;594;1651;38;145;395;1030;433;1175
314430;202007;7802;19057;5409;15008;812;2375;2508;6632;3320;9007
314435;202007;1782;4724;1403;4085;59;224;1030;2920;1089;3144
314437;202007;901;2310;655;1894;71;224;319;913;390;1137
314440;202007;614;1750;429;1367;121;423;86;227;207;650
314450;202007;1383;3693;1154;3337;115;388;673;1860;788;2248
314460;202007;3222;9787;2323;7873;594;2129;544;1775;1138;3904
314465;202007;2191;6340;1860;5702;54;208;1426;4226;1480;4434
314467;202007;915;2388;770;2154;23;64;616;1679;639;1743
314470;202007;2198;6318;1768;5437;309;1046;809;2334;1118;3380
314480;202007;6392;18223;4595;14416;770;2692;1676;4660;2446;7352
314490;202007;1066;2843;777;2240;66;189;477;1336;543;1525
314500;202007;1710;4102;1217;3407;306;845;423;1229;729;2074
314505;202007;2025;4948;1642;4401;101;282;1196;3119;1297;3401
314510;202007;1890;4944;1322;4065;263;916;595;1784;858;2700
314520;202007;4996;15276;3650;12420;745;2773;456;1376;1201;4149
314530;202007;5361;17252;4795;16153;314;1328;3521;11579;3835;12907
314535;202007;2502;6534;2010;5816;88;323;1533;4387;1621;4710
314537;202007;1084;3078;830;2666;46;177;596;1878;642;2055
314540;202007;389;965;259;742;18;62;149;409;167;471
314545;202007;1886;4487;1685;4254;29;84;1465;3790;1494;3874
314550;202007;634;1572;473;1341;35;130;264;681;299;811
314560;202007;4262;12811;3144;10289;494;1797;1083;3214;1577;5011
314570;202007;294;812;216;665;27;99;94;289;121;388
314580;202007;455;1358;357;1159;89;293;122;389;211;682
314585;202007;651;2032;490;1673;71;296;208;686;279;982
314587;202007;1993;5415;1497;4616;199;580;853;2709;1052;3289
314590;202007;3983;10846;2861;8706;388;1335;1245;3491;1633;4826
314600;202007;1903;5173;1108;3633;218;770;132;397;350;1167
314610;202007;8730;21800;6058;17804;1003;3501;2544;7645;3547;11146
314620;202007;2214;5190;1742;4590;40;135;1449;3791;1489;3926
314625;202007;1517;4167;1294;3858;30;178;1113;3241;1143;3419
314630;202007;5326;13511;4345;12204;98;406;3641;10220;3739;10626
314640;202007;676;1610;487;1315;67;206;269;677;336;883
314650;202007;830;1911;503;1403;48;152;274;675;322;827
314655;202007;1595;4382;1124;3524;169;527;554;1728;723;2255
314660;202007;322;729;206;519;14;30;134;325;148;355
314670;202007;1609;3689;1106;2968;17;53;729;1932;746;1985
314675;202007;1681;4468;1427;4038;74;249;1114;3064;1188;3313
314690;202007;2052;5712;1570;4987;414;1462;539;1674;953;3136
314700;202007;9996;27925;6464;21012;1244;4467;1959;6176;3203;10643
314710;202007;7697;21529;5524;16923;925;3131;1929;5144;2854;8275
314720;202007;2108;6190;1439;4801;298;1120;366;1136;664;2256
314730;202007;2233;5843;1608;4695;255;830;665;1782;920;2612
314740;202007;2898;8188;2229;6970;290;972;1123;3431;1413;4403
314750;202007;292;790;223;650;27;92;134;351;161;443
314760;202007;1927;5742;1245;4156;204;781;321;839;525;1620
314770;202007;1100;3207;588;1893;47;165;179;536;226;701
314780;202007;351;825;234;646;40;135;128;310;168;445
314790;202007;10476;27992;7156;21820;1500;5258;2483;6988;3983;12246
314795;202007;1495;3945;1255;3523;29;120;995;2687;1024;2807
314800;202007;10663;27085;6415;19142;1177;3886;1602;4234;2779;8120
314810;202007;8597;22870;6178;18601;1551;4992;2032;5978;3583;10970
314820;202007;1212;2916;945;2517;50;189;610;1549;660;1738
314830;202007;1479;4486;1228;4005;220;819;594;1870;814;2689
314840;202007;834;2631;657;2344;47;235;465;1588;512;1823
314850;202007;2031;4758;1649;4268;40;136;1435;3727;1475;3863
314860;202007;3146;9273;2592;8256;193;788;1778;5511;1971;6299
314870;202007;6265;15883;4722;13817;279;904;3485;10279;3764;11183
314875;202007;1747;5201;1516;4896;117;303;1212;4006;1329;4309
314880;202007;819;2009;627;1712;32;88;377;1041;409;1129
314890;202007;420;1252;317;1032;50;183;131;403;181;586
314900;202007;727;1951;564;1660;92;317;239;643;331;960
314910;202007;1651;4654;1222;3956;207;780;604;1836;811;2616
314915;202007;2177;6446;1815;5806;118;392;1196;3763;1314;4155
314920;202007;463;1200;295;942;7;22;197;645;204;667
314930;202007;5402;15159;4022;12556;685;2385;1592;4593;2277;6978
314940;202007;396;994;326;873;33;86;210;531;243;617
314950;202007;512;1289;336;991;28;109;175;458;203;567
314960;202007;841;2002;643;1674;28;90;457;1120;485;1210
314970;202007;964;2797;735;2317;138;476;325;936;463;1412
314980;202007;1487;3801;1091;3217;195;663;515;1485;710;2148
314990;202007;2434;7000;1690;5307;342;1143;356;1004;698;2147
314995;202007;1570;4400;1237;3793;37;162;821;2381;858;2543
315000;202007;1108;2800;784;2304;62;199;517;1497;579;1696
315010;202007;375;1031;283;873;46;170;134;390;180;560
315015;202007;2247;6313;1943;5798;189;630;1285;3768;1474;4398
315020;202007;795;2321;554;1769;71;283;235;687;306;970
315030;202007;583;1559;393;1203;89;277;81;225;170;502
315040;202007;808;2272;653;1999;85;281;400;1213;485;1494
315050;202007;1213;3135;873;2590;50;180;463;1340;513;1520
315053;202007;1090;2841;829;2383;52;162;485;1330;537;1492
315057;202007;1735;5222;1408;4645;139;462;943;3135;1082;3597
315060;202007;542;1638;397;1357;74;265;104;339;178;604
315070;202007;521;1375;354;1079;83;282;92;262;175;544
315080;202007;2913;8186;2227;6856;240;822;1401;4098;1641;4920
315090;202007;786;2357;572;1942;84;306;224;732;308;1038
315100;202007;1323;3859;860;2800;140;545;384;1097;524;1642
315110;202007;1829;4418;1319;3628;131;348;655;1864;786;2212
315120;202007;12026;28072;8829;23218;1167;2873;4782;13000;5949;15873
315130;202007;1570;4275;1294;3787;137;459;538;1477;675;1936
315140;202007;2925;8099;2246;6864;393;1302;1126;3265;1519;4567
315150;202007;4308;10320;2996;8202;462;1480;1401;3720;1863;5200
315160;202007;1741;4248;1143;3289;244;747;517;1473;761;2220
315170;202007;1355;4310;924;3261;218;849;215;723;433;1572
315180;202007;16890;40842;8955;26122;1205;3988;2847;7279;4052;11267
315190;202007;2198;4797;1700;4143;196;471;1245;3067;1441;3538
315200;202007;3860;10966;2763;8982;791;2769;727;2261;1518;5030
315210;202007;8458;21977;5720;16148;670;2057;2843;7259;3513;9316
315213;202007;1107;2903;950;2689;21;73;785;2180;806;2253
315217;202007;2785;8047;2106;6902;89;436;1461;4570;1550;5006
315220;202007;8489;23034;6646;19748;1154;3653;2810;8342;3964;11995
315230;202007;3065;7160;2558;6499;201;282;1940;5286;2141;5568
315240;202007;2427;7131;2040;6445;460;1513;985;3110;1445;4623
315250;202007;12710;34234;9043;27245;1436;4692;3842;11042;5278;15734
315260;202007;919;2527;483;1587;75;249;41;114;116;363
315270;202007;824;2356;582;1891;82;283;207;577;289;860
315280;202007;2896;7228;1707;5065;425;1372;265;759;690;2131
315290;202007;1166;2854;682;2079;192;657;198;573;390;1230
315300;202007;623;1512;428;1230;83;269;221;633;304;902
315310;202007;1249;3513;921;2883;76;271;514;1519;590;1790
315320;202007;649;1898;452;1494;69;272;192;579;261;851
315330;202007;748;2548;409;1622;64;298;129;456;193;754
315340;202007;2957;7144;2115;5934;272;797;1127;3146;1399;3943
315350;202007;1541;4204;1190;3655;165;592;665;2017;830;2609
315360;202007;1688;4988;1261;4076;195;673;504;1530;699;2203
315370;202007;471;1362;370;1155;70;217;148;452;218;669
315380;202007;193;568;141;455;39;136;30;68;69;204
315390;202007;1056;3002;836;2582;144;516;387;1101;531;1617
315400;202007;3982;10892;3119;9323;433;1362;1683;4830;2116;6192
315410;202007;2349;5411;1758;4557;468;1307;260;705;728;2012
315415;202007;1373;3736;1097;3313;227;807;426;1293;653;2100
315420;202007;1394;3928;943;3047;179;607;182;566;361;1173
315430;202007;3563;8667;2496;7048;442;1469;1083;2847;1525;4316
315440;202007;1021;2697;817;2363;60;203;493;1350;553;1553
315445;202007;1939;4685;1378;3884;87;291;999;2770;1086;3061
315450;202007;2195;6156;1783;5480;222;667;1101;3388;1323;4055
315460;202007;36051;100474;29585;88756;4559;15468;15941;44992;20500;60460
315470;202007;622;1758;442;1316;33;105;252;717;285;822
315480;202007;1164;3347;812;2584;156;526;262;804;418;1330
315490;202007;2928;7361;2014;5873;296;889;732;2051;1028;2940
315500;202007;525;1400;320;951;43;149;160;416;203;565
315510;202007;1223;3196;1032;2924;24;104;897;2499;921;2603
315520;202007;976;2711;784;2378;52;192;590;1741;642;1933
315530;202007;575;1617;461;1426;132;470;225;638;357;1108
315540;202007;1412;3800;978;2986;101;367;448;1327;549;1694
315550;202007;1910;4973;1230;3702;256;887;301;885;557;1772
315560;202007;6216;18892;5229;17067;298;939;3487;11624;3785;12563
315570;202007;2022;5477;1607;4783;91;323;919;2664;1010;2987
315580;202007;2759;6555;2056;5443;283;879;781;1945;1064;2824
315590;202007;886;2259;679;1925;72;254;378;989;450;1243
315600;202007;2442;7674;1749;6295;261;901;898;3400;1159;4301
315610;202007;950;2429;699;1957;106;372;311;752;417;1124
315620;202007;503;1342;376;1152;45;163;217;671;262;834
315630;202007;1034;2741;763;2241;129;394;349;940;478;1334
315640;202007;349;867;259;755;29;108;155;430;184;538
315645;202007;988;2543;668;2013;159;517;170;493;329;1010
315650;202007;1720;4133;1372;3648;36;114;1115;2873;1151;2987
315660;202007;2428;5985;1816;4925;103;313;1287;3363;1390;3676
315670;202007;13442;36799;10168;30822;2004;6356;4577;13346;6581;19702
315680;202007;3103;8937;2263;7326;294;1078;1181;3641;1475;4719
315690;202007;3296;8011;1930;5631;419;1245;574;1800;993;3045
315700;202007;7945;22000;5953;17962;952;3041;2661;7695;3613;10736
315710;202007;1823;4525;1281;3701;42;183;909;2519;951;2702
315720;202007;4259;11879;3582;10666;175;709;2549;7268;2724;7977
315725;202007;2133;5583;1619;4697;176;490;1015;3075;1191;3565
315727;202007;559;1452;422;1228;56;198;168;467;224;665
315730;202007;558;1750;490;1603;81;303;186;570;267;873
315733;202007;1139;2887;803;2310;117;407;311;851;428;1258
315737;202007;1148;3245;898;2746;27;111;647;1897;674;2008
315740;202007;824;2286;654;1944;71;247;421;1167;492;1414
315750;202007;1258;3320;983;2869;92;284;594;1768;686;2052
315760;202007;1112;2658;981;2488;39;111;828;2060;867;2171
315765;202007;1890;5020;1550;4572;25;111;1364;3998;1389;4109
315770;202007;1014;2798;773;2458;318;1116;159;416;477;1532
315780;202007;28846;78623;24094;70231;1337;4821;16739;46696;18076;51517
315790;202007;3518;10904;2979;9866;392;1361;1764;5930;2156;7291
315800;202007;1236;4318;898;3432;123;545;293;988;416;1533
315810;202007;1298;3216;1053;2793;57;194;812;2055;869;2249
315820;202007;2551;6923;2067;6214;181;637;1431;4266;1612;4903
315830;202007;1185;3513;805;2691;86;314;283;873;369;1187
315840;202007;829;2002;571;1540;45;139;276;679;321;818
315850;202007;1160;3428;906;2964;180;637;445;1371;625;2008
315860;202007;461;1324;318;1059;68;238;93;275;161;513
315870;202007;455;1194;363;1049;17;61;262;716;279;777
315880;202007;1075;2793;708;2144;100;374;166;469;266;843
315890;202007;1675;4782;1341;4314;329;1165;663;2099;992;3264
315895;202007;6165;16564;4601;13486;444;1455;2404;6543;2848;7998
315900;202007;807;2064;693;1898;58;177;523;1388;581;1565
315910;202007;500;1412;420;1283;57;191;292;871;349;1062
315920;202007;1457;3668;793;2404;123;447;250;687;373;1134
315930;202007;1086;2435;720;1913;135;343;306;835;441;1178
315935;202007;783;2361;612;2030;119;414;214;707;333;1121
315940;202007;588;1629;467;1443;52;169;246;730;298;899
315950;202007;1158;3193;951;2854;84;246;728;2183;812;2429
315960;202007;5066;14246;3253;10549;958;3515;272;551;1230;4066
315970;202007;613;1627;482;1453;61;201;314;949;375;1150
315980;202007;4284;9257;2324;6047;416;1149;856;2038;1272;3187
315990;202007;3605;9146;2795;7766;265;797;1594;4286;1859;5083
316000;202007;575;1461;428;1246;52;188;204;554;256;742
316010;202007;836;2210;617;1839;42;145;381;1050;423;1195
316020;202007;914;2795;727;2417;89;350;416;1287;505;1637
316030;202007;2704;7623;2034;6417;236;767;1285;4104;1521;4871
316040;202007;2379;6702;1734;5493;308;1105;436;1192;744;2297
316045;202007;2067;5342;1896;5135;74;145;1637;4560;1711;4705
316050;202007;361;1019;278;875;31;108;157;458;188;566
316060;202007;663;1656;480;1385;16;68;335;926;351;994
316070;202007;5207;14520;4221;12640;730;2263;1983;5779;2713;8042
316080;202007;721;2268;561;1940;142;509;80;255;222;764
316090;202007;398;1147;291;929;41;151;140;417;181;568
316095;202007;1268;3941;1004;3274;268;915;327;1037;595;1952
316100;202007;2404;7016;1727;5576;313;1109;636;1870;949;2979
316105;202007;812;2159;661;1914;36;123;453;1354;489;1477
316110;202007;13412;38983;11154;35148;806;2952;7545;23466;8351;26418
316120;202007;1190;3387;758;2364;116;378;230;588;346;966
316130;202007;1268;2868;807;2107;60;187;467;1185;527;1372
316140;202007;1194;3171;766;2378;97;331;374;1129;471;1460
316150;202007;1879;4114;1515;3620;172;529;633;1444;805;1973
316160;202007;970;2661;796;2357;40;143;546;1566;586;1709
316165;202007;847;2113;644;1785;93;305;344;888;437;1193
316170;202007;1149;2823;860;2388;53;191;597;1578;650;1769
316180;202007;1366;3855;917;2919;147;559;163;479;310;1038
316190;202007;2638;7489;1534;4870;223;736;572;1611;795;2347
316200;202007;3208;9196;2379;7729;577;1989;576;1806;1153;3795
316210;202007;4429;12992;3178;10152;1155;3988;188;502;1343;4490
316220;202007;582;1764;386;1313;94;362;41;160;135;522
316225;202007;1544;3512;1149;2874;54;200;861;2000;915;2200
316230;202007;400;1097;303;928;36;116;171;529;207;645
316240;202007;5560;16035;4862;14825;369;1208;3666;11008;4035;12216
316245;202007;2929;9546;2632;9033;121;702;2038;6669;2159;7371
316250;202007;10099;24218;7322;19815;1544;4630;2675;7102;4219;11732
316255;202007;2937;8124;2554;7504;117;362;1916;5698;2033;6060
316257;202007;1371;3327;984;2644;127;356;557;1419;684;1775
316260;202007;2092;5306;1597;4469;199;540;828;2385;1027;2925
316265;202007;1124;3007;869;2577;21;74;637;1835;658;1909
316270;202007;3630;11244;3102;10066;497;1736;1481;4577;1978;6313
316280;202007;2849;8134;2422;7326;322;1058;1356;3977;1678;5035
316290;202007;3377;9268;2685;7999;294;1028;1148;3303;1442;4331
316292;202007;4889;13021;3903;11363;489;1550;2529;7078;3018;8628
316294;202007;811;2413;601;2041;114;437;157;501;271;938
316295;202007;3105;8676;2516;7648;140;522;1770;5115;1910;5637
316300;202007;990;2809;807;2522;46;161;591;1824;637;1985
316310;202007;792;2112;510;1602;106;394;86;220;192;614
316320;202007;658;1842;509;1602;57;214;234;712;291;926
316330;202007;1083;2816;816;2340;54;190;611;1688;665;1878
316340;202007;1005;2710;748;2240;72;285;427;1202;499;1487
316350;202007;1270;3578;1048;3222;90;303;735;2229;825;2532
316360;202007;613;1631;499;1437;49;148;363;1027;412;1175
316370;202007;4873;13019;3562;10615;677;2311;1309;3457;1986;5768
316380;202007;1712;4102;1337;3565;52;117;929;2486;981;2603
316390;202007;801;2133;564;1712;227;787;95;257;322;1044
316400;202007;1164;3262;748;2426;113;400;244;731;357;1131
316410;202007;1101;3072;917;2801;56;185;725;2165;781;2350
316420;202007;1928;5267;1670;4926;47;183;1377;3982;1424;4165
316430;202007;834;2209;526;1658;93;323;164;483;257;806
316440;202007;825;2499;648;2176;111;430;162;489;273;919
316443;202007;532;1467;388;1194;99;358;82;229;181;587
316447;202007;1947;5214;1702;4805;28;108;1462;4047;1490;4155
316450;202007;2103;6426;1596;5366;212;780;953;3110;1165;3890
316460;202007;1180;2982;946;2601;131;402;594;1533;725;1935
316470;202007;6750;19311;4778;15116;782;2829;1837;5304;2619;8133
316480;202007;200;548;166;499;45;132;76;224;121;356
316490;202007;325;865;229;694;38;118;83;213;121;331
316500;202007;1156;3596;762;2644;162;619;170;559;332;1178
316510;202007;736;2403;588;2114;110;414;283;1019;393;1433
316520;202007;1213;2992;930;2535;117;401;478;1180;595;1581
316530;202007;1089;2834;787;2294;84;330;406;1038;490;1368
316540;202007;818;2126;633;1842;107;356;302;798;409;1154
316550;202007;1350;3935;1152;3550;53;189;895;2738;948;2927
316553;202007;4203;12473;2942;9350;462;1628;1065;2995;1527;4623
316555;202007;2467;7899;2234;7573;112;408;1844;6299;1956;6707
316556;202007;535;1306;386;1049;29;78;215;530;244;608
316557;202007;1020;3182;872;2929;289;1054;284;926;573;1980
316560;202007;329;910;225;753;50;214;70;197;120;411
316570;202007;1211;3510;992;3103;239;759;353;1137;592;1896
316580;202007;383;810;220;542;36;107;110;255;146;362
316590;202007;1321;3414;928;2644;186;463;458;1283;644;1746
316600;202007;925;2857;786;2575;125;444;420;1347;545;1791
316610;202007;600;1866;487;1683;55;241;288;969;343;1210
316620;202007;2004;5382;1753;5027;91;286;1371;3920;1462;4206
316630;202007;1535;4625;1248;4075;323;1068;500;1762;823;2830
316640;202007;140;367;109;320;16;53;51;124;67;177
316650;202007;1019;3241;814;2916;76;288;504;1840;580;2128
316660;202007;180;452;77;238;6;22;13;36;19;58
316670;202007;1779;4513;1301;3728;305;951;480;1343;785;2294
316680;202007;2272;5751;1666;4605;97;299;1267;3399;1364;3698
316690;202007;1378;3905;1031;3269;180;623;465;1434;645;2057
316695;202007;1012;2941;827;2605;31;128;566;1750;597;1878
316700;202007;401;937;331;848;16;53;257;624;273;677
316710;202007;3001;9834;2292;8337;468;1825;887;3210;1355;5035
316720;202007;19953;54605;14489;44060;2566;8308;6102;17646;8668;25954
316730;202007;425;1155;340;991;44;150;172;473;216;623
316740;202007;735;2151;636;1989;71;250;396;1248;467;1498
316750;202007;385;1161;296;990;61;236;136;423;197;659
316760;202007;3489;11115;2841;9808;1132;4240;613;1992;1745;6232
316770;202007;1597;3672;1222;3144;25;75;995;2631;1020;2706
316780;202007;557;1661;426;1396;163;597;67;185;230;782
316790;202007;690;1864;487;1458;99;324;143;383;242;707
316800;202007;6128;17286;4883;14996;503;1761;2521;7479;3024;9240
316805;202007;1000;2221;806;2009;57;160;621;1561;678;1721
316810;202007;621;1728;419;1309;79;287;215;626;294;913
316820;202007;304;727;170;487;10;32;81;217;91;249
316830;202007;731;1973;578;1728;72;245;357;1034;429;1279
316840;202007;2717;7054;2164;6112;190;670;1487;3991;1677;4661
316850;202007;1902;5001;1354;3988;218;689;589;1672;807;2361
316860;202007;18874;48602;13830;41026;2233;7698;6286;18169;8519;25867
316870;202007;7770;21190;5746;17262;864;2864;2577;7211;3441;10075
316880;202007;825;2242;667;2022;133;454;315;902;448;1356
316890;202007;1137;2520;662;1874;96;345;393;1011;489;1356
316900;202007;2272;6120;1737;5031;346;1085;547;1470;893;2555
316905;202007;520;1550;420;1353;108;377;165;540;273;917
316910;202007;888;2333;535;1699;134;469;44;130;178;599
316920;202007;1737;4273;1196;3451;229;723;532;1478;761;2201
316930;202007;7429;21476;5426;17780;1219;4269;1436;4473;2655;8742
316935;202007;3973;10773;2864;8683;517;1695;1140;3311;1657;5006
316940;202007;6359;18711;4837;15513;741;2653;1894;5594;2635;8247
316950;202007;1845;4349;1435;3788;43;137;1189;3093;1232;3230
316960;202007;5020;11334;3596;9366;346;995;2424;6160;2770;7155
316970;202007;3646;10422;3165;9509;492;1551;1346;3867;1838;5418
316980;202007;665;1994;502;1676;163;614;60;210;223;824
316990;202007;11400;30626;8159;23993;2115;6767;1256;3297;3371;10064
317000;202007;2519;7429;2211;6977;171;499;1628;5183;1799;5682
317005;202007;2551;7261;2012;6148;326;1056;1053;3154;1379;4210
317010;202007;24157;56650;14778;42216;2976;9381;5552;16322;8528;25703
317020;202007;63217;149969;35980;102391;6543;20483;11051;29031;17594;49514
317030;202007;697;1853;539;1638;17;80;411;1227;428;1307
317040;202007;11020;27848;7630;21959;1677;5228;2711;7999;4388;13227
317043;202007;848;1903;600;1558;52;136;434;1118;486;1254
317047;202007;1177;2827;812;2238;88;247;506;1341;594;1588
317050;202007;1160;3560;806;2735;108;384;339;1018;447;1402
317052;202007;2366;6608;1905;5855;278;848;1167;3607;1445;4455
317057;202007;1794;4351;1303;3543;34;133;838;2259;872;2392
317060;202007;497;1320;311;939;38;119;131;350;169;469
317065;202007;1160;3398;944;2977;57;193;585;1735;642;1928
317070;202007;7452;20464;5196;16115;973;3405;1508;4416;2481;7821
317075;202007;912;2361;653;1911;105;340;296;793;401;1133
317080;202007;5987;14079;4397;11527;1187;3358;1428;3591;2615;6949
317090;202007;4575;13509;4058;12660;305;920;2994;9397;3299;10317
317100;202007;2671;6348;1691;4708;387;1120;614;1673;1001;2793
317103;202007;2153;5811;1828;5302;83;385;1404;3881;1487;4266
317107;202007;1420;3779;1079;3118;77;270;655;1688;732;1958
317110;202007;711;1643;358;1093;54;192;120;382;174;574
317115;202007;1082;3092;917;2784;53;143;621;1892;674;2035
317120;202007;13841;37488;10990;32831;1121;3952;6576;18860;7697;22812
317130;202007;11055;25681;6932;18875;1118;3408;2316;6250;3434;9658
317140;202007;838;2026;641;1732;38;106;445;1237;483;1343
317150;202007;995;2359;743;2044;32;95;583;1579;615;1674
317160;202007;3532;8556;2298;6569;175;544;1269;3702;1444;4246
317170;202007;1817;4501;1309;3641;213;704;540;1296;753;2000
317180;202007;1959;6106;1438;4849;282;1009;366;1154;648;2163
317190;202007;1204;3242;889;2749;106;343;516;1578;622;1921
317200;202007;5167;13496;3924;11347;1028;3204;832;2212;1860;5416
317210;202007;1161;2849;901;2488;27;106;666;1866;693;1972
317220;202007;245;758;207;685;49;165;78;274;127;439
320010;202007;4456;12968;3554;11166;356;1240;2300;7046;2656;8286
320013;202007;1926;5264;1289;3990;211;671;565;1818;776;2489
320016;202007;2990;7654;2326;6637;172;461;1760;5045;1932;5506
320020;202007;3920;10182;2859;8338;628;2027;1003;3038;1631;5065
320030;202007;1735;4825;1117;3578;209;730;395;1210;604;1940
320035;202007;1874;5167;1519;4535;376;1250;646;1872;1022;3122
320040;202007;3957;11254;3251;9946;465;1507;1811;5372;2276;6879
320050;202007;1746;3967;1497;3606;185;536;893;2061;1078;2597
320060;202007;12242;33808;9128;27696;1406;4711;4326;12430;5732;17141
320070;202007;1492;4207;1036;3261;187;657;371;1114;558;1771
320080;202007;5631;14456;3931;11099;811;2426;1426;3800;2237;6226
320090;202007;8414;22381;5516;16363;1220;3886;1979;5478;3199;9364
320100;202007;2928;8069;2374;7087;401;1340;1231;3657;1632;4997
320110;202007;2048;4783;1356;3654;197;553;645;1670;842;2223
320115;202007;1783;5745;1515;5294;642;2364;417;1508;1059;3872
320120;202007;22749;58210;15606;45292;2278;7167;7105;19603;9383;26770
320130;202007;44373;123849;36212;108974;4798;15941;21023;61475;25821;77416
320140;202007;3567;9742;2346;7337;348;1253;933;2887;1281;4140
320150;202007;13277;34407;9312;26714;2362;7453;1608;4136;3970;11589
320160;202007;5852;16390;4271;13296;701;2392;1960;5981;2661;8373
320170;202007;1599;4606;1152;3707;307;976;436;1475;743;2451
320180;202007;687;2180;552;1913;213;782;144;463;357;1245
320190;202007;2741;8770;2094;7326;509;1897;547;1813;1056;3710
320200;202007;1259;3392;852;2641;188;637;317;979;505;1616
320210;202007;4334;11069;3312;9287;531;1621;1758;4718;2289;6339
320220;202007;2730;7235;2047;6099;363;1172;1015;2871;1378;4043
320225;202007;1346;4185;943;3220;338;1248;193;646;531;1894
320230;202007;4929;13619;3734;11600;829;2829;1458;4360;2287;7189
320240;202007;15794;40286;11657;33561;2789;8765;3873;10858;6662;19623
320245;202007;3035;9008;2396;7704;886;3000;455;1433;1341;4433
320250;202007;2231;6295;1492;4531;329;1119;441;1175;770;2294
320255;202007;1792;5640;1540;5184;421;1447;740;2598;1161;4045
320260;202007;1413;3964;835;2669;177;626;200;543;377;1169
320265;202007;2482;7645;2006;6665;926;3272;343;1141;1269;4413
320270;202007;2189;6304;1651;5248;404;1380;626;2007;1030;3387
320280;202007;6949;18580;5579;16213;1231;3849;2508;7017;3739;10866
320290;202007;1350;4018;869;2833;227;810;231;701;458;1511
320300;202007;3565;10838;2825;9306;815;2897;657;2019;1472;4916
320305;202007;5077;14431;3916;12113;746;2507;1893;5662;2639;8169
320310;202007;2084;5788;1416;4359;254;818;622;1840;876;2658
320313;202007;2417;6075;1545;4409;312;1019;402;1045;714;2064
320316;202007;1458;4112;1178;3636;184;581;715;2219;899;2800
320320;202007;21806;57281;15299;45907;3558;11181;5566;16781;9124;27962
320330;202007;2926;7972;2256;6757;428;1279;1176;3597;1604;4876
320332;202007;6814;18572;5377;16012;1303;4176;2404;7098;3707;11274
320334;202007;1731;4936;1198;3833;261;992;286;718;547;1710
320335;202007;1386;4111;962;3118;235;854;242;717;477;1571
320340;202007;4722;11864;3907;10663;501;1503;2283;6278;2784;7781
320350;202007;5375;13334;3766;10405;466;1383;1988;5216;2454;6599
320360;202007;1426;3609;1046;2892;120;337;528;1395;648;1732
320370;202007;2592;7955;1893;6421;574;2044;600;2009;1174;4053
320380;202007;2490;6713;2062;6009;241;755;1303;3690;1544;4445
320390;202007;6995;19003;5130;15250;1075;3401;2062;5771;3137;9172
320400;202007;3265;9242;2464;7539;694;2259;867;2534;1561;4793
320405;202007;4600;12175;3439;10182;551;1768;1603;4643;2154;6411
320410;202007;4819;12499;3607;10516;642;1832;1793;5450;2435;7282
320420;202007;3171;8341;2386;6977;690;2263;424;1242;1114;3505
320425;202007;2083;5011;1575;4154;100;294;1036;2648;1136;2942
320430;202007;3034;7585;2366;6369;304;908;1519;3924;1823;4832
320435;202007;2159;6734;1702;5825;606;2194;514;1780;1120;3974
320440;202007;1458;4007;1057;3234;156;504;474;1399;630;1903
320450;202007;1609;4663;1249;3978;276;992;552;1642;828;2634
320455;202007;4164;12582;2784;9318;706;2537;669;2020;1375;4557
320460;202007;2103;6201;1472;4847;359;1253;380;1167;739;2420
320465;202007;1212;3438;915;2865;129;417;507;1594;636;2011
320470;202007;3721;10235;2595;7840;588;1881;629;1694;1217;3575
320480;202007;1674;4618;1355;4079;189;653;800;2334;989;2987
320490;202007;21112;55452;15471;45448;2647;8495;6364;18505;9011;27000
320495;202007;1282;3515;881;2731;193;683;327;966;520;1649
320500;202007;52019;138526;41271;119862;5754;18141;23810;66282;29564;84423
320501;202007;4392;12727;3234;10607;902;3302;1068;3444;1970;6746
320503;202007;2393;6820;1531;5023;409;1474;445;1381;854;2855
320506;202007;2609;7728;1868;6096;550;1945;184;596;734;2541
320510;202007;10010;27142;8060;23737;900;3057;4994;14221;5894;17278
320515;202007;1755;4790;1343;3957;366;1173;460;1306;826;2479
320517;202007;2155;6492;1702;5502;539;1910;498;1580;1037;3490
320520;202007;35526;92169;26239;76428;4629;14848;11048;31148;15677;45996
320530;202007;31320;83115;24478;70921;2321;7933;15376;42151;17697;50084
330010;202007;21632;57960;17569;51088;2409;7537;11147;31667;13556;39204
330015;202007;1482;3650;1144;3128;201;619;616;1598;817;2217
330020;202007;19997;49828;16720;45053;2387;7223;11513;30275;13900;37498
330022;202007;1880;5038;1439;4269;243;743;835;2457;1078;3200
330023;202007;5003;11866;3550;9818;587;1799;1970;5312;2557;7111
330025;202007;6704;15615;3886;10824;896;2766;822;2183;1718;4949
330030;202007;10202;27318;7668;23107;834;2903;4669;13449;5503;16352
330040;202007;14552;37905;11445;32588;1095;3518;7637;20866;8732;24384
330045;202007;84486;199250;69009;179617;5230;13561;54604;141549;59834;155110
330050;202007;2453;6533;1782;5387;359;1172;847;2436;1206;3608
330060;202007;5147;13551;3987;11452;777;2483;1667;4411;2444;6894
330070;202007;22602;57204;18041;50483;2855;8498;10589;29422;13444;37920
330080;202007;8812;22254;7468;20336;931;2697;5162;13878;6093;16575
330090;202007;3519;7338;2386;5759;161;412;1628;3929;1789;4341
330093;202007;2695;6468;2002;5480;123;369;1520;4131;1643;4500
330095;202007;1263;3557;962;2981;77;287;593;1708;670;1995
330100;202007;70100;185976;59396;169990;3624;12382;45293;127698;48917;140080
330110;202007;2065;5785;1646;5066;273;925;915;2710;1188;3635
330115;202007;2564;6177;1788;4957;244;776;1010;2689;1254;3465
330120;202007;3533;7911;2614;6716;223;644;1808;4468;2031;5112
330130;202007;4259;11617;3454;10380;480;1510;2147;6411;2627;7921
330140;202007;3743;9724;2939;8552;421;1371;1865;5299;2286;6670
330150;202007;2153;5745;1625;4900;285;912;799;2352;1084;3264
330160;202007;1370;3713;1014;3080;175;578;537;1557;712;2135
330170;202007;106996;265853;85047;235969;11456;31553;56670;159322;68126;190875
330180;202007;1973;4759;1507;4100;98;303;1038;2750;1136;3053
330185;202007;9582;24151;7957;21872;494;1661;6330;16971;6824;18632
330187;202007;4280;10881;3294;9268;467;1422;1908;5328;2375;6750
330190;202007;33157;80358;27831;72990;1932;5503;21988;56972;23920;62475
330200;202007;15850;40228;12766;36399;2503;6801;7947;23348;10450;30149
330205;202007;2110;5182;1580;4322;94;311;1091;2861;1185;3172
330210;202007;3438;8614;2476;6920;359;1095;1202;3115;1561;4210
330220;202007;11895;29535;8235;23352;1711;5433;2881;7561;4592;12994
330225;202007;3926;9840;2938;8313;196;674;2116;5838;2312;6512
330227;202007;17433;41883;14510;38306;586;1724;12398;32364;12984;34088
330230;202007;1996;4453;1328;3592;117;338;799;2154;916;2492
330240;202007;23754;61696;19320;54696;2414;7479;12645;34947;15059;42426
330245;202007;1702;4181;993;2917;202;606;380;1102;582;1708
330250;202007;37829;96768;31116;86821;5465;15627;18823;52480;24288;68107
330260;202007;4758;11577;3543;9915;352;1109;2462;6680;2814;7789
330270;202007;29025;63996;17729;46136;2908;8111;7237;18198;10145;26309
330280;202007;2348;6179;1749;5145;190;616;1026;2911;1216;3527
330285;202007;23740;56840;18603;49434;1475;4589;13590;34876;15065;39465
330290;202007;3778;9176;3008;8153;328;988;2110;5545;2438;6533
330300;202007;5792;13617;4159;11242;312;958;2891;7667;3203;8625
330310;202007;2685;6601;1883;5251;124;310;1242;3468;1366;3778
330320;202007;16517;39042;12468;33975;1417;3836;8967;24552;10384;28388
330330;202007;37747;82732;28763;70643;2594;7040;20600;49606;23194;56646
330340;202007;15152;37058;10920;30368;1715;5347;5588;14751;7303;20098
330350;202007;136978;316806;111771;285927;7216;19246;91210;232110;98426;251356
330360;202007;7473;18071;6388;16741;209;559;5411;14113;5620;14672
330370;202007;4903;13991;3715;11952;866;2846;1533;5145;2399;7991
330380;202007;5392;14449;4019;11972;704;2419;1979;5610;2683;8029
330385;202007;3918;11274;3166;10159;751;2668;1512;4797;2263;7465
330390;202007;26040;70302;19562;58963;2765;9559;11166;31778;13931;41337
330395;202007;3167;7842;2592;7086;159;503;1870;5004;2029;5507
330400;202007;3368;8840;2846;8019;156;552;2138;5671;2294;6223
330410;202007;3234;8627;2270;6914;431;1444;1005;2908;1436;4352
330411;202007;2781;7496;2131;6264;143;498;1485;4197;1628;4695
330412;202007;1511;4276;1212;3785;131;483;750;2198;881;2681
330414;202007;23648;59346;18975;52948;1571;4572;13976;38625;15547;43197
330415;202007;4182;11357;3216;9677;324;1042;1917;5725;2241;6767
330420;202007;11419;28171;7888;22438;954;3082;4097;10869;5051;13951
330430;202007;9550;22938;7936;20696;323;1067;6218;15723;6541;16790
330440;202007;2499;6713;1859;5616;304;1070;1045;3015;1349;4085
330450;202007;1330;3773;1056;3313;137;476;587;1802;724;2278
330452;202007;17072;43281;13560;37871;1711;5404;8652;23351;10363;28755
330455;202007;555353;1311907;422177;1119651;59739;168995;267007;696599;326746;865594
330460;202007;1185;3226;872;2758;153;517;471;1454;624;1971
330470;202007;4800;12001;3424;9850;1094;3243;1014;3012;2108;6255
330475;202007;9521;24641;7647;22188;1190;3966;4888;13869;6078;17835
330480;202007;5904;15283;4931;13855;406;1272;3415;9328;3821;10600
330490;202007;112511;257865;90376;228103;9986;26338;64598;161478;74584;187816
330500;202007;7377;18155;6115;16416;616;1850;4427;11710;5043;13560
330510;202007;40128;99246;29390;83939;4898;15000;17751;50012;22649;65012
330513;202007;1233;3171;965;2793;209;647;471;1376;680;2023
330515;202007;2465;6492;1945;5752;367;1172;1073;3099;1440;4271
330520;202007;11266;29695;9059;26195;1195;3816;5536;15616;6731;19432
330530;202007;1691;4083;1235;3383;253;754;562;1510;815;2264
330540;202007;2877;7623;2202;6450;507;1546;944;2675;1451;4221
330550;202007;8995;23305;6807;20396;1913;6238;2743;8121;4656;14359
330555;202007;17930;37833;14785;34126;849;2188;11930;27759;12779;29947
330560;202007;4139;11074;3309;9671;505;1513;1965;5608;2470;7121
330570;202007;2720;7465;2271;6768;352;1130;1459;4305;1811;5435
330575;202007;5466;14108;4678;12756;283;883;3743;9874;4026;10757
330580;202007;17202;45957;13151;38566;2393;7627;6276;17592;8669;25219
330590;202007;1450;3921;1191;3587;220;659;736;2256;956;2915
330600;202007;11735;30853;9477;27192;899;3015;6038;16824;6937;19839
330610;202007;9227;24567;7369;21620;576;1991;5131;14655;5707;16646
330615;202007;2092;5692;1610;5022;305;965;986;3151;1291;4116
330620;202007;4003;11426;3122;9882;699;2396;1316;3912;2015;6308
330630;202007;24228;60671;18866;52249;1379;4510;13403;35884;14782;40394
350010;202007;2044;5235;1019;3051;219;710;179;389;398;1099
350020;202007;692;1771;387;1186;50;162;153;428;203;590
350030;202007;3560;9932;2600;8237;651;2256;1057;3179;1708;5435
350040;202007;719;2053;405;1371;54;212;135;354;189;566
350050;202007;1264;3132;806;2327;185;622;268;625;453;1247
350055;202007;909;2380;695;2035;77;245;402;1112;479;1357
350060;202007;169;437;102;301;13;45;51;153;64;198
350070;202007;3396;8957;2113;6609;426;1489;641;1807;1067;3296
350075;202007;577;1701;429;1402;173;598;39;135;212;733
350080;202007;658;1701;417;1266;59;202;170;461;229;663
350090;202007;585;1385;351;973;71;212;149;384;220;596
350100;202007;2312;6112;1577;4797;126;471;964;2756;1090;3227
350110;202007;481;1220;326;943;17;59;187;533;204;592
350115;202007;1273;3695;1038;3196;183;624;536;1501;719;2125
350120;202007;664;1541;362;974;36;114;190;445;226;559
350130;202007;3060;8068;2375;6806;414;1219;1172;3198;1586;4417
350140;202007;764;2156;497;1614;49;219;270;803;319;1022
350150;202007;511;1563;416;1375;93;300;119;363;212;663
350160;202007;10903;27242;7195;20492;924;2995;4311;11596;5235;14591
350170;202007;2143;6162;1689;5155;323;1051;729;2058;1052;3109
350180;202007;1027;2546;513;1543;115;358;74;199;189;557
350190;202007;2837;8030;1929;6084;361;1304;793;2128;1154;3432
350200;202007;442;1251;343;1066;18;62;221;647;239;709
350210;202007;5768;13167;3859;10260;503;1437;2362;6059;2865;7496
350220;202007;2850;7824;1896;5919;413;1361;618;1754;1031;3115
350230;202007;1023;2627;835;2350;156;471;464;1261;620;1732
350240;202007;647;1874;411;1319;87;282;102;305;189;587
350250;202007;2339;6712;1739;5703;603;2176;343;1129;946;3305
350260;202007;821;1940;519;1416;57;176;315;823;372;999
350270;202007;4449;11986;3506;10168;539;1706;1846;4996;2385;6702
350275;202007;2357;6313;1831;5472;300;999;1054;2998;1354;3997
350280;202007;18873;42265;11002;29481;1858;5265;4267;10925;6125;16190
350290;202007;3172;8746;2114;6548;382;1299;843;2427;1225;3726
350300;202007;638;1731;467;1402;69;210;239;674;308;884
350310;202007;880;2541;638;2044;107;388;242;703;349;1091
350315;202007;576;1439;376;1100;23;78;192;522;215;600
350320;202007;14924;38234;10808;30912;2316;7320;4007;10616;6323;17936
350330;202007;14005;34525;9813;26382;1059;3154;6142;15480;7201;18634
350335;202007;363;1028;280;874;35;125;134;393;169;518
350340;202007;1155;2962;686;2093;118;405;269;738;387;1143
350350;202007;738;1875;562;1677;69;247;332;972;401;1219
350360;202007;1086;3210;825;2661;219;720;252;828;471;1548
350370;202007;619;1542;419;1182;151;407;121;352;272;759
350380;202007;4354;11895;3038;9228;865;2605;754;2342;1619;4947
350390;202007;10373;27490;8049;23492;1754;5313;3573;10136;5327;15449
350395;202007;431;1105;222;698;21;63;80;225;101;288
350400;202007;7942;19538;5445;15417;1343;4108;1502;4183;2845;8291
350410;202007;9634;26815;6898;21477;1466;5119;2605;7460;4071;12579
350420;202007;711;1912;493;1437;80;262;118;295;198;557
350430;202007;652;1761;524;1550;68;238;321;871;389;1109
350440;202007;2013;5057;1621;4459;129;372;1058;2854;1187;3226
350450;202007;6615;18139;5090;15471;1121;3717;2100;5986;3221;9703
350460;202007;1723;4455;877;2715;157;515;201;551;358;1066
350470;202007;253;638;194;538;10;31;135;361;145;392
350480;202007;986;2457;622;1814;124;439;142;322;266;761
350490;202007;1926;5050;1365;4128;313;971;409;1138;722;2109
350500;202007;684;1816;516;1503;68;211;256;704;324;915
350510;202007;1165;3034;863;2484;94;304;505;1397;599;1701
350520;202007;2111;6440;1614;5449;267;1003;713;2175;980;3178
350530;202007;2723;6817;1985;5441;223;685;1173;3014;1396;3699
350535;202007;1405;3829;1208;3556;170;571;752;2138;922;2709
350540;202007;1904;4568;1399;3814;174;486;866;2290;1040;2776
350550;202007;8320;20524;5715;16207;626;2108;3325;8774;3951;10882
350560;202007;3908;10987;3077;9482;302;998;1899;5653;2201;6651
350570;202007;24145;67339;19264;57796;3638;11959;9673;27805;13311;39764
350580;202007;2088;5646;1205;3750;310;1052;215;553;525;1605
350590;202007;4924;13354;3566;10314;489;1594;2076;5548;2565;7142
350600;202007;35776;82496;21850;58155;3232;9689;10284;25169;13516;34858
350610;202007;6729;18447;4792;14547;844;2792;2214;6359;3058;9151
350620;202007;410;1045;259;814;28;90;148;449;176;539
350630;202007;1437;3743;1044;3034;74;280;675;1826;749;2106
350635;202007;8935;22091;6693;18615;1099;3378;3820;10075;4919;13453
350640;202007;920;2463;477;1492;74;238;135;369;209;607
350650;202007;8234;21969;5557;16633;1086;3506;2028;5632;3114;9138
350660;202007;4541;11913;3465;10117;581;1713;1784;5215;2365;6928
350670;202007;1834;4870;1493;4370;156;472;1002;2932;1158;3404
350680;202007;1111;2994;730;2286;138;442;288;856;426;1298
350690;202007;1262;3256;876;2603;148;476;470;1348;618;1824
350700;202007;4737;11980;3287;9714;610;2061;1425;3963;2035;6024
350710;202007;2801;7688;2355;6895;405;1375;1285;3467;1690;4842
350715;202007;813;2335;664;2063;71;290;358;1014;429;1304
350720;202007;154;405;113;333;17;49;37;88;54;137
350730;202007;614;1640;514;1465;29;110;383;1025;412;1135
350740;202007;1620;4324;1093;3246;207;659;353;960;560;1619
350745;202007;591;1494;319;967;40;150;122;332;162;482
350750;202007;9747;25319;7320;21105;1299;4337;3297;8489;4596;12826
350760;202007;14513;36145;10349;28921;2225;6856;4169;10488;6394;17344
350770;202007;960;2404;595;1758;39;125;380;1101;419;1226
350775;202007;664;1564;449;1238;44;127;218;599;262;726
350780;202007;2099;5172;1476;4261;256;838;534;1757;790;2595
350790;202007;1653;4385;1010;3203;204;700;285;733;489;1433
350800;202007;3443;9885;2938;8988;248;867;2030;6020;2278;6887
350810;202007;2725;6682;2121;5807;316;832;1176;3284;1492;4116
350820;202007;924;2170;516;1428;53;178;255;634;308;812
350830;202007;860;2400;476;1532;76;240;141;395;217;635
350840;202007;3223;9416;2377;7791;542;1942;1031;3092;1573;5034
350850;202007;6983;19401;5369;16488;1096;3651;2455;7191;3551;10842
350860;202007;3548;9516;3025;8802;118;430;2296;6606;2414;7036
350870;202007;2585;7269;1877;6115;260;952;1031;3273;1291;4225
350880;202007;1274;3638;990;3076;254;815;282;843;536;1658
350890;202007;529;1362;330;949;50;150;124;330;174;480
350900;202007;7061;19143;4407;13462;1008;3390;1398;3904;2406;7294
350910;202007;895;2205;762;1999;95;260;543;1402;638;1662
350920;202007;11668;29005;9743;25843;439;1427;7854;20063;8293;21490
350925;202007;4304;11731;3039;9409;587;1965;1418;4054;2005;6019
350930;202007;1499;3913;1023;2968;90;270;630;1785;720;2055
350940;202007;2238;5913;1706;5040;182;595;1072;3051;1254;3646
350945;202007;834;2338;617;1915;94;341;326;927;420;1268
350950;202007;85574;220549;64974;181645;8678;26720;39291;104730;47969;131450
350960;202007;6362;17250;4901;14490;592;2013;2918;8176;3510;10189
350970;202007;3581;10063;2558;8087;757;2672;514;1389;1271;4061
350980;202007;641;1769;515;1543;134;424;231;687;365;1111
350990;202007;1744;4871;1269;4082;312;1119;439;1321;751;2440
350995;202007;773;2408;690;2237;53;208;484;1494;537;1702
351000;202007;2807;7281;1949;5756;345;1076;728;2095;1073;3171
351010;202007;330;818;217;621;28;96;115;316;143;412
351015;202007;808;2439;642;2082;101;360;297;863;398;1223
351020;202007;8775;23839;6652;20176;1385;4289;3184;9425;4569;13714
351030;202007;2784;8275;2219;7124;318;1121;1188;3726;1506;4847
351040;202007;4947;12257;4112;10995;212;688;3355;8726;3567;9414
351050;202007;17055;41572;11999;33587;2437;7220;5136;14203;7573;21423
351060;202007;48686;122480;36800;101889;3841;11714;24540;65684;28381;77398
351070;202007;1428;3534;761;2354;185;625;131;392;316;1017
351080;202007;2775;6702;1965;5731;216;752;1300;3609;1516;4361
351090;202007;319;943;228;768;50;170;63;210;113;380
351100;202007;2631;7104;1674;5159;377;1210;473;1519;850;2729
351110;202007;6218;15853;3973;11681;660;2139;1688;4646;2348;6785
351120;202007;780;1968;515;1526;60;187;198;570;258;757
351130;202007;1189;3095;537;1695;101;320;135;406;236;726
351140;202007;2072;5906;1529;4820;315;1112;624;1765;939;2877
351150;202007;2514;7232;1664;5334;276;979;651;1861;927;2840
351160;202007;1128;3501;837;2809;180;645;215;619;395;1264
351170;202007;1364;3730;1172;3381;93;286;831;2323;924;2609
351190;202007;1005;2790;650;2050;118;378;231;672;349;1050
351200;202007;1612;3858;1184;3213;96;298;831;2119;927;2417
351210;202007;1537;3798;940;2650;78;261;555;1449;633;1710
351220;202007;3242;9184;2748;8359;312;990;1812;5459;2124;6449
351230;202007;1753;4763;1275;3911;227;797;567;1587;794;2384
351240;202007;2414;6162;1451;4135;311;952;543;1378;854;2330
351250;202007;1056;2814;613;1915;82;276;222;676;304;952
351260;202007;917;2314;655;1834;130;368;249;660;379;1028
351270;202007;445;1188;369;1058;37;131;227;565;264;696
351280;202007;3818;10040;2877;8261;535;1567;1353;3759;1888;5326
351290;202007;1235;3032;840;2351;117;353;493;1325;610;1678
351300;202007;17509;47665;11803;36500;2130;7138;5007;14866;7137;22004
351310;202007;3379;8249;2527;6925;182;634;1839;4763;2021;5397
351320;202007;950;2737;699;2197;134;455;247;690;381;1145
351330;202007;489;1158;402;998;24;71;288;645;312;716
351340;202007;6308;17973;5010;15669;1209;3957;2197;6832;3406;10789
351350;202007;11422;28563;9356;25293;1005;2918;6802;17890;7807;20808
351360;202007;3796;10151;3101;9096;749;2356;1209;3274;1958;5630
351370;202007;2047;5710;1352;4250;322;1090;428;1232;750;2322
351380;202007;47716;115553;33305;90175;4335;12633;18855;48753;23190;61386
351385;202007;337;896;156;484;29;88;43;123;72;211
351390;202007;1382;3384;829;2563;124;452;466;1354;590;1806
351400;202007;916;2573;752;2232;124;373;456;1320;580;1693
351410;202007;2596;7246;1827;5731;326;1052;708;2175;1034;3227
351420;202007;413;972;227;643;28;74;134;351;162;425
351430;202007;938;2541;717;2170;56;171;495;1455;551;1626
351440;202007;3404;8925;2193;6425;401;1223;611;1538;1012;2761
351450;202007;1684;4472;1079;3325;220;742;164;382;384;1124
351460;202007;812;2126;621;1812;152;440;331;956;483;1396
351470;202007;1201;3039;919;2566;85;293;596;1559;681;1852
351480;202007;2462;7268;1925;6303;367;1325;812;2485;1179;3810
351490;202007;1978;5564;1671;5010;73;293;1345;3883;1418;4176
351492;202007;349;942;285;806;8;24;213;587;221;611
351495;202007;185;481;134;378;17;43;71;200;88;243
351500;202007;36657;90511;27042;74156;4126;12155;15816;41495;19942;53650
351510;202007;12893;32129;9266;25770;1146;3639;5738;15193;6884;18832
351512;202007;474;1285;333;976;58;169;117;314;175;483
351515;202007;3186;7105;1940;5147;339;1014;560;1577;899;2591
351518;202007;2381;6006;1504;4417;204;674;828;2202;1032;2876
351519;202007;713;1968;432;1408;88;282;64;199;152;481
351520;202007;1257;3100;515;1561;55;190;215;568;270;758
351530;202007;352;928;206;613;29;89;81;188;110;277
351535;202007;1876;4563;1324;3621;202;610;698;1790;900;2400
351540;202007;2386;5941;1582;4542;309;1031;554;1401;863;2432
351550;202007;6967;17242;4586;12879;463;1497;2605;6804;3068;8301
351560;202007;448;1284;342;1070;83;289;103;295;186;584
351565;202007;214;603;170;524;41;144;44;114;85;258
351570;202007;20719;55705;15565;45101;1654;5212;9643;26714;11297;31926
351580;202007;246;636;134;411;13;42;58;185;71;227
351590;202007;508;1146;269;732;21;74;153;376;174;450
351600;202007;1330;3515;1016;2931;91;281;620;1692;711;1973
351610;202007;757;1776;471;1277;26;75;270;689;296;764
351620;202007;22757;60125;16323;48931;2687;9114;7352;19900;10039;29014
351630;202007;27452;72162;21857;62388;3190;9612;13479;37267;16669;46879
351640;202007;16828;44584;12947;37379;1268;4203;8729;24181;9997;28384
351650;202007;371;983;167;543;20;70;48;133;68;203
351660;202007;743;2097;460;1450;87;293;67;166;154;459
351670;202007;5928;15883;3792;11219;814;2408;1620;4513;2434;6921
351680;202007;433;1232;272;873;45;143;66;174;111;317
351685;202007;423;1207;337;1067;92;293;104;307;196;600
351690;202007;1084;2734;604;1776;84;275;254;671;338;946
351700;202007;1364;3387;967;2686;163;467;526;1380;689;1847
351710;202007;740;1998;521;1572;51;175;273;739;324;914
351720;202007;1397;3629;909;2766;143;467;366;1055;509;1522
351730;202007;932;2437;768;2181;58;207;498;1339;556;1546
351740;202007;3516;8823;2719;7291;487;1411;1341;3321;1828;4732
351750;202007;1338;3509;815;2570;153;497;307;946;460;1443
351760;202007;3291;9302;2378;7444;484;1732;865;2429;1349;4161
351770;202007;1734;5158;1404;4507;268;914;726;2268;994;3182
351780;202007;1251;3160;730;2173;107;369;255;713;362;1082
351790;202007;1343;3191;1043;2792;165;451;614;1654;779;2105
351800;202007;520;1205;247;690;22;62;92;224;114;286
351810;202007;1031;2695;830;2383;38;114;605;1657;643;1771
351820;202007;2564;7151;1762;5591;454;1574;399;1158;853;2732
351830;202007;4477;12025;3407;10167;321;1153;2127;6022;2448;7175
351840;202007;8489;23484;6283;19347;912;3131;3247;9345;4159;12476
351850;202007;1567;4228;1010;3144;168;601;344;916;512;1517
351860;202007;2747;7926;2098;6706;361;1231;1124;3635;1485;4866
351870;202007;23607;60217;17488;50061;4540;13406;7062;20521;11602;33927
351880;202007;127698;329989;94362;272071;21837;69386;42118;115433;63955;184819
351885;202007;894;2405;699;2073;67;246;456;1283;523;1529
351890;202007;816;2117;513;1600;115;380;87;221;202;601
351900;202007;1089;2907;841;2536;120;359;475;1427;595;1786
351905;202007;428;1166;300;917;25;86;139;370;164;456
351907;202007;20922;54815;16015;45992;1887;5983;10230;28287;12117;34270
351910;202007;1522;3989;1050;2958;71;220;604;1536;675;1756
351920;202007;854;2263;644;1856;101;337;285;748;386;1085
351925;202007;892;2365;690;1988;89;295;371;986;460;1281
351930;202007;3191;8945;2852;8321;583;1704;1894;5460;2477;7164
351940;202007;1079;2785;766;2231;121;383;381;1091;502;1474
351950;202007;1667;3804;1213;3127;62;181;851;2116;913;2297
351960;202007;5212;13141;3746;10513;828;2491;1674;4365;2502;6856
351970;202007;7136;21163;5603;18431;880;3226;3054;9727;3934;12953
351980;202007;991;2338;620;1730;86;274;354;909;440;1183
351990;202007;1410;3317;1002;2724;55;206;484;1189;539;1395
352000;202007;2566;7305;2190;6531;264;906;1436;4012;1700;4918
352010;202007;2228;5964;1765;5178;461;1486;380;1137;841;2623
352020;202007;1435;3929;1091;3342;170;560;525;1523;695;2083
352030;202007;5718;15064;4415;12925;833;2674;2188;6184;3021;8858
352040;202007;2832;7614;1885;5651;278;934;688;1751;966;2685
352042;202007;2951;7212;1895;5511;377;1240;803;2237;1180;3477
352044;202007;2056;5504;1160;3764;182;674;252;751;434;1425
352050;202007;12183;32446;7729;23548;1947;6771;1448;3701;3395;10472
352060;202007;698;1876;506;1520;72;237;226;623;298;860
352070;202007;913;1839;580;1394;61;157;283;607;344;764
352080;202007;472;1194;281;808;30;104;104;266;134;370
352090;202007;1462;4276;1194;3736;132;489;582;1646;714;2135
352100;202007;3437;9647;2774;8394;599;1983;1215;3530;1814;5513
352110;202007;589;1717;448;1432;95;316;177;526;272;842
352115;202007;498;1355;407;1214;50;178;242;702;292;880
352120;202007;891;2624;729;2293;86;271;432;1266;518;1537
352130;202007;1975;5546;1314;3919;206;649;524;1438;730;2087
352140;202007;1179;3202;825;2504;147;475;389;1133;536;1608
352150;202007;836;2223;630;1871;82;261;424;1228;506;1489
352160;202007;985;2431;705;1988;75;262;400;1071;475;1333
352170;202007;3013;8057;2356;6739;327;1053;1412;3736;1739;4789
352180;202007;2510;6790;1914;5680;455;1520;566;1468;1021;2988
352190;202007;1209;3258;942;2846;168;472;454;1441;622;1913
352200;202007;338;1020;234;809;32;121;87;288;119;409
352210;202007;19289;45753;15016;40081;1022;3020;11563;30330;12585;33350
352215;202007;624;1627;536;1501;65;200;349;940;414;1140
352220;202007;20350;50448;13753;38556;2655;8046;6099;15810;8754;23856
352230;202007;13873;40167;10592;33925;2545;9070;3853;11340;6398;20410
352240;202007;10538;27092;7967;22759;1733;5580;3447;9068;5180;14648
352250;202007;23223;64870;18364;56346;3033;9938;10809;32604;13842;42542
352260;202007;4791;12025;3207;8934;471;1514;1817;4555;2288;6069
352265;202007;912;2524;801;2366;51;175;607;1746;658;1921
352270;202007;1444;4322;1055;3470;232;824;366;1129;598;1953
352280;202007;2445;6208;1845;5323;192;673;1089;2904;1281;3577
352290;202007;1146;3320;916;2863;125;441;494;1400;619;1841
352300;202007;903;2451;595;1790;82;283;313;879;395;1162
352310;202007;44680;118619;32851;97664;8146;24868;13976;41748;22122;66616
352320;202007;6500;17126;4931;14056;762;2461;2613;6712;3375;9173
352330;202007;2201;5828;1639;5033;287;1035;874;2512;1161;3547
352340;202007;5649;14851;4101;12022;649;2170;2062;5562;2711;7732
352350;202007;2131;6051;1645;4966;179;663;892;2413;1071;3076
352360;202007;1243;3303;1014;2906;83;293;762;2098;845;2391
352370;202007;1057;2983;914;2749;20;79;739;2181;759;2260
352380;202007;840;2290;622;1890;126;395;221;632;347;1027
352390;202007;15030;36791;10073;28135;1638;4996;5518;14556;7156;19552
352400;202007;3473;9577;2820;8350;608;2092;1450;3983;2058;6075
352410;202007;3196;8198;2389;6842;220;764;1475;4020;1695;4784
352420;202007;834;2022;588;1662;108;322;220;589;328;911
352430;202007;7843;19515;5550;15486;1180;3738;2550;6690;3730;10428
352440;202007;17593;47675;12966;38678;3171;9812;4813;13998;7984;23810
352450;202007;776;1905;386;1223;54;192;132;392;186;584
352460;202007;2945;8171;2004;6414;405;1424;773;2327;1178;3751
352470;202007;3350;8425;2501;7051;289;920;1500;4006;1789;4926
352480;202007;3946;9343;2589;6913;412;1259;1271;3052;1683;4311
352490;202007;723;2080;575;1812;100;335;280;840;380;1175
352500;202007;10188;26341;6826;20001;2896;9336;747;1238;3643;10574
352510;202007;3677;9904;2724;8238;572;1877;1263;3628;1835;5505
352520;202007;2776;7278;2134;6191;394;1281;1182;3114;1576;4395
352530;202007;9942;25818;6426;18974;1164;3940;1943;4855;3107;8795
352540;202007;563;1666;403;1301;63;229;133;380;196;609
352550;202007;997;2778;695;2196;133;461;231;657;364;1118
352560;202007;572;1598;432;1320;77;250;203;580;280;830
352570;202007;2227;6418;1368;4497;331;1183;125;338;456;1521
352580;202007;656;1693;540;1489;47;156;364;952;411;1108
352585;202007;319;846;227;682;17;67;140;382;157;449
352590;202007;13176;34615;9115;26804;2369;7593;3951;10794;6320;18387
352600;202007;1950;5227;1508;4399;157;495;942;2603;1099;3098
352610;202007;2905;8154;2172;6872;437;1570;883;2622;1320;4192
352620;202007;5597;14369;4246;12410;1252;3754;1601;4724;2853;8478
352630;202007;808;2010;596;1690;110;358;273;704;383;1062
352640;202007;2965;7640;2105;6104;210;658;1209;3348;1419;4006
352650;202007;603;1691;413;1277;59;212;150;440;209;652
352660;202007;1074;3128;871;2711;109;347;482;1465;591;1812
352670;202007;9639;25861;6256;19093;1582;5171;1488;4275;3070;9446
352680;202007;3246;9649;2239;7336;355;1412;1105;3249;1460;4661
352690;202007;26812;67273;20583;56570;1378;4516;14478;38143;15856;42659
352700;202007;568;1416;414;1203;151;494;93;262;244;756
352710;202007;5124;13187;3598;10401;840;2672;1504;3993;2344;6665
352720;202007;7703;21056;5928;17709;2478;7542;1240;3497;3718;11039
352725;202007;598;1430;330;942;21;54;160;434;181;488
352730;202007;4838;14081;4311;12824;511;1654;2082;5500;2593;7154
352740;202007;2292;5389;1681;4488;174;547;1031;2580;1205;3127
352750;202007;410;1010;243;711;36;114;104;265;140;379
352760;202007;1642;4546;1251;3763;104;301;706;2140;810;2441
352770;202007;869;2340;581;1775;121;383;229;669;350;1052
352780;202007;615;1752;432;1389;87;275;120;379;207;654
352790;202007;444;1183;305;901;32;112;115;301;147;413
352800;202007;1254;3888;873;2975;241;854;111;330;352;1184
352810;202007;1151;2722;718;1952;92;263;444;1141;536;1404
352820;202007;508;1406;354;1137;77;247;74;248;151;495
352830;202007;576;1464;256;784;23;71;57;141;80;212
352840;202007;3944;11265;3222;9977;1077;3567;1065;3214;2142;6781
352850;202007;10694;26122;7190;20391;1919;5941;2298;5878;4217;11819
352860;202007;998;2752;728;2251;140;471;275;807;415;1278
352870;202007;859;2137;603;1614;37;124;405;1022;442;1146
352880;202007;1730;4075;1215;3179;182;495;708;1767;890;2262
352885;202007;297;826;218;684;23;81;131;390;154;471
352890;202007;698;1672;439;1134;42;119;261;607;303;726
352900;202007;17658;46045;11527;33886;1930;6050;5090;14065;7020;20115
352910;202007;430;1149;229;718;22;77;67;185;89;262
352920;202007;2648;6767;1905;5482;138;431;1297;3627;1435;4058
352930;202007;5720;15453;4190;12460;771;2526;1949;5367;2720;7893
352940;202007;21767;59555;15485;46224;3233;10590;6322;17783;9555;28373
352950;202007;526;1404;313;1006;89;280;57;169;146;449
352960;202007;744;1969;408;1252;67;218;116;311;183;529
352965;202007;235;659;146;480;45;149;34;101;79;250
352970;202007;2958;7074;2234;5881;241;678;1457;3785;1698;4463
352980;202007;1372;3646;1083;3206;263;848;545;1566;808;2414
352990;202007;4046;11423;3146;9924;637;2218;1541;4655;2178;6873
353000;202007;469;1291;253;786;38;123;58;149;96;272
353010;202007;2582;6317;1692;4745;341;1103;709;1801;1050;2904
353020;202007;3610;9290;2057;6033;295;972;703;1914;998;2886
353030;202007;4514;11402;3075;8856;694;2185;885;2422;1579;4607
353040;202007;630;1450;442;1174;73;197;243;615;316;812
353050;202007;5122;14683;3587;11531;703;2453;1605;4929;2308;7382
353060;202007;48065;122579;39291;108548;2748;9152;29339;78192;32087;87344
353070;202007;9251;26488;6609;20823;1286;4440;2671;7785;3957;12225
353080;202007;4044;11212;2693;8582;515;1860;1039;2906;1554;4766
353090;202007;574;1716;435;1422;31;110;278;878;309;988
353100;202007;306;825;137;438;28;97;38;95;66;192
353110;202007;7533;20231;6062;18082;1224;3746;3207;9856;4431;13602
353120;202007;398;988;289;808;41;137;133;325;174;462
353130;202007;2421;5676;1521;4199;389;1192;511;1271;900;2463
353140;202007;2719;6730;1938;5381;114;374;1356;3601;1470;3975
353150;202007;1527;3747;1067;2982;198;574;482;1270;680;1844
353160;202007;581;1520;419;1246;74;230;174;471;248;701
353170;202007;529;1421;395;1231;82;285;172;523;254;808
353180;202007;9679;23734;7510;20211;670;2003;5601;14657;6271;16660
353190;202007;3184;8623;2521;7300;302;944;1534;4187;1836;5131
353200;202007;1908;5038;972;3088;160;567;236;672;396;1239
353205;202007;354;1071;302;958;53;176;152;472;205;648
353210;202007;927;2141;580;1570;29;91;381;1011;410;1102
353215;202007;381;1052;294;891;42;139;144;398;186;537
353220;202007;729;1999;449;1394;95;285;60;178;155;463
353230;202007;831;2291;642;1989;181;624;249;704;430;1328
353240;202007;2311;6257;1867;5515;265;902;1091;3080;1356;3982
353250;202007;1268;2839;763;1998;104;312;426;1049;530;1361
353260;202007;1176;2706;641;1823;95;309;299;801;394;1110
353270;202007;681;1755;570;1555;48;153;394;1009;442;1162
353280;202007;697;1900;482;1499;125;393;128;385;253;778
353282;202007;1785;4995;1487;4438;152;518;945;2658;1097;3176
353284;202007;360;835;184;499;20;74;82;191;102;265
353286;202007;171;432;103;321;13;40;34;100;47;140
353290;202007;1477;3920;910;2758;149;456;299;825;448;1281
353300;202007;1880;5037;1351;4003;221;742;602;1597;823;2339
353310;202007;395;952;282;743;21;70;191;471;212;541
353320;202007;659;1609;544;1444;9;39;472;1238;481;1277
353325;202007;660;1925;450;1464;93;295;172;540;265;835
353330;202007;536;1369;362;1038;44;131;201;542;245;673
353340;202007;2841;7663;1964;5948;408;1374;872;2462;1280;3836
353350;202007;3481;8922;2359;6686;517;1600;688;1703;1205;3303
353360;202007;628;1759;478;1469;59;186;276;831;335;1017
353370;202007;564;1626;467;1474;36;120;330;1006;366;1126
353380;202007;281;853;231;752;25;87;126;374;151;461
353390;202007;6133;15129;4556;12487;503;1561;2644;6834;3147;8395
353400;202007;423;1158;315;950;52;186;118;293;170;479
353410;202007;520;1393;391;1163;70;214;222;663;292;877
353420;202007;422;1105;246;716;59;163;20;45;79;208
353430;202007;2194;6075;1648;5063;367;1229;706;2038;1073;3267
353440;202007;63294;171405;45163;136182;7485;24521;23733;67927;31218;92448
353450;202007;364;920;242;708;35;121;115;305;150;426
353460;202007;3224;8728;2272;6869;165;573;1049;3052;1214;3625
353470;202007;7662;20096;5403;15900;890;3017;2349;6297;3239;9314
353475;202007;1499;3900;1032;2926;157;488;514;1350;671;1838
353480;202007;1601;4299;1267;3705;62;228;881;2489;943;2717
353490;202007;1093;2872;717;2146;102;336;324;911;426;1247
353500;202007;1031;2411;764;2010;162;437;422;1105;584;1542
353510;202007;772;2329;555;1793;138;494;141;379;279;873
353520;202007;1064;2786;665;2051;85;291;308;876;393;1167
353530;202007;2382;6307;1839;5330;255;834;973;2617;1228;3451
353540;202007;2025;5440;1642;4832;263;812;976;2811;1239;3623
353550;202007;5759;14769;4596;12903;755;2225;2617;7089;3372;9314
353560;202007;2230;6013;1638;5082;452;1537;463;1290;915;2827
353570;202007;590;1532;436;1284;48;152;256;707;304;859
353580;202007;2109;5544;1568;4485;335;969;747;2084;1082;3053
353590;202007;707;1849;460;1372;93;295;188;556;281;851
353600;202007;1707;4205;1271;3445;156;426;704;1862;860;2288
353610;202007;543;1608;384;1297;86;352;116;353;202;705
353620;202007;2642;7065;1837;5653;371;1270;593;1668;964;2938
353625;202007;494;1221;325;921;20;68;203;563;223;631
353630;202007;1279;3961;1060;3466;240;872;367;1098;607;1970
353640;202007;1365;3487;1086;3067;149;437;618;1740;767;2177
353650;202007;7821;20818;5786;16935;606;2007;3502;9631;4108;11638
353657;202007;389;1008;276;812;30;95;127;346;157;441
353660;202007;1260;2680;852;2134;386;972;194;467;580;1439
353670;202007;4040;11219;3097;9352;612;2079;1515;4238;2127;6317
353680;202007;688;1786;498;1508;81;267;273;782;354;1049
353690;202007;426;1094;188;580;21;63;36;95;57;158
353700;202007;2023;5290;1653;4663;122;393;1214;3293;1336;3686
353710;202007;5152;11471;3038;7712;305;797;1786;4088;2091;4885
353715;202007;426;1123;252;790;10;41;83;242;93;283
353720;202007;1967;5222;1505;4533;204;693;889;2612;1093;3305
353730;202007;4400;11557;3255;9485;486;1638;1639;4352;2125;5990
353740;202007;2011;5310;1387;4196;342;1123;455;1232;797;2355
353750;202007;825;2470;573;1969;137;512;105;363;242;875
353760;202007;12410;29003;9344;24801;1803;4920;5111;13295;6914;18215
353770;202007;730;2174;412;1386;69;256;59;172;128;428
353780;202007;5090;14260;3971;12079;805;2743;1891;5301;2696;8044
353790;202007;2527;7703;1822;6205;520;1983;389;1139;909;3122
353800;202007;17769;46527;13663;39844;1977;6134;7610;22122;9587;28256
353810;202007;1135;3055;714;2158;112;380;293;840;405;1220
353820;202007;1707;4608;1177;3532;245;795;383;1077;628;1872
353830;202007;613;1555;450;1283;79;236;196;528;275;764
353850;202007;1609;4485;1222;3729;268;827;434;1308;702;2135
353860;202007;2552;7111;1962;6039;476;1665;859;2391;1335;4056
353870;202007;29053;76363;20274;59028;2654;8768;10610;28065;13264;36833
353880;202007;3116;8581;2454;7311;200;692;1531;4381;1731;5073
353890;202007;2567;5585;1706;4383;144;382;1178;2886;1322;3268
353900;202007;740;2072;524;1638;82;283;205;592;287;875
353910;202007;2309;6396;1900;5738;198;705;1296;3831;1494;4536
353920;202007;1806;5003;1263;3941;298;1056;328;839;626;1895
353930;202007;4234;11273;2858;8708;500;1751;1169;3132;1669;4883
353940;202007;1070;3022;716;2311;126;422;246;736;372;1158
353950;202007;3176;8645;2415;7240;433;1426;1349;3753;1782;5179
353960;202007;697;1831;462;1377;91;294;192;544;283;838
353970;202007;662;1596;488;1332;46;141;326;864;372;1005
353980;202007;16123;40829;12458;34310;864;2751;8921;23555;9785;26306
353990;202007;894;2185;525;1509;87;267;240;660;327;927
354000;202007;2460;5948;1346;3817;301;897;230;628;531;1525
354010;202007;361;941;257;773;48;153;140;405;188;558
354020;202007;3403;9391;2636;7791;666;2114;1055;2853;1721;4967
354025;202007;712;1983;461;1467;64;235;125;376;189;611
354030;202007;484;1061;250;669;51;149;122;306;173;455
354040;202007;804;1867;508;1377;22;72;376;986;398;1058
354050;202007;940;2627;639;2081;145;500;202;652;347;1152
354060;202007;3296;9354;2247;7142;516;1756;804;2349;1320;4105
354070;202007;3571;9483;2400;7188;422;1450;992;2536;1414;3986
354075;202007;2569;7494;1963;6339;243;892;1109;3476;1352;4368
354080;202007;1353;3685;883;2758;191;633;213;593;404;1226
354085;202007;413;873;319;747;0;0;236;511;236;511
354090;202007;1631;4572;1388;4051;79;251;1082;3081;1161;3332
354100;202007;19185;52327;12997;41396;2864;9828;4948;15625;7812;25453
354105;202007;1487;3750;1001;2851;129;377;465;1246;594;1623
354110;202007;472;1306;318;1017;47;161;117;373;164;534
354120;202007;1381;3721;913;2716;186;606;309;799;495;1405
354130;202007;5398;14222;3527;10620;899;2893;211;420;1110;3313
354140;202007;19033;46677;12681;34955;2200;6719;5414;13751;7614;20470
354150;202007;2992;7103;2212;5858;486;1325;881;2272;1367;3597
354160;202007;2908;8432;2126;6834;610;2109;593;1735;1203;3844
354165;202007;644;1920;490;1615;83;313;254;788;337;1101
354170;202007;1762;4876;1466;4307;85;283;948;2663;1033;2946
354180;202007;387;1081;274;838;51;163;108;299;159;462
354190;202007;1473;4131;1018;3186;66;231;467;1399;533;1630
354200;202007;851;2076;655;1780;70;209;426;1101;496;1310
354210;202007;784;2064;621;1784;40;143;456;1233;496;1376
354220;202007;3103;8337;2288;6701;389;1219;1153;3211;1542;4430
354230;202007;745;1844;590;1654;42;154;430;1158;472;1312
354240;202007;1621;4504;1077;3392;189;651;321;895;510;1546
354250;202007;543;1304;331;974;94;282;82;253;176;535
354260;202007;8087;21506;6059;17917;1258;3962;2489;7097;3747;11059
354270;202007;1023;3075;822;2683;192;613;322;1023;514;1636
354280;202007;790;1981;670;1805;60;196;424;1051;484;1247
354290;202007;926;2934;773;2608;131;434;393;1353;524;1787
354300;202007;3546;10409;2987;9364;840;2643;1123;3486;1963;6129
354310;202007;707;2097;578;1827;136;449;215;635;351;1084
354320;202007;962;2343;617;1747;96;307;241;603;337;910
354323;202007;457;1109;303;828;37;79;130;347;167;426
354325;202007;1364;4054;951;3115;147;472;357;1131;504;1603
354330;202007;9361;23760;6137;17128;734;2395;3604;9341;4338;11736
354340;202007;31608;79485;20935;60671;3389;10999;10562;29178;13951;40177
354350;202007;1166;2999;925;2591;86;263;633;1697;719;1960
354360;202007;592;1513;339;1086;67;222;71;224;138;446
354370;202007;994;2868;784;2514;128;444;447;1407;575;1851
354380;202007;711;1864;503;1520;91;357;123;284;214;641
354390;202007;13405;32551;8522;23902;1606;4784;3426;9155;5032;13939
354400;202007;1549;4951;1161;4029;195;740;431;1458;626;2198
354410;202007;5731;15529;4301;12641;894;2846;1911;5312;2805;8158
354420;202007;1460;3841;1060;3105;137;434;651;1814;788;2248
354425;202007;2668;6473;1871;5084;439;1198;802;2173;1241;3371
354430;202007;1499;4001;1144;3430;126;440;671;1881;797;2321
354440;202007;553;1478;359;1076;57;191;158;432;215;623
354450;202007;416;1096;226;730;33;109;73;213;106;322
354460;202007;866;2185;562;1637;76;236;311;875;387;1111
354470;202007;468;1193;307;877;19;61;153;387;172;448
354480;202007;1200;2722;768;2025;68;187;519;1308;587;1495
354490;202007;811;2399;582;1889;95;339;271;819;366;1158
354500;202007;2052;5786;1676;5206;518;1724;400;1251;918;2975
354510;202007;722;2019;566;1708;54;176;304;829;358;1005
354515;202007;332;961;243;775;40;146;101;308;141;454
354520;202007;6844;18804;4729;14193;681;2359;2618;7266;3299;9625
354530;202007;4223;12071;3204;10021;758;2417;1237;3893;1995;6310
354540;202007;1287;3422;920;2762;217;690;349;1047;566;1737
354550;202007;562;1466;437;1226;64;203;249;657;313;860
354560;202007;2155;5210;1151;3264;143;412;574;1510;717;1922
354570;202007;1205;3020;481;1377;80;237;59;167;139;404
354580;202007;8771;22980;5594;16910;853;2814;2780;8062;3633;10876
354600;202007;1862;4991;1413;4133;155;538;917;2529;1072;3067
354610;202007;437;1133;243;730;26;77;111;315;137;392
354620;202007;440;1235;271;899;51;195;99;293;150;488
354625;202007;313;834;168;537;31;102;23;47;54;149
354630;202007;1990;5962;1586;5118;563;1910;281;829;844;2739
354640;202007;3191;9155;2322;7397;405;1404;849;2514;1254;3918
354650;202007;872;2271;689;1967;56;156;430;1212;486;1368
354660;202007;3700;8619;1901;5573;175;626;907;2416;1082;3042
354670;202007;1071;2995;727;2286;153;513;264;754;417;1267
354680;202007;5222;13709;3918;11540;908;2796;1936;5813;2844;8609
354690;202007;499;1595;354;1263;78;289;93;325;171;614
354700;202007;855;2277;601;1776;88;279;294;828;382;1107
354710;202007;465;1251;331;986;36;117;142;358;178;475
354720;202007;284;687;125;371;41;130;28;82;69;212
354730;202007;9751;27413;7252;22562;1041;3542;4063;12154;5104;15696
354740;202007;315;853;124;411;17;66;20;57;37;123
354750;202007;2549;6553;1622;4794;261;842;724;1931;985;2773
354760;202007;2045;5510;1404;4263;336;1120;446;1214;782;2334
354765;202007;376;1001;142;457;21;70;28;78;49;148
354770;202007;2308;5719;1686;4651;317;966;792;2037;1109;3003
354780;202007;53624;136414;40063;109411;4444;13688;24882;63707;29326;77395
354790;202007;960;2646;743;2285;82;278;448;1318;530;1596
354800;202007;2572;6613;1999;5735;497;1453;861;2330;1358;3783
354805;202007;1334;3056;894;2407;99;268;529;1323;628;1591
354810;202007;647;1904;361;1283;45;188;81;266;126;454
354820;202007;952;2716;669;2161;115;418;194;501;309;919
354830;202007;447;1104;281;799;55;168;96;257;151;425
354840;202007;934;2308;554;1543;51;153;318;828;369;981
354850;202007;21333;55358;14576;43031;1672;5704;8649;24148;10321;29852
354860;202007;1739;4919;1042;3389;174;616;305;898;479;1514
354870;202007;56873;143803;43431;118688;4790;14456;26916;69481;31706;83937
354880;202007;5837;14438;2749;7804;323;1076;1060;2442;1383;3518
354890;202007;16392;40865;12583;34409;1714;5301;7477;19727;9191;25028
354900;202007;402;1004;249;730;41;132;71;181;112;313
354910;202007;5419;14204;3203;10140;725;2424;544;1644;1269;4068
354920;202007;476;1276;217;743;27;109;44;156;71;265
354925;202007;292;835;170;551;18;59;40;110;58;169
354930;202007;402;946;234;661;16;53;119;309;135;362
354940;202007;2281;6865;1584;5282;543;1934;282;861;825;2795
354950;202007;1482;3821;1172;3386;61;248;866;2357;927;2605
354960;202007;916;2445;688;2096;52;190;400;1152;452;1342
354970;202007;4170;11635;3216;9974;361;1265;2053;6162;2414;7427
354980;202007;32853;77706;21716;58426;2363;7624;13174;32893;15537;40517
354990;202007;64856;164044;48066;133219;4064;13075;31212;81489;35276;94564
354995;202007;2809;6371;2107;5438;150;459;1560;3853;1710;4312
355000;202007;1573;3933;1176;3357;185;621;567;1488;752;2109
355010;202007;3764;10242;2208;6904;735;2368;234;760;969;3128
355020;202007;3612;10150;2623;8384;601;2116;967;2909;1568;5025
355030;202007;1354817;3325380;960598;2555470;147840;431911;476119;1166331;623959;1598242
355040;202007;2846;7145;2205;6300;320;908;1511;4354;1831;5262
355050;202007;980;2304;701;1886;175;522;271;663;446;1185
355060;202007;6063;16430;4354;13175;731;2565;2103;5774;2834;8339
355070;202007;8855;22876;7047;19944;823;2695;4511;12022;5334;14717
355080;202007;912;2599;553;1903;110;416;79;214;189;630
355090;202007;1100;3183;822;2691;212;687;254;861;466;1548
355100;202007;22408;58689;17113;50692;2784;8723;10131;29725;12915;38448
355110;202007;813;2287;582;1914;177;654;106;320;283;974
355120;202007;690;1810;487;1509;37;132;207;602;244;734
355130;202007;879;1960;416;1112;29;91;241;604;270;695
355140;202007;1895;4323;1584;3889;99;289;1303;3097;1402;3386
355150;202007;4237;11211;3333;9594;394;1262;2095;5789;2489;7051
355160;202007;1989;5456;1422;4415;357;1208;338;999;695;2207
355170;202007;10106;25679;7787;21741;1487;4503;4124;11110;5611;15613
355180;202007;2784;7510;1947;6075;413;1437;701;1990;1114;3427
355190;202007;1844;4836;1439;4205;347;1006;758;2348;1105;3354
355200;202007;824;2542;688;2317;183;680;284;909;467;1589
355210;202007;2859;7824;2207;6477;423;1410;1117;3057;1540;4467
355220;202007;43853;116748;34092;97767;8085;24700;13834;36691;21919;61391
355230;202007;1154;2891;623;1837;111;309;220;609;331;918
355240;202007;23494;62174;16085;47186;2252;7161;8514;23579;10766;30740
355250;202007;37119;99588;26917;79483;6749;21029;9913;27876;16662;48905
355255;202007;692;1744;359;1109;60;208;136;403;196;611
355260;202007;1437;3567;1032;2879;136;460;589;1512;725;1972
355270;202007;1171;3501;899;2928;208;694;298;901;506;1595
355280;202007;30105;77351;20975;59827;3028;9367;10171;27308;13199;36675
355290;202007;862;2386;642;1972;138;406;259;774;397;1180
355300;202007;1270;3724;973;3096;182;652;331;984;513;1636
355310;202007;967;2688;726;2280;99;302;398;1274;497;1576
355320;202007;538;1419;397;1159;77;258;160;380;237;638
355330;202007;2833;7181;2122;5960;141;517;1595;4254;1736;4771
355340;202007;4041;8929;3085;7649;399;889;1905;4839;2304;5728
355350;202007;1292;3751;951;3085;205;685;336;1075;541;1760
355360;202007;1156;2972;883;2571;120;377;535;1536;655;1913
355365;202007;360;952;185;633;40;125;31;110;71;235
355370;202007;5310;13576;4065;11619;974;2598;1803;5663;2777;8261
355380;202007;2849;7634;2115;6239;391;1242;759;1952;1150;3194
355385;202007;1449;3811;1178;3407;113;398;744;1974;857;2372
355390;202007;828;2266;586;1729;133;425;228;610;361;1035
355395;202007;1971;5407;1345;4116;231;760;481;1302;712;2062
355400;202007;8997;25923;7047;21995;1742;6196;2473;6895;4215;13091
355410;202007;22167;60652;13612;43207;2904;10176;3433;10697;6337;20873
355420;202007;623;2004;506;1770;145;557;122;415;267;972
355430;202007;3720;9488;2770;7755;662;1816;1247;3469;1909;5285
355440;202007;793;2163;473;1480;85;280;138;401;223;681
355450;202007;3085;7986;1960;5731;358;1126;805;2123;1163;3249
355460;202007;494;1209;308;903;45;170;140;365;185;535
355465;202007;410;1077;310;910;47;148;161;460;208;608
355470;202007;1069;2761;599;1825;162;555;188;508;350;1063
355475;202007;353;838;279;728;18;42;204;519;222;561
355480;202007;3768;10454;3064;9404;424;1507;2012;6001;2436;7508
355490;202007;948;2545;511;1583;37;131;271;765;308;896
355495;202007;786;2249;571;1850;70;264;206;603;276;867
355500;202007;6545;17008;3782;11474;592;1975;1259;3532;1851;5507
355510;202007;1310;3192;813;2335;111;377;357;905;468;1282
355520;202007;370;824;167;492;28;80;49;136;77;216
355530;202007;406;945;143;424;19;70;52;136;71;206
355535;202007;505;1392;378;1179;76;297;170;472;246;769
355540;202007;10525;26540;8531;23665;1328;4009;5449;14642;6777;18651
355550;202007;621;1838;504;1620;68;247;271;816;339;1063
355560;202007;1103;2845;586;1835;129;452;38;120;167;572
355570;202007;247;707;134;438;25;84;32;103;57;187
355580;202007;1201;2942;779;2224;143;449;316;846;459;1295
355590;202007;170;427;130;360;19;57;78;205;97;262
355600;202007;1459;3548;968;2730;183;555;392;1075;575;1630
355610;202007;1736;4301;1145;3267;134;427;609;1653;743;2080
355620;202007;4616;12311;3399;9930;382;1359;1908;5126;2290;6485
355630;202007;2279;6295;1574;4942;256;839;776;2405;1032;3244
355635;202007;877;2562;640;2095;117;427;188;545;305;972
355640;202007;2943;8249;1932;6192;378;1313;578;1775;956;3088
355645;202007;4182;11788;3021;9731;447;1551;1613;5100;2060;6651
355650;202007;6578;17731;5114;15018;1402;4277;1698;4496;3100;8773
355660;202007;1298;3364;885;2593;137;454;306;880;443;1334
355670;202007;3455;9299;2252;6606;288;999;1132;2906;1420;3905
355680;202007;2734;7522;1169;3843;307;1066;126;437;433;1503
355690;202007;792;2355;501;1750;111;424;20;46;131;470
355695;202007;239;675;139;453;12;59;25;55;37;114
355700;202007;7134;20518;5739;17369;1002;3197;3031;8705;4033;11902
355710;202007;8747;20683;5588;14882;859;2541;2556;6054;3415;8595
355715;202007;481;1282;249;759;53;177;49;129;102;306
355720;202007;1463;4106;1143;3532;188;629;609;1755;797;2384
355730;202007;905;2516;732;2183;134;437;328;884;462;1321
410010;202007;1224;3419;917;2757;194;636;190;558;384;1194
410020;202007;1012;3098;781;2553;277;854;174;600;451;1454
410030;202007;1486;4128;1250;3749;169;570;686;2052;855;2622
410040;202007;12226;33857;8860;27483;1950;6445;2790;8032;4740;14477
410045;202007;870;2303;605;1807;83;281;220;613;303;894
410050;202007;2350;5873;1564;4482;307;961;509;1371;816;2332
410060;202007;2047;5833;1571;4852;367;1216;502;1485;869;2701
410070;202007;1918;4873;1398;3911;225;701;551;1411;776;2112
410080;202007;1353;3630;949;2872;214;664;307;947;521;1611
410090;202007;1086;2790;925;2531;90;236;558;1596;648;1832
410100;202007;1823;5287;1196;3750;174;622;156;468;330;1090
410105;202007;485;1224;273;816;33;104;88;247;121;351
410110;202007;3117;7899;2156;6041;270;818;973;2563;1243;3381
410115;202007;587;1520;424;1232;57;185;165;458;222;643
410120;202007;2550;7255;2219;6719;492;1643;1131;3293;1623;4936
410130;202007;1207;3266;1041;2952;198;661;523;1363;721;2024
410140;202007;15834;38323;10000;27759;1839;5590;2602;6531;4441;12121
410150;202007;16569;38973;8170;22478;1387;4220;1926;4805;3313;9025
410160;202007;2818;7828;2242;6805;512;1698;779;2365;1291;4063
410165;202007;736;1958;600;1681;54;185;359;928;413;1113
410170;202007;2717;7071;1775;5040;408;1269;131;385;539;1654
410180;202007;14596;40655;11079;33390;1509;4964;5838;16448;7347;21412
410185;202007;442;1284;308;946;56;184;92;255;148;439
410190;202007;2210;5490;1572;4351;329;933;419;1111;748;2044
410200;202007;5305;12279;2886;8051;460;1497;447;1196;907;2693
410210;202007;3058;7714;1881;5538;304;1015;643;1622;947;2637
410220;202007;513;1317;326;965;55;179;78;222;133;401
410230;202007;1676;4484;1272;3656;172;569;662;1750;834;2319
410240;202007;4946;13113;3367;10033;826;2723;316;848;1142;3571
410250;202007;2649;6282;1937;5118;151;494;946;2429;1097;2923
410260;202007;1859;4656;1138;3279;191;567;494;1397;685;1964
410270;202007;457;1213;327;986;48;159;120;350;168;509
410275;202007;654;1840;451;1410;62;208;191;552;253;760
410280;202007;2266;6094;1476;4501;229;770;577;1628;806;2398
410290;202007;3238;9133;2187;6851;580;1825;563;1752;1143;3577
410300;202007;633;1600;497;1373;40;127;254;657;294;784
410302;202007;380;945;199;600;25;85;96;281;121;366
410304;202007;1219;3180;1015;2805;113;305;613;1650;726;1955
410305;202007;1763;4212;1196;3384;133;419;740;2014;873;2433
410310;202007;2478;7062;1948;6017;338;1136;886;2731;1224;3867
410315;202007;663;1582;344;1062;123;378;80;255;203;633
410320;202007;1059;2940;712;2212;118;413;126;369;244;782
410322;202007;575;1505;314;922;32;105;164;443;196;548
410330;202007;1496;3660;1017;2749;172;499;293;783;465;1282
410335;202007;832;2257;640;1895;97;314;285;782;382;1096
410337;202007;852;2065;587;1549;68;186;248;620;316;806
410340;202007;494;1383;335;985;29;97;162;400;191;497
410345;202007;2401;6209;1198;3541;250;779;329;860;579;1639
410347;202007;736;1882;533;1508;45;152;176;502;221;654
410350;202007;1414;3588;1014;2896;136;396;416;1138;552;1534
410360;202007;4299;10497;3293;8748;384;1115;1813;4633;2197;5748
410370;202007;13104;35469;8392;24191;1009;3199;3544;9038;4553;12237
410380;202007;1566;3958;1145;3188;158;449;389;1001;547;1450
410390;202007;2605;6661;1688;4962;385;1262;508;1362;893;2624
410395;202007;897;2580;731;2228;144;465;294;893;438;1358
410400;202007;6344;16761;4674;13448;699;2139;2263;6135;2962;8274
410405;202007;817;1973;604;1658;110;343;262;667;372;1010
410410;202007;1232;3327;1151;3199;167;544;721;2069;888;2613
410420;202007;9863;27311;7418;22407;1223;4145;2852;7689;4075;11834
410425;202007;3164;8877;2137;6731;363;1237;775;2210;1138;3447
410430;202007;12964;32554;8930;25086;1408;4351;3137;8248;4545;12599
410440;202007;2284;6845;1945;6197;291;1040;1018;3182;1309;4222
410442;202007;2203;6709;1832;5898;531;1779;580;1780;1111;3559
410445;202007;2239;6544;1633;5332;316;1183;371;1276;687;2459
410450;202007;1421;3568;1043;2953;200;628;376;999;576;1627
410460;202007;1987;4920;1523;4183;165;460;756;2012;921;2472
410465;202007;2671;7754;2078;6604;385;1283;745;2216;1130;3499
410470;202007;2004;5570;1399;4421;359;1303;221;743;580;2046
410480;202007;36647;86969;19026;55417;3047;9982;4083;10156;7130;20138
410490;202007;10945;30519;7746;23811;1443;4822;3009;8699;4452;13521
410500;202007;1842;4860;1271;3731;275;928;374;963;649;1891
410510;202007;1850;4572;1205;3359;241;670;334;932;575;1602
410520;202007;3013;9494;2669;8784;915;3099;927;3132;1842;6231
410530;202007;1624;4018;778;2228;99;288;185;432;284;720
410540;202007;2706;7334;1852;5580;278;914;860;2492;1138;3406
410550;202007;7329;19652;4740;13862;819;2608;1300;3282;2119;5890
410560;202007;1438;3800;1056;2997;237;738;365;902;602;1640
410570;202007;2439;6779;1793;5603;482;1776;202;666;684;2442
410580;202007;25159;65724;18132;52690;3539;11025;7610;20678;11149;31703
410590;202007;1531;4382;1013;3129;145;470;289;774;434;1244
410600;202007;1792;4771;1355;3921;290;808;474;1412;764;2220
410610;202007;712;1883;521;1511;60;210;227;618;287;828
410620;202007;2355;6815;1543;4881;333;1152;268;783;601;1935
410630;202007;2429;6395;1571;4623;298;1002;314;750;612;1752
410640;202007;4550;10684;3034;8024;675;2089;406;1065;1081;3154
410645;202007;1035;2956;837;2693;268;886;353;1158;621;2044
410650;202007;2194;5994;1485;4530;298;980;527;1484;825;2464
410655;202007;898;2155;630;1677;26;82;326;825;352;907
410657;202007;648;1746;396;1187;51;189;143;355;194;544
410660;202007;3359;8676;1894;5454;341;1031;487;1319;828;2350
410670;202007;1053;2634;629;1803;126;369;229;601;355;970
410680;202007;2603;7891;1845;5948;445;1491;335;1095;780;2586
410685;202007;528;1349;396;1122;94;312;156;391;250;703
410690;202007;129061;315822;84253;231933;13394;42261;31991;77402;45385;119663
410700;202007;2437;6219;2039;5584;302;852;1050;2807;1352;3659
410710;202007;867;2186;566;1615;92;273;229;605;321;878
410712;202007;634;1830;519;1603;134;454;189;555;323;1009
410715;202007;799;2324;485;1606;70;234;169;534;239;768
410720;202007;3106;7899;2413;6555;324;1041;523;1395;847;2436
410725;202007;1063;2601;598;1732;112;357;88;211;200;568
410730;202007;617;1647;469;1378;106;359;96;270;202;629
410740;202007;927;2596;674;2107;92;317;266;819;358;1136
410750;202007;1754;4454;1377;3743;205;632;628;1618;833;2250
410752;202007;368;934;182;548;27;84;81;226;108;310
410753;202007;299;908;203;687;31;125;46;138;77;263
410754;202007;1085;2783;893;2489;56;121;611;1812;667;1933
410755;202007;585;1515;398;1137;56;172;174;435;230;607
410760;202007;3560;9172;2537;7295;646;2124;568;1478;1214;3602
410765;202007;13013;36477;10038;30550;1693;5633;2118;5725;3811;11358
410770;202007;1052;2519;730;1976;64;182;367;995;431;1177
410773;202007;1235;3327;1073;3082;111;358;658;1831;769;2189
410775;202007;1484;3693;1286;3394;67;203;855;2204;922;2407
410780;202007;623;1547;403;1116;66;200;104;267;170;467
410785;202007;725;1900;557;1613;92;296;196;577;288;873
410790;202007;769;2177;618;1881;168;563;64;139;232;702
410800;202007;3387;7491;2722;6520;49;167;1782;4156;1831;4323
410810;202007;418;1111;327;936;24;75;171;436;195;511
410820;202007;875;2482;447;1391;93;307;82;217;175;524
410830;202007;34780;84718;23363;65362;4744;15202;8363;21888;13107;37090
410832;202007;1000;2602;790;2226;87;277;464;1232;551;1509
410840;202007;8022;20529;4705;14126;869;2843;1194;3345;2063;6188
410845;202007;1135;2835;890;2468;168;492;373;1013;541;1505
410850;202007;2198;6358;1903;5810;302;1014;956;2827;1258;3841
410855;202007;777;1934;510;1423;45;122;240;615;285;737
410860;202007;4311;10628;3361;9065;348;1090;1885;4812;2233;5902
410865;202007;1364;4034;1187;3668;139;479;701;2208;840;2687
410870;202007;1273;3423;1045;3029;85;268;703;2016;788;2284
410880;202007;4526;12174;3177;9658;551;1784;460;1531;1011;3315
410890;202007;951;2718;692;2203;152;533;178;558;330;1091
410895;202007;984;3141;835;2813;251;933;184;579;435;1512
410900;202007;845;2223;579;1702;102;315;111;271;213;586
410910;202007;376;891;226;605;13;48;134;326;147;374
410920;202007;854;2033;584;1588;76;228;291;772;367;1000
410930;202007;1630;4195;1107;3262;265;918;232;665;497;1583
410940;202007;22251;60945;15862;49211;3267;11248;4877;14797;8144;26045
410950;202007;1899;5564;1677;5217;48;187;1397;4291;1445;4478
410960;202007;7414;18592;4952;14350;1147;3657;1834;5275;2981;8932
410965;202007;1086;2760;736;2090;86;266;413;1164;499;1430
410970;202007;3909;10514;2699;8154;615;2225;368;928;983;3153
410975;202007;1340;3341;1015;2819;109;325;498;1368;607;1693
410980;202007;7088;17797;4458;12994;523;1727;1930;5164;2453;6891
410990;202007;1403;3415;925;2666;224;740;300;840;524;1580
411000;202007;620;1650;413;1243;56;201;123;311;179;512
411005;202007;449;1165;271;785;47;149;82;210;129;359
411007;202007;2260;6320;1840;5589;434;1393;646;1946;1080;3339
411010;202007;4133;12404;3234;10541;830;2941;363;1067;1193;4008
411020;202007;2211;6335;1804;5592;530;1700;495;1498;1025;3198
411030;202007;765;1890;535;1417;34;121;302;701;336;822
411040;202007;965;2421;485;1361;54;176;169;425;223;601
411050;202007;1876;5852;1512;5033;397;1422;228;662;625;2084
411060;202007;1837;4775;1149;3432;260;914;192;507;452;1421
411065;202007;384;999;258;754;36;116;113;305;149;421
411070;202007;7074;18115;5571;15569;778;2417;2719;7330;3497;9747
411080;202007;2066;5469;1615;4662;412;1356;321;901;733;2257
411090;202007;850;2228;553;1648;48;171;155;437;203;608
411095;202007;1622;3804;1089;2967;122;359;359;918;481;1277
411100;202007;1178;3044;814;2386;85;288;263;791;348;1079
411110;202007;632;1632;282;882;35;111;19;39;54;150
411120;202007;1262;3522;1041;3099;322;1104;229;617;551;1721
411125;202007;5168;15037;4560;13874;985;2946;2197;7011;3182;9957
411130;202007;700;1883;490;1486;94;262;178;571;272;833
411140;202007;2227;6888;1877;6129;550;1939;486;1548;1036;3487
411150;202007;3809;9756;2538;7166;505;1651;252;519;757;2170
411155;202007;956;2431;555;1674;80;229;234;673;314;902
411160;202007;354;815;233;653;31;94;53;152;84;246
411170;202007;710;2121;530;1698;122;385;179;557;301;942
411180;202007;5451;14370;4184;12115;621;2009;2025;5493;2646;7502
411190;202007;1671;4279;1229;3478;207;623;480;1230;687;1853
411200;202007;4894;13279;3372;10363;847;2887;648;1710;1495;4597
411210;202007;3139;7009;2033;5179;351;999;663;1592;1014;2591
411220;202007;840;2182;588;1693;136;430;165;449;301;879
411230;202007;867;2286;613;1794;123;383;228;655;351;1038
411240;202007;1545;3733;1000;2720;105;335;483;1207;588;1542
411250;202007;2207;5878;1606;4777;317;1084;508;1455;825;2539
411260;202007;340;899;218;646;28;88;85;221;113;309
411270;202007;2028;5408;1504;4355;204;623;756;2016;960;2639
411275;202007;1429;3284;974;2534;146;459;435;1044;581;1503
411280;202007;1318;3569;865;2685;230;728;120;361;350;1089
411290;202007;806;2119;513;1540;51;140;268;832;319;972
411295;202007;1218;3060;859;2348;100;293;381;976;481;1269
411300;202007;1018;2542;633;1794;60;186;289;717;349;903
411310;202007;857;1994;652;1688;50;124;287;728;337;852
411320;202007;5426;14072;3924;11340;667;2073;1647;4249;2314;6322
411325;202007;1384;3966;1172;3601;192;584;662;2100;854;2684
411330;202007;3340;9018;2406;7298;544;1791;752;2292;1296;4083
411340;202007;839;2283;495;1517;71;236;164;474;235;710
411342;202007;1036;2501;601;1652;102;302;237;616;339;918
411345;202007;1031;2680;773;2251;61;194;555;1634;616;1828
411350;202007;2632;7174;1686;5231;438;1484;241;687;679;2171
411360;202007;699;1701;489;1357;64;179;160;429;224;608
411370;202007;54632;134010;38793;107028;2811;9404;23341;60268;26152;69672
411373;202007;1369;3485;1107;3092;94;322;599;1685;693;2007
411375;202007;1098;2770;795;2197;129;374;314;834;443;1208
411380;202007;1119;2602;743;1882;37;103;456;1076;493;1179
411390;202007;1501;4144;1162;3403;184;595;475;1232;659;1827
411400;202007;2247;5605;1680;4532;175;556;847;2177;1022;2733
411410;202007;2420;6707;1749;5244;385;1258;402;1166;787;2424
411420;202007;4082;10052;2177;6366;316;1067;386;860;702;1927
411430;202007;3406;9237;2553;7604;545;1774;891;2411;1436;4185
411435;202007;411;1151;255;808;51;154;78;201;129;355
411440;202007;2460;6905;1973;5978;397;1305;701;2065;1098;3370
411450;202007;2467;6606;1876;5618;247;746;1004;3054;1251;3800
411460;202007;4098;10537;2529;7506;414;1460;459;1229;873;2689
411470;202007;752;1946;547;1545;98;295;208;536;306;831
411480;202007;4814;12831;3479;10304;689;2437;1248;3306;1937;5743
411490;202007;1600;4136;1212;3486;155;516;512;1339;667;1855
411500;202007;1263;3422;829;2476;148;491;163;401;311;892
411510;202007;2279;5834;1806;5005;391;1258;427;1190;818;2448
411520;202007;29935;72858;16809;47221;1958;6400;6351;16030;8309;22430
411530;202007;923;2426;552;1696;90;309;91;250;181;559
411535;202007;476;1383;286;920;30;107;82;212;112;319
411540;202007;2680;6563;1796;4946;168;538;903;2391;1071;2929
411545;202007;913;2619;755;2340;73;229;490;1534;563;1763
411550;202007;701;1775;488;1376;70;216;81;242;151;458
411560;202007;1948;5264;1108;3445;160;550;78;222;238;772
411570;202007;7444;17239;4931;13363;1096;3226;885;2389;1981;5615
411573;202007;751;2040;635;1861;96;296;327;936;423;1232
411575;202007;1966;5360;1446;4286;281;910;349;1024;630;1934
411580;202007;4628;10617;2736;7682;400;1383;496;1270;896;2653
411585;202007;638;1899;275;899;65;228;50;142;115;370
411590;202007;385;1061;259;786;31;94;135;380;166;474
411600;202007;297;756;188;584;39;123;55;160;94;283
411605;202007;1566;3635;976;2678;125;437;510;1366;635;1803
411610;202007;2531;6054;1779;4681;74;246;1182;2882;1256;3128
411620;202007;2778;7414;2348;6735;402;1213;1277;3653;1679;4866
411630;202007;745;1943;495;1457;76;272;179;473;255;745
411640;202007;464;1217;323;913;47;150;118;302;165;452
411650;202007;197;581;125;419;24;86;22;59;46;145
411660;202007;919;2317;665;1852;54;160;294;788;348;948
411670;202007;1358;3332;914;2446;101;297;424;1055;525;1352
411680;202007;1435;3833;1051;3072;137;455;468;1315;605;1770
411690;202007;3708;9481;2769;7829;589;1702;816;2444;1405;4146
411695;202007;648;1986;407;1327;49;176;171;522;220;698
411700;202007;1654;4290;1053;3132;222;718;157;441;379;1159
411705;202007;1870;5811;1577;5305;297;960;904;3266;1201;4226
411710;202007;1941;4941;1319;3780;295;869;253;710;548;1579
411720;202007;1064;2477;753;1931;150;403;288;692;438;1095
411721;202007;976;2480;720;1995;147;406;174;484;321;890
411722;202007;821;2182;456;1321;66;222;175;417;241;639
411725;202007;1168;3273;794;2529;184;631;173;564;357;1195
411727;202007;1481;4121;949;2962;218;709;171;501;389;1210
411729;202007;691;1667;430;1166;50;187;164;384;214;571
411730;202007;5150;13725;3955;11362;823;2534;1671;4717;2494;7251
411740;202007;536;1380;265;795;54;146;59;156;113;302
411745;202007;763;2168;503;1576;76;255;76;177;152;432
411750;202007;5214;13749;3771;10909;509;1602;1842;5002;2351;6604
411760;202007;6627;17772;5058;15018;1687;5200;994;3274;2681;8474
411770;202007;2963;8589;2143;6761;521;1750;318;937;839;2687
411780;202007;2747;7750;2327;6947;642;2007;785;2360;1427;4367
411790;202007;2783;6751;1468;4355;316;1072;228;582;544;1654
411800;202007;985;2788;713;2180;123;389;147;427;270;816
411810;202007;1590;4122;1184;3303;198;565;550;1442;748;2007
411820;202007;11017;31689;8839;27800;2187;7365;3726;11442;5913;18807
411830;202007;578;1426;432;1179;81;244;98;286;179;530
411840;202007;11810;31569;7825;23206;1358;4351;2050;5563;3408;9914
411845;202007;555;1601;301;975;37;143;67;188;104;331
411850;202007;7176;18380;4817;14196;1218;4038;795;2142;2013;6180
411860;202007;662;1875;474;1477;69;219;128;360;197;579
411870;202007;581;1691;398;1271;85;305;98;273;183;578
411880;202007;2236;5607;1624;4613;224;728;567;1543;791;2271
411885;202007;1041;2658;731;2105;105;356;234;614;339;970
411890;202007;1334;3546;925;2779;159;533;98;282;257;815
411900;202007;804;2216;488;1527;110;377;78;220;188;597
411910;202007;928;2748;664;2175;165;607;236;708;401;1315
411915;202007;15106;37006;9925;27563;1468;4591;3883;9642;5351;14233
411920;202007;1090;3213;906;2812;200;720;324;922;524;1642
411925;202007;465;1225;327;973;70;237;129;359;199;596
411930;202007;4885;15095;4091;13551;1762;6361;269;1049;2031;7410
411940;202007;3222;9627;2456;7917;601;2020;765;2223;1366;4243
411950;202007;13903;37515;11348;33276;1599;5309;6595;18521;8194;23830
411960;202007;5795;15648;4555;13100;843;2678;1722;4682;2565;7360
411965;202007;462;1277;327;996;50;168;138;384;188;552
411970;202007;1082;2525;832;2188;169;420;363;1083;532;1503
411980;202007;1461;3640;1045;2948;256;737;381;1037;637;1774
411990;202007;38303;100471;24029;73889;4482;15226;8186;24048;12668;39274
411995;202007;3284;8104;2459;6818;713;2223;685;1786;1398;4009
412000;202007;1920;4425;1347;3452;31;99;956;2298;987;2397
412010;202007;580;1812;421;1460;70;255;118;354;188;609
412015;202007;540;1517;438;1334;56;182;259;785;315;967
412020;202007;446;1242;273;860;43;161;112;328;155;489
412030;202007;611;1710;432;1377;75;250;127;392;202;642
412033;202007;909;2399;646;1853;88;260;232;580;320;840
412035;202007;758;2047;479;1527;52;204;259;777;311;981
412040;202007;577;1551;360;1112;53;153;65;201;118;354
412050;202007;1635;4086;1099;3090;223;706;269;750;492;1456
412060;202007;7229;21144;5993;18652;1587;5618;1718;5074;3305;10692
412065;202007;609;1679;440;1332;100;324;108;327;208;651
412070;202007;1144;2949;897;2456;111;328;367;925;478;1253
412080;202007;2083;5882;1353;4327;202;680;282;795;484;1475
412085;202007;301;725;102;315;12;40;19;45;31;85
412090;202007;5738;15017;4238;12173;1110;3322;1488;4363;2598;7685
412100;202007;1580;4330;1181;3582;348;1155;258;851;606;2006
412110;202007;811;2122;553;1600;80;238;185;507;265;745
412120;202007;1947;5669;1494;4763;293;1037;436;1196;729;2233
412125;202007;640;1818;446;1410;93;303;124;371;217;674
412130;202007;795;2022;535;1519;79;244;143;409;222;653
412135;202007;622;1656;281;854;42;130;94;254;136;384
412140;202007;1667;4066;1094;3054;200;679;223;584;423;1263
412150;202007;2721;7200;2295;6442;334;1082;1387;3659;1721;4741
412160;202007;935;2888;515;1755;94;341;85;257;179;598
412170;202007;4299;11845;3586;10694;735;2400;1459;4014;2194;6414
412175;202007;1273;3673;1053;3290;224;724;459;1454;683;2178
412180;202007;1620;4474;1164;3610;145;524;535;1534;680;2058
412190;202007;3330;8339;2446;6777;329;990;1063;2928;1392;3918
412200;202007;1685;5039;1204;3908;326;1165;193;571;519;1736
412210;202007;603;1453;355;1003;48;153;132;336;180;489
412215;202007;3292;8936;2585;7551;645;1839;1098;3541;1743;5380
412217;202007;959;2512;809;2245;55;165;539;1448;594;1613
412220;202007;5923;16325;4700;14069;1230;3630;1460;4679;2690;8309
412230;202007;2611;7727;2066;6654;359;1305;554;1536;913;2841
412240;202007;6932;17791;4344;12736;767;2444;1295;3437;2062;5881
412250;202007;2009;5200;1490;4209;354;1063;337;881;691;1944
412260;202007;1198;3221;848;2460;148;460;261;709;409;1169
412265;202007;889;2425;697;2091;144;445;288;826;432;1271
412270;202007;986;2686;627;1924;81;283;242;657;323;940
412280;202007;396;1112;310;972;62;207;96;276;158;483
412290;202007;1007;2571;676;1967;105;332;215;579;320;911
412300;202007;1645;4252;1128;3323;248;771;246;749;494;1520
412310;202007;742;2056;596;1772;89;317;223;615;312;932
412320;202007;847;2197;546;1565;59;203;181;521;240;724
412330;202007;1528;4130;1012;3116;196;671;340;1071;536;1742
412340;202007;1130;3172;689;2181;100;372;117;334;217;706
412350;202007;2770;7172;1745;5138;352;1092;313;834;665;1926
412360;202007;270;743;182;541;5;26;109;302;114;328
412370;202007;867;2472;581;1847;115;415;51;168;166;583
412380;202007;1505;4100;1055;3178;287;894;135;472;422;1366
412382;202007;513;1280;335;986;45;161;139;343;184;504
412385;202007;2145;5918;1731;5106;537;1506;538;1767;1075;3273
412390;202007;2406;5821;1936;5100;312;821;747;1991;1059;2812
412395;202007;678;1939;470;1460;55;153;202;639;257;792
412400;202007;905;2424;642;1909;125;412;179;530;304;942
412402;202007;1947;4811;1296;3703;321;946;172;492;493;1438
412405;202007;2967;7820;1914;5816;493;1794;51;147;544;1941
412410;202007;5899;15267;4321;12662;770;2608;1427;3942;2197;6550
412420;202007;518;1326;333;957;23;83;162;407;185;490
412430;202007;596;1489;308;888;33;112;121;324;154;436
412440;202007;2665;7297;1763;5533;436;1477;279;904;715;2381
412450;202007;427;1246;284;877;47;142;25;61;72;203
412460;202007;1005;2644;785;2263;143;451;368;1040;511;1491
412470;202007;1455;4729;1184;4095;303;1100;256;892;559;1992
412480;202007;1035;2759;672;1947;121;378;199;507;320;885
412490;202007;1292;3264;1030;2780;123;330;520;1331;643;1661
412500;202007;1883;4749;1395;3827;301;816;405;1069;706;1885
412510;202007;1881;5787;1284;4238;291;1033;125;341;416;1374
412520;202007;1197;3134;629;1881;154;459;56;171;210;630
412530;202007;710;1871;515;1466;79;245;109;309;188;554
412535;202007;785;2041;525;1534;85;268;111;272;196;540
412540;202007;1201;3061;861;2423;96;343;280;826;376;1169
412545;202007;676;1741;469;1305;67;188;179;483;246;671
412550;202007;32052;85821;22301;66021;3765;12174;8797;23812;12562;35986
412555;202007;290;771;189;545;20;59;55;123;75;182
412560;202007;4595;13434;3348;10470;582;1995;987;3081;1569;5076
412570;202007;4401;11200;2485;7436;515;1737;301;1001;816;2738
412575;202007;989;2497;783;2136;94;285;425;1084;519;1369
412580;202007;1429;3758;1001;2923;87;308;530;1489;617;1797
412590;202007;418;1104;228;719;32;106;22;53;54;159
412600;202007;1561;4251;1159;3429;188;639;490;1348;678;1987
412610;202007;787;2055;553;1547;57;157;292;738;349;895
412620;202007;1231;3223;931;2753;188;631;271;759;459;1390
412625;202007;8667;22973;5232;16037;726;2532;344;938;1070;3470
412627;202007;1132;3167;708;2277;135;465;191;618;326;1083
412630;202007;2823;8270;1990;6421;389;1268;604;1785;993;3053
412635;202007;383;1042;262;775;38;130;91;221;129;351
412640;202007;1020;2706;564;1724;68;206;161;447;229;653
412650;202007;1629;4490;1294;3791;218;706;496;1266;714;1972
412660;202007;2372;6064;1643;4656;272;832;495;1247;767;2079
412665;202007;378;972;290;806;44;135;139;372;183;507
412667;202007;1693;4474;1253;3616;177;544;503;1393;680;1937
412670;202007;829;1958;552;1505;95;292;173;438;268;730
412680;202007;1868;4991;1269;3813;173;597;450;1197;623;1794
412690;202007;1080;2866;789;2291;127;400;310;843;437;1243
412700;202007;1951;5187;1602;4630;190;646;880;2454;1070;3100
412710;202007;5828;17052;4323;13763;852;3080;1218;3422;2070;6502
412720;202007;1155;3392;879;2773;143;482;174;462;317;944
412730;202007;2354;6286;1553;4637;288;955;528;1474;816;2429
412740;202007;1836;5123;1232;3854;220;808;167;515;387;1323
412750;202007;3838;10103;3165;9137;307;1073;2085;5662;2392;6735
412760;202007;2867;7800;2364;6940;436;1446;1261;3478;1697;4924
412770;202007;10010;25224;5200;15654;733;2331;1185;3058;1918;5389
412780;202007;1172;3110;862;2533;190;604;339;974;529;1578
412785;202007;2024;4922;1406;3843;142;399;908;2429;1050;2828
412788;202007;1314;3679;1075;3258;291;885;459;1360;750;2245
412790;202007;1324;3502;731;2257;116;410;230;625;346;1035
412795;202007;1268;3277;660;2030;101;328;132;373;233;701
412796;202007;2191;6331;1792;5542;377;1225;587;1688;964;2913
412800;202007;3498;8475;2363;6371;273;836;1081;2579;1354;3415
412810;202007;11363;28896;7111;20186;873;2901;2765;6954;3638;9855
412820;202007;6376;17458;4448;13550;1074;3463;1278;3891;2352;7354
412830;202007;354;998;246;765;37;111;60;180;97;291
412840;202007;1817;4580;1277;3518;141;438;550;1387;691;1825
412850;202007;2817;7413;2021;5998;328;1044;842;2460;1170;3504
412853;202007;1514;3810;1250;3338;178;520;636;1519;814;2039
412855;202007;1236;3295;794;2342;139;480;228;634;367;1114
412860;202007;780;1911;528;1511;73;234;290;786;363;1020
412862;202007;698;1704;461;1304;87;252;195;526;282;778
412863;202007;1255;3793;1121;3541;207;670;654;2049;861;2719
412865;202007;715;1946;519;1548;130;386;150;471;280;857
412870;202007;850;2194;615;1811;168;559;121;383;289;942
412880;202007;827;2234;545;1647;89;311;91;247;180;558
420005;202007;403;1192;235;813;34;124;105;366;139;490
420010;202007;3267;7961;2158;6092;131;420;1583;4490;1714;4910
420020;202007;435;1366;281;971;45;183;64;177;109;360
420030;202007;73;247;53;204;17;73;17;60;34;133
420040;202007;515;1545;293;1043;59;234;16;41;75;275
420050;202007;711;1647;463;1196;68;202;284;668;352;870
420055;202007;159;487;88;314;22;98;27;81;49;179
420060;202007;102;275;57;170;11;34;14;32;25;66
420070;202007;679;2076;506;1704;109;385;198;647;307;1032
420075;202007;80;201;40;119;7;25;15;30;22;55
420080;202007;337;985;266;822;67;228;106;326;173;554
420090;202007;409;1274;241;860;52;194;44;133;96;327
420100;202007;1217;3213;1004;2885;51;182;810;2290;861;2472
420110;202007;237;762;215;714;44;170;100;306;144;476
420120;202007;523;1418;346;1037;67;229;157;401;224;630
420125;202007;342;1051;241;827;60;218;97;321;157;539
420127;202007;260;704;95;314;15;55;23;75;38;130
420130;202007;3136;8656;2356;7312;366;1365;1134;3201;1500;4566
420140;202007;3439;9291;2414;7487;672;2378;333;1036;1005;3414
420150;202007;660;1682;451;1320;45;151;270;768;315;919
420160;202007;201;490;77;245;10;30;20;63;30;93
420165;202007;153;437;87;281;19;66;27;75;46;141
420170;202007;264;821;176;602;21;62;51;157;72;219
420180;202007;174;546;103;370;12;41;30;98;42;139
420190;202007;199;633;122;432;37;145;32;109;69;254
420195;202007;1376;3538;987;2908;307;1068;112;244;419;1312
420200;202007;4266;10402;2493;7061;338;1177;992;2414;1330;3591
420205;202007;1687;4570;1133;3474;166;537;623;1910;789;2447
420207;202007;1667;4372;1014;3122;196;693;404;1156;600;1849
420208;202007;314;889;182;642;57;220;47;157;104;377
420209;202007;149;497;89;307;22;86;29;95;51;181
420210;202007;2923;7498;1896;5812;344;1183;896;2686;1240;3869
420213;202007;753;2345;628;2084;138;500;309;1002;447;1502
420215;202007;180;549;122;415;29;106;27;86;56;192
420220;202007;250;731;149;503;25;101;68;203;93;304
420230;202007;4745;12995;3557;10743;541;1780;1874;5468;2415;7248
420240;202007;12888;35556;7959;24279;1036;3613;3898;10478;4934;14091
420243;202007;367;1056;287;891;46;164;171;502;217;666
420245;202007;1213;3130;852;2507;64;233;519;1460;583;1693
420250;202007;423;1185;348;1055;53;180;195;551;248;731
420253;202007;479;1183;340;982;34;113;193;551;227;664
420257;202007;158;409;100;305;18;67;50;151;68;218
420260;202007;1056;2787;762;2372;127;448;471;1439;598;1887
420270;202007;502;1321;244;722;32;104;113;333;145;437
420280;202007;1099;3302;830;2745;163;615;282;897;445;1512
420285;202007;117;236;48;138;10;41;10;20;20;61
420287;202007;424;986;300;813;81;221;109;302;190;523
420290;202007;4575;13041;3487;10570;461;1628;2061;5751;2522;7379
420300;202007;6995;19667;3982;12625;750;2647;1138;3174;1888;5821
420310;202007;789;1818;390;1081;40;127;215;554;255;681
420315;202007;756;2136;519;1709;112;386;205;680;317;1066
420320;202007;4897;13462;3521;11095;1005;3514;886;2571;1891;6085
420325;202007;279;783;194;609;30;101;91;258;121;359
420330;202007;939;2739;592;1997;110;424;176;519;286;943
420340;202007;941;2611;699;2173;163;535;107;288;270;823
420350;202007;1133;2999;824;2438;70;239;574;1664;644;1903
420360;202007;2712;7501;1454;4731;279;980;129;422;408;1402
420370;202007;1051;2831;845;2495;87;303;573;1624;660;1927
420380;202007;4246;11177;2789;8550;587;1912;1035;3058;1622;4970
420390;202007;1063;2541;723;1851;131;409;299;518;430;927
420395;202007;991;2835;668;2177;103;393;89;221;192;614
420400;202007;961;2734;652;2062;120;426;239;709;359;1135
420410;202007;537;1460;412;1200;43;133;276;780;319;913
420415;202007;282;834;215;686;56;200;81;258;137;458
420417;202007;587;1757;463;1495;127;414;164;543;291;957
420419;202007;136;477;104;400;37;149;8;30;45;179
420420;202007;10698;27759;7032;21050;1995;6789;1921;5220;3916;12009
420425;202007;645;1722;423;1271;41;142;206;596;247;738
420430;202007;3051;8216;1755;5348;422;1342;561;1575;983;2917
420435;202007;243;618;116;376;17;60;56;174;73;234
420440;202007;723;1979;435;1351;112;387;173;495;285;882
420445;202007;259;637;166;466;30;86;77;205;107;291
420450;202007;651;1890;465;1489;85;330;170;472;255;802
420455;202007;1934;4779;1380;3928;192;667;693;1856;885;2523
420460;202007;8680;23194;6353;18892;947;3152;3232;9195;4179;12347
420470;202007;596;1559;319;1008;59;217;65;172;124;389
420475;202007;76;196;30;94;10;30;3;11;13;41
420480;202007;5333;13135;3193;9539;651;2132;1061;3159;1712;5291
420490;202007;342;961;246;767;53;187;99;300;152;487
420500;202007;1380;3837;878;2872;155;565;379;1234;534;1799
420510;202007;156;437;86;272;10;42;24;66;34;108
420515;202007;61;159;37;105;4;22;17;37;21;59
420517;202007;751;2072;652;1897;52;153;483;1425;535;1578
420519;202007;291;705;211;589;25;76;122;354;147;430
420520;202007;299;806;151;505;26;91;12;41;38;132
420530;202007;786;2285;529;1732;87;336;196;552;283;888
420535;202007;230;679;92;317;12;46;40;128;52;174
420540;202007;34616;82068;21653;60172;3266;10331;7420;17636;10686;27967
420543;202007;204;617;156;501;20;72;82;243;102;315
420545;202007;1077;3205;805;2605;151;534;315;920;466;1454
420550;202007;3374;8990;2103;6824;345;1293;864;2855;1209;4148
420555;202007;288;827;191;616;24;86;111;342;135;428
420560;202007;386;960;256;764;53;173;143;418;196;591
420570;202007;2136;5900;1659;4999;297;1025;720;2078;1017;3103
420580;202007;1827;4645;1290;3817;295;940;436;1327;731;2267
420590;202007;2720;7208;1558;4698;285;1035;412;942;697;1977
420600;202007;977;2842;736;2368;103;390;417;1279;520;1669
420610;202007;349;1010;191;643;43;152;65;226;108;378
420620;202007;719;1770;473;1360;103;314;191;541;294;855
420630;202007;869;2618;628;2024;86;304;365;1111;451;1415
420640;202007;477;1292;224;764;72;241;21;74;93;315
420650;202007;3457;9090;2046;6111;293;961;786;2025;1079;2986
420660;202007;427;1095;268;765;50;149;72;183;122;332
420665;202007;575;1507;362;1137;65;238;163;453;228;691
420670;202007;1277;3515;815;2575;138;525;309;865;447;1390
420675;202007;162;458;92;313;14;63;45;138;59;201
420680;202007;322;755;162;529;31;116;83;256;114;372
420690;202007;843;2499;503;1680;71;293;128;354;199;647
420700;202007;2531;6660;1873;5540;236;768;1051;3008;1287;3776
420710;202007;864;2515;653;2054;65;269;389;1123;454;1392
420720;202007;1192;3314;845;2698;177;595;408;1247;585;1842
420730;202007;2939;7639;2148;6320;350;1136;1149;3247;1499;4383
420740;202007;514;1554;300;1064;87;332;25;106;112;438
420750;202007;1864;5427;1207;3882;213;801;479;1410;692;2211
420757;202007;78;196;41;130;4;8;19;57;23;65
420760;202007;341;1011;161;506;36;122;43;118;79;240
420765;202007;453;1307;199;675;26;107;90;295;116;402
420768;202007;1323;3709;1133;3385;145;435;828;2461;973;2896
420770;202007;450;1213;221;749;39;150;91;284;130;434
420775;202007;268;813;181;603;40;148;49;137;89;285
420780;202007;909;2514;551;1727;110;381;98;263;208;644
420785;202007;192;504;132;374;14;47;67;159;81;206
420790;202007;980;2993;718;2450;118;475;381;1229;499;1704
420800;202007;629;1589;293;898;85;298;69;195;154;493
420810;202007;1375;4289;1107;3753;316;1220;362;1045;678;2265
420820;202007;11284;28054;7948;22580;1531;4910;3669;9522;5200;14432
420830;202007;3701;9738;2722;7934;495;1579;1169;3314;1664;4893
420840;202007;458;1335;212;771;63;257;25;77;88;334
420845;202007;2288;5859;1360;4176;260;985;543;1553;803;2538
420850;202007;1027;3299;627;2251;116;460;117;368;233;828
420860;202007;290;740;152;496;31;112;43;125;74;237
420870;202007;763;2114;571;1753;145;525;244;677;389;1202
420880;202007;969;2986;747;2518;154;621;283;878;437;1499
420890;202007;7717;20885;4706;14634;702;2433;1659;4563;2361;6996
420895;202007;163;473;102;314;27;83;31;97;58;180
420900;202007;1456;3576;859;2522;116;415;399;1016;515;1431
420910;202007;27450;72310;16830;51633;2565;8951;6639;18244;9204;27195
420915;202007;518;1864;375;1449;55;212;198;787;253;999
420917;202007;330;812;167;458;29;84;83;226;112;310
420920;202007;76;201;28;98;0;0;5;16;5;16
420930;202007;15988;41773;11124;33150;2051;6810;4867;13745;6918;20555
420940;202007;2793;6837;1601;4749;399;1353;302;727;701;2080
420945;202007;130;371;102;309;24;85;42;115;66;200
420950;202007;329;959;176;586;28;114;44;130;72;244
420960;202007;976;2387;694;1901;122;400;302;719;424;1119
420970;202007;2334;6444;1628;5095;463;1519;430;1321;893;2840
420980;202007;264;871;228;796;112;398;62;227;174;625
420985;202007;297;849;142;506;35;137;45;138;80;275
420990;202007;300;931;159;570;30;107;34;108;64;215
421000;202007;525;1573;367;1219;81;284;100;299;181;583
421003;202007;468;1113;159;466;9;26;26;66;35;92
421005;202007;54;153;42;135;9;30;20;63;29;93
421010;202007;3052;8392;2181;6771;455;1616;573;1563;1028;3179
421020;202007;352;1097;270;945;44;184;138;457;182;641
421030;202007;719;2192;552;1835;167;629;171;526;338;1155
421040;202007;648;1532;407;1166;27;92;251;708;278;800
421050;202007;971;2608;628;1830;128;417;238;604;366;1021
421055;202007;169;457;91;278;13;44;54;151;67;195
421060;202007;608;1753;425;1332;80;289;200;559;280;848
421070;202007;625;1849;354;1168;73;265;108;343;181;608
421080;202007;491;1406;408;1248;43;154;250;756;293;910
421085;202007;362;1029;119;421;18;58;14;34;32;92
421090;202007;243;621;152;439;9;34;51;132;60;166
421100;202007;802;1794;329;1000;98;344;84;209;182;553
421105;202007;1498;4138;1018;3136;181;573;453;1324;634;1897
421110;202007;1039;2736;856;2502;20;59;636;1966;656;2025
421120;202007;903;2758;669;2220;102;374;220;666;322;1040
421125;202007;288;762;206;610;73;237;73;181;146;418
421130;202007;4725;13842;3867;12137;912;3276;1944;5706;2856;8982
421140;202007;331;899;189;583;32;99;59;165;91;264
421145;202007;427;1191;273;855;65;227;99;278;164;505
421150;202007;618;1677;391;1226;63;232;201;594;264;826
421160;202007;505;1350;358;1072;48;158;235;681;283;839
421165;202007;199;580;126;411;24;84;54;169;78;253
421170;202007;1045;2756;823;2412;136;390;499;1507;635;1897
421175;202007;980;2462;589;1849;114;400;253;773;367;1173
421180;202007;373;970;200;615;37;142;77;215;114;357
421185;202007;307;825;208;619;27;93;123;362;150;455
421187;202007;269;816;168;556;31;103;56;176;87;279
421189;202007;345;1002;263;842;43;151;101;299;144;450
421190;202007;10487;28391;6984;21734;1312;4480;2449;7022;3761;11502
421200;202007;610;1786;489;1557;53;193;313;968;366;1161
421205;202007;182;479;133;397;25;93;58;151;83;244
421210;202007;1042;2680;605;1924;129;419;233;746;362;1165
421220;202007;1289;3876;985;3226;232;830;304;910;536;1740
421223;202007;322;901;197;665;47;156;91;313;138;469
421225;202007;865;2544;724;2299;127;451;431;1358;558;1809
421227;202007;620;1790;395;1299;79;286;172;576;251;862
421230;202007;579;1521;363;1120;65;236;141;423;206;659
421240;202007;268;799;127;459;11;45;20;69;31;114
421250;202007;1893;4795;1333;3891;151;525;778;2153;929;2678
421260;202007;180;528;49;185;15;68;9;31;24;99
421265;202007;637;1663;567;1572;7;23;527;1454;534;1477
421270;202007;323;856;137;489;19;63;53;182;72;245
421280;202007;1730;4709;1279;3928;189;709;726;2099;915;2808
421290;202007;958;2590;491;1498;87;284;116;326;203;610
421300;202007;273;705;138;437;13;49;22;63;35;112
421310;202007;177;502;118;388;24;82;62;207;86;289
421315;202007;219;603;135;420;43;116;29;102;72;218
421320;202007;631;1932;325;1108;38;120;40;99;78;219
421330;202007;572;1705;413;1371;84;323;114;358;198;681
421335;202007;333;1015;274;911;66;249;115;370;181;619
421340;202007;1319;3657;936;2915;174;630;391;1113;565;1743
421350;202007;1410;3666;932;2828;183;638;394;1101;577;1739
421360;202007;2179;5875;1265;3993;233;892;489;1338;722;2230
421370;202007;614;2004;371;1336;65;237;105;326;170;563
421380;202007;782;2088;669;1908;90;288;394;1084;484;1372
421390;202007;165;444;58;196;14;42;21;60;35;102
421400;202007;299;964;212;755;37;145;110;373;147;518
421410;202007;208;570;91;323;22;87;28;83;50;170
421415;202007;177;529;103;329;21;66;21;63;42;129
421420;202007;527;1425;426;1237;45;141;268;759;313;900
421430;202007;100;307;75;246;8;28;20;59;28;87
421440;202007;584;1579;350;1151;72;234;151;485;223;719
421450;202007;429;1278;249;852;32;135;42;148;74;283
421460;202007;360;1072;195;713;25;100;38;117;63;217
421470;202007;247;723;143;491;29;102;52;187;81;289
421480;202007;2678;7205;1735;5324;367;1328;659;1833;1026;3161
421490;202007;114;393;68;260;6;26;16;40;22;66
421500;202007;2028;5981;1408;4706;379;1482;336;976;715;2458
421505;202007;277;789;228;719;35;125;146;445;181;570
421507;202007;412;1175;219;742;54;192;75;241;129;433
421510;202007;294;829;181;555;27;90;99;276;126;366
421520;202007;488;1273;311;878;26;77;186;478;212;555
421530;202007;298;892;172;601;30;135;51;146;81;281
421535;202007;378;990;231;726;37;138;119;355;156;493
421540;202007;283;666;133;407;18;59;47;126;65;185
421545;202007;664;1970;494;1657;110;440;237;739;347;1179
421550;202007;1982;5294;1594;4707;295;896;908;2675;1203;3571
421555;202007;164;495;65;222;10;36;8;19;18;55
421560;202007;79;258;53;198;10;36;17;57;27;93
421565;202007;873;2264;570;1776;146;501;153;481;299;982
421567;202007;420;1382;271;952;97;360;66;209;163;569
421568;202007;329;985;245;790;34;123;111;345;145;468
421569;202007;153;441;74;240;14;50;37;114;51;164
421570;202007;1086;2952;770;2348;179;621;215;607;394;1228
421575;202007;287;832;208;624;30;104;90;232;120;336
421580;202007;3695;10192;2409;7472;394;1447;949;2495;1343;3942
421590;202007;135;418;109;358;33;121;30;80;63;201
421600;202007;545;1478;369;1108;78;264;116;292;194;556
421605;202007;718;1857;505;1509;88;235;262;839;350;1074
421610;202007;1024;2783;668;2101;113;383;213;646;326;1029
421620;202007;3759;9960;2176;7034;467;1715;602;1844;1069;3559
421625;202007;127;352;56;179;13;44;13;39;26;83
421630;202007;2325;6130;1426;4352;250;900;475;1198;725;2098
421635;202007;247;672;176;521;17;54;107;291;124;345
421640;202007;694;1861;496;1554;97;346;211;644;308;990
421650;202007;2269;6180;1458;4656;346;1314;451;1195;797;2509
421660;202007;9472;26374;6536;20692;1019;3572;2856;8289;3875;11861
421670;202007;725;2100;506;1581;87;300;251;765;338;1065
421680;202007;998;2743;747;2288;194;645;362;1016;556;1661
421690;202007;1229;3547;829;2694;163;599;302;973;465;1572
421700;202007;486;1434;304;1012;65;235;96;301;161;536
421710;202007;199;635;88;296;18;65;23;70;41;135
421715;202007;102;286;79;234;18;48;47;135;65;183
421720;202007;1811;4912;1053;3284;269;908;283;765;552;1673
421725;202007;233;568;120;369;21;72;51;120;72;192
421730;202007;400;1155;207;621;26;85;104;291;130;376
421740;202007;675;1898;461;1427;109;351;134;376;243;727
421750;202007;830;1966;375;1115;87;285;135;360;222;645
421755;202007;151;417;87;262;15;59;46;119;61;178
421760;202007;905;2355;595;1790;94;323;234;596;328;919
421770;202007;2353;6259;1691;5091;433;1290;607;1984;1040;3274
421775;202007;203;518;122;363;16;49;56;156;72;205
421780;202007;778;2305;496;1691;102;403;199;632;301;1035
421790;202007;756;1958;431;1380;93;312;216;669;309;981
421795;202007;175;479;124;362;22;76;44;118;66;194
421800;202007;2361;6406;1688;5153;213;769;967;2794;1180;3563
421810;202007;594;1637;403;1275;49;186;237;729;286;915
421820;202007;897;2607;504;1642;103;382;154;394;257;776
421825;202007;1278;3644;1133;3418;122;394;793;2345;915;2739
421830;202007;1950;5800;1577;5094;322;1105;669;2101;991;3206
421835;202007;205;505;122;364;22;81;36;99;58;180
421840;202007;208;667;137;497;29;111;35;117;64;228
421850;202007;359;1000;191;642;36;129;57;153;93;282
421860;202007;299;837;158;546;22;86;54;170;76;256
421870;202007;3976;10033;2830;7898;488;1625;1389;3440;1877;5065
421875;202007;264;794;109;360;17;65;29;77;46;142
421880;202007;550;1574;359;1146;93;348;86;270;179;618
421885;202007;203;583;123;395;30;94;29;88;59;182
421890;202007;815;2471;603;2038;113;457;310;983;423;1440
421895;202007;392;992;325;904;39;124;222;638;261;762
421900;202007;969;2543;702;1993;100;331;323;835;423;1166
421910;202007;290;855;198;637;31;125;57;156;88;281
421915;202007;361;1018;196;632;45;142;31;92;76;234
421917;202007;556;1306;309;986;111;387;76;256;187;643
421920;202007;365;1124;263;920;107;393;70;236;177;629
421930;202007;2483;6278;1243;3864;293;1040;386;1036;679;2076
421935;202007;389;1232;308;1052;59;213;171;563;230;776
421940;202007;347;1004;162;516;25;87;40;110;65;197
421950;202007;2867;7185;1567;4766;310;1039;380;1019;690;2058
421960;202007;171;440;89;284;18;71;20;54;38;125
421970;202007;1815;4652;1070;3152;215;750;399;986;614;1736
421985;202007;274;736;158;507;16;52;60;180;76;232
422000;202007;1895;4927;1525;4313;161;534;1044;2903;1205;3437
430003;202007;557;1524;364;1158;64;222;156;494;220;716
430005;202007;259;677;163;504;30;100;73;215;103;315
430010;202007;1679;4074;1328;3529;138;411;936;2413;1074;2824
430020;202007;579;1324;435;1128;44;136;284;711;328;847
430030;202007;976;2302;532;1503;128;413;166;437;294;850
430040;202007;10113;24251;5893;16770;1554;4806;677;2055;2231;6861
430045;202007;495;1230;335;937;25;79;225;620;250;699
430047;202007;249;541;94;261;27;79;27;73;54;152
430050;202007;848;2137;485;1403;107;325;121;327;228;652
430055;202007;247;611;114;337;15;56;64;170;79;226
430057;202007;81;173;31;82;6;21;10;22;16;43
430060;202007;16404;43901;12525;37780;2635;8434;5752;17275;8387;25709
430063;202007;839;2336;664;1968;126;374;359;1063;485;1437
430064;202007;987;2708;723;2162;214;654;281;822;495;1476
430066;202007;94;199;67;159;6;13;53;121;59;134
430070;202007;731;1857;94;310;7;26;18;52;25;78
430080;202007;821;2022;502;1395;78;261;264;639;342;900
430085;202007;825;1880;495;1349;98;278;210;562;308;840
430087;202007;601;1514;503;1380;61;153;348;969;409;1122
430090;202007;531;1352;179;554;11;43;64;188;75;231
430100;202007;749;1798;444;1219;78;255;203;477;281;732
430105;202007;1152;3069;748;2368;126;461;362;1103;488;1564
430107;202007;163;474;93;293;19;69;26;68;45;137
430110;202007;2097;5266;1521;4406;238;743;823;2357;1061;3100
430120;202007;1140;3397;734;2377;127;437;336;1086;463;1523
430130;202007;3406;7851;2482;6546;899;2398;434;1399;1333;3797
430140;202007;871;2374;607;1868;149;443;288;868;437;1311
430150;202007;559;1434;300;917;65;216;104;306;169;522
430155;202007;247;631;111;338;17;48;24;67;41;115
430160;202007;19059;44824;14586;38433;1735;4979;8541;22320;10276;27299
430163;202007;2877;6908;1998;5489;87;288;1425;3854;1512;4142
430165;202007;303;747;85;277;14;31;14;39;28;70
430170;202007;919;2419;327;1129;54;200;52;165;106;365
430175;202007;643;1936;539;1709;134;433;252;785;386;1218
430180;202007;628;1520;495;1304;57;148;344;902;401;1050
430185;202007;562;1406;286;834;77;209;62;163;139;372
430187;202007;663;1500;464;1249;75;215;238;683;313;898
430190;202007;1374;3635;1104;3206;224;698;518;1432;742;2130
430192;202007;127;339;41;123;6;18;10;26;16;44
430195;202007;409;1213;60;210;5;14;11;33;16;47
430200;202007;1052;3145;840;2760;278;949;239;808;517;1757
430205;202007;451;1178;394;1079;13;42;340;908;353;950
430210;202007;5236;13369;3514;9702;610;1834;1220;2760;1830;4594
430215;202007;304;780;191;550;38;116;71;208;109;324
430220;202007;629;1565;185;622;25;103;39;97;64;200
430222;202007;176;495;128;392;13;48;46;134;59;182
430223;202007;238;626;185;536;17;52;118;338;135;390
430225;202007;17;34;12;26;1;2;9;19;10;21
430230;202007;1840;5046;1550;4593;135;449;1161;3380;1296;3829
430235;202007;324;919;210;667;47;178;67;181;114;359
430237;202007;500;1195;361;961;20;59;264;684;284;743
430240;202007;1230;2850;689;1906;85;293;365;923;450;1216
430245;202007;699;1980;532;1655;151;489;248;790;399;1279
430250;202007;889;2212;642;1824;226;707;45;114;271;821
430258;202007;128;337;94;272;6;10;50;152;56;162
430260;202007;646;1704;440;1307;61;198;244;717;305;915
430265;202007;202;577;130;431;29;90;42;142;71;232
430270;202007;2772;6888;2175;5947;395;1195;1284;3396;1679;4591
430280;202007;4925;11615;3363;8916;690;1856;1433;3762;2123;5618
430290;202007;2167;5011;1757;4529;47;160;1506;3794;1553;3954
430300;202007;9434;24090;7061;19869;1114;3424;3729;10236;4843;13660
430310;202007;11585;28741;7686;21392;997;3096;3706;9586;4703;12682
430320;202007;980;2555;522;1625;64;192;283;898;347;1090
430330;202007;668;1628;408;1110;72;215;176;421;248;636
430340;202007;703;1530;383;1045;53;157;224;592;277;749
430350;202007;7453;18905;5513;15418;770;2327;3175;8466;3945;10793
430355;202007;323;853;107;349;17;58;14;38;31;96
430360;202007;847;1987;535;1446;103;316;216;542;319;858
430367;202007;307;707;168;458;31;96;92;241;123;337
430370;202007;474;1279;215;662;40;133;55;144;95;277
430380;202007;691;1703;332;1031;74;273;98;285;172;558
430390;202007;3033;7321;1723;4883;318;1031;256;519;574;1550
430400;202007;1040;2223;798;1882;69;185;548;1243;617;1428
430410;202007;526;1269;357;991;56;165;217;582;273;747
430420;202007;2571;7071;1960;5717;514;1575;847;2349;1361;3924
430430;202007;573;1466;267;826;63;188;60;198;123;386
430435;202007;1440;3663;1097;3105;199;602;560;1595;759;2197
430440;202007;3574;9793;2741;8290;293;999;1656;4964;1949;5963
430450;202007;6527;16460;5158;14027;793;2396;2733;7159;3526;9555
430460;202007;30712;78044;22339;64115;3945;12563;11127;30461;15072;43024
430461;202007;282;728;86;269;12;40;32;86;44;126
430462;202007;231;631;128;422;20;67;48;160;68;227
430463;202007;5730;15069;4234;12395;843;2741;1922;5373;2765;8114
430465;202007;409;1059;341;939;53;166;214;564;267;730
430466;202007;3995;10046;3082;8556;753;2183;1420;3738;2173;5921
430467;202007;492;1180;348;949;48;156;189;476;237;632
430468;202007;1201;2982;923;2561;83;252;598;1626;681;1878
430469;202007;552;1492;66;211;6;19;12;18;18;37
430470;202007;5403;13790;3535;10429;1044;3390;907;2482;1951;5872
430471;202007;519;1475;419;1290;60;208;243;707;303;915
430480;202007;733;1951;408;1258;53;184;93;252;146;436
430485;202007;168;439;65;198;18;47;6;24;24;71
430490;202007;363;948;204;610;26;94;98;265;124;359
430495;202007;372;986;233;714;33;105;111;324;144;429
430500;202007;948;2450;644;1940;208;683;179;486;387;1169
430510;202007;24457;63870;17405;49945;2902;9494;7971;20966;10873;30460
430511;202007;319;918;132;424;16;54;19;54;35;108
430512;202007;942;2126;725;1803;168;421;269;685;437;1106
430513;202007;758;1903;346;1011;49;156;171;472;220;628
430515;202007;366;1034;259;816;32;94;138;438;170;532
430517;202007;1126;3408;821;2688;146;478;398;1344;544;1822
430520;202007;1265;3235;648;1905;116;362;145;384;261;746
430530;202007;952;2387;367;1128;69;211;98;286;167;497
430535;202007;3406;8758;2448;6993;350;1058;1238;3395;1588;4453
430537;202007;319;1110;299;1053;20;64;240;845;260;909
430540;202007;610;1467;345;1005;61;173;158;463;219;636
430543;202007;749;1331;411;948;53;106;191;492;244;598
430544;202007;709;1991;495;1514;120;387;178;527;298;914
430545;202007;2212;5754;1633;4844;332;1013;805;2461;1137;3474
430550;202007;346;947;249;745;46;147;99;272;145;419
430558;202007;111;255;48;130;7;14;18;52;25;66
430560;202007;333;751;140;423;21;70;48;139;69;209
430570;202007;828;2009;577;1546;96;292;303;764;399;1056
430580;202007;818;2044;579;1664;144;441;250;710;394;1151
430583;202007;195;483;32;103;2;7;9;23;11;30
430585;202007;230;557;114;305;18;55;49;113;67;168
430587;202007;196;540;143;431;17;55;62;184;79;239
430590;202007;1378;3298;1129;2928;53;161;938;2380;991;2541
430593;202007;16;54;11;36;1;3;5;16;6;19
430595;202007;425;1065;113;370;12;49;19;45;31;94
430597;202007;432;1116;226;684;22;68;74;174;96;242
430600;202007;1951;4948;865;2448;161;490;232;584;393;1074
430605;202007;1143;3060;833;2473;106;368;398;1127;504;1495
430607;202007;526;1223;427;1062;28;74;311;764;339;838
430610;202007;5669;13271;3769;10352;1070;3318;824;2218;1894;5536
430613;202007;253;591;70;201;9;28;17;36;26;64
430620;202007;599;1458;436;1150;63;190;252;607;315;797
430630;202007;400;1107;109;357;18;59;22;66;40;125
430632;202007;469;1231;196;601;24;80;90;261;114;341
430635;202007;526;1250;387;1015;47;125;275;725;322;850
430637;202007;452;1100;350;948;40;126;220;567;260;693
430640;202007;1053;2747;643;1918;93;287;230;632;323;919
430642;202007;350;951;262;750;43;114;140;377;183;491
430645;202007;151;354;56;149;8;21;19;48;27;69
430650;202007;1567;4524;1245;3990;339;1093;579;1938;918;3031
430655;202007;271;684;163;458;24;79;79;191;103;270
430660;202007;5135;13146;3858;10973;837;2499;1672;4713;2509;7212
430670;202007;644;1565;486;1284;34;97;291;776;325;873
430673;202007;529;1201;211;608;38;113;79;209;117;322
430675;202007;239;688;56;199;8;28;24;86;32;114
430676;202007;4840;11979;3802;10384;460;1385;2408;6393;2868;7778
430680;202007;893;2415;551;1717;154;485;133;407;287;892
430690;202007;2792;7586;2183;6474;746;2327;590;1663;1336;3990
430692;202007;217;667;165;572;12;41;124;440;136;481
430693;202007;936;2472;556;1708;105;375;146;404;251;779
430695;202007;428;1107;236;698;32;83;124;355;156;438
430697;202007;384;968;290;820;74;194;143;437;217;631
430700;202007;6905;16978;3991;11533;831;2618;817;2149;1648;4767
430705;202007;397;965;193;584;21;74;82;216;103;290
430710;202007;1608;3499;1116;2824;145;407;673;1675;818;2082
430720;202007;669;1616;340;1034;47;143;174;534;221;677
430730;202007;1003;2738;684;2124;95;280;360;1111;455;1391
430740;202007;591;1600;299;979;53;179;70;242;123;421
430745;202007;358;987;224;692;44;157;69;182;113;339
430750;202007;1321;3362;913;2662;199;601;463;1327;662;1928
430755;202007;443;1073;269;723;20;57;155;384;175;441
430760;202007;2006;4910;1508;4136;351;1044;673;1751;1024;2795
430770;202007;5965;14907;4545;12777;585;1891;2885;7833;3470;9724
430780;202007;1811;4406;1022;3033;201;659;396;1131;597;1790
430781;202007;455;1266;245;768;33;102;73;195;106;297
430783;202007;354;818;211;599;20;68;130;343;150;411
430786;202007;35;126;25;94;3;9;3;15;6;24
430790;202007;4242;10364;2914;8073;328;1082;1780;4602;2108;5684
430800;202007;739;1724;541;1420;35;97;358;943;393;1040
430805;202007;356;961;217;653;16;58;135;382;151;440
430807;202007;459;1126;239;700;27;78;97;266;124;344
430810;202007;678;1590;273;803;31;118;118;318;149;436
430820;202007;1178;3139;682;2162;138;455;204;634;342;1089
430825;202007;231;580;78;204;12;30;22;53;34;83
430830;202007;1664;4745;1332;4104;64;219;956;2912;1020;3131
430840;202007;1002;2480;704;1969;100;292;474;1306;574;1598
430843;202007;129;300;54;147;3;11;27;68;30;79
430845;202007;426;1027;286;789;54;163;120;316;174;479
430850;202007;2248;5845;1508;4388;239;769;588;1728;827;2497
430860;202007;868;2009;373;1062;46;162;179;436;225;598
430865;202007;508;1260;375;1033;73;201;174;474;247;675
430870;202007;602;1565;254;795;39;145;83;222;122;367
430880;202007;1446;3286;969;2558;159;433;518;1342;677;1775
430885;202007;180;487;93;314;8;29;57;188;65;217
430890;202007;968;2407;640;1843;55;236;139;378;194;614
430900;202007;3015;6598;2063;5214;175;520;1359;3227;1534;3747
430905;202007;732;1870;454;1336;83;278;169;460;252;738
430910;202007;1572;4169;1102;3207;187;637;542;1399;729;2036
430912;202007;486;1349;324;1024;25;76;222;714;247;790
430915;202007;470;1429;354;1206;129;437;95;335;224;772
430920;202007;22518;57056;16967;47708;2297;7132;10167;27834;12464;34966
430925;202007;94;211;34;101;5;13;16;49;21;62
430930;202007;10037;23782;6283;17941;1215;3541;2577;7688;3792;11229
430940;202007;964;2514;569;1664;146;454;148;370;294;824
430950;202007;750;1754;475;1276;37;132;298;730;335;862
430955;202007;338;901;87;262;21;65;24;57;45;122
430957;202007;176;602;161;563;25;90;100;346;125;436
430960;202007;1305;3119;721;2036;156;470;309;845;465;1315
430965;202007;1601;3788;1229;3201;70;185;938;2500;1008;2685
430970;202007;349;834;169;479;22;68;83;210;105;278
430975;202007;495;1467;379;1198;81;275;197;590;278;865
430980;202007;383;869;221;594;28;91;103;248;131;339
430990;202007;529;1514;323;1019;41;130;158;499;199;629
430995;202007;553;1407;399;1156;45;141;219;621;264;762
431000;202007;1325;3111;523;1517;88;282;44;116;132;398
431010;202007;2097;5421;1298;4042;261;900;275;724;536;1624
431020;202007;7870;17049;4583;12085;1045;3125;1539;3514;2584;6639
431030;202007;318;874;155;524;26;94;22;70;48;164
431033;202007;3614;8486;2280;6373;505;1430;802;2278;1307;3708
431036;202007;339;742;78;223;8;24;24;56;32;80
431040;202007;875;2245;563;1684;88;295;253;699;341;994
431041;202007;459;1057;334;869;27;67;202;520;229;587
431043;202007;333;832;180;552;39;134;87;264;126;398
431046;202007;104;271;41;123;4;9;10;30;14;39
431050;202007;1314;3203;932;2588;173;530;464;1306;637;1836
431053;202007;626;1696;349;1084;75;269;115;314;190;583
431055;202007;579;1421;487;1280;59;142;342;901;401;1043
431057;202007;234;668;116;383;26;85;33;99;59;184
431060;202007;5270;13563;3508;10476;846;2766;932;2726;1778;5492
431065;202007;405;1013;283;804;48;151;135;375;183;526
431070;202007;428;1186;240;761;55;188;59;180;114;368
431075;202007;216;622;132;428;29;104;36;117;65;221
431080;202007;557;1514;376;1122;62;219;134;375;196;594
431085;202007;738;1916;460;1276;62;173;231;623;293;796
431087;202007;401;1140;324;976;22;63;225;701;247;764
431090;202007;408;955;158;479;28;95;44;137;72;232
431100;202007;3330;7285;2266;5861;324;846;1156;3049;1480;3895
431110;202007;1362;3127;910;2356;272;731;338;801;610;1532
431112;202007;578;1606;482;1418;67;225;298;839;365;1064
431113;202007;366;1004;315;905;49;157;194;542;243;699
431115;202007;936;2684;722;2283;101;388;410;1211;511;1599
431120;202007;2417;6618;1626;4986;488;1692;367;1018;855;2710
431123;202007;404;1094;256;774;48;125;138;440;186;565
431125;202007;971;2767;737;2303;266;801;255;863;521;1664
431127;202007;202;526;61;197;8;26;13;38;21;64
431130;202007;2891;7389;2093;6036;307;1017;1176;3291;1483;4308
431140;202007;5129;12117;3011;8106;366;1093;1369;3197;1735;4290
431142;202007;497;1323;366;1086;48;147;223;663;271;810
431150;202007;1005;2689;708;2131;130;420;304;882;434;1302
431160;202007;632;1808;419;1329;70;241;127;394;197;635
431162;202007;504;1212;279;800;29;96;154;408;183;504
431164;202007;175;398;39;118;9;29;5;11;14;40
431170;202007;458;1275;319;975;95;292;90;262;185;554
431171;202007;643;1511;516;1337;112;261;304;817;416;1078
431173;202007;391;1041;290;887;76;261;120;346;196;607
431175;202007;1214;2820;733;1988;118;324;273;697;391;1021
431177;202007;785;2131;596;1826;130;459;357;1039;487;1498
431179;202007;333;730;95;282;18;54;22;62;40;116
431180;202007;2106;5317;1269;3668;323;930;353;1007;676;1937
431190;202007;470;1212;241;713;28;90;95;229;123;319
431198;202007;344;998;281;887;107;354;73;254;180;608
431200;202007;359;896;76;210;15;43;11;30;26;73
431205;202007;193;529;97;311;23;77;38;120;61;197
431210;202007;597;1475;475;1304;123;337;215;629;338;966
431213;202007;248;660;185;542;12;39;96;289;108;328
431215;202007;565;1334;245;707;22;64;125;348;147;412
431217;202007;151;389;101;298;11;34;56;156;67;190
431220;202007;530;1375;310;939;30;109;175;489;205;598
431225;202007;1484;3517;1127;2917;113;313;779;2023;892;2336
431230;202007;678;1927;525;1577;68;216;320;930;388;1146
431235;202007;153;389;23;80;4;10;5;21;9;31
431237;202007;311;984;254;850;49;177;131;420;180;597
431238;202007;26;65;21;55;5;16;8;13;13;29
431240;202007;4278;10554;3305;9025;468;1445;1945;5055;2413;6500
431242;202007;237;643;202;588;42;129;106;300;148;429
431244;202007;318;768;167;467;24;83;62;143;86;226
431245;202007;1273;2971;792;2126;75;221;419;1067;494;1288
431247;202007;258;667;144;429;30;101;53;135;83;236
431250;202007;1643;4102;1205;3507;260;795;621;1890;881;2685
431260;202007;231;636;150;480;23;84;49;150;72;234
431261;202007;235;717;187;638;15;59;102;330;117;389
431262;202007;366;1013;177;573;10;27;118;387;128;414
431265;202007;1559;3680;616;1793;77;268;218;554;295;822
431267;202007;274;728;167;485;8;35;119;313;127;348
431270;202007;2732;6161;1447;3986;334;958;477;1312;811;2270
431275;202007;118;340;59;191;23;72;11;37;34;109
431280;202007;230;614;69;218;5;18;6;12;11;30
431290;202007;303;882;196;608;37;134;38;83;75;217
431295;202007;69;174;20;62;3;8;5;16;8;24
431300;202007;285;732;52;161;5;17;13;27;18;44
431301;202007;306;865;66;213;7;16;6;17;13;33
431303;202007;561;1480;330;978;24;85;152;419;176;504
431306;202007;2185;5086;1272;3555;184;591;553;1353;737;1944
431308;202007;26;79;23;73;11;37;10;31;21;68
431310;202007;529;1480;369;1121;51;162;162;454;213;616
431320;202007;623;1703;312;1020;45;135;60;168;105;303
431330;202007;1652;3860;793;2262;149;483;313;805;462;1288
431333;202007;216;574;108;318;19;55;39;108;58;163
431335;202007;40;108;21;64;4;8;3;7;7;15
431337;202007;2568;6794;1858;5612;346;1183;965;2803;1311;3986
431339;202007;406;1055;295;847;84;247;119;339;203;586
431340;202007;18570;44832;12611;34761;2166;6621;5573;14411;7739;21032
431342;202007;412;889;299;729;17;34;261;642;278;676
431344;202007;388;980;227;672;10;36;125;354;135;390
431346;202007;237;580;91;289;15;53;25;76;40;129
431349;202007;636;1657;331;975;82;239;118;342;200;581
431350;202007;3847;9993;2798;8155;409;1360;1471;4122;1880;5482
431360;202007;559;1323;274;773;85;243;69;193;154;436
431365;202007;1981;4656;1560;4081;124;366;1165;3013;1289;3379
431370;202007;4320;10511;3053;8411;639;1837;1510;4264;2149;6101
431380;202007;775;2081;624;1837;36;114;440;1295;476;1409
431390;202007;2579;6265;1537;4389;163;559;754;1884;917;2443
431395;202007;1265;3146;887;2561;204;606;389;1160;593;1766
431400;202007;319;889;171;535;30;90;40;121;70;211
431402;202007;843;1898;604;1534;76;206;405;1004;481;1210
431403;202007;192;540;147;446;24;85;68;181;92;266
431405;202007;4414;11557;3346;9764;591;1926;1638;4541;2229;6467
431406;202007;530;1498;380;1184;79;237;195;629;274;866
431407;202007;432;1207;297;920;65;224;149;440;214;664
431410;202007;15775;39847;10119;29656;1521;5136;4991;13684;6512;18820
431413;202007;223;590;59;195;7;25;8;28;15;53
431415;202007;660;1621;407;1195;76;266;196;514;272;780
431417;202007;533;1179;362;918;56;160;204;507;260;667
431420;202007;1574;3532;1174;2974;168;437;659;1653;827;2090
431430;202007;538;1382;251;791;42;143;76;209;118;352
431440;202007;29483;69014;20218;54326;3464;10059;7875;19910;11339;29969
431442;202007;112;312;54;183;10;32;10;29;20;61
431445;202007;381;1068;118;380;15;42;10;28;25;70
431446;202007;263;778;196;640;36;130;98;307;134;437
431447;202007;713;1889;409;1234;86;288;140;421;226;709
431449;202007;749;1964;447;1326;88;243;179;549;267;792
431450;202007;2211;4552;1736;3886;86;206;1356;2961;1442;3167
431454;202007;32;100;27;88;7;22;9;28;16;50
431455;202007;604;1440;296;798;36;105;150;363;186;468
431460;202007;2760;6768;1946;5306;512;1481;539;1487;1051;2968
431470;202007;1392;3917;999;3077;196;614;435;1367;631;1981
431475;202007;250;671;48;169;5;18;6;13;11;31
431477;202007;397;1029;232;687;44;127;93;245;137;372
431478;202007;254;666;51;164;11;29;8;19;19;48
431480;202007;3090;7681;2408;6607;567;1563;1221;3391;1788;4954
431490;202007;107522;252937;80786;211668;5941;18411;58593;147575;64534;165986
431500;202007;463;1172;338;933;59;166;183;487;242;653
431505;202007;268;641;183;513;11;35;129;360;140;395
431507;202007;338;795;131;388;41;130;36;99;77;229
431510;202007;1537;3964;1024;2961;218;683;359;1030;577;1713
431513;202007;201;436;113;295;9;19;79;208;88;227
431514;202007;103;262;71;203;4;11;52;142;56;153
431515;202007;459;1141;324;897;74;206;158;439;232;645
431517;202007;61;182;48;149;7;20;22;65;29;85
431520;202007;409;997;156;486;23;83;66;175;89;258
431530;202007;4088;8699;2299;6034;534;1419;553;1468;1087;2887
431531;202007;207;513;123;350;13;39;56;145;69;184
431532;202007;544;1259;319;856;68;206;124;322;192;528
431535;202007;245;650;112;347;22;70;26;72;48;142
431540;202007;1754;5645;1627;5470;54;225;1327;4470;1381;4695
431545;202007;338;868;64;195;6;15;13;39;19;54
431550;202007;1998;5074;1479;4092;249;762;747;1970;996;2732
431555;202007;646;1465;400;1050;26;81;237;611;263;692
431560;202007;22013;53519;14818;42152;3063;9159;4938;14801;8001;23960
431570;202007;4372;10566;3475;9262;402;1194;2447;6244;2849;7438
431575;202007;242;606;184;504;65;159;46;136;111;295
431580;202007;584;1510;348;1026;40;146;191;531;231;677
431590;202007;572;1589;432;1300;92;292;169;521;261;813
431595;202007;355;962;227;681;49;146;90;244;139;390
431600;202007;1366;3125;930;2491;230;671;365;987;595;1658
431610;202007;1354;3485;916;2675;136;385;472;1418;608;1803
431620;202007;470;1198;213;616;36;104;81;225;117;329
431630;202007;1303;3239;604;1786;99;316;213;576;312;892
431640;202007;6171;14699;5193;13474;506;1351;3863;10084;4369;11435
431642;202007;541;1328;335;907;25;65;162;406;187;471
431643;202007;372;913;179;503;18;45;56;159;74;204
431645;202007;1799;4021;1390;3464;61;191;1114;2736;1175;2927
431647;202007;263;641;82;234;9;21;25;62;34;83
431650;202007;112;305;74;241;5;19;44;130;49;149
431660;202007;863;2299;427;1382;72;272;118;331;190;603
431670;202007;1124;2669;689;1871;103;298;352;900;455;1198
431673;202007;233;595;81;274;13;44;16;52;29;96
431675;202007;523;1312;110;367;11;41;22;64;33;105
431680;202007;7363;18871;5274;14941;1224;3634;2250;6206;3474;9840
431690;202007;22936;56033;14903;41554;3058;9132;5853;16206;8911;25338
431695;202007;162;388;102;299;23;78;52;131;75;209
431697;202007;449;1058;346;897;49;115;204;543;253;658
431700;202007;1310;3397;1097;3009;160;409;663;1805;823;2214
431710;202007;12558;30145;8629;24441;1507;4604;4267;12228;5774;16832
431720;202007;6216;15385;3609;10281;888;2677;714;1792;1602;4469
431725;202007;31;88;24;74;4;11;10;30;14;41
431730;202007;3844;9217;2348;6827;549;1700;720;2233;1269;3933
431740;202007;4966;11803;3192;8773;855;2722;814;1881;1669;4603
431750;202007;7204;18469;5415;15574;1215;3770;2298;6493;3513;10263
431755;202007;319;875;69;243;9;35;10;35;19;70
431760;202007;5247;11749;3478;8918;395;1156;2073;5023;2468;6179
431770;202007;1866;4370;1444;3802;96;290;1088;2789;1184;3079
431775;202007;197;514;101;313;21;64;13;37;34;101
431780;202007;2012;5011;1270;3615;216;690;529;1438;745;2128
431790;202007;783;2119;559;1682;100;293;252;741;352;1034
431795;202007;230;584;112;334;25;66;29;81;54;147
431800;202007;8014;19225;4848;14123;1278;4329;520;1580;1798;5909
431805;202007;292;685;87;281;7;25;30;96;37;121
431810;202007;3220;7612;2003;5382;381;1070;857;2200;1238;3270
431820;202007;2107;5675;1641;4919;454;1438;567;1788;1021;3226
431830;202007;8920;19220;6508;16008;1647;4770;1988;4865;3635;9635
431840;202007;2476;6537;1957;5683;314;908;1205;3531;1519;4439
431842;202007;535;1351;184;565;25;81;61;167;86;248
431843;202007;330;880;242;691;31;101;120;315;151;416
431844;202007;197;506;61;192;13;44;20;64;33;108
431845;202007;515;1351;357;1034;31;88;210;606;241;694
431846;202007;275;712;230;645;9;29;206;577;215;606
431848;202007;102;262;63;189;9;29;12;29;21;58
431849;202007;411;992;63;184;5;9;8;21;13;30
431850;202007;4052;10980;3085;9033;723;2292;980;2855;1703;5147
431860;202007;624;1511;344;971;58;172;189;513;247;685
431861;202007;96;262;53;165;10;37;17;47;27;84
431862;202007;433;1369;354;1232;67;257;180;598;247;855
431870;202007;19060;48594;15253;42542;1836;5748;9358;25147;11194;30895
431880;202007;3917;10056;2733;7915;433;1436;1252;3436;1685;4872
431890;202007;4451;11167;2706;7821;758;2411;472;1526;1230;3937
431900;202007;948;2396;605;1765;98;320;310;852;408;1172
431910;202007;743;1788;266;752;41;117;82;188;123;305
431912;202007;465;1275;360;1088;70;224;206;614;276;838
431915;202007;1014;2506;793;2143;27;86;610;1611;637;1697
431920;202007;1201;2806;992;2528;31;78;852;2164;883;2242
431930;202007;657;1753;442;1355;142;400;186;604;328;1004
431935;202007;83;230;57;177;15;51;12;37;27;88
431936;202007;299;864;161;517;34;114;62;182;96;296
431937;202007;165;412;101;277;16;49;46;101;62;150
431940;202007;2939;6975;1677;4663;189;568;822;2194;1011;2762
431950;202007;1747;4612;1387;4019;444;1318;514;1462;958;2780
431960;202007;2871;7016;2070;5553;577;1634;523;1397;1100;3031
431970;202007;413;1043;165;475;37;106;46;115;83;221
431971;202007;83;214;33;108;2;8;4;8;6;16
431973;202007;470;1507;386;1344;37;137;284;984;321;1121
431975;202007;110;226;22;70;1;4;2;6;3;10
431980;202007;993;2592;762;2208;157;477;357;1001;514;1478
431990;202007;5516;13233;3673;10558;484;1677;1775;4868;2259;6545
432000;202007;10945;26106;7902;21351;1901;5223;3421;9332;5322;14555
432010;202007;2132;5237;1548;4212;237;720;897;2300;1134;3020
432020;202007;1743;4474;1068;3071;229;685;446;1223;675;1908
432023;202007;496;1192;256;726;34;110;120;299;154;409
432026;202007;936;2627;683;2133;175;551;235;734;410;1285
432030;202007;354;869;201;557;22;62;116;314;138;376
432032;202007;333;855;229;651;27;87;126;337;153;424
432035;202007;643;1831;556;1681;172;527;231;724;403;1251
432040;202007;1028;2372;367;1128;60;205;126;347;186;552
432045;202007;159;442;96;313;22;70;33;116;55;186
432050;202007;475;1190;350;972;78;216;141;416;219;632
432055;202007;576;1557;373;1167;129;408;74;218;203;626
432057;202007;222;592;164;448;25;61;67;167;92;228
432060;202007;450;1088;139;432;33;111;43;115;76;226
432065;202007;209;589;147;452;30;90;61;188;91;278
432067;202007;714;2072;598;1816;56;192;448;1305;504;1497
432070;202007;1626;4298;1046;3146;235;779;334;904;569;1683
432080;202007;4431;10520;3378;8832;583;1780;1595;3927;2178;5707
432085;202007;339;871;229;701;61;191;90;287;151;478
432090;202007;1506;3822;979;2794;193;588;476;1259;669;1847
432100;202007;911;2333;442;1370;89;302;86;214;175;516
432110;202007;1998;5331;1336;4121;321;1123;128;360;449;1483
432120;202007;2696;7300;2058;6194;391;1299;804;2309;1195;3608
432130;202007;2482;6356;2040;5704;587;1677;916;2605;1503;4282
432132;202007;178;505;106;346;20;65;49;137;69;202
432135;202007;994;2334;650;1745;38;118;468;1241;506;1359
432140;202007;1547;4633;1164;3850;171;596;691;2283;862;2879
432143;202007;1377;3594;1051;3085;68;217;698;2036;766;2253
432145;202007;1550;4074;959;2814;133;426;334;833;467;1259
432146;202007;98;268;64;209;22;77;21;62;43;139
432147;202007;469;1329;272;900;90;321;71;200;161;521
432149;202007;438;1071;219;617;15;47;110;279;125;326
432150;202007;3013;7657;2175;6159;463;1463;846;2331;1309;3794
432160;202007;5020;13238;3643;11011;899;3010;1314;3773;2213;6783
432162;202007;254;555;35;98;7;17;6;15;13;32
432163;202007;119;292;24;64;0;0;3;4;3;4
432166;202007;592;1660;445;1349;88;294;145;396;233;690
432170;202007;1352;3600;863;2679;158;537;331;943;489;1480
432180;202007;2924;6956;1612;4442;306;887;580;1405;886;2292
432183;202007;360;1051;238;759;59;209;65;188;124;397
432185;202007;796;2052;466;1398;41;138;246;691;287;829
432190;202007;1801;4381;1167;3356;198;627;591;1599;789;2226
432195;202007;883;2223;576;1670;163;443;198;608;361;1051
432200;202007;3134;8021;2231;6554;382;1135;1229;3661;1611;4796
432210;202007;375;988;228;696;41;158;104;267;145;425
432215;202007;613;1795;553;1703;54;147;409;1282;463;1429
432218;202007;247;612;110;310;15;53;52;132;67;185
432220;202007;3432;8122;2534;6696;448;1257;1376;3563;1824;4820
432225;202007;88;249;66;204;10;33;38;117;48;150
432230;202007;698;1628;371;1010;40;114;167;409;207;523
432232;202007;480;1179;298;862;60;183;107;283;167;466
432234;202007;267;665;121;354;21;53;14;38;35;91
432235;202007;49;139;17;55;5;17;4;13;9;30
432237;202007;322;826;280;756;11;22;231;613;242;635
432240;202007;15213;37754;10877;31877;814;2573;6877;21170;7691;23743
432250;202007;5003;14394;3792;11978;995;3281;1566;4904;2561;8185
432252;202007;440;1047;272;751;35;103;141;373;176;476
432253;202007;881;2714;546;1851;128;462;47;149;175;611
432254;202007;682;1606;170;507;27;85;30;77;57;162
432255;202007;109;276;56;170;3;9;27;73;30;82
432260;202007;4704;12106;3457;9729;994;2886;1113;3012;2107;5898
432270;202007;1725;4836;1363;4132;404;1326;280;791;684;2117
432280;202007;1319;3277;668;1973;99;306;249;611;348;917
432285;202007;142;429;21;64;2;6;2;4;4;10
432290;202007;330;929;177;558;60;195;33;74;93;269
432300;202007;25502;64387;18867;53532;2736;8768;10908;29837;13644;38605
432310;202007;817;2196;585;1757;58;176;401;1205;459;1381
432320;202007;214;502;77;236;8;29;29;79;37;108
432330;202007;228;508;65;211;8;20;11;35;19;55
432335;202007;182;504;63;220;5;21;15;50;20;71
432340;202007;303;725;134;416;11;32;50;144;61;176
432345;202007;663;1529;582;1429;18;49;478;1158;496;1207
432350;202007;342;895;184;582;27;89;74;234;101;323
432360;202007;235;684;47;154;4;7;17;58;21;65
432370;202007;304;751;200;571;15;49;135;377;150;426
432375;202007;467;1169;342;923;61;158;173;470;234;628
432377;202007;179;558;32;108;7;28;6;16;13;44
432380;202007;1615;4287;1037;3219;179;638;525;1554;704;2192
500020;202007;2471;6417;1772;5225;157;551;1098;3131;1255;3682
500025;202007;1202;2945;748;2086;71;213;404;1070;475;1283
500060;202007;7731;21801;5223;16547;648;2136;3010;9801;3658;11937
500070;202007;4186;10834;2876;8576;533;1622;1232;3765;1765;5387
500080;202007;1534;3802;944;2706;180;573;363;917;543;1490
500085;202007;2026;5046;1375;3954;319;965;645;1781;964;2746
500090;202007;2113;5608;1414;4370;247;809;485;1588;732;2397
500100;202007;3534;9010;2671;7602;450;1443;1304;3514;1754;4957
500110;202007;7956;20300;5042;15613;1072;3645;1519;5533;2591;9178
500124;202007;2011;5918;1592;5201;254;777;841;2896;1095;3673
500150;202007;1298;2954;805;2233;139;406;331;916;470;1322
500190;202007;4715;12193;2961;8771;638;1930;753;2147;1391;4077
500200;202007;2223;5291;1626;4286;177;486;988;2499;1165;2985
500210;202007;4540;11074;3205;9302;855;2467;1404;4176;2259;6643
500215;202007;1352;3772;961;3046;94;325;524;1643;618;1968
500220;202007;2536;7129;1599;5305;274;987;399;1269;673;2256
500230;202007;2015;4732;1512;4027;177;439;1014;2683;1191;3122
500240;202007;3823;11297;2673;8880;408;1520;1046;3570;1454;5090
500260;202007;3185;6780;1989;5139;278;725;1030;2557;1308;3282
500270;202007;135188;317443;79754;222583;13301;40845;29339;76873;42640;117718
500280;202007;1303;3289;886;2642;125;394;483;1413;608;1807
500290;202007;3551;8409;2010;5815;322;1069;646;1682;968;2751
500295;202007;3374;8184;2082;5872;328;1018;797;1934;1125;2952
500310;202007;948;1974;631;1571;98;211;322;833;420;1044
500315;202007;3662;10189;2869;8988;243;788;2025;6481;2268;7269
500320;202007;19226;51640;13246;41694;3349;11093;4527;15149;7876;26242
500325;202007;4221;9428;2882;7646;224;630;1952;5224;2176;5854
500330;202007;6624;15106;4331;11736;352;1054;2362;6559;2714;7613
500345;202007;2041;5023;1356;3957;319;967;451;1303;770;2270
500348;202007;2328;6033;1775;5090;244;715;1018;2971;1262;3686
500350;202007;1282;3495;707;2246;87;277;286;871;373;1148
500370;202007;25228;64965;17528;52252;2323;7942;9167;27093;11490;35035
500375;202007;2415;6357;1583;4653;294;938;526;1444;820;2382
500380;202007;3359;8401;2269;6536;633;1973;531;1543;1164;3516
500390;202007;596;1208;354;919;55;176;213;521;268;697
500400;202007;1460;3706;965;2742;175;577;332;833;507;1410
500410;202007;2373;5854;1659;4772;179;507;950;2862;1129;3369
500430;202007;2553;6262;1707;4989;220;754;733;2258;953;3012
500440;202007;1198;2920;748;2214;117;380;283;888;400;1268
500450;202007;1426;3535;782;2350;136;429;196;551;332;980
500460;202007;3605;9709;2178;6856;355;1277;687;2110;1042;3387
500470;202007;2419;6523;1453;4512;408;1411;315;855;723;2266
500480;202007;2087;6346;1759;5816;170;581;1300;4370;1470;4951
500490;202007;1045;2406;609;1753;126;445;166;472;292;917
500500;202007;4175;11181;2646;8657;927;3573;448;1507;1375;5080
500510;202007;673;1724;431;1261;26;91;266;757;292;848
500515;202007;1710;4376;1304;3726;139;434;822;2250;961;2684
500520;202007;3157;9738;2426;8373;635;2233;968;3564;1603;5797
500525;202007;856;2560;702;2323;58;203;444;1491;502;1694
500540;202007;4398;11437;2631;8287;685;2690;246;689;931;3379
500560;202007;5387;14635;4302;13265;280;874;3447;10815;3727;11689
500568;202007;4215;9207;2517;6678;595;1724;884;2352;1479;4076
500570;202007;7500;17494;4509;12379;819;2440;1654;4256;2473;6696
500580;202007;2979;7951;2157;6490;476;1493;997;3015;1473;4508
500600;202007;3355;8348;2368;6795;529;1570;981;2873;1510;4443
500620;202007;7676;20188;5121;15276;1076;3356;1846;5360;2922;8716
500625;202007;538;1470;338;1038;62;202;90;252;152;454
500627;202007;753;1946;447;1394;76;258;147;449;223;707
500630;202007;6512;15080;3735;10427;770;2352;1098;3077;1868;5429
500635;202007;2850;8947;2205;8097;162;652;1529;6131;1691;6783
500640;202007;1689;3712;1109;2938;39;123;760;1984;799;2107
500660;202007;17358;44732;11850;36681;3708;13043;2977;9469;6685;22512
500690;202007;2272;6356;1477;4964;521;2036;78;193;599;2229
500710;202007;2756;7431;2115;6318;600;1893;659;1862;1259;3755
500720;202007;4746;12041;3059;9222;701;2246;918;2842;1619;5088
500730;202007;1060;2631;580;1751;112;314;141;460;253;774
500740;202007;4511;10765;3052;8434;398;1138;1581;4380;1979;5518
500750;202007;950;2448;625;1846;84;249;242;653;326;902
500755;202007;889;2326;481;1533;82;283;98;282;180;565
500769;202007;4991;12233;2692;7888;513;1702;378;893;891;2595
500770;202007;1463;3951;938;3010;167;612;321;1018;488;1630
500780;202007;1189;2885;764;2174;159;503;199;538;358;1041
500790;202007;7005;18624;5409;15946;1111;3526;2651;7861;3762;11387
500793;202007;2005;5169;1412;4124;356;1116;454;1225;810;2341
500795;202007;2660;6598;2157;5962;103;255;1733;5052;1836;5307
500797;202007;676;1711;444;1278;126;377;137;395;263;772
500800;202007;3140;7128;1880;5240;580;1918;209;633;789;2551
500830;202007;18075;45249;12224;34425;2544;7706;4428;11791;6972;19497
500840;202007;1368;3341;833;2332;99;287;332;878;431;1165
510010;202007;1777;4018;1173;3235;106;272;837;2349;943;2621
510020;202007;3319;8417;1750;5336;372;1220;396;1087;768;2307
510025;202007;6508;15920;3946;11717;584;1971;1629;4680;2213;6651
510030;202007;2471;5544;1621;4270;338;912;626;1610;964;2522
510035;202007;1197;3127;751;2410;85;294;446;1521;531;1815
510040;202007;2273;5060;1660;4262;173;433;1029;2760;1202;3193
510050;202007;2061;4341;1349;3414;150;413;938;2332;1088;2745
510060;202007;1294;3284;935;2705;196;624;267;723;463;1347
510080;202007;1205;3184;768;2442;265;877;210;576;475;1453
510100;202007;641;1501;442;1186;55;153;233;603;288;756
510120;202007;269;490;147;346;10;22;107;256;117;278
510125;202007;2003;4954;1563;4320;160;574;831;2149;991;2723
510130;202007;1408;3547;979;2859;202;649;308;920;510;1569
510140;202007;3031;7839;2057;6608;736;2762;722;2182;1458;4944
510160;202007;1691;4357;1235;3764;161;470;895;2795;1056;3265
510170;202007;4379;11571;3174;9622;772;2468;1237;3835;2009;6303
510180;202007;14396;32312;8997;24330;1970;5842;2688;8222;4658;14064
510185;202007;1655;4300;1083;3482;437;1430;278;1155;715;2585
510190;202007;2030;5810;1302;4567;358;1382;231;885;589;2267
510250;202007;16384;41548;12139;35196;2339;7085;6124;18480;8463;25565
510260;202007;1877;7911;1551;7318;262;1333;939;4826;1201;6159
510263;202007;3042;8448;1862;6051;308;1128;278;783;586;1911
510267;202007;4757;13519;2694;8915;494;1735;368;1092;862;2827
510268;202007;1226;2995;926;2541;110;291;608;1663;718;1954
510269;202007;988;2682;602;1946;144;514;186;554;330;1068
510270;202007;2842;8137;1941;6493;344;1275;794;2627;1138;3902
510279;202007;1728;4459;1066;3293;200;689;439;1313;639;2002
510285;202007;1105;2895;749;2278;235;806;159;433;394;1239
510300;202007;3604;9118;2637;7805;371;1146;1545;4778;1916;5924
510305;202007;1409;3866;850;2777;186;649;195;714;381;1363
510310;202007;901;2209;601;1704;169;497;170;506;339;1003
510320;202007;3591;8917;2445;6938;555;1731;618;1730;1173;3461
510325;202007;4164;12308;3103;10359;892;3139;941;3254;1833;6393
510330;202007;2646;8003;1782;6465;349;1267;661;2776;1010;4043
510335;202007;4699;13512;3538;11645;536;1907;2010;6795;2546;8702
510336;202007;432;1218;307;1017;50;167;152;557;202;724
510337;202007;1479;4291;945;3319;364;1404;186;664;550;2068
510340;202007;89249;198388;55866;149639;13537;43037;16408;41229;29945;84266
510343;202007;1003;2756;680;2155;121;437;288;865;409;1302
510345;202007;1232;3533;925;2928;156;491;418;1300;574;1791
510350;202007;2754;7138;1791;5493;384;1261;714;2139;1098;3400
510360;202007;1844;3836;1182;3057;69;135;816;2282;885;2417
510370;202007;1735;4901;1251;4066;173;618;734;2485;907;3103
510380;202007;550;1357;303;929;55;193;115;345;170;538
510385;202007;1198;4006;876;3398;93;415;551;2208;644;2623
510390;202007;1239;3288;835;2763;249;833;277;1076;526;1909
510395;202007;708;1606;471;1255;27;74;292;828;319;902
510410;202007;4651;13002;3364;10691;657;2174;1733;5711;2390;7885
510420;202007;2405;5066;1628;4033;131;349;1054;2595;1185;2944
510450;202007;422;1052;247;717;59;173;38;125;97;298
510452;202007;747;2079;529;1670;74;252;303;932;377;1184
510454;202007;927;2551;709;2176;76;233;434;1395;510;1628
510455;202007;903;2501;646;1980;108;361;256;727;364;1088
510460;202007;1735;4293;1224;3535;93;334;781;2157;874;2491
510480;202007;4433;10672;2892;7862;566;1702;1145;3032;1711;4734
510490;202007;1643;4250;1218;3715;174;526;792;2448;966;2974
510500;202007;1489;3737;916;2803;181;593;305;946;486;1539
510510;202007;3355;9818;2474;8222;603;2258;777;2728;1380;4986
510515;202007;5189;13310;3371;10034;802;2675;875;2299;1677;4974
510517;202007;1026;2998;775;2571;235;866;142;414;377;1280
510520;202007;2053;4182;1165;3071;85;226;602;1703;687;1929
510523;202007;1077;2673;798;2224;174;461;455;1314;629;1775
510525;202007;7043;19234;5258;15777;807;2687;2540;7213;3347;9900
510530;202007;551;1416;400;1192;29;93;254;743;283;836
510550;202007;2313;6853;1664;5718;384;1389;747;2583;1131;3972
510558;202007;2236;6002;1616;5015;221;661;752;2540;973;3201
510560;202007;1587;4542;937;3242;193;758;234;878;427;1636
510562;202007;5488;14248;3938;11446;921;2895;1332;4057;2253;6952
510590;202007;3093;7604;2194;6467;170;518;1571;4733;1741;5251
510600;202007;1382;3124;886;2404;160;438;399;1097;559;1535
510610;202007;2586;6253;1767;5177;170;568;1109;3262;1279;3830
510615;202007;2592;6459;1787;5159;304;911;948;2804;1252;3715
510617;202007;976;2937;748;2563;102;399;468;1666;570;2065
510618;202007;1211;3224;829;2554;186;629;382;1125;568;1754
510619;202007;736;1851;472;1406;66;206;131;370;197;576
510620;202007;1404;3161;649;1927;171;625;35;74;206;699
510621;202007;1506;4020;906;2862;193;677;280;826;473;1503
510622;202007;4439;12542;2998;9434;1008;3393;424;1215;1432;4608
510623;202007;2632;6503;1841;5247;436;1459;590;1634;1026;3093
510624;202007;1631;4110;768;2530;92;325;174;521;266;846
510625;202007;2810;6869;1495;4494;249;891;332;1010;581;1901
510626;202007;1472;3552;913;2658;253;848;208;600;461;1448
510627;202007;601;1554;335;1033;82;281;83;273;165;554
510628;202007;1432;3308;940;2647;194;583;355;985;549;1568
510629;202007;1542;4381;1135;3648;225;772;417;1337;642;2109
510630;202007;3243;9025;1877;6410;435;1590;336;1223;771;2813
510631;202007;570;1371;413;1139;14;38;316;902;330;940
510637;202007;3375;8114;2410;6716;602;1895;679;1906;1281;3801
510642;202007;5320;15166;4019;13181;976;3477;1725;5799;2701;9276
510645;202007;959;1860;565;1357;174;391;220;537;394;928
510650;202007;6895;17655;5450;16065;630;1657;3734;12174;4364;13831
510665;202007;1882;4063;1155;2886;238;575;427;1148;665;1723
510670;202007;431;922;249;659;25;66;140;380;165;446
510675;202007;6038;16606;4105;12969;1186;4142;722;2194;1908;6336
510677;202007;2045;5262;1402;4286;202;714;748;2219;950;2933
510680;202007;688;1761;384;1192;74;254;78;224;152;478
510682;202007;1488;4405;1082;3729;377;1444;243;806;620;2250
510685;202007;524;1529;374;1218;58;205;187;603;245;808
510700;202007;4032;9681;2796;7927;263;814;2049;5796;2312;6610
510704;202007;10515;24672;6850;18351;1505;4346;1771;4605;3276;8951
510706;202007;1922;5807;1374;4903;265;964;728;2822;993;3786
510710;202007;2616;6534;1690;4795;370;1085;565;1536;935;2621
510715;202007;580;1298;418;1076;36;109;204;513;240;622
510718;202007;2309;5180;1335;3873;393;1151;452;1600;845;2751
510719;202007;440;929;256;689;22;61;149;379;171;440
510720;202007;875;2045;562;1571;93;297;264;697;357;994
510724;202007;801;2186;550;1712;78;256;299;908;377;1164
510726;202007;1036;1876;549;1289;61;165;270;636;331;801
510729;202007;595;1387;259;749;32;107;63;198;95;305
510730;202007;2870;6933;1914;5442;248;798;951;2645;1199;3443
510735;202007;994;2855;751;2510;75;314;550;1816;625;2130
510740;202007;928;2300;582;1649;101;286;257;719;358;1005
510757;202007;500;1537;390;1368;123;479;139;469;262;948
510760;202007;43286;94984;25698;67930;5215;15868;8083;19613;13298;35481
510770;202007;4190;9450;2831;7736;241;612;1927;5536;2168;6148
510774;202007;339;867;234;692;36;106;122;369;158;475
510775;202007;602;1600;382;1238;80;284;84;252;164;536
510776;202007;416;1044;294;817;71;196;97;290;168;486
510777;202007;1483;3959;1056;3404;145;544;675;2153;820;2697
510779;202007;663;1780;510;1534;57;163;288;947;345;1110
510780;202007;3622;9279;2652;7916;642;1891;1143;3869;1785;5760
510785;202007;1969;5209;1135;3674;297;1037;185;685;482;1722
510787;202007;2584;7314;1689;5427;544;1847;198;641;742;2488
510788;202007;586;1398;411;1127;64;187;197;612;261;799
510790;202007;17153;44269;10333;31569;2188;7529;1668;4519;3856;12048
510792;202007;9057;24695;5619;18054;1192;4343;959;2709;2151;7052
510794;202007;1205;3202;814;2527;249;857;155;427;404;1284
510795;202007;7994;20993;5149;15817;1164;3961;1337;4029;2501;7990
510800;202007;1653;4281;1068;3286;354;1110;122;366;476;1476
510805;202007;1473;4089;1013;3224;243;827;333;966;576;1793
510810;202007;619;1266;389;957;105;262;154;403;259;665
510820;202007;746;1420;410;991;34;100;214;522;248;622
510830;202007;831;2022;591;1714;49;141;415;1283;464;1424
510835;202007;546;1320;352;1035;35;121;216;620;251;741
510840;202007;51877;110752;35627;90924;6975;16811;17877;50471;24852;67282
510850;202007;1778;4272;1000;3031;330;1145;122;337;452;1482
510860;202007;2290;6086;1409;4573;437;1654;113;358;550;2012
510880;202007;697;1973;522;1648;125;407;187;600;312;1007
510885;202007;555;1355;384;1114;78;251;126;357;204;608
510890;202007;627;1841;473;1577;106;378;212;707;318;1085
510895;202007;1267;3237;843;2547;164;592;369;1040;533;1632
520005;202007;2558;6512;1966;5783;573;1692;817;2752;1390;4444
520010;202007;2212;6300;1582;5103;391;1416;479;1361;870;2777
520013;202007;2752;7065;1796;5301;397;1205;513;1652;910;2857
520015;202007;500;1259;353;1041;81;247;140;435;221;682
520017;202007;1148;2932;856;2483;149;471;474;1352;623;1823
520020;202007;396;878;302;760;23;77;234;561;257;638
520025;202007;32896;92006;28140;85315;2809;9303;20196;60924;23005;70227
520030;202007;5593;14260;4454;12658;306;955;3157;8913;3463;9868
520050;202007;403;946;250;685;14;41;158;443;172;484
520055;202007;1766;4273;1136;3053;98;248;647;1698;745;1946
520060;202007;1385;3813;994;3096;254;879;247;772;501;1651
520080;202007;1762;4571;1309;3955;234;708;641;2118;875;2826
520082;202007;900;2282;697;1943;79;207;369;1082;448;1289
520085;202007;803;2158;620;1857;110;338;300;885;410;1223
520090;202007;831;1630;568;1341;57;91;436;1084;493;1175
520110;202007;37804;101463;25975;81695;7886;28328;2275;6499;10161;34827
520120;202007;197;465;110;322;14;49;45;127;59;176
520130;202007;3573;8741;2784;7524;542;1487;1188;3293;1730;4780
520140;202007;39759;106057;27404;84838;9785;32882;3573;11495;13358;44377
520145;202007;597;1384;402;1106;62;195;237;605;299;800
520150;202007;613;1380;441;1171;76;203;235;639;311;842
520160;202007;742;1724;534;1398;103;259;236;662;339;921
520170;202007;4897;9846;3234;7941;179;503;2483;6043;2662;6546
520180;202007;2148;5834;1746;5255;315;1045;976;2917;1291;3962
520215;202007;1680;4046;1189;3288;279;836;408;1069;687;1905
520235;202007;592;1353;338;963;37;128;129;356;166;484
520250;202007;1533;3914;1050;3095;325;1038;251;796;576;1834
520260;202007;790;1835;500;1376;92;262;208;588;300;850
520280;202007;704;1728;545;1484;117;323;257;747;374;1070
520310;202007;1019;2229;661;1693;149;434;254;685;403;1119
520320;202007;1596;4279;1202;3650;156;528;661;1964;817;2492
520330;202007;3845;10338;2779;8600;417;1539;1451;4390;1868;5929
520340;202007;2419;5341;1499;4059;176;446;873;2485;1049;2931
520350;202007;2820;6727;1994;5480;592;1706;751;2098;1343;3804
520355;202007;1807;4920;1271;3847;421;1383;287;753;708;2136
520357;202007;737;1773;524;1461;29;75;392;1124;421;1199
520360;202007;698;1826;528;1547;140;429;154;483;294;912
520380;202007;1406;3480;822;2395;87;266;420;1148;507;1414
520390;202007;1005;2208;592;1697;161;500;202;623;363;1123
520393;202007;492;1177;326;916;39;124;149;390;188;514
520396;202007;831;2135;691;1913;39;129;513;1377;552;1506
520400;202007;1575;3851;1194;3332;152;464;805;2244;957;2708
520410;202007;1959;4422;1175;3216;195;576;450;1178;645;1754
520420;202007;360;833;278;704;21;57;218;532;239;589
520425;202007;1448;3530;801;2328;206;626;151;420;357;1046
520430;202007;2258;5180;1251;3598;231;778;45;123;276;901
520440;202007;2899;7024;1731;4960;418;1328;454;1235;872;2563
520450;202007;11706;27706;7658;21613;2394;7396;1480;4294;3874;11690
520455;202007;689;1882;501;1596;143;480;140;462;283;942
520460;202007;1005;2337;779;2050;74;170;624;1676;698;1846
520465;202007;769;1936;614;1727;77;257;434;1169;511;1426
520470;202007;2025;5225;1541;4579;476;1474;592;1876;1068;3350
520480;202007;918;2547;632;2050;194;651;145;492;339;1143
520485;202007;1534;4334;1281;3981;163;520;909;2819;1072;3339
520490;202007;3901;10749;2887;9119;991;3245;1042;3443;2033;6688
520495;202007;1576;3453;1186;2923;51;127;955;2356;1006;2483
520500;202007;1195;3213;810;2457;189;614;325;991;514;1605
520505;202007;751;1643;517;1346;61;165;331;849;392;1014
520510;202007;7573;18790;4959;14726;1131;3756;1371;4400;2502;8156
520520;202007;1132;2847;836;2381;196;614;300;857;496;1471
520530;202007;2056;5775;1540;4926;414;1398;622;2074;1036;3472
520540;202007;2820;7429;1741;5295;324;1068;435;1246;759;2314
520545;202007;939;2443;697;2046;144;417;283;845;427;1262
520547;202007;787;2143;626;1875;149;447;314;949;463;1396
520549;202007;13310;35428;10975;32022;1473;4577;7406;21463;8879;26040
520551;202007;4469;12015;3708;10897;388;1341;2637;7584;3025;8925
520552;202007;810;2079;664;1892;138;391;383;1155;521;1546
520570;202007;520;1153;342;904;83;194;134;403;217;597
520580;202007;2167;4937;1628;4308;115;376;1198;3115;1313;3491
520590;202007;1232;3076;850;2462;266;779;225;665;491;1444
520620;202007;7906;21396;6169;18853;1546;4869;2740;8658;4286;13527
520630;202007;725;1859;500;1464;84;260;146;403;230;663
520640;202007;2334;5778;1774;4804;412;1099;746;2097;1158;3196
520650;202007;833;1941;610;1631;89;236;343;970;432;1206
520660;202007;530;1276;278;832;53;184;74;218;127;402
520670;202007;933;2504;780;2285;63;189;513;1478;576;1667
520680;202007;682;1730;509;1455;80;223;264;764;344;987
520690;202007;322;746;217;594;65;163;69;215;134;378
520710;202007;410;990;287;780;12;28;208;553;220;581
520725;202007;1491;3495;1016;2728;114;358;638;1643;752;2001
520735;202007;756;1851;496;1421;105;286;188;579;293;865
520740;202007;2073;4667;1552;4054;268;647;879;2481;1147;3128
520750;202007;650;1572;445;1238;71;196;224;625;295;821
520753;202007;1250;3319;946;2755;182;562;381;1043;563;1605
520760;202007;1181;2648;1035;2472;29;54;949;2303;978;2357
520780;202007;1476;3440;1044;2840;117;326;527;1419;644;1745
520790;202007;3326;7897;2352;6311;318;868;1293;3655;1611;4523
520800;202007;16032;41423;12390;36096;1879;5721;7242;21704;9121;27425
520810;202007;1304;2702;958;2306;156;389;610;1552;766;1941
520815;202007;564;1718;418;1420;75;282;121;421;196;703
520830;202007;1807;3813;1277;3217;43;98;1057;2635;1100;2733
520840;202007;2517;6754;2028;6116;859;2811;537;1736;1396;4547
520850;202007;628;1625;461;1376;158;550;114;352;272;902
520860;202007;6308;16940;4549;14072;1199;4012;1656;5055;2855;9067
520870;202007;104136;240800;69210;188766;15165;44903;24579;65882;39744;110785
520880;202007;6611;19003;5072;16239;1170;3931;1884;6073;3054;10004
520890;202007;3853;9251;2593;7273;517;1585;1109;3107;1626;4692
520910;202007;4525;11378;2843;8451;703;2251;663;1932;1366;4183
520915;202007;701;1958;410;1295;70;241;140;427;210;668
520920;202007;4305;9649;2994;7995;368;1022;1667;4651;2035;5673
520929;202007;684;1596;512;1343;65;139;266;750;331;889
520940;202007;948;2510;734;2211;41;132;540;1595;581;1727
520945;202007;471;1056;375;920;15;36;272;656;287;692
520960;202007;1026;2472;805;2134;172;398;454;1252;626;1650
520970;202007;2486;6817;1929;5920;478;1657;496;1629;974;3286
520980;202007;772;1864;560;1574;99;293;227;622;326;915
520990;202007;2948;7850;2350;7061;344;992;1537;4730;1881;5722
520993;202007;1124;2638;767;2079;114;346;434;1119;548;1465
520995;202007;2237;5651;1668;4852;265;781;655;1967;920;2748
521000;202007;8459;22052;5531;16773;1121;3529;1659;5017;2780;8546
521010;202007;3581;9309;2662;7717;257;748;1550;4452;1807;5200
521015;202007;781;1922;537;1496;43;136;335;890;378;1026
521020;202007;3139;7993;1810;5429;534;1783;129;411;663;2194
521030;202007;479;1049;316;800;67;154;129;355;196;509
521040;202007;7539;18458;5520;15262;1190;3433;2327;6589;3517;10022
521056;202007;912;2396;710;2096;223;653;194;642;417;1295
521060;202007;934;2476;680;2011;93;283;286;844;379;1127
521080;202007;1107;2376;557;1515;72;212;234;551;306;763
521090;202007;3167;8470;2119;6394;585;1889;278;876;863;2765
521100;202007;1721;3997;1212;3274;193;514;717;1965;910;2479
521120;202007;4611;10778;3310;9176;202;515;1627;5263;1829;5778
521130;202007;996;2235;554;1471;20;61;293;826;313;887
521140;202007;1233;3162;894;2579;111;341;436;1271;547;1612
521150;202007;12246;26737;7524;20012;1270;3918;3540;9607;4810;13525
521160;202007;629;1307;439;1031;48;110;292;663;340;773
521170;202007;1009;2357;725;1938;56;155;492;1292;548;1447
521180;202007;7131;19661;5829;17394;933;3023;3035;8767;3968;11790
521190;202007;10530;26122;6042;18557;1528;5011;1212;3981;2740;8992
521200;202007;694;1693;480;1345;48;143;272;764;320;907
521205;202007;624;1541;467;1290;16;50;350;925;366;975
521210;202007;683;1745;389;1155;80;256;72;165;152;421
521220;202007;3575;8714;2283;6684;392;1291;861;2500;1253;3791
521225;202007;372;792;270;682;48;122;157;397;205;519
521230;202007;1314;3352;1152;3153;367;1018;582;1694;949;2712
521250;202007;30447;81034;23441;70708;8639;27370;6812;21940;15451;49310
521260;202007;550;1270;394;1022;53;138;225;577;278;715
521270;202007;1797;4535;1563;4260;87;200;1191;3283;1278;3483
521280;202007;1753;4691;1293;3919;306;1032;541;1656;847;2688
521290;202007;477;1111;333;925;45;145;207;556;252;701
521295;202007;1094;2362;823;2064;63;114;671;1745;734;1859
521300;202007;1842;4535;1443;3971;269;698;910;2587;1179;3285
521305;202007;713;1702;506;1391;75;189;288;801;363;990
521308;202007;4729;12614;3273;9823;306;911;1915;5657;2221;6568
521310;202007;8143;20740;5590;16447;1212;3897;2308;6501;3520;10398
521340;202007;409;958;298;795;20;56;197;505;217;561
521350;202007;2001;5091;1502;4339;126;452;1065;2928;1191;3380
521370;202007;1217;3077;713;2204;205;732;86;290;291;1022
521375;202007;1288;3132;863;2522;198;576;265;863;463;1439
521377;202007;1482;3113;1075;2614;93;156;861;2206;954;2362
521380;202007;6063;16056;3895;12046;404;1366;1039;3439;1443;4805
521385;202007;643;1546;493;1354;57;145;282;839;339;984
521390;202007;708;1729;493;1406;143;450;179;539;322;989
521400;202007;2618;6039;2019;5310;226;590;1393;3757;1619;4347
521405;202007;1276;3246;921;2638;175;511;444;1254;619;1765
521410;202007;796;2128;588;1760;104;293;294;939;398;1232
521440;202007;1154;2894;818;2383;274;876;229;673;503;1549
521450;202007;3885;11496;2836;9459;742;2482;726;2589;1468;5071
521460;202007;5618;14711;3905;11668;1313;4114;894;2746;2207;6860
521470;202007;605;1631;360;1117;48;144;119;362;167;506
521480;202007;361;912;213;628;42;126;72;203;114;329
521483;202007;2399;5698;1667;4575;360;1062;654;1780;1014;2842
521486;202007;1742;4107;1288;3469;78;207;933;2500;1011;2707
521487;202007;407;989;286;821;43;127;144;422;187;549
521490;202007;896;2373;660;1987;37;136;456;1332;493;1468
521500;202007;2266;5494;1662;4550;101;340;1198;3187;1299;3527
521520;202007;719;1666;506;1353;73;205;210;573;283;778
521523;202007;11253;34519;9183;31147;2505;9353;2474;8687;4979;18040
521525;202007;1042;2368;767;1985;74;198;553;1415;627;1613
521530;202007;2233;5761;1298;3856;282;873;334;995;616;1868
521540;202007;835;2093;562;1642;76;253;269;815;345;1068
521550;202007;1544;3891;827;2443;149;496;216;654;365;1150
521560;202007;4470;11696;3048;9769;453;1711;1547;5251;2000;6962
521565;202007;634;1518;486;1312;73;179;295;789;368;968
521570;202007;3383;9204;2216;6939;436;1605;203;671;639;2276
521580;202007;479;1157;275;812;41;127;83;221;124;348
521590;202007;638;1490;466;1246;83;243;268;704;351;947
521600;202007;372;998;241;744;33;82;105;325;138;407
521630;202007;1647;3594;994;2635;204;584;344;886;548;1470
521640;202007;1796;4149;1189;3277;254;741;414;1128;668;1869
521645;202007;544;1413;343;1045;84;238;110;338;194;576
521680;202007;1082;3271;826;2773;240;881;121;446;361;1327
521690;202007;529;1281;437;1158;60;169;277;723;337;892
521710;202007;3170;7886;1997;5960;358;1216;495;1385;853;2601
521720;202007;2163;4981;1384;3796;146;450;782;2152;928;2602
521730;202007;3528;9804;2668;8302;743;2706;738;1944;1481;4650
521740;202007;3823;9978;2847;8549;695;2244;1078;3384;1773;5628
521760;202007;14612;39922;11231;34687;2856;9794;4136;13360;6992;23154
521770;202007;2945;7051;1928;5401;572;1733;494;1389;1066;3122
521800;202007;6360;16978;4559;13954;1017;3172;1820;6034;2837;9206
521805;202007;476;1158;353;982;106;269;151;434;257;703
521810;202007;611;1436;427;1186;63;179;251;706;314;885
521830;202007;5462;15095;4299;13290;287;1076;3096;9390;3383;10466
521839;202007;725;1707;501;1342;82;252;274;659;356;911
521850;202007;5400;12557;3361;9511;582;1850;558;1502;1140;3352
521860;202007;1507;3979;1027;3137;185;619;320;964;505;1583
521870;202007;682;1899;485;1510;101;348;124;344;225;692
521878;202007;667;1715;448;1283;56;189;241;623;297;812
521880;202007;18370;44630;12279;35226;3091;9387;4317;12584;7408;21971
521890;202007;3030;7816;1975;5966;558;1830;363;1003;921;2833
521900;202007;1464;3426;815;2413;242;691;93;279;335;970
521910;202007;1230;2599;807;2105;73;190;450;1286;523;1476
521920;202007;474;1303;349;1082;63;223;148;439;211;662
521925;202007;740;1921;532;1617;82;260;290;876;372;1136
521930;202007;5370;12822;3506;9970;902;2407;1317;4174;2219;6581
521935;202007;1022;2436;682;1832;66;186;404;1030;470;1216
521940;202007;1334;2925;852;2269;200;589;336;879;536;1468
521945;202007;563;1529;455;1346;98;300;248;744;346;1044
521950;202007;741;1790;509;1424;122;347;208;561;330;908
521960;202007;712;1832;458;1359;56;181;242;666;298;847
521970;202007;2520;6149;1994;5520;165;449;1518;4254;1683;4703
521971;202007;750;1762;528;1441;151;406;151;422;302;828
521973;202007;1380;3558;1090;3121;39;116;843;2396;882;2512
521975;202007;11788;30967;9595;27908;1534;4650;5992;17518;7526;22168
521980;202007;2529;5885;1928;5085;149;383;1447;3912;1596;4295
521990;202007;1069;3005;840;2594;179;589;301;928;480;1517
522000;202007;2590;6779;2076;6143;299;865;1307;4060;1606;4925
522005;202007;334;804;250;678;49;127;125;350;174;477
522010;202007;3916;9498;2737;7592;615;1883;1002;2706;1617;4589
522015;202007;996;2595;729;2184;224;655;265;828;489;1483
522020;202007;5456;12957;3546;9923;728;2130;1409;4074;2137;6204
522026;202007;764;2030;508;1566;91;306;181;520;272;826
522028;202007;420;1040;311;863;69;198;133;362;202;560
522040;202007;3053;6886;2160;5687;267;744;1449;3776;1716;4520
522045;202007;17260;47849;12656;39625;2987;10091;3460;10550;6447;20641
522050;202007;1080;2835;728;2219;190;652;254;686;444;1338
522060;202007;2868;7502;1964;5997;169;514;1128;3565;1297;4079
522068;202007;1805;4590;1405;4110;119;325;1097;3246;1216;3571
522070;202007;637;1536;510;1347;19;55;426;1104;445;1159
522100;202007;727;1861;487;1477;60;207;254;738;314;945
522108;202007;985;2497;760;2174;55;201;602;1670;657;1871
522119;202007;1572;3838;1198;3343;195;556;623;1844;818;2400
522130;202007;392;996;279;837;26;74;190;596;216;670
522140;202007;17361;46007;12006;36369;3122;10158;3210;9314;6332;19472
522145;202007;788;1943;525;1538;149;429;186;554;335;983
522150;202007;1060;2579;749;2063;207;566;220;636;427;1202
522155;202007;1077;2702;821;2297;159;398;457;1327;616;1725
522157;202007;586;1379;479;1243;27;87;379;987;406;1074
522160;202007;5948;15325;3804;11386;1030;3322;302;992;1332;4314
522170;202007;2613;6663;1948;5666;298;880;1094;3247;1392;4127
522180;202007;519;1201;345;900;63;178;83;233;146;411
522185;202007;18328;45203;12800;37582;4996;15931;2774;8780;7770;24711
522190;202007;766;1835;517;1402;96;274;200;529;296;803
522200;202007;1621;4579;1064;3508;220;793;187;554;407;1347
522205;202007;1669;3874;1266;3334;135;378;866;2281;1001;2659
522220;202007;1254;3089;922;2585;109;325;541;1554;650;1879
522230;202007;1112;2819;883;2490;192;663;440;1159;632;1822
530010;202007;168790;451723;135043;401837;20925;68238;78447;230099;99372;298337
110001;202006;3925;11009;2607;8516;589;2063;1013;3364;1602;5427
110002;202006;12308;32139;8597;25679;2390;7591;2300;6958;4690;14549
110003;202006;618;1807;432;1418;103;363;105;326;208;689
110004;202006;11126;29068;7313;22212;1548;5136;2137;6631;3685;11767
110005;202006;2486;6461;1677;5109;358;1189;448;1478;806;2667
110006;202006;1774;4930;1098;3486;199;729;207;620;406;1349
110007;202006;1196;3062;749;2307;238;788;184;697;422;1485
110008;202006;3284;9096;2396;7733;271;858;1584;5441;1855;6299
110009;202006;4306;12092;2745;9217;598;2123;1105;3746;1703;5869
110010;202006;7534;24318;5480;20221;1115;4174;2647;10610;3762;14784
110011;202006;6808;18173;4593;14130;1638;5280;650;2098;2288;7378
110012;202006;15325;38354;8889;26869;2096;6839;799;2618;2895;9457
110013;202006;5161;15076;3730;12116;1513;5183;460;1660;1973;6843
110014;202006;3789;10065;2569;7747;589;1893;1031;3035;1620;4928
110015;202006;5534;14340;3207;9736;730;2411;675;1891;1405;4302
110018;202006;3716;9355;2123;6543;405;1461;596;1810;1001;3271
110020;202006;74405;178614;52824;148810;11609;33797;21613;67070;33222;100867
110025;202006;5131;12392;3375;9336;706;2094;1478;4121;2184;6215
110026;202006;494;1253;350;1045;81;268;151;473;232;741
110028;202006;6753;17244;4010;12226;1015;3371;600;1860;1615;5231
110029;202006;1516;3720;874;2587;197;594;310;967;507;1561
110030;202006;12677;29252;7787;21930;1691;5574;1521;4654;3212;10228
110032;202006;3004;8575;1897;6194;598;1939;391;1375;989;3314
110033;202006;3613;11315;2779;9767;992;3534;692;2708;1684;6242
110034;202006;3400;7968;2232;6349;675;2160;755;2317;1430;4477
110037;202006;1612;4780;1198;4050;255;864;581;2010;836;2874
110040;202006;2906;8114;2059;6531;581;1989;635;1968;1216;3957
110045;202006;4953;14351;3702;12058;989;3463;1293;4289;2282;7752
110050;202006;1777;4824;1240;3890;489;1669;218;708;707;2377
110060;202006;883;2627;596;1941;207;719;76;247;283;966
110070;202006;1572;4988;1174;4106;373;1390;234;739;607;2129
110080;202006;6259;14608;4601;12638;615;1599;3015;8853;3630;10452
110090;202006;554;1497;395;1216;88;297;176;529;264;826
110092;202006;1155;3354;834;2751;149;505;414;1478;563;1983
110094;202006;2782;8339;2076;6982;879;3154;292;984;1171;4138
110100;202006;1689;4993;1350;4335;373;1267;566;1842;939;3109
110110;202006;1697;4699;1172;3787;382;1276;270;947;652;2223
110120;202006;1304;3794;985;3169;234;827;328;1022;562;1849
110130;202006;2630;6610;1661;4855;324;1076;562;1615;886;2691
110140;202006;2035;6006;1370;4626;340;1205;354;1234;694;2439
110143;202006;1376;3746;934;2850;282;870;157;489;439;1359
110145;202006;887;2325;543;1685;126;408;192;613;318;1021
110146;202006;463;1195;324;980;65;186;157;514;222;700
110147;202006;791;2056;494;1469;71;232;186;485;257;717
110148;202006;755;2065;421;1402;113;424;45;148;158;572
110149;202006;2961;8149;2038;6655;705;2438;450;1561;1155;3999
110150;202006;2749;6715;1816;5391;541;1768;447;1604;988;3372
110155;202006;734;2159;512;1620;112;381;172;516;284;897
110160;202006;1447;4520;1061;3653;314;1102;257;910;571;2012
110170;202006;2165;5547;1314;3921;243;767;677;1942;920;2709
110175;202006;1677;4710;1183;3842;181;644;524;1784;705;2428
110180;202006;1402;3855;962;2962;147;478;488;1494;635;1972
120001;202006;3249;9560;2662;8689;427;1454;1688;5668;2115;7122
120005;202006;1944;7435;1759;7171;152;683;1405;5816;1557;6499
120010;202006;5317;16020;4487;14774;421;1362;3269;11104;3690;12466
120013;202006;2164;7595;1909;7285;417;1535;1191;4859;1608;6394
120017;202006;2426;8035;2132;7586;339;1215;1366;5134;1705;6349
120020;202006;14990;58618;13748;56186;1085;5041;10823;44563;11908;49604
120025;202006;3122;8889;2493;8127;373;1201;1720;5807;2093;7008
120030;202006;6505;25656;6022;24740;430;2276;4665;19332;5095;21608
120032;202006;1691;7597;1598;7424;109;698;1318;6012;1427;6710
120033;202006;4073;15125;3828;14694;124;713;3346;12727;3470;13440
120034;202006;2653;9647;2263;8962;115;686;1870;7275;1985;7961
120035;202006;3718;14690;3528;14359;291;1416;2891;11761;3182;13177
120038;202006;2692;8653;2289;7988;530;1910;1228;4376;1758;6286
120039;202006;2026;8735;1892;8463;125;782;1524;6757;1649;7539
120040;202006;44516;140055;37736;128916;5347;19332;23459;81321;28806;100653
120042;202006;3288;12372;3019;11872;147;796;2518;9821;2665;10617
120043;202006;1381;5610;1257;5408;35;214;1155;4974;1190;5188
120045;202006;6219;15987;5389;15060;125;515;4904;13566;5029;14081
120050;202006;9344;33687;8532;32435;392;2072;7137;27178;7529;29250
120060;202006;9540;36977;8730;35770;379;2285;7618;31005;7997;33290
120070;202006;3146;10113;2716;9522;243;867;1957;7120;2200;7987
120080;202006;4216;13605;3741;12899;460;1676;2749;9656;3209;11332
130002;202006;3078;12148;2745;11661;194;834;2319;10045;2513;10879
130006;202006;2413;8983;1994;8225;180;784;1492;6209;1672;6993
130008;202006;2675;9344;2363;8884;68;369;2047;7695;2115;8064
130010;202006;3969;11560;3329;10830;81;230;3053;10087;3134;10317
130014;202006;3099;9236;2378;8033;414;1411;1456;5065;1870;6476
130020;202006;2870;11067;2561;10597;140;813;2050;8429;2190;9242
130030;202006;10127;32884;9197;31788;328;1118;8134;28593;8462;29711
130040;202006;3952;11723;3288;10831;195;603;2726;9127;2921;9730
130050;202006;7595;27804;6318;26106;159;830;5733;23928;5892;24758
130060;202006;7528;29886;6446;28460;431;2381;5332;23534;5763;25915
130063;202006;6379;20822;5673;20032;210;897;5139;18269;5349;19166
130068;202006;3796;13358;3200;12476;209;1187;2435;9396;2644;10583
130070;202006;7613;21409;6216;19881;291;896;5128;16937;5419;17833
130080;202006;7061;25619;6161;24567;250;1389;5253;21274;5503;22663
130083;202006;2766;9031;2444;8624;152;631;2081;7374;2233;8005
130090;202006;3543;10967;3136;10453;56;244;2779;9436;2835;9680
130100;202006;8102;24257;6886;22983;59;128;6496;22231;6555;22359
130110;202006;8616;24614;7082;22708;1020;2592;5148;17859;6168;20451
130115;202006;5302;16502;4563;15680;106;362;4053;14162;4159;14524
130120;202006;14259;50358;12551;48071;1087;4584;10186;39413;11273;43997
130130;202006;5355;16942;4125;15314;304;1267;3182;11934;3486;13201
130140;202006;7367;25611;6484;24596;187;1063;5711;21755;5898;22818
130150;202006;3646;13662;3425;13416;81;507;3142;12332;3223;12839
130160;202006;5131;18195;4380;17232;271;1148;3721;14928;3992;16076
130165;202006;3226;12236;3031;11990;118;528;2732;10902;2850;11430
130170;202006;11849;34563;9473;31780;699;2645;7628;26038;8327;28683
130180;202006;4497;14494;4260;14229;41;212;4114;13716;4155;13928
130185;202006;18529;45789;15123;42166;1006;1829;12725;37604;13731;39433
130190;202006;18822;62376;15112;56832;1707;6697;10710;41545;12417;48242
130195;202006;2487;9017;2015;8388;73;417;1717;7149;1790;7566
130200;202006;2592;7296;2139;6704;98;386;1782;5570;1880;5956
130210;202006;1313;4935;1179;4778;101;589;949;3745;1050;4334
130220;202006;2321;7990;1980;7543;53;295;1743;6661;1796;6956
130230;202006;4626;19057;4013;18177;225;1414;3446;15588;3671;17002
130240;202006;12273;36758;9932;33648;185;1099;8934;30264;9119;31363
130250;202006;26478;79133;22686;74858;1669;5094;18233;62584;19902;67678
130255;202006;4414;14758;3838;13752;159;735;3113;11147;3272;11882
130260;202006;264499;736958;214743;664634;58039;190607;98778;315939;156817;506546
130270;202006;9573;33839;7877;31199;1180;4642;5239;21704;6419;26346
130280;202006;3552;14377;3261;14051;90;452;3037;13249;3127;13701
130290;202006;13262;44468;11464;42151;665;2596;9668;36353;10333;38949
130300;202006;4727;16534;4301;15952;150;822;3737;13851;3887;14673
130310;202006;6293;21005;5455;19919;286;1276;4645;16977;4931;18253
130320;202006;3454;11227;2870;10468;366;1300;2100;7937;2466;9237
130330;202006;4622;14835;3728;13735;207;929;3187;11739;3394;12668
130340;202006;23714;74064;20363;70246;1473;4384;17075;60980;18548;65364
130350;202006;3995;14427;3592;13913;148;758;3182;12290;3330;13048
130353;202006;7581;20463;6092;18581;784;2269;4368;13851;5152;16120
130356;202006;5264;16765;4351;15345;755;2612;2658;9957;3413;12569
130360;202006;2977;9816;2570;9258;93;412;2289;8184;2382;8596
130370;202006;5751;22647;5000;21579;301;1685;4054;17408;4355;19093
130380;202006;7394;30667;6846;29895;393;2210;5820;25248;6213;27458
130390;202006;5816;24578;5144;23454;540;2813;3869;17722;4409;20535
130395;202006;2339;7441;2001;6885;184;662;1532;5280;1716;5942
130400;202006;2783;8680;2387;8147;92;268;2141;7461;2233;7729
130406;202006;11100;38757;9336;36584;1768;6953;6242;25423;8010;32376
130410;202006;4220;15004;3584;13922;1067;4371;1641;6542;2708;10913
130420;202006;13707;48190;11444;45351;919;4665;8957;35753;9876;40418
130423;202006;4359;13723;3810;13100;192;856;3339;11383;3531;12239
130426;202006;2800;11122;2606;10892;71;395;2404;10105;2475;10500
130430;202006;4279;12123;3706;11359;240;891;3121;9433;3361;10324
130440;202006;4838;15213;4135;14373;86;384;3826;13383;3912;13767
140002;202006;2193;6502;1908;6150;91;348;1615;5256;1706;5604
140005;202006;3330;9174;2904;8685;134;358;2483;7635;2617;7993
140010;202006;57094;151640;45543;134373;11314;35187;19665;59213;30979;94400
140015;202006;3823;11382;3235;10662;223;713;2818;9451;3041;10164
140017;202006;4437;12347;3850;11605;256;712;3162;9818;3418;10530
140020;202006;5310;15466;4563;14481;230;961;3763;11845;3993;12806
140023;202006;2501;7428;2045;6772;199;664;1555;5275;1754;5939
140028;202006;2056;5293;1737;4885;87;275;1404;3944;1491;4219
140030;202006;5277;13482;4661;12773;339;671;4054;11504;4393;12175
140040;202006;2578;10163;2363;9879;93;575;2135;8796;2228;9371
140045;202006;2602;9485;2185;8910;347;1231;1483;6521;1830;7752
140047;202006;6311;17951;5309;16483;596;1883;3808;12021;4404;13904
140050;202006;1446;4219;1214;3885;121;375;923;3032;1044;3407
140060;202006;1699;4470;1458;4113;112;289;1181;3407;1293;3696
140070;202006;1897;9864;1831;9733;122;849;1522;8016;1644;8865
150010;202006;45582;113815;41158;108133;958;2259;36902;96901;37860;99160
150013;202006;1962;5006;1631;4652;154;308;1270;3873;1424;4181
150020;202006;14506;43660;13408;42227;1449;3830;10958;35614;12407;39444
150030;202006;8904;33362;8089;32354;468;2012;7018;28330;7486;30342
150034;202006;4199;10307;3452;9384;234;578;2875;7998;3109;8576
150040;202006;16451;42603;14447;40384;1252;1937;12093;36745;13345;38682
150050;202006;6979;24375;6357;23551;129;578;5845;21884;5974;22462
150060;202006;22136;60071;17721;53397;2798;8601;11251;34723;14049;43324
150070;202006;6762;25229;5916;24213;226;1111;5285;21843;5511;22954
150080;202006;94633;211274;78566;189316;19013;50115;22648;66827;41661;116942
150085;202006;7727;22332;6978;21442;119;387;6543;20259;6662;20646
150090;202006;9848;36660;9257;35505;696;2721;7429;28710;8125;31431
150095;202006;5671;16605;4932;15681;270;606;4183;13888;4453;14494
150100;202006;2876;10081;2550;9528;202;662;1991;7622;2193;8284
150110;202006;4431;18205;4106;17831;186;874;3778;16522;3964;17396
150120;202006;8194;25400;7770;24889;260;674;6872;22777;7132;23451
150125;202006;749;1995;557;1732;97;362;331;1012;428;1374
150130;202006;22395;64953;19373;60388;3357;9373;12634;41768;15991;51141
150140;202006;253361;586410;213026;530440;31763;76592;123712;320847;155475;397439
150145;202006;4267;13183;3617;12178;923;2846;1962;7325;2885;10171
150150;202006;16193;41691;14117;39026;538;1633;11797;32604;12335;34237
150157;202006;3527;9599;2835;8700;296;907;1997;6417;2293;7324
150160;202006;3034;8960;2822;8653;538;1555;1754;5617;2292;7172
150170;202006;24568;80513;21452;75201;3901;12861;13177;49197;17078;62058
150172;202006;4853;13328;3893;11971;263;738;2953;9376;3216;10114
150175;202006;1625;5143;1353;4613;247;885;774;2675;1021;3560
150178;202006;10510;28298;8713;26201;206;521;7804;23803;8010;24324
150180;202006;22533;79608;20305;77033;1098;3642;17816;69248;18914;72890
150190;202006;6743;22748;6262;22141;252;1159;5558;19543;5810;20702
150195;202006;5128;16558;4867;16151;70;381;4515;14835;4585;15216
150200;202006;5895;17165;5390;16604;64;172;5101;15828;5165;16000
150210;202006;26315;91078;24510;88661;1690;6108;20296;75595;21986;81703
150215;202006;7665;21734;6591;20161;1184;3525;3920;12544;5104;16069
150220;202006;12506;35176;10913;32901;1074;3102;7576;23368;8650;26470
150230;202006;12209;34894;10747;32941;1132;3084;7458;23921;8590;27005
150240;202006;32218;89654;26662;80121;7277;22303;9229;28194;16506;50497
150250;202006;4256;16234;3961;15896;606;2351;3046;12575;3652;14926
150260;202006;2764;9010;2509;8616;155;506;2007;6989;2162;7495
150270;202006;8840;25331;6226;20698;2004;6942;1645;5858;3649;12800
150275;202006;6907;22008;6307;21173;239;916;5480;18342;5719;19258
150276;202006;2372;6251;2026;5841;259;664;1397;4443;1656;5107
150277;202006;5196;13560;4186;12388;315;832;3224;10182;3539;11014
150280;202006;6863;27659;6612;27250;474;1919;5610;23409;6084;25328
150285;202006;3295;11515;2885;10872;237;914;2122;8142;2359;9056
150290;202006;10476;28689;9450;27592;287;617;8551;25582;8838;26199
150293;202006;9376;23151;7144;20200;925;2652;4407;13096;5332;15748
150295;202006;7688;20695;5649;17942;1840;6232;1973;7181;3813;13413
150300;202006;2417;7187;2161;6864;35;125;1971;6295;2006;6420
150304;202006;4098;12156;3376;11036;596;1854;2069;7090;2665;8944
150307;202006;6163;19806;5675;18991;342;1146;4628;15656;4970;16802
150309;202006;6242;18790;5029;16692;875;2872;2827;9814;3702;12686
150310;202006;7299;28994;6947;28576;207;1175;6209;25758;6416;26933
150320;202006;9463;25815;8624;24591;413;1257;6693;19041;7106;20298
150330;202006;14076;45124;12966;43349;1250;3900;9761;33679;11011;37579
150340;202006;2544;7439;2258;7012;333;964;1547;4971;1880;5935
150345;202006;8153;23881;7309;22749;435;1419;6215;19425;6650;20844
150350;202006;8995;22547;8288;21632;701;1315;6840;18439;7541;19754
150360;202006;24436;67027;19560;60852;2055;5139;13888;46145;15943;51284
150370;202006;10773;32729;8837;30122;1005;2887;6423;23587;7428;26474
150375;202006;3567;14367;3207;13843;227;1096;2725;11864;2952;12960
150380;202006;11174;28545;9165;25911;118;442;8102;22928;8220;23370
150390;202006;7986;31828;7162;30532;1085;4039;5100;23034;6185;27073
150400;202006;6546;23468;6281;22970;283;1044;5473;20113;5756;21157
150405;202006;9275;24387;8095;22973;483;1135;6548;19185;7031;20320
150410;202006;1936;6159;1640;5651;223;690;1039;3700;1262;4390
150420;202006;40712;112192;31277;98210;8678;28599;10728;39238;19406;67837
150430;202006;8491;24798;7734;23817;872;1997;6015;19462;6887;21459
150440;202006;5673;18218;5157;17480;760;2263;3616;12866;4376;15129
150442;202006;26619;63141;21873;57196;2282;5863;15154;40482;17436;46345
150445;202006;6309;19537;5534;18359;206;728;4730;15727;4936;16455
150450;202006;5097;21832;4713;21307;362;1783;4055;18345;4417;20128
150460;202006;8399;27638;7676;26718;249;999;6568;23688;6817;24687
150470;202006;21922;56617;19527;53894;363;1018;18363;50717;18726;51735
150475;202006;4920;15439;4243;14417;161;610;3551;12209;3712;12819
150480;202006;13722;44399;12266;42205;2200;6853;8128;29871;10328;36724
150490;202006;8389;29042;7696;28183;272;1149;6831;25164;7103;26313
150495;202006;5302;18183;5065;17847;110;552;4600;16127;4710;16679
150497;202006;2876;9085;2307;8097;508;1813;1206;4560;1714;6373
150500;202006;3285;8448;2922;7942;236;566;2282;6217;2518;6783
150503;202006;4824;12378;3329;10430;990;3343;1066;3835;2056;7178
150506;202006;10451;30922;8766;28633;1871;5343;5429;19731;7300;25074
150510;202006;9909;35980;8550;33419;1261;4627;5595;23054;6856;27681
150520;202006;6987;27330;6680;26947;231;1394;5980;24037;6211;25431
150530;202006;12464;42439;10776;40014;1540;4618;7717;30638;9257;35256
150540;202006;4993;13612;4243;12493;232;619;3540;10495;3772;11114
150543;202006;7423;19851;6113;18204;496;1484;4683;14583;5179;16067
150548;202006;10123;31680;9110;30290;254;1040;8072;26895;8326;27935
150549;202006;2009;5964;1719;5565;46;196;1464;4749;1510;4945
150550;202006;20173;59226;16794;53640;4021;13097;7343;25074;11364;38171
150553;202006;28846;83175;22716;72132;6642;21440;8204;27911;14846;49351
150555;202006;1937;5153;1514;4496;140;326;1041;3251;1181;3577
150560;202006;1844;5619;1635;5207;267;815;974;3218;1241;4033
150563;202006;2534;7642;2130;6943;430;1506;1192;3899;1622;5405
150565;202006;4363;13936;3883;13183;101;438;3241;11109;3342;11547
150570;202006;6335;20124;5896;19510;275;1034;5097;16850;5372;17884
150580;202006;10559;41343;9090;39697;623;3192;7360;33294;7983;36486
150590;202006;8138;27944;6968;26553;178;1048;6325;24016;6503;25064
150600;202006;9748;32275;9038;31415;218;833;8360;29267;8578;30100
150610;202006;2877;8484;2566;7981;90;378;2160;6636;2250;7014
150611;202006;3223;9027;2851;8509;92;347;2520;7474;2612;7821
150613;202006;13431;36966;10110;31241;1876;6159;4982;15395;6858;21554
150616;202006;3439;9418;2498;7865;588;1934;1078;3375;1666;5309
150618;202006;6842;19795;5521;17751;488;1539;3572;12139;4060;13678
150619;202006;6364;17835;5257;16289;179;618;4452;13915;4631;14533
150620;202006;6812;22537;5859;20926;666;2260;4007;14761;4673;17021
150630;202006;6300;16990;5749;16307;422;1118;4785;13723;5207;14841
150635;202006;4754;13063;3987;11841;545;1511;2564;7902;3109;9413
150640;202006;2275;6663;2067;6407;36;101;1921;6036;1957;6137
150650;202006;11654;32358;10128;29895;2971;8291;4451;14373;7422;22664
150655;202006;5826;16640;5269;15826;202;623;4548;13659;4750;14282
150658;202006;4427;12492;3503;11105;531;1779;2124;7111;2655;8890
150660;202006;5755;16429;5109;15510;465;1341;3594;11195;4059;12536
150670;202006;8437;19470;6580;17373;651;1396;5156;14381;5807;15777
150680;202006;69195;201722;53168;176269;12729;41311;23824;89340;36553;130651
150690;202006;2879;7391;2484;6927;95;217;2211;6316;2306;6533
150700;202006;6198;18250;5523;17375;355;919;4386;14198;4741;15117
150710;202006;3798;12641;3445;12070;279;956;2614;9367;2893;10323
150715;202006;4990;14347;4079;12965;298;917;3202;10346;3500;11263
150720;202006;6922;24458;6414;23667;426;1688;5339;19925;5765;21613
150730;202006;12036;36511;10419;34220;1201;4077;7696;26001;8897;30078
150740;202006;3990;11134;3525;10404;302;727;2673;8074;2975;8801
150745;202006;5084;14449;4091;12978;823;2761;2588;8299;3411;11060
150746;202006;1642;5009;1493;4797;79;255;1224;3948;1303;4203
150747;202006;4914;15566;4321;14594;690;2060;2951;10438;3641;12498
150750;202006;3697;11528;3101;10619;217;808;2346;8295;2563;9103
150760;202006;11953;35126;10834;33573;1480;4188;7673;24550;9153;28738
150770;202006;6379;22808;6000;22374;185;559;5461;21016;5646;21575
150775;202006;937;2611;723;2322;134;478;391;1255;525;1733
150780;202006;4543;13629;4022;13022;151;434;3609;11989;3760;12423
150790;202006;5688;16085;4876;15215;225;513;3906;13548;4131;14061
150795;202006;14042;43251;12237;40441;2989;9335;7006;24684;9995;34019
150796;202006;3872;9440;3362;8853;185;441;2855;7632;3040;8073
150797;202006;3950;12216;3405;11435;141;367;2911;9951;3052;10318
150800;202006;13476;42120;12107;40302;1443;4520;9185;31571;10628;36091
150803;202006;7052;22678;6596;21961;367;1152;5609;18843;5976;19995
150805;202006;3496;10719;2961;9937;210;711;2322;7934;2532;8645
150808;202006;6043;17056;4426;14403;1722;6205;620;2302;2342;8507
150810;202006;20808;54429;15727;48320;3278;10295;7995;27177;11273;37472
150812;202006;5313;14980;4663;13918;415;1305;3451;10120;3866;11425
150815;202006;9474;27916;7903;26054;614;2038;6532;21870;7146;23908
150820;202006;11972;32850;10100;30500;1107;2840;7665;24269;8772;27109
150830;202006;11889;43420;11010;42344;421;1814;9569;37776;9990;39590
150835;202006;2365;7825;2008;7187;342;1201;1152;4192;1494;5393
150840;202006;7619;21381;6057;18860;992;3329;3407;10524;4399;13853
160005;202006;1204;3325;1065;3148;61;216;896;2661;957;2877
160010;202006;2457;6466;2290;6283;20;106;2224;6029;2244;6135
160015;202006;2806;8204;2489;7812;70;236;2292;7221;2362;7457
160020;202006;2088;6693;1826;6365;156;519;1436;5178;1592;5697
160021;202006;1105;4261;1018;4155;60;337;842;3409;902;3746
160023;202006;1269;4479;1120;4230;120;415;787;3157;907;3572
160025;202006;1866;5663;1769;5552;12;38;1721;5424;1733;5462
160027;202006;9061;25089;8090;23845;641;1808;6513;19598;7154;21406
160030;202006;71080;201804;57337;183333;12130;36388;31199;110031;43329;146419
160040;202006;5738;19525;5213;18859;71;335;4880;17783;4951;18118
160050;202006;4809;14517;3763;13100;1414;4720;1307;5682;2721;10402
160053;202006;3749;11647;3393;11203;244;700;2797;9569;3041;10269
160055;202006;910;2645;875;2605;32;100;808;2408;840;2508
160060;202006;24869;66075;20107;60662;918;2957;15975;50518;16893;53475
160070;202006;2753;10393;2463;9944;198;787;1932;8064;2130;8851
160080;202006;3344;10635;2990;10237;31;164;2794;9633;2825;9797
170025;202006;604;1570;431;1314;69;218;222;700;291;918
170030;202006;1226;3717;944;3209;147;504;455;1601;602;2105
170035;202006;1478;3836;1089;3214;89;285;664;1970;753;2255
170040;202006;1898;5322;1497;4762;99;360;928;3065;1027;3425
170070;202006;1846;4301;1301;3604;76;236;779;2251;855;2487
170100;202006;2456;7001;2035;6299;200;561;1287;4133;1487;4694
170105;202006;735;2128;502;1631;133;380;169;573;302;953
170110;202006;965;2920;736;2487;126;441;342;1117;468;1558
170130;202006;1317;3928;939;3196;179;651;441;1534;620;2185
170190;202006;1384;3877;990;3240;350;1217;173;728;523;1945
170200;202006;2038;4885;1307;3667;208;618;538;1493;746;2111
170210;202006;24815;67428;18707;57190;6415;21353;2338;8233;8753;29586
170215;202006;1328;3539;1051;3154;39;160;830;2482;869;2642
170220;202006;5766;17939;4821;16224;1313;4241;1974;7274;3287;11515
170230;202006;1224;3655;908;3029;265;894;164;607;429;1501
170240;202006;2606;7317;2011;6347;140;527;1415;4354;1555;4881
170255;202006;3932;11418;2785;9307;491;1679;1266;4350;1757;6029
170270;202006;958;2305;631;1841;38;109;373;1083;411;1192
170290;202006;2862;8508;2457;7986;114;380;1929;6458;2043;6838
170300;202006;1989;5351;1599;4768;174;508;1073;3261;1247;3769
170305;202006;625;1720;519;1538;68;236;265;775;333;1011
170307;202006;956;3236;769;2871;105;410;424;1601;529;2011
170310;202006;1580;3935;1086;3140;169;543;508;1471;677;2014
170320;202006;1008;2629;758;2222;64;207;489;1465;553;1672
170330;202006;910;2800;825;2671;40;185;686;2159;726;2344
170360;202006;505;1377;348;1115;24;87;225;683;249;770
170370;202006;1264;3412;899;2777;280;817;225;839;505;1656
170380;202006;1775;5111;1310;4381;94;377;766;2607;860;2984
170382;202006;533;1593;434;1420;29;120;318;1010;347;1130
170384;202006;1542;5501;1253;4935;252;1032;640;2566;892;3598
170386;202006;930;2518;574;1817;78;279;202;615;280;894
170388;202006;614;1752;427;1408;60;215;196;655;256;870
170389;202006;1027;3188;844;2888;43;175;620;2168;663;2343
170390;202006;1728;3966;1292;3430;47;108;1061;2901;1108;3009
170410;202006;566;1656;406;1354;32;134;247;801;279;935
170460;202006;366;958;293;839;39;103;188;558;227;661
170510;202006;899;2611;656;2168;44;182;419;1330;463;1512
170550;202006;6489;17341;4717;14447;1191;3919;1130;3741;2321;7660
170555;202006;1390;3771;1082;3285;59;194;540;1712;599;1906
170560;202006;1015;2869;755;2503;57;218;484;1692;541;1910
170600;202006;1293;3492;1047;3146;226;540;583;1914;809;2454
170610;202006;1643;4349;1177;3650;88;297;722;2210;810;2507
170625;202006;430;1176;265;837;45;143;85;254;130;397
170650;202006;1227;3631;955;3182;136;477;543;1874;679;2351
170700;202006;3319;9805;2469;8165;497;1665;1101;3756;1598;5421
170710;202006;1492;3911;1131;3333;153;489;708;2089;861;2578
170720;202006;1725;4346;1313;3691;190;526;735;2153;925;2679
170730;202006;1040;2821;767;2371;135;372;388;1276;523;1648
170740;202006;2050;6795;1759;6262;156;618;1281;4534;1437;5152
170755;202006;896;2471;617;1985;62;214;306;961;368;1175
170765;202006;1140;2961;788;2388;165;501;341;1077;506;1578
170770;202006;1843;5348;1494;4801;174;529;981;3256;1155;3785
170820;202006;3310;9985;2609;8685;520;1802;1207;4151;1727;5953
170825;202006;969;2258;773;1995;80;199;566;1465;646;1664
170830;202006;1406;3743;1147;3339;145;405;768;2291;913;2696
170900;202006;2678;8406;2243;7778;190;636;1772;6246;1962;6882
170930;202006;3694;10246;2813;8586;655;2119;928;2839;1583;4958
170950;202006;11130;30786;7627;24414;2141;7802;889;3101;3030;10903
170980;202006;453;1208;362;1070;14;63;266;744;280;807
171050;202006;1606;5055;1390;4681;48;224;1156;3877;1204;4101
171070;202006;1318;3791;1120;3498;299;941;488;1769;787;2710
171090;202006;1046;2580;830;2273;76;207;553;1498;629;1705
171110;202006;570;1525;398;1204;61;185;189;527;250;712
171150;202006;1106;2728;669;1978;63;219;405;1182;468;1401
171180;202006;792;2167;524;1647;93;272;217;692;310;964
171190;202006;1735;5858;1492;5428;237;942;890;3344;1127;4286
171195;202006;801;2571;638;2262;86;360;382;1334;468;1694
171200;202006;550;1544;408;1294;71;233;182;581;253;814
171215;202006;355;996;288;879;32;107;200;596;232;703
171240;202006;752;2492;608;2210;34;177;411;1459;445;1636
171245;202006;644;1945;494;1629;45;172;300;948;345;1120
171250;202006;1015;2667;733;2247;130;419;335;1049;465;1468
171270;202006;464;1644;360;1422;76;302;160;681;236;983
171280;202006;873;2627;680;2277;67;234;389;1364;456;1598
171320;202006;3939;11081;3013;9439;622;1925;1138;3767;1760;5692
171330;202006;2735;7515;2091;6385;414;1255;982;3127;1396;4382
171360;202006;1391;4038;1095;3601;78;282;790;2660;868;2942
171370;202006;690;1744;522;1506;50;138;353;1027;403;1165
171380;202006;1464;4033;1221;3687;114;321;881;2748;995;3069
171395;202006;960;2658;664;2099;58;231;407;1234;465;1465
171420;202006;1953;5728;1405;4620;238;847;635;2099;873;2946
171430;202006;1020;3018;839;2677;59;204;570;1754;629;1958
171488;202006;2302;6859;1798;6000;268;875;929;3247;1197;4122
171500;202006;985;2438;742;2070;43;117;572;1612;615;1729
171510;202006;805;2631;693;2416;44;197;483;1658;527;1855
171515;202006;465;1183;330;965;29;81;201;565;230;646
171525;202006;696;1978;525;1701;21;77;305;948;326;1025
171550;202006;343;994;257;852;31;114;143;465;174;579
171570;202006;1132;3448;944;3105;118;380;553;1883;671;2263
171575;202006;1812;4844;1151;3638;113;386;519;1640;632;2026
171610;202006;5747;16028;4281;13492;894;3177;1188;4010;2082;7187
171620;202006;2592;7331;2172;6721;100;385;1770;5496;1870;5881
171630;202006;954;2515;750;2234;107;316;507;1556;614;1872
171650;202006;2029;5780;1552;4968;387;1349;458;1612;845;2961
171660;202006;2347;5948;1592;4684;234;632;825;2483;1059;3115
171665;202006;1246;3490;961;3024;164;580;451;1437;615;2017
171670;202006;1899;5037;1447;4292;196;643;786;2339;982;2982
171700;202006;1205;3438;873;2830;114;362;465;1547;579;1909
171720;202006;787;2022;615;1753;53;173;443;1236;496;1409
171750;202006;1293;3636;877;2847;226;758;107;445;333;1203
171780;202006;1224;3117;870;2594;93;303;574;1675;667;1978
171790;202006;1381;4562;1130;4044;212;787;527;1929;739;2716
171800;202006;717;1980;535;1702;63;255;305;951;368;1206
171820;202006;11235;31505;8231;26255;2028;6697;2474;8545;4502;15242
171830;202006;1493;4849;1248;4409;107;477;807;2851;914;3328
171840;202006;763;2031;590;1758;24;74;389;1151;413;1225
171845;202006;642;1573;484;1338;47;163;309;830;356;993
171850;202006;888;2945;753;2638;69;307;535;1821;604;2128
171855;202006;1042;3189;879;2888;71;234;542;1751;613;1985
171865;202006;370;1164;300;1042;50;195;147;485;197;680
171870;202006;819;2268;577;1826;68;216;295;949;363;1165
171875;202006;1270;3712;1000;3270;41;176;760;2472;801;2648
171880;202006;1154;3527;1012;3338;43;139;805;2720;848;2859
171884;202006;861;2449;633;2056;115;436;231;777;346;1213
171886;202006;1359;3768;963;3109;282;1033;192;630;474;1663
171888;202006;717;2006;485;1573;30;115;306;972;336;1087
171889;202006;379;1176;301;1019;66;243;122;408;188;651
171890;202006;1188;3302;857;2767;177;543;471;1570;648;2113
171900;202006;546;1881;394;1494;81;299;162;638;243;937
172000;202006;572;1692;477;1509;48;150;273;841;321;991
172010;202006;993;3426;843;3118;72;303;517;1887;589;2190
172015;202006;379;1313;278;1103;68;276;109;449;177;725
172020;202006;2608;7491;2283;7062;155;519;1704;5467;1859;5986
172025;202006;706;1950;516;1636;34;130;377;1191;411;1321
172030;202006;1220;3604;1036;3307;54;212;806;2565;860;2777
172049;202006;1297;3121;873;2532;180;500;437;1383;617;1883
172065;202006;1440;3582;1107;3166;102;220;870;2680;972;2900
172080;202006;2337;6871;1882;6082;106;376;1259;4051;1365;4427
172085;202006;473;1286;305;923;48;138;114;328;162;466
172090;202006;3993;10059;3072;8839;117;371;2339;6786;2456;7157
172093;202006;481;1421;341;1169;24;120;198;641;222;761
172097;202006;672;1784;465;1420;63;198;205;636;268;834
172100;202006;48894;121052;34123;97408;6009;19040;12262;35912;18271;54952
172110;202006;1569;5759;1345;5396;125;518;987;4164;1112;4682
172120;202006;4966;14622;3880;12858;499;1736;2196;7482;2695;9218
172125;202006;364;977;272;824;25;83;159;461;184;544
172130;202006;638;1552;494;1323;26;85;343;840;369;925
172208;202006;2530;6229;2028;5580;183;425;1464;4140;1647;4565
172210;202006;2661;6768;2034;5960;325;1039;1162;3552;1487;4591
210005;202006;18711;53856;14246;46392;4139;14018;5423;18544;9562;32562
210010;202006;1923;5936;1732;5703;74;316;1503;4969;1577;5285
210015;202006;3300;9868;2943;9402;110;308;2587;8365;2697;8673
210020;202006;7315;17320;6253;16088;74;223;5798;14982;5872;15205
210030;202006;4700;15534;4329;14975;199;888;3739;12914;3938;13802
210040;202006;1776;4271;1603;4057;25;44;1517;3876;1542;3920
210043;202006;6104;17578;5155;16262;433;1287;3942;12747;4375;14034
210047;202006;6573;20437;5338;18784;129;656;4640;16331;4769;16987
210050;202006;2214;7506;1736;6616;154;697;1214;4609;1368;5306
210055;202006;1869;6008;1686;5728;66;261;1427;4864;1493;5125
210060;202006;7246;26527;6422;25049;709;2890;4569;18311;5278;21201
210070;202006;7116;20292;6657;19697;40;182;6301;18600;6341;18782
210080;202006;4283;14525;4062;14284;42;261;3725;13177;3767;13438
210083;202006;5518;16090;4549;15065;37;182;4326;14389;4363;14571
210087;202006;3026;8232;2620;7707;100;230;2275;6872;2375;7102
210090;202006;9172;28830;8526;27689;502;1348;7243;23787;7745;25135
210095;202006;6354;20449;5797;19745;219;902;4980;17388;5199;18290
210100;202006;6788;20708;6073;19594;307;1083;4946;16027;5253;17110
210110;202006;2944;9642;2718;9374;50;301;2495;8564;2545;8865
210120;202006;22693;62469;18708;57209;1847;4630;12744;41462;14591;46092
210125;202006;4411;11784;3857;11137;722;1622;2783;8643;3505;10265
210130;202006;4365;11494;3617;10562;157;343;3082;9133;3239;9476
210135;202006;1446;4356;1242;4029;62;180;1005;3329;1067;3509
210140;202006;18935;49659;14473;43902;2733;7960;8160;26247;10893;34207
210150;202006;4405;10622;3918;9955;137;381;3424;8613;3561;8994
210160;202006;16469;48188;14187;45311;1255;4260;10073;33338;11328;37598
210170;202006;14982;46656;13917;45293;755;2171;12245;40255;13000;42426
210173;202006;2241;8614;2095;8355;75;460;1840;7318;1915;7778
210177;202006;3453;9450;3004;8905;120;230;2663;8184;2783;8414
210180;202006;1441;3884;1270;3681;25;66;1152;3350;1177;3416
210190;202006;5295;14386;4474;13284;73;352;3878;11364;3951;11716
210193;202006;1287;3765;1140;3536;31;141;897;2823;928;2964
210197;202006;2063;6476;1895;6244;137;462;1559;5209;1696;5671
210200;202006;7622;24553;6753;23103;404;1561;5419;18515;5823;20076
210203;202006;7062;20751;6040;19379;398;1308;4926;16190;5324;17498
210207;202006;3935;9652;3029;8689;140;310;2542;7486;2682;7796
210210;202006;8031;26194;7345;25261;131;801;6614;22605;6745;23406
210215;202006;2446;7755;2084;7208;55;272;1846;6414;1901;6686
210220;202006;6099;21166;5774;20673;177;1159;5106;17888;5283;19047
210230;202006;5077;15482;4589;14751;386;998;3841;12665;4227;13663
210232;202006;11106;35070;9104;32026;1533;5399;5693;21371;7226;26770
210235;202006;3336;10032;2933;9478;64;280;2616;8478;2680;8758
210237;202006;2739;9099;2345;8637;32;197;2168;7991;2200;8188
210240;202006;2583;8210;2382;7852;81;323;2055;6706;2136;7029
210250;202006;5598;17106;5086;16473;72;430;4595;14828;4667;15258
210255;202006;2498;7660;2109;6970;278;942;1352;4472;1630;5414
210260;202006;5457;16339;4826;15421;212;774;4187;13379;4399;14153
210270;202006;4795;13348;4271;12695;106;478;3799;11218;3905;11696
210275;202006;3511;8909;3101;8420;61;132;2811;7748;2872;7880
210280;202006;5515;15792;4414;14082;260;1044;3204;10094;3464;11138
210290;202006;7212;19435;6442;18472;110;358;5980;17152;6090;17510
210300;202006;33310;90020;26995;81003;1869;5907;19339;60106;21208;66013
210310;202006;3060;7864;2701;7341;120;269;2359;6450;2479;6719
210312;202006;2659;6825;2339;6478;31;138;2191;6003;2222;6141
210315;202006;2937;8252;2511;7767;55;155;2298;7245;2353;7400
210317;202006;4044;12891;3658;12437;98;538;3299;11146;3397;11684
210320;202006;18788;57236;17150;55060;384;1901;15211;48571;15595;50472
210325;202006;3615;10232;3100;9558;90;268;2757;8676;2847;8944
210330;202006;24541;69143;19705;62903;5966;17144;9357;34676;15323;51820
210340;202006;9996;29436;8850;27884;702;2216;6775;21964;7477;24180
210350;202006;9168;26592;8008;25168;154;540;7154;22616;7308;23156
210355;202006;4253;14262;3735;13454;103;518;3179;11517;3282;12035
210360;202006;13438;42292;11987;40150;595;2710;9175;30274;9770;32984
210370;202006;10718;24227;8312;21679;241;413;7622;20375;7863;20788
210375;202006;3235;8626;2468;7592;640;2000;1115;3812;1755;5812
210380;202006;5405;13907;4664;13044;202;483;3998;11288;4200;11771
210390;202006;2569;9039;2371;8693;116;533;2013;7347;2129;7880
210400;202006;4409;13604;3915;12992;119;381;3521;11842;3640;12223
210405;202006;6862;18580;5520;16647;1048;2937;3109;10000;4157;12937
210407;202006;1946;6484;1623;5890;73;327;1310;4704;1383;5031
210408;202006;2497;9320;2340;9092;147;700;1916;7466;2063;8166
210409;202006;3760;13060;3432;12606;104;593;2850;10530;2954;11123
210410;202006;3414;10492;2896;9632;149;602;2212;7284;2361;7886
210420;202006;3826;12253;3465;11625;205;634;2907;9861;3112;10495
210430;202006;2235;6574;1993;6268;70;190;1765;5628;1835;5818
210440;202006;4363;11712;3787;10989;64;229;3496;10094;3560;10323
210450;202006;2416;7159;2071;6654;81;295;1712;5472;1793;5767
210455;202006;4269;11260;3240;9943;944;2926;1504;4890;2448;7816
210460;202006;3678;10474;3107;9744;61;259;2770;8638;2831;8897
210462;202006;1634;4964;1390;4564;36;146;1129;3747;1165;3893
210465;202006;2686;7798;2348;7342;52;207;2044;6372;2096;6579
210467;202006;5851;18752;5078;17726;298;1207;4208;14850;4506;16057
210470;202006;2030;5342;1440;4500;94;221;1102;3586;1196;3807
210480;202006;16329;47802;13457;44249;1141;3433;9882;35053;11023;38486
210490;202006;3674;9334;2975;8356;62;178;2588;7305;2650;7483
210500;202006;6271;24160;5752;23266;338;1695;4787;19246;5125;20941
210510;202006;5930;19627;5187;18823;127;556;4640;17131;4767;17687
210515;202006;3658;10839;3200;10318;101;383;2774;9090;2875;9473
210520;202006;2507;7195;2249;6870;69;245;1987;6037;2056;6282
210530;202006;52381;127820;40512;110227;6707;22560;10952;37789;17659;60349
210535;202006;3045;10413;2845;10095;119;464;2402;8590;2521;9054
210540;202006;14424;41820;11999;38425;1388;4137;8452;28333;9840;32470
210542;202006;6439;14973;5183;13602;324;525;4282;12035;4606;12560
210545;202006;2205;6851;2073;6636;42;178;1829;5796;1871;5974
210547;202006;3533;12710;3117;11885;294;1118;2316;9035;2610;10153
210550;202006;6110;18421;4829;16413;331;1298;3574;12455;3905;13753
210560;202006;3528;10782;3147;10168;119;386;2647;8487;2766;8873
210565;202006;1468;4809;1223;4446;57;307;973;3563;1030;3870
210570;202006;10344;28214;9192;26803;273;754;8191;24330;8464;25084
210580;202006;2963;7935;2445;7298;132;269;1968;6176;2100;6445
210590;202006;4270;12730;3688;11984;70;381;3285;10614;3355;10995
210592;202006;2633;7787;2427;7457;25;121;2152;6559;2177;6680
210594;202006;2490;6719;1898;5801;74;221;1403;4438;1477;4659
210596;202006;2510;8922;2247;8389;103;455;1837;6875;1940;7330
210598;202006;1803;5288;1664;5081;33;136;1500;4541;1533;4677
210600;202006;3028;8075;2451;7271;91;215;1993;6024;2084;6239
210610;202006;2678;7552;2295;7080;60;284;1946;5987;2006;6271
210620;202006;2738;7443;2288;6903;59;171;2105;6450;2164;6621
210630;202006;2979;10042;2722;9620;106;553;2271;7907;2377;8460
210632;202006;4377;14157;3874;13432;206;941;3093;10623;3299;11564
210635;202006;1727;6180;1625;6000;99;363;1352;5088;1451;5451
210637;202006;2406;7987;2094;7538;145;625;1589;5782;1734;6407
210640;202006;4550;16344;4267;16003;68;350;3876;14569;3944;14919
210650;202006;7344;21013;6685;20187;79;313;6196;18762;6275;19075
210660;202006;8044;23992;7127;22522;247;996;6218;19407;6465;20403
210663;202006;2544;7460;2334;7213;126;307;2002;6361;2128;6668
210667;202006;1937;6304;1740;6016;35;142;1579;5519;1614;5661
210670;202006;4493;15105;4095;14479;103;511;3596;12647;3699;13158
210675;202006;5016;13582;4280;12628;186;455;3621;10944;3807;11399
210680;202006;4509;11035;3800;10179;120;192;3436;9400;3556;9592
210690;202006;7623;23371;6397;22016;238;1051;5674;19653;5912;20704
210700;202006;2702;7650;2140;6841;140;443;1586;5295;1726;5738
210710;202006;4869;15339;4273;14497;107;601;3772;12646;3879;13247
210720;202006;2908;9621;2612;9252;53;316;2357;8295;2410;8611
210725;202006;1284;4362;1122;4117;39;163;821;3137;860;3300
210730;202006;1178;3090;989;2825;50;130;831;2378;881;2508
210735;202006;4628;13640;3945;12730;179;546;3400;11226;3579;11772
210740;202006;5245;14193;4561;13422;96;322;3865;11392;3961;11714
210745;202006;4361;11970;4046;11569;109;337;3714;10590;3823;10927
210750;202006;23031;58734;19911;54813;1640;4224;13971;40627;15611;44851
210760;202006;5895;15608;4986;14648;29;65;4739;14055;4768;14120
210770;202006;6103;15721;5249;14736;56;250;4951;13825;5007;14075
210780;202006;7241;23011;6341;21507;528;1596;5017;17362;5545;18958
210790;202006;4189;13317;3759;12755;179;451;3110;11069;3289;11520
210800;202006;4869;12954;4172;12031;53;224;3784;10799;3837;11023
210805;202006;3910;14255;3721;13979;100;540;3347;12494;3447;13034
210810;202006;4818;14067;4394;13518;283;615;3684;11720;3967;12335
210820;202006;6860;19530;5704;17679;664;2123;3409;10926;4073;13049
210825;202006;6669;20756;6022;19900;246;828;5216;17476;5462;18304
210830;202006;7639;21573;6943;20721;343;786;6029;18457;6372;19243
210840;202006;3167;8440;2832;7991;62;213;2520;7013;2582;7226
210845;202006;6473;17504;5811;16784;19;83;5606;16249;5625;16332
210850;202006;5902;20067;4917;18599;234;1182;3877;14720;4111;15902
210860;202006;20920;54048;17417;49642;769;1892;14056;42233;14825;44125
210870;202006;7286;19010;5740;17237;230;637;5003;15140;5233;15777
210880;202006;4230;13076;3829;12607;178;689;3196;10526;3374;11215
210890;202006;3844;11352;3449;10881;235;635;2808;9176;3043;9811
210900;202006;4456;13096;3377;11036;1328;4646;550;2038;1878;6684
210905;202006;1984;5496;1643;5058;44;79;1497;4723;1541;4802
210910;202006;7197;21768;5966;19762;788;2662;3919;13125;4707;15787
210920;202006;3210;10581;2776;10008;70;407;2501;8933;2571;9340
210923;202006;1508;4538;1296;4203;71;239;960;3151;1031;3390
210927;202006;5191;16506;4571;15775;218;773;3801;13395;4019;14168
210930;202006;2469;8547;2165;7952;172;705;1624;5960;1796;6665
210940;202006;4051;11504;3760;11159;109;445;3456;10149;3565;10594
210945;202006;6371;18469;5712;17686;221;647;4804;15261;5025;15908
210950;202006;5157;14364;3979;12735;608;1538;2633;9215;3241;10753
210955;202006;1544;4902;1327;4521;128;455;938;3272;1066;3727
210960;202006;8935;26666;7660;24753;1248;3770;4953;16768;6201;20538
210970;202006;1318;4068;1048;3610;64;237;802;2708;866;2945
210975;202006;1729;5428;1548;5139;55;209;1250;4166;1305;4375
210980;202006;10133;23457;8867;22147;76;187;8419;21097;8495;21284
210990;202006;15786;44829;12451;40437;688;2475;9368;31219;10056;33694
211000;202006;14383;42182;12113;39419;677;2314;9724;32942;10401;35256
211003;202006;5577;16731;4689;15670;127;514;4059;13860;4186;14374
211010;202006;6382;23049;5730;22257;85;427;5229;20644;5314;21071
211020;202006;8167;23668;7064;22406;195;825;6017;19579;6212;20404
211023;202006;1937;6328;1804;6154;87;317;1539;5243;1626;5560
211027;202006;3060;9793;2896;9534;192;524;2503;8323;2695;8847
211030;202006;3860;10640;3440;10129;227;506;2831;8602;3058;9108
211040;202006;4564;16534;4222;15926;110;685;3782;14119;3892;14804
211050;202006;9041;23616;8209;22541;86;301;7556;20753;7642;21054
211060;202006;6866;20898;6276;20103;121;518;5763;18456;5884;18974
211065;202006;2172;6051;1808;5596;83;224;1493;4787;1576;5011
211070;202006;7649;24328;6466;22534;494;1754;5023;17707;5517;19461
211080;202006;1290;3568;1033;3159;37;191;804;2325;841;2516
211085;202006;2042;5750;1734;5336;91;215;1493;4764;1584;4979
211090;202006;3158;8710;2848;8348;36;166;2639;7702;2675;7868
211100;202006;6673;16969;6162;16359;50;156;5694;15211;5744;15367
211102;202006;3030;10378;2773;10004;122;579;2437;8703;2559;9282
211105;202006;2347;7439;1948;6714;166;590;1414;4848;1580;5438
211107;202006;4610;14613;3929;13613;129;580;3209;11465;3338;12045
211110;202006;5797;15959;4484;13950;351;1022;3309;10519;3660;11541
211120;202006;43693;107400;35892;98319;4839;12162;23281;68172;28120;80334
211125;202006;2054;6092;1731;5601;36;149;1481;4808;1517;4957
211130;202006;186944;442567;161742;409870;23505;57711;75257;218145;98762;275856
211140;202006;4904;14616;4281;13803;208;590;3630;11807;3838;12397
211150;202006;9217;25515;7762;23622;339;1014;6550;20069;6889;21083
211153;202006;2423;7116;1971;6571;273;957;1312;4616;1585;5573
211157;202006;1100;3501;919;3168;34;175;673;2302;707;2477
211160;202006;4036;11384;3166;10129;146;523;2382;7547;2528;8070
211163;202006;1621;5197;1477;4999;20;103;1352;4603;1372;4706
211167;202006;1511;4819;1416;4668;28;125;1302;4267;1330;4392
211170;202006;6416;15847;5961;15329;54;166;5670;14539;5724;14705
211172;202006;2491;6733;2165;6253;105;320;1749;4978;1854;5298
211174;202006;2832;8206;2561;7904;40;205;2389;7337;2429;7542
211176;202006;4196;12038;3252;10655;152;660;2590;8449;2742;9109
211178;202006;4583;10788;3948;10095;34;156;3753;9519;3787;9675
211180;202006;3999;13182;3710;12763;203;747;3162;10946;3365;11693
211190;202006;3038;8950;2572;8262;35;203;2279;7252;2314;7455
211195;202006;1383;3898;1180;3585;61;133;998;3110;1059;3243
211200;202006;2114;6025;1685;5435;206;634;1178;3885;1384;4519
211210;202006;6209;19098;5627;18330;244;1011;4883;15773;5127;16784
211220;202006;36703;92622;29874;84193;2787;7386;22113;64092;24900;71478
211223;202006;5175;13659;4299;12505;354;1052;3259;9540;3613;10592
211227;202006;1754;5836;1591;5600;32;153;1405;5027;1437;5180
211230;202006;7485;21683;6529;20234;398;1064;5258;16678;5656;17742
211240;202006;8044;25688;7620;25142;136;751;7074;23082;7210;23833
211245;202006;6995;17652;6246;16876;88;213;6030;16322;6118;16535
211250;202006;12985;40921;11716;39209;616;2477;9669;32113;10285;34590
211260;202006;7921;25763;7062;24630;202;891;6351;22281;6553;23172
211270;202006;10405;33234;8914;31208;382;1755;7254;25579;7636;27334
211280;202006;12519;34682;11128;32918;916;2153;8926;27619;9842;29772
211285;202006;1752;5783;1539;5482;142;558;1117;4083;1259;4641
211290;202006;7417;22346;6668;21364;178;755;5743;18339;5921;19094
211300;202006;7774;22323;6886;20997;180;610;5980;18085;6160;18695
211400;202006;11259;32073;9150;29198;971;3111;6284;21066;7255;24177
220005;202006;1831;4805;1658;4570;34;130;1401;3784;1435;3914
220010;202006;1472;4216;1206;3738;26;107;941;2883;967;2990
220020;202006;3615;9984;3119;9281;133;478;2576;7596;2709;8074
220025;202006;2227;5057;1910;4587;26;66;1598;3723;1624;3789
220027;202006;1268;3206;1082;2961;20;70;921;2473;941;2543
220030;202006;3308;8352;3092;8063;73;222;2750;7079;2823;7301
220040;202006;7048;21374;6133;19607;1404;4119;3233;10904;4637;15023
220045;202006;1472;4481;1207;4037;30;166;975;3199;1005;3365
220050;202006;4745;12818;4012;11850;61;287;3677;10729;3738;11016
220060;202006;2370;4975;1995;4542;24;57;1872;4252;1896;4309
220070;202006;2455;6164;2096;5647;71;150;1753;4749;1824;4899
220080;202006;711;2020;613;1872;25;95;527;1591;552;1686
220090;202006;1758;4233;1449;3796;19;63;1203;3268;1222;3331
220095;202006;643;1606;599;1559;26;43;540;1427;566;1470
220100;202006;1363;3755;1090;3316;45;160;872;2581;917;2741
220105;202006;1997;6221;1748;5721;114;426;1327;4316;1441;4742
220110;202006;3349;9264;3086;8808;39;199;2767;7786;2806;7985
220115;202006;2693;7815;2492;7546;70;227;2256;6790;2326;7017
220117;202006;1354;3264;1055;2851;11;55;891;2353;902;2408
220120;202006;12674;34099;11565;32720;76;271;10854;30695;10930;30966
220130;202006;1094;2961;929;2733;14;80;841;2448;855;2528
220140;202006;2117;4396;1783;3997;105;268;1563;3442;1668;3710
220150;202006;6319;18771;5771;17847;117;574;4894;14847;5011;15421
220155;202006;1153;3317;920;2886;36;124;649;1996;685;2120
220157;202006;1054;2582;894;2340;20;81;723;1830;743;1911
220160;202006;2802;7789;2418;7093;33;158;2013;5796;2046;5954
220170;202006;1538;4006;1310;3674;12;63;1175;3254;1187;3317
220173;202006;2136;5944;1725;5216;43;190;1381;4065;1424;4255
220177;202006;1976;5648;1869;5529;10;37;1846;5453;1856;5490
220180;202006;1125;2755;917;2403;4;21;711;1752;715;1773
220190;202006;6885;17253;5815;15789;360;1032;4349;11994;4709;13026
220191;202006;1502;4507;1360;4265;73;260;999;3060;1072;3320
220192;202006;2040;5360;1485;4371;30;103;1195;3458;1225;3561
220194;202006;1721;4889;1522;4573;57;212;1249;3708;1306;3920
220196;202006;1996;5145;1803;4855;28;112;1548;4095;1576;4207
220198;202006;1286;3538;1083;3278;9;39;997;3038;1006;3077
220200;202006;5101;14679;4432;13808;96;400;3804;11833;3900;12233
220202;202006;2154;6053;1849;5552;28;150;1593;4708;1621;4858
220205;202006;2479;7116;2219;6650;48;187;1874;5534;1922;5721
220207;202006;785;2331;636;2074;61;207;400;1317;461;1524
220208;202006;1649;5073;1343;4478;157;578;811;2643;968;3221
220209;202006;1575;4465;1355;4079;22;98;1117;3329;1139;3427
220210;202006;1682;4159;1445;3792;12;55;1240;3180;1252;3235
220211;202006;1597;4072;1466;3891;13;58;1289;3431;1302;3489
220213;202006;1743;4662;1509;4258;29;103;1210;3325;1239;3428
220217;202006;2141;6438;1995;6269;40;97;1853;5933;1893;6030
220220;202006;10423;27188;8610;24382;555;1385;5856;17429;6411;18814
220225;202006;1024;2688;824;2428;6;36;767;2231;773;2267
220230;202006;5691;14133;4881;13016;160;381;4208;11278;4368;11659
220240;202006;2980;8605;2700;8120;111;355;2194;6605;2305;6960
220245;202006;1725;4055;1330;3558;11;51;1208;3259;1219;3310
220250;202006;2957;8298;2606;7854;18;96;2440;7324;2458;7420
220253;202006;1566;4285;1378;3972;61;215;1164;3259;1225;3474
220255;202006;1886;4477;1607;4085;36;158;1369;3347;1405;3505
220260;202006;4215;13045;3713;12116;157;599;2959;9643;3116;10242
220265;202006;1310;4174;1177;3994;34;169;967;3216;1001;3385
220270;202006;6138;19487;5765;18800;208;1014;4823;15200;5031;16214
220271;202006;1486;3779;1286;3506;28;102;1134;3070;1162;3172
220272;202006;1758;5043;1561;4685;51;157;1184;3458;1235;3615
220273;202006;1220;3451;1016;3076;34;129;785;2335;819;2464
220275;202006;2255;5386;1788;4744;31;83;1572;4202;1603;4285
220277;202006;2131;5370;1824;4918;22;66;1555;4130;1577;4196
220280;202006;1639;3828;1355;3453;26;80;1149;2902;1175;2982
220285;202006;1425;3604;1216;3364;11;46;1114;3057;1125;3103
220290;202006;6420;18140;5042;16172;361;1287;3676;12052;4037;13339
220300;202006;1965;5663;1595;5174;36;190;1325;4280;1361;4470
220310;202006;3034;8159;2350;7358;41;203;1968;6133;2009;6336
220320;202006;3002;8855;2300;7510;83;401;1793;5668;1876;6069
220323;202006;1626;4741;1282;4182;56;214;1050;3367;1106;3581
220325;202006;1256;3705;1073;3402;22;110;898;2794;920;2904
220327;202006;1497;4259;1300;3937;42;179;1078;3179;1120;3358
220330;202006;4371;10522;3651;9646;55;179;3302;8654;3357;8833
220335;202006;1668;5052;1498;4837;32;107;1333;4322;1365;4429
220340;202006;1839;4855;1415;4146;60;195;965;2739;1025;2934
220342;202006;1144;3341;1019;3156;45;191;807;2471;852;2662
220345;202006;3101;6979;2395;5962;13;42;2174;5389;2187;5431
220350;202006;3274;8356;2597;7344;135;410;1845;5230;1980;5640
220360;202006;1239;3156;977;2727;19;54;778;2161;797;2215
220370;202006;8666;25075;7855;23773;166;732;6859;20479;7025;21211
220375;202006;1596;4527;1411;4301;2;13;1338;4101;1340;4114
220380;202006;1485;3517;1204;3113;15;37;1056;2704;1071;2741
220385;202006;854;2048;680;1726;7;21;591;1480;598;1501
220390;202006;10137;26355;7722;22592;1979;5650;2846;9246;4825;14896
220400;202006;1465;3462;1110;2922;23;69;852;2177;875;2246
220410;202006;1155;3164;927;2781;49;144;750;2217;799;2361
220415;202006;801;2048;671;1838;19;56;541;1461;560;1517
220420;202006;2027;5608;1629;4846;54;166;1253;3675;1307;3841
220430;202006;2453;6610;2303;6391;78;264;1966;5383;2044;5647
220435;202006;1737;4480;1502;4134;39;130;1242;3361;1281;3491
220440;202006;2386;7440;2039;6902;92;385;1713;5709;1805;6094
220450;202006;2470;6386;2005;5807;61;207;1710;4975;1771;5182
220455;202006;1285;3965;1219;3872;11;59;1085;3446;1096;3505
220460;202006;978;2390;909;2301;37;93;775;1941;812;2034
220465;202006;2336;7222;2057;6784;180;600;1508;5086;1688;5686
220470;202006;3464;9574;3102;9009;78;206;2534;7274;2612;7480
220480;202006;2744;7133;2198;6244;176;418;1456;4176;1632;4594
220490;202006;2478;6201;2138;5766;26;128;1862;4953;1888;5081
220500;202006;2768;7096;2414;6526;56;184;1980;5212;2036;5396
220510;202006;2542;7168;1993;6185;80;234;1567;4897;1647;5131
220515;202006;1639;3961;1497;3764;37;60;1306;3281;1343;3341
220520;202006;4901;12722;4413;12035;101;286;3837;10391;3938;10677
220525;202006;1315;3318;1129;3081;9;42;1039;2801;1048;2843
220527;202006;1294;3619;1106;3346;12;53;949;2922;961;2975
220530;202006;1430;3553;1224;3290;30;96;1118;2977;1148;3073
220535;202006;793;2198;741;2129;29;98;606;1728;635;1826
220540;202006;3196;10210;2989;9817;115;400;2562;8383;2677;8783
220545;202006;1388;4194;1272;4005;68;261;1059;3290;1127;3551
220550;202006;8544;26224;7540;24480;494;1738;5685;18296;6179;20034
220551;202006;1395;3972;1214;3661;28;121;993;2933;1021;3054
220552;202006;1599;4617;1300;4087;27;135;1043;3160;1070;3295
220553;202006;1722;4436;1418;4036;57;105;1149;3399;1206;3504
220554;202006;899;2328;656;1927;54;124;418;1234;472;1358
220555;202006;2277;6763;2023;6418;45;184;1689;5435;1734;5619
220556;202006;1194;3463;1032;3152;56;227;742;2171;798;2398
220557;202006;1591;4875;1337;4361;67;267;983;3108;1050;3375
220558;202006;1392;3594;1091;3178;18;81;943;2717;961;2798
220559;202006;1750;4319;1477;3900;9;22;1191;3193;1200;3215
220560;202006;1763;3952;1423;3519;37;71;1294;3222;1331;3293
220570;202006;7132;21277;6479;20360;447;1414;5141;16263;5588;17677
220580;202006;6919;18906;6323;17947;79;291;5730;16145;5809;16436
220585;202006;2002;6307;1662;5681;41;148;1365;4715;1406;4863
220590;202006;1318;3570;1077;3205;70;203;772;2319;842;2522
220595;202006;2525;6891;2288;6572;20;98;2037;5798;2057;5896
220600;202006;1385;3099;1163;2822;87;108;966;2432;1053;2540
220605;202006;1606;4686;1366;4259;19;116;1105;3338;1124;3454
220610;202006;2708;7961;2535;7706;34;151;2363;7163;2397;7314
220620;202006;7774;24113;7150;23268;168;891;6510;20925;6678;21816
220630;202006;371;1083;284;921;22;76;192;617;214;693
220635;202006;1599;5079;1404;4649;54;267;1060;3412;1114;3679
220640;202006;2472;6819;2106;6290;79;316;1708;5036;1787;5352
220650;202006;2052;5657;1779;5243;37;136;1424;4201;1461;4337
220660;202006;2608;8123;2217;7462;80;412;1854;6092;1934;6504
220665;202006;1200;3643;1010;3327;31;173;837;2667;868;2840
220667;202006;1575;4911;1407;4594;58;230;1157;3751;1215;3981
220669;202006;1605;4896;1536;4789;51;242;1358;4135;1409;4377
220670;202006;2167;5652;1738;5052;16;82;1511;4378;1527;4460
220672;202006;3204;7813;2584;7063;104;337;2282;6177;2386;6514
220675;202006;1241;3411;1109;3168;31;103;926;2612;957;2715
220680;202006;2675;7271;2555;7100;100;238;2336;6521;2436;6759
220690;202006;1562;4116;1379;3839;61;174;1091;3050;1152;3224
220695;202006;892;2460;821;2338;20;63;718;2031;738;2094
220700;202006;9843;24236;7889;21534;341;958;6026;16347;6367;17305
220710;202006;893;2463;656;2011;34;109;488;1471;522;1580
220720;202006;2100;4981;1893;4703;15;62;1649;4043;1664;4105
220730;202006;1308;3651;1098;3295;14;77;931;2730;945;2807
220735;202006;956;2231;746;1910;18;63;626;1545;644;1608
220740;202006;1364;3544;1088;3193;29;78;906;2714;935;2792
220750;202006;3833;9723;3339;9011;190;465;2887;7826;3077;8291
220755;202006;1306;3208;1086;2879;23;89;886;2287;909;2376
220760;202006;3076;8559;2685;8031;71;235;2403;7255;2474;7490
220770;202006;22680;67371;19054;61086;5816;19650;6676;22249;12492;41899
220775;202006;1150;2919;1023;2760;10;39;982;2632;992;2671
220777;202006;1603;4051;1214;3454;30;78;932;2667;962;2745
220779;202006;1288;3251;1112;2996;20;62;972;2604;992;2666
220780;202006;5553;14014;4819;12902;200;655;3939;10304;4139;10959
220785;202006;1463;3234;1279;2999;8;20;1235;2881;1243;2901
220790;202006;10008;28529;8978;27054;215;997;7550;22514;7765;23511
220793;202006;914;2399;723;2065;10;23;603;1743;613;1766
220795;202006;1380;3558;1211;3326;16;70;1077;2949;1093;3019
220800;202006;17731;39386;14976;35733;629;1468;11581;27578;12210;29046
220810;202006;3002;8275;2524;7426;53;161;2079;6056;2132;6217
220820;202006;4980;12986;4299;11993;277;677;3251;9063;3528;9740
220830;202006;7240;19235;6496;18204;237;784;5391;14883;5628;15667
220840;202006;12130;37185;10054;32913;2267;7121;4658;15902;6925;23023
220850;202006;3116;9630;2780;9217;59;312;2450;8140;2509;8452
220855;202006;686;1736;592;1606;13;48;540;1454;553;1502
220860;202006;1040;2590;900;2365;16;67;812;2101;828;2168
220865;202006;2431;6433;1904;5509;93;343;1392;3902;1485;4245
220870;202006;2911;8261;2425;7619;34;178;2231;6989;2265;7167
220880;202006;5285;12465;4538;11536;83;301;4134;10397;4217;10698
220885;202006;1373;4209;1134;3807;57;228;904;3072;961;3300
220887;202006;1558;3358;1296;3020;13;30;1201;2779;1214;2809
220890;202006;1392;4260;1217;3992;45;159;1011;3369;1056;3528
220900;202006;2016;4787;1681;4351;31;78;1470;3791;1501;3869
220910;202006;1514;4131;1266;3770;54;166;1050;3141;1104;3307
220915;202006;947;2569;767;2240;5;20;576;1636;581;1656
220920;202006;1377;4364;1181;4101;59;249;977;3404;1036;3653
220930;202006;1726;4649;1447;4247;20;63;1345;3937;1365;4000
220935;202006;1079;3102;875;2676;24;91;576;1670;600;1761
220937;202006;1427;3781;1227;3471;22;79;975;2723;997;2802
220940;202006;1520;4239;1211;3680;38;132;941;2824;979;2956
220945;202006;442;1534;381;1393;21;120;280;983;301;1103
220950;202006;1425;3272;927;2496;18;62;735;1912;753;1974
220955;202006;1594;4109;1328;3644;25;77;1127;3047;1152;3124
220960;202006;808;2044;600;1696;16;55;427;1144;443;1199
220965;202006;1771;4849;1545;4508;21;130;1338;3813;1359;3943
220970;202006;1907;4580;1395;3809;36;88;1157;3146;1193;3234
220975;202006;691;1978;588;1847;16;93;521;1574;537;1667
220980;202006;1141;3209;1011;3036;37;150;847;2512;884;2662
220985;202006;1209;3163;1049;2933;41;123;851;2305;892;2428
220987;202006;1422;4241;1237;3908;56;211;996;3127;1052;3338
220990;202006;1698;4637;1489;4332;19;103;1253;3582;1272;3685
220995;202006;1053;3211;852;2842;35;121;624;2071;659;2192
220997;202006;2369;7098;2187;6806;46;211;1960;6035;2006;6246
221000;202006;4459;12159;3932;11371;88;413;3351;9549;3439;9962
221005;202006;1472;3854;1342;3642;22;122;1164;3038;1186;3160
221010;202006;1205;2748;966;2456;20;60;838;2083;858;2143
221020;202006;1493;4569;1379;4352;22;88;1064;3314;1086;3402
221030;202006;1626;4042;1393;3759;23;71;1198;3284;1221;3355
221035;202006;1490;3911;1301;3656;23;30;1148;3320;1171;3350
221037;202006;666;1850;553;1656;7;24;390;1125;397;1149
221038;202006;517;1454;403;1246;12;42;284;874;296;916
221039;202006;864;2349;737;2128;20;86;600;1663;620;1749
221040;202006;4005;11919;3496;11006;151;535;2770;8709;2921;9244
221050;202006;3905;10207;3423;9595;67;243;3081;8617;3148;8860
221060;202006;8392;23313;6933;21003;253;710;5641;17225;5894;17935
221062;202006;1161;3756;986;3461;41;187;791;2740;832;2927
221063;202006;1049;2869;897;2649;55;182;699;2022;754;2204
221065;202006;2600;6708;2292;6153;21;84;2013;5305;2034;5389
221070;202006;3304;10307;2657;8956;280;937;1638;5647;1918;6584
221080;202006;3478;8536;2819;7564;62;233;2311;6092;2373;6325
221090;202006;1399;3597;1145;3181;9;34;982;2668;991;2702
221093;202006;1360;3822;1238;3574;125;348;850;2410;975;2758
221095;202006;886;2294;738;2064;10;33;618;1697;628;1730
221097;202006;840;2182;645;1836;23;68;474;1293;497;1361
221100;202006;114138;304790;94530;271113;10098;31068;61283;170981;71381;202049
221110;202006;9823;29263;8998;28187;147;747;8050;24953;8197;25700
221120;202006;4767;13096;4232;12231;158;472;3684;10640;3842;11112
221130;202006;5296;13827;3916;11121;760;2043;1887;5419;2647;7462
221135;202006;1639;4302;1473;4080;46;141;1301;3610;1347;3751
221140;202006;1320;3111;1109;2839;11;37;996;2503;1007;2540
221150;202006;1114;2739;863;2299;23;100;666;1659;689;1759
221160;202006;725;1801;636;1684;13;16;519;1381;532;1397
221170;202006;994;2843;899;2671;20;68;776;2277;796;2345
230010;202006;3048;7973;2504;7037;37;137;2037;5600;2074;5737
230015;202006;3019;9736;2639;8980;170;653;1855;6273;2025;6926
230020;202006;12893;40565;12032;39241;330;1368;10219;33156;10549;34524
230030;202006;12935;32315;10774;29508;182;565;9454;25879;9636;26444
230040;202006;4406;11427;3646;10206;44;221;3056;8426;3100;8647
230050;202006;2781;8602;2091;6955;339;1080;931;3021;1270;4101
230060;202006;2356;6427;1863;5554;35;153;1472;4315;1507;4468
230070;202006;3894;10366;3125;8881;144;454;2193;6153;2337;6607
230075;202006;8930;28956;8157;27582;469;1969;6491;21664;6960;23633
230080;202006;3077;6411;2324;5480;7;24;2120;5017;2127;5041
230090;202006;4321;10632;3641;9546;171;443;2909;7578;3080;8021
230100;202006;17732;46162;15559;43195;1158;3321;11185;31173;12343;34494
230110;202006;12679;37601;10633;33575;1714;5383;5625;17882;7339;23265
230120;202006;7335;19784;6438;18307;502;1266;4740;13691;5242;14957
230125;202006;3133;8248;2542;7291;88;299;1952;5521;2040;5820
230130;202006;5731;17589;4629;15138;309;1092;3135;10063;3444;11155
230140;202006;3426;10247;2899;9149;101;414;2202;6785;2303;7199
230150;202006;1570;4707;1297;4098;194;531;760;2493;954;3024
230160;202006;6476;16796;5517;15288;197;690;4468;12163;4665;12853
230170;202006;6236;17678;5061;15249;312;915;3630;10766;3942;11681
230180;202006;1640;4529;1385;4047;21;99;1120;3166;1141;3265
230185;202006;4393;12431;3689;11255;249;847;2754;8377;3003;9224
230190;202006;13142;38203;11017;34251;1451;4724;6259;19291;7710;24015
230195;202006;5250;15472;4751;14529;336;1021;3644;11107;3980;12128
230200;202006;5006;13780;4183;12221;148;477;3196;9136;3344;9613
230205;202006;4052;12107;3541;11317;189;671;2665;8448;2854;9119
230210;202006;10359;24882;8708;22644;339;1116;6867;17546;7206;18662
230220;202006;13938;34916;12150;32322;623;1669;9987;26304;10610;27973
230230;202006;6814;20491;6058;18923;395;1221;4469;13946;4864;15167
230240;202006;13018;34656;11214;31569;276;1158;9251;25441;9527;26599
230250;202006;8913;24980;8285;23999;235;831;6627;18633;6862;19464
230260;202006;14635;43701;12647;40123;1708;5272;7224;23449;8932;28721
230270;202006;7561;20393;5745;16947;477;1364;3792;11269;4269;12633
230280;202006;20350;54260;16531;47775;473;2000;13011;36230;13484;38230
230290;202006;4828;13371;3991;11776;267;709;3006;8884;3273;9593
230300;202006;4792;12777;4323;12133;102;304;3779;10542;3881;10846
230310;202006;4606;13109;3880;11816;132;577;2796;8277;2928;8854
230320;202006;7717;22226;6465;19916;242;984;4939;14891;5181;15875
230330;202006;4679;12751;3674;10805;140;464;2753;7918;2893;8382
230340;202006;3577;11103;3033;9991;264;925;2036;6636;2300;7561
230350;202006;17715;48791;15469;45414;863;2905;10395;30740;11258;33645
230360;202006;2908;7705;2267;6569;143;409;1530;4400;1673;4809
230365;202006;3013;7550;2483;6754;52;253;2113;5654;2165;5907
230370;202006;58499;162436;49569;149057;7361;22390;29369;89769;36730;112159
230380;202006;6283;17435;4918;14904;129;525;3631;10763;3760;11288
230390;202006;3394;10049;2923;9280;96;422;2253;7059;2349;7481
230393;202006;3210;9591;2548;8226;86;448;1950;6056;2036;6504
230395;202006;5777;15688;5027;14429;316;849;3578;10298;3894;11147
230400;202006;5467;14997;4852;13982;92;483;3912;10947;4004;11430
230410;202006;14185;41696;11626;36936;884;3053;7958;25240;8842;28293
230420;202006;28625;78577;23099;68877;2812;8718;12879;38226;15691;46944
230423;202006;4646;13774;4031;12538;88;394;3298;10086;3386;10480
230425;202006;5528;17043;5014;15982;389;1319;3578;11340;3967;12659
230426;202006;2736;7198;1974;5707;25;99;1483;4208;1508;4307
230427;202006;1852;5210;1317;4075;60;201;877;2604;937;2805
230428;202006;9623;25640;8223;23523;1112;3161;4817;13729;5929;16890
230430;202006;4965;13908;3900;12068;152;536;2909;8874;3061;9410
230435;202006;5834;15317;4834;13519;575;1528;2950;8313;3525;9841
230440;202006;409485;1014828;338205;909292;34137;97276;216132;574973;250269;672249
230445;202006;4278;11308;3439;9855;175;495;2359;6626;2534;7121
230450;202006;3581;10313;3109;9616;238;916;2264;6793;2502;7709
230460;202006;2114;5897;1840;5464;58;233;1535;4533;1593;4766
230465;202006;4006;11232;3392;10053;101;397;2551;7270;2652;7667
230470;202006;11278;37100;10074;34867;881;3465;7138;24278;8019;27743
230480;202006;1433;4130;1216;3737;70;278;898;2654;968;2932
230490;202006;2512;7052;2095;6268;164;562;1312;3685;1476;4247
230495;202006;5711;16934;5015;15682;364;1382;3330;10282;3694;11664
230500;202006;9262;29722;8289;27917;267;1081;6746;22680;7013;23761
230510;202006;1611;4844;1248;4049;171;607;623;1982;794;2589
230520;202006;4501;12743;3879;11615;311;879;2731;8209;3042;9088
230523;202006;15371;45334;12217;38527;2768;8723;3153;10602;5921;19325
230526;202006;3694;10504;3142;9554;186;536;2291;7030;2477;7566
230530;202006;5358;16727;4492;15015;296;1106;3228;10679;3524;11785
230533;202006;4425;10593;3667;9376;87;256;3054;7687;3141;7943
230535;202006;5301;14705;4469;13291;230;693;3136;9444;3366;10137
230540;202006;16174;43810;13843;40352;276;1105;11407;32933;11683;34038
230550;202006;20759;54879;16592;47743;1488;4418;10564;30249;12052;34667
230560;202006;8065;19655;6483;17150;50;209;5568;14625;5618;14834
230565;202006;3000;8354;2506;7443;88;363;1895;5504;1983;5867
230570;202006;3452;8809;2934;8102;80;228;2409;6646;2489;6874
230580;202006;10935;28211;9322;25883;338;953;7690;21235;8028;22188
230590;202006;8824;25069;7277;22228;392;1418;5366;15862;5758;17280
230600;202006;3611;9401;2821;7992;69;211;1972;5611;2041;5822
230610;202006;6630;18284;5843;16956;437;1244;4599;13276;5036;14520
230620;202006;2110;5674;1600;4665;121;369;982;2770;1103;3139
230625;202006;7824;22195;6538;19820;1942;6120;1796;5861;3738;11981
230630;202006;10736;31836;9272;28893;1445;4270;5353;17086;6798;21356
230640;202006;27694;83422;24900;78976;1212;4817;19787;61819;20999;66636
230650;202006;5111;13884;4348;12542;132;542;3544;9991;3676;10533
230655;202006;9210;31189;8645;30197;601;2175;6895;24355;7496;26530
230660;202006;5962;17765;4868;15826;151;807;3976;12662;4127;13469
230670;202006;6166;14680;4493;11984;133;436;3618;9420;3751;9856
230680;202006;2620;7165;2215;6444;127;351;1599;4675;1726;5026
230690;202006;7129;21028;6119;19011;382;1346;3875;11823;4257;13169
230700;202006;10172;26049;8194;22381;317;859;6065;16246;6382;17105
230710;202006;6746;21275;5881;19423;612;2012;3964;12967;4576;14979
230720;202006;1892;5573;1529;4825;118;349;1027;3168;1145;3517
230725;202006;3842;11564;3433;10849;378;1331;1991;6206;2369;7537
230730;202006;56326;152397;43843;133168;9620;31640;14671;46832;24291;78472
230740;202006;6019;16640;5097;15160;123;433;4122;12226;4245;12659
230750;202006;8301;22110;6869;19724;158;569;5474;15322;5632;15891
230760;202006;11062;29093;9610;26910;502;1670;7256;19857;7758;21527
230763;202006;4785;13104;3996;11666;117;552;3220;9115;3337;9667
230765;202006;40521;110000;33478;98478;5207;15882;16772;49036;21979;64918
230770;202006;25348;62692;21106;57023;2145;5840;13987;37897;16132;43737
230780;202006;6329;22143;5762;20812;786;2804;3400;12608;4186;15412
230790;202006;2969;8593;2665;8097;109;446;2004;5933;2113;6379
230800;202006;7996;25458;7004;23439;812;2960;4203;13811;5015;16771
230810;202006;11339;33790;10114;31808;393;1448;7821;24144;8214;25592
230820;202006;3427;11199;2783;9681;250;1043;1686;5582;1936;6625
230830;202006;7502;20373;6362;18448;128;543;5265;14912;5393;15455
230835;202006;4237;10100;3220;8475;86;256;2601;6742;2687;6998
230837;202006;3101;9501;2695;8784;107;501;2145;6801;2252;7302
230840;202006;8943;26218;7672;24073;772;2310;5510;17435;6282;19745
230850;202006;9452;27443;7902;24357;361;1312;5700;17300;6061;18612
230860;202006;5158;13144;4262;11857;55;197;3776;10450;3831;10647
230870;202006;16390;40050;14001;36073;372;1076;11467;29034;11839;30110
230880;202006;2101;6360;1913;6047;39;222;1526;4706;1565;4928
230890;202006;4550;14503;4119;13629;326;1199;2991;9712;3317;10911
230900;202006;2971;8548;2528;7692;177;614;1710;5088;1887;5702
230910;202006;3123;8318;2506;7341;62;287;2044;5962;2106;6249
230920;202006;4579;12894;3843;11718;133;545;3018;9006;3151;9551
230930;202006;6448;18062;5379;16138;288;840;3751;11272;4039;12112
230940;202006;7951;20294;6841;18592;191;479;5732;15500;5923;15979
230945;202006;6446;18535;5518;16752;301;1075;3924;11706;4225;12781
230950;202006;6164;15544;5439;14552;94;244;4718;12652;4812;12896
230960;202006;13097;38059;11494;35049;1853;5624;5835;17999;7688;23623
230970;202006;13419;35557;11153;32011;1723;4893;6302;18386;8025;23279
230980;202006;2656;7784;2328;7204;348;1026;1438;4571;1786;5597
230990;202006;1623;4570;1345;4009;63;266;963;2734;1026;3000
231000;202006;2469;6593;2002;5662;74;193;1490;4134;1564;4327
231010;202006;3522;8264;2769;6950;41;155;2401;5846;2442;6001
231020;202006;7930;24980;7056;23226;1289;3919;3993;13728;5282;17647
231025;202006;7415;20486;6420;18848;715;2058;4458;13206;5173;15264
231030;202006;7224;21490;5625;18107;884;2752;2940;9520;3824;12272
231040;202006;2900;8396;2522;7686;117;368;1976;5932;2093;6300
231050;202006;11616;29844;9335;25797;637;1716;6935;18741;7572;20457
231060;202006;2879;8084;2516;7500;61;206;2060;6140;2121;6346
231070;202006;7720;22388;6574;20383;694;2214;4258;13127;4952;15341
231080;202006;3937;11223;3342;10254;128;538;2551;7663;2679;8201
231085;202006;6740;16366;5323;14664;201;538;4176;11508;4377;12046
231090;202006;4507;11652;3316;9351;115;446;2282;6188;2397;6634
231095;202006;2274;6750;1770;5651;134;432;1178;3752;1312;4184
231100;202006;3141;9069;2585;8022;117;434;1935;5929;2052;6363
231110;202006;3546;10412;3217;9800;123;443;2411;7243;2534;7686
231120;202006;2213;6470;1824;5795;71;279;1313;4121;1384;4400
231123;202006;1874;4844;1565;4314;68;151;1143;3176;1211;3327
231126;202006;5436;14978;4377;12968;243;725;3194;9358;3437;10083
231130;202006;21081;54085;17494;49538;1001;3691;12982;36028;13983;39719
231135;202006;4130;11621;3402;10191;149;501;2435;7163;2584;7664
231140;202006;16363;46019;12994;40045;583;2436;9131;27393;9714;29829
231150;202006;5738;15604;4407;13065;667;2005;1973;6011;2640;8016
231160;202006;6185;18824;5405;17370;760;2319;3120;10292;3880;12611
231170;202006;4321;12635;3547;11146;187;682;2464;7483;2651;8165
231180;202006;14310;40506;11543;34646;3183;9238;3915;12265;7098;21503
231190;202006;3857;10883;3169;9619;67;300;2435;7198;2502;7498
231195;202006;4892;14825;4033;13020;231;864;2917;9326;3148;10190
231200;202006;7731;24187;6727;22147;197;1003;5276;16839;5473;17842
231210;202006;4803;14059;4079;12849;181;679;3087;9531;3268;10210
231220;202006;11943;31141;9229;25975;381;1191;6782;18416;7163;19607
231230;202006;9150;29143;8029;27107;483;1903;5914;19958;6397;21861
231240;202006;11378;33255;9984;30593;1510;4502;6069;18808;7579;23310
231250;202006;2112;5447;1370;3800;99;279;835;2271;934;2550
231260;202006;3186;9047;2750;8359;255;775;1886;5857;2141;6632
231270;202006;6363;16645;5134;14633;148;587;3883;10811;4031;11398
231280;202006;1716;5345;1563;5060;90;303;1171;3757;1261;4060
231290;202006;37392;111374;30898;98059;5203;16351;14316;45203;19519;61554
231300;202006;4034;11177;3141;9369;202;658;2077;6072;2279;6730
231310;202006;7143;18566;5677;15841;459;1299;3912;10728;4371;12027
231320;202006;7748;21247;6038;18202;85;406;4751;14121;4836;14527
231325;202006;2420;6388;1983;5724;166;391;1332;3941;1498;4332
231330;202006;9376;28082;7673;24684;1371;4202;4101;13792;5472;17994
231335;202006;5671;14975;4786;13536;84;359;4215;11795;4299;12154
231340;202006;17209;53341;15397;50084;1272;4189;11216;36878;12488;41067
231350;202006;15719;42904;14241;40804;274;996;12749;36185;13023;37181
231355;202006;4350;12967;3888;12092;233;781;3013;9274;3246;10055
231360;202006;7249;21977;6282;20285;248;924;5002;16070;5250;16994
231370;202006;2145;5917;1712;5147;35;112;1312;3943;1347;4055
231375;202006;4334;13474;3948;12835;130;597;3318;10649;3448;11246
231380;202006;5987;16259;5402;15448;183;487;4398;12765;4581;13252
231390;202006;3291;9607;2935;9017;122;477;2175;6503;2297;6980
231395;202006;3974;11673;3281;10555;403;1279;1953;6384;2356;7663
231400;202006;9615;27556;8031;24638;266;1126;6082;18258;6348;19384
231410;202006;14531;45202;13170;42925;589;2250;10628;34247;11217;36497
240010;202006;2563;6753;1988;5692;199;580;1185;3322;1384;3902
240020;202006;12385;34703;10355;31064;628;2330;6944;20514;7572;22844
240030;202006;2846;6946;2577;6528;88;256;2232;5609;2320;5865
240040;202006;805;2323;667;2053;33;129;465;1376;498;1505
240050;202006;3265;8756;2648;7632;49;154;2035;5765;2084;5919
240060;202006;1390;3726;1143;3279;23;86;935;2620;958;2706
240070;202006;2127;6174;1923;5757;177;576;1392;4047;1569;4623
240080;202006;2930;7896;2375;6869;52;205;1825;5171;1877;5376
240090;202006;2232;5482;1811;4769;17;48;1533;3991;1550;4039
240100;202006;10077;24844;7983;21004;206;629;6246;15878;6452;16507
240110;202006;4604;12933;3866;11594;189;682;2799;8228;2988;8910
240120;202006;3268;9063;2613;8256;181;605;1846;5990;2027;6595
240130;202006;3607;7532;3004;6750;27;83;2748;6090;2775;6173
240140;202006;1800;5385;1531;4856;156;544;1033;3248;1189;3792
240145;202006;6589;18248;5364;16142;820;2519;3022;9210;3842;11729
240150;202006;918;2690;805;2450;51;180;621;1832;672;2012
240160;202006;1444;4349;1204;3893;45;206;899;2919;944;3125
240165;202006;961;2630;798;2318;32;110;647;1844;679;1954
240170;202006;2489;6724;2082;5978;188;618;1422;3952;1610;4570
240180;202006;2965;8792;2362;7555;556;1678;1061;3615;1617;5293
240185;202006;1201;3775;1100;3600;52;213;914;2950;966;3163
240190;202006;1038;3091;889;2840;21;99;756;2427;777;2526
240200;202006;10829;27653;8600;23826;864;2622;4934;13335;5798;15957
240210;202006;3214;7958;2627;7025;25;134;2214;5744;2239;5878
240220;202006;7221;21570;6442;20342;328;1444;5074;15736;5402;17180
240230;202006;5803;14767;4640;12808;196;554;3688;10187;3884;10741
240240;202006;1839;5264;1142;3598;114;379;423;1189;537;1568
240250;202006;2929;7686;2578;7208;96;290;2162;6010;2258;6300
240260;202006;14073;41300;12113;37967;1709;5002;7514;24723;9223;29725
240270;202006;2262;6718;1970;6229;99;319;1433;4679;1532;4998
240280;202006;1675;4290;1419;3866;50;141;1138;3059;1188;3200
240290;202006;1183;3444;951;2922;31;140;676;1947;707;2087
240300;202006;2287;5809;1640;4614;68;207;1038;2844;1106;3051
240310;202006;8478;22365;6677;19127;881;2684;3478;9781;4359;12465
240320;202006;2010;5490;1479;4439;34;151;1103;3164;1137;3315
240325;202006;31299;83166;24763;71588;4336;12894;11036;32086;15372;44980
240330;202006;1749;4760;1331;3962;55;199;905;2560;960;2759
240340;202006;1967;4521;1597;3956;64;152;1305;3179;1369;3331
240350;202006;2161;5472;1927;5213;27;82;1757;4771;1784;4853
240360;202006;8774;24186;7797;22638;817;2408;5483;16081;6300;18489
240370;202006;1908;5034;1475;4138;61;184;1051;2869;1112;3053
240375;202006;900;2265;741;1964;27;98;606;1550;633;1648
240380;202006;2242;6354;1641;4996;143;411;954;2866;1097;3277
240390;202006;1020;2490;715;1906;26;58;452;1129;478;1187
240400;202006;1434;3501;1121;2957;34;123;787;1949;821;2072
240410;202006;561;1689;469;1483;38;146;298;887;336;1033
240420;202006;4542;15910;3991;14671;456;1989;2376;8551;2832;10540
240430;202006;3362;8700;2796;7698;171;546;2077;5549;2248;6095
240440;202006;2511;5478;2115;4934;137;265;1712;4007;1849;4272
240450;202006;4525;12280;3530;10392;346;1074;2097;5943;2443;7017
240460;202006;2853;8142;2571;7683;231;752;1993;5921;2224;6673
240470;202006;3635;10867;2760;9035;483;1481;1423;4891;1906;6372
240480;202006;578;1600;392;1185;33;104;182;531;215;635
240485;202006;2131;6002;1737;5268;122;385;1208;3668;1330;4053
240490;202006;1608;4124;1258;3473;82;195;933;2594;1015;2789
240500;202006;2140;5737;1868;5280;101;268;1508;4271;1609;4539
240510;202006;1672;4337;1467;4039;60;218;1224;3294;1284;3512
240520;202006;1433;3509;1113;3062;49;157;845;2324;894;2481
240530;202006;2141;6108;1924;5767;90;275;1581;4727;1671;5002
240540;202006;2266;5672;1975;5217;58;119;1714;4529;1772;4648
240550;202006;678;1917;612;1785;18;75;511;1447;529;1522
240560;202006;3293;8508;2764;7795;266;678;2014;5782;2280;6460
240570;202006;2818;7364;1855;5228;285;811;725;1920;1010;2731
240580;202006;8062;23436;7109;21663;552;1602;5664;17412;6216;19014
240590;202006;731;1909;636;1749;12;40;482;1293;494;1333
240600;202006;1773;4824;1304;3839;45;143;863;2456;908;2599
240610;202006;4185;11278;3528;10082;126;429;2704;7576;2830;8005
240615;202006;1255;3197;989;2717;102;270;668;1802;770;2072
240620;202006;1830;5150;1575;4699;92;256;1263;3756;1355;4012
240630;202006;2083;5878;1880;5528;147;310;1327;4076;1474;4386
240640;202006;947;2523;750;2193;29;113;562;1616;591;1729
240650;202006;4030;11200;3469;10056;214;629;2653;7586;2867;8215
240660;202006;3092;7897;2743;7444;50;155;2484;6748;2534;6903
240670;202006;2437;6860;1952;5867;137;446;1267;3702;1404;4148
240680;202006;1626;4308;1304;3755;45;141;994;2786;1039;2927
240690;202006;1001;2502;793;2152;16;69;629;1636;645;1705
240700;202006;2418;6971;1963;6110;56;204;1552;4744;1608;4948
240710;202006;16167;41772;13484;37142;1735;4663;8337;22988;10072;27651
240720;202006;5149;12654;4446;11666;385;1051;3267;8478;3652;9529
240725;202006;1123;3185;856;2647;36;121;571;1704;607;1825
240730;202006;2221;6227;1795;5382;60;221;1367;4015;1427;4236
240740;202006;1791;4815;1434;4112;43;163;1057;2874;1100;3037
240750;202006;2120;6996;1783;6276;262;1007;955;3397;1217;4404
240760;202006;1611;3783;1135;3049;63;96;867;2419;930;2515
240770;202006;3198;8787;2679;8035;125;462;2154;6375;2279;6837
240780;202006;4840;13285;3919;11736;517;1520;2422;7431;2939;8951
240790;202006;864;2443;716;2146;14;62;545;1590;559;1652
240800;202006;46489;111679;35993;95689;4914;13431;18561;49429;23475;62860
240810;202006;88905;230425;74942;207034;9250;26228;47570;129553;56820;155781
240820;202006;5806;17228;5019;15798;689;2127;3099;9932;3788;12059
240830;202006;8704;24750;7711;23257;238;1037;6399;19028;6637;20065
240840;202006;1117;2748;882;2370;29;74;631;1627;660;1701
240850;202006;1355;3683;969;2868;46;147;538;1528;584;1675
240860;202006;1285;3426;968;2852;15;74;719;2018;734;2092
240870;202006;1102;2797;828;2314;131;373;450;1284;581;1657
240880;202006;1255;3966;1110;3681;84;356;857;2763;941;3119
240890;202006;4377;11941;3313;9887;439;1418;1699;4878;2138;6296
240895;202006;2780;8562;2542;8184;138;448;2210;7171;2348;7619
240910;202006;3346;9076;2854;8179;54;190;2340;6595;2394;6785
240920;202006;889;2425;733;2169;64;178;421;1297;485;1475
240930;202006;3678;8349;3038;7570;197;285;2279;5991;2476;6276
240933;202006;1770;4279;1448;3808;41;163;1257;3249;1298;3412
240940;202006;6084;14983;4704;12620;539;1458;2814;7344;3353;8802
240950;202006;1014;3019;882;2775;26;110;722;2216;748;2326
240960;202006;681;2075;610;1931;30;107;471;1456;501;1563
240970;202006;1833;4701;1484;4105;56;206;1216;3254;1272;3460
240980;202006;3305;9811;2923;9121;112;484;2362;7245;2474;7729
240990;202006;2572;7229;2271;6636;267;860;1596;4504;1863;5364
241000;202006;942;2505;747;2141;26;70;554;1562;580;1632
241010;202006;2777;8875;2531;8344;158;632;1866;6056;2024;6688
241020;202006;2128;5636;1573;4521;135;393;1024;2891;1159;3284
241025;202006;1767;5031;1404;4346;49;202;1020;3109;1069;3311
241030;202006;2493;7765;1988;6680;220;758;1278;4301;1498;5059
241040;202006;2287;7222;2024;6776;96;427;1624;5399;1720;5826
241050;202006;1334;3701;1098;3275;33;125;807;2339;840;2464
241060;202006;744;2097;656;1910;27;87;464;1295;491;1382
241070;202006;664;1804;571;1638;12;39;450;1244;462;1283
241080;202006;1132;3179;855;2624;9;36;619;1872;628;1908
241090;202006;2013;5875;1638;5227;43;218;1294;4068;1337;4286
241100;202006;1167;3261;917;2750;67;206;599;1740;666;1946
241105;202006;973;2940;792;2595;251;799;257;881;508;1680
241110;202006;953;2694;709;2180;32;102;470;1395;502;1497
241120;202006;7621;21453;6456;19390;955;2808;3814;11763;4769;14571
241140;202006;3288;8650;2584;7236;152;437;1865;5098;2017;5535
241142;202006;775;2079;570;1682;25;86;339;941;364;1027
241150;202006;5914;15354;5208;14192;143;493;4278;11440;4421;11933
241160;202006;1133;3040;915;2639;132;386;587;1652;719;2038
241170;202006;1326;3377;1133;3044;28;109;946;2434;974;2543
241180;202006;1030;2645;744;2082;93;272;378;1042;471;1314
241190;202006;1139;2996;950;2619;17;71;693;1837;710;1908
241200;202006;19253;50354;16515;45874;2603;7224;9606;26758;12209;33982
241210;202006;1419;3785;1011;2964;119;381;575;1639;694;2020
241220;202006;8812;25840;7641;23840;1741;5368;3619;11769;5360;17137
241230;202006;2926;7642;2577;7098;103;320;2143;5832;2246;6152
241240;202006;1218;3392;754;2351;66;208;330;1031;396;1239
241250;202006;5388;15625;4303;13571;164;756;3119;9459;3283;10215
241255;202006;2257;7004;1988;6430;112;450;1516;4801;1628;5251
241260;202006;4896;12721;3834;10938;79;322;3036;8474;3115;8796
241270;202006;1739;4990;1429;4392;104;360;1025;3137;1129;3497
241280;202006;2173;5437;1859;4865;57;147;1581;4078;1638;4225
241290;202006;3400;8289;2521;6854;76;249;1992;5267;2068;5516
241300;202006;1480;3928;1179;3385;38;126;798;2232;836;2358
241310;202006;2131;5260;1827;4829;15;62;1557;4145;1572;4207
241320;202006;941;3047;801;2779;85;366;520;1776;605;2142
241330;202006;1745;4539;1361;4027;16;82;1183;3475;1199;3557
241335;202006;3230;8997;2849;8299;101;337;2353;6778;2454;7115
241340;202006;1562;4390;1207;3648;255;809;494;1453;749;2262
241350;202006;2078;5889;1819;5422;88;301;1417;4153;1505;4454
241355;202006;1295;3505;1057;3037;16;45;824;2360;840;2405
241360;202006;2050;5304;1535;4248;40;124;1099;2926;1139;3050
241370;202006;1342;3708;1036;3066;48;166;721;2042;769;2208
241380;202006;622;1756;480;1474;74;192;243;772;317;964
241390;202006;2742;7986;2438;7533;195;540;1885;5930;2080;6470
241400;202006;3567;9852;3170;9226;155;492;2572;7424;2727;7916
241410;202006;2389;7088;1938;6158;343;1107;986;3137;1329;4244
241415;202006;1657;4882;1353;4285;60;226;950;2952;1010;3178
241420;202006;2276;7175;1946;6601;457;1722;962;3245;1419;4967
241430;202006;606;1676;416;1241;18;59;258;741;276;800
241440;202006;7513;23109;6708;21686;354;1286;5308;17077;5662;18363
241445;202006;1112;2826;982;2657;22;56;871;2413;893;2469
241450;202006;2615;6499;2242;5891;387;864;1462;3986;1849;4850
241460;202006;3776;10184;3053;8647;195;584;2145;5930;2340;6514
241470;202006;1403;3697;1137;3304;25;92;948;2755;973;2847
241475;202006;1194;3357;935;2849;23;112;673;1959;696;2071
241480;202006;2922;9091;2403;7946;722;2364;799;2939;1521;5303
241490;202006;633;1498;517;1341;25;66;371;943;396;1009
241500;202006;799;2276;708;2158;3;10;657;2024;660;2034
250010;202006;2522;7541;2089;6648;59;238;1523;4739;1582;4977
250020;202006;1605;4305;1151;3414;32;75;832;2457;864;2532
250030;202006;6943;18897;6105;17568;529;1550;4556;12968;5085;14518
250040;202006;4006;12258;3451;11222;227;844;2501;8002;2728;8846
250050;202006;3603;9674;3245;9189;127;436;2642;7496;2769;7932
250053;202006;1169;3252;1058;3071;70;203;773;2255;843;2458
250057;202006;652;2325;608;2257;10;44;543;2050;553;2094
250060;202006;5467;14240;4903;13543;290;780;4039;11222;4329;12002
250070;202006;3952;11023;3349;9959;36;153;2696;7846;2732;7999
250073;202006;761;2016;619;1798;10;28;507;1437;517;1465
250077;202006;2199;5903;1646;4987;61;216;1246;3747;1307;3963
250080;202006;4868;12115;4121;11150;67;290;3595;9596;3662;9886
250090;202006;3321;8109;2896;7541;53;159;2493;6376;2546;6535
250100;202006;3635;11056;3276;10375;161;567;2564;7953;2725;8520
250110;202006;4894;13682;4396;12949;258;964;3421;9858;3679;10822
250115;202006;685;1788;496;1496;9;45;346;1040;355;1085
250120;202006;1818;5323;1523;4833;30;142;1204;3793;1234;3935
250130;202006;5484;15040;4624;13821;72;386;3915;11543;3987;11929
250135;202006;1197;3311;1040;3031;25;96;901;2603;926;2699
250140;202006;2249;6552;2088;6347;107;446;1794;5388;1901;5834
250150;202006;4791;14896;4295;14042;135;622;3462;11118;3597;11740
250153;202006;1405;3698;1169;3338;31;89;937;2656;968;2745
250157;202006;1712;5081;1553;4776;54;230;1239;3741;1293;3971
250160;202006;3912;9705;3115;8626;40;148;2740;7591;2780;7739
250170;202006;1841;4711;1640;4426;24;95;1431;3814;1455;3909
250180;202006;20094;48466;17093;44616;733;2301;13334;33929;14067;36230
250190;202006;4037;10761;3362;9746;317;963;2324;6572;2641;7535
250200;202006;1937;5148;1645;4736;59;187;1383;3983;1442;4170
250205;202006;861;2646;739;2453;17;85;612;2000;629;2085
250210;202006;1555;4693;1399;4440;73;318;1088;3395;1161;3713
250215;202006;1540;4231;1282;3855;74;250;770;2323;844;2573
250220;202006;659;1825;529;1632;27;103;347;1047;374;1150
250230;202006;1669;3736;1110;2868;17;60;923;2295;940;2355
250240;202006;2297;6967;2010;6434;40;202;1665;5243;1705;5445
250250;202006;4566;12646;3969;11761;83;294;3393;10061;3476;10355
250260;202006;1698;4726;1409;4230;49;134;1115;3322;1164;3456
250270;202006;1204;3609;1086;3463;58;203;807;2672;865;2875
250280;202006;3330;9241;2973;8705;105;305;2361;6916;2466;7221
250290;202006;1593;4194;1354;3848;22;69;1063;3025;1085;3094
250300;202006;5498;14616;4929;13951;184;826;4112;11225;4296;12051
250310;202006;1148;3145;948;2811;38;126;727;2130;765;2256
250320;202006;11846;26625;10152;24675;255;719;9053;21696;9308;22415
250330;202006;2407;6605;2014;6062;107;334;1627;4891;1734;5225
250340;202006;1096;2779;978;2629;11;28;897;2404;908;2432
250350;202006;4098;11409;3618;10604;197;480;2839;8571;3036;9051
250355;202006;1964;5906;1759;5621;27;142;1576;5005;1603;5147
250360;202006;1775;4887;1578;4619;38;145;1324;3843;1362;3988
250370;202006;13380;34541;11016;30961;240;901;9246;25613;9486;26514
250375;202006;1185;3084;950;2797;5;17;896;2663;901;2680
250380;202006;1602;4132;1466;3959;26;113;1287;3364;1313;3477
250390;202006;1845;4677;1540;4185;84;233;1223;3287;1307;3520
250400;202006;69388;170232;50571;140709;14011;41620;14600;42895;28611;84515
250403;202006;1737;4838;1546;4608;73;366;1192;3384;1265;3750
250407;202006;1228;3049;984;2682;73;156;693;1947;766;2103
250410;202006;642;1714;556;1565;4;9;464;1279;468;1288
250415;202006;1871;5206;1635;4824;32;146;1412;4136;1444;4282
250420;202006;1178;3329;1072;3184;25;96;957;2824;982;2920
250430;202006;6249;15296;5270;13979;137;427;4359;11317;4496;11744
250435;202006;1533;4269;1227;3729;11;53;941;2823;952;2876
250440;202006;4578;12067;3910;11223;69;193;3468;9955;3537;10148
250450;202006;1816;4796;1483;4339;30;105;1234;3622;1264;3727
250460;202006;7332;19821;6480;18559;327;1001;5213;14850;5540;15851
250470;202006;1536;3958;1265;3536;51;158;989;2714;1040;2872
250480;202006;4036;10845;3418;10105;41;146;3016;8987;3057;9133
250485;202006;716;1614;525;1337;38;65;386;954;424;1019
250490;202006;5165;12248;4579;11575;171;516;4045;10036;4216;10552
250500;202006;1987;5479;1760;5084;73;239;1427;4116;1500;4355
250510;202006;5454;13655;4667;12607;75;199;4076;11106;4151;11305
250520;202006;1818;4918;1550;4525;123;394;1103;3195;1226;3589
250523;202006;2226;5466;1968;5140;66;282;1657;4169;1723;4451
250527;202006;1672;4303;1501;4109;24;76;1330;3661;1354;3737
250530;202006;626;1611;531;1481;5;11;468;1304;473;1315
250535;202006;1349;3950;1216;3692;27;114;997;2933;1024;3047
250540;202006;2948;6756;2453;6202;66;123;2150;5529;2216;5652
250550;202006;773;2463;675;2270;22;86;504;1663;526;1749
250560;202006;1731;4759;1527;4464;34;135;1292;3686;1326;3821
250570;202006;2632;7886;2253;7195;78;299;1778;5585;1856;5884
250580;202006;1051;2712;923;2534;47;178;774;2073;821;2251
250590;202006;816;2273;726;2144;19;65;594;1765;613;1830
250600;202006;8185;20852;6822;19085;235;731;5647;15683;5882;16414
250610;202006;2966;8299;2649;7836;117;440;2205;6441;2322;6881
250620;202006;780;2052;661;1849;10;30;489;1338;499;1368
250625;202006;2477;7137;2208;6691;40;217;1876;5521;1916;5738
250630;202006;10077;27886;8114;24424;851;2608;5185;15289;6036;17897
250640;202006;3410;9323;3070;8884;87;362;2642;7507;2729;7869
250650;202006;945;2268;790;2059;13;36;685;1764;698;1800
250660;202006;1632;4023;1309;3578;38;105;1078;2878;1116;2983
250670;202006;2324;7207;2110;6828;44;193;1837;5839;1881;6032
250680;202006;5802;13326;5171;12615;59;225;4792;11539;4851;11764
250690;202006;6801;15253;5750;13943;93;225;5109;12279;5202;12504
250700;202006;4271;11967;3717;11122;422;1249;2593;7726;3015;8975
250710;202006;4404;12581;3778;11722;271;939;2759;8554;3030;9493
250720;202006;2728;7263;2441;6856;36;178;2140;5936;2176;6114
250730;202006;4113;10900;3584;10201;102;421;3002;8297;3104;8718
250740;202006;1914;4778;1584;4337;90;212;1236;3403;1326;3615
250750;202006;104218;255585;87733;232407;7037;20253;63451;164863;70488;185116
250760;202006;2362;6097;2058;5602;83;252;1638;4328;1721;4580
250770;202006;4011;12043;3584;11469;378;1179;2583;8361;2961;9540
250780;202006;1733;4659;1439;4121;48;172;1117;3111;1165;3283
250790;202006;2444;7230;2103;6708;133;531;1427;4442;1560;4973
250800;202006;2455;6482;2133;5963;85;177;1728;4872;1813;5049
250810;202006;1267;3352;1046;3038;27;58;883;2602;910;2660
250820;202006;1973;5486;1815;5311;32;139;1658;4823;1690;4962
250830;202006;5799;17329;4767;15242;258;999;3293;10214;3551;11213
250840;202006;759;2397;649;2177;14;56;491;1655;505;1711
250850;202006;1787;5309;1594;4964;33;157;1318;3999;1351;4156
250855;202006;941;2788;815;2564;56;197;610;1901;666;2098
250860;202006;3153;9313;2605;8381;438;1484;1528;4912;1966;6396
250870;202006;1035;2833;872;2557;31;118;717;2070;748;2188
250880;202006;1616;4120;1328;3705;73;211;1017;2829;1090;3040
250890;202006;10138;26334;8941;24713;406;1702;7135;18770;7541;20472
250900;202006;2807;7778;2426;7086;65;234;2055;5887;2120;6121
250905;202006;2404;6792;2204;6501;43;171;2006;5908;2049;6079
250910;202006;5898;14666;4848;13475;80;286;4219;11781;4299;12067
250915;202006;2158;5008;1503;4301;24;53;1309;3834;1333;3887
250920;202006;3506;8807;3071;8137;331;751;2254;6010;2585;6761
250930;202006;2252;5958;2028;5672;52;212;1762;4827;1814;5039
250933;202006;1157;3432;1020;3182;21;106;786;2380;807;2486
250937;202006;699;1867;571;1656;24;74;435;1283;459;1357
250939;202006;1750;4657;1519;4351;62;196;1191;3389;1253;3585
250940;202006;3987;10659;3496;10011;16;59;3109;8920;3125;8979
250950;202006;1719;4337;1383;3910;26;95;1143;3189;1169;3284
250960;202006;1125;3271;982;3043;26;140;799;2382;825;2522
250970;202006;8290;21181;7242;19498;223;688;6012;15885;6235;16573
250980;202006;2426;6411;2170;6027;35;149;1871;5063;1906;5212
250990;202006;2061;6196;1714;5587;54;255;1266;4075;1320;4330
251000;202006;2056;5750;1667;5078;37;159;1361;4112;1398;4271
251010;202006;2666;7420;2411;7036;19;83;2177;6354;2196;6437
251020;202006;1635;4427;1462;4152;32;146;1270;3532;1302;3678
251030;202006;1002;2652;821;2318;33;94;580;1614;613;1708
251040;202006;1821;5136;1533;4642;38;188;1237;3715;1275;3903
251050;202006;1060;2881;882;2535;48;157;629;1743;677;1900
251060;202006;1070;2294;806;1958;8;26;640;1524;648;1550
251065;202006;476;1299;368;1098;11;33;250;727;261;760
251070;202006;728;1875;619;1714;10;41;530;1440;540;1481
251080;202006;18470;47224;15001;41980;1815;5271;9728;27314;11543;32585
251090;202006;2774;7974;2330;7177;56;205;1862;5692;1918;5897
251100;202006;804;2554;716;2391;23;89;548;1759;571;1848
251110;202006;1696;4534;1439;4089;47;125;1091;3085;1138;3210
251120;202006;7244;20238;6086;18818;260;988;4850;14954;5110;15942
251130;202006;3865;8649;3407;8139;58;164;3086;7335;3144;7499
251140;202006;4240;11810;3790;11177;75;314;3171;9237;3246;9551
251150;202006;2636;7664;2366;7229;101;423;1940;5796;2041;6219
251160;202006;2132;6235;1848;5820;39;189;1589;4910;1628;5099
251170;202006;1557;4232;1351;3960;33;117;1168;3405;1201;3522
251180;202006;2631;7015;2149;6332;168;498;1465;4296;1633;4794
251190;202006;4388;11405;3991;10957;44;247;3630;9762;3674;10009
251200;202006;4328;12633;3808;11961;72;304;3352;10555;3424;10859
251203;202006;936;3030;861;2867;22;103;653;2117;675;2220
251207;202006;1075;2936;830;2526;19;100;580;1725;599;1825
251210;202006;7540;19149;6144;17247;270;643;4701;13461;4971;14104
251220;202006;1180;2835;926;2497;54;122;710;1958;764;2080
251230;202006;4588;12712;3947;11605;115;425;3115;8920;3230;9345
251240;202006;3617;9863;3041;8896;153;413;2292;6600;2445;7013
251250;202006;10246;27538;8955;25365;720;2153;6626;18207;7346;20360
251260;202006;480;1372;437;1305;12;62;348;1005;360;1067
251270;202006;4241;13179;3806;12599;109;448;3106;10507;3215;10955
251272;202006;1338;3618;1201;3436;43;165;1014;2822;1057;2987
251274;202006;893;2471;713;2143;62;208;474;1358;536;1566
251275;202006;1213;3389;1034;3098;29;131;813;2368;842;2499
251276;202006;1318;3569;1145;3340;31;161;931;2617;962;2778
251278;202006;580;1595;519;1506;46;111;377;1125;423;1236
251280;202006;2222;6034;1984;5667;50;171;1662;4680;1712;4851
251290;202006;5880;13867;5302;13159;146;489;4631;11131;4777;11620
251300;202006;856;2502;774;2378;8;41;658;2019;666;2060
251310;202006;2699;7767;2350;7218;49;259;1887;5649;1936;5908
251315;202006;1695;5284;1547;5013;82;252;1175;3758;1257;4010
251320;202006;1611;4262;1153;3476;32;113;866;2562;898;2675
251330;202006;2108;4886;1717;4426;21;77;1550;4024;1571;4101
251335;202006;1077;3133;958;2947;26;120;838;2516;864;2636
251340;202006;3681;8879;2940;7885;115;348;2258;6018;2373;6366
251350;202006;1056;3038;947;2855;26;100;780;2312;806;2412
251360;202006;1821;5087;1468;4588;20;97;1245;3904;1265;4001
251365;202006;720;1955;567;1653;6;23;445;1282;451;1305
251370;202006;24445;64287;20927;59215;2799;8037;12763;36854;15562;44891
251380;202006;1201;3391;1049;3133;19;108;879;2547;898;2655
251385;202006;744;1914;568;1589;15;43;424;1146;439;1189
251390;202006;6405;18576;5639;17365;461;1475;3753;11591;4214;13066
251392;202006;963;2612;805;2374;25;107;630;1820;655;1927
251394;202006;610;1763;501;1570;18;81;375;1154;393;1235
251396;202006;664;1781;567;1610;14;41;402;1116;416;1157
251398;202006;959;2409;666;1906;18;72;492;1365;510;1437
251400;202006;1216;2970;974;2642;25;95;777;2034;802;2129
251410;202006;1467;3477;1201;3100;17;73;1028;2556;1045;2629
251420;202006;1900;5001;1537;4575;37;148;1221;3594;1258;3742
251430;202006;1514;4643;1360;4375;28;128;1175;3783;1203;3911
251440;202006;1098;3078;884;2679;35;97;703;2141;738;2238
251445;202006;1526;4266;1403;4095;36;121;1183;3402;1219;3523
251450;202006;4490;13085;3974;12313;85;337;3302;10137;3387;10474
251455;202006;848;2576;769;2435;22;99;608;1878;630;1977
251460;202006;881;2548;771;2377;16;55;634;1966;650;2021
251465;202006;450;1312;385;1193;7;28;287;866;294;894
251470;202006;1180;3249;882;2626;71;228;510;1446;581;1674
251480;202006;988;2606;803;2272;19;80;619;1666;638;1746
251490;202006;1879;4938;1486;4389;56;177;1105;3267;1161;3444
251500;202006;1934;5439;1773;5227;28;99;1610;4754;1638;4853
251510;202006;2646;7906;2184;6977;106;397;1483;4625;1589;5022
251520;202006;964;2541;730;2108;63;180;476;1340;539;1520
251530;202006;14648;35105;11743;31477;100;566;10393;27361;10493;27927
251540;202006;2965;8453;2672;7904;76;273;2222;6475;2298;6748
251550;202006;3763;8875;3008;7931;102;206;2507;6662;2609;6868
251560;202006;541;1641;473;1534;59;208;326;1022;385;1230
251570;202006;942;2641;763;2285;18;80;607;1764;625;1844
251580;202006;1888;4468;1683;4169;36;152;1467;3489;1503;3641
251590;202006;1568;3888;1316;3592;50;135;1097;2943;1147;3078
251593;202006;896;2611;799;2455;83;262;518;1566;601;1828
251597;202006;2105;5883;1893;5604;20;101;1685;4922;1705;5023
251600;202006;6398;17226;5588;15984;165;532;4625;13034;4790;13566
251610;202006;3215;9128;2751;8260;250;697;1909;5832;2159;6529
251615;202006;1233;3080;994;2718;24;66;798;2125;822;2191
251620;202006;18887;43545;14536;38199;108;367;12431;33155;12539;33522
251630;202006;4699;11046;3773;9761;194;512;2838;7281;3032;7793
251640;202006;2145;5825;1896;5434;27;131;1646;4604;1673;4735
251650;202006;3920;10566;3426;9910;120;395;2918;8415;3038;8810
251660;202006;3458;10353;3033;9598;70;330;2538;7895;2608;8225
251670;202006;3964;11235;3532;10618;49;249;3148;9368;3197;9617
251675;202006;640;1834;578;1758;76;231;382;1177;458;1408
251680;202006;2501;6616;2079;6068;43;141;1678;4941;1721;5082
251690;202006;3100;8680;2610;7824;89;270;1952;5795;2041;6065
251700;202006;2080;5906;1740;5478;42;194;1477;4566;1519;4760
251710;202006;789;2046;536;1528;39;134;312;859;351;993
251720;202006;1301;3679;1045;3230;23;103;800;2400;823;2503
251740;202006;612;1711;490;1480;43;154;327;951;370;1105
260005;202006;29646;62515;24334;55683;1599;3609;18802;42227;20401;45836
260010;202006;10221;26764;8410;23812;454;1369;5020;14268;5474;15637
260020;202006;6758;15886;5752;14441;109;495;4858;11973;4967;12468
260030;202006;6770;17321;5705;15781;136;413;4632;12755;4768;13168
260040;202006;7559;19633;6298;17792;437;1211;4426;12720;4863;13931
260050;202006;13881;35985;11488;33332;178;704;10543;30635;10721;31339
260060;202006;3985;9975;3415;9051;190;468;2698;7156;2888;7624
260070;202006;10485;26325;8952;24108;327;1139;7236;18967;7563;20106
260080;202006;6502;14796;5673;13697;112;363;4778;11323;4890;11686
260090;202006;4635;11939;4103;11209;456;1273;2907;7945;3363;9218
260100;202006;3001;8087;2504;7352;53;266;2061;5947;2114;6213
260105;202006;4994;13629;4465;12920;126;449;3761;10739;3887;11188
260110;202006;22161;61204;19671;57585;923;3161;16216;46805;17139;49966
260120;202006;14342;38208;12008;34698;1420;4051;7682;22549;9102;26600
260130;202006;3072;7899;2738;7407;248;664;1993;5321;2241;5985
260140;202006;12968;29319;11158;27156;534;1460;9366;22458;9900;23918
260150;202006;3593;8301;3076;7662;83;247;2704;6665;2787;6912
260160;202006;6464;16917;5455;15686;86;318;4912;14266;4998;14584
260170;202006;20112;47519;17019;43292;893;2289;13592;34169;14485;36458
260180;202006;3475;9254;3003;8612;74;270;2580;7293;2654;7563
260190;202006;18154;36450;15238;33006;160;431;13519;28725;13679;29156
260200;202006;11117;26569;9534;24554;431;981;7962;20791;8393;21772
260210;202006;11816;33326;9982;30311;323;1223;7943;23967;8266;25190
260220;202006;10238;24726;9450;23724;168;556;8320;20586;8488;21142
260230;202006;10697;26205;9314;24364;194;637;7854;20184;8048;20821
260240;202006;2660;7974;2323;7326;106;365;1798;5625;1904;5990
260250;202006;2177;5726;1890;5277;116;267;1444;4026;1560;4293
260260;202006;12999;33673;11556;31449;365;1217;9179;24482;9544;25699
260270;202006;4254;10216;3732;9583;133;481;3124;7863;3257;8344
260280;202006;12661;38148;11337;36269;439;1918;9654;30436;10093;32354
260290;202006;40297;101917;34592;93622;3705;10249;23492;63334;27197;73583
260300;202006;9566;25827;8292;24093;190;859;6976;20206;7166;21065
260310;202006;5061;13026;4444;12231;301;781;3443;9609;3744;10390
260320;202006;7640;21953;6435;19897;256;815;5236;16194;5492;17009
260330;202006;2544;7784;2222;7126;68;255;1760;5499;1828;5754
260340;202006;2031;5421;1746;4992;28;128;1495;4180;1523;4308
260345;202006;24868;64533;20706;58439;3038;9177;11011;30557;14049;39734
260350;202006;5500;13009;4773;12163;67;196;4230;10733;4297;10929
260360;202006;2513;6536;2264;6080;45;194;1589;4155;1634;4349
260370;202006;5539;15836;4758;14520;233;810;3672;11126;3905;11936
260380;202006;4929;14564;4200;13368;148;539;3154;9911;3302;10450
260390;202006;4465;13340;3703;11772;210;664;2491;7776;2701;8440
260392;202006;3317;10658;2975;10221;116;694;2397;8235;2513;8929
260400;202006;18110;41804;15616;38522;466;1332;12303;29200;12769;30532
260410;202006;72966;176929;56318;153488;9912;28333;25269;71040;35181;99373
260415;202006;4487;12100;3874;11077;61;256;3169;8923;3230;9179
260420;202006;12698;26326;10746;24150;100;283;9962;22179;10062;22462
260430;202006;2704;8447;2325;7695;99;396;1668;5465;1767;5861
260440;202006;3708;9637;3270;8956;68;248;2745;7381;2813;7629
260450;202006;5722;14397;5116;13620;294;605;4213;11432;4507;12037
260460;202006;5193;15423;4414;14043;472;1672;2638;8248;3110;9920
260470;202006;4908;12929;4138;12030;80;195;3791;11186;3871;11381
260480;202006;3962;10543;3320;9619;210;765;2310;6690;2520;7455
260490;202006;5321;12221;4704;11312;34;141;4280;10110;4314;10251
260500;202006;6097;15286;5211;14038;455;1165;3655;9984;4110;11149
260510;202006;9682;23932;8084;21697;118;466;7127;18947;7245;19413
260515;202006;4139;11342;3217;9583;141;425;2165;6282;2306;6707
260520;202006;17093;39449;14895;36622;757;1833;12132;29439;12889;31272
260530;202006;9744;27797;8284;25537;146;692;7101;21591;7247;22283
260540;202006;7175;15523;6316;14432;150;349;5667;12865;5817;13214
260545;202006;52;160;22;81;2;7;8;23;10;30
260550;202006;3031;8382;2482;7480;114;468;1670;4913;1784;5381
260560;202006;5880;15070;4957;13744;124;490;4174;11333;4298;11823
260570;202006;7708;20901;6766;19619;375;1186;5326;15500;5701;16686
260580;202006;4453;10544;4000;9945;17;64;3681;9127;3698;9191
260590;202006;6686;15489;5607;14280;227;546;4658;12026;4885;12572
260600;202006;30756;79486;24896;70443;1096;3438;18808;52323;19904;55761
260610;202006;7267;18660;6491;17654;391;1138;4877;13178;5268;14316
260620;202006;16269;42114;14152;39049;1245;3887;10276;27762;11521;31649
260630;202006;2378;6407;1941;5707;35;148;1566;4498;1601;4646
260640;202006;21490;48505;17954;44436;847;2079;14414;35504;15261;37583
260650;202006;6003;15743;4766;14228;159;600;4072;12090;4231;12690
260660;202006;7014;18503;6045;17207;155;676;5172;14388;5327;15064
260670;202006;2215;5782;1858;5236;76;192;1366;3791;1442;3983
260680;202006;28413;67469;23861;60952;1663;4530;16867;42234;18530;46764
260690;202006;3508;9075;2917;8156;88;342;2287;6338;2375;6680
260700;202006;6080;17506;5679;17044;20;69;5495;16614;5515;16683
260710;202006;1350;3552;1161;3281;31;121;911;2569;942;2690
260720;202006;23402;58131;20074;53668;1932;5290;14540;38604;16472;43894
260730;202006;7639;21925;6646;20541;257;974;5538;16842;5795;17816
260740;202006;1335;3769;1118;3409;12;64;880;2750;892;2814
260750;202006;7090;19401;5908;17920;171;434;5223;16196;5394;16630
260760;202006;5675;13388;4868;12431;185;516;3998;10243;4183;10759
260765;202006;8028;23039;6969;21576;401;1671;4937;14955;5338;16626
260770;202006;3828;9750;3180;8677;116;368;2497;6724;2613;7092
260775;202006;5210;13832;4567;12851;184;685;3560;9670;3744;10355
260780;202006;3612;10690;3214;10049;275;1038;2070;6250;2345;7288
260790;202006;119298;266289;98403;238932;14903;35041;60784;148088;75687;183129
260795;202006;2978;7626;2548;7061;78;265;1992;5561;2070;5826
260800;202006;5387;12420;4793;11599;120;380;4203;9845;4323;10225
260805;202006;3617;10222;3041;9196;161;569;2274;6754;2435;7323
260810;202006;6480;17528;5671;15969;457;1220;4097;11302;4554;12522
260820;202006;4552;10467;3976;9769;99;359;3280;7857;3379;8216
260825;202006;2905;8641;2523;7975;105;379;1885;5881;1990;6260
260830;202006;4217;12221;3493;10897;450;1232;2234;7198;2684;8430
260840;202006;4159;10830;3703;10199;203;525;3073;8492;3276;9017
260845;202006;4323;11404;3841;10575;228;635;2879;7833;3107;8468
260850;202006;5067;13855;4203;12187;343;1071;2713;7607;3056;8678
260860;202006;3501;9836;2955;8897;102;361;2353;6904;2455;7265
260870;202006;4549;10893;3872;10062;68;255;3451;8847;3519;9102
260875;202006;7047;17303;5768;15428;562;1513;3899;10518;4461;12031
260880;202006;9722;27183;8408;24899;483;1460;6581;19454;7064;20914
260890;202006;13018;33361;11261;30671;595;1742;8228;21863;8823;23605
260900;202006;5389;14936;4417;13551;311;1017;2934;8983;3245;10000
260910;202006;3224;8698;2783;8027;98;315;2186;6259;2284;6574
260915;202006;5192;15108;4529;14334;58;269;4135;13104;4193;13373
260920;202006;3285;8104;2747;7522;90;237;2349;6494;2439;6731
260930;202006;3722;11671;3157;10656;178;726;2332;7682;2510;8408
260940;202006;14676;34836;12764;32173;979;2414;9602;23889;10581;26303
260950;202006;6889;18364;5540;16027;355;1204;3568;9891;3923;11095
260960;202006;70074;156040;56089;137987;6156;15565;35670;86649;41826;102214
260970;202006;5534;14523;4914;13682;234;534;3739;10544;3973;11078
260980;202006;4514;13112;3971;12428;52;188;3620;11431;3672;11619
260990;202006;17902;49351;15120;45546;850;2823;11740;35028;12590;37851
261000;202006;16220;38040;13589;34688;374;1338;10970;27309;11344;28647
261010;202006;2387;6211;2082;5812;75;196;1807;5068;1882;5264
261020;202006;6134;16575;5254;15057;190;701;4256;11717;4446;12418
261030;202006;4036;11608;3486;10663;124;509;2766;8220;2890;8729
261040;202006;5227;15220;4206;13267;147;596;3139;9659;3286;10255
261050;202006;7755;20169;7041;19047;439;871;5371;14638;5810;15509
261060;202006;14137;35260;12268;32984;269;879;10217;27202;10486;28081
261070;202006;64696;140331;53512;125543;2777;6452;40953;93947;43730;100399
261080;202006;6679;15958;6090;15217;134;331;5604;13987;5738;14318
261090;202006;19155;45080;17007;42307;286;964;14910;36479;15196;37443
261100;202006;8351;23040;7225;21365;501;1594;5262;15567;5763;17161
261110;202006;65518;181876;54687;162369;7776;24315;31707;93230;39483;117545
261120;202006;3693;9216;3178;8515;85;219;2738;7349;2823;7568
261130;202006;7304;17784;6402;16564;115;352;5668;14560;5783;14912
261140;202006;3649;8389;3244;7846;168;432;2594;6177;2762;6609
261150;202006;5312;13820;4686;12874;71;268;4073;11062;4144;11330
261153;202006;1878;5659;1597;5111;56;201;1085;3487;1141;3688
261160;202006;210583;487668;169787;430855;41201;107818;70255;181440;111456;289258
261170;202006;6025;14984;5344;13962;315;754;4262;11071;4577;11825
261180;202006;9561;23693;8345;22084;448;1164;6080;16147;6528;17311
261190;202006;4581;13359;4084;12523;187;798;3202;9510;3389;10308
261200;202006;3373;7767;3006;7270;132;343;2528;6002;2660;6345
261210;202006;1908;4577;1615;4163;62;179;1360;3444;1422;3623
261220;202006;13759;38764;11386;34359;1416;4643;6489;19259;7905;23902
261230;202006;4019;11495;3360;10576;52;211;2800;8884;2852;9095
261240;202006;5339;13334;4669;12279;248;658;3844;9963;4092;10621
261245;202006;3571;10105;3002;9097;72;345;2388;7010;2460;7355
261247;202006;2909;8683;2406;7779;154;545;1643;5285;1797;5830
261250;202006;22476;51066;19459;47535;1728;3772;14787;37064;16515;40836
261255;202006;4070;11955;3291;10434;139;626;2415;7406;2554;8032
261260;202006;12676;34138;10924;31849;345;1412;9374;26952;9719;28364
261270;202006;4436;10872;3873;10149;187;529;3211;8285;3398;8814
261280;202006;2586;7130;2269;6588;67;240;1809;5102;1876;5342
261290;202006;2969;7605;2484;7051;67;272;2012;5749;2079;6021
261300;202006;12391;34409;10451;31084;585;2072;7578;22046;8163;24118
261310;202006;8786;22286;7474;20489;628;1940;5485;14665;6113;16605
261320;202006;5938;16767;5171;15501;79;347;4346;12832;4425;13179
261330;202006;5853;14268;5258;13490;122;439;4571;11499;4693;11938
261340;202006;4249;11857;3664;11102;135;504;3022;9055;3157;9559
261350;202006;8778;25463;7776;23788;122;571;6329;19074;6451;19645
261360;202006;8166;19633;6895;17834;238;684;5489;13822;5727;14506
261370;202006;23468;58538;19703;53293;2093;5585;12755;34744;14848;40329
261380;202006;4067;12250;3571;11374;449;1506;2332;7319;2781;8825
261390;202006;16574;46859;13921;42543;1181;3949;9250;28041;10431;31990
261400;202006;4604;14590;3986;13260;165;734;2989;9690;3154;10424
261410;202006;9546;23722;7839;21083;463;1322;6152;16170;6615;17492
261420;202006;7374;21974;6631;21053;774;2841;4663;14713;5437;17554
261430;202006;3420;9621;2866;8749;61;268;2381;7156;2442;7424
261440;202006;1473;4369;1225;3885;36;177;879;2653;915;2830
261450;202006;14967;40274;13196;37520;188;689;10922;31104;11110;31793
261460;202006;7499;20697;6624;19314;206;742;5372;15527;5578;16269
261470;202006;4188;10345;3645;9629;24;125;3144;8284;3168;8409
261480;202006;5044;15446;4333;14247;189;778;3360;10810;3549;11588
261485;202006;4940;14021;4249;12937;339;1121;3031;9078;3370;10199
261500;202006;5890;15026;5152;14023;380;922;3607;10189;3987;11111
261510;202006;1899;5631;1643;5202;64;240;1239;3948;1303;4188
261520;202006;2344;7198;2105;6701;67;241;1538;4875;1605;5116
261530;202006;11914;34814;9641;30620;904;3421;4888;14944;5792;18365
261540;202006;8149;23246;7314;22037;1062;3167;4166;13229;5228;16396
261550;202006;3663;9696;3162;8906;222;674;2266;6255;2488;6929
261560;202006;7804;23097;6742;21515;279;1070;5192;16570;5471;17640
261570;202006;3543;9437;2831;8294;198;692;1953;5603;2151;6295
261580;202006;6717;17573;5777;16299;107;511;5169;14374;5276;14885
261590;202006;2711;6897;2170;6129;69;225;1649;4621;1718;4846
261600;202006;5149;12922;4323;11678;300;729;3028;8407;3328;9136
261610;202006;2208;6217;1768;5415;96;354;1204;3645;1300;3999
261618;202006;2525;6273;2198;5792;59;174;1779;4645;1838;4819
261620;202006;4178;11681;3810;11147;837;2171;2367;7310;3204;9481
261630;202006;6319;17675;5341;15822;365;1294;3582;10175;3947;11469
261640;202006;37394;83540;31733;76511;1814;3496;23952;59491;25766;62987
261650;202006;4123;10177;3505;9354;147;467;2637;6975;2784;7442
270010;202006;4301;14369;3690;13317;166;938;2921;10237;3087;11175
270020;202006;3876;9667;3377;9020;126;438;2891;7538;3017;7976
270030;202006;33650;90858;27948;81667;3619;10318;18517;54216;22136;64534
270040;202006;10809;28986;9253;27146;366;1381;7669;22295;8035;23676
270050;202006;5519;12757;4695;11825;208;510;4116;10405;4324;10915
270060;202006;2157;5392;1793;4975;150;369;1422;4002;1572;4371
270070;202006;4670;13050;4055;12185;136;510;3396;10020;3532;10530
270080;202006;1441;3907;1199;3496;42;129;924;2590;966;2719
270090;202006;1761;5373;1576;5009;69;282;1286;3983;1355;4265
270100;202006;5466;14402;4703;13280;147;572;3917;10846;4064;11418
270110;202006;3234;7558;2602;6820;137;335;2068;5648;2205;5983
270120;202006;2766;7493;2387;6987;70;307;2014;5790;2084;6097
270130;202006;5087;13020;4393;12193;122;390;3786;10527;3908;10917
270135;202006;2038;4838;1722;4487;50;161;1557;4036;1607;4197
270140;202006;9667;22413;7717;19720;308;1067;6099;14846;6407;15913
270150;202006;2700;8084;2466;7748;4;27;2325;7278;2329;7305
270160;202006;6209;16693;5235;15598;65;330;4842;14407;4907;14737
270170;202006;3374;9844;2837;9090;178;852;2155;6603;2333;7455
270180;202006;2219;6873;2017;6612;40;197;1815;5903;1855;6100
270190;202006;1637;4861;1445;4621;36;183;1263;4005;1299;4188
270200;202006;2408;7280;2089;6848;111;423;1527;4967;1638;5390
270210;202006;5728;13447;4873;12490;75;319;4477;11288;4552;11607
270220;202006;1523;3960;1216;3529;198;599;703;2005;901;2604
270230;202006;9291;25711;7639;23142;637;2140;5434;16269;6071;18409
270235;202006;5657;17375;4869;16113;116;535;4011;13129;4127;13664
270240;202006;10526;28928;8459;26026;917;3072;5903;18175;6820;21247
270250;202006;2720;6879;2376;6381;186;488;1867;5015;2053;5503
270255;202006;4437;12655;3432;10808;109;450;2619;8115;2728;8565
270260;202006;5578;16370;5049;15499;99;506;4419;13244;4518;13750
270270;202006;1044;2691;860;2463;100;299;631;1785;731;2084
270280;202006;3950;9366;3115;8318;482;781;2168;6256;2650;7037
270290;202006;7412;23562;6625;22246;182;865;5740;19062;5922;19927
270300;202006;4165;10788;3231;9783;147;402;2519;7800;2666;8202
270310;202006;6918;19344;5927;17811;100;535;5048;14772;5148;15307
270320;202006;5543;16207;4812;14792;437;1391;3397;10175;3834;11566
270330;202006;3836;12543;3403;11882;258;1042;2603;9046;2861;10088
270340;202006;1603;4335;1384;4043;46;149;1172;3373;1218;3522
270350;202006;1896;4443;1556;4038;143;409;1104;2872;1247;3281
270360;202006;2591;6485;2304;6161;71;163;2119;5693;2190;5856
270370;202006;1375;4250;1250;4015;34;158;1042;3296;1076;3454
270375;202006;3107;7230;2571;6641;18;51;2413;6255;2431;6306
270380;202006;5422;15321;4554;14187;618;1880;2956;9559;3574;11439
270390;202006;1203;3016;979;2758;23;93;805;2264;828;2357
270400;202006;6219;16333;5205;14790;241;695;4049;11410;4290;12105
270410;202006;4595;13197;3956;12203;151;537;3280;10075;3431;10612
270420;202006;5491;16235;4926;15408;125;606;4267;13086;4392;13692
270430;202006;133712;317102;104877;280147;20806;57820;49846;135248;70652;193068
270440;202006;4706;12683;4046;11869;88;383;3516;10172;3604;10555
270450;202006;6944;18669;6084;17633;249;864;5102;14864;5351;15728
270460;202006;3802;8377;3264;7737;158;321;2923;6951;3081;7272
270470;202006;11006;30628;9524;28505;649;2150;7321;21877;7970;24027
270480;202006;2945;7810;2477;7130;93;370;2020;5678;2113;6048
270490;202006;955;2614;826;2457;47;153;662;1950;709;2103
270500;202006;4885;14896;4318;13955;290;1076;3359;10715;3649;11791
270510;202006;5565;14708;4682;13585;334;1330;3497;9657;3831;10987
270520;202006;3935;11202;3097;9760;638;2089;1283;4186;1921;6275
270530;202006;1257;3580;1070;3296;52;153;759;2374;811;2527
270540;202006;2213;6356;1901;5952;59;275;1648;5060;1707;5335
270550;202006;6694;17205;5311;15687;575;1384;3977;12202;4552;13586
270560;202006;2948;7670;2536;7115;132;426;2043;5675;2175;6101
270570;202006;4079;11404;3437;10446;111;364;2801;8459;2912;8823
270580;202006;2259;6375;2046;6063;96;285;1770;5201;1866;5486
270590;202006;1600;4796;1473;4631;16;81;1387;4330;1403;4411
270600;202006;2764;8446;2500;8052;47;244;2219;7057;2266;7301
270610;202006;3615;9468;3111;8802;69;264;2786;7800;2855;8064
270620;202006;1212;3709;1102;3490;35;153;939;2879;974;3032
270630;202006;17453;42486;14940;39018;567;1818;12576;32113;13143;33931
270640;202006;5363;15421;4624;14225;161;663;3757;11318;3918;11981
270642;202006;2515;8044;2223;7568;158;684;1702;5657;1860;6341
270644;202006;3588;8926;2933;8070;275;675;2196;6205;2471;6880
270650;202006;3137;9182;2741;8619;357;1209;1943;6049;2300;7258
270660;202006;2023;5113;1678;4616;79;299;1257;3403;1336;3702
270670;202006;16340;37297;13496;33806;401;1205;11473;28112;11874;29317
270680;202006;5490;13064;4877;12392;117;167;4561;11745;4678;11912
270690;202006;9057;22173;7536;20274;525;1370;5891;15847;6416;17217
270700;202006;512;1533;446;1422;31;126;323;1008;354;1134
270710;202006;5428;16344;4795;15368;223;962;3857;12122;4080;13084
270720;202006;3562;10460;3139;9746;65;350;2754;8382;2819;8732
270730;202006;8109;17925;7065;16803;233;474;5565;14650;5798;15124
270740;202006;2380;6202;2095;5866;91;311;1741;4800;1832;5111
270750;202006;5696;14958;4975;14035;82;384;4422;12397;4504;12781
270760;202006;3262;9168;2820;8571;49;252;2395;7190;2444;7442
270770;202006;20475;49832;16259;44700;2518;6252;10217;29643;12735;35895
270780;202006;1774;4965;1631;4758;84;304;1379;3954;1463;4258
270790;202006;1572;4369;1308;3998;99;321;947;2879;1046;3200
270800;202006;10673;29321;9547;27719;332;1216;8193;23404;8525;24620
270810;202006;3308;9414;2603;8209;167;649;1828;5658;1995;6307
270820;202006;1639;4904;1379;4483;54;261;1082;3423;1136;3684
270830;202006;5167;12267;4161;11033;165;545;3380;8814;3545;9359
270840;202006;8203;24369;7292;23076;172;946;6381;19682;6553;20628
270850;202006;9023;21352;7960;20076;638;1850;6582;16296;7220;18146
270860;202006;14212;31523;11217;28096;601;1397;9053;22649;9654;24046
270870;202006;2137;6031;1761;5418;231;692;1156;3636;1387;4328
270880;202006;8071;24091;7172;22731;220;939;5928;18448;6148;19387
270890;202006;2780;7526;2329;6878;175;544;1626;4792;1801;5336
270895;202006;3085;9460;2792;9076;73;400;2464;7838;2537;8238
270900;202006;1783;4583;1341;3870;37;107;1037;2966;1074;3073
270910;202006;3871;11174;3315;10295;92;319;2699;8290;2791;8609
270915;202006;9309;26686;7520;23730;649;2394;5142;15839;5791;18233
270920;202006;5032;15748;4540;14894;162;792;3725;11818;3887;12610
270930;202006;17154;39800;13264;35269;1863;4527;8922;24855;10785;29382
270940;202006;6514;17073;5526;15889;185;875;4499;12556;4684;13431
280010;202006;688;1895;537;1566;16;65;378;988;394;1053
280020;202006;4847;12231;4109;11064;480;1192;2772;7564;3252;8756
280030;202006;74575;175054;58516;152167;12318;32380;26016;70517;38334;102897
280040;202006;2897;8116;2515;7516;244;770;1696;5016;1940;5786
280050;202006;3826;10865;3279;9996;548;1745;1945;5912;2493;7657
280060;202006;5875;15386;4667;13506;880;2679;2180;6562;3060;9241
280067;202006;6904;16994;5859;15418;317;837;4299;11152;4616;11989
280070;202006;1921;5642;1783;5422;127;394;1469;4438;1596;4832
280100;202006;4000;10616;3359;9590;316;936;2300;6560;2616;7496
280110;202006;1378;3732;1198;3464;17;85;1053;2965;1070;3050
280120;202006;7585;21794;6748;20445;743;2093;4924;15284;5667;17377
280130;202006;9213;21411;8052;19742;413;1108;6524;15820;6937;16928
280140;202006;5415;12944;4751;12059;196;583;4038;10127;4234;10710
280150;202006;4215;10564;3642;9776;332;831;2790;7517;3122;8348
280160;202006;1221;3461;1016;3118;91;311;701;2097;792;2408
280170;202006;5181;13639;4625;12901;234;643;3729;10410;3963;11053
280190;202006;1291;2813;1121;2587;55;128;917;2074;972;2202
280200;202006;1265;3300;1038;2977;74;271;770;2158;844;2429
280210;202006;16545;41297;14350;38143;1517;4185;9197;24424;10714;28609
280220;202006;1750;4674;1497;4332;46;217;1233;3530;1279;3747
280230;202006;4251;10725;3569;9712;282;668;2546;6980;2828;7648
280240;202006;3312;8825;2956;8276;53;276;2543;6895;2596;7171
280250;202006;878;2157;710;1902;69;205;470;1216;539;1421
280260;202006;2199;5285;1951;4979;33;92;1774;4561;1807;4653
280270;202006;2342;6401;2059;5957;118;376;1701;4851;1819;5227
280280;202006;4203;12409;3719;11691;485;1315;2608;8584;3093;9899
280290;202006;18073;47619;15461;43934;1353;4111;10342;29624;11695;33735
280300;202006;11784;28577;10260;26934;288;838;7670;22039;7958;22877
280310;202006;1395;3567;1146;3139;35;123;866;2298;901;2421
280320;202006;8611;23195;7461;21467;892;2590;5002;14242;5894;16832
280330;202006;4648;11486;3937;10496;263;734;2886;7648;3149;8382
280340;202006;5460;11417;4555;10437;215;374;3957;9246;4172;9620
280350;202006;25776;60345;22545;56070;1116;2981;17730;43342;18846;46323
280360;202006;5775;15842;5016;14576;750;2214;2937;8660;3687;10874
280370;202006;2122;5256;1770;4674;56;161;1406;3642;1462;3803
280380;202006;983;2632;840;2434;74;214;572;1684;646;1898
280390;202006;3668;9009;3054;8035;138;358;2446;6379;2584;6737
280400;202006;3916;9863;3375;9106;520;1245;2051;5847;2571;7092
280410;202006;2242;6182;1804;5469;197;615;1042;3098;1239;3713
280420;202006;4303;11435;3942;10974;73;284;3616;10001;3689;10285
280430;202006;2066;4997;1802;4648;67;252;1462;3648;1529;3900
280440;202006;4227;11281;3690;10490;145;493;3103;8625;3248;9118
280445;202006;2312;5862;2057;5422;47;148;1554;3924;1601;4072
280450;202006;10297;23704;8918;21825;985;2024;6031;15410;7016;17434
280460;202006;6888;16286;6223;15353;331;802;5310;12942;5641;13744
280470;202006;1686;4749;1449;4329;63;218;1073;3122;1136;3340
280480;202006;42468;103110;36535;94646;2957;8274;25945;65765;28902;74039
280490;202006;3693;10463;3176;9561;92;399;2458;7154;2550;7553
280500;202006;997;2382;853;2189;37;129;710;1782;747;1911
280510;202006;2545;6443;2200;5949;73;279;1717;4523;1790;4802
280520;202006;1606;4077;1401;3793;58;161;1124;3004;1182;3165
280530;202006;2442;6096;2098;5614;290;649;1466;4047;1756;4696
280540;202006;8938;23899;8111;22700;260;901;7096;19568;7356;20469
280550;202006;6623;15391;5426;13701;184;658;4464;10865;4648;11523
280560;202006;7147;19862;6672;19147;133;506;5874;16656;6007;17162
280570;202006;6455;15639;5227;14080;212;667;3935;10525;4147;11192
280580;202006;5594;14888;4829;13739;570;1454;3367;9787;3937;11241
280590;202006;2922;6554;2486;6056;108;410;1966;4592;2074;5002
280600;202006;3576;9437;3140;8824;167;533;2255;6336;2422;6869
280610;202006;2465;6041;2214;5660;140;359;1821;4616;1961;4975
280620;202006;5426;13225;4650;12203;409;896;3258;8918;3667;9814
280630;202006;3793;10644;3461;10174;166;607;2844;8251;3010;8858
280640;202006;2364;6325;2081;5999;57;177;1846;5326;1903;5503
280650;202006;1187;3102;952;2746;85;292;709;1952;794;2244
280660;202006;3705;8095;3164;7453;211;389;2629;6320;2840;6709
280670;202006;19703;44215;16943;40702;919;2312;13514;32218;14433;34530
280680;202006;2796;6661;2389;6088;229;427;1717;4454;1946;4881
280690;202006;957;2336;809;2140;51;117;633;1656;684;1773
280700;202006;1168;2923;1009;2684;27;101;797;2083;824;2184
280710;202006;15296;34286;12898;31563;515;967;10913;27442;11428;28409
280720;202006;2663;6049;2209;5515;57;180;1612;4167;1669;4347
280730;202006;1058;2712;947;2527;42;131;730;1879;772;2010
280740;202006;14106;34327;11976;31081;719;2042;8614;21772;9333;23814
280750;202006;3590;10000;3118;9182;178;609;2243;6478;2421;7087
280760;202006;6359;16892;5521;15586;560;1432;3684;10763;4244;12195
290010;202006;3177;6659;2069;4931;5;16;1695;3861;1700;3877
290020;202006;5377;14264;4861;13598;336;637;4088;11848;4424;12485
290030;202006;4532;10378;3640;9395;169;399;3083;8049;3252;8448
290035;202006;5142;11190;4249;10028;368;562;3358;8293;3726;8855
290040;202006;4171;10209;3545;9447;107;286;2808;7848;2915;8134
290050;202006;2023;6517;1698;5811;116;476;1133;3775;1249;4251
290060;202006;1321;3176;968;2616;76;241;632;1682;708;1923
290070;202006;37405;81380;32024;74660;1773;4322;24899;57397;26672;61719
290080;202006;5309;15488;4542;14334;457;1560;3176;10109;3633;11669
290090;202006;2158;4130;1516;3445;18;61;1382;3108;1400;3169
290100;202006;9796;25499;7902;22637;1292;3470;4274;12860;5566;16330
290110;202006;5224;13719;4622;12775;327;929;3337;9124;3664;10053
290115;202006;3949;11378;3309;10223;223;758;2457;7517;2680;8275
290120;202006;6505;15994;5468;14561;134;459;4685;12256;4819;12715
290130;202006;4724;11408;3672;10042;161;470;2851;7770;3012;8240
290135;202006;4207;9893;3424;8606;191;486;2653;6493;2844;6979
290140;202006;4545;11866;3468;10419;100;371;2908;8686;3008;9057
290150;202006;2466;6336;2119;5903;139;383;1634;4584;1773;4967
290160;202006;3367;7671;2969;7120;284;589;2323;5606;2607;6195
290170;202006;3387;8508;2982;8063;111;306;2659;7253;2770;7559
290180;202006;2969;8123;2446;7257;83;296;1990;5856;2073;6152
290190;202006;4254;11840;3718;11112;145;575;3057;9012;3202;9587
290195;202006;2354;5808;1874;5174;27;136;1584;4332;1611;4468
290200;202006;4114;11405;3335;10104;187;626;2505;7512;2692;8138
290205;202006;3450;8875;3020;8222;126;435;2354;6192;2480;6627
290210;202006;12973;36045;11458;33737;875;2355;8818;26407;9693;28762
290220;202006;2864;7092;2503;6625;120;334;2046;5394;2166;5728
290225;202006;3234;6879;2484;6085;159;281;2064;5164;2223;5445
290230;202006;2442;6436;2219;6168;30;94;1998;5547;2028;5641
290240;202006;3729;9368;2961;8383;70;252;2494;7049;2564;7301
290250;202006;3943;11471;3290;10496;104;351;2711;8770;2815;9121
290260;202006;5459;13276;4525;11914;165;549;3765;9662;3930;10211
290265;202006;3505;10144;2833;8839;193;625;2018;6265;2211;6890
290270;202006;11069;37440;10323;36157;528;2318;8304;28791;8832;31109
290280;202006;6115;18184;5276;16497;296;1050;3804;11710;4100;12760
290290;202006;9982;28862;8037;25268;799;2720;5262;16315;6061;19035
290300;202006;4233;11475;3107;9339;158;519;2228;6664;2386;7183
290310;202006;1596;3920;1261;3510;55;230;973;2618;1028;2848
290320;202006;24286;63254;19089;55235;4190;11931;9083;27709;13273;39640
290323;202006;3785;10285;3280;9497;104;331;2591;7472;2695;7803
290327;202006;4093;11907;3475;10693;245;707;2482;7607;2727;8314
290330;202006;2206;4627;1709;4091;47;85;1514;3683;1561;3768
290340;202006;5716;14259;4391;12620;436;1299;3166;9234;3602;10533
290350;202006;4717;13037;3890;11633;272;829;2788;8383;3060;9212
290360;202006;5044;13222;4416;12397;132;369;3804;10772;3936;11141
290370;202006;5238;12743;3832;10882;153;402;2771;8031;2924;8433
290380;202006;5575;14822;4683;13604;113;272;4021;11910;4134;12182
290390;202006;14572;41206;12044;37216;1288;3920;7847;24653;9135;28573
290395;202006;2840;8199;2278;7221;65;306;1743;5426;1808;5732
290400;202006;3778;10113;3020;8865;82;351;2306;6581;2388;6932
290405;202006;4653;13499;3962;12294;295;953;2715;8608;3010;9561
290410;202006;5740;15549;4385;13356;106;497;3313;9819;3419;10316
290420;202006;2980;8313;2462;7494;71;252;1896;5727;1967;5979
290430;202006;3164;8646;2591;7755;224;702;1754;5176;1978;5878
290440;202006;2890;7119;2064;5812;47;127;1441;4135;1488;4262
290450;202006;3475;8859;2710;7694;140;401;1990;5721;2130;6122
290460;202006;11680;32812;9778;29188;1948;5920;4381;13036;6329;18956
290470;202006;4575;11223;3352;9522;390;1220;1898;5470;2288;6690
290475;202006;6484;18780;5452;16941;95;519;4439;13494;4534;14013
290480;202006;1793;4530;1464;4042;82;279;1012;2663;1094;2942
290485;202006;4517;13135;3982;12385;101;522;3404;10391;3505;10913
290490;202006;9254;21616;8252;20250;501;1115;6450;16078;6951;17193
290500;202006;4033;12046;3089;9992;542;1835;1347;4239;1889;6074
290510;202006;3492;8666;2896;7890;74;248;2499;6764;2573;7012
290515;202006;3650;10078;3149;9400;43;130;2826;8591;2869;8721
290520;202006;11546;32776;8885;27618;589;1981;5404;16568;5993;18549
290530;202006;4990;14200;4188;12893;135;520;3529;10813;3664;11333
290540;202006;3380;8864;3008;8434;50;166;2776;7756;2826;7922
290550;202006;4304;11233;3714;10537;10;54;3415;9804;3425;9858
290560;202006;6461;16644;4878;14286;418;1506;3192;9046;3610;10552
290570;202006;44748;109421;39524;102759;2451;6556;31750;82003;34201;88559
290580;202006;7802;22677;6702;21069;598;1845;4904;15792;5502;17637
290590;202006;7090;21737;5969;19729;143;590;4817;15993;4960;16583
290600;202006;18842;52219;16579;48516;681;2098;13343;38954;14024;41052
290610;202006;2578;7996;2001;6807;95;400;1402;4710;1497;5110
290620;202006;6379;17866;5497;16412;198;570;4618;13763;4816;14333
290630;202006;9274;22349;7338;19845;546;1476;5663;15434;6209;16910
290640;202006;2791;7179;2134;6222;85;252;1547;4582;1632;4834
290650;202006;13128;32482;11580;30727;2553;6484;7153;19863;9706;26347
290660;202006;3653;9316;3029;8407;50;140;2289;6558;2339;6698
290670;202006;6772;18625;5693;16834;373;1044;4316;12937;4689;13981
290680;202006;10840;29976;9078;27351;197;1056;7495;22093;7692;23149
290682;202006;4795;12298;4137;11421;125;294;3493;9747;3618;10041
290685;202006;3489;7841;2484;6390;204;485;1529;4209;1733;4694
290687;202006;6642;17823;5368;15729;712;2006;3416;10272;4128;12278
290689;202006;2838;7850;2168;6607;201;668;1481;4482;1682;5150
290690;202006;5559;14357;4486;12836;304;939;3247;9149;3551;10088
290700;202006;2631;7172;2309;6763;71;240;1939;5698;2010;5938
290710;202006;8295;23296;7090;21615;156;625;5980;18257;6136;18882
290720;202006;18479;50380;16763;47764;928;2932;13435;37814;14363;40746
290730;202006;7049;16728;5988;15489;288;585;4736;12436;5024;13021
290740;202006;1033;2777;795;2392;33;112;657;1976;690;2088
290750;202006;11125;27644;9601;25187;636;1795;7111;18111;7747;19906
290755;202006;2101;5898;1679;5125;91;285;1164;3581;1255;3866
290760;202006;3757;10883;3014;9456;185;546;2037;6585;2222;7131
290770;202006;2635;8363;2404;8070;50;249;2012;6815;2062;7064
290780;202006;8252;20308;7110;18803;269;592;5572;15083;5841;15675
290790;202006;4702;12891;4074;11992;159;457;3364;10043;3523;10500
290800;202006;7136;14771;5038;12298;291;685;3738;9193;4029;9878
290810;202006;5406;14132;4317;12526;110;356;3253;9640;3363;9996
290820;202006;4851;13104;4340;12364;182;524;3271;9449;3453;9973
290830;202006;4488;10151;3971;9508;29;81;3498;8273;3527;8354
290840;202006;17075;45030;14628;41238;1896;4390;9403;28182;11299;32572
290850;202006;6676;16000;5966;15235;206;515;5110;13183;5316;13698
290860;202006;6173;17618;5362;16673;216;719;4512;14308;4728;15027
290870;202006;4742;13004;3574;10775;142;452;2529;7567;2671;8019
290880;202006;1391;3463;1109;3092;73;176;765;2228;838;2404
290890;202006;9298;18670;8323;17573;154;333;7806;16412;7960;16745
290900;202006;2380;6200;1805;5192;101;245;1125;3206;1226;3451
290910;202006;5148;12304;3927;10447;49;156;3324;8760;3373;8916
290920;202006;5061;12805;4598;12266;42;90;4336;11687;4378;11777
290930;202006;7655;21298;6106;18585;194;827;4773;14157;4967;14984
290940;202006;3691;10319;3027;9353;160;587;2423;7472;2583;8059
290950;202006;1460;3654;1187;3238;62;178;834;2281;896;2459
290960;202006;5478;14332;4897;13602;181;453;4127;11525;4308;11978
290970;202006;3357;9837;2729;8697;107;393;2094;6671;2201;7064
290980;202006;12163;29089;10153;25987;796;2221;6324;15723;7120;17944
290990;202006;9550;25412;8403;23542;250;1030;7043;19054;7293;20084
291000;202006;3420;8866;2645;7881;109;346;2165;6509;2274;6855
291005;202006;15291;37518;13437;35085;1211;2896;10470;27545;11681;30441
291010;202006;3059;9239;2470;7982;116;428;1620;5098;1736;5526
291020;202006;1248;3083;997;2634;22;74;723;1803;745;1877
291030;202006;2511;6095;1739;4759;110;277;1075;2859;1185;3136
291040;202006;5385;14781;4475;13484;155;610;3514;10545;3669;11155
291050;202006;7669;19928;6531;18352;633;2002;4752;13084;5385;15086
291060;202006;5946;18160;5041;16944;314;1372;3829;12788;4143;14160
291070;202006;15947;42745;13244;38408;419;1471;10794;31114;11213;32585
291072;202006;24739;63260;17684;51061;3226;9627;7504;21929;10730;31556
291075;202006;5431;13337;4862;12454;103;276;4057;10197;4160;10473
291077;202006;1597;4151;1237;3522;54;120;868;2468;922;2588
291080;202006;103629;256755;81083;225016;24365;69317;22212;66663;46577;135980
291085;202006;5632;14183;4727;12791;182;558;3925;10591;4107;11149
291090;202006;2011;3787;1446;3153;46;103;1165;2497;1211;2600
291100;202006;3223;7009;2208;5796;101;274;1683;4380;1784;4654
291110;202006;5949;17594;5024;16006;317;1296;3810;11694;4127;12990
291120;202006;7589;18469;6377;16920;300;862;4912;12999;5212;13861
291125;202006;2194;3847;1649;3243;99;149;1330;2676;1429;2825
291130;202006;3249;9195;2380;7476;64;290;1768;5375;1832;5665
291140;202006;4894;13150;3557;10713;444;1169;2192;6633;2636;7802
291150;202006;2483;5376;1906;4724;6;22;1796;4442;1802;4464
291160;202006;5123;13927;4217;12621;370;1178;2821;8371;3191;9549
291165;202006;2132;5787;1603;4758;28;122;1183;3403;1211;3525
291170;202006;21002;53117;17472;47082;930;2742;11511;30496;12441;33238
291180;202006;6307;14562;4588;12238;264;682;3536;9441;3800;10123
291185;202006;3086;8279;2695;7641;89;273;2076;5902;2165;6175
291190;202006;7604;18656;6235;16891;293;925;4915;13266;5208;14191
291200;202006;2768;7580;2040;6203;92;291;1250;3664;1342;3955
291210;202006;7044;15047;5254;12986;136;440;3907;9698;4043;10138
291220;202006;4085;11535;3665;10905;181;651;2900;8517;3081;9168
291230;202006;4466;9567;3360;8356;36;97;3026;7597;3062;7694
291240;202006;4221;10765;3616;9757;64;222;3102;8244;3166;8466
291250;202006;3419;10031;2648;8616;158;502;1706;5571;1864;6073
291260;202006;1426;3333;1166;2997;31;100;954;2465;985;2565
291270;202006;5406;13925;4165;12091;633;1836;2589;7689;3222;9525
291280;202006;2607;6355;1939;5374;141;425;1260;3416;1401;3841
291290;202006;5872;15361;4513;13245;335;1067;3107;9033;3442;10100
291300;202006;3846;10335;2963;8881;111;405;2257;6663;2368;7068
291310;202006;5137;13605;4367;12200;117;379;3688;10158;3805;10537
291320;202006;6131;16964;4748;14384;1060;3005;2332;7509;3392;10514
291330;202006;1781;4489;1468;3977;80;214;1096;2936;1176;3150
291340;202006;4287;11079;3458;9630;78;247;2629;7203;2707;7450
291345;202006;2948;8788;2671;8355;111;391;2241;7010;2352;7401
291350;202006;6893;16963;5349;15082;60;198;4639;13315;4699;13513
291360;202006;37622;85588;29344;75596;2746;7223;19197;50521;21943;57744
291370;202006;8044;21838;7090;20366;517;1560;5261;14847;5778;16407
291380;202006;3417;9273;2988;8682;101;414;2483;7160;2584;7574
291390;202006;13247;28331;10239;24993;432;1047;8478;20680;8910;21727
291400;202006;13936;35521;11421;31709;1538;3747;6748;20213;8286;23960
291410;202006;2938;7696;2271;6549;34;143;1678;4756;1712;4899
291420;202006;1908;4715;1476;4175;30;120;1277;3604;1307;3724
291430;202006;2750;7774;2370;7143;81;356;1904;5556;1985;5912
291440;202006;6380;18251;5480;16759;325;1066;4274;13066;4599;14132
291450;202006;9338;22749;7667;20822;73;126;6729;18867;6802;18993
291460;202006;15587;41162;13617;38222;666;2089;10282;28648;10948;30737
291465;202006;9395;22981;7380;20669;136;610;6375;17722;6511;18332
291470;202006;16719;37265;13925;34104;741;1602;10329;26079;11070;27681
291480;202006;41520;91887;30374;76599;3535;9236;16065;40561;19600;49797
291490;202006;5624;13903;4835;13001;141;450;4353;11645;4494;12095
291500;202006;4996;12193;4130;11039;70;308;3750;9972;3820;10280
291510;202006;4309;10609;3194;9197;52;294;2667;7609;2719;7903
291520;202006;4571;10331;3429;8822;179;494;2631;6711;2810;7205
291530;202006;2317;5299;1617;4373;305;749;918;2729;1223;3478
291535;202006;3427;9978;3033;9281;170;470;2336;7305;2506;7775
291540;202006;2306;5095;1576;4214;66;219;1292;3398;1358;3617
291550;202006;5652;12911;4387;11304;383;827;2996;7900;3379;8727
291560;202006;18671;43898;13348;36845;1288;3433;8005;22980;9293;26413
291570;202006;2417;5733;1897;5092;58;158;1551;4328;1609;4486
291580;202006;6307;16231;4963;14423;218;700;3689;10646;3907;11346
291590;202006;2160;5216;1870;4878;72;261;1656;4220;1728;4481
291600;202006;5577;12832;4272;10830;382;1029;2907;7141;3289;8170
291610;202006;5666;14811;5082;14161;80;301;4656;12952;4736;13253
291620;202006;3172;7016;2329;6092;105;268;1816;4847;1921;5115
291630;202006;3315;7413;2470;6300;291;814;1733;4330;2024;5144
291640;202006;15763;38901;11872;33254;1708;4656;5341;15549;7049;20205
291650;202006;9533;23587;8400;22238;560;1039;7075;19205;7635;20244
291660;202006;2102;5127;1519;4219;128;420;989;2589;1117;3009
291670;202006;2067;5419;1744;4954;103;255;1311;3787;1414;4042
291680;202006;4168;10168;3365;8997;291;806;2370;6291;2661;7097
291685;202006;4701;11188;3752;9972;225;467;2838;7834;3063;8301
291690;202006;4189;9203;2877;7288;233;474;2181;5580;2414;6054
291700;202006;8619;24864;7528;22937;316;1171;6126;18310;6442;19481
291710;202006;5333;12612;3912;10618;214;674;2850;7587;3064;8261
291720;202006;4488;13590;3721;12049;396;1364;2433;7711;2829;9075
291730;202006;6394;16221;5480;15028;266;810;4532;12352;4798;13162
291733;202006;2893;7331;2429;6715;59;167;1763;5118;1822;5285
291735;202006;2923;7669;2315;6592;72;166;1764;4999;1836;5165
291740;202006;3885;10021;2876;8154;88;238;2067;5762;2155;6000
291750;202006;19474;46322;15802;40947;1514;3834;10698;28033;12212;31867
291760;202006;10331;29673;8057;25998;2431;8883;2206;7104;4637;15987
291770;202006;7101;18987;5909;16942;344;1065;4433;12379;4777;13444
291780;202006;5163;13631;4638;12890;85;320;4077;11204;4162;11524
291790;202006;2754;7544;2490;7204;231;560;1867;5596;2098;6156
291800;202006;29182;73307;21628;61986;3399;9467;10599;31596;13998;41063
291810;202006;10615;25125;8827;22930;266;676;7502;19596;7768;20272
291820;202006;3796;9982;3276;9310;92;307;2627;7487;2719;7794
291830;202006;4463;10513;3645;9415;189;421;2893;7500;3082;7921
291835;202006;6514;19404;5099;16671;531;1852;3244;10748;3775;12600
291840;202006;48000;130822;41402;120567;4313;13380;28996;83955;33309;97335
291845;202006;2521;6490;1968;5806;111;355;1589;4732;1700;5087
291850;202006;3911;11149;3203;9963;257;758;2283;7286;2540;8044
291855;202006;2212;4303;1711;3746;43;100;1543;3384;1586;3484
291860;202006;2241;5823;1556;4505;45;124;1055;2942;1100;3066
291870;202006;1284;3214;855;2473;46;133;581;1650;627;1783
291875;202006;2909;8701;2504;7853;63;258;1838;5594;1901;5852
291880;202006;5645;15837;4766;14351;219;639;3564;10776;3783;11415
291890;202006;1658;3373;1067;2688;126;295;717;1811;843;2106
291900;202006;1223;2939;930;2485;23;89;732;1901;755;1990
291905;202006;2497;6314;2018;5553;78;282;1535;4068;1613;4350
291910;202006;2962;7422;2519;6893;53;190;2167;6059;2220;6249
291915;202006;7431;20935;6047;18596;222;776;4584;14265;4806;15041
291920;202006;26681;68899;22436;62969;2157;6592;15573;42878;17730;49470
291930;202006;2516;6772;2147;6253;238;701;1433;4219;1671;4920
291940;202006;3899;9902;2593;7677;196;579;1521;4484;1717;5063
291950;202006;9212;27606;7817;24912;291;1096;5434;17100;5725;18196
291955;202006;15617;39148;13870;36901;1173;3261;10811;28841;11984;32102
291960;202006;3051;8056;2532;7344;119;363;1977;5857;2096;6220
291970;202006;4548;11408;3794;10459;142;481;2848;7871;2990;8352
291980;202006;9696;27561;7630;23943;967;2819;4642;14936;5609;17755
291990;202006;2314;5925;1890;5417;28;116;1754;5027;1782;5143
291992;202006;3956;9500;3134;8437;223;520;2482;6808;2705;7328
291995;202006;2088;5759;1712;5155;53;241;1296;3802;1349;4043
292000;202006;2652;6199;2157;5602;97;367;1677;4296;1774;4663
292010;202006;5746;13383;4672;11848;170;524;3872;9620;4042;10144
292020;202006;4584;13227;3786;11801;204;733;2737;8278;2941;9011
292030;202006;1837;5593;1673;5287;71;254;1061;3289;1132;3543
292040;202006;4406;11268;3410;9782;226;582;2599;7621;2825;8203
292045;202006;4013;10526;2966;8989;31;88;2622;8108;2653;8196
292050;202006;6600;18334;5293;16002;251;867;3398;10104;3649;10971
292060;202006;11472;26282;10487;25055;484;1087;9165;21689;9649;22776
292070;202006;5806;14981;5053;14080;295;832;4329;11997;4624;12829
292080;202006;3117;7824;2573;7120;78;260;2282;6272;2360;6532
292090;202006;4655;10010;3295;8372;258;670;2471;6328;2729;6998
292100;202006;11088;26751;9450;24692;944;2578;6584;17168;7528;19746
292105;202006;3525;8719;3065;8093;100;238;2516;6667;2616;6905
292110;202006;5951;14497;4185;11667;979;2780;1922;5369;2901;8149
292120;202006;6938;17637;5703;15580;363;1050;4334;11629;4697;12679
292130;202006;3433;8163;2820;7405;102;300;2223;5763;2325;6063
292140;202006;5069;11936;4237;10672;315;791;3361;8434;3676;9225
292145;202006;2376;6809;1998;6161;62;161;1539;4804;1601;4965
292150;202006;14075;38336;12191;35254;316;1201;9941;28397;10257;29598
292160;202006;2965;7165;2233;6219;41;113;1822;5311;1863;5424
292170;202006;8435;22282;7005;19949;342;1138;5306;14806;5648;15944
292180;202006;2847;7775;2084;6361;164;492;1290;3867;1454;4359
292190;202006;2972;7770;2532;7093;90;313;1990;5512;2080;5825
292200;202006;8469;20966;6320;17925;1045;3065;3280;9591;4325;12656
292205;202006;3879;10654;3349;9864;56;254;2926;8575;2982;8829
292210;202006;6532;15128;5259;13528;90;389;4726;12021;4816;12410
292220;202006;2142;5131;1877;4723;49;139;1488;3617;1537;3756
292225;202006;3214;9341;2809;8722;72;333;2372;7235;2444;7568
292230;202006;8589;20410;7667;19242;157;521;6626;16346;6783;16867
292240;202006;4731;13649;4096;12502;300;897;2862;8760;3162;9657
292250;202006;5845;14959;5247;14052;427;1118;3912;10438;4339;11556
292260;202006;3424;8860;3020;8333;93;249;2625;7254;2718;7503
292265;202006;3390;9137;2833;8296;75;317;2247;6451;2322;6768
292270;202006;4423;10020;3510;8936;114;280;2917;7425;3031;7705
292273;202006;2768;5862;2192;5162;55;91;1612;4066;1667;4157
292275;202006;1645;4260;1289;3777;58;164;971;2897;1029;3061
292280;202006;2632;6226;2110;5623;78;160;1790;4904;1868;5064
292285;202006;2548;6141;2033;5446;79;176;1651;4462;1730;4638
292290;202006;7423;19616;5858;17414;163;623;4789;14207;4952;14830
292300;202006;10320;25828;8119;22871;759;2277;5630;15928;6389;18205
292303;202006;2942;8373;2551;7753;77;194;2134;6535;2211;6729
292305;202006;2325;6193;2145;5946;44;202;1945;5294;1989;5496
292310;202006;6692;16788;5766;15670;147;498;5027;13525;5174;14023
292320;202006;6097;16621;4827;14260;261;856;3517;10116;3778;10972
292330;202006;2730;5996;2192;5391;97;195;1706;4365;1803;4560
292335;202006;4735;12251;4203;11488;205;485;3554;9804;3759;10289
292340;202006;5617;15617;4621;13700;224;672;3416;10049;3640;10721
292350;202006;2486;6722;2066;6146;76;282;1667;4976;1743;5258
292360;202006;4918;13072;4075;11644;223;724;2884;8058;3107;8782
292370;202006;10541;24375;9042;22423;130;421;8382;20521;8512;20942
292380;202006;6792;18877;6069;17582;389;1131;4616;13255;5005;14386
292390;202006;4537;8689;3333;7285;109;198;2919;6393;3028;6591
292400;202006;22537;63614;19421;58662;1908;5856;13292;40381;15200;46237
292405;202006;4401;10720;3707;9627;93;241;3075;7875;3168;8116
292410;202006;2217;5250;1844;4777;65;144;1626;4238;1691;4382
292420;202006;3456;10428;3141;9925;109;549;2698;8294;2807;8843
292430;202006;4873;14495;3671;12290;278;965;2398;8019;2676;8984
292440;202006;8427;26748;7782;25780;128;648;6963;22970;7091;23618
292450;202006;4024;11436;3146;9724;83;317;2456;7539;2539;7856
292460;202006;4900;13397;3995;11854;332;942;2874;8544;3206;9486
292465;202006;2670;6843;2266;6327;92;197;1516;4642;1608;4839
292467;202006;1909;5334;1681;5024;239;635;1162;3611;1401;4246
292470;202006;2978;7551;2302;6500;55;118;1794;5075;1849;5193
292480;202006;6316;14947;5083;13449;75;294;4615;12102;4690;12396
292490;202006;2070;5338;1728;4836;116;264;1305;3743;1421;4007
292500;202006;6608;17969;5268;15584;506;1566;3414;9963;3920;11529
292510;202006;13233;35612;10296;30895;524;1860;7198;21535;7722;23395
292520;202006;7008;17398;6206;16250;450;1212;4825;12524;5275;13736
292525;202006;5885;14072;4783;12833;119;284;4132;11282;4251;11566
292530;202006;28183;74866;21470;63337;5159;15356;8238;24938;13397;40294
292540;202006;4428;8137;3453;7097;113;185;3108;6424;3221;6609
292550;202006;8406;21604;6415;19217;473;1404;4541;14488;5014;15892
292560;202006;4380;10877;3797;10112;84;233;3148;8453;3232;8686
292570;202006;3602;9478;3012;8372;77;288;2532;6859;2609;7147
292575;202006;6947;19686;6355;18899;374;1085;5113;15368;5487;16453
292580;202006;7554;18951;6240;17011;134;455;5266;14211;5400;14666
292590;202006;7351;19528;6283;17689;257;829;5239;14475;5496;15304
292593;202006;2844;7037;2351;6213;69;177;1972;5152;2041;5329
292595;202006;5411;14315;4620;13345;148;497;3898;11187;4046;11684
292600;202006;10938;29602;9394;27238;304;898;7473;21737;7777;22635
292610;202006;4118;10773;3469;9621;185;433;2618;7352;2803;7785
292620;202006;6431;17531;5326;16201;123;280;4864;15088;4987;15368
292630;202006;8555;20869;6867;18163;697;1850;4438;11789;5135;13639
292640;202006;8158;23934;7072;22128;194;771;5054;15924;5248;16695
292650;202006;4469;10969;4020;10384;107;288;3654;9338;3761;9626
292660;202006;11442;30620;9678;28027;449;1455;7423;21476;7872;22931
292665;202006;2169;6368;1873;5980;66;194;1577;5112;1643;5306
292670;202006;3581;9570;2737;7998;115;364;1863;5335;1978;5699
292680;202006;3970;10407;3124;8933;191;498;2284;6423;2475;6921
292690;202006;2645;6754;1818;5402;195;541;1075;3349;1270;3890
292700;202006;9815;26556;8521;24587;723;1853;5883;17562;6606;19415
292710;202006;2445;7560;2261;7306;42;145;2048;6653;2090;6798
292720;202006;8998;21356;7607;19753;209;572;6049;15985;6258;16557
292730;202006;4565;10345;4268;9990;268;440;3648;8741;3916;9181
292740;202006;326561;784249;280319;717417;38924;99716;174479;444687;213403;544403
292750;202006;6178;16513;5395;15372;223;649;4169;12057;4392;12706
292760;202006;3906;11188;3385;10258;225;766;2470;7431;2695;8197
292770;202006;6187;16144;4976;14457;764;2278;3163;9463;3927;11741
292780;202006;2127;4194;1567;3504;45;135;1271;2683;1316;2818
292790;202006;4082;8651;3113;7601;153;371;2599;6403;2752;6774
292800;202006;11332;28207;9673;25704;297;843;8088;21210;8385;22053
292805;202006;3608;8624;2815;7581;100;318;2220;5925;2320;6243
292810;202006;10663;27843;8400;24303;209;887;6326;17714;6535;18601
292820;202006;7430;20383;5395;16966;432;1442;3747;11592;4179;13034
292830;202006;2882;6785;2467;6271;91;271;2089;5321;2180;5592
292840;202006;8726;22652;7372;20809;144;543;6452;17900;6596;18443
292850;202006;2495;6591;2092;5986;146;440;1478;4194;1624;4634
292860;202006;17206;37555;15412;35427;411;1000;13345;30296;13756;31296
292870;202006;17968;44247;15375;40603;934;2513;10517;27481;11451;29994
292880;202006;11005;29839;9363;27385;269;1112;7388;20899;7657;22011
292890;202006;7035;19437;6202;18226;184;744;5425;15823;5609;16567
292895;202006;3008;6424;2173;5182;95;229;1753;4139;1848;4368
292900;202006;2597;6953;2355;6581;61;238;1935;5246;1996;5484
292905;202006;4330;11120;3417;9782;135;451;2530;7158;2665;7609
292910;202006;4906;13250;4450;12589;214;604;3405;9573;3619;10177
292920;202006;9719;26549;8966;25479;251;949;7761;21658;8012;22607
292925;202006;5428;15279;4528;13658;217;656;3273;9767;3490;10423
292930;202006;6496;18972;5576;17269;464;1603;3575;10788;4039;12391
292935;202006;2465;6162;1900;5531;23;126;1703;4976;1726;5102
292937;202006;2770;6908;2363;6355;50;147;2007;5413;2057;5560
292940;202006;2835;7155;2262;6305;176;403;1642;4756;1818;5159
292950;202006;9557;24113;8344;22326;529;1226;6302;16839;6831;18065
292960;202006;5231;12596;4374;11376;127;331;3501;9012;3628;9343
292970;202006;3804;10874;3356;10190;84;394;2797;8515;2881;8909
292975;202006;4486;9508;3969;8927;128;219;3616;8224;3744;8443
292980;202006;3302;7924;2639;6948;87;276;2149;5551;2236;5827
292990;202006;11386;31074;9492;27714;649;1995;6957;19996;7606;21991
293000;202006;2618;6198;2238;5621;41;142;1788;4498;1829;4640
293010;202006;17991;45894;14452;40305;1928;5548;8817;24557;10745;30105
293015;202006;8305;25292;6488;21722;433;1567;4360;14819;4793;16386
293020;202006;9804;28348;8817;26936;135;588;7941;24313;8076;24901
293030;202006;5273;13861;3999;11872;99;329;2774;8456;2873;8785
293040;202006;4170;11190;3502;10241;69;266;3048;8905;3117;9171
293050;202006;22296;54684;19677;50829;1027;2731;14889;37945;15916;40676
293060;202006;3496;9271;2836;8038;233;698;1964;5474;2197;6172
293070;202006;25107;60244;21360;55500;1960;5346;15371;39995;17331;45341
293075;202006;3454;10957;2989;10157;156;690;2372;8062;2528;8752
293076;202006;3544;8649;3221;8267;55;146;2873;7438;2928;7584
293077;202006;6112;16867;4954;14990;422;1406;3229;9993;3651;11399
293080;202006;4706;13870;4045;12738;91;430;3276;10122;3367;10552
293090;202006;3220;9329;2451;8054;207;670;1604;5341;1811;6011
293100;202006;5777;15305;4770;13498;224;655;3744;10485;3968;11140
293105;202006;3742;11822;3267;10855;232;802;2305;7599;2537;8401
293110;202006;2402;5957;1980;5337;68;245;1619;4255;1687;4500
293120;202006;4375;11861;3888;11095;114;305;3239;9251;3353;9556
293130;202006;3677;10096;3203;9470;76;290;2755;8068;2831;8358
293135;202006;30883;71877;22742;61059;3412;9955;10806;29330;14218;39285
293140;202006;2386;5274;2062;4875;61;144;1737;4104;1798;4248
293150;202006;5487;16202;4503;14324;333;1075;3091;9869;3424;10944
293160;202006;3857;9344;3268;8705;246;408;2717;7606;2963;8014
293170;202006;4946;10269;4298;9467;117;253;3756;8237;3873;8490
293180;202006;4350;12190;3579;10784;88;339;2838;8363;2926;8702
293190;202006;14005;38028;12289;35536;144;640;10897;31302;11041;31942
293200;202006;8382;20769;6680;18087;196;709;5350;14189;5546;14898
293210;202006;5175;13689;4425;12544;273;777;3412;9657;3685;10434
293220;202006;5035;12938;3670;10600;852;2458;1459;4325;2311;6783
293230;202006;3863;9902;2835;8427;207;695;1937;5807;2144;6502
293240;202006;4524;11917;3614;10434;66;158;2743;8243;2809;8401
293245;202006;3815;10276;3418;9707;144;483;2915;8147;3059;8630
293250;202006;5938;13678;4830;12259;138;354;4056;10291;4194;10645
293260;202006;4540;12116;3746;10873;144;458;2584;7536;2728;7994
293270;202006;7238;15932;5695;14280;394;599;4472;12051;4866;12650
293280;202006;4505;11845;3914;11010;231;577;3048;8666;3279;9243
293290;202006;14355;41745;12604;39002;1694;5340;8268;25922;9962;31262
293300;202006;5751;13906;4923;12704;278;729;3603;9302;3881;10031
293305;202006;4086;9661;3557;9008;50;123;3210;8137;3260;8260
293310;202006;2099;5354;1763;4836;53;161;1399;3788;1452;3949
293315;202006;4095;9673;3366;8576;196;436;2780;7083;2976;7519
293317;202006;2631;6147;2322;5719;141;270;1841;4549;1982;4819
293320;202006;12059;28998;10657;27431;259;717;9510;24367;9769;25084
293325;202006;1790;4404;1389;3865;200;540;842;2387;1042;2927
293330;202006;56671;160794;45887;141575;8533;27164;21191;65740;29724;92904
293340;202006;2212;6187;1820;5493;81;272;1297;3858;1378;4130
293345;202006;3526;9476;2816;8412;363;842;1830;5976;2193;6818
293350;202006;6612;18882;5695;17788;61;308;5189;16408;5250;16716
293360;202006;15523;38516;13149;35351;297;1224;11574;30550;11871;31774
310010;202006;947;2132;606;1656;48;174;227;561;275;735
310020;202006;2624;7085;1921;5829;423;1390;403;1164;826;2554
310030;202006;1912;5352;1466;4575;214;745;939;2817;1153;3562
310040;202006;895;2334;710;2020;29;129;488;1300;517;1429
310050;202006;1492;4464;1250;4075;131;537;818;2557;949;3094
310060;202006;3157;8908;2736;8349;78;321;2275;6851;2353;7172
310070;202006;344;781;240;633;7;15;180;472;187;487
310080;202006;685;1812;485;1449;71;237;222;623;293;860
310090;202006;4673;12409;3818;11014;287;888;2781;7891;3068;8779
310100;202006;3471;9593;2896;8622;78;365;2349;6795;2427;7160
310110;202006;4601;12091;3568;10266;764;2405;1551;4285;2315;6690
310120;202006;638;1560;404;1183;44;155;238;645;282;800
310130;202006;372;960;309;867;26;105;228;600;254;705
310140;202006;264;751;186;622;36;138;73;221;109;359
310150;202006;5358;14103;3945;11479;505;1698;1870;5127;2375;6825
310160;202006;7629;19040;5418;15393;1043;3255;1916;5496;2959;8751
310163;202006;1021;3013;811;2614;182;668;271;806;453;1474
310170;202006;9160;23303;7271;20333;612;1772;5137;14338;5749;16110
310180;202006;1783;4420;1305;3630;166;507;766;2058;932;2565
310190;202006;2529;7332;2031;6435;451;1608;339;993;790;2601
310200;202006;1848;5454;1329;4440;191;723;614;2018;805;2741
310205;202006;1111;3066;851;2654;149;519;383;1172;532;1691
310210;202006;2598;6943;2106;6070;118;361;1531;4310;1649;4671
310220;202006;1244;3384;952;2816;88;280;629;1792;717;2072
310230;202006;2184;6030;1752;5220;217;725;1100;3064;1317;3789
310240;202006;955;2908;800;2633;46;178;576;1850;622;2028
310250;202006;1035;2751;830;2414;18;74;577;1663;595;1737
310260;202006;3066;7885;1948;5926;564;1996;538;1280;1102;3276
310270;202006;2692;6654;2122;5882;101;337;1725;4768;1826;5105
310280;202006;2406;5542;1853;4746;263;706;1060;2620;1323;3326
310285;202006;1856;5859;1540;5294;166;641;940;3200;1106;3841
310290;202006;1125;2960;913;2580;207;676;475;1200;682;1876
310300;202006;1491;4316;1262;3929;136;522;750;2182;886;2704
310310;202006;298;716;195;539;33;94;100;277;133;371
310320;202006;521;1324;353;1052;24;95;200;561;224;656
310330;202006;480;1133;284;785;40;129;117;294;157;423
310340;202006;7788;20883;6227;18241;869;2482;3107;9369;3976;11851
310350;202006;12507;30056;8464;23498;1621;4840;3744;10048;5365;14888
310360;202006;493;1121;375;969;12;36;253;658;265;694
310370;202006;1264;3907;1056;3504;203;734;352;1203;555;1937
310375;202006;861;2126;603;1743;91;274;328;940;419;1214
310380;202006;402;906;221;616;36;105;98;253;134;358
310390;202006;437;1299;341;1116;79;279;96;269;175;548
310400;202006;9980;24076;7075;19723;697;2260;4287;11653;4984;13913
310410;202006;892;2557;581;1974;89;330;220;698;309;1028
310420;202006;4263;10936;2868;8273;381;1246;1186;3169;1567;4415
310430;202006;1492;4051;965;3065;214;751;329;919;543;1670
310440;202006;656;1702;450;1326;42;151;239;663;281;814
310445;202006;1369;3877;992;3123;58;196;708;2190;766;2386
310450;202006;4687;11696;3508;9843;135;514;2668;7259;2803;7773
310460;202006;1622;4265;1167;3433;193;614;399;1105;592;1719
310470;202006;3749;8173;2898;7063;286;672;2049;5132;2335;5804
310480;202006;942;2429;731;2089;82;250;471;1312;553;1562
310490;202006;2804;7567;2186;6558;229;853;1238;3489;1467;4342
310500;202006;1344;3799;1007;3224;175;643;538;1661;713;2304
310510;202006;2077;5389;1334;4014;236;803;491;1475;727;2278
310520;202006;1187;3093;855;2492;142;402;444;1293;586;1695
310530;202006;711;1788;449;1308;65;233;156;369;221;602
310540;202006;2967;8438;2453;7551;551;1798;1120;3312;1671;5110
310550;202006;1254;3187;872;2530;76;278;500;1346;576;1624
310560;202006;14515;37678;10242;30191;1517;5128;4330;11536;5847;16664
310570;202006;1026;2664;809;2363;53;189;600;1722;653;1911
310590;202006;4035;10683;3208;9144;194;652;1872;5047;2066;5699
310600;202006;1301;3858;1061;3371;147;525;543;1609;690;2134
310610;202006;464;1213;289;925;52;183;139;423;191;606
310620;202006;171070;432378;123078;345799;17848;58169;59829;152535;77677;210704
310630;202006;4435;12082;3467;10198;311;997;2215;6307;2526;7304
310640;202006;1023;3046;834;2673;171;599;350;1069;521;1668
310650;202006;2349;6710;1689;5432;165;565;982;3071;1147;3636
310660;202006;1308;3480;1067;3156;32;106;903;2651;935;2757
310665;202006;1404;3608;1126;3200;30;111;913;2619;943;2730
310670;202006;56560;145202;47477;129636;4428;13911;32746;85158;37174;99069
310680;202006;754;1764;613;1568;17;62;522;1282;539;1344
310690;202006;1936;5055;1391;4127;110;373;785;2221;895;2594
310700;202006;485;1065;385;946;22;73;306;725;328;798
310710;202006;5439;15488;3975;13342;877;3497;693;2125;1570;5622
310720;202006;1009;2337;786;2054;34;113;598;1515;632;1628
310730;202006;9736;26158;8341;23959;316;1169;6287;17721;6603;18890
310740;202006;5955;16337;4050;12342;653;2206;1431;3991;2084;6197
310750;202006;1211;2870;881;2396;108;326;447;1146;555;1472
310760;202006;574;1478;411;1233;34;103;219;674;253;777
310770;202006;1091;2929;751;2410;76;299;386;1159;462;1458
310780;202006;4246;10295;3501;9298;69;206;2852;7618;2921;7824
310790;202006;1769;5584;1529;5068;352;1246;248;733;600;1979
310800;202006;2238;6600;1613;5326;356;1411;104;282;460;1693
310810;202006;1238;3042;1004;2653;42;118;717;1826;759;1944
310820;202006;1109;2853;676;2127;151;514;164;519;315;1033
310825;202006;2536;7658;2023;6801;70;410;1625;5268;1695;5678
310830;202006;1821;5122;1266;3999;244;885;531;1576;775;2461
310840;202006;1942;5270;1393;4345;346;1223;341;940;687;2163
310850;202006;1474;4025;1228;3682;45;229;956;2734;1001;2963
310855;202006;3032;8018;2343;6906;156;560;1683;4817;1839;5377
310860;202006;6892;19905;5492;17138;527;1742;3381;10636;3908;12378
310870;202006;952;2280;745;1986;57;146;552;1481;609;1627
310880;202006;977;2938;764;2498;105;355;442;1404;547;1759
310890;202006;2237;6363;1431;4727;263;939;224;626;487;1565
310900;202006;3824;10665;2587;7941;380;1228;1089;3132;1469;4360
310910;202006;2022;4977;1399;3976;115;399;287;761;402;1160
310920;202006;1897;4937;1432;4223;200;637;810;2346;1010;2983
310925;202006;943;2552;756;2251;69;242;514;1444;583;1686
310930;202006;5718;14957;4038;12209;771;2385;1850;5833;2621;8218
310940;202006;6696;15812;5378;13896;179;581;4127;10366;4306;10947
310945;202006;1315;3434;1031;2971;160;494;526;1485;686;1979
310950;202006;1889;5604;1228;4096;228;850;412;1209;640;2059
310960;202006;733;1957;407;1269;71;257;81;229;152;486
310970;202006;1113;3292;779;2569;201;729;143;433;344;1162
310980;202006;271;652;175;507;19;65;107;299;126;364
310990;202006;1318;3643;1020;3121;163;536;526;1578;689;2114
311000;202006;3978;11039;2883;9194;708;2438;1183;3649;1891;6087
311010;202006;873;2529;697;2168;199;700;297;889;496;1589
311020;202006;1070;2743;681;2036;39;115;374;1101;413;1216
311030;202006;1631;3995;1115;3153;195;631;525;1405;720;2036
311040;202006;276;867;227;758;69;241;70;220;139;461
311050;202006;2786;6808;2047;5735;357;1155;1034;2769;1391;3924
311060;202006;3144;8005;2295;6402;329;1057;933;2362;1262;3419
311070;202006;2288;5676;1643;4663;172;641;896;2356;1068;2997
311080;202006;1128;2538;910;2194;56;171;708;1622;764;1793
311090;202006;1998;6343;1552;5495;348;1359;469;1607;817;2966
311100;202006;2353;6668;1366;4619;251;976;246;739;497;1715
311110;202006;3601;7353;2006;5141;362;993;747;1965;1109;2958
311115;202006;1362;3055;1138;2751;61;156;928;2218;989;2374
311120;202006;6344;16634;4779;13825;707;2333;1825;4649;2532;6982
311130;202006;1854;4815;1402;4187;108;402;806;2336;914;2738
311140;202006;1391;3413;1074;2978;82;270;719;1953;801;2223
311150;202006;1470;4659;1140;4010;182;714;609;2081;791;2795
311160;202006;3696;10595;2573;8467;646;2359;771;2427;1417;4786
311170;202006;885;2226;695;1971;39;112;439;1323;478;1435
311180;202006;1355;3045;840;2280;158;472;375;1009;533;1481
311190;202006;866;2392;662;1994;115;395;267;701;382;1096
311200;202006;1984;5346;1414;4245;270;896;511;1381;781;2277
311205;202006;863;2592;698;2260;47;212;438;1337;485;1549
311210;202006;1002;2924;870;2748;111;314;629;2043;740;2357
311220;202006;724;2014;604;1802;48;163;383;1082;431;1245
311230;202006;7548;22775;5686;18954;1010;3556;2134;7243;3144;10799
311240;202006;1018;2648;780;2306;164;520;331;973;495;1493
311250;202006;1004;2918;773;2474;172;528;303;931;475;1459
311260;202006;2641;6509;1676;4825;269;878;716;1880;985;2758
311265;202006;1312;3401;963;2809;43;165;660;1876;703;2041
311270;202006;2939;8773;2552;8126;157;693;1853;5626;2010;6319
311280;202006;1075;2743;494;1565;98;361;48;131;146;492
311290;202006;1853;5616;1685;5265;148;484;1142;3553;1290;4037
311300;202006;4634;12967;3775;11523;197;838;2979;8887;3176;9725
311310;202006;567;1571;477;1414;47;144;285;815;332;959
311320;202006;3127;9507;2655;8482;387;1464;1251;3603;1638;5067
311330;202006;5028;13177;3981;11467;436;1377;2219;6505;2655;7882
311340;202006;10308;28827;8115;24917;2116;7058;2223;6486;4339;13544
311350;202006;2392;5890;1696;4609;148;442;920;2236;1068;2678
311360;202006;1116;2724;700;2089;197;668;228;648;425;1316
311370;202006;4631;11142;3381;9177;142;547;2258;5774;2400;6321
311380;202006;352;1063;255;858;64;206;108;389;172;595
311390;202006;1719;5203;1351;4687;591;2298;326;1023;917;3321
311400;202006;1480;4058;1073;3275;162;508;394;1074;556;1582
311410;202006;1646;4815;1314;4324;196;749;759;2453;955;3202
311420;202006;1436;4180;993;3259;185;689;245;659;430;1348
311430;202006;3958;10435;2619;7788;496;1537;834;2444;1330;3981
311440;202006;2701;7573;1984;6338;462;1738;515;1569;977;3307
311450;202006;1677;4992;1192;4079;316;1224;325;959;641;2183
311455;202006;978;2173;643;1673;167;437;253;698;420;1135
311460;202006;469;1459;314;1129;63;297;86;258;149;555
311470;202006;497;1549;334;1158;75;304;49;158;124;462
311480;202006;1039;2671;855;2391;46;134;661;1842;707;1976
311490;202006;250;738;185;606;32;128;87;250;119;378
311500;202006;444;1098;343;956;20;60;230;622;250;682
311510;202006;3173;8264;2135;6449;302;1035;888;2514;1190;3549
311520;202006;620;1732;545;1589;69;258;306;868;375;1126
311530;202006;8665;20173;5402;14911;1308;4014;1424;3721;2732;7735
311535;202006;781;2135;503;1564;82;265;174;498;256;763
311540;202006;480;1519;426;1416;78;292;284;910;362;1202
311545;202006;2004;5734;1708;5272;98;349;1320;4020;1418;4369
311547;202006;1451;3700;1253;3395;42;114;863;2362;905;2476
311550;202006;2708;7572;2143;6526;303;1047;930;2694;1233;3741
311560;202006;290;637;183;482;73;182;39;94;112;276
311570;202006;1658;3815;1169;3140;39;114;924;2523;963;2637
311580;202006;2144;3979;1406;3108;144;299;942;2082;1086;2381
311590;202006;487;1293;386;1139;62;210;214;620;276;830
311600;202006;1736;3884;1449;3514;60;145;1244;2976;1304;3121
311610;202006;2210;7168;1821;6339;197;756;1032;3536;1229;4292
311615;202006;3180;8901;2566;7873;116;430;2011;6059;2127;6489
311620;202006;434;1111;374;1045;8;30;321;889;329;919
311630;202006;1323;3631;1073;3115;103;334;699;1947;802;2281
311640;202006;621;1688;490;1461;63;220;225;612;288;832
311650;202006;1866;4798;1537;4287;156;471;1002;2716;1158;3187
311660;202006;2831;7966;2074;6498;366;1286;594;1575;960;2861
311670;202006;1514;3965;1106;3234;164;535;457;1344;621;1879
311680;202006;2140;6095;1587;5060;166;532;1059;3362;1225;3894
311690;202006;605;1286;471;1116;39;74;343;863;382;937
311700;202006;2204;5292;1712;4610;26;128;1442;3757;1468;3885
311710;202006;1496;4291;1072;3529;251;901;400;1297;651;2198
311720;202006;406;1195;324;1043;27;104;179;569;206;673
311730;202006;3754;9619;2394;7000;699;2202;473;1419;1172;3621
311740;202006;864;2264;724;2099;33;84;622;1861;655;1945
311750;202006;3813;11413;3024;9962;422;1516;1711;5428;2133;6944
311760;202006;634;1783;515;1568;70;264;261;684;331;948
311770;202006;2045;5876;1586;5041;243;818;745;2296;988;3114
311780;202006;1279;3665;860;2816;158;589;267;752;425;1341
311783;202006;2226;6029;1793;5271;41;190;1445;4071;1486;4261
311787;202006;740;2124;553;1684;81;266;244;637;325;903
311790;202006;1459;3927;946;2989;235;821;253;752;488;1573
311800;202006;4679;14068;3780;12102;800;2800;662;1828;1462;4628
311810;202006;928;2818;733;2472;55;209;476;1587;531;1796
311820;202006;773;1878;572;1567;69;222;356;916;425;1138
311830;202006;8290;23724;5597;17860;1552;5363;689;2156;2241;7519
311840;202006;3510;8926;2816;7931;252;761;2061;5768;2313;6529
311850;202006;361;951;292;821;13;41;194;522;207;563
311860;202006;57392;144595;43574;121153;6404;19222;24197;64292;30601;83514
311870;202006;1849;4894;1248;3801;203;705;500;1380;703;2085
311880;202006;6167;15968;5141;14545;275;697;3877;11190;4152;11887
311890;202006;1649;3961;1262;3401;93;296;898;2294;991;2590
311900;202006;726;1869;540;1615;62;222;349;1013;411;1235
311910;202006;4122;10561;3086;9204;547;1604;1555;4785;2102;6389
311920;202006;2081;5495;1651;4869;123;328;1038;3164;1161;3492
311930;202006;3741;8737;2638;7163;822;2422;788;1975;1610;4397
311940;202006;14997;39306;11036;31818;1565;4971;5055;13563;6620;18534
311950;202006;2284;6157;1707;5180;112;412;1037;3174;1149;3586
311960;202006;489;1198;393;1054;22;84;256;629;278;713
311970;202006;419;1350;306;1062;51;213;71;214;122;427
311980;202006;443;1198;226;761;22;77;77;254;99;331
311990;202006;539;1249;337;950;68;242;144;354;212;596
311995;202006;955;2620;480;1529;21;70;68;148;89;218
312000;202006;725;1839;557;1582;51;148;357;1022;408;1170
312010;202006;947;2620;729;2250;54;194;462;1349;516;1543
312015;202006;1342;3957;1179;3692;48;214;953;2916;1001;3130
312020;202006;1539;4710;1159;3887;249;890;292;918;541;1808
312030;202006;1980;4947;1722;4660;21;80;1604;4332;1625;4412
312040;202006;845;2477;583;1957;66;230;263;853;329;1083
312050;202006;1176;3655;937;3188;216;865;289;872;505;1737
312060;202006;846;2097;555;1735;137;421;267;860;404;1281
312070;202006;888;2562;634;2056;49;178;347;1061;396;1239
312080;202006;2623;6457;1946;5450;106;344;1269;3400;1375;3744
312083;202006;860;2237;631;1879;51;188;426;1220;477;1408
312087;202006;2451;6380;1974;5633;45;139;1552;4455;1597;4594
312090;202006;10033;26163;7718;22477;1142;3673;3885;10984;5027;14657
312100;202006;1539;4455;1193;3821;106;417;692;2116;798;2533
312110;202006;1013;3127;840;2773;191;729;298;879;489;1608
312120;202006;890;2419;589;1871;156;570;179;464;335;1034
312125;202006;1708;4399;1422;3983;113;371;1058;2847;1171;3218
312130;202006;995;2396;742;1977;59;173;334;813;393;986
312140;202006;670;1933;545;1681;109;375;246;700;355;1075
312150;202006;446;1246;376;1101;12;55;271;738;283;793
312160;202006;8497;23234;6395;19473;784;2790;3135;9067;3919;11857
312170;202006;887;2414;668;1982;36;136;447;1288;483;1424
312180;202006;1367;3641;1080;3097;155;460;546;1514;701;1974
312190;202006;644;1776;456;1409;81;278;155;443;236;721
312200;202006;4506;12255;3544;10703;1079;3254;1233;3841;2312;7095
312210;202006;1350;3019;969;2464;37;116;730;1809;767;1925
312220;202006;1619;5010;1395;4588;101;359;885;2913;986;3272
312230;202006;12726;32977;8314;24864;1989;6721;1652;4254;3641;10975
312235;202006;1904;4861;1502;4252;87;301;1080;2971;1167;3272
312240;202006;686;2243;520;1893;118;463;145;517;263;980
312245;202006;2633;6785;2146;6045;59;169;1754;4913;1813;5082
312247;202006;947;2304;677;1909;122;367;351;1001;473;1368
312250;202006;973;2581;622;1877;80;257;236;694;316;951
312260;202006;916;2464;727;2174;37;154;553;1591;590;1745
312270;202006;685;1863;519;1539;23;102;306;829;329;931
312280;202006;410;1210;320;1049;96;322;43;131;139;453
312290;202006;716;2107;570;1842;102;376;201;623;303;999
312300;202006;964;2924;642;2127;157;566;122;338;279;904
312310;202006;934;2820;737;2397;114;399;340;1057;454;1456
312320;202006;1955;5032;1410;4057;327;990;325;895;652;1885
312330;202006;841;2498;668;2133;61;217;412;1290;473;1507
312340;202006;261;680;184;550;44;156;78;204;122;360
312350;202006;247;498;173;418;15;46;119;273;134;319
312352;202006;1594;4769;1415;4446;85;274;869;2905;954;3179
312360;202006;2630;7620;1911;6213;380;1354;601;1865;981;3219
312370;202006;1824;4743;1479;4161;174;551;868;2330;1042;2881
312380;202006;2115;4791;1736;4315;6;25;1554;3818;1560;3843
312385;202006;1201;3295;936;2816;138;440;445;1336;583;1776
312390;202006;1854;5338;1374;4425;201;748;522;1532;723;2280
312400;202006;2786;7989;2282;7099;694;2324;733;2261;1427;4585
312410;202006;11413;31504;9235;27815;1593;5005;5074;15104;6667;20109
312420;202006;3625;9901;3010;8879;551;1802;1612;4625;2163;6427
312430;202006;7646;20468;6230;17894;394;1318;4393;12296;4787;13614
312440;202006;902;2899;707;2451;353;1294;93;292;446;1586
312450;202006;1171;3447;892;2955;250;882;297;1024;547;1906
312460;202006;431;1135;294;922;43;145;152;490;195;635
312470;202006;469;1117;294;811;34;101;109;267;143;368
312480;202006;1034;2562;720;2101;100;323;355;969;455;1292
312490;202006;2073;5058;1585;4335;201;573;858;2290;1059;2863
312500;202006;976;2403;793;2146;53;185;546;1452;599;1637
312510;202006;3645;9641;2583;7630;652;1862;687;2070;1339;3932
312520;202006;168;463;128;395;34;111;54;166;88;277
312530;202006;584;1439;500;1337;16;56;441;1183;457;1239
312540;202006;1534;4319;1025;3258;146;508;561;1721;707;2229
312550;202006;770;2036;586;1669;46;148;375;979;421;1127
312560;202006;1927;4968;1536;4350;69;220;1169;3304;1238;3524
312570;202006;2122;5200;1582;4521;448;1337;616;1834;1064;3171
312580;202006;617;1704;435;1317;56;198;197;547;253;745
312590;202006;1579;4605;1256;3957;86;396;784;2284;870;2680
312595;202006;1924;5675;1604;5127;262;786;951;3204;1213;3990
312600;202006;1145;2768;642;1804;113;402;121;383;234;785
312610;202006;6379;16143;4147;11965;624;1971;1446;3853;2070;5824
312620;202006;2523;6492;1859;5558;56;242;1469;4483;1525;4725
312630;202006;282;815;199;665;37;142;79;255;116;397
312640;202006;500;1367;344;1098;40;134;133;439;173;573
312650;202006;2022;5191;1374;3968;67;212;969;2674;1036;2886
312660;202006;1327;3224;995;2657;91;268;674;1735;765;2003
312670;202006;4860;12861;4027;11526;180;756;2927;8003;3107;8759
312675;202006;1233;3270;998;2922;60;196;799;2316;859;2512
312680;202006;1364;3857;1178;3569;52;227;970;2849;1022;3076
312690;202006;2871;6091;2229;5316;52;149;1852;4426;1904;4575
312695;202006;959;2592;794;2306;40;92;621;1807;661;1899
312700;202006;2087;5502;1504;4427;149;512;845;2351;994;2863
312705;202006;1388;3323;1177;3008;15;51;1069;2713;1084;2764
312707;202006;1360;3959;1047;3381;63;300;680;2072;743;2372
312710;202006;6460;14793;3755;10526;950;2863;1064;3080;2014;5943
312720;202006;1057;2819;793;2398;107;342;484;1421;591;1763
312730;202006;1615;3813;1138;3149;94;297;659;1745;753;2042
312733;202006;1367;3612;1038;2980;37;144;711;1940;748;2084
312735;202006;688;1860;583;1654;67;213;343;869;410;1082
312737;202006;783;1788;543;1431;70;200;345;868;415;1068
312738;202006;642;1640;458;1335;48;159;252;696;300;855
312740;202006;423;1029;243;719;50;169;63;145;113;314
312750;202006;1562;4507;1158;3746;208;712;494;1513;702;2225
312760;202006;1763;5183;1241;4100;219;784;454;1427;673;2211
312770;202006;43860;105049;27256;76497;5640;16966;8961;24650;14601;41616
312780;202006;2396;7165;2028;6571;242;839;1300;4201;1542;5040
312790;202006;242;580;129;400;7;38;41;106;48;144
312800;202006;4764;13490;3589;11226;882;2917;1230;3757;2112;6674
312810;202006;1531;4060;995;3188;253;909;348;1012;601;1921
312820;202006;1741;4646;1375;4006;39;156;1038;2946;1077;3102
312825;202006;1321;3103;1145;2873;19;67;977;2400;996;2467
312830;202006;2797;7847;1633;5423;340;1282;399;1252;739;2534
312840;202006;1283;3506;1006;3027;87;342;531;1491;618;1833
312850;202006;900;2198;633;1802;26;101;378;990;404;1091
312860;202006;1135;2934;762;2353;200;661;171;483;371;1144
312870;202006;6020;16242;3664;11679;627;2129;814;2422;1441;4551
312880;202006;1414;3530;1081;2961;39;138;646;1766;685;1904
312890;202006;2221;5550;1593;4499;106;293;816;2341;922;2634
312900;202006;1166;2962;942;2682;120;387;480;1485;600;1872
312910;202006;1630;2971;850;1943;163;311;320;758;483;1069
312920;202006;985;2628;675;2108;114;413;285;816;399;1229
312930;202006;2293;5650;1759;4852;400;1138;783;2179;1183;3317
312940;202006;938;2576;726;2262;76;286;365;1077;441;1363
312950;202006;3094;7668;2000;5874;517;1656;628;1784;1145;3440
312960;202006;1785;4732;1501;4290;67;176;1173;3438;1240;3614
312965;202006;1602;4480;1335;4053;110;349;929;2762;1039;3111
312970;202006;1321;3692;1024;3203;145;549;589;1716;734;2265
312980;202006;23195;63722;18623;55461;3584;11675;8939;25011;12523;36686
312990;202006;487;1231;308;914;56;186;147;412;203;598
313000;202006;478;1364;358;1139;28;120;209;618;237;738
313005;202006;2480;7130;2078;6444;163;490;1463;4505;1626;4995
313010;202006;4916;13562;3894;11889;691;2312;2273;6791;2964;9103
313020;202006;1015;3075;699;2338;127;462;136;387;263;849
313030;202006;1076;2518;722;1990;77;264;473;1234;550;1498
313040;202006;796;2435;658;2155;44;184;391;1217;435;1401
313050;202006;1734;4773;1204;3966;203;800;392;1142;595;1942
313055;202006;1881;5055;1662;4735;56;182;1437;4071;1493;4253
313060;202006;942;2253;674;1799;180;588;128;303;308;891
313065;202006;1623;4846;1416;4501;48;193;1092;3383;1140;3576
313070;202006;932;2463;698;2049;72;224;403;1158;475;1382
313080;202006;388;1076;282;871;49;175;102;264;151;439
313090;202006;5019;13351;4255;12112;335;1094;2847;8025;3182;9119
313100;202006;1321;3422;1015;2982;28;112;776;2220;804;2332
313110;202006;1460;3836;1057;3128;95;353;592;1633;687;1986
313115;202006;2593;7478;2089;6488;272;940;1093;3182;1365;4122
313120;202006;3739;8816;2714;7465;224;714;1759;4793;1983;5507
313130;202006;30087;77967;22811;64514;2486;7967;12883;34380;15369;42347
313140;202006;605;1315;357;954;29;70;239;647;268;717
313150;202006;1343;3763;991;3115;303;1033;218;618;521;1651
313160;202006;1134;2853;887;2473;27;100;669;1813;696;1913
313170;202006;10969;31126;7774;25146;1326;4703;3086;9399;4412;14102
313180;202006;2061;5442;1452;4238;182;560;829;2366;1011;2926
313190;202006;4137;11828;3014;9560;563;1943;1033;3050;1596;4993
313200;202006;1065;2957;925;2714;15;55;783;2230;798;2285
313210;202006;3727;10884;3014;9599;353;1276;1800;5509;2153;6785
313220;202006;1725;4542;1129;3352;164;554;456;1205;620;1759
313230;202006;2944;8248;2423;7610;46;172;2025;6507;2071;6679
313240;202006;9579;23376;5900;17433;995;3383;2486;6823;3481;10206
313250;202006;6179;18027;4593;14683;837;2717;1988;6215;2825;8932
313260;202006;606;1604;429;1283;60;233;213;589;273;822
313270;202006;5682;14226;4518;12572;561;1551;3036;8611;3597;10162
313280;202006;454;1275;294;942;34;122;128;387;162;509
313290;202006;931;2880;682;2436;215;832;216;760;431;1592
313300;202006;1553;4143;1100;3319;279;916;258;680;537;1596
313310;202006;1106;3241;841;2684;138;517;228;610;366;1127
313320;202006;2095;5569;1502;4596;261;912;620;1906;881;2818
313330;202006;4034;10583;3036;9068;178;683;1963;5820;2141;6503
313340;202006;1387;3107;974;2537;86;237;679;1756;765;1993
313350;202006;2614;7341;1677;5166;230;762;598;1629;828;2391
313360;202006;1442;3498;990;2782;156;541;519;1336;675;1877
313370;202006;1403;3943;1165;3476;134;481;664;1828;798;2309
313375;202006;1718;4489;1047;3223;192;643;224;646;416;1289
313380;202006;6188;15472;4394;12169;783;2430;2047;5029;2830;7459
313390;202006;800;2566;691;2382;49;233;461;1520;510;1753
313400;202006;3684;9101;2831;7920;159;494;2172;5982;2331;6476
313410;202006;1300;3385;997;2844;55;186;737;2050;792;2236
313420;202006;15191;33670;7620;20901;1708;5234;1113;2994;2821;8228
313430;202006;937;2749;711;2282;125;492;297;835;422;1327
313440;202006;6185;13447;4032;10597;388;1055;2463;6488;2851;7543
313450;202006;714;1921;493;1470;78;251;176;451;254;702
313460;202006;2069;5922;1636;5240;327;1191;771;2331;1098;3522
313470;202006;2846;7286;2234;6380;249;702;1449;4197;1698;4899
313480;202006;1004;2870;556;1859;71;264;166;502;237;766
313490;202006;2499;6034;1164;3625;302;1044;187;579;489;1623
313500;202006;506;1414;380;1138;45;136;155;428;200;564
313505;202006;9893;26180;8408;24159;337;1186;6765;19415;7102;20601
313507;202006;1457;3785;1180;3356;32;131;944;2617;976;2748
313510;202006;13552;37328;10578;31563;1265;3978;4984;14537;6249;18515
313520;202006;14072;39741;11148;34669;594;2239;8264;25103;8858;27342
313530;202006;518;1530;385;1242;47;161;151;442;198;603
313535;202006;2350;6511;1957;5742;265;703;1193;3511;1458;4214
313540;202006;757;2241;601;1862;109;341;248;721;357;1062
313545;202006;1142;3749;951;3351;150;555;511;1740;661;2295
313550;202006;1717;5241;1406;4508;315;1131;708;2159;1023;3290
313560;202006;2643;5232;1964;4405;62;117;1649;3726;1711;3843
313570;202006;967;2826;792;2505;193;636;323;983;516;1619
313580;202006;5552;14577;4245;12376;485;1496;2435;7199;2920;8695
313590;202006;1009;2850;809;2567;200;669;369;1245;569;1914
313600;202006;3970;10613;3295;9559;96;390;2757;7850;2853;8240
313610;202006;1038;2615;835;2271;89;272;532;1370;621;1642
313620;202006;5494;14506;4272;12264;539;1717;2433;6741;2972;8458
313630;202006;8550;20544;5974;16653;591;1908;3594;9812;4185;11720
313640;202006;1081;2456;685;1946;145;446;306;857;451;1303
313650;202006;1711;5104;1350;4485;94;372;888;2980;982;3352
313652;202006;739;2327;663;2169;108;374;414;1323;522;1697
313655;202006;1125;2860;886;2552;46;139;689;1979;735;2118
313657;202006;1170;3124;922;2734;39;151;675;1889;714;2040
313660;202006;878;2450;707;2139;75;266;440;1257;515;1523
313665;202006;4700;12554;3625;10622;413;1357;2229;6226;2642;7583
313670;202006;48443;118230;30457;87639;4543;14330;13300;36196;17843;50526
313680;202006;1008;2699;825;2403;60;205;551;1555;611;1760
313690;202006;799;2468;617;2129;152;583;163;541;315;1124
313695;202006;1788;4898;1358;4177;84;272;910;2806;994;3078
313700;202006;2891;9212;2487;8671;250;890;1854;6500;2104;7390
313710;202006;1367;3165;981;2650;74;206;651;1775;725;1981
313720;202006;5359;14757;3685;11254;581;1975;1499;4170;2080;6145
313730;202006;1303;2953;982;2516;78;175;645;1657;723;1832
313740;202006;1622;5783;1330;5021;313;1362;236;759;549;2121
313750;202006;1977;5273;1506;4434;268;880;714;1968;982;2848
313753;202006;2174;5165;1449;3994;145;437;802;2139;947;2576
313760;202006;5102;14049;3806;11543;789;2633;1649;4651;2438;7284
313770;202006;3909;10993;3078;9648;198;659;2272;7209;2470;7868
313780;202006;3968;10582;2849;8694;233;841;827;2584;1060;3425
313790;202006;480;1496;428;1401;49;181;241;766;290;947
313800;202006;1354;3111;978;2571;123;377;528;1318;651;1695
313810;202006;1569;4028;1245;3566;51;198;956;2666;1007;2864
313820;202006;17525;44295;10915;30314;1729;5076;3012;8066;4741;13142
313830;202006;380;1079;264;813;47;160;89;252;136;412
313835;202006;905;2668;744;2370;59;241;418;1246;477;1487
313840;202006;6885;17915;5077;14887;1257;3905;1060;3188;2317;7093
313850;202006;976;2380;773;2105;139;462;370;890;509;1352
313860;202006;2511;6768;1866;5547;296;1008;775;2107;1071;3115
313862;202006;1355;2853;647;1810;41;119;312;872;353;991
313865;202006;2513;6710;2068;5979;81;249;1562;4428;1643;4677
313867;202006;1292;3866;1068;3446;146;462;668;2213;814;2675
313868;202006;1685;5192;1379;4569;43;218;1056;3385;1099;3603
313870;202006;760;2054;548;1663;93;294;208;575;301;869
313880;202006;1665;4364;1219;3605;164;555;577;1508;741;2063
313890;202006;2014;4394;1507;3731;46;153;1118;2696;1164;2849
313900;202006;4075;11808;2902;9393;746;2660;698;2056;1444;4716
313910;202006;643;1890;486;1592;100;352;105;333;205;685
313920;202006;2899;8950;2417;7934;497;1609;1193;3957;1690;5566
313925;202006;1576;3979;1255;3406;190;506;810;2182;1000;2688
313930;202006;4615;13974;3726;12358;284;1072;2411;7889;2695;8961
313940;202006;8638;25026;6199;20757;776;3190;1486;5504;2262;8694
313950;202006;5120;11381;3709;9638;410;1328;2205;5699;2615;7027
313960;202006;5732;13873;3819;10639;707;2240;1309;3326;2016;5566
313970;202006;1482;4017;1236;3600;20;64;793;2259;813;2323
313980;202006;1330;3436;865;2706;133;482;341;1003;474;1485
313990;202006;1881;6004;1337;4741;340;1389;412;1274;752;2663
314000;202006;9399;24198;7867;21580;568;2004;5242;14194;5810;16198
314010;202006;1458;3513;1134;3069;47;159;856;2245;903;2404
314015;202006;1897;5264;1434;4470;186;684;771;2347;957;3031
314020;202006;452;1228;296;962;64;252;59;207;123;459
314030;202006;797;2294;629;1968;59;186;332;1023;391;1209
314040;202006;615;1656;489;1422;73;244;263;734;336;978
314050;202006;1768;4714;1272;3792;149;531;670;1856;819;2387
314053;202006;1784;5320;1429;4609;277;888;747;2499;1024;3387
314055;202006;2255;6079;1897;5516;43;163;1553;4509;1596;4672
314060;202006;1284;3379;961;2867;33;127;679;1997;712;2124
314070;202006;4573;12582;3548;10712;725;2178;1550;4630;2275;6808
314080;202006;2058;5353;1392;4205;182;653;588;1593;770;2246
314085;202006;2080;5913;1689;5300;228;755;959;3066;1187;3821
314090;202006;4549;12256;3883;11270;242;907;2454;7239;2696;8146
314100;202006;3113;7401;2397;6410;42;121;1801;4830;1843;4951
314110;202006;4657;13165;3768;11432;425;1505;2153;6107;2578;7612
314120;202006;773;1807;317;950;66;241;72;197;138;438
314130;202006;606;1562;373;1147;23;97;231;700;254;797
314140;202006;4453;12701;3494;10839;472;1553;1745;5304;2217;6857
314150;202006;1480;3688;1081;3000;82;235;722;1948;804;2183
314160;202006;2150;5676;1561;4595;213;692;669;1972;882;2664
314170;202006;924;2601;741;2237;43;162;487;1382;530;1544
314180;202006;5372;14940;4327;13247;362;1194;2607;7996;2969;9190
314190;202006;615;1525;432;1252;82;274;199;509;281;783
314200;202006;2927;8180;2391;7263;146;508;1699;5017;1845;5525
314210;202006;1982;5212;1565;4444;176;513;785;2182;961;2695
314220;202006;1353;3685;967;3008;208;741;358;1024;566;1765
314225;202006;1072;3015;881;2710;76;198;634;2009;710;2207
314230;202006;758;1962;618;1789;75;247;398;1181;473;1428
314240;202006;1009;2744;773;2375;190;604;295;925;485;1529
314250;202006;502;1408;313;1019;45;140;116;346;161;486
314260;202006;932;2539;724;2255;160;539;401;1213;561;1752
314270;202006;3283;9289;2692;8364;78;327;1972;6077;2050;6404
314280;202006;3385;7849;2233;6083;264;800;1208;3129;1472;3929
314290;202006;4413;11448;3593;9978;292;839;2449;6666;2741;7505
314300;202006;1899;5444;1229;3993;251;903;400;1226;651;2129
314310;202006;4078;10555;2688;8161;858;2852;431;1156;1289;4008
314315;202006;895;3099;763;2827;50;238;537;1920;587;2158
314320;202006;2921;7961;1893;5999;341;1190;707;2160;1048;3350
314330;202006;49192;137709;36918;115662;9829;32206;7566;25008;17395;57214
314340;202006;2403;5949;1455;4236;278;935;373;929;651;1864
314345;202006;1387;4118;1120;3630;154;507;648;2083;802;2590
314350;202006;809;2209;518;1679;111;381;121;341;232;722
314360;202006;559;1610;336;1122;51;192;108;322;159;514
314370;202006;730;1931;582;1706;43;148;401;1126;444;1274
314380;202006;1124;3054;747;2371;163;590;163;490;326;1080
314390;202006;13377;33822;8677;25226;1612;5097;2843;7416;4455;12513
314400;202006;3939;11743;2954;9825;759;2603;1091;3776;1850;6379
314410;202006;2670;7430;1832;5868;246;908;612;2072;858;2980
314420;202006;824;2035;590;1650;38;145;395;1036;433;1181
314430;202006;7764;18985;5380;14958;807;2368;2491;6600;3298;8968
314435;202006;1772;4698;1397;4066;57;211;1027;2912;1084;3123
314437;202006;901;2312;655;1896;71;224;318;911;389;1135
314440;202006;611;1744;429;1367;120;419;87;231;207;650
314450;202006;1383;3693;1154;3337;115;388;673;1860;788;2248
314460;202006;3224;9798;2325;7884;594;2129;545;1779;1139;3908
314465;202006;2181;6314;1853;5684;51;197;1419;4201;1470;4398
314467;202006;909;2375;764;2141;23;64;612;1673;635;1737
314470;202006;2163;6218;1735;5341;302;1022;799;2297;1101;3319
314480;202006;6352;18129;4569;14348;766;2677;1660;4621;2426;7298
314490;202006;1064;2840;774;2233;69;203;474;1323;543;1526
314500;202006;1706;4091;1211;3394;305;843;421;1226;726;2069
314505;202006;2013;4934;1632;4390;101;288;1184;3099;1285;3387
314510;202006;1876;4914;1318;4051;256;892;597;1789;853;2681
314520;202006;4961;15183;3625;12345;741;2758;451;1365;1192;4123
314530;202006;5357;17249;4791;16150;316;1336;3517;11576;3833;12912
314535;202006;2496;6527;2005;5812;86;314;1529;4387;1615;4701
314537;202006;1084;3078;830;2665;46;177;594;1872;640;2049
314540;202006;381;954;251;727;17;60;142;394;159;454
314545;202006;1859;4461;1661;4232;31;90;1440;3764;1471;3854
314550;202006;631;1564;470;1334;36;134;259;669;295;803
314560;202006;4173;12587;3078;10104;481;1758;1069;3165;1550;4923
314570;202006;292;808;214;661;27;99;94;289;121;388
314580;202006;446;1335;349;1137;86;288;120;385;206;673
314585;202006;646;2021;485;1659;70;294;208;688;278;982
314587;202006;1990;5408;1493;4607;199;575;851;2710;1050;3285
314590;202006;3907;10665;2790;8535;384;1328;1206;3411;1590;4739
314600;202006;1888;5145;1096;3613;214;765;132;402;346;1167
314610;202006;8655;21613;5995;17634;1002;3503;2507;7542;3509;11045
314620;202006;2206;5178;1736;4580;39;133;1444;3788;1483;3921
314625;202006;1511;4161;1289;3853;31;186;1109;3236;1140;3422
314630;202006;5288;13489;4307;12181;104;435;3602;10182;3706;10617
314640;202006;664;1589;478;1299;66;204;264;672;330;876
314650;202006;822;1891;496;1383;45;142;270;664;315;806
314655;202006;1586;4358;1116;3501;171;531;544;1691;715;2222
314660;202006;324;734;207;522;14;30;134;325;148;355
314670;202006;1604;3686;1102;2967;17;53;727;1934;744;1987
314675;202006;1679;4469;1427;4044;74;249;1112;3064;1186;3313
314690;202006;2043;5697;1558;4965;414;1464;537;1672;951;3136
314700;202006;9837;27543;6370;20778;1226;4411;1914;6077;3140;10488
314710;202006;7612;21327;5454;16755;914;3103;1885;5039;2799;8142
314720;202006;2066;6071;1406;4700;295;1113;368;1146;663;2259
314730;202006;2228;5836;1604;4689;255;830;663;1780;918;2610
314740;202006;2883;8159;2224;6960;290;974;1119;3421;1409;4395
314750;202006;292;790;223;650;27;92;134;351;161;443
314760;202006;1908;5704;1226;4118;200;776;314;828;514;1604
314770;202006;1095;3196;582;1875;48;171;178;528;226;699
314780;202006;349;820;233;643;40;135;128;310;168;445
314790;202006;10268;27518;6972;21389;1475;5236;2379;6747;3854;11983
314795;202006;1481;3921;1242;3498;29;120;985;2670;1014;2790
314800;202006;10543;26722;6247;18723;1153;3833;1506;3978;2659;7811
314810;202006;8690;22926;6279;18669;1540;4960;2156;6097;3696;11057
314820;202006;1202;2904;938;2509;49;189;606;1544;655;1733
314830;202006;1470;4461;1220;3979;216;797;592;1871;808;2668
314840;202006;836;2643;659;2356;47;235;467;1600;514;1835
314850;202006;2012;4734;1634;4251;40;134;1421;3713;1461;3847
314860;202006;3141;9266;2588;8249;194;789;1775;5506;1969;6295
314870;202006;6269;15889;4725;13822;279;904;3488;10284;3767;11188
314875;202006;1744;5196;1514;4892;114;297;1216;4020;1330;4317
314880;202006;818;2007;626;1709;31;85;378;1042;409;1127
314890;202006;417;1239;315;1020;50;183;132;404;182;587
314900;202006;716;1929;555;1643;94;323;235;637;329;960
314910;202006;1638;4629;1210;3932;208;789;589;1794;797;2583
314915;202006;2166;6430;1812;5808;116;383;1194;3770;1310;4153
314920;202006;463;1199;295;940;7;22;197;643;204;665
314930;202006;5329;15007;3960;12425;677;2349;1566;4566;2243;6915
314940;202006;393;992;323;871;31;81;210;532;241;613
314950;202006;499;1268;325;974;26;104;172;459;198;563
314960;202006;837;1994;642;1673;27;84;456;1118;483;1202
314970;202006;934;2731;708;2256;136;474;307;895;443;1369
314980;202006;1477;3780;1084;3199;192;654;513;1482;705;2136
314990;202006;2404;6904;1667;5233;341;1137;347;976;688;2113
314995;202006;1569;4394;1238;3793;38;168;823;2386;861;2554
315000;202006;1108;2801;784;2305;62;199;517;1498;579;1697
315010;202006;374;1034;282;874;46;170;133;389;179;559
315015;202006;2231;6291;1931;5783;188;628;1274;3752;1462;4380
315020;202006;792;2312;554;1766;71;282;238;691;309;973
315030;202006;580;1550;391;1197;89;277;82;226;171;503
315040;202006;810;2278;654;2004;85;281;400;1215;485;1496
315050;202006;1206;3121;866;2576;49;178;456;1327;505;1505
315053;202006;1087;2837;827;2380;51;161;484;1331;535;1492
315057;202006;1730;5216;1403;4639;135;451;940;3129;1075;3580
315060;202006;535;1619;390;1338;74;265;101;329;175;594
315070;202006;520;1373;354;1082;82;277;92;265;174;542
315080;202006;2894;8158;2211;6834;236;812;1389;4075;1625;4887
315090;202006;782;2354;569;1940;82;297;225;746;307;1043
315100;202006;1321;3864;855;2796;140;544;381;1097;521;1641
315110;202006;1809;4396;1304;3612;131;347;651;1868;782;2215
315120;202006;11919;27901;8747;23081;1160;2859;4726;12905;5886;15764
315130;202006;1549;4238;1276;3757;136;458;530;1459;666;1917
315140;202006;2920;8093;2241;6857;395;1311;1119;3250;1514;4561
315150;202006;4292;10297;2986;8187;462;1483;1398;3720;1860;5203
315160;202006;1711;4203;1120;3250;243;750;500;1442;743;2192
315170;202006;1354;4308;924;3261;218;849;216;727;434;1576
315180;202006;16637;40261;8768;25693;1180;3942;2768;7125;3948;11067
315190;202006;2189;4781;1692;4127;196;471;1241;3061;1437;3532
315200;202006;3847;10957;2754;8978;790;2766;724;2265;1514;5031
315210;202006;8404;21873;5692;16087;663;2042;2828;7228;3491;9270
315213;202006;1098;2881;942;2668;21;73;780;2174;801;2247
315217;202006;2771;8039;2093;6900;88;434;1449;4556;1537;4990
315220;202006;8429;22904;6590;19620;1153;3655;2779;8270;3932;11925
315230;202006;3057;7158;2550;6496;193;279;1947;5302;2140;5581
315240;202006;2425;7136;2038;6450;464;1531;981;3101;1445;4632
315250;202006;12533;33837;8891;26875;1421;4667;3774;10879;5195;15546
315260;202006;911;2518;483;1592;76;250;39;110;115;360
315270;202006;824;2358;582;1893;82;283;206;575;288;858
315280;202006;2889;7214;1697;5048;422;1369;263;756;685;2125
315290;202006;1157;2832;673;2055;191;653;192;555;383;1208
315300;202006;620;1507;424;1222;84;271;218;626;302;897
315310;202006;1248;3510;920;2878;77;273;514;1521;591;1794
315320;202006;649;1898;452;1494;69;272;192;579;261;851
315330;202006;739;2540;401;1609;64;298;126;455;190;753
315340;202006;2947;7142;2109;5936;263;773;1131;3162;1394;3935
315350;202006;1533;4182;1181;3631;163;586;661;2008;824;2594
315360;202006;1663;4920;1236;4004;192;671;496;1509;688;2180
315370;202006;467;1355;366;1148;69;211;146;449;215;660
315380;202006;191;564;141;455;39;136;30;68;69;204
315390;202006;1038;2951;821;2543;145;523;379;1077;524;1600
315400;202006;3936;10803;3080;9245;433;1365;1664;4801;2097;6166
315410;202006;2318;5344;1728;4490;465;1300;260;709;725;2009
315415;202006;1366;3727;1092;3312;226;801;426;1305;652;2106
315420;202006;1378;3896;932;3023;180;611;181;567;361;1178
315430;202006;3556;8659;2491;7044;443;1473;1082;2849;1525;4322
315440;202006;1009;2675;806;2343;60;201;486;1340;546;1541
315445;202006;1933;4672;1373;3876;86;290;998;2769;1084;3059
315450;202006;2188;6148;1779;5478;220;661;1102;3404;1322;4065
315460;202006;35504;99165;29118;87621;4536;15409;15654;44382;20190;59791
315470;202006;618;1748;436;1300;31;101;250;714;281;815
315480;202006;1164;3350;813;2588;156;526;262;805;418;1331
315490;202006;2907;7315;2000;5848;286;864;732;2065;1018;2929
315500;202006;522;1393;317;942;42;145;159;414;201;559
315510;202006;1220;3193;1030;2922;24;104;895;2496;919;2600
315520;202006;974;2710;782;2377;53;200;588;1735;641;1935
315530;202006;576;1620;461;1428;132;470;226;644;358;1114
315540;202006;1392;3765;969;2963;99;367;440;1304;539;1671
315550;202006;1910;4972;1233;3710;256;885;303;895;559;1780
315560;202006;6216;18892;5228;17065;298;939;3487;11621;3785;12560
315570;202006;2004;5435;1593;4748;88;323;925;2680;1013;3003
315580;202006;2694;6402;2004;5325;278;884;766;1907;1044;2791
315590;202006;885;2256;679;1924;72;254;378;989;450;1243
315600;202006;2422;7654;1732;6273;257;894;901;3416;1158;4310
315610;202006;934;2394;691;1935;105;369;306;739;411;1108
315620;202006;492;1326;366;1135;45;168;213;665;258;833
315630;202006;1021;2724;756;2238;132;408;337;915;469;1323
315640;202006;349;869;259;757;28;107;156;432;184;539
315645;202006;974;2514;658;1990;157;512;166;484;323;996
315650;202006;1718;4131;1370;3645;35;110;1117;2884;1152;2994
315660;202006;2426;5971;1814;4911;105;315;1285;3349;1390;3664
315670;202006;13298;36473;10049;30533;1995;6343;4494;13147;6489;19490
315680;202006;3069;8901;2238;7310;304;1127;1152;3573;1456;4700
315690;202006;3245;7900;1887;5534;407;1205;566;1795;973;3000
315700;202006;7928;21969;5947;17949;948;3032;2659;7695;3607;10727
315710;202006;1820;4525;1279;3701;41;181;908;2521;949;2702
315720;202006;4261;11883;3584;10670;175;709;2552;7276;2727;7985
315725;202006;2120;5566;1608;4685;175;491;1014;3080;1189;3571
315727;202006;553;1442;416;1218;56;197;165;464;221;661
315730;202006;556;1745;488;1598;81;302;187;574;268;876
315733;202006;1139;2888;805;2314;117;408;312;853;429;1261
315737;202006;1140;3236;892;2740;26;109;643;1896;669;2005
315740;202006;824;2286;654;1944;71;247;421;1167;492;1414
315750;202006;1257;3316;980;2860;91;282;594;1769;685;2051
315760;202006;1108;2654;977;2484;38;108;827;2064;865;2172
315765;202006;1878;4999;1539;4558;26;114;1354;3986;1380;4100
315770;202006;1012;2793;772;2455;317;1112;159;417;476;1529
315780;202006;28294;77241;23622;69046;1340;4861;16412;45990;17752;50851
315790;202006;3520;10916;2981;9876;392;1362;1767;5945;2159;7307
315800;202006;1220;4286;882;3407;128;566;280;960;408;1526
315810;202006;1297;3218;1051;2791;57;194;811;2055;868;2249
315820;202006;2531;6890;2048;6182;176;626;1421;4253;1597;4879
315830;202006;1185;3516;805;2694;86;314;283;876;369;1190
315840;202006;821;1989;567;1537;45;141;279;691;324;832
315850;202006;1155;3418;903;2957;180;636;443;1363;623;1999
315860;202006;460;1322;317;1057;68;238;94;276;162;514
315870;202006;452;1182;360;1039;19;65;259;710;278;775
315880;202006;1064;2771;698;2124;95;363;166;469;261;832
315890;202006;1667;4771;1335;4308;330;1168;660;2097;990;3265
315895;202006;6105;16425;4548;13360;433;1421;2382;6504;2815;7925
315900;202006;807;2064;693;1898;58;177;523;1388;581;1565
315910;202006;500;1412;420;1283;57;191;292;871;349;1062
315920;202006;1446;3653;786;2393;123;447;245;685;368;1132
315930;202006;1079;2432;716;1915;133;344;305;833;438;1177
315935;202006;782;2358;611;2027;120;416;212;704;332;1120
315940;202006;581;1621;463;1436;50;166;246;730;296;896
315950;202006;1158;3195;951;2856;83;243;730;2190;813;2433
315960;202006;5016;14129;3207;10436;947;3478;267;548;1214;4026
315970;202006;612;1626;482;1455;62;208;316;955;378;1163
315980;202006;4269;9228;2313;6027;415;1150;852;2032;1267;3182
315990;202006;3594;9128;2788;7755;264;795;1595;4294;1859;5089
316000;202006;569;1455;423;1242;52;189;202;554;254;743
316010;202006;837;2217;615;1844;42;145;382;1059;424;1204
316020;202006;905;2782;724;2418;88;343;420;1312;508;1655
316030;202006;2708;7634;2037;6427;236;769;1288;4111;1524;4880
316040;202006;2380;6702;1735;5495;309;1104;434;1187;743;2291
316045;202006;2057;5336;1886;5129;73;150;1629;4555;1702;4705
316050;202006;361;1011;278;869;32;113;159;463;191;576
316060;202006;662;1656;480;1386;17;74;336;931;353;1005
316070;202006;5199;14502;4215;12626;730;2261;1982;5777;2712;8038
316080;202006;721;2268;561;1940;142;509;80;255;222;764
316090;202006;398;1147;291;929;41;151;140;417;181;568
316095;202006;1267;3941;1004;3275;270;921;325;1031;595;1952
316100;202006;2386;6990;1712;5559;309;1096;627;1859;936;2955
316105;202006;806;2160;656;1915;38;133;451;1351;489;1484
316110;202006;13348;38903;11108;35101;800;2951;7522;23460;8322;26411
316120;202006;1185;3377;752;2349;115;378;227;581;342;959
316130;202006;1264;2868;803;2105;61;190;463;1181;524;1371
316140;202006;1187;3161;760;2371;95;331;375;1134;470;1465
316150;202006;1851;4045;1499;3575;172;529;626;1433;798;1962
316160;202006;970;2662;797;2361;40;143;546;1566;586;1709
316165;202006;837;2098;635;1771;93;306;338;872;431;1178
316170;202006;1146;2811;858;2380;52;190;597;1571;649;1761
316180;202006;1346;3809;900;2876;143;545;163;482;306;1027
316190;202006;2592;7349;1507;4787;222;744;556;1567;778;2311
316200;202006;3182;9125;2352;7659;569;1971;567;1782;1136;3753
316210;202006;4417;12960;3169;10122;1152;3974;188;498;1340;4472
316220;202006;576;1750;381;1301;92;358;41;160;133;518
316225;202006;1539;3504;1145;2869;55;203;855;1989;910;2192
316230;202006;399;1093;302;924;36;116;171;529;207;645
316240;202006;5551;16022;4857;14815;369;1208;3663;11004;4032;12212
316245;202006;2931;9552;2634;9039;121;702;2039;6672;2160;7374
316250;202006;9895;23824;7154;19470;1515;4556;2574;6902;4089;11458
316255;202006;2934;8120;2552;7501;117;362;1915;5697;2032;6059
316257;202006;1358;3310;970;2625;127;359;544;1399;671;1758
316260;202006;2079;5286;1584;4449;195;533;824;2381;1019;2914
316265;202006;1123;3013;867;2581;20;71;635;1838;655;1909
316270;202006;3618;11217;3090;10041;495;1730;1476;4572;1971;6302
316280;202006;2830;8106;2403;7296;324;1068;1345;3967;1669;5035
316290;202006;3374;9265;2682;7996;295;1034;1147;3305;1442;4339
316292;202006;4867;12992;3885;11337;485;1546;2516;7059;3001;8605
316294;202006;791;2360;580;1986;107;417;153;494;260;911
316295;202006;3040;8492;2466;7498;140;527;1733;5014;1873;5541
316300;202006;979;2795;797;2510;46;161;579;1806;625;1967
316310;202006;773;2074;506;1599;106;394;86;230;192;624
316320;202006;648;1816;500;1579;57;216;233;712;290;928
316330;202006;1080;2810;814;2336;54;190;608;1681;662;1871
316340;202006;997;2708;743;2244;71;285;426;1210;497;1495
316350;202006;1269;3576;1049;3223;90;303;735;2225;825;2528
316360;202006;611;1626;495;1430;49;149;360;1018;409;1167
316370;202006;4817;12930;3519;10549;676;2331;1278;3382;1954;5713
316380;202006;1703;4082;1330;3552;50;110;929;2492;979;2602
316390;202006;798;2125;559;1701;228;793;95;257;323;1050
316400;202006;1156;3251;741;2416;113;406;239;713;352;1119
316410;202006;1095;3071;912;2801;56;184;721;2169;777;2353
316420;202006;1907;5232;1653;4896;47;181;1364;3956;1411;4137
316430;202006;833;2205;526;1655;92;321;165;482;257;803
316440;202006;823;2501;646;2178;111;430;161;491;272;921
316443;202006;533;1470;389;1197;100;362;83;231;183;593
316447;202006;1939;5206;1695;4798;28;108;1457;4046;1485;4154
316450;202006;2099;6408;1595;5357;210;772;954;3114;1164;3886
316460;202006;1155;2933;929;2564;130;401;583;1511;713;1912
316470;202006;6699;19189;4744;15028;777;2804;1827;5291;2604;8095
316480;202006;200;548;166;499;45;132;76;224;121;356
316490;202006;319;850;226;684;38;121;81;201;119;322
316500;202006;1148;3597;760;2663;160;618;170;561;330;1179
316510;202006;730;2383;582;2095;110;415;279;1008;389;1423
316520;202006;1191;2943;914;2493;116;402;472;1169;588;1571
316530;202006;1083;2824;783;2287;84;337;403;1029;487;1366
316540;202006;817;2124;632;1838;108;359;304;804;412;1163
316550;202006;1351;3935;1153;3550;53;189;896;2738;949;2927
316553;202006;4105;12224;2861;9138;453;1609;1024;2900;1477;4509
316555;202006;2442;7859;2211;7538;109;400;1822;6266;1931;6666
316556;202006;532;1301;383;1044;29;78;213;527;242;605
316557;202006;1009;3161;865;2918;292;1061;272;900;564;1961
316560;202006;329;910;225;753;49;209;71;202;120;411
316570;202006;1199;3488;981;3084;237;756;350;1125;587;1881
316580;202006;383;810;220;542;35;104;110;255;145;359
316590;202006;1305;3389;916;2625;183;465;458;1285;641;1750
316600;202006;922;2852;784;2571;124;439;422;1355;546;1794
316610;202006;596;1863;484;1682;56;243;287;972;343;1215
316620;202006;1981;5351;1733;5000;89;282;1355;3906;1444;4188
316630;202006;1524;4594;1240;4053;323;1070;498;1755;821;2825
316640;202006;140;367;109;320;16;53;51;124;67;177
316650;202006;1013;3237;810;2916;74;298;502;1829;576;2127
316660;202006;179;453;77;240;7;24;12;35;19;59
316670;202006;1778;4523;1300;3738;306;960;480;1346;786;2306
316680;202006;2248;5719;1649;4583;93;289;1256;3390;1349;3679
316690;202006;1358;3864;1014;3237;176;614;463;1433;639;2047
316695;202006;1013;2944;828;2608;31;128;566;1750;597;1878
316700;202006;401;935;332;847;15;49;258;623;273;672
316710;202006;2974;9769;2266;8277;463;1813;883;3207;1346;5020
316720;202006;19845;54358;14404;43862;2562;8307;6065;17590;8627;25897
316730;202006;422;1151;337;987;43;146;172;473;215;619
316740;202006;727;2132;627;1969;68;242;393;1244;461;1486
316750;202006;375;1134;288;969;58;227;134;417;192;644
316760;202006;3470;11071;2824;9768;1125;4221;615;2003;1740;6224
316770;202006;1597;3672;1222;3144;25;75;995;2631;1020;2706
316780;202006;554;1654;424;1391;161;589;68;188;229;777
316790;202006;679;1835;476;1430;97;317;143;386;240;703
316800;202006;6083;17193;4846;14912;495;1743;2519;7490;3014;9233
316805;202006;996;2212;802;2000;57;160;621;1561;678;1721
316810;202006;612;1713;411;1297;77;281;208;615;285;896
316820;202006;302;723;167;479;10;32;81;218;91;250
316830;202006;723;1953;573;1709;71;243;359;1038;430;1281
316840;202006;2697;7038;2144;6092;189;669;1468;3966;1657;4635
316850;202006;1896;4992;1348;3980;214;677;590;1685;804;2362
316860;202006;18859;48585;13821;41015;2233;7698;6280;18163;8513;25861
316870;202006;7765;21188;5746;17271;865;2867;2570;7198;3435;10065
316880;202006;820;2228;662;2008;133;454;311;891;444;1345
316890;202006;1126;2501;653;1857;96;347;387;1000;483;1347
316900;202006;2240;6054;1713;4978;340;1074;550;1489;890;2563
316905;202006;519;1549;419;1351;109;380;163;535;272;915
316910;202006;889;2335;538;1705;133;467;45;132;178;599
316920;202006;1720;4241;1182;3424;223;705;524;1468;747;2173
316930;202006;7279;21066;5292;17413;1182;4169;1405;4411;2587;8580
316935;202006;3960;10751;2857;8670;517;1693;1136;3307;1653;5000
316940;202006;6320;18630;4802;15439;738;2639;1872;5571;2610;8210
316950;202006;1838;4345;1429;3785;43;137;1185;3094;1228;3231
316960;202006;5012;11333;3590;9366;346;995;2419;6160;2765;7155
316970;202006;3638;10408;3158;9496;492;1551;1345;3866;1837;5417
316980;202006;658;1964;497;1652;162;606;63;222;225;828
316990;202006;11172;30140;7954;23531;2084;6708;1218;3207;3302;9915
317000;202006;2515;7428;2207;6976;165;491;1630;5189;1795;5680
317005;202006;2548;7257;2010;6146;323;1049;1053;3154;1376;4203
317010;202006;24004;56326;14666;41975;2964;9342;5501;16225;8465;25567
317020;202006;62989;149518;35803;102038;6506;20408;10980;28896;17486;49304
317030;202006;676;1801;521;1589;17;80;403;1208;420;1288
317040;202006;10957;27725;7586;21881;1662;5194;2711;8018;4373;13212
317043;202006;845;1895;597;1551;53;140;429;1105;482;1245
317047;202006;1173;2809;811;2230;88;245;504;1334;592;1579
317050;202006;1158;3559;807;2739;108;384;338;1017;446;1401
317052;202006;2360;6599;1898;5843;278;852;1163;3595;1441;4447
317057;202006;1794;4357;1302;3545;34;133;836;2257;870;2390
317060;202006;490;1302;304;920;37;118;130;347;167;465
317065;202006;1159;3395;941;2970;57;196;584;1733;641;1929
317070;202006;7423;20349;5153;15965;970;3398;1483;4338;2453;7736
317075;202006;906;2352;650;1909;106;348;288;767;394;1115
317080;202006;5970;14051;4382;11500;1184;3349;1422;3587;2606;6936
317090;202006;4531;13429;4017;12585;308;937;2963;9329;3271;10266
317100;202006;2660;6333;1681;4690;384;1120;614;1669;998;2789
317103;202006;2135;5800;1811;5290;85;390;1384;3855;1469;4245
317107;202006;1414;3765;1074;3107;77;275;656;1695;733;1970
317110;202006;711;1644;359;1095;54;192;120;382;174;574
317115;202006;1071;3068;906;2761;51;139;621;1899;672;2038
317120;202006;13430;36441;10604;31835;1113;3934;6261;18086;7374;22020
317130;202006;10985;25550;6870;18756;1109;3382;2279;6162;3388;9544
317140;202006;837;2024;640;1730;38;106;445;1237;483;1343
317150;202006;995;2366;742;2049;32;95;582;1581;614;1676
317160;202006;3531;8555;2296;6567;174;543;1269;3703;1443;4246
317170;202006;1820;4506;1313;3647;214;707;543;1300;757;2007
317180;202006;1947;6084;1430;4837;282;1013;362;1142;644;2155
317190;202006;1205;3245;889;2751;106;343;515;1578;621;1921
317200;202006;5034;13156;3803;11025;1007;3155;801;2143;1808;5298
317210;202006;1164;2862;904;2501;27;106;668;1876;695;1982
317220;202006;244;754;207;682;49;165;77;269;126;434
320010;202006;4453;12976;3556;11188;356;1244;2299;7053;2655;8297
320013;202006;1904;5240;1276;3976;208;666;561;1814;769;2480
320016;202006;2976;7632;2315;6617;167;449;1762;5060;1929;5509
320020;202006;3903;10151;2847;8316;631;2037;998;3029;1629;5066
320030;202006;1713;4786;1107;3559;207;726;389;1198;596;1924
320035;202006;1874;5171;1518;4536;376;1252;644;1870;1020;3122
320040;202006;3901;11134;3196;9825;461;1511;1783;5332;2244;6843
320050;202006;1748;3971;1498;3609;185;536;894;2064;1079;2600
320060;202006;12048;33404;8966;27345;1373;4633;4248;12284;5621;16917
320070;202006;1468;4151;1019;3219;182;641;367;1105;549;1746
320080;202006;5568;14324;3898;11044;811;2443;1409;3768;2220;6211
320090;202006;8303;22150;5443;16187;1193;3823;1959;5441;3152;9264
320100;202006;2876;7983;2328;7015;391;1324;1218;3641;1609;4965
320110;202006;2022;4727;1339;3616;195;549;639;1659;834;2208
320115;202006;1784;5745;1517;5296;644;2371;421;1518;1065;3889
320120;202006;22312;57193;15275;44503;2215;7002;6955;19288;9170;26290
320130;202006;44013;122995;35916;108261;4762;15869;20854;61097;25616;76966
320140;202006;3550;9695;2333;7301;348;1252;927;2877;1275;4129
320150;202006;13136;34131;9183;26464;2342;7397;1601;4145;3943;11542
320160;202006;5791;16248;4218;13168;698;2378;1950;5965;2648;8343
320170;202006;1577;4542;1138;3668;306;972;431;1463;737;2435
320180;202006;686;2182;552;1918;214;791;144;465;358;1256
320190;202006;2734;8766;2090;7326;507;1892;547;1819;1054;3711
320200;202006;1246;3365;840;2613;185;623;310;969;495;1592
320210;202006;4320;11051;3297;9261;525;1611;1756;4724;2281;6335
320220;202006;2663;7092;1987;5961;350;1149;977;2792;1327;3941
320225;202006;1337;4173;939;3213;338;1248;191;646;529;1894
320230;202006;4880;13557;3697;11560;829;2840;1434;4338;2263;7178
320240;202006;15657;40011;11552;33351;2763;8705;3866;10853;6629;19558
320245;202006;3026;8997;2390;7696;887;3005;454;1437;1341;4442
320250;202006;2185;6202;1456;4457;327;1123;420;1138;747;2261
320255;202006;1782;5617;1531;5165;419;1444;741;2606;1160;4050
320260;202006;1400;3925;832;2657;176;627;198;535;374;1162
320265;202006;2465;7612;1999;6663;925;3274;345;1147;1270;4421
320270;202006;2173;6270;1633;5212;397;1367;632;2028;1029;3395
320280;202006;6865;18420;5511;16084;1220;3830;2457;6916;3677;10746
320290;202006;1341;3998;861;2820;221;794;230;706;451;1500
320300;202006;3566;10845;2826;9314;815;2897;657;2026;1472;4923
320305;202006;5067;14410;3909;12096;745;2504;1891;5651;2636;8155
320310;202006;2043;5698;1385;4297;255;827;595;1771;850;2598
320313;202006;2382;6006;1521;4362;313;1023;390;1021;703;2044
320316;202006;1443;4076;1166;3608;182;578;712;2211;894;2789
320320;202006;21499;56581;15063;45376;3517;11109;5480;16593;8997;27702
320330;202006;2925;7977;2254;6757;428;1275;1175;3606;1603;4881
320332;202006;6662;18182;5246;15672;1281;4120;2347;6961;3628;11081
320334;202006;1721;4908;1193;3820;256;975;286;722;542;1697
320335;202006;1357;4024;939;3046;234;847;239;707;473;1554
320340;202006;4687;11814;3883;10626;494;1489;2280;6280;2774;7769
320350;202006;5344;13269;3737;10343;465;1381;1963;5164;2428;6545
320360;202006;1408;3575;1038;2879;126;347;526;1396;652;1743
320370;202006;2584;7935;1889;6412;573;2042;598;2003;1171;4045
320380;202006;2456;6634;2031;5935;236;745;1286;3659;1522;4404
320390;202006;6936;18880;5088;15165;1062;3369;2049;5766;3111;9135
320400;202006;3228;9160;2445;7499;688;2249;868;2541;1556;4790
320405;202006;4530;12024;3391;10080;556;1787;1566;4568;2122;6355
320410;202006;4795;12454;3591;10483;636;1822;1788;5441;2424;7263
320420;202006;3136;8263;2357;6909;684;2247;423;1235;1107;3482
320425;202006;2073;4992;1573;4146;98;294;1042;2660;1140;2954
320430;202006;2993;7507;2345;6324;302;903;1504;3889;1806;4792
320435;202006;2155;6739;1697;5831;606;2201;513;1781;1119;3982
320440;202006;1448;3982;1046;3206;152;492;469;1394;621;1886
320450;202006;1603;4648;1246;3968;278;1001;546;1621;824;2622
320455;202006;4071;12364;2717;9165;689;2500;655;2006;1344;4506
320460;202006;2084;6157;1462;4822;359;1261;370;1134;729;2395
320465;202006;1187;3392;897;2826;128;417;499;1578;627;1995
320470;202006;3683;10161;2568;7780;581;1866;619;1673;1200;3539
320480;202006;1652;4581;1342;4055;188;653;794;2325;982;2978
320490;202006;20892;54933;15273;44954;2601;8382;6301;18356;8902;26738
320495;202006;1273;3497;876;2720;191;679;330;978;521;1657
320500;202006;51793;138037;41081;119463;5759;18177;23672;66029;29431;84206
320501;202006;4380;12692;3224;10578;905;3312;1067;3439;1972;6751
320503;202006;2360;6748;1519;5010;409;1477;445;1381;854;2858
320506;202006;2541;7549;1820;5954;542;1915;191;623;733;2538
320510;202006;9918;26912;7996;23559;899;3060;4954;14126;5853;17186
320515;202006;1741;4763;1332;3934;359;1153;455;1293;814;2446
320517;202006;2124;6433;1685;5487;541;1921;491;1573;1032;3494
320520;202006;35120;91199;25918;75632;4596;14774;10877;30756;15473;45530
320530;202006;30622;81637;23894;69682;2290;7936;14954;41296;17244;49232
330010;202006;21333;57309;17286;50463;2377;7454;10940;31252;13317;38706
330015;202006;1479;3643;1141;3121;200;616;615;1598;815;2214
330020;202006;19946;49758;16682;44998;2387;7232;11493;30255;13880;37487
330022;202006;1875;5041;1436;4274;239;733;838;2472;1077;3205
330023;202006;4971;11807;3517;9754;591;1819;1935;5231;2526;7050
330025;202006;6415;15096;3800;10633;898;2790;830;2204;1728;4994
330030;202006;10154;27215;7628;23019;833;2907;4652;13424;5485;16331
330040;202006;14495;37775;11398;32486;1095;3513;7605;20816;8700;24329
330045;202006;83726;197984;68380;178546;5132;13423;54191;140874;59323;154297
330050;202006;2442;6506;1771;5361;361;1182;839;2414;1200;3596
330060;202006;5000;13228;3951;11335;782;2485;1685;4452;2467;6937
330070;202006;22570;57173;18020;50470;2856;8508;10568;29404;13424;37912
330080;202006;8783;22219;7439;20293;931;2701;5140;13852;6071;16553
330090;202006;3505;7319;2375;5745;160;409;1625;3931;1785;4340
330093;202006;2600;6295;1922;5326;123;370;1465;4042;1588;4412
330095;202006;1248;3533;951;2958;77;288;581;1671;658;1959
330100;202006;69748;185443;59092;169534;3607;12369;45040;127314;48647;139683
330110;202006;2063;5788;1645;5071;273;925;916;2724;1189;3649
330115;202006;2553;6146;1782;4936;244;784;1008;2672;1252;3456
330120;202006;3519;7897;2607;6712;226;654;1796;4449;2022;5103
330130;202006;4230;11573;3433;10352;482;1523;2129;6370;2611;7893
330140;202006;3712;9661;2910;8490;423;1378;1841;5240;2264;6618
330150;202006;2151;5747;1622;4899;292;936;781;2301;1073;3237
330160;202006;1361;3696;1010;3071;176;581;535;1551;711;2132
330170;202006;105984;264034;84179;234299;11365;31416;55971;157957;67336;189373
330180;202006;1971;4761;1507;4104;97;301;1037;2752;1134;3053
330185;202006;9555;24107;7932;21829;497;1675;6306;16924;6803;18599
330187;202006;4272;10862;3288;9253;465;1415;1907;5327;2372;6742
330190;202006;32835;79767;27582;72523;1928;5506;21781;56588;23709;62094
330200;202006;15768;40142;12692;36324;2489;6787;7903;23306;10392;30093
330205;202006;2091;5145;1566;4296;92;299;1088;2865;1180;3164
330210;202006;3413;8585;2451;6882;358;1106;1183;3075;1541;4181
330220;202006;11748;29245;8156;23175;1714;5465;2846;7491;4560;12956
330225;202006;3859;9698;2879;8187;197;681;2065;5728;2262;6409
330227;202006;17414;41879;14495;38304;585;1727;12389;32366;12974;34093
330230;202006;1959;4395;1307;3548;114;324;788;2141;902;2465
330240;202006;23654;61496;19220;54500;2426;7537;12550;34741;14976;42278
330245;202006;1677;4144;1007;2967;202;636;378;1098;580;1734
330250;202006;37512;96309;30871;86466;5457;15641;18621;52173;24078;67814
330260;202006;4725;11511;3517;9857;351;1109;2444;6643;2795;7752
330270;202006;28857;63623;17629;45878;2900;8092;7180;18070;10080;26162
330280;202006;2344;6174;1747;5145;190;616;1025;2910;1215;3526
330285;202006;23026;55460;18054;48317;1454;4546;13169;34054;14623;38600
330290;202006;3702;9048;2942;8043;318;976;2062;5476;2380;6452
330300;202006;5766;13578;4134;11207;314;964;2873;7643;3187;8607
330310;202006;2633;6517;1853;5196;122;311;1228;3440;1350;3751
330320;202006;16426;38934;12395;33881;1404;3814;8926;24517;10330;28331
330330;202006;37042;81449;28200;69576;2547;6927;20203;48931;22750;55858
330340;202006;14561;35967;10559;29630;1694;5294;5376;14394;7070;19688
330350;202006;134853;312929;109828;282299;7113;19067;89490;228960;96603;248027
330360;202006;7431;18018;6350;16693;206;556;5377;14070;5583;14626
330370;202006;4827;13829;3647;11801;850;2813;1519;5123;2369;7936
330380;202006;5359;14398;3998;11937;705;2425;1964;5585;2669;8010
330385;202006;3904;11263;3153;10149;756;2694;1500;4773;2256;7467
330390;202006;25899;70056;19452;58769;2763;9564;11084;31671;13847;41235
330395;202006;3155;7838;2583;7085;161;512;1861;4999;2022;5511
330400;202006;3353;8838;2835;8021;153;542;2126;5662;2279;6204
330410;202006;3167;8489;2248;6862;429;1441;1005;2920;1434;4361
330411;202006;2770;7473;2125;6251;143;500;1484;4208;1627;4708
330412;202006;1485;4211;1187;3719;131;483;729;2148;860;2631
330414;202006;23296;58619;18657;52276;1572;4566;13675;38007;15247;42573
330415;202006;4173;11322;3206;9636;324;1037;1908;5695;2232;6732
330420;202006;11292;27934;7793;22248;952;3073;4027;10737;4979;13810
330430;202006;9461;22752;7882;20571;318;1053;6183;15652;6501;16705
330440;202006;2469;6651;1837;5572;304;1074;1029;2979;1333;4053
330450;202006;1305;3724;1036;3271;140;485;569;1760;709;2245
330452;202006;16559;42234;13105;36927;1687;5343;8299;22669;9986;28012
330455;202006;552351;1306747;419630;1115153;59562;168790;265015;693225;324577;862015
330460;202006;1185;3229;873;2766;154;519;470;1453;624;1972
330470;202006;4797;11994;3422;9847;1093;3243;1015;3016;2108;6259
330475;202006;9490;24609;7622;22160;1192;3980;4863;13830;6055;17810
330480;202006;5891;15257;4919;13831;402;1263;3411;9326;3813;10589
330490;202006;112261;258186;90228;228558;9974;26368;64572;162158;74546;188526
330500;202006;7378;18161;6116;16422;617;1854;4427;11712;5044;13566
330510;202006;40013;99067;29327;83832;4907;15031;17710;49959;22617;64990
330513;202006;1230;3173;963;2795;210;658;474;1388;684;2046
330515;202006;2449;6460;1933;5731;367;1176;1063;3076;1430;4252
330520;202006;11230;29644;9030;26148;1197;3824;5512;15581;6709;19405
330530;202006;1683;4072;1234;3388;254;759;561;1510;815;2269
330540;202006;2876;7631;2204;6463;507;1546;943;2680;1450;4226
330550;202006;8932;23242;6752;20344;1914;6267;2704;8057;4618;14324
330555;202006;17653;37424;14548;33770;848;2202;11710;27407;12558;29609
330560;202006;4133;11057;3305;9660;505;1518;1959;5589;2464;7107
330570;202006;2700;7427;2252;6733;357;1149;1441;4273;1798;5422
330575;202006;5461;14098;4678;12757;282;881;3744;9880;4026;10761
330580;202006;16993;45497;12949;38105;2380;7620;6110;17187;8490;24807
330590;202006;1449;3919;1190;3585;219;658;737;2261;956;2919
330600;202006;11660;30751;9415;27100;902;3027;5984;16737;6886;19764
330610;202006;9216;24554;7377;21637;574;1985;5143;14682;5717;16667
330615;202006;2063;5634;1589;4980;304;978;978;3133;1282;4111
330620;202006;4002;11431;3121;9887;701;2403;1314;3914;2015;6317
330630;202006;24016;60212;18680;51828;1382;4520;13264;35604;14646;40124
350010;202006;2044;5237;1018;3046;219;710;180;390;399;1100
350020;202006;688;1764;383;1178;49;158;153;429;202;587
350030;202006;3535;9888;2580;8210;648;2250;1044;3163;1692;5413
350040;202006;716;2044;402;1363;53;208;133;348;186;556
350050;202006;1240;3072;787;2273;182;613;262;614;444;1227
350055;202006;909;2373;696;2029;76;242;402;1109;478;1351
350060;202006;168;433;101;297;13;45;50;149;63;194
350070;202006;3360;8874;2085;6539;419;1463;630;1799;1049;3262
350075;202006;571;1686;425;1391;177;617;34;114;211;731
350080;202006;655;1692;413;1255;58;198;165;451;223;649
350090;202006;585;1386;351;974;71;212;148;383;219;595
350100;202006;2288;6067;1560;4767;123;463;950;2732;1073;3195
350110;202006;481;1218;325;940;17;59;186;529;203;588
350115;202006;1263;3668;1028;3169;186;635;524;1466;710;2101
350120;202006;658;1528;357;961;36;113;186;437;222;550
350130;202006;3022;7987;2348;6747;410;1210;1152;3148;1562;4358
350140;202006;763;2162;497;1619;49;219;270;807;319;1026
350150;202006;507;1545;411;1356;93;299;115;350;208;649
350160;202006;10821;27062;7125;20339;924;3002;4264;11492;5188;14494
350170;202006;2089;6045;1645;5075;321;1051;691;1979;1012;3030
350180;202006;1030;2550;514;1545;115;358;74;199;189;557
350190;202006;2821;7984;1919;6047;363;1310;793;2124;1156;3434
350200;202006;438;1247;343;1066;18;62;221;647;239;709
350210;202006;5706;13053;3818;10188;502;1448;2338;6022;2840;7470
350220;202006;2840;7806;1888;5899;413;1363;615;1746;1028;3109
350230;202006;1022;2631;836;2357;156;471;462;1262;618;1733
350240;202006;643;1864;409;1313;87;282;102;305;189;587
350250;202006;2317;6669;1720;5667;612;2207;318;1074;930;3281
350260;202006;813;1934;513;1412;57;176;310;823;367;999
350270;202006;4399;11866;3459;10051;542;1722;1807;4898;2349;6620
350275;202006;2338;6291;1825;5461;301;1000;1050;2994;1351;3994
350280;202006;18658;41842;10867;29180;1839;5239;4191;10762;6030;16001
350290;202006;3130;8622;2082;6444;381;1303;833;2388;1214;3691
350300;202006;630;1718;462;1395;69;210;234;665;303;875
350310;202006;868;2509;625;2008;108;399;236;688;344;1087
350315;202006;574;1443;374;1098;22;74;194;530;216;604
350320;202006;14809;37983;10728;30732;2307;7298;3958;10529;6265;17827
350330;202006;14019;34527;9799;26349;1062;3160;6128;15456;7190;18616
350335;202006;356;1013;273;859;34;121;131;386;165;507
350340;202006;1145;2941;677;2074;118;406;264;728;382;1134
350350;202006;735;1869;562;1674;68;248;334;971;402;1219
350360;202006;1087;3217;827;2667;220;722;253;831;473;1553
350370;202006;613;1542;417;1182;152;409;118;348;270;757
350380;202006;4284;11715;2978;9065;852;2569;734;2286;1586;4855
350390;202006;10144;26988;7850;23026;1743;5303;3421;9771;5164;15074
350395;202006;431;1105;222;698;21;63;80;225;101;288
350400;202006;7904;19471;5418;15359;1336;4093;1501;4179;2837;8272
350410;202006;9501;26481;6791;21191;1462;5113;2532;7303;3994;12416
350420;202006;697;1850;484;1409;78;257;117;296;195;553
350430;202006;648;1754;519;1540;68;238;317;865;385;1103
350440;202006;1999;5032;1607;4434;123;362;1055;2851;1178;3213
350450;202006;6597;18100;5075;15435;1123;3728;2094;5970;3217;9698
350460;202006;1707;4412;859;2659;154;507;184;496;338;1003
350470;202006;252;631;193;531;10;31;135;356;145;387
350480;202006;984;2454;617;1804;123;434;138;316;261;750
350490;202006;1909;5033;1351;4115;310;981;412;1155;722;2136
350500;202006;683;1811;515;1498;67;210;257;706;324;916
350510;202006;1157;3009;857;2463;95;308;501;1382;596;1690
350520;202006;2106;6429;1609;5438;266;998;710;2173;976;3171
350530;202006;2694;6751;1961;5380;220;672;1163;3001;1383;3673
350535;202006;1385;3795;1187;3515;171;578;735;2100;906;2678
350540;202006;1879;4518;1376;3765;177;494;841;2234;1018;2728
350550;202006;8294;20476;5690;16157;624;2102;3316;8765;3940;10867
350560;202006;3902;10984;3070;9476;302;998;1895;5657;2197;6655
350570;202006;24102;67244;19227;57711;3643;11983;9640;27722;13283;39705
350580;202006;2077;5618;1199;3734;309;1050;211;534;520;1584
350590;202006;4821;13111;3478;10110;474;1559;2024;5438;2498;6997
350600;202006;35589;82173;21730;57928;3230;9684;10242;25127;13472;34811
350610;202006;6650;18255;4728;14374;829;2758;2187;6298;3016;9056
350620;202006;400;1016;256;807;27;88;148;449;175;537
350630;202006;1430;3729;1038;3023;74;278;667;1807;741;2085
350635;202006;8680;21575;6493;18198;1080;3352;3662;9732;4742;13084
350640;202006;916;2462;474;1488;73;234;133;361;206;595
350650;202006;8066;21591;5414;16308;1062;3455;1970;5494;3032;8949
350660;202006;4521;11874;3451;10088;579;1710;1775;5198;2354;6908
350670;202006;1833;4868;1495;4376;156;472;1002;2933;1158;3405
350680;202006;1102;2979;721;2269;138;443;282;847;420;1290
350690;202006;1260;3252;875;2602;148;476;470;1349;618;1825
350700;202006;4686;11874;3238;9613;612;2082;1376;3833;1988;5915
350710;202006;2752;7605;2308;6816;398;1361;1253;3407;1651;4768
350715;202006;811;2329;662;2057;70;288;358;1012;428;1300
350720;202006;153;403;112;331;17;49;34;80;51;129
350730;202006;608;1627;509;1454;29;110;381;1023;410;1133
350740;202006;1596;4273;1069;3194;218;691;334;923;552;1614
350745;202006;591;1495;318;965;40;150;122;333;162;483
350750;202006;9702;25215;7277;20996;1299;4337;3267;8423;4566;12760
350760;202006;14245;35545;10125;28392;2195;6783;4027;10174;6222;16957
350770;202006;961;2408;596;1762;39;125;380;1101;419;1226
350775;202006;662;1562;447;1235;44;127;218;600;262;727
350780;202006;2037;5039;1432;4158;253;825;518;1714;771;2539
350790;202006;1612;4328;982;3161;196;687;261;688;457;1375
350800;202006;3427;9869;2929;8983;250;878;2021;6006;2271;6884
350810;202006;2674;6597;2102;5762;316;838;1166;3262;1482;4100
350820;202006;913;2146;509;1414;50;168;251;625;301;793
350830;202006;852;2383;470;1522;76;242;139;396;215;638
350840;202006;3157;9251;2314;7627;533;1930;986;2965;1519;4895
350850;202006;6886;19161;5279;16252;1081;3616;2398;7045;3479;10661
350860;202006;3541;9504;3020;8794;122;452;2287;6575;2409;7027
350870;202006;2585;7275;1876;6118;261;951;1031;3280;1292;4231
350880;202006;1257;3601;977;3046;249;806;278;830;527;1636
350890;202006;525;1353;325;937;48;147;119;314;167;461
350900;202006;6969;18911;4336;13273;997;3360;1348;3773;2345;7133
350910;202006;889;2194;757;1990;94;260;541;1396;635;1656
350920;202006;11585;28886;9661;25726;446;1458;7763;19916;8209;21374
350925;202006;4308;11745;3044;9427;588;1968;1421;4062;2009;6030
350930;202006;1486;3900;1012;2958;88;268;624;1784;712;2052
350940;202006;2213;5871;1687;5005;182;595;1058;3027;1240;3622
350945;202006;832;2332;615;1909;94;346;324;919;418;1265
350950;202006;84724;218583;64234;179871;8625;26607;38720;103372;47345;129979
350960;202006;6313;17146;4859;14401;588;2003;2892;8131;3480;10134
350970;202006;3551;10003;2541;8041;752;2652;502;1358;1254;4010
350980;202006;640;1774;516;1552;134;424;232;694;366;1118
350990;202006;1728;4834;1258;4056;307;1109;434;1312;741;2421
350995;202006;768;2394;685;2223;54;216;483;1493;537;1709
351000;202006;2777;7219;1937;5715;338;1058;728;2087;1066;3145
351010;202006;322;796;213;611;26;88;114;314;140;402
351015;202006;795;2399;634;2056;98;351;294;852;392;1203
351020;202006;8723;23732;6608;20073;1381;4288;3169;9395;4550;13683
351030;202006;2779;8261;2223;7123;325;1142;1182;3698;1507;4840
351040;202006;4938;12250;4108;10995;211;687;3354;8733;3565;9420
351050;202006;16959;41369;11910;33398;2435;7224;5063;14032;7498;21256
351060;202006;48678;122493;36806;101920;3842;11720;24542;65709;28384;77429
351070;202006;1429;3542;763;2363;185;625;131;392;316;1017
351080;202006;2753;6672;1952;5712;216;758;1295;3609;1511;4367
351090;202006;323;949;229;771;51;176;62;208;113;384
351100;202006;2561;6958;1639;5052;371;1199;465;1489;836;2688
351110;202006;6174;15824;3967;11699;662;2145;1682;4640;2344;6785
351120;202006;778;1970;513;1527;60;188;194;566;254;754
351130;202006;1172;3059;525;1667;98;319;132;397;230;716
351140;202006;2046;5854;1510;4785;319;1141;606;1727;925;2868
351150;202006;2457;7066;1619;5189;273;975;629;1799;902;2774
351160;202006;1123;3488;831;2795;181;649;213;622;394;1271
351170;202006;1362;3738;1171;3390;95;296;827;2321;922;2617
351190;202006;1001;2771;647;2033;119;379;232;670;351;1049
351200;202006;1596;3828;1171;3189;96;298;818;2098;914;2396
351210;202006;1525;3765;930;2622;78;261;550;1441;628;1702
351220;202006;3221;9133;2727;8310;314;1000;1793;5411;2107;6411
351230;202006;1735;4738;1258;3884;225;797;559;1572;784;2369
351240;202006;2397;6137;1439;4117;307;942;539;1372;846;2314
351250;202006;1041;2785;599;1885;79;268;217;669;296;937
351260;202006;907;2291;647;1814;132;377;246;654;378;1031
351270;202006;442;1185;366;1055;37;131;224;561;261;692
351280;202006;3781;9952;2850;8197;533;1563;1334;3717;1867;5280
351290;202006;1230;3039;836;2356;115;350;493;1333;608;1683
351300;202006;17153;46767;11539;35808;2111;7122;4852;14438;6963;21560
351310;202006;3329;8170;2491;6864;178;620;1811;4721;1989;5341
351320;202006;924;2678;675;2135;128;437;238;670;366;1107
351330;202006;488;1156;402;998;24;71;288;645;312;716
351340;202006;6292;17940;5003;15650;1203;3942;2195;6818;3398;10760
351350;202006;11416;28549;9353;25288;1004;2915;6799;17888;7803;20803
351360;202006;3769;10123;3091;9085;747;2354;1204;3269;1951;5623
351370;202006;2031;5684;1338;4230;319;1090;425;1222;744;2312
351380;202006;47068;114193;32770;89046;4344;12707;18384;47722;22728;60429
351385;202006;333;881;154;473;29;88;43;121;72;209
351390;202006;1377;3365;822;2539;122;448;463;1340;585;1788
351400;202006;911;2561;749;2222;124;371;451;1303;575;1674
351410;202006;2598;7246;1828;5729;327;1054;707;2171;1034;3225
351420;202006;407;961;221;632;26;69;131;348;157;417
351430;202006;929;2528;709;2160;58;180;485;1436;543;1616
351440;202006;3341;8825;2156;6348;394;1210;607;1542;1001;2752
351450;202006;1664;4431;1058;3288;218;741;158;377;376;1118
351460;202006;810;2123;619;1809;152;440;330;956;482;1396
351470;202006;1184;2995;904;2523;84;289;587;1532;671;1821
351480;202006;2462;7267;1924;6300;368;1328;811;2483;1179;3811
351490;202006;1952;5529;1652;4990;74;299;1330;3867;1404;4166
351492;202006;347;941;283;805;8;24;212;589;220;613
351495;202006;184;479;133;376;17;43;71;200;88;243
351500;202006;36217;89660;26637;73327;4091;12101;15464;40745;19555;52846
351510;202006;12899;32152;9271;25790;1146;3640;5743;15209;6889;18849
351512;202006;475;1286;334;977;59;170;117;314;176;484
351515;202006;3145;7012;1910;5077;326;975;553;1568;879;2543
351518;202006;2381;6008;1504;4419;204;675;828;2202;1032;2877
351519;202006;712;1968;431;1408;89;286;63;196;152;482
351520;202006;1251;3085;509;1550;57;197;210;557;267;754
351530;202006;351;927;204;610;29;89;81;188;110;277
351535;202006;1852;4509;1308;3581;208;622;668;1733;876;2355
351540;202006;2373;5907;1569;4506;307;1025;548;1385;855;2410
351550;202006;6910;17115;4536;12761;462;1496;2574;6748;3036;8244
351560;202006;442;1263;338;1053;84;287;101;288;185;575
351565;202006;205;586;162;508;40;141;42;115;82;256
351570;202006;20382;54968;15286;44471;1639;5176;9437;26278;11076;31454
351580;202006;244;629;134;414;14;44;58;185;72;229
351590;202006;505;1144;266;729;21;74;151;375;172;449
351600;202006;1332;3513;1016;2930;91;281;621;1693;712;1974
351610;202006;740;1755;462;1267;24;72;267;690;291;762
351620;202006;22530;59751;16226;48714;2681;9106;7292;19785;9973;28891
351630;202006;27080;71414;21529;61717;3174;9591;13211;36705;16385;46296
351640;202006;16469;43772;12634;36660;1245;4135;8510;23739;9755;27874
351650;202006;372;985;167;543;20;70;48;133;68;203
351660;202006;739;2092;461;1456;84;285;67;168;151;453
351670;202006;5908;15846;3775;11180;811;2399;1619;4517;2430;6916
351680;202006;434;1240;273;878;45;143;65;173;110;316
351685;202006;421;1201;336;1062;92;293;104;307;196;600
351690;202006;1052;2694;601;1773;83;273;254;674;337;947
351700;202006;1360;3384;964;2684;164;472;525;1380;689;1852
351710;202006;741;2000;518;1572;49;169;270;740;319;909
351720;202006;1396;3632;908;2766;145;476;365;1053;510;1529
351730;202006;914;2386;754;2134;61;212;491;1318;552;1530
351740;202006;3502;8803;2705;7270;481;1394;1336;3318;1817;4712
351750;202006;1324;3501;816;2577;154;498;305;946;459;1444
351760;202006;3283;9282;2368;7417;480;1719;860;2419;1340;4138
351770;202006;1731;5151;1400;4500;268;915;724;2264;992;3179
351780;202006;1243;3158;725;2171;107;371;247;694;354;1065
351790;202006;1339;3190;1039;2791;164;451;612;1656;776;2107
351800;202006;519;1204;245;686;22;62;92;224;114;286
351810;202006;1015;2651;816;2346;35;106;598;1638;633;1744
351820;202006;2522;7078;1740;5538;450;1564;391;1143;841;2707
351830;202006;4448;11982;3382;10125;326;1175;2104;5975;2430;7150
351840;202006;8444;23383;6244;19248;911;3127;3222;9297;4133;12424
351850;202006;1568;4236;1012;3153;168;601;345;921;513;1522
351860;202006;2737;7906;2097;6702;366;1242;1123;3632;1489;4874
351870;202006;23443;59915;17357;49808;4633;13669;6887;20120;11520;33789
351880;202006;124852;323645;91965;266545;21515;68646;40467;111677;61982;180323
351885;202006;897;2417;702;2085;67;246;459;1294;526;1540
351890;202006;802;2085;506;1581;118;389;81;208;199;597
351900;202006;1084;2904;840;2540;120;361;476;1432;596;1793
351905;202006;423;1152;296;905;25;86;137;369;162;455
351907;202006;20673;54310;15787;45535;1875;5950;10023;27886;11898;33836
351910;202006;1503;3950;1037;2934;72;224;594;1522;666;1746
351920;202006;856;2268;646;1861;100;336;288;754;388;1090
351925;202006;871;2330;675;1963;84;280;363;978;447;1258
351930;202006;3183;8929;2848;8313;582;1702;1893;5461;2475;7163
351940;202006;1059;2735;751;2192;117;373;372;1069;489;1442
351950;202006;1649;3794;1199;3115;62;181;841;2113;903;2294
351960;202006;5190;13089;3724;10462;826;2490;1662;4340;2488;6830
351970;202006;7110;21136;5589;18421;880;3237;3039;9712;3919;12949
351980;202006;989;2341;620;1737;86;274;351;909;437;1183
351990;202006;1391;3281;987;2690;55;204;476;1175;531;1379
352000;202006;2547;7258;2176;6495;256;879;1429;3989;1685;4868
352010;202006;2218;5948;1756;5161;459;1480;377;1127;836;2607
352020;202006;1434;3931;1091;3343;169;557;526;1526;695;2083
352030;202006;5581;14810;4319;12745;816;2644;2165;6183;2981;8827
352040;202006;2822;7607;1871;5643;278;936;676;1731;954;2667
352042;202006;2955;7220;1897;5516;378;1241;804;2241;1182;3482
352044;202006;2057;5514;1161;3774;182;674;251;753;433;1427
352050;202006;11978;31906;7551;23054;1913;6670;1395;3547;3308;10217
352060;202006;698;1880;506;1524;71;233;227;631;298;864
352070;202006;912;1835;578;1389;62;161;279;596;341;757
352080;202006;471;1196;283;813;30;104;106;270;136;374
352090;202006;1452;4250;1187;3716;132;485;575;1624;707;2109
352100;202006;3372;9469;2725;8249;592;1970;1195;3480;1787;5450
352110;202006;579;1696;440;1415;93;313;171;516;264;829
352115;202006;491;1342;401;1206;49;173;238;695;287;868
352120;202006;889;2620;728;2292;86;272;433;1267;519;1539
352130;202006;1954;5509;1304;3907;207;658;520;1438;727;2096
352140;202006;1173;3194;817;2488;147;476;383;1123;530;1599
352150;202006;815;2200;626;1871;83;266;414;1200;497;1466
352160;202006;980;2411;699;1968;75;264;394;1050;469;1314
352170;202006;2983;7995;2328;6682;332;1073;1386;3680;1718;4753
352180;202006;2509;6793;1912;5680;453;1515;564;1461;1017;2976
352190;202006;1197;3244;934;2837;168;479;448;1431;616;1910
352200;202006;338;1020;234;809;32;121;87;288;119;409
352210;202006;19091;45441;14843;39795;1024;3047;11382;30002;12406;33049
352215;202006;619;1619;531;1493;65;199;345;931;410;1130
352220;202006;19426;48507;12867;36631;2795;8488;5047;13401;7842;21889
352230;202006;13697;39783;10443;33600;2509;8994;3783;11192;6292;20186
352240;202006;10528;27085;7963;22757;1731;5582;3455;9082;5186;14664
352250;202006;23235;64925;18376;56400;3039;9957;10809;32624;13848;42581
352260;202006;4786;12016;3206;8930;472;1516;1815;4554;2287;6070
352265;202006;910;2519;798;2357;49;169;605;1741;654;1910
352270;202006;1437;4300;1057;3468;229;814;368;1129;597;1943
352280;202006;2428;6181;1835;5308;194;685;1081;2886;1275;3571
352290;202006;1148;3331;918;2874;125;441;496;1411;621;1852
352300;202006;900;2440;592;1779;81;278;313;879;394;1157
352310;202006;44478;118177;32658;97226;8090;24760;13877;41504;21967;66264
352320;202006;6405;16929;4847;13873;739;2403;2574;6637;3313;9040
352330;202006;2180;5779;1622;4997;289;1041;857;2471;1146;3512
352340;202006;5554;14616;4011;11795;646;2170;2002;5414;2648;7584
352350;202006;2124;6042;1642;4962;179;663;894;2422;1073;3085
352360;202006;1243;3302;1015;2910;83;293;762;2099;845;2392
352370;202006;1044;2964;903;2731;19;77;727;2159;746;2236
352380;202006;832;2276;618;1882;123;390;222;636;345;1026
352390;202006;15064;36842;10103;28177;1637;4994;5548;14593;7185;19587
352400;202006;3466;9560;2815;8335;609;2097;1445;3964;2054;6061
352410;202006;3171;8153;2367;6800;222;770;1458;3986;1680;4756
352420;202006;829;2011;584;1653;107;320;217;579;324;899
352430;202006;7733;19270;5465;15286;1174;3726;2489;6544;3663;10270
352440;202006;17287;47015;12751;38149;3135;9733;4708;13742;7843;23475
352450;202006;769;1898;380;1214;53;188;130;390;183;578
352460;202006;2915;8099;1974;6340;405;1426;751;2265;1156;3691
352470;202006;3302;8301;2453;6928;283;906;1466;3923;1749;4829
352480;202006;3909;9269;2551;6824;404;1241;1245;2985;1649;4226
352490;202006;715;2053;569;1790;100;331;275;823;375;1154
352500;202006;10192;26350;6835;20013;2893;9330;761;1264;3654;10594
352510;202006;3632;9781;2691;8134;571;1876;1237;3546;1808;5422
352520;202006;2734;7192;2103;6124;396;1295;1163;3071;1559;4366
352530;202006;9765;25421;6264;18587;1148;3894;1815;4527;2963;8421
352540;202006;555;1652;400;1296;65;234;130;375;195;609
352550;202006;989;2769;689;2189;137;476;222;627;359;1103
352560;202006;567;1591;428;1315;76;246;200;577;276;823
352570;202006;2201;6374;1354;4467;327;1166;127;345;454;1511
352580;202006;653;1683;538;1480;48;157;362;947;410;1104
352585;202006;305;804;223;666;18;70;137;367;155;437
352590;202006;13098;34425;9054;26647;2364;7571;3918;10705;6282;18276
352600;202006;1945;5226;1503;4394;158;507;942;2610;1100;3117
352610;202006;2905;8155;2173;6875;439;1577;882;2618;1321;4195
352620;202006;5585;14360;4244;12409;1255;3770;1598;4717;2853;8487
352630;202006;806;2011;595;1692;109;357;273;704;382;1061
352640;202006;2945;7602;2090;6079;216;676;1193;3318;1409;3994
352650;202006;600;1679;409;1262;60;215;149;439;209;654
352660;202006;1058;3101;853;2677;116;378;460;1401;576;1779
352670;202006;9538;25617;6173;18893;1569;5146;1428;4120;2997;9266
352680;202006;3231;9639;2229;7325;354;1410;1092;3222;1446;4632
352690;202006;26553;66738;20362;56110;1373;4520;14284;37749;15657;42269
352700;202006;564;1403;410;1190;150;490;94;264;244;754
352710;202006;5093;13111;3572;10342;834;2657;1495;3978;2329;6635
352720;202006;7644;20933;5889;17609;2472;7524;1215;3435;3687;10959
352725;202006;597;1437;330;949;21;54;161;445;182;499
352730;202006;4319;12626;3777;11328;474;1529;1903;5095;2377;6624
352740;202006;2279;5355;1668;4453;173;540;1024;2574;1197;3114
352750;202006;406;1005;241;709;36;114;101;259;137;373
352760;202006;1619;4505;1231;3726;144;453;642;1932;786;2385
352770;202006;861;2332;581;1775;121;383;229;669;350;1052
352780;202006;616;1759;433;1396;87;276;121;384;208;660
352790;202006;442;1179;304;899;30;104;116;302;146;406
352800;202006;1255;3888;876;2984;242;858;112;333;354;1191
352810;202006;1151;2724;718;1953;91;261;444;1141;535;1402
352820;202006;503;1400;350;1130;76;243;73;248;149;491
352830;202006;576;1464;256;787;23;71;55;136;78;207
352840;202006;3894;11141;3176;9860;1081;3606;1027;3095;2108;6701
352850;202006;10581;25915;7108;20229;1923;5979;2245;5745;4168;11724
352860;202006;982;2712;714;2218;141;474;266;787;407;1261
352870;202006;857;2134;601;1611;36;122;404;1021;440;1143
352880;202006;1727;4062;1212;3168;182;495;707;1765;889;2260
352885;202006;294;819;215;677;23;81;128;381;151;462
352890;202006;692;1666;431;1122;41;117;252;588;293;705
352900;202006;17598;45914;11481;33779;1924;6038;5063;14013;6987;20051
352910;202006;427;1144;227;713;21;72;67;183;88;255
352920;202006;2646;6769;1906;5487;138;431;1299;3634;1437;4065
352930;202006;5646;15291;4124;12304;751;2454;1920;5304;2671;7758
352940;202006;21707;59463;15446;46175;3239;10612;6289;17727;9528;28339
352950;202006;524;1402;311;1002;87;278;56;163;143;441
352960;202006;738;1961;404;1248;67;222;109;293;176;515
352965;202006;235;657;144;473;45;150;34;101;79;251
352970;202006;2952;7065;2230;5878;239;675;1454;3781;1693;4456
352980;202006;1374;3652;1085;3212;263;848;547;1572;810;2420
352990;202006;4047;11430;3148;9932;636;2216;1543;4661;2179;6877
353000;202006;460;1266;243;759;38;127;54;141;92;268
353010;202006;2565;6283;1680;4723;340;1106;701;1788;1041;2894
353020;202006;3574;9270;2033;6011;285;955;693;1901;978;2856
353030;202006;4460;11311;3040;8782;692;2184;874;2396;1566;4580
353040;202006;630;1450;442;1174;73;197;243;615;316;812
353050;202006;5107;14636;3579;11496;703;2449;1598;4908;2301;7357
353060;202006;47701;121815;38986;107913;2751;9181;29099;77718;31850;86899
353070;202006;9132;26205;6513;20561;1273;4378;2615;7656;3888;12034
353080;202006;4048;11226;2697;8595;516;1863;1040;2909;1556;4772
353090;202006;566;1691;429;1402;31;110;269;845;300;955
353100;202006;306;824;137;437;26;86;38;95;64;181
353110;202006;7511;20214;6056;18082;1225;3758;3210;9866;4435;13624
353120;202006;395;983;286;806;40;133;129;320;169;453
353130;202006;2386;5609;1495;4150;384;1181;501;1260;885;2441
353140;202006;2701;6711;1934;5373;114;374;1352;3594;1466;3968
353150;202006;1514;3717;1058;2959;196;571;477;1258;673;1829
353160;202006;569;1497;408;1228;70;220;171;469;241;689
353170;202006;529;1422;393;1226;80;280;173;526;253;806
353180;202006;9629;23641;7467;20124;667;2001;5569;14593;6236;16594
353190;202006;3155;8555;2492;7237;300;932;1521;4167;1821;5099
353200;202006;1901;5021;961;3063;157;552;230;663;387;1215
353205;202006;351;1065;299;951;55;186;152;473;207;659
353210;202006;920;2137;577;1570;30;99;379;1010;409;1109
353215;202006;378;1044;293;886;42;139;144;396;186;535
353220;202006;729;1999;449;1394;95;285;60;178;155;463
353230;202006;824;2273;637;1975;179;619;248;699;427;1318
353240;202006;2287;6219;1845;5471;264;905;1078;3053;1342;3958
353250;202006;1247;2803;743;1958;102;304;406;1017;508;1321
353260;202006;1144;2653;625;1783;95;315;294;786;389;1101
353270;202006;677;1747;566;1547;48;153;391;1005;439;1158
353280;202006;688;1876;475;1478;119;376;129;388;248;764
353282;202006;1774;4976;1478;4421;155;529;938;2647;1093;3176
353284;202006;359;834;183;498;20;74;80;189;100;263
353286;202006;171;432;103;321;13;40;34;100;47;140
353290;202006;1474;3917;903;2748;149;467;297;823;446;1290
353300;202006;1845;4992;1335;3972;217;728;592;1581;809;2309
353310;202006;393;949;281;741;21;70;190;469;211;539
353320;202006;658;1608;543;1443;9;39;471;1237;480;1276
353325;202006;654;1912;444;1453;94;299;166;528;260;827
353330;202006;532;1362;359;1033;43;129;201;544;244;673
353340;202006;2843;7674;1966;5958;408;1374;874;2468;1282;3842
353350;202006;3386;8769;2310;6595;506;1576;669;1665;1175;3241
353360;202006;615;1736;467;1449;58;184;264;809;322;993
353370;202006;553;1602;456;1450;37;126;320;982;357;1108
353380;202006;275;833;228;738;25;84;122;353;147;437
353390;202006;6013;14857;4442;12227;495;1544;2561;6648;3056;8192
353400;202006;421;1154;313;945;51;183;117;290;168;473
353410;202006;517;1383;389;1155;70;216;220;655;290;871
353420;202006;418;1095;243;710;58;163;19;43;77;206
353430;202006;2173;6026;1631;5021;366;1232;693;1999;1059;3231
353440;202006;62783;170263;44729;135161;7461;24461;23376;67117;30837;91578
353450;202006;360;915;240;707;34;120;118;317;152;437
353460;202006;3195;8697;2270;6865;165;573;1050;3053;1215;3626
353470;202006;7618;19999;5367;15817;884;2999;2322;6231;3206;9230
353475;202006;1478;3847;1018;2888;154;482;509;1340;663;1822
353480;202006;1599;4299;1265;3705;62;228;879;2487;941;2715
353490;202006;1087;2863;708;2131;103;340;319;904;422;1244
353500;202006;1016;2392;757;2000;163;440;415;1096;578;1536
353510;202006;773;2334;556;1797;139;496;141;380;280;876
353520;202006;1062;2777;666;2049;86;294;310;876;396;1170
353530;202006;2374;6289;1830;5310;254;832;971;2620;1225;3452
353540;202006;2023;5442;1638;4832;263;814;974;2810;1237;3624
353550;202006;5722;14698;4567;12849;748;2217;2599;7050;3347;9267
353560;202006;2199;5949;1612;5026;453;1551;446;1244;899;2795
353570;202006;590;1533;436;1285;48;152;256;708;304;860
353580;202006;2084;5512;1564;4475;333;966;746;2087;1079;3053
353590;202006;703;1844;455;1363;90;290;188;556;278;846
353600;202006;1697;4186;1265;3435;155;430;700;1850;855;2280
353610;202006;530;1562;375;1258;86;350;114;347;200;697
353620;202006;2643;7080;1837;5657;364;1258;595;1670;959;2928
353625;202006;481;1188;315;899;19;66;200;559;219;625
353630;202006;1262;3926;1042;3424;230;848;359;1076;589;1924
353640;202006;1354;3459;1079;3048;148;436;616;1735;764;2171
353650;202006;7779;20727;5749;16853;598;1978;3471;9564;4069;11542
353657;202006;389;1007;275;808;31;99;124;335;155;434
353660;202006;1254;2666;848;2122;379;953;198;475;577;1428
353670;202006;4016;11177;3081;9326;610;2065;1516;4249;2126;6314
353680;202006;671;1760;491;1492;80;264;270;779;350;1043
353690;202006;423;1086;186;575;21;63;34;93;55;156
353700;202006;1996;5242;1632;4626;122;399;1196;3254;1318;3653
353710;202006;4958;11065;2896;7398;269;719;1750;4035;2019;4754
353715;202006;425;1118;249;780;10;41;83;240;93;281
353720;202006;1948;5195;1494;4521;198;677;887;2622;1085;3299
353730;202006;4340;11458;3220;9414;483;1631;1616;4312;2099;5943
353740;202006;2001;5290;1384;4185;341;1116;455;1232;796;2348
353750;202006;820;2461;568;1962;136;511;103;359;239;870
353760;202006;12413;29034;9348;24826;1805;4937;5114;13309;6919;18246
353770;202006;714;2149;407;1372;66;248;59;172;125;420
353780;202006;5067;14200;3948;12018;802;2727;1872;5251;2674;7978
353790;202006;2533;7720;1831;6227;525;2004;382;1109;907;3113
353800;202006;17519;45978;13452;39355;1959;6106;7478;21833;9437;27939
353810;202006;1109;3007;701;2127;110;375;289;829;399;1204
353820;202006;1676;4536;1154;3480;236;770;377;1071;613;1841
353830;202006;609;1549;445;1274;76;230;195;524;271;754
353850;202006;1586;4438;1204;3689;276;859;422;1269;698;2128
353860;202006;2529;7041;1941;5976;469;1645;850;2353;1319;3998
353870;202006;28863;75958;20113;58664;2637;8745;10521;27883;13158;36628
353880;202006;3092;8532;2436;7273;200;693;1522;4367;1722;5060
353890;202006;2521;5506;1673;4327;139;374;1151;2842;1290;3216
353900;202006;741;2076;525;1642;82;283;206;596;288;879
353910;202006;2309;6401;1901;5741;198;705;1298;3836;1496;4541
353920;202006;1797;4978;1255;3926;297;1049;325;835;622;1884
353930;202006;4204;11213;2836;8662;505;1765;1149;3088;1654;4853
353940;202006;1058;3002;707;2294;127;425;242;727;369;1152
353950;202006;3174;8643;2413;7238;433;1426;1349;3753;1782;5179
353960;202006;694;1826;460;1372;89;288;191;542;280;830
353970;202006;661;1591;488;1331;46;138;326;865;372;1003
353980;202006;15862;40297;12233;33847;861;2737;8744;23217;9605;25954
353990;202006;894;2185;525;1509;87;267;240;660;327;927
354000;202006;2436;5905;1338;3798;302;908;224;603;526;1511
354010;202006;359;933;256;768;48;152;140;405;188;557
354020;202006;3347;9326;2609;7753;666;2132;1041;2822;1707;4954
354025;202006;705;1962;456;1450;62;226;123;371;185;597
354030;202006;485;1063;250;669;51;149;122;306;173;455
354040;202006;802;1876;507;1387;23;80;374;989;397;1069
354050;202006;936;2624;636;2078;146;505;199;646;345;1151
354060;202006;3282;9324;2238;7121;516;1758;793;2327;1309;4085
354070;202006;3555;9445;2393;7172;422;1454;982;2505;1404;3959
354075;202006;2535;7409;1930;6251;239;891;1095;3440;1334;4331
354080;202006;1338;3662;874;2748;192;639;208;590;400;1229
354085;202006;413;873;319;747;0;0;236;511;236;511
354090;202006;1615;4543;1373;4023;79;250;1066;3048;1145;3298
354100;202006;19118;52221;12953;41326;2860;9820;4936;15604;7796;25424
354105;202006;1488;3753;1002;2854;129;377;466;1249;595;1626
354110;202006;472;1306;318;1017;47;161;117;373;164;534
354120;202006;1381;3720;912;2711;186;606;309;797;495;1403
354130;202006;5379;14202;3515;10612;899;2906;209;410;1108;3316
354140;202006;18777;46016;12466;34399;2169;6620;5304;13506;7473;20126
354150;202006;2968;7057;2190;5810;489;1355;873;2252;1362;3607
354160;202006;2910;8443;2128;6845;610;2111;592;1735;1202;3846
354165;202006;624;1875;477;1584;81;312;247;771;328;1083
354170;202006;1719;4780;1430;4223;80;273;933;2635;1013;2908
354180;202006;387;1081;274;838;51;163;108;299;159;462
354190;202006;1458;4095;1004;3151;65;229;463;1397;528;1626
354200;202006;841;2058;645;1756;70;209;416;1081;486;1290
354210;202006;781;2055;619;1779;40;143;456;1235;496;1378
354220;202006;3076;8298;2258;6654;387;1220;1134;3184;1521;4404
354230;202006;732;1816;578;1627;39;144;424;1149;463;1293
354240;202006;1610;4476;1070;3376;185;639;325;910;510;1549
354250;202006;522;1266;319;952;93;275;77;242;170;517
354260;202006;8094;21534;6065;17943;1263;3979;2490;7105;3753;11084
354270;202006;1008;3040;811;2656;189;609;319;1019;508;1628
354280;202006;791;1988;672;1813;59;190;427;1067;486;1257
354290;202006;918;2913;766;2590;132;440;385;1337;517;1777
354300;202006;3512;10343;2957;9306;851;2685;1084;3396;1935;6081
354310;202006;699;2083;570;1809;134;446;214;632;348;1078
354320;202006;948;2312;608;1725;92;294;236;596;328;890
354323;202006;451;1096;301;827;35;76;130;347;165;423
354325;202006;1316;3916;918;3019;140;455;349;1108;489;1563
354330;202006;9194;23375;5991;16789;727;2390;3486;9068;4213;11458
354340;202006;31255;78705;20612;59917;3363;10952;10328;28613;13691;39565
354350;202006;1160;2991;918;2581;85;263;630;1694;715;1957
354360;202006;588;1511;335;1081;67;224;70;221;137;445
354370;202006;994;2869;784;2515;129;450;447;1407;576;1857
354380;202006;709;1863;502;1524;93;367;122;282;215;649
354390;202006;13274;32234;8392;23576;1568;4670;3334;8936;4902;13606
354400;202006;1546;4956;1157;4029;194;738;429;1461;623;2199
354410;202006;5652;15348;4237;12480;898;2879;1870;5205;2768;8084
354420;202006;1452;3833;1055;3096;136;431;648;1815;784;2246
354425;202006;2627;6402;1837;5024;433;1197;784;2147;1217;3344
354430;202006;1497;3992;1142;3420;126;440;670;1877;796;2317
354440;202006;552;1484;360;1085;58;193;157;434;215;627
354450;202006;415;1093;227;732;33;109;72;208;105;317
354460;202006;863;2176;559;1628;77;238;308;867;385;1105
354470;202006;466;1187;303;868;19;61;150;381;169;442
354480;202006;1192;2710;764;2019;69;190;514;1299;583;1489
354490;202006;808;2397;579;1882;97;349;270;814;367;1163
354500;202006;2025;5726;1657;5161;510;1713;391;1215;901;2928
354510;202006;718;2011;562;1700;54;175;300;821;354;996
354515;202006;330;955;241;768;40;146;101;307;141;453
354520;202006;6633;18277;4540;13717;665;2298;2484;6974;3149;9272
354530;202006;4216;12067;3200;10020;759;2423;1241;3911;2000;6334
354540;202006;1283;3414;920;2767;217;691;346;1043;563;1734
354550;202006;556;1456;430;1215;62;197;247;654;309;851
354560;202006;2131;5166;1136;3228;143;414;568;1508;711;1922
354570;202006;1197;3013;478;1376;79;236;60;168;139;404
354580;202006;8788;23009;5603;16925;853;2818;2788;8067;3641;10885
354600;202006;1848;4969;1402;4118;154;541;909;2518;1063;3059
354610;202006;433;1121;240;721;27;79;110;313;137;392
354620;202006;435;1227;269;896;50;190;99;298;149;488
354625;202006;306;816;160;515;30;98;24;51;54;149
354630;202006;1944;5845;1550;5021;554;1882;266;793;820;2675
354640;202006;3199;9171;2330;7413;405;1404;853;2519;1258;3923
354650;202006;865;2255;682;1951;56;156;425;1201;481;1357
354660;202006;3695;8613;1893;5558;175;629;897;2393;1072;3022
354670;202006;1072;3002;729;2294;153;513;264;753;417;1266
354680;202006;5131;13551;3888;11467;902;2776;1926;5797;2828;8573
354690;202006;495;1586;350;1257;77;284;93;329;170;613
354700;202006;859;2282;601;1775;88;279;295;831;383;1110
354710;202006;463;1259;329;993;39;131;144;374;183;505
354720;202006;283;684;124;368;40;127;28;82;68;209
354730;202006;9682;27227;7184;22377;1036;3529;4008;12013;5044;15542
354740;202006;315;851;122;404;18;70;19;56;37;126
354750;202006;2503;6451;1582;4700;264;853;703;1880;967;2733
354760;202006;1984;5364;1351;4135;328;1102;422;1164;750;2266
354765;202006;374;995;141;455;21;70;28;78;49;148
354770;202006;2283;5665;1664;4604;314;965;784;2021;1098;2986
354780;202006;53114;135383;39631;108485;4441;13674;24510;62947;28951;76621
354790;202006;959;2646;744;2286;82;278;451;1325;533;1603
354800;202006;2555;6576;1982;5693;498;1460;849;2306;1347;3766
354805;202006;1334;3057;894;2408;99;268;529;1324;628;1592
354810;202006;648;1905;362;1284;45;188;82;267;127;455
354820;202006;948;2717;667;2163;118;424;191;497;309;921
354830;202006;443;1091;279;791;55;168;96;255;151;423
354840;202006;933;2308;554;1547;51;152;318;832;369;984
354850;202006;21293;55286;14542;42962;1674;5716;8621;24075;10295;29791
354860;202006;1730;4902;1034;3372;176;627;303;892;479;1519
354870;202006;56382;142718;43038;117783;4766;14400;26623;68854;31389;83254
354880;202006;5782;14308;2726;7723;323;1073;1043;2395;1366;3468
354890;202006;16391;40866;12583;34412;1712;5302;7485;19747;9197;25049
354900;202006;400;999;249;729;40;128;71;182;111;310
354910;202006;5354;14054;3149;9994;708;2374;534;1621;1242;3995
354920;202006;476;1276;217;743;27;109;44;156;71;265
354925;202006;289;826;171;550;18;59;38;107;56;166
354930;202006;401;943;233;658;16;53;118;306;134;359
354940;202006;2270;6855;1566;5252;536;1922;275;839;811;2761
354950;202006;1472;3815;1162;3378;60;245;860;2354;920;2599
354960;202006;906;2414;684;2081;55;198;395;1140;450;1338
354970;202006;4129;11554;3180;9897;367;1285;2012;6061;2379;7346
354980;202006;32466;76913;21408;57750;2349;7586;12938;32414;15287;40000
354990;202006;63661;161417;47066;130937;4024;13002;30440;79874;34464;92876
354995;202006;2777;6335;2077;5405;178;556;1493;3696;1671;4252
355000;202006;1572;3933;1176;3359;182;609;571;1500;753;2109
355010;202006;3731;10177;2167;6820;724;2352;226;736;950;3088
355020;202006;3581;10089;2598;8328;603;2132;946;2856;1549;4988
355030;202006;1339689;3292192;948310;2527619;146676;429476;467771;1148227;614447;1577703
355040;202006;2828;7129;2195;6295;322;920;1497;4335;1819;5255
355050;202006;969;2268;689;1849;174;517;264;647;438;1164
355060;202006;6025;16344;4325;13098;723;2544;2085;5728;2808;8272
355070;202006;8715;22569;6931;19676;816;2683;4432;11843;5248;14526
355080;202006;911;2605;551;1903;108;410;78;214;186;624
355090;202006;1094;3183;817;2692;215;706;245;835;460;1541
355100;202006;22370;58637;17082;50652;2781;8727;10123;29720;12904;38447
355110;202006;815;2293;584;1920;178;657;106;320;284;977
355120;202006;682;1796;482;1496;35;122;204;594;239;716
355130;202006;874;1952;412;1105;29;91;235;592;264;683
355140;202006;1876;4294;1570;3867;100;294;1290;3077;1390;3371
355150;202006;4209;11141;3311;9530;389;1251;2090;5765;2479;7016
355160;202006;1971;5414;1406;4375;356;1203;331;981;687;2184
355170;202006;9963;25375;7651;21438;1475;4466;4012;10871;5487;15337
355180;202006;2772;7506;1938;6073;414;1439;696;1996;1110;3435
355190;202006;1850;4840;1443;4206;348;1007;760;2346;1108;3353
355200;202006;825;2543;689;2318;183;680;285;910;468;1590
355210;202006;2833;7773;2187;6439;423;1410;1105;3035;1528;4445
355220;202006;43552;116035;33858;97213;8064;24668;13703;36427;21767;61095
355230;202006;1146;2876;620;1831;111;309;218;604;329;913
355240;202006;23393;61989;16043;47124;2261;7199;8514;23606;10775;30805
355250;202006;36888;99109;26715;79062;6695;20901;9822;27674;16517;48575
355255;202006;693;1748;360;1113;60;208;136;403;196;611
355260;202006;1406;3527;1020;2861;133;450;584;1510;717;1960
355270;202006;1167;3494;896;2922;206;693;298;901;504;1594
355280;202006;29553;76151;20523;58772;3024;9366;9788;26424;12812;35790
355290;202006;862;2386;642;1972;138;406;259;774;397;1180
355300;202006;1249;3672;957;3055;184;661;328;977;512;1638
355310;202006;962;2677;723;2272;100;309;394;1258;494;1567
355320;202006;533;1409;394;1154;78;260;158;378;236;638
355330;202006;2780;7099;2096;5907;142;518;1572;4214;1714;4732
355340;202006;3981;8839;3052;7585;393;879;1897;4825;2290;5704
355350;202006;1276;3717;937;3059;204;685;326;1055;530;1740
355360;202006;1150;2955;877;2551;118;371;533;1528;651;1899
355365;202006;360;952;185;633;40;125;31;110;71;235
355370;202006;5292;13542;4051;11591;977;2603;1801;5667;2778;8270
355380;202006;2843;7630;2110;6237;390;1241;755;1947;1145;3188
355385;202006;1435;3778;1167;3377;111;389;736;1954;847;2343
355390;202006;816;2246;579;1715;131;418;228;612;359;1030
355395;202006;1948;5358;1333;4105;234;774;460;1256;694;2030
355400;202006;8973;25869;7029;21954;1742;6190;2455;6847;4197;13037
355410;202006;22070;60429;13541;43031;2903;10181;3397;10608;6300;20789
355420;202006;615;1990;499;1758;143;554;122;418;265;972
355430;202006;3687;9414;2739;7691;661;1817;1237;3457;1898;5274
355440;202006;792;2157;471;1473;86;282;138;401;224;683
355450;202006;3084;7993;1960;5735;360;1130;802;2117;1162;3247
355460;202006;491;1204;306;899;45;170;137;356;182;526
355465;202006;399;1053;301;888;45;138;155;452;200;590
355470;202006;1065;2751;595;1818;161;552;185;501;346;1053
355475;202006;353;839;279;729;17;41;204;516;221;557
355480;202006;3747;10417;3045;9372;453;1611;1966;5874;2419;7485
355490;202006;943;2528;505;1565;35;122;268;757;303;879
355495;202006;782;2240;568;1844;70;264;201;594;271;858
355500;202006;6520;16951;3767;11424;588;1964;1257;3526;1845;5490
355510;202006;1290;3149;799;2307;108;363;348;890;456;1253
355520;202006;370;826;167;493;28;80;48;134;76;214
355530;202006;406;945;142;422;19;70;52;136;71;206
355535;202006;506;1395;379;1182;76;297;170;472;246;769
355540;202006;10432;26384;8448;23520;1330;4012;5364;14498;6694;18510
355550;202006;619;1837;503;1622;68;247;270;815;338;1062
355560;202006;1097;2831;581;1819;131;460;36;114;167;574
355570;202006;247;709;133;436;23;75;33;106;56;181
355580;202006;1186;2918;782;2227;142;448;320;852;462;1300
355590;202006;170;428;130;361;19;58;78;205;97;263
355600;202006;1438;3504;957;2704;184;561;394;1081;578;1642
355610;202006;1724;4283;1141;3257;132;421;607;1647;739;2068
355620;202006;4512;12066;3303;9707;371;1326;1831;4946;2202;6272
355630;202006;2269;6274;1566;4923;255;837;773;2401;1028;3238
355635;202006;869;2537;634;2073;118;440;186;538;304;978
355640;202006;2943;8257;1935;6204;382;1324;579;1780;961;3104
355645;202006;4141;11658;2987;9613;437;1522;1603;5064;2040;6586
355650;202006;6536;17617;5093;14949;1399;4265;1697;4491;3096;8756
355660;202006;1278;3334;869;2569;137;460;299;871;436;1331
355670;202006;3415;9217;2222;6538;288;997;1120;2906;1408;3903
355680;202006;2707;7468;1153;3808;303;1054;123;422;426;1476
355690;202006;792;2358;499;1744;111;424;20;46;131;470
355695;202006;240;677;139;454;12;59;25;55;37;114
355700;202006;7069;20354;5688;17233;999;3183;2992;8610;3991;11793
355710;202006;8636;20442;5499;14674;849;2511;2487;5896;3336;8407
355715;202006;478;1276;245;752;52;174;47;126;99;300
355720;202006;1451;4087;1133;3515;187;625;603;1755;790;2380
355730;202006;903;2505;730;2172;136;443;326;877;462;1320
410010;202006;1215;3393;907;2727;195;636;186;543;381;1179
410020;202006;1012;3106;781;2561;277;855;176;607;453;1462
410030;202006;1484;4133;1248;3754;169;570;682;2052;851;2622
410040;202006;12110;33576;8777;27272;1940;6428;2777;7997;4717;14425
410045;202006;862;2289;601;1803;84;283;217;608;301;891
410050;202006;2328;5832;1544;4447;308;970;501;1352;809;2322
410060;202006;2025;5786;1559;4824;365;1203;499;1482;864;2685
410070;202006;1898;4827;1379;3863;219;681;549;1407;768;2088
410080;202006;1347;3619;948;2863;211;659;312;953;523;1612
410090;202006;1067;2752;910;2500;85;227;561;1607;646;1834
410100;202006;1823;5292;1197;3754;174;622;156;468;330;1090
410105;202006;480;1212;267;800;32;100;85;236;117;336
410110;202006;3035;7740;2093;5908;266;806;925;2487;1191;3293
410115;202006;587;1515;418;1219;54;178;165;460;219;638
410120;202006;2549;7257;2218;6721;492;1646;1129;3290;1621;4936
410130;202006;1198;3237;1034;2924;198;657;518;1348;716;2005
410140;202006;15541;37703;9776;27227;1799;5515;2508;6323;4307;11838
410150;202006;16294;38408;7971;22023;1359;4151;1865;4687;3224;8838
410160;202006;2814;7820;2239;6797;511;1695;780;2369;1291;4064
410165;202006;731;1947;596;1670;54;187;356;924;410;1111
410170;202006;2683;6996;1751;4979;405;1259;126;371;531;1630
410180;202006;14607;40735;11095;33478;1513;4990;5850;16501;7363;21491
410185;202006;440;1280;307;944;55;179;91;254;146;433
410190;202006;2208;5483;1568;4340;328;934;418;1108;746;2042
410200;202006;5218;12073;2831;7909;456;1493;446;1195;902;2688
410210;202006;3038;7666;1861;5495;300;1005;636;1607;936;2612
410220;202006;513;1319;326;965;55;179;78;222;133;401
410230;202006;1671;4476;1268;3649;172;569;659;1747;831;2316
410240;202006;4878;12961;3318;9928;822;2723;295;803;1117;3526
410250;202006;2628;6237;1920;5083;147;488;942;2424;1089;2912
410260;202006;1842;4633;1136;3284;189;561;494;1410;683;1971
410270;202006;455;1209;326;985;47;155;121;354;168;509
410275;202006;651;1833;448;1403;61;203;191;553;252;756
410280;202006;2266;6097;1478;4508;232;780;573;1614;805;2394
410290;202006;3234;9133;2188;6862;582;1838;563;1748;1145;3586
410300;202006;635;1606;499;1379;40;127;255;661;295;788
410302;202006;380;946;199;601;25;85;96;280;121;365
410304;202006;1217;3171;1013;2799;113;305;608;1635;721;1940
410305;202006;1746;4178;1183;3356;128;405;734;2010;862;2415
410310;202006;2478;7063;1948;6018;337;1130;887;2738;1224;3868
410315;202006;659;1574;342;1057;121;377;82;253;203;630
410320;202006;1056;2931;712;2210;114;397;131;383;245;780
410322;202006;565;1490;308;914;33;107;160;441;193;548
410330;202006;1495;3659;1016;2749;171;502;295;784;466;1286
410335;202006;825;2240;633;1877;97;314;284;783;381;1097
410337;202006;840;2039;583;1541;67;186;245;611;312;797
410340;202006;491;1375;332;977;29;97;160;394;189;491
410345;202006;2392;6181;1191;3526;249;777;328;859;577;1636
410347;202006;733;1875;532;1506;46;155;175;500;221;655
410350;202006;1382;3527;994;2862;136;401;409;1128;545;1529
410360;202006;4271;10443;3270;8701;380;1108;1817;4643;2197;5751
410370;202006;12959;35165;8276;23943;1007;3197;3472;8885;4479;12082
410380;202006;1543;3902;1127;3139;155;440;387;992;542;1432
410390;202006;2599;6655;1678;4945;383;1256;501;1347;884;2603
410395;202006;883;2539;719;2191;146;479;291;880;437;1359
410400;202006;6226;16493;4566;13200;685;2112;2197;5991;2882;8103
410405;202006;808;1950;594;1632;109;339;260;666;369;1005
410410;202006;1211;3287;1131;3160;163;540;712;2056;875;2596
410420;202006;9537;26537;7117;21687;1199;4083;2661;7262;3860;11345
410425;202006;3127;8788;2118;6686;357;1228;772;2208;1129;3436
410430;202006;12763;32109;8761;24696;1388;4322;3042;8043;4430;12365
410440;202006;2281;6833;1942;6186;291;1039;1021;3190;1312;4229
410442;202006;2169;6628;1805;5824;523;1756;575;1771;1098;3527
410445;202006;2235;6530;1635;5337;316;1179;375;1294;691;2473
410450;202006;1414;3550;1038;2938;200;626;375;996;575;1622
410460;202006;1980;4884;1516;4148;165;457;758;2015;923;2472
410465;202006;2671;7764;2076;6609;386;1292;746;2230;1132;3522
410470;202006;1986;5533;1388;4402;361;1311;222;744;583;2055
410480;202006;36482;86560;18902;55081;3033;9921;4010;9962;7043;19883
410490;202006;10938;30475;7739;23772;1441;4819;3010;8701;4451;13520
410500;202006;1820;4827;1254;3713;271;923;359;935;630;1858
410510;202006;1842;4547;1196;3336;239;665;330;924;569;1589
410520;202006;3007;9486;2667;8780;912;3082;927;3139;1839;6221
410530;202006;1613;4004;775;2228;103;300;185;435;288;735
410540;202006;2694;7303;1842;5557;278;913;854;2482;1132;3395
410550;202006;7209;19386;4621;13570;808;2582;1252;3162;2060;5744
410560;202006;1436;3798;1056;3000;239;745;368;911;607;1656
410570;202006;2431;6764;1779;5578;481;1773;201;670;682;2443
410580;202006;24803;64903;17850;52012;3510;10955;7440;20313;10950;31268
410590;202006;1544;4423;1022;3158;145;469;293;791;438;1260
410600;202006;1772;4742;1343;3906;283;789;478;1436;761;2225
410610;202006;710;1883;519;1512;61;214;225;615;286;829
410620;202006;2333;6771;1529;4849;332;1164;270;790;602;1954
410630;202006;2390;6308;1545;4557;299;1011;299;710;598;1721
410640;202006;4529;10635;3021;7995;669;2071;405;1062;1074;3133
410645;202006;1032;2956;837;2698;269;893;351;1154;620;2047
410650;202006;2169;5946;1462;4484;290;963;521;1466;811;2429
410655;202006;896;2155;631;1683;26;82;324;822;350;904
410657;202006;637;1722;388;1167;51;191;141;348;192;539
410660;202006;3331;8617;1864;5385;334;1014;478;1301;812;2315
410670;202006;1044;2621;622;1794;124;366;224;592;348;958
410680;202006;2601;7886;1842;5943;446;1495;335;1098;781;2593
410685;202006;527;1346;395;1119;94;312;157;393;251;705
410690;202006;127130;311969;82692;228699;13228;41866;31069;75653;44297;117519
410700;202006;2415;6171;2020;5545;294;835;1053;2818;1347;3653
410710;202006;863;2179;564;1614;89;261;228;611;317;872
410712;202006;628;1821;514;1595;131;448;188;556;319;1004
410715;202006;797;2312;482;1591;70;234;169;529;239;763
410720;202006;3092;7863;2401;6529;322;1032;518;1386;840;2418
410725;202006;1053;2587;594;1730;116;365;86;207;202;572
410730;202006;618;1651;470;1382;106;359;96;270;202;629
410740;202006;924;2590;673;2108;92;317;266;820;358;1137
410750;202006;1749;4431;1375;3731;204;628;625;1605;829;2233
410752;202006;364;925;178;539;26;82;80;222;106;304
410753;202006;296;893;199;672;31;125;45;136;76;261
410754;202006;1074;2766;885;2474;53;116;607;1807;660;1923
410755;202006;585;1516;398;1138;56;172;175;440;231;612
410760;202006;3524;9110;2513;7256;636;2094;564;1474;1200;3568
410765;202006;12750;35797;9826;29966;1663;5552;2024;5488;3687;11040
410770;202006;1044;2498;720;1950;64;184;364;984;428;1168
410773;202006;1235;3323;1073;3078;110;356;658;1829;768;2185
410775;202006;1472;3675;1276;3380;69;208;845;2190;914;2398
410780;202006;614;1523;397;1100;64;194;97;250;161;444
410785;202006;723;1900;555;1613;92;296;195;576;287;872
410790;202006;754;2126;609;1840;166;561;68;144;234;705
410800;202006;3370;7457;2710;6496;50;171;1768;4128;1818;4299
410810;202006;406;1080;316;907;23;72;164;424;187;496
410820;202006;859;2446;439;1369;88;293;82;222;170;515
410830;202006;34065;83075;22655;63724;4643;14949;7971;21048;12614;35997
410832;202006;986;2572;777;2198;91;291;448;1197;539;1488
410840;202006;7959;20394;4669;14033;857;2804;1199;3349;2056;6153
410845;202006;1138;2848;893;2481;169;498;373;1013;542;1511
410850;202006;2187;6338;1896;5797;301;1016;950;2811;1251;3827
410855;202006;765;1915;499;1407;43;119;237;619;280;738
410860;202006;4309;10628;3358;9064;349;1092;1885;4815;2234;5907
410865;202006;1350;4004;1174;3641;135;466;696;2199;831;2665
410870;202006;1262;3390;1036;3001;81;255;703;2016;784;2271
410880;202006;4461;12035;3118;9521;538;1736;462;1543;1000;3279
410890;202006;948;2705;692;2194;151;528;179;561;330;1089
410895;202006;980;3140;830;2809;253;942;183;574;436;1516
410900;202006;841;2226;576;1702;105;318;107;265;212;583
410910;202006;372;884;226;612;13;49;134;333;147;382
410920;202006;846;2017;580;1583;76;228;288;770;364;998
410930;202006;1626;4188;1107;3263;265;918;232;666;497;1584
410940;202006;22116;60652;15758;48965;3250;11196;4845;14714;8095;25910
410950;202006;1894;5553;1674;5211;48;187;1395;4289;1443;4476
410960;202006;7339;18466;4886;14211;1138;3642;1802;5205;2940;8847
410965;202006;1064;2709;721;2055;84;260;407;1154;491;1414
410970;202006;3866;10429;2663;8078;610;2210;369;943;979;3153
410975;202006;1322;3300;1000;2779;106;320;494;1351;600;1671
410980;202006;6857;17322;4272;12597;509;1691;1804;4918;2313;6609
410990;202006;1381;3370;905;2622;220;732;295;826;515;1558
411000;202006;603;1607;399;1209;49;177;124;316;173;493
411005;202006;442;1149;267;775;47;149;79;201;126;350
411007;202006;2252;6320;1833;5593;438;1404;638;1938;1076;3342
411010;202006;4118;12361;3223;10504;831;2941;367;1080;1198;4021
411020;202006;2198;6324;1794;5583;529;1709;497;1509;1026;3218
411030;202006;760;1886;530;1410;33;120;300;702;333;822
411040;202006;948;2377;480;1336;52;173;168;412;220;585
411050;202006;1862;5812;1505;5016;396;1424;230;662;626;2086
411060;202006;1828;4753;1143;3417;260;911;192;509;452;1420
411065;202006;384;999;258;754;35;115;113;305;148;420
411070;202006;6994;17937;5499;15401;772;2404;2688;7276;3460;9680
411080;202006;2065;5467;1613;4657;412;1357;322;905;734;2262
411090;202006;847;2223;551;1645;48;171;155;438;203;609
411095;202006;1549;3658;1048;2883;121;354;334;882;455;1236
411100;202006;1161;3005;796;2345;86;292;255;766;341;1058
411110;202006;632;1629;281;876;36;112;17;37;53;149
411120;202006;1248;3477;1029;3061;322;1099;227;610;549;1709
411125;202006;5132;14973;4531;13820;973;2908;2195;7010;3168;9918
411130;202006;689;1863;482;1471;90;250;178;576;268;826
411140;202006;2215;6860;1863;6095;548;1928;485;1545;1033;3473
411150;202006;3806;9756;2535;7165;504;1650;252;519;756;2169
411155;202006;951;2420;550;1662;80;234;229;658;309;892
411160;202006;356;817;234;654;31;94;53;152;84;246
411170;202006;707;2118;527;1696;122;384;176;555;298;939
411180;202006;5402;14270;4151;12047;613;1992;2010;5465;2623;7457
411190;202006;1640;4217;1205;3437;204;621;473;1225;677;1846
411200;202006;4885;13254;3361;10331;856;2920;643;1701;1499;4621
411210;202006;3104;6922;2006;5109;348;997;654;1570;1002;2567
411220;202006;835;2164;583;1675;133;421;166;446;299;867
411230;202006;865;2287;613;1795;122;379;227;655;349;1034
411240;202006;1524;3695;991;2706;104;337;478;1195;582;1532
411250;202006;2201;5866;1604;4776;318;1090;507;1455;825;2545
411260;202006;340;897;219;645;29;89;86;222;115;311
411270;202006;1982;5309;1473;4276;204;626;739;1979;943;2605
411275;202006;1427;3279;973;2531;147;459;435;1050;582;1509
411280;202006;1313;3557;862;2679;228;722;120;361;348;1083
411290;202006;806;2124;515;1548;51;140;268;834;319;974
411295;202006;1217;3060;858;2348;101;293;378;967;479;1260
411300;202006;1015;2536;631;1790;56;173;290;722;346;895
411310;202006;857;1988;652;1683;48;118;290;730;338;848
411320;202006;5378;13977;3885;11263;672;2092;1618;4196;2290;6288
411325;202006;1385;3969;1173;3604;192;584;663;2103;855;2687
411330;202006;3326;8979;2393;7257;542;1783;750;2287;1292;4070
411340;202006;831;2269;489;1504;69;232;166;480;235;712
411342;202006;1031;2495;596;1641;103;301;235;614;338;915
411345;202006;1021;2657;766;2233;61;196;551;1622;612;1818
411350;202006;2590;7076;1657;5167;431;1458;234;670;665;2128
411360;202006;696;1691;489;1352;66;187;161;428;227;615
411370;202006;53461;131351;37776;104641;2745;9212;22718;59045;25463;68257
411373;202006;1356;3450;1096;3061;92;319;594;1670;686;1989
411375;202006;1094;2768;796;2202;130;375;309;823;439;1198
411380;202006;1117;2591;740;1871;37;103;453;1067;490;1170
411390;202006;1490;4110;1154;3380;186;605;467;1202;653;1807
411400;202006;2233;5574;1671;4514;171;549;846;2174;1017;2723
411410;202006;2368;6570;1705;5126;369;1218;395;1146;764;2364
411420;202006;4037;9972;2147;6310;306;1039;386;870;692;1909
411430;202006;3379;9159;2528;7530;545;1769;881;2390;1426;4159
411435;202006;410;1151;255;811;51;154;79;207;130;361
411440;202006;2429;6831;1949;5914;400;1317;690;2034;1090;3351
411450;202006;2460;6576;1871;5594;245;737;1005;3051;1250;3788
411460;202006;3978;10284;2461;7348;404;1430;458;1233;862;2663
411470;202006;736;1917;532;1518;96;287;200;524;296;811
411480;202006;4735;12660;3422;10184;689;2435;1214;3256;1903;5691
411490;202006;1599;4129;1212;3481;155;516;510;1332;665;1848
411500;202006;1257;3405;826;2465;148;489;164;403;312;892
411510;202006;2264;5810;1789;4976;391;1262;418;1174;809;2436
411520;202006;29862;72663;16707;46961;1958;6401;6298;15911;8256;22312
411530;202006;920;2426;549;1698;92;316;87;247;179;563
411535;202006;471;1369;279;900;29;108;82;211;111;319
411540;202006;2682;6567;1797;4949;168;538;904;2394;1072;2932
411545;202006;912;2621;754;2342;73;228;490;1540;563;1768
411550;202006;697;1766;486;1372;70;216;83;245;153;461
411560;202006;1933;5215;1097;3406;158;547;78;222;236;769
411570;202006;7345;17056;4860;13215;1079;3214;859;2320;1938;5534
411573;202006;748;2033;633;1858;97;297;325;934;422;1231
411575;202006;1954;5337;1437;4271;283;920;348;1023;631;1943
411580;202006;4604;10552;2708;7609;394;1369;494;1262;888;2631
411585;202006;637;1893;273;891;65;226;50;141;115;367
411590;202006;376;1049;252;776;28;82;132;376;160;458
411600;202006;291;741;186;575;41;129;55;160;96;289
411605;202006;1551;3598;961;2640;124;432;505;1358;629;1790
411610;202006;2510;6010;1764;4646;72;241;1174;2871;1246;3112
411620;202006;2780;7425;2350;6746;402;1213;1278;3661;1680;4874
411630;202006;742;1934;494;1452;76;269;175;463;251;732
411640;202006;464;1213;323;909;46;145;120;307;166;452
411650;202006;197;581;125;419;24;86;22;59;46;145
411660;202006;913;2297;660;1841;53;159;297;795;350;954
411670;202006;1357;3335;913;2449;101;297;422;1054;523;1351
411680;202006;1432;3827;1049;3070;139;460;466;1312;605;1772
411690;202006;3668;9401;2737;7761;581;1685;818;2452;1399;4137
411695;202006;650;1993;409;1334;49;176;171;522;220;698
411700;202006;1617;4199;1023;3052;224;734;151;419;375;1153
411705;202006;1872;5817;1579;5311;298;963;907;3274;1205;4237
411710;202006;1902;4843;1288;3690;287;848;238;657;525;1505
411720;202006;1061;2472;751;1927;150;405;286;688;436;1093
411721;202006;964;2442;710;1962;146;397;172;475;318;872
411722;202006;812;2156;452;1309;65;217;173;414;238;631
411725;202006;1163;3267;791;2526;186;639;169;549;355;1188
411727;202006;1465;4086;941;2945;216;704;171;504;387;1208
411729;202006;693;1675;432;1172;51;191;165;386;216;577
411730;202006;5113;13649;3932;11308;814;2509;1649;4661;2463;7170
411740;202006;533;1378;262;791;54;149;59;161;113;310
411745;202006;758;2158;498;1564;74;250;76;177;150;427
411750;202006;5075;13419;3657;10621;501;1581;1783;4886;2284;6467
411760;202006;6594;17697;5036;14964;1683;5191;993;3274;2676;8465
411770;202006;2940;8534;2130;6734;521;1752;312;916;833;2668
411780;202006;2741;7739;2319;6930;642;2007;782;2354;1424;4361
411790;202006;2765;6706;1453;4318;311;1055;222;569;533;1624
411800;202006;975;2757;702;2148;120;383;147;429;267;812
411810;202006;1565;4075;1165;3272;191;552;540;1431;731;1983
411820;202006;10962;31551;8788;27680;2187;7379;3700;11374;5887;18753
411830;202006;576;1426;432;1184;82;246;100;295;182;541
411840;202006;11681;31315;7726;22981;1352;4343;2007;5478;3359;9821
411845;202006;538;1565;296;970;35;137;64;191;99;328
411850;202006;7124;18253;4784;14106;1209;4020;784;2109;1993;6129
411860;202006;662;1875;474;1477;69;219;128;360;197;579
411870;202006;583;1694;401;1277;87;310;98;273;185;583
411880;202006;2231;5596;1621;4606;224;726;563;1537;787;2263
411885;202006;1026;2622;720;2076;104;351;234;620;338;971
411890;202006;1321;3516;910;2740;156;525;97;279;253;804
411900;202006;799;2200;486;1522;111;377;76;218;187;595
411910;202006;917;2726;655;2156;159;585;233;706;392;1291
411915;202006;14906;36566;9751;27173;1466;4596;3773;9403;5239;13999
411920;202006;1080;3193;897;2795;198;716;319;911;517;1627
411925;202006;460;1214;324;965;69;234;128;354;197;588
411930;202006;4888;15112;4095;13568;1759;6356;270;1053;2029;7409
411940;202006;3224;9631;2458;7921;602;2021;765;2223;1367;4244
411950;202006;13828;37346;11291;33143;1609;5346;6550;18429;8159;23775
411960;202006;5788;15642;4549;13092;843;2680;1723;4686;2566;7366
411965;202006;461;1282;326;1001;49;167;137;387;186;554
411970;202006;1069;2509;821;2174;165;415;360;1076;525;1491
411980;202006;1463;3650;1045;2953;256;737;379;1034;635;1771
411990;202006;38176;100178;23952;73663;4481;15238;8162;23977;12643;39215
411995;202006;3181;7890;2376;6632;681;2130;672;1766;1353;3896
412000;202006;1919;4427;1344;3448;31;99;952;2292;983;2391
412010;202006;578;1806;419;1454;70;255;118;354;188;609
412015;202006;542;1518;441;1337;56;183;261;786;317;969
412020;202006;438;1218;270;849;39;151;115;334;154;485
412030;202006;604;1692;425;1359;71;231;123;382;194;613
412033;202006;894;2362;633;1821;84;240;225;570;309;810
412035;202006;760;2052;481;1532;53;207;259;776;312;983
412040;202006;578;1549;361;1106;50;147;69;210;119;357
412050;202006;1620;4058;1087;3068;214;694;268;745;482;1439
412060;202006;7170;21027;5937;18539;1581;5629;1709;5070;3290;10699
412065;202006;607;1676;438;1327;99;321;108;327;207;648
412070;202006;1127;2906;884;2419;111;326;363;915;474;1241
412080;202006;2045;5762;1306;4195;195;662;259;734;454;1396
412085;202006;293;704;100;309;10;31;20;55;30;86
412090;202006;5731;14995;4234;12158;1111;3326;1484;4349;2595;7675
412100;202006;1577;4332;1182;3590;347;1153;260;864;607;2017
412110;202006;811;2122;553;1600;80;238;185;507;265;745
412120;202006;1939;5648;1487;4745;290;1029;431;1185;721;2214
412125;202006;640;1822;446;1414;92;301;124;370;216;671
412130;202006;778;1991;530;1510;79;245;142;407;221;652
412135;202006;619;1648;279;848;44;137;93;251;137;388
412140;202006;1648;4009;1079;3006;198;673;219;577;417;1250
412150;202006;2714;7184;2289;6427;332;1075;1385;3656;1717;4731
412160;202006;935;2893;516;1762;95;346;85;257;180;603
412170;202006;4269;11800;3559;10647;731;2393;1444;3991;2175;6384
412175;202006;1274;3675;1054;3292;225;727;459;1453;684;2180
412180;202006;1594;4416;1143;3556;140;510;532;1530;672;2040
412190;202006;3303;8307;2431;6767;321;973;1067;2947;1388;3920
412200;202006;1686;5042;1203;3903;327;1168;193;571;520;1739
412210;202006;598;1437;350;987;48;153;130;329;178;482
412215;202006;3279;8921;2573;7540;639;1835;1099;3561;1738;5396
412217;202006;959;2514;809;2247;56;168;538;1449;594;1617
412220;202006;5894;16256;4680;14013;1225;3615;1459;4678;2684;8293
412230;202006;2581;7654;2050;6621;361;1312;554;1537;915;2849
412240;202006;6817;17526;4266;12553;762;2436;1271;3412;2033;5848
412250;202006;2010;5188;1490;4200;354;1052;339;894;693;1946
412260;202006;1200;3227;849;2466;150;463;260;711;410;1174
412265;202006;882;2408;691;2076;142;442;285;820;427;1262
412270;202006;965;2619;618;1892;81;283;243;661;324;944
412280;202006;395;1110;309;970;61;205;96;276;157;481
412290;202006;995;2548;667;1949;104;324;211;574;315;898
412300;202006;1646;4255;1129;3326;249;774;246;749;495;1523
412310;202006;736;2044;593;1768;89;320;227;624;316;944
412320;202006;841;2185;544;1563;60;207;184;533;244;740
412330;202006;1507;4079;999;3076;189;647;336;1059;525;1706
412340;202006;1129;3175;688;2181;99;369;118;340;217;709
412350;202006;2778;7200;1753;5165;352;1092;316;843;668;1935
412360;202006;270;743;182;541;5;26;109;302;114;328
412370;202006;861;2467;577;1845;114;415;50;167;164;582
412380;202006;1504;4087;1053;3168;288;896;136;475;424;1371
412382;202006;510;1270;333;979;45;159;136;332;181;491
412385;202006;2142;5908;1730;5099;539;1510;538;1766;1077;3276
412390;202006;2380;5778;1920;5079;315;833;741;1976;1056;2809
412395;202006;675;1930;465;1444;55;153;201;637;256;790
412400;202006;900;2412;641;1907;128;422;178;525;306;947
412402;202006;1944;4812;1294;3704;320;945;171;495;491;1440
412405;202006;2948;7781;1903;5792;494;1796;50;154;544;1950
412410;202006;5719;14883;4168;12310;748;2543;1385;3893;2133;6436
412420;202006;511;1312;328;948;23;83;159;399;182;482
412430;202006;595;1483;307;881;32;106;123;328;155;434
412440;202006;2643;7261;1755;5524;441;1489;280;913;721;2402
412450;202006;419;1225;279;864;45;138;26;62;71;200
412460;202006;1006;2647;786;2266;143;451;369;1043;512;1494
412470;202006;1437;4710;1175;4101;308;1131;252;882;560;2013
412480;202006;1009;2688;648;1886;120;378;190;488;310;866
412490;202006;1273;3233;1014;2748;122;331;516;1328;638;1659
412500;202006;1880;4742;1394;3826;299;809;407;1079;706;1888
412510;202006;1855;5723;1270;4203;289;1029;124;340;413;1369
412520;202006;1191;3127;625;1878;149;445;55;169;204;614
412530;202006;712;1879;520;1479;82;257;108;303;190;560
412535;202006;784;2038;524;1531;85;268;109;268;194;536
412540;202006;1194;3047;858;2414;95;340;279;823;374;1163
412545;202006;672;1731;464;1293;66;185;176;474;242;659
412550;202006;31488;84505;21846;64920;3710;12039;8579;23341;12289;35380
412555;202006;288;760;188;538;20;59;54;115;74;174
412560;202006;4597;13445;3350;10481;583;1999;985;3079;1568;5078
412570;202006;4355;11122;2456;7372;511;1727;303;1012;814;2739
412575;202006;985;2493;779;2130;90;275;427;1091;517;1366
412580;202006;1409;3725;982;2885;88;311;516;1458;604;1769
412590;202006;409;1084;220;697;30;99;21;51;51;150
412600;202006;1552;4240;1151;3424;183;627;486;1348;669;1975
412610;202006;782;2045;548;1536;54;153;291;733;345;886
412620;202006;1210;3158;913;2701;174;593;279;772;453;1365
412625;202006;8578;22750;5180;15888;720;2519;341;931;1061;3450
412627;202006;1121;3145;697;2251;136;467;190;613;326;1080
412630;202006;2823;8260;1988;6407;386;1258;606;1789;992;3047
412635;202006;381;1036;258;766;38;130;88;215;126;345
412640;202006;1013;2692;561;1718;67;208;156;436;223;644
412650;202006;1609;4448;1277;3754;220;716;489;1255;709;1971
412660;202006;2337;5975;1617;4585;262;805;494;1250;756;2055
412665;202006;377;967;289;803;44;132;139;373;183;505
412667;202006;1682;4458;1241;3595;176;551;494;1370;670;1921
412670;202006;800;1898;528;1451;91;285;167;426;258;711
412680;202006;1829;4890;1235;3720;169;576;443;1190;612;1766
412690;202006;1079;2864;787;2287;125;390;314;857;439;1247
412700;202006;1948;5180;1599;4622;189;645;880;2457;1069;3102
412710;202006;5716;16767;4221;13490;838;3026;1173;3329;2011;6355
412720;202006;1158;3403;882;2784;143;482;177;473;320;955
412730;202006;2301;6178;1498;4517;281;935;495;1406;776;2341
412740;202006;1823;5086;1221;3832;217;802;171;533;388;1335
412750;202006;3836;10098;3163;9132;307;1076;2086;5664;2393;6740
412760;202006;2856;7769;2356;6917;436;1443;1256;3464;1692;4907
412770;202006;10004;25195;5190;15623;734;2329;1179;3038;1913;5367
412780;202006;1168;3107;857;2528;187;600;340;982;527;1582
412785;202006;2011;4901;1395;3824;140;392;899;2414;1039;2806
412788;202006;1308;3664;1073;3252;290;889;459;1362;749;2251
412790;202006;1311;3474;719;2221;110;386;225;619;335;1005
412795;202006;1231;3203;643;1983;100;326;127;359;227;685
412796;202006;2190;6330;1792;5544;373;1209;594;1720;967;2929
412800;202006;3460;8372;2330;6283;270;824;1068;2561;1338;3385
412810;202006;11172;28474;6944;19795;850;2855;2690;6801;3540;9656
412820;202006;6352;17403;4419;13488;1062;3428;1277;3895;2339;7323
412830;202006;346;977;239;746;38;113;59;182;97;295
412840;202006;1791;4545;1255;3491;137;428;537;1373;674;1801
412850;202006;2815;7411;2020;5999;328;1042;840;2456;1168;3498
412853;202006;1511;3802;1247;3331;178;520;632;1511;810;2031
412855;202006;1231;3292;794;2346;142;493;225;626;367;1119
412860;202006;774;1897;526;1507;72;234;291;792;363;1026
412862;202006;691;1684;453;1282;84;238;195;532;279;770
412863;202006;1252;3785;1119;3535;206;667;653;2048;859;2715
412865;202006;708;1933;514;1538;129;386;147;463;276;849
412870;202006;851;2198;616;1815;168;559;121;383;289;942
412880;202006;808;2189;534;1626;88;307;90;241;178;548
420005;202006;402;1189;236;818;34;124;105;365;139;489
420010;202006;3254;7941;2144;6067;129;413;1573;4471;1702;4884
420020;202006;433;1359;280;968;44;180;64;177;108;357
420030;202006;73;247;53;204;17;73;17;60;34;133
420040;202006;511;1541;291;1042;59;235;16;41;75;276
420050;202006;706;1634;459;1185;68;202;282;663;350;865
420055;202006;156;480;85;307;21;97;28;85;49;182
420060;202006;100;273;56;169;12;40;14;32;26;72
420070;202006;677;2077;504;1708;109;387;199;657;308;1044
420075;202006;78;200;37;108;6;19;13;28;19;47
420080;202006;333;967;259;800;62;208;104;326;166;534
420090;202006;405;1263;236;846;53;197;42;129;95;326
420100;202006;1216;3210;1003;2882;51;182;808;2284;859;2466
420110;202006;237;762;215;714;44;170;100;306;144;476
420120;202006;517;1407;340;1027;66;227;153;396;219;623
420125;202006;342;1050;240;823;58;210;98;324;156;534
420127;202006;256;695;94;311;15;55;22;72;37;127
420130;202006;3117;8616;2352;7296;367;1371;1125;3171;1492;4542
420140;202006;3425;9263;2403;7467;668;2378;328;1021;996;3399
420150;202006;646;1656;441;1300;45;151;264;757;309;908
420160;202006;202;493;78;248;10;30;20;63;30;93
420165;202006;151;432;85;276;19;66;27;75;46;141
420170;202006;263;822;178;615;22;68;50;160;72;228
420180;202006;172;541;100;362;11;37;30;100;41;137
420190;202006;194;621;117;420;36;143;30;104;66;247
420195;202006;1361;3522;976;2890;304;1060;111;243;415;1303
420200;202006;4208;10279;2448;6967;331;1150;967;2367;1298;3517
420205;202006;1687;4571;1134;3476;166;537;624;1912;790;2449
420207;202006;1668;4375;1015;3125;195;690;404;1157;599;1847
420208;202006;315;893;183;646;56;216;47;157;103;373
420209;202006;145;489;82;293;20;82;25;87;45;169
420210;202006;2861;7345;1843;5683;339;1169;860;2604;1199;3773
420213;202006;750;2343;627;2084;136;494;311;1010;447;1504
420215;202006;181;553;123;419;30;109;26;82;56;191
420220;202006;241;699;143;478;23;94;68;201;91;295
420230;202006;4700;12901;3519;10665;538;1775;1850;5431;2388;7206
420240;202006;12622;34853;7720;23635;1019;3568;3749;10112;4768;13680
420243;202006;368;1056;288;891;47;166;171;500;218;666
420245;202006;1201;3107;842;2488;65;235;509;1442;574;1677
420250;202006;424;1187;349;1057;53;180;196;553;249;733
420253;202006;478;1182;339;981;33;111;192;550;225;661
420257;202006;155;404;98;301;18;68;48;146;66;214
420260;202006;1057;2791;763;2376;127;448;472;1443;599;1891
420270;202006;497;1313;242;720;31;100;111;333;142;433
420280;202006;1091;3290;823;2736;160;602;281;902;441;1504
420285;202006;115;232;46;134;10;41;8;16;18;57
420287;202006;422;983;299;811;80;222;108;298;188;520
420290;202006;4530;12934;3447;10468;459;1630;2030;5665;2489;7295
420300;202006;6931;19542;3935;12510;746;2646;1103;3083;1849;5729
420310;202006;790;1820;391;1083;40;127;216;556;256;683
420315;202006;751;2119;515;1692;111;384;204;672;315;1056
420320;202006;4873;13398;3496;11019;1002;3494;872;2541;1874;6035
420325;202006;273;774;189;601;31;103;86;248;117;351
420330;202006;936;2729;587;1979;108;413;175;512;283;925
420340;202006;935;2598;692;2160;162;536;107;287;269;823
420350;202006;1133;3000;824;2439;70;239;574;1665;644;1904
420360;202006;2681;7433;1439;4686;271;952;132;431;403;1383
420370;202006;1046;2832;840;2495;87;303;568;1622;655;1925
420380;202006;4215;11137;2767;8529;584;1919;1016;3020;1600;4939
420390;202006;1058;2535;720;1845;129;406;299;516;428;922
420395;202006;973;2788;655;2141;102;398;87;213;189;611
420400;202006;950;2731;643;2059;118;421;232;710;350;1131
420410;202006;531;1444;406;1184;44;136;269;762;313;898
420415;202006;281;834;214;686;57;203;80;256;137;459
420417;202006;587;1757;463;1495;127;414;164;543;291;957
420419;202006;136;477;104;400;37;149;8;30;45;179
420420;202006;10654;27682;6996;20984;1996;6808;1905;5194;3901;12002
420425;202006;642;1712;421;1266;41;142;205;593;246;735
420430;202006;3011;8121;1721;5256;404;1297;550;1543;954;2840
420435;202006;241;605;114;363;16;53;55;168;71;221
420440;202006;722;1978;435;1351;113;392;172;491;285;883
420445;202006;256;631;163;460;31;90;76;203;107;293
420450;202006;641;1859;457;1459;84;326;165;454;249;780
420455;202006;1918;4749;1365;3898;192;670;685;1834;877;2504
420460;202006;8540;22822;6239;18579;935;3121;3169;9035;4104;12156
420470;202006;593;1551;317;1001;58;212;66;176;124;388
420475;202006;75;194;29;92;10;30;3;11;13;41
420480;202006;5328;13132;3188;9534;649;2129;1058;3157;1707;5286
420490;202006;340;954;244;760;54;192;98;296;152;488
420500;202006;1381;3840;879;2875;156;568;379;1234;535;1802
420510;202006;156;437;86;272;10;42;25;71;35;113
420515;202006;57;146;34;94;3;16;15;33;18;49
420517;202006;748;2067;649;1892;51;151;481;1424;532;1575
420519;202006;291;707;211;591;25;76;121;353;146;429
420520;202006;297;801;149;500;26;91;12;41;38;132
420530;202006;778;2258;521;1705;88;338;192;541;280;879
420535;202006;232;686;93;320;12;46;41;131;53;177
420540;202006;34321;81306;21403;59487;3241;10242;7306;17394;10547;27636
420543;202006;204;617;156;501;20;72;82;243;102;315
420545;202006;1069;3188;798;2593;148;525;313;918;461;1443
420550;202006;3358;8954;2090;6791;346;1296;859;2835;1205;4131
420555;202006;288;828;191;617;24;86;111;342;135;428
420560;202006;383;955;254;760;53;173;142;415;195;588
420570;202006;2103;5834;1638;4957;297;1020;702;2039;999;3059
420580;202006;1829;4653;1289;3820;299;959;435;1317;734;2276
420590;202006;2705;7166;1548;4666;284;1036;407;923;691;1959
420600;202006;965;2817;727;2348;104;394;406;1252;510;1646
420610;202006;349;1010;191;643;42;149;65;226;107;375
420620;202006;708;1744;465;1340;102;312;191;541;293;853
420630;202006;860;2604;621;2009;86;303;357;1095;443;1398
420640;202006;474;1288;222;759;72;241;20;73;92;314
420650;202006;3434;9049;2020;6059;294;964;766;1978;1060;2942
420660;202006;426;1094;265;757;50;146;72;183;122;329
420665;202006;566;1481;354;1114;63;232;157;437;220;669
420670;202006;1270;3492;814;2570;135;514;315;881;450;1395
420675;202006;159;450;89;304;14;63;44;136;58;199
420680;202006;319;745;160;524;30;113;82;253;112;366
420690;202006;830;2460;493;1648;71;292;121;333;192;625
420700;202006;2532;6665;1875;5546;236;768;1052;3011;1288;3779
420710;202006;840;2433;631;1979;61;255;377;1081;438;1336
420720;202006;1182;3295;837;2682;176;593;400;1232;576;1825
420730;202006;2935;7632;2145;6316;352;1141;1145;3240;1497;4381
420740;202006;512;1543;301;1065;87;332;26;107;113;439
420750;202006;1824;5314;1174;3783;205;773;469;1381;674;2154
420757;202006;77;195;39;126;4;8;18;55;22;63
420760;202006;339;1004;159;499;37;124;41;110;78;234
420765;202006;450;1300;197;670;26;108;89;293;115;401
420768;202006;1302;3653;1121;3348;142;428;828;2457;970;2885
420770;202006;444;1195;215;731;37;144;90;281;127;425
420775;202006;265;805;181;601;42;153;49;138;91;291
420780;202006;876;2402;531;1664;113;394;97;264;210;658
420785;202006;193;510;133;380;14;47;67;159;81;206
420790;202006;980;2991;718;2447;119;477;382;1232;501;1709
420800;202006;629;1589;293;898;85;298;69;195;154;493
420810;202006;1361;4261;1093;3723;322;1253;345;998;667;2251
420820;202006;11157;27733;7846;22319;1512;4850;3634;9459;5146;14309
420830;202006;3626;9571;2659;7790;485;1548;1143;3257;1628;4805
420840;202006;459;1338;213;774;63;257;25;77;88;334
420845;202006;2266;5811;1340;4133;249;952;539;1546;788;2498
420850;202006;1015;3269;614;2223;111;444;108;346;219;790
420860;202006;287;740;149;494;32;117;37;112;69;229
420870;202006;757;2105;567;1748;143;520;242;677;385;1197
420880;202006;961;2961;738;2495;155;626;278;867;433;1493
420890;202006;7637;20690;4629;14449;705;2439;1593;4382;2298;6821
420895;202006;162;472;100;311;27;86;30;92;57;178
420900;202006;1443;3563;856;2528;113;408;395;1005;508;1413
420910;202006;26975;71021;16441;50509;2524;8828;6461;17793;8985;26621
420915;202006;515;1852;372;1437;55;212;195;776;250;988
420917;202006;325;801;166;456;29;84;82;224;111;308
420920;202006;75;200;27;97;0;0;5;16;5;16
420930;202006;16014;41838;11135;33181;2050;6802;4884;13804;6934;20606
420940;202006;2747;6746;1572;4700;399;1365;289;694;688;2059
420945;202006;130;372;102;310;24;84;42;115;66;199
420950;202006;327;956;173;582;28;114;41;127;69;241
420960;202006;964;2367;683;1883;122;404;296;713;418;1117
420970;202006;2304;6386;1598;5035;456;1509;415;1292;871;2801
420980;202006;256;847;223;780;109;386;63;233;172;619
420985;202006;297;849;142;506;35;137;45;138;80;275
420990;202006;296;918;156;560;32;115;31;97;63;212
421000;202006;511;1534;354;1182;78;271;96;288;174;559
421003;202006;466;1110;159;466;10;35;26;65;36;100
421005;202006;54;153;42;135;9;30;20;63;29;93
421010;202006;3025;8319;2158;6709;455;1616;563;1542;1018;3158
421020;202006;353;1105;272;954;44;184;139;464;183;648
421030;202006;718;2195;553;1841;167;630;173;530;340;1160
421040;202006;640;1513;401;1150;27;92;247;700;274;792
421050;202006;960;2589;617;1813;123;403;234;603;357;1006
421055;202006;169;453;91;274;12;39;55;152;67;191
421060;202006;597;1743;412;1311;81;295;186;523;267;818
421070;202006;624;1872;348;1177;75;278;105;347;180;625
421080;202006;491;1412;409;1255;42;152;251;761;293;913
421085;202006;363;1031;118;418;18;58;14;34;32;92
421090;202006;242;620;152;440;9;34;51;133;60;167
421100;202006;800;1791;326;996;98;348;84;209;182;557
421105;202006;1492;4131;1018;3137;181;571;454;1331;635;1902
421110;202006;1039;2737;856;2503;20;59;636;1967;656;2026
421120;202006;879;2684;645;2150;97;353;212;653;309;1006
421125;202006;282;743;200;591;73;237;68;165;141;402
421130;202006;4723;13843;3862;12131;914;3286;1938;5693;2852;8979
421140;202006;326;885;184;571;33;102;56;159;89;261
421145;202006;427;1193;274;861;65;229;100;280;165;509
421150;202006;614;1667;388;1217;64;236;199;588;263;824
421160;202006;498;1331;351;1053;48;158;231;672;279;830
421165;202006;194;564;122;398;24;84;52;162;76;246
421170;202006;1036;2733;815;2391;134;385;498;1506;632;1891
421175;202006;981;2463;591;1852;114;400;255;776;369;1176
421180;202006;371;964;199;613;37;142;76;214;113;356
421185;202006;307;825;208;620;28;97;122;359;150;456
421187;202006;268;812;166;548;30;99;56;176;86;275
421189;202006;345;1002;263;842;43;151;101;299;144;450
421190;202006;10251;27748;6791;21182;1288;4411;2352;6758;3640;11169
421200;202006;611;1791;490;1562;53;193;314;973;367;1166
421205;202006;181;477;132;395;25;93;58;151;83;244
421210;202006;1042;2680;604;1921;129;419;233;746;362;1165
421220;202006;1283;3867;983;3220;233;831;306;918;539;1749
421223;202006;320;892;195;656;47;156;89;304;136;460
421225;202006;866;2552;724;2305;125;447;433;1368;558;1815
421227;202006;642;1830;398;1309;79;286;172;576;251;862
421230;202006;575;1517;362;1120;65;236;140;422;205;658
421240;202006;267;799;125;452;11;45;20;69;31;114
421250;202006;1867;4732;1307;3826;151;525;758;2113;909;2638
421260;202006;178;521;48;182;15;68;9;31;24;99
421265;202006;629;1632;560;1542;6;20;527;1451;533;1471
421270;202006;323;856;137;489;19;63;53;182;72;245
421280;202006;1703;4656;1259;3881;187;706;714;2069;901;2775
421290;202006;952;2586;489;1501;87;284;112;321;199;605
421300;202006;274;708;138;437;13;49;22;63;35;112
421310;202006;176;499;118;388;24;82;62;207;86;289
421315;202006;217;603;137;425;44;118;30;106;74;224
421320;202006;614;1871;312;1064;35;112;38;90;73;202
421330;202006;573;1707;414;1373;84;323;114;358;198;681
421335;202006;333;1016;274;912;68;255;115;370;183;625
421340;202006;1313;3658;930;2918;174;630;386;1105;560;1735
421350;202006;1398;3634;926;2808;184;641;387;1085;571;1726
421360;202006;2165;5868;1251;3982;233;905;482;1334;715;2239
421370;202006;606;1979;366;1321;65;240;101;314;166;554
421380;202006;783;2091;670;1911;90;288;395;1087;485;1375
421390;202006;163;443;56;195;13;39;20;62;33;101
421400;202006;296;958;209;749;37;145;108;371;145;516
421410;202006;207;564;88;312;23;92;27;84;50;176
421415;202006;175;524;100;320;21;65;21;63;42;128
421420;202006;522;1408;423;1224;43;136;267;751;310;887
421430;202006;100;307;75;246;8;28;20;59;28;87
421440;202006;581;1569;346;1136;70;228;151;480;221;708
421450;202006;427;1273;248;849;32;135;42;148;74;283
421460;202006;355;1052;191;696;24;98;39;121;63;219
421470;202006;244;718;141;487;28;99;52;187;80;286
421480;202006;2663;7184;1721;5299;368;1339;651;1816;1019;3155
421490;202006;114;391;68;258;4;17;18;47;22;64
421500;202006;2024;5979;1407;4710;380;1485;333;972;713;2457
421505;202006;275;783;227;714;35;125;145;440;180;565
421507;202006;412;1175;219;742;54;192;75;241;129;433
421510;202006;287;815;175;544;25;85;93;263;118;348
421520;202006;483;1269;308;878;28;87;184;477;212;564
421530;202006;298;892;173;602;31;136;51;146;82;282
421535;202006;376;991;230;728;37;139;119;357;156;496
421540;202006;281;662;132;404;18;59;47;126;65;185
421545;202006;663;1969;493;1659;109;438;239;748;348;1186
421550;202006;1968;5274;1584;4697;293;891;903;2676;1196;3567
421555;202006;165;499;67;230;12;46;8;19;20;65
421560;202006;78;255;52;195;10;36;17;57;27;93
421565;202006;871;2261;570;1777;148;508;154;487;302;995
421567;202006;419;1385;271;955;97;360;67;213;164;573
421568;202006;329;985;245;790;34;123;111;345;145;468
421569;202006;153;441;74;240;14;50;37;114;51;164
421570;202006;1080;2933;764;2333;180;625;215;606;395;1231
421575;202006;284;830;206;623;30;104;86;224;116;328
421580;202006;3585;9886;2341;7265;375;1386;928;2454;1303;3840
421590;202006;135;418;109;358;33;121;30;80;63;201
421600;202006;541;1468;366;1102;77;259;115;290;192;549
421605;202006;715;1855;504;1513;87;234;259;834;346;1068
421610;202006;1022;2779;666;2099;113;382;215;649;328;1031
421620;202006;3747;9939;2169;7016;470;1725;594;1824;1064;3549
421625;202006;127;352;56;179;13;44;13;39;26;83
421630;202006;2294;6035;1391;4249;245;885;454;1136;699;2021
421635;202006;247;672;176;521;17;54;107;291;124;345
421640;202006;694;1861;496;1554;97;346;211;644;308;990
421650;202006;2227;6094;1425;4583;343;1316;422;1125;765;2441
421660;202006;9313;25970;6386;20291;1006;3552;2763;8041;3769;11593
421670;202006;722;2097;505;1581;88;306;250;761;338;1067
421680;202006;996;2739;746;2286;194;645;358;1003;552;1648
421690;202006;1228;3550;829;2699;164;604;301;970;465;1574
421700;202006;485;1434;302;1010;64;233;97;305;161;538
421710;202006;199;636;88;296;19;68;22;66;41;134
421715;202006;99;281;76;229;18;48;45;134;63;182
421720;202006;1797;4880;1051;3283;268;907;285;769;553;1676
421725;202006;229;560;117;362;21;72;50;118;71;190
421730;202006;400;1155;207;621;26;85;104;291;130;376
421740;202006;658;1851;446;1388;109;346;125;354;234;700
421750;202006;824;1944;366;1087;85;280;135;360;220;640
421755;202006;152;420;88;265;14;56;46;120;60;176
421760;202006;869;2277;566;1729;91;313;215;569;306;882
421770;202006;2341;6239;1681;5071;429;1277;606;1989;1035;3266
421775;202006;203;518;122;363;16;49;56;156;72;205
421780;202006;773;2294;492;1681;102;403;194;612;296;1015
421790;202006;748;1935;423;1357;90;304;214;660;304;964
421795;202006;172;473;121;356;22;76;43;117;65;193
421800;202006;2351;6384;1678;5131;213;766;960;2777;1173;3543
421810;202006;591;1631;398;1263;47;180;235;724;282;904
421820;202006;898;2609;507;1649;103;382;157;407;260;789
421825;202006;1271;3633;1126;3408;121;385;786;2339;907;2724
421830;202006;1932;5756;1566;5064;322;1107;665;2090;987;3197
421835;202006;199;494;117;354;22;80;34;94;56;174
421840;202006;208;671;137;497;27;104;35;117;62;221
421850;202006;360;1004;191;641;36;129;58;154;94;283
421860;202006;302;845;160;553;23;89;55;171;78;260
421870;202006;3928;9921;2794;7809;479;1602;1369;3392;1848;4994
421875;202006;237;697;104;344;17;65;28;75;45;140
421880;202006;551;1583;360;1155;93;348;87;276;180;624
421885;202006;202;579;123;394;30;94;29;88;59;182
421890;202006;805;2455;594;2023;112;456;303;971;415;1427
421895;202006;391;992;324;904;39;124;221;638;260;762
421900;202006;957;2513;691;1963;102;336;312;808;414;1144
421910;202006;289;853;197;635;31;125;57;156;88;281
421915;202006;361;1023;197;638;43;137;32;93;75;230
421917;202006;549;1283;304;966;113;393;74;248;187;641
421920;202006;364;1121;263;921;107;393;70;236;177;629
421930;202006;2456;6221;1218;3808;285;1014;369;1003;654;2017
421935;202006;385;1226;304;1046;59;213;169;560;228;773
421940;202006;341;992;157;504;26;91;36;97;62;188
421950;202006;2826;7106;1539;4702;305;1028;378;1021;683;2049
421960;202006;172;443;89;286;18;71;20;54;38;125
421970;202006;1818;4659;1072;3158;216;753;399;986;615;1739
421985;202006;278;741;156;499;17;55;57;172;74;227
422000;202006;1878;4901;1513;4295;158;527;1039;2903;1197;3430
430003;202006;549;1502;357;1137;64;220;153;483;217;703
430005;202006;259;676;164;507;31;104;72;210;103;314
430010;202006;1672;4075;1325;3537;139;415;935;2417;1074;2832
430020;202006;576;1323;432;1127;44;136;283;711;327;847
430030;202006;974;2307;530;1506;132;428;167;444;299;872
430040;202006;10000;24038;5813;16602;1526;4724;668;2046;2194;6770
430045;202006;494;1229;334;936;25;79;224;619;249;698
430047;202006;241;529;89;256;22;72;27;73;49;145
430050;202006;849;2145;486;1411;108;330;120;326;228;656
430055;202006;245;608;112;333;15;56;63;170;78;226
430057;202006;78;167;28;76;6;22;9;19;15;41
430060;202006;16147;43320;12307;37278;2589;8327;5643;17035;8232;25362
430063;202006;839;2338;664;1970;126;375;359;1063;485;1438
430064;202006;987;2708;723;2162;214;654;281;822;495;1476
430066;202006;94;199;67;159;6;13;53;121;59;134
430070;202006;734;1867;89;296;7;27;18;52;25;79
430080;202006;811;2004;497;1389;80;272;263;641;343;913
430085;202006;822;1874;494;1349;98;280;210;562;308;842
430087;202006;582;1479;486;1347;62;154;336;950;398;1104
430090;202006;526;1345;175;545;11;43;64;188;75;231
430100;202006;734;1759;433;1187;75;245;202;477;277;722
430105;202006;1111;2975;716;2288;125;458;343;1061;468;1519
430107;202006;163;475;94;297;19;69;26;68;45;137
430110;202006;2081;5233;1508;4382;233;729;819;2352;1052;3081
430120;202006;1135;3388;730;2371;128;442;333;1081;461;1523
430130;202006;3382;7805;2465;6513;904;2411;430;1385;1334;3796
430140;202006;862;2364;601;1862;145;436;286;867;431;1303
430150;202006;549;1407;295;898;67;218;102;301;169;519
430155;202006;246;628;110;335;17;48;24;67;41;115
430160;202006;18827;44502;14395;38161;1703;4921;8419;22159;10122;27080
430163;202006;2814;6812;1951;5414;89;300;1388;3802;1477;4102
430165;202006;302;744;84;275;14;31;13;37;27;68
430170;202006;904;2390;321;1108;51;187;51;158;102;345
430175;202006;636;1929;533;1705;134;432;248;779;382;1211
430180;202006;629;1522;496;1306;57;148;345;904;402;1052
430185;202006;556;1394;281;824;76;205;62;165;138;370
430187;202006;662;1500;465;1251;77;220;235;677;312;897
430190;202006;1364;3615;1095;3185;225;705;510;1414;735;2119
430192;202006;125;335;42;126;6;18;11;29;17;47
430195;202006;409;1215;60;212;5;14;10;31;15;45
430200;202006;1054;3150;841;2764;278;949;240;812;518;1761
430205;202006;447;1171;390;1072;13;42;336;901;349;943
430210;202006;5127;13111;3448;9523;605;1807;1190;2682;1795;4489
430215;202006;302;774;189;544;38;116;72;209;110;325
430220;202006;621;1548;177;608;23;100;35;90;58;190
430222;202006;175;496;127;393;12;41;45;136;57;177
430223;202006;238;626;185;536;17;52;117;334;134;386
430225;202006;17;34;12;26;1;2;9;19;10;21
430230;202006;1815;5011;1537;4580;132;441;1150;3372;1282;3813
430235;202006;314;895;204;649;46;174;66;179;112;353
430237;202006;500;1197;361;963;20;59;264;686;284;745
430240;202006;1204;2787;673;1860;85;291;363;919;448;1210
430245;202006;692;1971;525;1643;150;487;240;771;390;1258
430250;202006;885;2202;639;1817;223;700;48;120;271;820
430258;202006;129;342;95;277;6;10;50;152;56;162
430260;202006;638;1690;436;1300;60;197;243;716;303;913
430265;202006;195;549;129;425;30;94;39;133;69;227
430270;202006;2757;6859;2162;5923;391;1185;1275;3382;1666;4567
430280;202006;4896;11590;3336;8894;697;1878;1411;3732;2108;5610
430290;202006;2168;5015;1758;4533;47;160;1506;3795;1553;3955
430300;202006;9300;23853;6942;19656;1117;3462;3644;10075;4761;13537
430310;202006;11417;28373;7551;21085;983;3071;3631;9422;4614;12493
430320;202006;975;2547;521;1621;64;192;284;899;348;1091
430330;202006;660;1610;405;1103;72;216;174;416;246;632
430340;202006;693;1516;376;1034;52;155;218;582;270;737
430350;202006;7335;18676;5408;15206;783;2380;3067;8226;3850;10606
430355;202006;323;853;108;351;17;58;14;38;31;96
430360;202006;841;1972;533;1444;104;318;213;536;317;854
430367;202006;306;706;166;454;31;96;90;237;121;333
430370;202006;472;1273;212;652;40;133;54;140;94;273
430380;202006;666;1655;327;1020;74;272;93;277;167;549
430390;202006;2981;7209;1684;4796;308;999;253;518;561;1517
430400;202006;1038;2221;796;1880;68;183;548;1244;616;1427
430410;202006;521;1256;358;989;55;165;219;582;274;747
430420;202006;2567;7064;1957;5714;513;1569;843;2342;1356;3911
430430;202006;573;1468;268;829;64;190;60;198;124;388
430435;202006;1429;3648;1088;3092;196;597;560;1599;756;2196
430440;202006;3493;9624;2670;8138;283;975;1608;4872;1891;5847
430450;202006;6469;16345;5119;13948;780;2364;2719;7149;3499;9513
430460;202006;30040;76618;21757;62863;3880;12418;10752;29691;14632;42109
430461;202006;281;725;85;266;12;40;31;83;43;123
430462;202006;229;626;126;417;20;67;46;155;66;222
430463;202006;5664;14924;4182;12269;845;2749;1896;5312;2741;8061
430465;202006;409;1058;341;938;53;166;214;563;267;729
430466;202006;3978;10012;3070;8528;750;2178;1421;3747;2171;5925
430467;202006;482;1162;336;929;46;150;179;462;225;612
430468;202006;1199;2984;923;2567;83;249;596;1626;679;1875
430469;202006;552;1497;66;212;7;23;12;18;19;41
430470;202006;5355;13718;3505;10384;1032;3364;908;2501;1940;5865
430471;202006;519;1475;419;1290;60;208;243;707;303;915
430480;202006;721;1912;395;1216;52;181;92;249;144;430
430485;202006;166;439;65;200;18;47;6;24;24;71
430490;202006;363;949;203;607;26;94;98;265;124;359
430495;202006;371;982;232;710;33;105;110;320;143;425
430500;202006;946;2453;642;1941;209;688;179;487;388;1175
430510;202006;24130;63142;17123;49311;2863;9387;7786;20558;10649;29945
430511;202006;319;928;131;432;16;58;17;47;33;105
430512;202006;929;2100;716;1785;166;419;267;682;433;1101
430513;202006;757;1896;346;1009;49;156;172;472;221;628
430515;202006;365;1032;259;816;32;93;140;440;172;533
430517;202006;1100;3355;804;2654;142;469;398;1348;540;1817
430520;202006;1256;3220;640;1888;116;361;142;382;258;743
430530;202006;934;2356;358;1115;72;218;88;264;160;482
430535;202006;3349;8640;2402;6889;344;1035;1219;3368;1563;4403
430537;202006;310;1101;290;1039;20;64;233;836;253;900
430540;202006;605;1459;341;999;59;169;156;461;215;630
430543;202006;746;1327;409;946;53;106;191;492;244;598
430544;202006;696;1959;490;1503;121;388;177;525;298;913
430545;202006;2206;5753;1628;4844;330;1012;804;2462;1134;3474
430550;202006;345;950;248;745;47;150;98;270;145;420
430558;202006;110;253;47;128;7;14;17;49;24;63
430560;202006;333;755;141;429;22;74;45;134;67;208
430570;202006;825;2014;574;1549;96;291;302;767;398;1058
430580;202006;814;2035;576;1657;144;440;249;707;393;1147
430583;202006;195;484;32;103;2;7;9;23;11;30
430585;202006;225;551;111;306;17;53;47;116;64;169
430587;202006;196;546;144;438;17;55;62;186;79;241
430590;202006;1377;3298;1128;2928;53;161;938;2382;991;2543
430593;202006;16;54;11;36;1;3;5;16;6;19
430595;202006;422;1057;111;361;13;52;18;41;31;93
430597;202006;425;1099;220;664;20;63;72;168;92;231
430600;202006;1925;4907;856;2438;162;494;225;568;387;1062
430605;202006;1129;3036;827;2463;109;376;392;1118;501;1494
430607;202006;519;1218;421;1059;27;73;303;751;330;824
430610;202006;5598;13136;3709;10230;1065;3310;809;2188;1874;5498
430613;202006;251;586;69;198;8;24;18;41;26;65
430620;202006;594;1455;432;1151;64;192;247;604;311;796
430630;202006;401;1110;109;357;18;59;22;66;40;125
430632;202006;471;1238;198;608;24;80;92;268;116;348
430635;202006;522;1238;384;1008;47;125;274;725;321;850
430637;202006;446;1094;346;948;37;120;218;568;255;688
430640;202006;1022;2669;616;1852;89;278;226;624;315;902
430642;202006;347;947;260;748;42;113;138;374;180;487
430645;202006;153;358;58;153;8;21;21;52;29;73
430650;202006;1558;4502;1238;3972;338;1090;578;1933;916;3023
430655;202006;267;673;159;448;24;79;79;194;103;273
430660;202006;5070;13034;3798;10871;829;2505;1641;4641;2470;7146
430670;202006;643;1560;487;1285;34;97;293;778;327;875
430673;202006;523;1195;204;601;37;113;76;206;113;319
430675;202006;239;688;56;199;8;28;24;86;32;114
430676;202006;4778;11881;3751;10303;458;1386;2368;6330;2826;7716
430680;202006;876;2369;535;1670;149;473;132;402;281;875
430690;202006;2770;7546;2168;6443;746;2336;592;1668;1338;4004
430692;202006;216;663;164;568;13;47;123;434;136;481
430693;202006;934;2467;553;1697;105;375;145;398;250;773
430695;202006;428;1107;236;698;32;83;124;355;156;438
430697;202006;383;968;289;820;73;190;143;441;216;631
430700;202006;6836;16862;3942;11457;809;2578;789;2083;1598;4661
430705;202006;395;963;193;586;21;74;82;217;103;291
430710;202006;1607;3499;1117;2827;144;404;675;1679;819;2083
430720;202006;666;1614;338;1032;49;148;173;534;222;682
430730;202006;999;2738;680;2123;96;287;359;1112;455;1399
430740;202006;580;1577;292;964;57;197;71;254;128;451
430745;202006;355;982;221;686;43;154;68;182;111;336
430750;202006;1298;3318;897;2626;198;599;457;1315;655;1914
430755;202006;445;1077;271;727;20;57;157;388;177;445
430760;202006;1987;4880;1494;4107;346;1033;668;1745;1014;2778
430770;202006;5941;14880;4519;12746;585;1888;2858;7792;3443;9680
430780;202006;1805;4407;1017;3029;202;668;394;1124;596;1792
430781;202006;451;1257;242;761;32;98;70;187;102;285
430783;202006;350;812;208;596;19;67;128;339;147;406
430786;202006;34;122;23;87;3;9;3;15;6;24
430790;202006;4165;10215;2851;7940;319;1062;1733;4506;2052;5568
430800;202006;738;1722;541;1419;35;97;357;940;392;1037
430805;202006;356;961;217;653;16;58;135;382;151;440
430807;202006;442;1082;230;670;25;72;98;267;123;339
430810;202006;678;1590;273;803;31;118;118;318;149;436
430820;202006;1162;3091;667;2119;133;440;194;609;327;1049
430825;202006;225;565;78;204;13;33;23;55;36;88
430830;202006;1658;4745;1326;4102;65;223;949;2905;1014;3128
430840;202006;998;2486;702;1977;95;290;474;1307;569;1597
430843;202006;126;298;55;154;3;11;26;68;29;79
430845;202006;421;1012;281;775;54;164;118;308;172;472
430850;202006;2247;5843;1508;4392;236;759;592;1742;828;2501
430860;202006;868;2012;372;1061;46;162;179;437;225;599
430865;202006;509;1262;376;1035;73;201;175;476;248;677
430870;202006;603;1565;255;798;38;144;85;226;123;370
430880;202006;1436;3270;963;2548;157;436;515;1333;672;1769
430885;202006;178;486;91;312;8;29;54;183;62;212
430890;202006;964;2401;634;1833;54;231;135;363;189;594
430900;202006;2990;6536;2037;5150;173;516;1343;3188;1516;3704
430905;202006;730;1868;452;1334;81;273;170;461;251;734
430910;202006;1552;4116;1085;3162;186;643;537;1383;723;2026
430912;202006;486;1349;324;1024;25;76;222;714;247;790
430915;202006;466;1419;350;1196;127;433;94;328;221;761
430920;202006;22484;56992;16935;47632;2312;7200;10131;27717;12443;34917
430925;202006;94;211;34;101;5;13;16;49;21;62
430930;202006;10011;23744;6257;17900;1210;3541;2571;7681;3781;11222
430940;202006;961;2504;566;1653;148;464;146;362;294;826
430950;202006;746;1749;472;1272;37;132;295;725;332;857
430955;202006;336;894;85;258;20;62;23;55;43;117
430957;202006;174;598;159;559;25;90;98;342;123;432
430960;202006;1305;3123;721;2039;155;469;310;849;465;1318
430965;202006;1593;3774;1220;3186;67;181;936;2496;1003;2677
430970;202006;348;841;171;490;23;72;84;214;107;286
430975;202006;489;1464;372;1190;78;261;192;588;270;849
430980;202006;382;870;221;596;29;92;102;249;131;341
430990;202006;527;1513;323;1018;41;129;159;504;200;633
430995;202006;543;1388;389;1137;44;139;214;613;258;752
431000;202006;1318;3108;522;1519;90;292;40;107;130;399
431010;202006;2010;5174;1223;3833;245;855;242;635;487;1490
431020;202006;7866;17035;4581;12073;1045;3125;1537;3503;2582;6628
431030;202006;318;874;155;524;27;97;22;70;49;167
431033;202006;3549;8372;2226;6273;493;1416;786;2249;1279;3665
431036;202006;337;733;77;218;7;22;24;56;31;78
431040;202006;875;2250;561;1687;88;298;250;695;338;993
431041;202006;459;1057;334;869;27;67;202;520;229;587
431043;202006;331;824;177;543;36;126;88;266;124;392
431046;202006;104;271;41;123;4;9;10;30;14;39
431050;202006;1309;3196;929;2585;175;534;468;1321;643;1855
431053;202006;622;1688;345;1074;75;269;111;302;186;571
431055;202006;576;1411;483;1269;59;142;339;890;398;1032
431057;202006;234;669;116;383;26;85;33;99;59;184
431060;202006;5227;13498;3471;10422;839;2750;922;2720;1761;5470
431065;202006;400;1007;278;799;49;153;132;372;181;525
431070;202006;419;1168;233;744;55;191;54;167;109;358
431075;202006;214;621;131;428;26;92;39;132;65;224
431080;202006;542;1476;364;1094;61;214;130;370;191;584
431085;202006;730;1897;454;1259;64;177;226;607;290;784
431087;202006;402;1141;325;977;22;63;225;699;247;762
431090;202006;402;943;154;471;28;95;43;134;71;229
431100;202006;3321;7268;2257;5844;324;846;1153;3044;1477;3890
431110;202006;1354;3105;905;2342;273;733;336;796;609;1529
431112;202006;559;1556;464;1370;67;226;286;809;353;1035
431113;202006;360;995;311;899;49;157;193;543;242;700
431115;202006;937;2685;722;2283;101;383;411;1217;512;1600
431120;202006;2374;6557;1596;4945;493;1729;361;1007;854;2736
431123;202006;402;1099;254;779;45;121;139;443;184;564
431125;202006;963;2764;727;2292;264;805;252;854;516;1659
431127;202006;202;525;62;200;7;22;14;41;21;63
431130;202006;2854;7334;2060;5983;300;1002;1159;3263;1459;4265
431140;202006;5064;11963;2933;7932;358;1074;1330;3136;1688;4210
431142;202006;491;1309;361;1075;47;146;223;662;270;808
431150;202006;1000;2679;701;2111;131;427;301;877;432;1304
431160;202006;632;1808;419;1329;70;241;127;394;197;635
431162;202006;496;1196;271;785;27;91;150;406;177;497
431164;202006;175;399;39;119;9;29;5;11;14;40
431170;202006;455;1267;317;969;96;293;91;265;187;558
431171;202006;639;1505;512;1330;111;255;303;822;414;1077
431173;202006;391;1040;290;886;76;261;120;345;196;606
431175;202006;1190;2764;711;1938;118;320;266;690;384;1010
431177;202006;782;2128;594;1824;132;464;352;1029;484;1493
431179;202006;334;728;95;280;18;54;22;61;40;115
431180;202006;2102;5321;1266;3672;323;929;351;1009;674;1938
431190;202006;456;1174;231;687;29;94;90;215;119;309
431198;202006;339;991;276;880;104;349;72;249;176;598
431200;202006;357;892;76;210;15;43;11;30;26;73
431205;202006;192;529;95;305;25;84;36;115;61;199
431210;202006;592;1478;472;1309;122;338;215;639;337;977
431213;202006;245;651;183;536;14;44;94;283;108;327
431215;202006;561;1325;243;702;25;78;118;324;143;402
431217;202006;150;385;100;294;11;34;56;156;67;190
431220;202006;530;1375;310;939;30;109;175;489;205;598
431225;202006;1478;3500;1121;2900;114;312;777;2022;891;2334
431230;202006;674;1924;521;1573;70;232;317;918;387;1150
431235;202006;152;386;24;82;4;10;5;21;9;31
431237;202006;311;985;254;851;48;175;132;423;180;598
431238;202006;26;65;21;55;5;16;8;13;13;29
431240;202006;4214;10437;3243;8911;469;1449;1890;4951;2359;6400
431242;202006;236;640;199;579;43;132;105;297;148;429
431244;202006;315;761;166;466;25;84;59;138;84;222
431245;202006;1273;2971;792;2126;76;222;418;1066;494;1288
431247;202006;250;659;141;426;32;105;51;134;83;239
431250;202006;1618;4063;1181;3469;251;776;615;1881;866;2657
431260;202006;232;640;151;484;23;84;50;154;73;238
431261;202006;234;718;186;639;15;59;100;328;115;387
431262;202006;366;1013;177;573;10;27;118;387;128;414
431265;202006;1549;3657;615;1795;76;266;214;544;290;810
431267;202006;274;728;167;485;8;35;119;313;127;348
431270;202006;2715;6147;1432;3975;329;947;471;1314;800;2261
431275;202006;116;339;58;191;24;80;10;32;34;112
431280;202006;223;589;63;196;5;18;6;12;11;30
431290;202006;302;880;196;608;37;134;36;77;73;211
431295;202006;70;175;21;63;3;8;6;17;9;25
431300;202006;284;731;49;154;3;10;13;30;16;40
431301;202006;301;856;64;208;7;16;6;17;13;33
431303;202006;557;1478;328;972;25;86;150;417;175;503
431306;202006;2116;4923;1211;3404;176;574;517;1270;693;1844
431308;202006;24;73;21;67;9;31;10;31;19;62
431310;202006;524;1473;365;1114;48;153;165;463;213;616
431320;202006;607;1666;301;995;43;130;54;154;97;284
431330;202006;1631;3813;780;2233;148;477;305;792;453;1269
431333;202006;214;571;105;312;19;55;39;108;58;163
431335;202006;40;108;21;64;4;8;3;7;7;15
431337;202006;2559;6789;1850;5605;346;1185;960;2801;1306;3986
431339;202006;401;1046;292;842;83;244;118;338;201;582
431340;202006;18479;44630;12537;34589;2172;6639;5534;14324;7706;20963
431342;202006;407;878;295;720;14;31;264;646;278;677
431344;202006;386;981;225;668;9;32;127;362;136;394
431346;202006;237;581;91;289;15;53;25;76;40;129
431349;202006;625;1639;326;969;80;230;119;352;199;582
431350;202006;3826;9957;2781;8125;410;1366;1455;4090;1865;5456
431360;202006;556;1321;271;771;82;239;69;195;151;434
431365;202006;1960;4622;1543;4052;121;349;1152;3000;1273;3349
431370;202006;4275;10471;3041;8408;640;1844;1499;4247;2139;6091
431380;202006;776;2087;625;1843;35;111;442;1304;477;1415
431390;202006;2547;6201;1510;4333;165;573;727;1822;892;2395
431395;202006;1259;3136;881;2551;205;612;384;1150;589;1762
431400;202006;319;890;171;536;30;90;40;121;70;211
431402;202006;838;1889;600;1526;76;207;400;992;476;1199
431403;202006;190;540;148;455;24;86;70;186;94;272
431405;202006;4335;11384;3289;9645;586;1911;1595;4451;2181;6362
431406;202006;524;1484;375;1172;79;238;191;618;270;856
431407;202006;426;1196;290;908;62;218;147;438;209;656
431410;202006;15724;39797;10085;29635;1526;5173;4955;13624;6481;18797
431413;202006;223;589;61;201;7;24;8;28;15;52
431415;202006;652;1600;402;1182;73;257;189;494;262;751
431417;202006;528;1174;360;920;56;160;201;505;257;665
431420;202006;1566;3525;1165;2966;167;435;651;1646;818;2081
431430;202006;540;1379;252;787;42;140;76;202;118;342
431440;202006;29390;68888;20169;54264;3462;10050;7857;19898;11319;29948
431442;202006;107;293;50;167;9;28;10;29;19;57
431445;202006;378;1061;116;374;15;42;10;28;25;70
431446;202006;263;778;195;639;35;129;99;308;134;437
431447;202006;697;1855;404;1232;79;271;141;427;220;698
431449;202006;743;1950;444;1317;88;244;179;544;267;788
431450;202006;2204;4547;1728;3880;88;210;1348;2957;1436;3167
431454;202006;31;100;27;91;7;22;9;31;16;53
431455;202006;602;1436;295;795;35;101;152;372;187;473
431460;202006;2739;6737;1936;5294;507;1468;541;1498;1048;2966
431470;202006;1390;3913;998;3075;198;621;434;1366;632;1987
431475;202006;251;674;49;174;5;18;7;15;12;33
431477;202006;393;1018;231;682;44;127;92;240;136;367
431478;202006;254;663;51;163;12;33;8;19;20;52
431480;202006;3049;7611;2368;6536;558;1553;1196;3335;1754;4888
431490;202006;107099;252235;80484;211180;5941;18424;58420;147408;64361;165832
431500;202006;463;1170;337;929;60;168;183;487;243;655
431505;202006;268;642;183;514;11;35;129;361;140;396
431507;202006;337;794;131;389;41;130;36;100;77;230
431510;202006;1532;3949;1017;2944;219;689;360;1032;579;1721
431513;202006;195;422;113;296;9;18;78;207;87;225
431514;202006;98;251;66;192;4;11;49;136;53;147
431515;202006;446;1115;314;881;65;179;156;439;221;618
431517;202006;61;182;49;151;8;22;22;65;30;87
431520;202006;409;995;155;481;23;83;66;175;89;258
431530;202006;4060;8643;2277;5991;524;1397;552;1470;1076;2867
431531;202006;207;513;123;350;13;39;56;145;69;184
431532;202006;543;1259;318;858;69;210;126;326;195;536
431535;202006;242;648;110;347;20;67;25;69;45;136
431540;202006;1751;5642;1626;5469;55;230;1330;4478;1385;4708
431545;202006;337;865;63;192;5;11;13;39;18;50
431550;202006;1921;4908;1431;3983;241;747;732;1945;973;2692
431555;202006;644;1465;399;1048;25;78;236;610;261;688
431560;202006;21901;53321;14716;41967;3031;9087;4916;14768;7947;23855
431570;202006;4374;10573;3477;9269;403;1200;2449;6250;2852;7450
431575;202006;240;604;182;502;60;148;49;144;109;292
431580;202006;585;1511;350;1029;40;146;193;535;233;681
431590;202006;570;1583;432;1299;93;296;169;522;262;818
431595;202006;348;954;222;673;50;153;87;241;137;394
431600;202006;1341;3074;910;2449;224;657;356;973;580;1630
431610;202006;1346;3469;908;2656;132;374;471;1415;603;1789
431620;202006;465;1188;209;610;36;106;80;224;116;330
431630;202006;1306;3251;606;1794;100;319;213;577;313;896
431640;202006;6138;14674;5170;13458;506;1354;3843;10073;4349;11427
431642;202006;534;1306;330;890;24;62;162;406;186;468
431643;202006;365;899;174;497;17;44;55;158;72;202
431645;202006;1795;4027;1388;3470;60;186;1112;2744;1172;2930
431647;202006;256;629;79;228;8;18;24;61;32;79
431650;202006;110;299;72;235;5;19;43;127;48;146
431660;202006;860;2296;426;1384;72;273;116;330;188;603
431670;202006;1112;2649;688;1870;104;301;352;901;456;1202
431673;202006;231;595;81;277;13;44;16;52;29;96
431675;202006;517;1284;104;336;11;41;19;49;30;90
431680;202006;7312;18770;5237;14871;1223;3642;2234;6176;3457;9818
431690;202006;22658;55467;14658;41053;3011;9040;5717;15945;8728;24985
431695;202006;160;381;101;294;24;84;51;124;75;208
431697;202006;448;1061;345;900;50;118;202;543;252;661
431700;202006;1309;3394;1098;3010;159;405;665;1810;824;2215
431710;202006;12452;29999;8542;24321;1503;4608;4190;12112;5693;16720
431720;202006;6147;15288;3553;10185;876;2680;678;1706;1554;4386
431725;202006;31;88;24;74;4;11;10;30;14;41
431730;202006;3814;9150;2326;6770;546;1686;708;2209;1254;3895
431740;202006;4946;11769;3179;8748;855;2723;808;1871;1663;4594
431750;202006;7178;18424;5398;15543;1219;3783;2290;6471;3509;10254
431755;202006;319;873;69;240;10;37;11;39;21;76
431760;202006;5184;11628;3425;8821;381;1120;2049;4994;2430;6114
431770;202006;1848;4343;1430;3781;88;277;1090;2801;1178;3078
431775;202006;198;518;103;316;21;64;14;38;35;102
431780;202006;1986;4971;1247;3580;211;682;521;1431;732;2113
431790;202006;781;2119;559;1684;99;292;250;729;349;1021
431795;202006;229;581;112;334;25;66;29;81;54;147
431800;202006;7944;19093;4789;14005;1257;4269;524;1587;1781;5856
431805;202006;290;680;86;279;7;25;29;93;36;118
431810;202006;3195;7568;1991;5365;380;1074;846;2186;1226;3260
431820;202006;2098;5653;1634;4902;455;1436;561;1780;1016;3216
431830;202006;8841;19085;6447;15895;1642;4760;1997;4892;3639;9652
431840;202006;2473;6549;1956;5698;317;922;1199;3528;1516;4450
431842;202006;539;1360;184;568;23;76;60;164;83;240
431843;202006;329;878;242;691;31;101;120;315;151;416
431844;202006;195;503;59;189;13;44;19;63;32;107
431845;202006;515;1352;357;1034;31;88;210;606;241;694
431846;202006;276;716;231;649;9;29;207;581;216;610
431848;202006;102;265;64;193;9;29;13;33;22;62
431849;202006;411;987;64;182;5;9;8;16;13;25
431850;202006;4025;10938;3067;9006;721;2285;972;2844;1693;5129
431860;202006;618;1500;342;969;56;169;188;511;244;680
431861;202006;93;254;50;157;10;37;16;45;26;82
431862;202006;431;1366;352;1229;67;257;178;595;245;852
431870;202006;18742;47996;14975;41995;1831;5759;9127;24702;10958;30461
431880;202006;3899;10031;2722;7901;430;1427;1246;3435;1676;4862
431890;202006;4419;11096;2684;7769;759;2419;470;1512;1229;3931
431900;202006;943;2386;602;1757;95;310;314;863;409;1173
431910;202006;737;1782;259;741;42;120;79;183;121;303
431912;202006;461;1266;359;1086;71;229;206;614;277;843
431915;202006;1012;2507;790;2143;27;87;607;1609;634;1696
431920;202006;1195;2820;987;2543;29;74;850;2185;879;2259
431930;202006;657;1753;442;1355;142;400;186;604;328;1004
431935;202006;83;230;57;177;15;51;12;37;27;88
431936;202006;298;860;160;513;34;114;62;182;96;296
431937;202006;161;405;102;278;17;51;45;98;62;149
431940;202006;2928;6948;1665;4626;186;552;822;2201;1008;2753
431950;202006;1747;4618;1389;4032;444;1321;514;1462;958;2783
431960;202006;2844;6986;2042;5518;564;1604;523;1399;1087;3003
431970;202006;409;1039;162;473;37;107;44;112;81;219
431971;202006;83;214;33;108;2;8;4;8;6;16
431973;202006;470;1506;386;1343;37;137;284;984;321;1121
431975;202006;110;226;21;68;1;4;2;6;3;10
431980;202006;994;2597;763;2213;158;482;357;1001;515;1483
431990;202006;5487;13174;3644;10496;491;1695;1757;4828;2248;6523
432000;202006;10771;25705;7752;21001;1864;5142;3372;9231;5236;14373
432010;202006;2103;5192;1529;4181;236;720;887;2287;1123;3007
432020;202006;1741;4468;1069;3075;229;691;446;1217;675;1908
432023;202006;496;1195;256;729;34;110;120;300;154;410
432026;202006;936;2629;683;2135;174;550;236;737;410;1287
432030;202006;350;865;198;556;21;56;114;315;135;371
432032;202006;332;856;228;652;27;88;126;340;153;428
432035;202006;643;1831;556;1681;172;527;231;724;403;1251
432040;202006;1021;2354;362;1111;59;199;123;337;182;536
432045;202006;160;446;97;317;23;74;34;117;57;191
432050;202006;464;1176;341;961;75;216;138;411;213;627
432055;202006;577;1560;374;1170;130;413;74;218;204;631
432057;202006;219;584;164;448;25;61;70;178;95;239
432060;202006;448;1084;137;428;31;105;43;117;74;222
432065;202006;205;574;144;440;29;87;60;182;89;269
432067;202006;705;2058;590;1804;51;178;444;1306;495;1484
432070;202006;1614;4272;1034;3119;236;781;324;886;560;1667
432080;202006;4365;10415;3329;8746;579;1768;1574;3895;2153;5663
432085;202006;340;875;230;705;61;191;90;286;151;477
432090;202006;1456;3710;948;2718;190;579;465;1245;655;1824
432100;202006;891;2289;423;1322;83;276;79;196;162;472
432110;202006;1992;5326;1331;4114;317;1111;128;361;445;1472
432120;202006;2674;7270;2039;6165;389;1295;792;2286;1181;3581
432130;202006;2467;6318;2027;5669;589;1684;906;2579;1495;4263
432132;202006;167;466;98;315;20;63;45;124;65;187
432135;202006;990;2329;645;1737;36;115;467;1239;503;1354
432140;202006;1436;4288;1089;3606;163;572;671;2224;834;2796
432143;202006;1374;3589;1052;3085;68;217;699;2036;767;2253
432145;202006;1479;3902;903;2673;127;407;312;783;439;1190
432146;202006;99;270;65;211;22;77;21;62;43;139
432147;202006;460;1310;265;885;87;314;68;195;155;509
432149;202006;430;1052;218;614;15;47;107;270;122;317
432150;202006;2958;7550;2128;6064;452;1445;821;2272;1273;3717
432160;202006;4987;13169;3604;10922;904;3034;1279;3683;2183;6717
432162;202006;255;560;36;103;7;17;5;14;12;31
432163;202006;119;292;24;64;0;0;3;4;3;4
432166;202006;591;1668;442;1351;85;289;145;400;230;689
432170;202006;1306;3478;830;2581;154;530;314;904;468;1434
432180;202006;2861;6837;1576;4362;308;894;558;1361;866;2255
432183;202006;353;1038;233;751;57;206;62;185;119;391
432185;202006;789;2040;459;1387;38;132;247;699;285;831
432190;202006;1768;4314;1138;3296;200;636;567;1551;767;2187
432195;202006;884;2225;576;1669;164;444;198;608;362;1052
432200;202006;3119;7984;2221;6526;379;1127;1225;3653;1604;4780
432210;202006;361;950;219;670;41;158;102;262;143;420
432215;202006;611;1787;552;1696;53;146;409;1276;462;1422
432218;202006;246;612;108;306;15;53;52;133;67;186
432220;202006;3415;8084;2517;6657;444;1251;1384;3584;1828;4835
432225;202006;87;246;65;201;9;30;38;117;47;147
432230;202006;689;1603;366;997;39;113;166;409;205;522
432232;202006;473;1164;295;854;58;180;106;278;164;458
432234;202006;267;665;121;354;21;53;14;38;35;91
432235;202006;48;137;17;55;5;17;4;13;9;30
432237;202006;320;823;278;753;11;22;228;606;239;628
432240;202006;15087;37583;10771;31737;801;2569;6825;21086;7626;23655
432250;202006;4891;14177;3730;11867;985;3277;1530;4841;2515;8118
432252;202006;440;1047;272;751;35;103;141;373;176;476
432253;202006;879;2710;546;1850;130;471;45;141;175;612
432254;202006;669;1572;166;496;27;84;28;70;55;154
432255;202006;109;276;56;170;3;9;27;73;30;82
432260;202006;4649;11991;3423;9656;991;2895;1087;2945;2078;5840
432270;202006;1718;4822;1361;4126;403;1322;280;791;683;2113
432280;202006;1291;3211;644;1915;99;315;237;583;336;898
432285;202006;138;414;19;57;2;6;2;4;4;10
432290;202006;324;912;169;535;57;183;32;74;89;257
432300;202006;25333;64035;18732;53242;2723;8742;10829;29677;13552;38419
432310;202006;802;2169;572;1734;56;171;394;1196;450;1367
432320;202006;216;507;78;239;8;29;29;80;37;109
432330;202006;214;481;62;199;8;20;11;35;19;55
432335;202006;181;501;62;217;5;21;15;50;20;71
432340;202006;295;700;127;394;11;33;47;137;58;170
432345;202006;655;1520;574;1420;18;48;470;1150;488;1198
432350;202006;343;899;185;586;27;89;74;234;101;323
432360;202006;234;683;46;153;3;6;17;58;20;64
432370;202006;304;758;201;580;15;49;135;385;150;434
432375;202006;463;1167;339;923;61;159;169;466;230;625
432377;202006;178;557;34;114;7;28;6;16;13;44
432380;202006;1591;4240;1013;3165;176;630;507;1517;683;2147
500020;202006;2466;6409;1766;5213;159;555;1091;3121;1250;3676
500025;202006;1199;2938;743;2074;70;209;404;1071;474;1280
500060;202006;7643;21617;5174;16455;631;2090;2982;9760;3613;11850
500070;202006;4183;10836;2875;8583;531;1617;1233;3771;1764;5388
500080;202006;1528;3796;940;2703;180;575;364;924;544;1499
500085;202006;2012;5029;1366;3949;317;962;640;1778;957;2740
500090;202006;2077;5538;1385;4306;240;789;480;1579;720;2368
500100;202006;3526;8991;2661;7579;453;1451;1288;3477;1741;4928
500110;202006;7885;20175;4991;15516;1072;3651;1511;5525;2583;9176
500124;202006;2002;5893;1586;5182;257;789;838;2883;1095;3672
500150;202006;1280;2918;793;2203;141;409;321;891;462;1300
500190;202006;4677;12113;2945;8741;635;1923;754;2160;1389;4083
500200;202006;2198;5248;1604;4247;176;488;977;2482;1153;2970
500210;202006;4514;11037;3189;9284;849;2462;1396;4164;2245;6626
500215;202006;1340;3755;947;3024;91;321;516;1636;607;1957
500220;202006;2485;6991;1564;5203;263;947;385;1223;648;2170
500230;202006;2016;4737;1512;4030;179;446;1013;2684;1192;3130
500240;202006;3770;11188;2625;8778;399;1487;1028;3552;1427;5039
500260;202006;3150;6710;1953;5068;274;714;1006;2515;1280;3229
500270;202006;134025;315224;78867;220769;13214;40627;28814;75924;42028;116551
500280;202006;1294;3276;882;2635;124;394;480;1410;604;1804
500290;202006;3515;8342;1985;5770;323;1070;630;1654;953;2724
500295;202006;3338;8110;2058;5816;319;989;785;1913;1104;2902
500310;202006;943;1964;627;1562;99;213;319;828;418;1041
500315;202006;3620;10102;2834;8910;241;779;1996;6417;2237;7196
500320;202006;19099;51429;13165;41555;3340;11079;4498;15089;7838;26168
500325;202006;4179;9335;2853;7578;221;624;1938;5210;2159;5834
500330;202006;6572;15012;4295;11667;335;997;2356;6575;2691;7572
500345;202006;2008;4930;1332;3884;313;946;443;1282;756;2228
500348;202006;2300;5970;1769;5089;240;712;1016;2975;1256;3687
500350;202006;1270;3478;699;2226;82;256;284;865;366;1121
500370;202006;24798;64086;17159;51470;2299;7905;8937;26633;11236;34538
500375;202006;2408;6354;1584;4658;294;938;526;1445;820;2383
500380;202006;3357;8399;2269;6537;634;1977;532;1546;1166;3523
500390;202006;588;1188;345;899;56;179;208;511;264;690
500400;202006;1438;3662;947;2711;171;564;325;832;496;1396
500410;202006;2369;5848;1657;4773;180;509;950;2861;1130;3370
500430;202006;2537;6240;1703;4992;222;769;727;2235;949;3004
500440;202006;1151;2830;724;2153;112;364;279;879;391;1243
500450;202006;1403;3479;767;2305;135;426;190;532;325;958
500460;202006;3603;9711;2176;6858;355;1277;687;2113;1042;3390
500470;202006;2420;6532;1454;4520;411;1422;314;854;725;2276
500480;202006;2090;6356;1762;5826;171;586;1302;4375;1473;4961
500490;202006;1017;2345;590;1703;126;449;162;461;288;910
500500;202006;4148;11124;2629;8621;923;3563;444;1502;1367;5065
500510;202006;672;1720;430;1259;26;91;265;752;291;843
500515;202006;1701;4359;1295;3709;138;433;817;2241;955;2674
500520;202006;3047;9562;2374;8289;628;2229;954;3550;1582;5779
500525;202006;849;2549;696;2314;58;203;442;1494;500;1697
500540;202006;4389;11430;2622;8276;683;2684;243;683;926;3367
500560;202006;5379;14637;4295;13268;278;876;3441;10813;3719;11689
500568;202006;4184;9166;2489;6637;578;1703;878;2336;1456;4039
500570;202006;7413;17309;4435;12213;809;2416;1611;4164;2420;6580
500580;202006;2971;7936;2147;6469;474;1493;993;3007;1467;4500
500600;202006;3299;8232;2343;6736;521;1540;979;2878;1500;4418
500620;202006;7533;19917;5023;15085;1055;3319;1800;5297;2855;8616
500625;202006;534;1467;336;1038;58;189;91;253;149;442
500627;202006;738;1914;437;1369;72;247;145;448;217;695
500630;202006;6467;15001;3707;10378;767;2341;1089;3069;1856;5410
500635;202006;2826;8918;2185;8075;162;665;1527;6135;1689;6800
500640;202006;1677;3688;1098;2914;38;119;757;1979;795;2098
500660;202006;17277;44599;11782;36575;3701;13046;2962;9446;6663;22492
500690;202006;2266;6346;1473;4958;519;2044;80;199;599;2243
500710;202006;2748;7420;2109;6315;599;1894;656;1857;1255;3751
500720;202006;4713;11968;3035;9160;697;2232;905;2812;1602;5044
500730;202006;1003;2511;577;1739;110;311;145;471;255;782
500740;202006;4482;10719;3039;8419;392;1136;1588;4406;1980;5542
500750;202006;947;2441;625;1843;84;249;242;652;326;901
500755;202006;881;2317;475;1521;87;301;95;270;182;571
500769;202006;4914;12065;2649;7790;510;1684;374;889;884;2573
500770;202006;1453;3920;929;2979;163;596;321;1013;484;1609
500780;202006;1179;2868;759;2161;157;505;205;554;362;1059
500790;202006;6966;18545;5390;15912;1103;3496;2652;7876;3755;11372
500793;202006;1987;5143;1393;4095;358;1121;441;1207;799;2328
500795;202006;2645;6575;2150;5947;99;246;1738;5062;1837;5308
500797;202006;672;1707;442;1278;123;372;140;403;263;775
500800;202006;3094;7053;1862;5210;582;1930;209;631;791;2561
500830;202006;17946;45033;12114;34245;2536;7707;4379;11705;6915;19412
500840;202006;1359;3316;822;2305;96;278;328;868;424;1146
510010;202006;1774;4015;1173;3236;104;269;838;2350;942;2619
510020;202006;3310;8404;1744;5326;372;1220;391;1081;763;2301
510025;202006;6501;15901;3946;11717;586;1981;1631;4685;2217;6666
510030;202006;2450;5506;1603;4235;340;913;618;1598;958;2511
510035;202006;1195;3124;749;2406;83;289;446;1523;529;1812
510040;202006;2254;5029;1643;4236;166;419;1023;2756;1189;3175
510050;202006;2048;4319;1337;3391;146;406;932;2321;1078;2727
510060;202006;1295;3288;936;2706;196;624;266;720;462;1344
510080;202006;1208;3190;771;2448;265;877;211;577;476;1454
510100;202006;636;1490;435;1171;55;156;230;596;285;752
510120;202006;267;486;146;343;10;22;107;256;117;278
510125;202006;2005;4964;1565;4330;161;580;832;2156;993;2736
510130;202006;1408;3551;978;2861;202;649;308;923;510;1572
510140;202006;3025;7835;2054;6606;731;2746;722;2182;1453;4928
510160;202006;1691;4361;1236;3769;160;469;897;2800;1057;3269
510170;202006;4373;11561;3169;9612;775;2476;1233;3832;2008;6308
510180;202006;14223;32003;8861;24068;1938;5775;2633;8113;4571;13888
510185;202006;1649;4292;1082;3480;437;1430;278;1155;715;2585
510190;202006;2016;5778;1294;4545;355;1372;226;873;581;2245
510250;202006;16347;41486;12118;35157;2337;7080;6114;18464;8451;25544
510260;202006;1877;7911;1551;7318;262;1333;939;4826;1201;6159
510263;202006;3002;8345;1826;5957;309;1128;260;737;569;1865
510267;202006;4715;13422;2663;8831;485;1709;362;1083;847;2792
510268;202006;1219;2979;923;2531;110;291;606;1658;716;1949
510269;202006;986;2682;600;1946;144;514;185;553;329;1067
510270;202006;2822;8101;1927;6463;342;1275;788;2604;1130;3879
510279;202006;1727;4457;1066;3294;200;689;437;1311;637;2000
510285;202006;1095;2864;740;2244;231;794;157;425;388;1219
510300;202006;3606;9130;2636;7814;370;1144;1544;4780;1914;5924
510305;202006;1403;3860;846;2775;184;639;194;715;378;1354
510310;202006;901;2210;602;1706;168;496;170;506;338;1002
510320;202006;3583;8906;2438;6925;557;1737;617;1727;1174;3464
510325;202006;4143;12274;3093;10348;888;3124;942;3271;1830;6395
510330;202006;2651;8013;1786;6472;350;1276;661;2763;1011;4039
510335;202006;4689;13502;3532;11642;536;1914;2006;6788;2542;8702
510336;202006;432;1218;307;1017;51;170;152;556;203;726
510337;202006;1466;4276;942;3317;364;1408;185;661;549;2069
510340;202006;88787;197475;55541;148949;13468;42906;16333;41063;29801;83969
510343;202006;1001;2757;680;2159;121;439;288;866;409;1305
510345;202006;1230;3534;924;2932;155;488;419;1305;574;1793
510350;202006;2718;7079;1760;5440;377;1244;694;2103;1071;3347
510360;202006;1844;3836;1182;3057;69;135;816;2282;885;2417
510370;202006;1730;4903;1249;4071;174;625;734;2488;908;3113
510380;202006;548;1356;299;922;55;193;114;342;169;535
510385;202006;1197;4003;874;3394;93;415;549;2205;642;2620
510390;202006;1239;3289;836;2765;249;833;277;1076;526;1909
510395;202006;709;1609;472;1258;27;74;292;828;319;902
510410;202006;4645;12988;3356;10676;653;2166;1732;5710;2385;7876
510420;202006;2401;5058;1624;4024;132;354;1053;2593;1185;2947
510450;202006;421;1051;247;717;59;173;38;125;97;298
510452;202006;738;2053;519;1640;74;252;295;908;369;1160
510454;202006;911;2524;703;2167;74;223;432;1407;506;1630
510455;202006;896;2494;643;1979;108;367;253;719;361;1086
510460;202006;1737;4306;1227;3549;93;334;783;2167;876;2501
510480;202006;4411;10608;2877;7814;563;1693;1149;3038;1712;4731
510490;202006;1627;4220;1204;3687;170;522;784;2431;954;2953
510500;202006;1490;3740;917;2806;182;595;307;951;489;1546
510510;202006;3345;9787;2463;8189;602;2256;773;2713;1375;4969
510515;202006;5144;13218;3333;9957;803;2679;851;2254;1654;4933
510517;202006;1022;2992;773;2571;233;860;142;415;375;1275
510520;202006;2041;4161;1155;3055;84;224;598;1693;682;1917
510523;202006;1069;2664;791;2216;174;466;450;1306;624;1772
510525;202006;6917;18946;5158;15543;798;2674;2482;7079;3280;9753
510530;202006;551;1415;400;1191;29;93;254;743;283;836
510550;202006;2301;6831;1653;5692;384;1392;740;2563;1124;3955
510558;202006;2223;5974;1602;4991;216;648;748;2533;964;3181
510560;202006;1589;4548;939;3248;193;758;236;884;429;1642
510562;202006;5438;14170;3883;11354;902;2851;1319;4048;2221;6899
510590;202006;3089;7602;2193;6468;171;523;1570;4731;1741;5254
510600;202006;1382;3124;886;2404;161;439;398;1096;559;1535
510610;202006;2586;6256;1767;5180;170;568;1109;3265;1279;3833
510615;202006;2578;6455;1778;5165;307;919;936;2794;1243;3713
510617;202006;976;2941;748;2567;102;399;468;1670;570;2069
510618;202006;1208;3225;824;2552;185;628;375;1111;560;1739
510619;202006;736;1853;472;1408;67;210;131;370;198;580
510620;202006;1400;3155;652;1937;175;639;36;77;211;716
510621;202006;1489;3986;894;2839;190;665;271;805;461;1470
510622;202006;4444;12557;3006;9451;1011;3400;426;1218;1437;4618
510623;202006;2600;6435;1816;5193;427;1440;586;1627;1013;3067
510624;202006;1620;4082;757;2500;93;325;168;508;261;833
510625;202006;2798;6845;1489;4488;250;895;331;1011;581;1906
510626;202006;1460;3530;907;2646;250;840;209;608;459;1448
510627;202006;597;1546;334;1031;82;281;83;273;165;554
510628;202006;1431;3303;939;2644;193;580;354;982;547;1562
510629;202006;1543;4385;1136;3652;225;772;418;1341;643;2113
510630;202006;3229;9004;1869;6397;432;1583;335;1227;767;2810
510631;202006;569;1368;412;1136;14;38;315;898;329;936
510637;202006;3353;8065;2395;6676;597;1874;670;1885;1267;3759
510642;202006;5298;15135;4001;13160;972;3475;1715;5790;2687;9265
510645;202006;882;1766;538;1320;165;381;216;535;381;916
510650;202006;6883;17635;5443;16052;621;1640;3749;12212;4370;13852
510665;202006;1864;4042;1147;2881;232;561;425;1148;657;1709
510670;202006;430;919;248;656;25;66;140;380;165;446
510675;202006;5914;16313;3980;12663;1104;3907;670;2057;1774;5964
510677;202006;2033;5245;1394;4276;201;712;742;2210;943;2922
510680;202006;688;1763;385;1198;74;254;77;223;151;477
510682;202006;1488;4406;1082;3730;378;1448;243;806;621;2254
510685;202006;525;1530;375;1219;58;205;188;604;246;809
510700;202006;4010;9643;2776;7892;262;811;2032;5770;2294;6581
510704;202006;10457;24569;6810;18282;1499;4331;1760;4581;3259;8912
510706;202006;1913;5799;1372;4901;264;961;726;2817;990;3778
510710;202006;2603;6509;1683;4785;370;1087;561;1529;931;2616
510715;202006;580;1298;418;1076;36;109;205;515;241;624
510718;202006;2290;5150;1321;3854;388;1145;446;1591;834;2736
510719;202006;439;928;255;688;22;61;148;378;170;439
510720;202006;875;2045;562;1571;93;297;264;697;357;994
510724;202006;792;2164;545;1703;76;253;297;903;373;1156
510726;202006;1036;1878;550;1291;61;165;270;636;331;801
510729;202006;595;1387;259;749;33;111;63;198;96;309
510730;202006;2861;6930;1908;5441;248;807;947;2641;1195;3448
510735;202006;994;2859;751;2514;75;314;550;1821;625;2135
510740;202006;913;2268;573;1628;97;277;254;712;351;989
510757;202006;499;1537;388;1364;123;479;139;469;262;948
510760;202006;43153;94751;25600;67750;5202;15842;8048;19545;13250;35387
510770;202006;4187;9452;2831;7744;241;614;1927;5547;2168;6161
510774;202006;341;871;233;691;36;106;122;371;158;477
510775;202006;601;1599;382;1238;80;284;84;252;164;536
510776;202006;416;1044;294;817;71;196;97;290;168;486
510777;202006;1484;3961;1058;3410;145;544;675;2152;820;2696
510779;202006;658;1767;508;1530;57;164;289;951;346;1115
510780;202006;3607;9250;2642;7895;640;1891;1141;3862;1781;5753
510785;202006;1969;5211;1135;3675;297;1037;185;685;482;1722
510787;202006;2562;7262;1678;5394;545;1852;200;648;745;2500
510788;202006;586;1398;411;1127;64;187;197;612;261;799
510790;202006;16950;43828;10173;31180;2149;7428;1616;4402;3765;11830
510792;202006;9002;24543;5597;17977;1184;4327;960;2711;2144;7038
510794;202006;1206;3209;816;2535;248;856;157;431;405;1287
510795;202006;7943;20883;5104;15714;1162;3955;1310;3965;2472;7920
510800;202006;1656;4290;1070;3291;355;1112;121;364;476;1476
510805;202006;1467;4074;1005;3203;240;819;331;963;571;1782
510810;202006;618;1266;389;958;105;262;154;403;259;665
510820;202006;741;1412;404;982;32;95;212;523;244;618
510830;202006;827;2003;587;1696;47;134;414;1275;461;1409
510835;202006;541;1306;348;1023;38;127;208;597;246;724
510840;202006;51564;110142;35379;90411;6921;16692;17790;50320;24711;67012
510850;202006;1779;4274;1001;3033;330;1145;121;335;451;1480
510860;202006;2281;6071;1406;4569;438;1658;113;358;551;2016
510880;202006;693;1971;520;1647;126;414;187;601;313;1015
510885;202006;554;1351;383;1110;78;251;126;357;204;608
510890;202006;616;1821;469;1571;107;386;210;704;317;1090
510895;202006;1255;3208;831;2517;162;585;361;1021;523;1606
520005;202006;2533;6486;1946;5760;572;1695;815;2752;1387;4447
520010;202006;2187;6260;1562;5065;386;1414;471;1338;857;2752
520013;202006;2749;7055;1794;5296;396;1204;512;1649;908;2853
520015;202006;500;1261;354;1044;81;247;140;436;221;683
520017;202006;1145;2924;854;2475;148;470;480;1368;628;1838
520020;202006;393;879;300;762;24;82;232;559;256;641
520025;202006;32754;91780;28030;85139;2790;9269;20131;60840;22921;70109
520030;202006;5541;14169;4413;12586;303;951;3131;8874;3434;9825
520050;202006;400;942;250;685;14;41;158;443;172;484
520055;202006;1760;4260;1134;3050;98;250;646;1696;744;1946
520060;202006;1382;3812;993;3097;254;879;245;765;499;1644
520080;202006;1759;4563;1306;3947;234;710;638;2108;872;2818
520082;202006;894;2266;698;1942;78;201;369;1082;447;1283
520085;202006;803;2157;620;1856;110;337;300;885;410;1222
520090;202006;831;1631;568;1342;56;89;437;1087;493;1176
520110;202006;37670;101202;25880;81516;7898;28384;2251;6447;10149;34831
520120;202006;197;465;110;322;14;49;45;127;59;176
520130;202006;3558;8719;2768;7499;534;1464;1194;3320;1728;4784
520140;202006;39603;105747;27304;84627;9767;32859;3558;11468;13325;44327
520145;202006;591;1370;397;1094;59;187;235;603;294;790
520150;202006;606;1360;435;1153;73;194;237;645;310;839
520160;202006;741;1723;535;1399;102;257;238;664;340;921
520170;202006;4897;9852;3236;7951;180;506;2483;6047;2663;6553
520180;202006;2140;5816;1737;5236;312;1049;972;2906;1284;3955
520215;202006;1681;4048;1190;3290;279;836;410;1074;689;1910
520235;202006;594;1355;339;961;37;128;130;355;167;483
520250;202006;1522;3898;1045;3090;325;1044;252;798;577;1842
520260;202006;787;1835;499;1376;91;260;209;591;300;851
520280;202006;702;1726;543;1482;115;319;258;751;373;1070
520310;202006;1015;2226;658;1692;150;439;252;681;402;1120
520320;202006;1595;4276;1200;3646;156;525;661;1970;817;2495
520330;202006;3825;10303;2755;8552;411;1521;1437;4354;1848;5875
520340;202006;2414;5318;1488;4034;170;431;872;2482;1042;2913
520350;202006;2811;6708;1981;5452;586;1689;753;2115;1339;3804
520355;202006;1799;4908;1266;3838;420;1381;288;762;708;2143
520357;202006;733;1767;522;1457;29;75;391;1122;420;1197
520360;202006;694;1820;525;1540;139;426;152;478;291;904
520380;202006;1409;3481;820;2391;87;266;417;1142;504;1408
520390;202006;1003;2206;591;1696;161;500;202;624;363;1124
520393;202006;493;1183;328;923;38;121;151;395;189;516
520396;202006;830;2133;692;1913;39;129;514;1377;553;1506
520400;202006;1565;3840;1187;3326;150;463;801;2243;951;2706
520410;202006;1951;4401;1170;3202;196;586;446;1161;642;1747
520420;202006;361;834;279;705;21;57;219;533;240;590
520425;202006;1449;3527;809;2344;212;636;166;455;378;1091
520430;202006;2251;5163;1249;3591;233;792;46;128;279;920
520440;202006;2887;6998;1720;4934;415;1322;448;1221;863;2543
520450;202006;11609;27509;7570;21428;2371;7341;1439;4192;3810;11533
520455;202006;687;1879;500;1597;142;479;140;462;282;941
520460;202006;1005;2337;779;2050;74;170;624;1676;698;1846
520465;202006;763;1926;610;1719;77;257;430;1161;507;1418
520470;202006;2026;5233;1541;4584;478;1480;595;1888;1073;3368
520480;202006;909;2525;628;2041;194;648;144;489;338;1137
520485;202006;1534;4331;1282;3984;163;521;910;2822;1073;3343
520490;202006;3888;10708;2880;9101;989;3237;1039;3434;2028;6671
520495;202006;1571;3446;1181;2916;50;124;950;2352;1000;2476
520500;202006;1196;3222;812;2470;190;620;326;993;516;1613
520505;202006;751;1643;517;1346;61;165;331;849;392;1014
520510;202006;7526;18696;4922;14647;1130;3765;1353;4355;2483;8120
520520;202006;1129;2837;833;2372;195;609;300;858;495;1467
520530;202006;2024;5755;1517;4917;416;1405;592;2023;1008;3428
520540;202006;2817;7435;1734;5289;325;1079;423;1214;748;2293
520545;202006;937;2440;696;2045;144;417;282;844;426;1261
520547;202006;785;2144;624;1875;150;450;311;946;461;1396
520549;202006;13169;35159;10851;31771;1478;4600;7295;21232;8773;25832
520551;202006;4455;12007;3696;10891;388;1344;2626;7568;3014;8912
520552;202006;810;2083;665;1899;138;394;384;1158;522;1552
520570;202006;519;1156;342;909;83;198;135;405;218;603
520580;202006;2154;4924;1617;4297;111;367;1190;3108;1301;3475
520590;202006;1225;3066;845;2455;265;779;223;665;488;1444
520620;202006;7903;21396;6168;18858;1543;4861;2745;8672;4288;13533
520630;202006;715;1841;490;1448;82;256;142;391;224;647
520640;202006;2326;5772;1769;4800;410;1094;745;2097;1155;3191
520650;202006;828;1936;604;1623;88;234;340;966;428;1200
520660;202006;530;1270;278;826;54;187;73;210;127;397
520670;202006;930;2509;781;2296;66;197;508;1472;574;1669
520680;202006;680;1727;508;1455;80;223;263;762;343;985
520690;202006;323;748;218;596;66;165;69;215;135;380
520710;202006;408;985;286;777;12;28;208;553;220;581
520725;202006;1488;3490;1014;2726;115;363;638;1641;753;2004
520735;202006;755;1848;495;1418;105;286;187;577;292;863
520740;202006;2061;4650;1541;4039;268;648;871;2469;1139;3117
520750;202006;649;1572;445;1239;69;191;227;635;296;826
520753;202006;1244;3307;941;2745;182;560;380;1041;562;1601
520760;202006;1171;2623;1026;2449;31;58;938;2276;969;2334
520780;202006;1464;3426;1036;2832;114;328;527;1416;641;1744
520790;202006;3314;7874;2345;6295;318;863;1296;3670;1614;4533
520800;202006;15963;41328;12327;36016;1878;5727;7199;21643;9077;27370
520810;202006;1298;2697;955;2304;157;391;607;1550;764;1941
520815;202006;562;1715;418;1420;75;282;121;422;196;704
520830;202006;1803;3818;1274;3224;43;101;1052;2635;1095;2736
520840;202006;2503;6732;2018;6099;855;2808;533;1730;1388;4538
520850;202006;627;1623;461;1376;158;550;114;352;272;902
520860;202006;6300;16926;4544;14066;1200;4015;1655;5054;2855;9069
520870;202006;103195;238799;68497;187152;15058;44620;24282;65225;39340;109845
520880;202006;6607;18981;5064;16206;1163;3902;1878;6055;3041;9957
520890;202006;3827;9208;2579;7241;521;1604;1100;3088;1621;4692
520910;202006;4519;11385;2847;8469;708;2277;654;1907;1362;4184
520915;202006;701;1959;410;1296;70;241;140;427;210;668
520920;202006;4291;9628;2982;7973;363;1008;1671;4662;2034;5670
520929;202006;679;1587;507;1334;63;137;264;744;327;881
520940;202006;948;2510;734;2211;41;132;540;1595;581;1727
520945;202006;471;1069;379;939;17;39;273;667;290;706
520960;202006;1021;2466;802;2132;172;403;454;1249;626;1652
520970;202006;2462;6763;1905;5866;476;1651;492;1617;968;3268
520980;202006;768;1859;557;1571;99;291;225;623;324;914
520990;202006;2943;7840;2349;7054;343;993;1537;4721;1880;5714
520993;202006;1121;2636;767;2088;113;345;431;1113;544;1458
520995;202006;2236;5656;1667;4857;264;782;656;1971;920;2753
521000;202006;8454;22051;5527;16771;1121;3529;1659;5023;2780;8552
521010;202006;3579;9306;2661;7720;257;748;1549;4456;1806;5204
521015;202006;779;1918;534;1489;43;136;334;889;377;1025
521020;202006;3119;7952;1793;5391;530;1771;127;408;657;2179
521030;202006;477;1047;315;799;67;154;128;353;195;507
521040;202006;7540;18465;5522;15270;1189;3434;2328;6593;3517;10027
521056;202006;908;2389;706;2089;224;657;195;648;419;1305
521060;202006;934;2484;682;2022;88;271;296;872;384;1143
521080;202006;1106;2377;557;1518;72;212;232;550;304;762
521090;202006;3155;8434;2113;6381;581;1873;281;885;862;2758
521100;202006;1722;3998;1212;3273;193;516;716;1958;909;2474
521120;202006;4611;10780;3309;9175;203;516;1628;5265;1831;5781
521130;202006;994;2235;553;1470;20;61;293;828;313;889
521140;202006;1231;3164;890;2576;112;343;432;1264;544;1607
521150;202006;12235;26730;7519;20022;1266;3912;3545;9624;4811;13536
521160;202006;629;1307;439;1031;48;110;292;663;340;773
521170;202006;1010;2358;726;1939;56;155;493;1293;549;1448
521180;202006;7045;19511;5751;17249;917;2984;2992;8696;3909;11680
521190;202006;10441;25952;5959;18362;1512;4976;1184;3926;2696;8902
521200;202006;692;1691;478;1343;48;143;270;759;318;902
521205;202006;623;1538;466;1287;16;50;350;924;366;974
521210;202006;684;1748;390;1158;81;259;72;165;153;424
521220;202006;3576;8721;2285;6692;394;1297;862;2501;1256;3798
521225;202006;366;785;265;677;46;119;153;391;199;510
521230;202006;1310;3341;1148;3142;367;1017;582;1692;949;2709
521250;202006;30207;80636;23264;70397;8585;27290;6780;21879;15365;49169
521260;202006;552;1272;396;1024;53;138;226;578;279;716
521270;202006;1787;4522;1553;4248;86;200;1185;3278;1271;3478
521280;202006;1754;4697;1294;3925;307;1036;542;1662;849;2698
521290;202006;476;1113;334;929;44;142;208;559;252;701
521295;202006;1094;2365;823;2067;63;114;671;1748;734;1862
521300;202006;1825;4504;1428;3945;265;691;905;2580;1170;3271
521305;202006;709;1695;503;1385;71;182;288;802;359;984
521308;202006;4709;12570;3249;9764;301;903;1897;5608;2198;6511
521310;202006;8138;20738;5584;16447;1211;3895;2303;6502;3514;10397
521340;202006;407;954;297;793;20;54;201;521;221;575
521350;202006;2001;5094;1502;4340;125;448;1068;2939;1193;3387
521370;202006;1215;3072;711;2199;204;729;86;290;290;1019
521375;202006;1288;3132;863;2522;198;576;265;863;463;1439
521377;202006;1468;3104;1060;2604;83;143;859;2218;942;2361
521380;202006;6057;16030;3892;12028;401;1355;1041;3441;1442;4796
521385;202006;642;1550;492;1358;57;145;281;842;338;987
521390;202006;704;1722;489;1399;143;450;179;540;322;990
521400;202006;2612;6031;2013;5302;226;592;1389;3749;1615;4341
521405;202006;1279;3247;922;2637;178;515;447;1271;625;1786
521410;202006;795;2126;588;1760;104;293;294;939;398;1232
521440;202006;1155;2902;819;2391;274;876;230;679;504;1555
521450;202006;3854;11416;2806;9376;737;2480;722;2576;1459;5056
521460;202006;5604;14689;3898;11652;1313;4118;894;2752;2207;6870
521470;202006;606;1633;361;1119;49;146;119;362;168;508
521480;202006;361;912;213;628;42;126;72;203;114;329
521483;202006;2385;5674;1656;4555;361;1067;646;1762;1007;2829
521486;202006;1734;4081;1279;3441;75;202;929;2482;1004;2684
521487;202006;405;986;285;819;44;130;143;419;187;549
521490;202006;894;2375;658;1988;35;137;467;1370;502;1507
521500;202006;2260;5483;1656;4537;99;336;1195;3182;1294;3518
521520;202006;720;1669;508;1358;76;215;213;580;289;795
521523;202006;11211;34444;9151;31095;2487;9314;2482;8721;4969;18035
521525;202006;1031;2355;757;1973;74;200;543;1402;617;1602
521530;202006;2226;5750;1290;3839;288;893;323;963;611;1856
521540;202006;829;2079;556;1627;76;253;263;799;339;1052
521550;202006;1491;3791;817;2411;147;490;216;655;363;1145
521560;202006;4460;11680;3043;9763;453;1712;1544;5243;1997;6955
521565;202006;632;1515;483;1306;72;179;294;786;366;965
521570;202006;3384;9216;2218;6950;436;1602;203;671;639;2273
521580;202006;477;1151;274;808;42;130;82;217;124;347
521590;202006;636;1490;464;1246;83;244;266;702;349;946
521600;202006;372;999;241;745;33;82;105;326;138;408
521630;202006;1645;3599;995;2647;203;582;345;891;548;1473
521640;202006;1791;4146;1193;3284;255;741;416;1128;671;1869
521645;202006;548;1424;345;1054;84;231;113;356;197;587
521680;202006;1081;3268;826;2772;240;879;120;442;360;1321
521690;202006;529;1282;437;1159;61;172;277;723;338;895
521710;202006;3160;7861;1989;5940;356;1210;492;1376;848;2586
521720;202006;2163;4982;1384;3797;146;450;782;2152;928;2602
521730;202006;3504;9764;2651;8274;744;2716;724;1909;1468;4625
521740;202006;3808;9961;2834;8533;691;2241;1073;3378;1764;5619
521760;202006;14597;39921;11221;34696;2856;9797;4133;13357;6989;23154
521770;202006;2935;7034;1919;5384;574;1740;490;1381;1064;3121
521800;202006;6293;16864;4503;13851;1016;3194;1779;5934;2795;9128
521805;202006;476;1162;353;986;106;269;151;433;257;702
521810;202006;611;1436;427;1186;63;179;251;706;314;885
521830;202006;5458;15089;4295;13284;287;1076;3093;9386;3380;10462
521839;202006;723;1704;500;1341;82;252;274;660;356;912
521850;202006;5396;12548;3354;9501;578;1842;558;1498;1136;3340
521860;202006;1504;3971;1026;3135;183;610;321;967;504;1577
521870;202006;682;1899;485;1510;101;348;124;344;225;692
521878;202006;652;1686;436;1262;55;185;230;605;285;790
521880;202006;18306;44468;12212;35064;3078;9371;4287;12512;7365;21883
521890;202006;3027;7812;1971;5958;558;1828;360;998;918;2826
521900;202006;1459;3413;816;2415;243;692;91;274;334;966
521910;202006;1228;2595;804;2100;73;190;447;1281;520;1471
521920;202006;467;1283;342;1062;63;225;145;431;208;656
521925;202006;740;1920;531;1615;82;260;290;876;372;1136
521930;202006;5356;12794;3493;9947;899;2397;1313;4168;2212;6565
521935;202006;998;2392;674;1809;66;186;403;1032;469;1218
521940;202006;1333;2926;851;2268;198;585;336;880;534;1465
521945;202006;557;1517;451;1336;99;301;243;732;342;1033
521950;202006;739;1792;508;1425;123;352;214;575;337;927
521960;202006;712;1832;458;1359;57;184;242;666;299;850
521970;202006;2518;6144;1992;5515;163;439;1522;4267;1685;4706
521971;202006;747;1755;526;1434;149;398;150;419;299;817
521973;202006;1369;3540;1082;3106;39;116;831;2368;870;2484
521975;202006;11754;30896;9587;27886;1520;4607;6012;17576;7532;22183
521980;202006;2526;5881;1926;5082;149;383;1447;3914;1596;4297
521990;202006;1065;2997;838;2590;180;590;299;925;479;1515
522000;202006;2534;6690;2042;6079;286;829;1319;4106;1605;4935
522005;202006;334;803;251;679;50;128;125;350;175;478
522010;202006;3901;9467;2724;7567;618;1893;987;2666;1605;4559
522015;202006;975;2559;709;2150;217;646;258;816;475;1462
522020;202006;5442;12930;3539;9910;730;2134;1400;4049;2130;6183
522026;202006;762;2027;510;1570;92;310;180;513;272;823
522028;202006;418;1036;308;856;66;192;133;360;199;552
522040;202006;3054;6896;2160;5695;268;748;1449;3782;1717;4530
522045;202006;17214;47776;12626;39580;2971;10057;3451;10538;6422;20595
522050;202006;1075;2823;719;2197;185;640;250;674;435;1314
522060;202006;2864;7499;1961;5995;167;510;1129;3569;1296;4079
522068;202006;1801;4584;1402;4105;119;325;1091;3235;1210;3560
522070;202006;634;1532;508;1344;19;56;424;1100;443;1156
522100;202006;726;1859;487;1477;60;207;254;740;314;947
522108;202006;975;2492;752;2171;54;204;595;1663;649;1867
522119;202006;1543;3795;1177;3313;188;545;624;1849;812;2394
522130;202006;387;983;274;824;26;74;185;583;211;657
522140;202006;17293;45862;11954;36252;3116;10152;3189;9268;6305;19420
522145;202006;787;1948;524;1541;147;427;188;560;335;987
522150;202006;1056;2572;746;2057;208;570;218;630;426;1200
522155;202006;1071;2686;816;2282;156;393;455;1316;611;1709
522157;202006;586;1379;479;1243;27;87;379;987;406;1074
522160;202006;5941;15331;3800;11394;1029;3324;301;991;1330;4315
522170;202006;2611;6661;1946;5664;301;895;1092;3238;1393;4133
522180;202006;506;1166;339;883;63;171;82;235;145;406
522185;202006;18301;45183;12784;37579;5006;15967;2785;8818;7791;24785
522190;202006;765;1835;516;1402;97;280;197;519;294;799
522200;202006;1621;4579;1064;3508;220;793;187;554;407;1347
522205;202006;1664;3863;1260;3320;133;369;865;2282;998;2651
522220;202006;1249;3085;919;2586;109;327;540;1557;649;1884
522230;202006;1103;2806;881;2487;191;664;441;1165;632;1829
530010;202006;168014;450227;134517;400714;20893;68169;78151;229624;99044;297793
110001;202005;3924;11006;2610;8521;589;2063;1013;3364;1602;5427
110002;202005;12099;31673;8424;25274;2359;7506;2254;6846;4613;14352
110003;202005;619;1810;433;1421;103;363;105;326;208;689
110004;202005;11008;28827;7235;22036;1531;5090;2106;6571;3637;11661
110005;202005;2468;6430;1664;5083;357;1185;449;1485;806;2670
110006;202005;1767;4907;1093;3467;198;731;209;621;407;1352
110007;202005;1185;3032;736;2273;234;781;179;680;413;1461
110008;202005;3281;9108;2396;7749;267;849;1586;5460;1853;6309
110009;202005;4293;12066;2741;9215;597;2119;1100;3737;1697;5856
110010;202005;7486;24239;5447;20163;1108;4153;2636;10608;3744;14761
110011;202005;6754;18066;4552;14049;1630;5273;647;2092;2277;7365
110012;202005;15050;37633;8714;26351;2073;6763;791;2606;2864;9369
110013;202005;5147;15054;3722;12098;1514;5185;461;1662;1975;6847
110014;202005;3753;9995;2533;7678;589;1903;1011;2993;1600;4896
110015;202005;5441;14140;3135;9565;718;2402;647;1824;1365;4226
110018;202005;3701;9322;2109;6512;404;1456;595;1813;999;3269
110020;202005;73900;177801;52400;148109;11485;33517;21542;67014;33027;100531
110025;202005;5096;12331;3345;9283;698;2078;1461;4091;2159;6169
110026;202005;492;1251;346;1040;81;268;148;469;229;737
110028;202005;6742;17220;3998;12197;1012;3358;600;1863;1612;5221
110029;202005;1503;3690;863;2562;195;590;309;967;504;1557
110030;202005;12642;29197;7771;21893;1691;5581;1525;4666;3216;10247
110032;202005;2993;8550;1890;6176;595;1931;391;1376;986;3307
110033;202005;3598;11297;2766;9751;985;3529;688;2700;1673;6229
110034;202005;3400;7976;2232;6356;673;2159;756;2322;1429;4481
110037;202005;1608;4764;1193;4033;254;860;581;2009;835;2869
110040;202005;2904;8113;2056;6527;584;1994;629;1952;1213;3946
110045;202005;4944;14342;3691;12042;988;3464;1292;4286;2280;7750
110050;202005;1769;4812;1234;3881;487;1665;220;720;707;2385
110060;202005;854;2556;578;1896;201;702;77;253;278;955
110070;202005;1571;4981;1173;4099;372;1384;231;728;603;2112
110080;202005;6250;14605;4592;12634;608;1587;3015;8863;3623;10450
110090;202005;553;1494;394;1213;88;297;176;529;264;826
110092;202005;1130;3293;821;2717;150;509;412;1471;562;1980
110094;202005;2759;8295;2059;6940;873;3139;292;983;1165;4122
110100;202005;1681;4973;1340;4307;370;1258;563;1833;933;3091
110110;202005;1690;4690;1166;3780;381;1273;271;952;652;2225
110120;202005;1287;3756;972;3140;231;812;325;1019;556;1831
110130;202005;2607;6582;1647;4842;327;1100;598;1749;925;2849
110140;202005;2019;5970;1352;4590;336;1197;348;1223;684;2420
110143;202005;1361;3715;922;2825;283;874;158;496;441;1370
110145;202005;882;2319;539;1679;125;409;188;601;313;1010
110146;202005;461;1190;323;979;65;186;157;515;222;701
110147;202005;787;2047;487;1448;71;232;184;482;255;714
110148;202005;729;2004;401;1354;108;411;42;144;150;555
110149;202005;2960;8151;2037;6658;703;2434;451;1566;1154;4000
110150;202005;2716;6650;1803;5358;537;1758;450;1610;987;3368
110155;202005;730;2149;510;1615;112;380;171;516;283;896
110160;202005;1446;4522;1061;3655;310;1091;257;910;567;2001
110170;202005;2161;5537;1310;3911;244;777;673;1930;917;2707
110175;202005;1670;4701;1176;3832;181;645;526;1797;707;2442
110180;202005;1391;3838;952;2946;149;484;478;1475;627;1959
120001;202005;3233;9527;2649;8660;420;1436;1686;5667;2106;7103
120005;202005;1944;7437;1759;7173;152;683;1405;5818;1557;6501
120010;202005;5312;16014;4482;14765;421;1362;3263;11093;3684;12455
120013;202005;2161;7605;1906;7295;416;1535;1191;4869;1607;6404
120017;202005;2425;8062;2131;7613;339;1220;1366;5155;1705;6375
120020;202005;14983;58608;13743;56181;1085;5045;10819;44560;11904;49605
120025;202005;3122;8891;2493;8129;373;1201;1720;5809;2093;7010
120030;202005;6503;25652;6023;24745;430;2276;4666;19337;5096;21613
120032;202005;1689;7590;1596;7417;107;685;1318;6017;1425;6702
120033;202005;4073;15124;3828;14693;124;713;3347;12729;3471;13442
120034;202005;2644;9645;2256;8959;117;702;1861;7257;1978;7959
120035;202005;3719;14691;3527;14356;291;1416;2892;11762;3183;13178
120038;202005;2692;8654;2289;7989;529;1901;1229;4387;1758;6288
120039;202005;2026;8735;1892;8463;125;782;1524;6757;1649;7539
120040;202005;44525;140109;37741;128956;5352;19354;23463;81351;28815;100705
120042;202005;3299;12401;3029;11899;147;796;2525;9839;2672;10635
120043;202005;1381;5610;1257;5408;35;214;1155;4974;1190;5188
120045;202005;6217;15985;5387;15058;123;502;4904;13572;5027;14074
120050;202005;9336;33686;8525;32433;392;2066;7133;27187;7525;29253
120060;202005;9539;36990;8729;35783;381;2295;7615;31008;7996;33303
120070;202005;3139;10116;2712;9529;249;901;1948;7099;2197;8000
120080;202005;4208;13606;3733;12900;461;1693;2740;9645;3201;11338
130002;202005;3075;12145;2745;11662;192;826;2323;10062;2515;10888
130006;202005;2410;8982;1991;8222;179;779;1488;6203;1667;6982
130008;202005;2675;9352;2363;8892;68;369;2047;7698;2115;8067
130010;202005;3969;11573;3329;10843;81;230;3052;10096;3133;10326
130014;202005;3084;9198;2364;7995;409;1398;1448;5049;1857;6447
130020;202005;2861;11048;2554;10579;140;813;2044;8418;2184;9231
130030;202005;10105;32880;9181;31790;328;1119;8116;28585;8444;29704
130040;202005;3919;11688;3263;10812;185;597;2715;9123;2900;9720
130050;202005;7594;27811;6316;26112;159;830;5732;23935;5891;24765
130060;202005;7522;29904;6441;28479;437;2419;5323;23526;5760;25945
130063;202005;6374;20827;5670;20040;211;903;5135;18272;5346;19175
130068;202005;3785;13345;3190;12465;212;1203;2419;9361;2631;10564
130070;202005;7604;21403;6209;19876;291;896;5122;16934;5413;17830
130080;202005;7052;25623;6155;24574;255;1406;5244;21266;5499;22672
130083;202005;2763;9032;2441;8625;154;637;2078;7376;2232;8013
130090;202005;3527;10953;3123;10442;56;244;2765;9421;2821;9665
130100;202005;8085;24251;6875;22983;56;125;6493;22243;6549;22368
130110;202005;8608;24609;7074;22703;1016;2584;5145;17863;6161;20447
130115;202005;5300;16495;4564;15677;105;355;4063;14184;4168;14539
130120;202005;14250;50345;12543;48059;1085;4572;10181;39413;11266;43985
130130;202005;5343;16959;4116;15336;396;1592;3037;11408;3433;13000
130140;202005;7366;25611;6483;24596;187;1063;5711;21756;5898;22819
130150;202005;3642;13663;3421;13417;81;507;3138;12333;3219;12840
130160;202005;5111;18156;4364;17197;268;1157;3712;14892;3980;16049
130165;202005;3225;12237;3030;11990;118;528;2734;10909;2852;11437
130170;202005;11805;34533;9433;31755;696;2653;7607;26022;8303;28675
130180;202005;4479;14481;4242;14216;43;225;4095;13694;4138;13919
130185;202005;18507;45775;15108;42160;1000;1819;12721;37611;13721;39430
130190;202005;18823;62383;15112;56838;1707;6698;10710;41550;12417;48248
130195;202005;2487;9031;2018;8410;73;412;1736;7246;1809;7658
130200;202005;2591;7296;2148;6719;98;390;1799;5606;1897;5996
130210;202005;1313;4935;1179;4778;101;589;949;3745;1050;4334
130220;202005;2305;7988;1965;7541;55;303;1726;6650;1781;6953
130230;202005;4621;19060;4010;18182;227;1434;3442;15574;3669;17008
130240;202005;12259;36733;9919;33624;185;1099;8922;30237;9107;31336
130250;202005;26406;79089;22625;74828;1666;5111;18185;62548;19851;67659
130255;202005;4385;14716;3818;13726;159;742;3102;11151;3261;11893
130260;202005;264242;736544;214565;664342;58008;190588;98744;315909;156752;506497
130270;202005;9563;33828;7868;31189;1181;4660;5241;21711;6422;26371
130280;202005;3550;14382;3259;14056;89;450;3036;13256;3125;13706
130290;202005;13221;44439;11426;42128;663;2613;9633;36305;10296;38918
130300;202005;4720;16523;4292;15939;150;822;3732;13843;3882;14665
130310;202005;6259;20970;5428;19891;287;1279;4619;16955;4906;18234
130320;202005;3458;11247;2878;10493;364;1287;2117;7994;2481;9281
130330;202005;4621;14831;3728;13732;206;922;3187;11737;3393;12659
130340;202005;23707;74177;20355;70356;1472;4411;17075;61078;18547;65489
130350;202005;3993;14420;3590;13906;148;758;3180;12283;3328;13041
130353;202005;7560;20436;6075;18559;776;2254;4363;13850;5139;16104
130356;202005;5245;16743;4339;15337;754;2612;2658;9968;3412;12580
130360;202005;2980;9838;2575;9282;93;413;2292;8201;2385;8614
130370;202005;5746;22634;4995;21568;300;1677;4054;17416;4354;19093
130380;202005;7391;30678;6843;29904;391;2210;5819;25256;6210;27466
130390;202005;5787;24508;5121;23394;536;2804;3852;17682;4388;20486
130395;202005;2333;7434;1998;6881;184;667;1531;5276;1715;5943
130400;202005;2781;8682;2386;8152;90;261;2141;7468;2231;7729
130406;202005;11102;38773;9337;36599;1769;6955;6243;25436;8012;32391
130410;202005;4201;14964;3566;13884;1063;4368;1629;6512;2692;10880
130420;202005;13670;48147;11423;45337;914;4653;8950;35773;9864;40426
130423;202005;4354;13721;3805;13098;191;853;3335;11382;3526;12235
130426;202005;2795;11126;2602;10897;69;391;2402;10114;2471;10505
130430;202005;4276;12117;3703;11353;239;889;3119;9429;3358;10318
130440;202005;4823;15210;4121;14370;87;388;3811;13380;3898;13768
140002;202005;2188;6492;1903;6140;90;347;1611;5247;1701;5594
140005;202005;3321;9172;2895;8683;135;359;2478;7637;2613;7996
140010;202005;56913;151204;45393;133967;11287;35091;19597;59027;30884;94118
140015;202005;3804;11361;3219;10644;220;709;2807;9441;3027;10150
140017;202005;4431;12343;3846;11603;257;713;3158;9816;3415;10529
140020;202005;5311;15477;4564;14492;231;964;3763;11853;3994;12817
140023;202005;2493;7411;2037;6755;198;664;1549;5262;1747;5926
140028;202005;2056;5294;1737;4886;87;275;1404;3945;1491;4220
140030;202005;5263;13456;4647;12747;335;667;4046;11484;4381;12151
140040;202005;2577;10161;2361;9876;94;577;2132;8791;2226;9368
140045;202005;2603;9484;2188;8914;347;1231;1487;6529;1834;7760
140047;202005;6246;17834;5248;16373;598;1905;3761;11929;4359;13834
140050;202005;1444;4215;1211;3880;119;371;922;3030;1041;3401
140060;202005;1683;4460;1442;4103;112;290;1166;3397;1278;3687
140070;202005;1895;9864;1830;9734;122;849;1521;8015;1643;8864
150010;202005;45549;113755;41134;108084;956;2258;36893;96883;37849;99141
150013;202005;1955;5011;1626;4659;151;304;1269;3882;1420;4186
150020;202005;14505;43663;13409;42232;1447;3826;10963;35628;12410;39454
150030;202005;8904;33366;8089;32358;469;2019;7017;28327;7486;30346
150034;202005;4191;10300;3444;9378;231;574;2871;7997;3102;8571
150040;202005;16438;42590;14442;40379;1253;1938;12089;36741;13342;38679
150050;202005;6978;24416;6357;23592;129;577;5842;21918;5971;22495
150060;202005;22108;60022;17699;53356;2798;8600;11229;34678;14027;43278
150070;202005;6762;25233;5916;24217;227;1117;5285;21846;5512;22963
150080;202005;94360;210780;78413;188978;18990;50066;22652;66845;41642;116911
150085;202005;7709;22309;6962;21421;118;385;6531;20245;6649;20630
150090;202005;9842;36645;9251;35486;692;2709;7430;28714;8122;31423
150095;202005;5665;16594;4926;15670;267;603;4182;13885;4449;14488
150100;202005;2876;10081;2550;9528;202;662;1991;7622;2193;8284
150110;202005;4431;18205;4106;17831;186;874;3778;16522;3964;17396
150120;202005;8161;25376;7737;24865;255;664;6872;22792;7127;23456
150125;202005;741;1985;550;1723;96;362;327;1005;423;1367
150130;202005;22397;64961;19375;60396;3357;9374;12636;41775;15993;51149
150140;202005;251169;582588;211218;527169;31421;76004;123012;319859;154433;395863
150145;202005;4264;13181;3615;12178;924;2849;1961;7323;2885;10172
150150;202005;16182;41701;14115;39047;539;1639;11791;32618;12330;34257
150157;202005;3507;9585;2823;8693;296;922;1988;6406;2284;7328
150160;202005;3023;8951;2811;8641;533;1547;1752;5623;2285;7170
150170;202005;24571;80528;21456;75217;3902;12868;13179;49202;17081;62070
150172;202005;4840;13318;3881;11962;264;743;2944;9372;3208;10115
150175;202005;1617;5134;1346;4601;242;868;770;2666;1012;3534
150178;202005;10499;28295;8707;26203;206;523;7799;23804;8005;24327
150180;202005;22506;79573;20287;77007;1096;3635;17804;69234;18900;72869
150190;202005;6744;22750;6263;22143;252;1159;5559;19545;5811;20704
150195;202005;5128;16559;4867;16152;70;381;4515;14836;4585;15217
150200;202005;5891;17161;5387;16602;64;172;5097;15824;5161;15996
150210;202005;26307;91075;24502;88658;1687;6105;20290;75590;21977;81695
150215;202005;7663;21744;6591;20174;1184;3528;3919;12548;5103;16076
150220;202005;12375;34943;10791;32680;1065;3111;7496;23221;8561;26332
150230;202005;12206;34889;10744;32936;1131;3083;7458;23922;8589;27005
150240;202005;32060;89285;26541;79827;7244;22243;9200;28121;16444;50364
150250;202005;4258;16240;3963;15902;606;2351;3046;12575;3652;14926
150260;202005;2760;9006;2505;8612;155;506;2004;6989;2159;7495
150270;202005;8757;25177;6168;20591;1992;6923;1652;5907;3644;12830
150275;202005;6898;21991;6299;21158;239;916;5474;18329;5713;19245
150276;202005;2363;6235;2017;5825;258;662;1390;4430;1648;5092
150277;202005;5191;13562;4182;12393;311;826;3226;10196;3537;11022
150280;202005;6854;27657;6604;27249;474;1921;5602;23405;6076;25326
150285;202005;3296;11517;2886;10874;237;914;2123;8144;2360;9058
150290;202005;10477;28708;9449;27609;288;624;8552;25601;8840;26225
150293;202005;9325;23058;7095;20110;920;2643;4381;13051;5301;15694
150295;202005;7658;20638;5623;17890;1834;6223;1967;7159;3801;13382
150300;202005;2412;7176;2156;6853;35;125;1968;6289;2003;6414
150304;202005;4089;12144;3370;11029;596;1858;2064;7081;2660;8939
150307;202005;6160;19802;5671;18986;342;1146;4628;15665;4970;16811
150309;202005;6241;18792;5028;16694;875;2872;2826;9816;3701;12688
150310;202005;7299;28997;6947;28579;207;1175;6209;25761;6416;26936
150320;202005;9435;25767;8598;24547;411;1256;6680;19021;7091;20277
150330;202005;14044;45079;12941;43318;1236;3864;9753;33689;10989;37553
150340;202005;2542;7440;2255;7010;333;964;1546;4972;1879;5936
150345;202005;8150;23876;7307;22745;434;1409;6213;19421;6647;20830
150350;202005;8983;22530;8280;21620;700;1314;6837;18437;7537;19751
150360;202005;24396;66992;19523;60822;2033;5097;13881;46159;15914;51256
150370;202005;10758;32704;8825;30098;1006;2896;6417;23577;7423;26473
150375;202005;3559;14360;3199;13836;229;1101;2717;11856;2946;12957
150380;202005;11170;28541;9162;25908;118;442;8099;22925;8217;23367
150390;202005;7984;31822;7159;30525;1085;4038;5100;23034;6185;27072
150400;202005;6509;23426;6244;22928;272;1029;5450;20087;5722;21116
150405;202005;9273;24384;8095;22973;483;1135;6548;19185;7031;20320
150410;202005;1935;6162;1640;5656;220;685;1042;3710;1262;4395
150420;202005;40709;112198;31276;98219;8679;28603;10730;39254;19409;67857
150430;202005;8476;24774;7718;23791;867;1989;6009;19445;6876;21434
150440;202005;5669;18216;5155;17479;760;2264;3615;12866;4375;15130
150442;202005;26464;62895;21751;56990;2266;5830;15097;40398;17363;46228
150445;202005;6310;19541;5535;18363;205;727;4731;15730;4936;16457
150450;202005;5097;21833;4713;21308;362;1783;4055;18346;4417;20129
150460;202005;8396;27645;7673;26725;249;1004;6566;23695;6815;24699
150470;202005;21922;56625;19527;53902;362;1017;18364;50726;18726;51743
150475;202005;4916;15437;4239;14413;160;609;3548;12205;3708;12814
150480;202005;13692;44412;12238;42221;2189;6850;8116;29893;10305;36743
150490;202005;8387;29042;7694;28183;273;1150;6830;25169;7103;26319
150495;202005;5304;18187;5067;17851;111;554;4601;16129;4712;16683
150497;202005;2876;9088;2308;8101;508;1813;1205;4558;1713;6371
150500;202005;3284;8447;2924;7945;235;565;2283;6217;2518;6782
150503;202005;4826;12379;3330;10429;991;3344;1066;3833;2057;7177
150506;202005;10450;30933;8765;28644;1871;5358;5427;19726;7298;25084
150510;202005;9901;35967;8544;33411;1261;4627;5593;23053;6854;27680
150520;202005;6986;27332;6679;26949;233;1408;5978;24030;6211;25438
150530;202005;12466;42451;10779;40027;1541;4624;7719;30643;9260;35267
150540;202005;4988;13598;4239;12482;232;619;3538;10493;3770;11112
150543;202005;7423;19849;6112;18201;496;1484;4683;14584;5179;16068
150548;202005;10117;31688;9104;30298;251;1030;8070;26915;8321;27945
150549;202005;2006;5960;1718;5565;46;196;1464;4750;1510;4946
150550;202005;20036;58916;16671;53354;3992;13030;7318;25028;11310;38058
150553;202005;28623;82671;22522;71687;6595;21332;8110;27699;14705;49031
150555;202005;1928;5135;1506;4479;137;321;1039;3244;1176;3565
150560;202005;1842;5616;1633;5204;268;823;973;3216;1241;4039
150563;202005;2511;7596;2111;6906;428;1501;1181;3882;1609;5383
150565;202005;4359;13931;3879;13178;101;436;3238;11109;3339;11545
150570;202005;6319;20113;5878;19496;274;1033;5081;16836;5355;17869
150580;202005;10560;41351;9091;39705;623;3192;7362;33303;7985;36495
150590;202005;8124;27926;6954;26534;177;1046;6314;24000;6491;25046
150600;202005;9741;32275;9031;31415;218;833;8354;29268;8572;30101
150610;202005;2873;8477;2563;7977;89;372;2159;6637;2248;7009
150611;202005;3223;9027;2851;8509;92;348;2520;7473;2612;7821
150613;202005;13430;36966;10111;31244;1876;6161;4986;15406;6862;21567
150616;202005;3406;9337;2473;7799;580;1915;1066;3335;1646;5250
150618;202005;6838;19789;5517;17745;487;1533;3568;12134;4055;13667
150619;202005;6365;17837;5258;16291;179;618;4453;13917;4632;14535
150620;202005;6813;22541;5859;20929;665;2258;4008;14765;4673;17023
150630;202005;6295;16987;5746;16307;423;1116;4781;13726;5204;14842
150635;202005;4732;13023;3971;11810;545;1513;2552;7876;3097;9389
150640;202005;2262;6655;2055;6399;36;107;1908;6024;1944;6131
150650;202005;11625;32318;10114;29875;2967;8282;4450;14378;7417;22660
150655;202005;5821;16632;5265;15820;203;626;4544;13652;4747;14278
150658;202005;4427;12492;3503;11105;531;1779;2124;7111;2655;8890
150660;202005;5752;16426;5107;15508;465;1341;3594;11198;4059;12539
150670;202005;8439;19480;6581;17382;649;1393;5161;14395;5810;15788
150680;202005;69043;201420;53046;175999;12691;41203;23815;89367;36506;130570
150690;202005;2862;7382;2467;6918;93;213;2198;6310;2291;6523
150700;202005;6190;18246;5515;17368;355;927;4382;14196;4737;15123
150710;202005;3792;12640;3442;12073;276;950;2615;9375;2891;10325
150715;202005;4991;14360;4081;12979;299;919;3205;10360;3504;11279
150720;202005;6901;24436;6394;23645;423;1695;5329;19912;5752;21607
150730;202005;12029;36514;10413;34222;1199;4076;7690;25992;8889;30068
150740;202005;3976;11143;3518;10432;312;777;2660;8065;2972;8842
150745;202005;5083;14455;4092;12987;820;2755;2588;8304;3408;11059
150746;202005;1632;4997;1484;4786;77;251;1217;3940;1294;4191
150747;202005;4901;15567;4310;14596;687;2056;2942;10440;3629;12496
150750;202005;3695;11524;3101;10617;217;808;2347;8295;2564;9103
150760;202005;11952;35123;10834;33571;1480;4188;7675;24556;9155;28744
150770;202005;6360;22812;5984;22381;184;570;5450;21026;5634;21596
150775;202005;933;2604;720;2316;134;478;390;1252;524;1730
150780;202005;4544;13635;4023;13028;152;437;3610;11993;3762;12430
150790;202005;5670;16070;4858;15200;223;506;3906;13560;4129;14066
150795;202005;14010;43199;12210;40402;2983;9328;6996;24667;9979;33995
150796;202005;3863;9431;3355;8848;185;442;2853;7631;3038;8073
150797;202005;3947;12216;3404;11436;141;367;2911;9956;3052;10323
150800;202005;13474;42123;12105;40306;1442;4518;9184;31576;10626;36094
150803;202005;7052;22684;6596;21967;368;1163;5609;18843;5977;20006
150805;202005;3496;10724;2962;9943;210;711;2322;7935;2532;8646
150808;202005;6035;17048;4421;14398;1721;6207;621;2306;2342;8513
150810;202005;20810;54442;15729;48333;3277;10295;7999;27189;11276;37484
150812;202005;5316;14988;4667;13927;415;1305;3453;10124;3868;11429
150815;202005;9468;27911;7896;26046;613;2038;6528;21865;7141;23903
150820;202005;11954;32841;10084;30492;1101;2836;7661;24280;8762;27116
150830;202005;11906;43529;11027;42453;420;1812;9589;37889;10009;39701
150835;202005;2366;7828;2009;7190;342;1201;1153;4195;1495;5396
150840;202005;7546;21250;5987;18728;984;3317;3360;10434;4344;13751
160005;202005;1200;3313;1061;3136;62;219;891;2647;953;2866
160010;202005;2457;6470;2290;6287;20;106;2224;6033;2244;6139
160015;202005;2806;8205;2489;7813;70;236;2292;7222;2362;7458
160020;202005;2088;6699;1825;6371;155;519;1436;5182;1591;5701
160021;202005;1096;4251;1008;4144;60;345;833;3398;893;3743
160023;202005;1269;4481;1120;4232;120;415;787;3159;907;3574
160025;202005;1866;5667;1769;5556;12;38;1721;5428;1733;5466
160027;202005;9061;25090;8090;23848;642;1811;6512;19598;7154;21409
160030;202005;70892;201477;57173;183045;12087;36275;31168;110025;43255;146300
160040;202005;5738;19528;5213;18862;71;335;4880;17786;4951;18121
160050;202005;4760;14467;3715;13050;1394;4699;1305;5689;2699;10388
160053;202005;3723;11611;3374;11177;237;690;2792;9561;3029;10251
160055;202005;909;2644;874;2604;32;100;807;2407;839;2507
160060;202005;24851;66073;20090;60662;918;2966;15962;50517;16880;53483
160070;202005;2752;10393;2463;9945;196;780;1935;8074;2131;8854
160080;202005;3341;10634;2987;10236;31;164;2790;9630;2821;9794
170025;202005;604;1572;431;1316;69;218;222;701;291;919
170030;202005;1226;3715;942;3203;148;508;455;1597;603;2105
170035;202005;1467;3816;1079;3196;90;288;657;1960;747;2248
170040;202005;1893;5325;1492;4765;99;360;925;3069;1024;3429
170070;202005;1832;4287;1292;3596;77;237;773;2248;850;2485
170100;202005;2446;6984;2029;6294;193;544;1288;4141;1481;4685
170105;202005;732;2126;496;1620;132;379;167;569;299;948
170110;202005;958;2909;729;2475;124;432;339;1122;463;1554
170130;202005;1316;3925;937;3192;176;642;442;1540;618;2182
170190;202005;1361;3832;970;3199;345;1209;176;739;521;1948
170200;202005;2017;4855;1288;3641;207;616;531;1482;738;2098
170210;202005;24819;67435;18707;57194;6414;21356;2338;8235;8752;29591
170215;202005;1326;3538;1050;3155;39;160;827;2476;866;2636
170220;202005;5759;17926;4816;16217;1314;4246;1973;7272;3287;11518
170230;202005;1213;3630;903;3017;263;894;162;605;425;1499
170240;202005;2588;7282;1994;6313;138;526;1401;4321;1539;4847
170255;202005;3907;11365;2759;9251;486;1671;1259;4341;1745;6012
170270;202005;954;2297;628;1834;37;107;373;1086;410;1193
170290;202005;2855;8519;2449;7994;114;381;1923;6466;2037;6847
170300;202005;1975;5335;1587;4757;175;524;1066;3247;1241;3771
170305;202005;620;1711;515;1531;66;230;265;777;331;1007
170307;202005;938;3189;755;2829;105;417;418;1592;523;2009
170310;202005;1582;3943;1089;3148;170;544;508;1467;678;2011
170320;202005;1006;2630;756;2223;64;207;488;1466;552;1673
170330;202005;907;2795;822;2666;40;185;684;2158;724;2343
170360;202005;501;1367;342;1099;23;84;225;682;248;766
170370;202005;1256;3394;893;2767;280;828;223;825;503;1653
170380;202005;1771;5116;1309;4393;96;386;761;2603;857;2989
170382;202005;532;1591;434;1420;29;120;318;1010;347;1130
170384;202005;1542;5503;1253;4937;252;1032;640;2567;892;3599
170386;202005;928;2516;573;1817;79;287;201;611;280;898
170388;202005;612;1750;425;1406;61;217;192;645;253;862
170389;202005;1025;3191;844;2892;44;176;619;2174;663;2350
170390;202005;1722;3954;1288;3419;47;108;1056;2890;1103;2998
170410;202005;561;1645;403;1349;31;132;244;796;275;928
170460;202005;365;959;292;840;38;102;188;560;226;662
170510;202005;885;2596;642;2150;45;191;405;1303;450;1494
170550;202005;6489;17345;4717;14451;1190;3915;1131;3749;2321;7664
170555;202005;1381;3762;1076;3280;60;197;538;1711;598;1908
170560;202005;1008;2857;748;2491;58;219;481;1693;539;1912
170600;202005;1294;3491;1048;3145;226;540;585;1916;811;2456
170610;202005;1641;4348;1177;3651;89;303;721;2204;810;2507
170625;202005;428;1173;264;834;45;143;85;253;130;396
170650;202005;1228;3635;956;3186;137;483;543;1874;680;2357
170700;202005;3310;9781;2461;8141;493;1653;1098;3747;1591;5400
170710;202005;1494;3915;1132;3336;153;489;709;2091;862;2580
170720;202005;1721;4343;1313;3700;184;503;746;2200;930;2703
170730;202005;1035;2812;760;2359;134;371;384;1269;518;1640
170740;202005;2044;6786;1747;6237;158;624;1269;4505;1427;5129
170755;202005;896;2474;616;1985;61;213;307;964;368;1177
170765;202005;1138;2957;787;2388;165;501;340;1076;505;1577
170770;202005;1835;5334;1491;4798;171;519;978;3254;1149;3773
170820;202005;3307;9983;2605;8680;519;1798;1205;4148;1724;5946
170825;202005;958;2248;767;1989;79;199;560;1455;639;1654
170830;202005;1402;3734;1144;3331;144;403;768;2291;912;2694
170900;202005;2663;8409;2229;7781;187;639;1762;6244;1949;6883
170930;202005;3681;10226;2802;8568;652;2099;930;2847;1582;4946
170950;202005;11054;30613;7558;24249;2128;7782;890;3101;3018;10883
170980;202005;451;1206;362;1070;14;63;266;744;280;807
171050;202005;1599;5040;1382;4666;47;223;1150;3864;1197;4087
171070;202005;1320;3794;1122;3501;300;943;488;1769;788;2712
171090;202005;1039;2572;824;2266;74;201;551;1501;625;1702
171110;202005;567;1519;396;1199;61;184;188;526;249;710
171150;202005;1100;2717;662;1966;66;224;393;1155;459;1379
171180;202005;790;2161;523;1645;91;264;216;689;307;953
171190;202005;1736;5859;1492;5428;236;938;891;3348;1127;4286
171195;202005;800;2567;637;2258;87;363;382;1334;469;1697
171200;202005;544;1527;405;1283;72;241;181;573;253;814
171215;202005;347;984;281;868;32;108;194;583;226;691
171240;202005;745;2475;605;2199;34;178;409;1452;443;1630
171245;202005;644;1947;494;1630;46;178;300;945;346;1123
171250;202005;1010;2657;729;2241;132;427;334;1046;466;1473
171270;202005;446;1601;344;1380;69;282;152;656;221;938
171280;202005;867;2623;676;2274;64;231;385;1354;449;1585
171320;202005;3917;11027;2996;9393;619;1925;1134;3756;1753;5681
171330;202005;2711;7475;2074;6358;403;1224;979;3129;1382;4353
171360;202005;1391;4038;1095;3601;78;282;790;2660;868;2942
171370;202005;685;1735;519;1498;50;138;351;1021;401;1159
171380;202005;1464;4129;1220;3780;106;304;895;2868;1001;3172
171395;202005;960;2658;664;2099;58;231;407;1234;465;1465
171420;202005;1943;5716;1396;4606;234;836;634;2110;868;2946
171430;202005;1011;3009;831;2670;58;206;565;1750;623;1956
171488;202005;2303;6857;1801;6002;267;869;931;3250;1198;4119
171500;202005;986;2442;743;2074;42;116;573;1616;615;1732
171510;202005;801;2619;690;2410;44;197;481;1655;525;1852
171515;202005;460;1177;326;960;29;85;200;564;229;649
171525;202005;693;1979;524;1705;21;77;305;952;326;1029
171550;202005;339;984;251;839;30;114;142;463;172;577
171570;202005;1129;3447;940;3101;115;376;554;1887;669;2263
171575;202005;1813;4846;1152;3640;113;386;520;1642;633;2028
171610;202005;5728;15982;4270;13462;894;3176;1191;4021;2085;7197
171620;202005;2593;7341;2173;6731;101;387;1770;5504;1871;5891
171630;202005;953;2512;749;2231;107;316;506;1553;613;1869
171650;202005;2025;5778;1549;4967;385;1346;458;1612;843;2958
171660;202005;2335;5928;1585;4673;231;625;820;2475;1051;3100
171665;202005;1244;3484;958;3017;164;580;450;1439;614;2019
171670;202005;1885;5012;1433;4267;195;645;783;2336;978;2981
171700;202005;1203;3434;871;2826;113;359;466;1551;579;1910
171720;202005;788;2025;616;1756;53;173;444;1239;497;1412
171750;202005;1284;3615;871;2835;224;749;106;444;330;1193
171780;202005;1226;3124;872;2601;93;303;576;1682;669;1985
171790;202005;1379;4574;1127;4050;213;801;523;1924;736;2725
171800;202005;714;1976;533;1698;62;253;303;948;365;1201
171820;202005;11139;31303;8154;26093;2016;6683;2471;8551;4487;15234
171830;202005;1494;4855;1249;4415;107;477;808;2856;915;3333
171840;202005;759;2027;586;1750;25;75;385;1144;410;1219
171845;202005;639;1567;481;1334;47;163;308;830;355;993
171850;202005;879;2937;746;2633;70;314;531;1819;601;2133
171855;202005;1040;3185;877;2884;72;239;541;1751;613;1990
171865;202005;370;1163;300;1041;50;195;148;487;198;682
171870;202005;812;2266;572;1819;67;220;297;955;364;1175
171875;202005;1266;3703;995;3259;41;176;755;2459;796;2635
171880;202005;1149;3537;1007;3348;43;139;802;2733;845;2872
171884;202005;856;2429;627;2033;116;437;229;769;345;1206
171886;202005;1359;3768;963;3109;282;1033;192;630;474;1663
171888;202005;719;2008;486;1574;30;115;307;973;337;1088
171889;202005;379;1178;301;1021;65;241;122;410;187;651
171890;202005;1171;3272;854;2762;179;550;470;1569;649;2119
171900;202005;543;1876;390;1488;79;293;161;636;240;929
172000;202005;569;1689;474;1506;47;148;272;840;319;988
172010;202005;992;3424;842;3116;72;303;516;1885;588;2188
172015;202005;377;1309;278;1105;67;267;109;451;176;718
172020;202005;2609;7502;2285;7074;158;529;1703;5470;1861;5999
172025;202005;702;1946;515;1635;35;131;372;1179;407;1310
172030;202005;1219;3603;1035;3306;54;212;805;2564;859;2776
172049;202005;1293;3118;869;2531;175;486;442;1404;617;1890
172065;202005;1441;3583;1107;3166;102;220;870;2680;972;2900
172080;202005;2334;6855;1878;6063;106;375;1257;4042;1363;4417
172085;202005;474;1288;306;925;48;138;114;328;162;466
172090;202005;3947;9992;3030;8777;114;362;2315;6763;2429;7125
172093;202005;472;1409;337;1166;23;118;196;640;219;758
172097;202005;665;1764;462;1407;62;192;205;635;267;827
172100;202005;48708;120720;33950;97096;6007;19072;12165;35732;18172;54804
172110;202005;1571;5772;1347;5409;125;518;989;4177;1114;4695
172120;202005;4964;14620;3877;12855;498;1734;2196;7487;2694;9221
172125;202005;356;957;264;805;24;72;154;456;178;528
172130;202005;638;1552;494;1322;26;85;343;839;369;924
172208;202005;2525;6221;2023;5572;182;427;1463;4138;1645;4565
172210;202005;2658;6765;2033;5959;325;1040;1161;3548;1486;4588
210005;202005;18666;53762;14209;46316;4135;14014;5418;18543;9553;32557
210010;202005;1923;5936;1732;5703;74;316;1503;4969;1577;5285
210015;202005;3299;9874;2942;9408;111;310;2587;8371;2698;8681
210020;202005;7309;17322;6246;16089;74;223;5795;14993;5869;15216
210030;202005;4701;15538;4330;14979;198;886;3741;12920;3939;13806
210040;202005;1774;4268;1603;4058;24;43;1517;3875;1541;3918
210043;202005;6099;17575;5153;16264;435;1299;3939;12742;4374;14041
210047;202005;6572;20439;5337;18785;129;656;4641;16336;4770;16992
210050;202005;2212;7504;1734;6614;154;697;1212;4607;1366;5304
210055;202005;1864;6008;1683;5730;68;276;1424;4855;1492;5131
210060;202005;7252;26575;6427;25093;700;2871;4585;18375;5285;21246
210070;202005;7116;20294;6657;19699;40;182;6302;18603;6342;18785
210080;202005;4281;14525;4060;14284;42;261;3723;13177;3765;13438
210083;202005;5515;16090;4545;15064;37;182;4322;14387;4359;14569
210087;202005;3022;8223;2616;7698;98;227;2273;6862;2371;7089
210090;202005;9172;28836;8526;27695;501;1347;7242;23787;7743;25134
210095;202005;6334;20426;5781;19729;219;901;4971;17380;5190;18281
210100;202005;6783;20711;6070;19601;307;1083;4942;16026;5249;17109
210110;202005;2940;9659;2715;9392;49;293;2491;8585;2540;8878
210120;202005;22628;62386;18659;57145;1829;4601;12741;41474;14570;46075
210125;202005;4401;11771;3850;11127;721;1622;2781;8639;3502;10261
210130;202005;4364;11493;3616;10561;157;343;3081;9132;3238;9475
210135;202005;1447;4359;1242;4031;62;180;1007;3338;1069;3518
210140;202005;18763;49283;14333;43576;2703;7900;8093;26084;10796;33984
210150;202005;4330;10502;3847;9840;130;370;3364;8516;3494;8886
210160;202005;16436;48149;14169;45292;1256;4260;10068;33338;11324;37598
210170;202005;14973;46638;13909;45276;752;2169;12241;40241;12993;42410
210173;202005;2245;8628;2098;8366;73;442;1843;7338;1916;7780
210177;202005;3443;9427;2997;8888;117;224;2663;8187;2780;8411
210180;202005;1438;3879;1266;3675;24;65;1150;3347;1174;3412
210190;202005;5278;14380;4468;13289;74;358;3872;11368;3946;11726
210193;202005;1284;3760;1137;3531;31;141;895;2823;926;2964
210197;202005;2061;6481;1894;6250;137;465;1557;5211;1694;5676
210200;202005;7623;24562;6754;23111;404;1562;5420;18521;5824;20083
210203;202005;7037;20715;6021;19354;397;1308;4922;16185;5319;17493
210207;202005;3918;9624;3012;8660;137;307;2528;7460;2665;7767
210210;202005;8030;26192;7344;25259;131;801;6614;22607;6745;23408
210215;202005;2444;7754;2082;7207;53;270;1847;6416;1900;6686
210220;202005;6092;21149;5768;20656;177;1164;5103;17879;5280;19043
210230;202005;5065;15465;4576;14731;385;1002;3832;12652;4217;13654
210232;202005;11099;35064;9099;32024;1537;5411;5692;21367;7229;26778
210235;202005;3318;10008;2916;9455;63;280;2602;8458;2665;8738
210237;202005;2739;9099;2345;8637;32;197;2168;7991;2200;8188
210240;202005;2576;8200;2374;7841;80;314;2048;6697;2128;7011
210250;202005;5588;17095;5077;16463;73;436;4585;14815;4658;15251
210255;202005;2498;7668;2110;6980;279;946;1351;4475;1630;5421
210260;202005;5457;16339;4826;15421;212;774;4187;13379;4399;14153
210270;202005;4785;13344;4266;12697;105;476;3795;11222;3900;11698
210275;202005;3494;8884;3088;8401;58;129;2803;7735;2861;7864
210280;202005;5515;15792;4414;14082;260;1044;3203;10091;3463;11135
210290;202005;7206;19436;6437;18474;110;358;5975;17154;6085;17512
210300;202005;33309;90023;26998;81012;1869;5907;19344;60122;21213;66029
210310;202005;3053;7864;2694;7341;121;271;2351;6448;2472;6719
210312;202005;2659;6836;2340;6490;31;138;2192;6014;2223;6152
210315;202005;2935;8260;2510;7779;54;154;2297;7256;2351;7410
210317;202005;4044;12896;3660;12445;98;539;3302;11155;3400;11694
210320;202005;18754;57176;17123;55010;383;1904;15193;48538;15576;50442
210325;202005;3612;10227;3098;9554;91;275;2755;8668;2846;8943
210330;202005;24485;69084;19673;62873;5950;17130;9353;34678;15303;51808
210340;202005;9966;29378;8825;27833;698;2204;6770;21959;7468;24163
210350;202005;9170;26615;8011;25192;153;539;7156;22631;7309;23170
210355;202005;4251;14278;3733;13470;103;518;3178;11535;3281;12053
210360;202005;13412;42266;11966;40130;594;2719;9170;30287;9764;33006
210370;202005;10704;24221;8306;21683;234;406;7625;20386;7859;20792
210375;202005;3216;8572;2453;7541;644;2013;1115;3811;1759;5824
210380;202005;5403;13907;4662;13044;203;484;3995;11287;4198;11771
210390;202005;2557;9020;2359;8673;117;539;2001;7328;2118;7867
210400;202005;4409;13605;3915;12993;120;386;3521;11842;3641;12228
210405;202005;6861;18576;5519;16643;1048;2927;3108;10006;4156;12933
210407;202005;1945;6492;1623;5901;75;334;1309;4707;1384;5041
210408;202005;2496;9321;2339;9093;145;695;1917;7471;2062;8166
210409;202005;3758;13057;3431;12604;104;593;2849;10527;2953;11120
210410;202005;3391;10443;2879;9600;148;602;2203;7267;2351;7869
210420;202005;3814;12234;3454;11610;208;639;2896;9846;3104;10485
210430;202005;2235;6577;1993;6271;70;190;1765;5631;1835;5821
210440;202005;4359;11711;3787;10992;64;229;3496;10097;3560;10326
210450;202005;2418;7160;2073;6655;81;295;1714;5473;1795;5768
210455;202005;4258;11233;3231;9919;944;2926;1501;4884;2445;7810
210460;202005;3655;10435;3091;9722;61;260;2757;8621;2818;8881
210462;202005;1632;4967;1388;4567;37;147;1128;3753;1165;3900
210465;202005;2669;7777;2334;7325;53;213;2034;6364;2087;6577
210467;202005;5851;18773;5079;17748;298;1208;4209;14867;4507;16075
210470;202005;2020;5321;1428;4475;91;215;1096;3575;1187;3790
210480;202005;16316;47796;13455;44255;1143;3441;9886;35062;11029;38503
210490;202005;3662;9322;2964;8346;60;181;2579;7294;2639;7475
210500;202005;6243;24121;5731;23241;334;1692;4771;19224;5105;20916
210510;202005;5916;19628;5173;18823;127;564;4626;17119;4753;17683
210515;202005;3658;10841;3199;10318;101;383;2773;9091;2874;9474
210520;202005;2504;7190;2247;6866;68;243;1986;6035;2054;6278
210530;202005;51635;125971;39917;108637;6598;22288;10815;37403;17413;59691
210535;202005;3034;10391;2833;10074;115;457;2398;8592;2513;9049
210540;202005;14429;41829;12002;38431;1389;4133;8451;28332;9840;32465
210542;202005;6434;14970;5175;13594;325;526;4284;12044;4609;12570
210545;202005;2185;6829;2059;6621;42;179;1818;5788;1860;5967
210547;202005;3517;12690;3103;11872;294;1119;2304;9021;2598;10140
210550;202005;6105;18411;4822;16400;330;1292;3573;12458;3903;13750
210560;202005;3528;10781;3147;10167;119;386;2647;8486;2766;8872
210565;202005;1463;4815;1218;4452;57;308;968;3565;1025;3873
210570;202005;10328;28200;9178;26793;270;745;8189;24342;8459;25087
210580;202005;2962;7933;2444;7296;132;269;1967;6174;2099;6443
210590;202005;4266;12725;3684;11979;69;375;3283;10616;3352;10991
210592;202005;2634;7795;2428;7465;26;127;2152;6564;2178;6691
210594;202005;2487;6709;1896;5793;78;230;1403;4436;1481;4666
210596;202005;2488;8871;2228;8345;100;450;1823;6843;1923;7293
210598;202005;1798;5285;1657;5071;31;131;1496;4541;1527;4672
210600;202005;3024;8068;2448;7270;87;204;1996;6034;2083;6238
210610;202005;2663;7537;2289;7074;59;282;1940;5980;1999;6262
210620;202005;2736;7443;2287;6904;59;171;2104;6451;2163;6622
210630;202005;2978;10048;2721;9626;107;559;2270;7912;2377;8471
210632;202005;4378;14169;3875;13444;206;942;3093;10630;3299;11572
210635;202005;1725;6175;1623;5995;99;363;1351;5084;1450;5447
210637;202005;2402;7984;2091;7538;144;627;1585;5778;1729;6405
210640;202005;4537;16351;4257;16014;68;351;3868;14586;3936;14937
210650;202005;7344;21013;6684;20186;77;310;6199;18770;6276;19080
210660;202005;8036;23982;7120;22512;248;1000;6210;19390;6458;20390
210663;202005;2537;7455;2328;7209;124;305;2002;6364;2126;6669
210667;202005;1938;6308;1741;6020;35;142;1580;5523;1615;5665
210670;202005;4472;15095;4076;14471;102;521;3579;12629;3681;13150
210675;202005;4994;13557;4260;12603;184;452;3602;10918;3786;11370
210680;202005;4473;11004;3764;10148;117;189;3402;9367;3519;9556
210690;202005;7626;23378;6398;22021;238;1051;5675;19658;5913;20709
210700;202005;2697;7649;2136;6841;139;441;1585;5298;1724;5739
210710;202005;4869;15340;4274;14498;107;601;3773;12647;3880;13248
210720;202005;2908;9621;2612;9252;53;316;2357;8295;2410;8611
210725;202005;1277;4348;1116;4106;37;158;819;3134;856;3292
210730;202005;1177;3089;988;2824;50;130;831;2380;881;2510
210735;202005;4625;13644;3943;12735;180;553;3399;11232;3579;11785
210740;202005;5238;14187;4556;13419;96;322;3859;11386;3955;11708
210745;202005;4352;11976;4038;11574;109;337;3707;10596;3816;10933
210750;202005;22911;58505;19822;54638;1614;4188;13949;40579;15563;44767
210760;202005;5894;15611;4984;14650;28;64;4739;14061;4767;14125
210770;202005;6087;15710;5237;14730;56;249;4939;13820;4995;14069
210780;202005;7225;22981;6330;21485;528;1593;5011;17356;5539;18949
210790;202005;4182;13306;3753;12746;179;451;3108;11068;3287;11519
210800;202005;4865;12943;4167;12018;53;223;3782;10794;3835;11017
210805;202005;3905;14268;3719;13997;99;539;3346;12509;3445;13048
210810;202005;4816;14070;4392;13521;282;614;3683;11724;3965;12338
210820;202005;6856;19519;5703;17673;662;2118;3412;10931;4074;13049
210825;202005;6667;20748;6020;19892;246;827;5218;17479;5464;18306
210830;202005;7638;21576;6943;20726;343;786;6029;18462;6372;19248
210840;202005;3165;8436;2830;7986;63;219;2518;7008;2581;7227
210845;202005;6443;17497;5784;16780;19;83;5577;16239;5596;16322
210850;202005;5904;20090;4919;18622;233;1179;3879;14739;4112;15918
210860;202005;20819;53908;17324;49512;747;1864;14027;42193;14774;44057
210870;202005;7291;19052;5750;17286;228;635;5016;15194;5244;15829
210880;202005;4220;13064;3818;12594;174;683;3194;10527;3368;11210
210890;202005;3840;11352;3402;10743;215;572;2774;9072;2989;9644
210900;202005;4448;13086;3372;11031;1323;4633;552;2053;1875;6686
210905;202005;1978;5492;1639;5055;45;80;1492;4719;1537;4799
210910;202005;7182;21728;5956;19733;789;2667;3914;13111;4703;15778
210920;202005;3195;10555;2767;9989;69;403;2498;8938;2567;9341
210923;202005;1501;4528;1294;4195;69;229;964;3170;1033;3399
210927;202005;5192;16515;4573;15786;217;769;3806;13414;4023;14183
210930;202005;2460;8535;2159;7944;171;696;1612;5931;1783;6627
210940;202005;4050;11500;3760;11158;110;449;3455;10145;3565;10594
210945;202005;6344;18431;5685;17647;221;651;4783;15228;5004;15879
210950;202005;5136;14326;3962;12705;601;1533;2626;9197;3227;10730
210955;202005;1541;4894;1324;4513;127;454;937;3267;1064;3721
210960;202005;8938;26680;7663;24767;1247;3761;4957;16791;6204;20552
210970;202005;1317;4063;1047;3606;64;237;802;2707;866;2944
210975;202005;1714;5391;1533;5103;58;217;1235;4128;1293;4345
210980;202005;10133;23459;8868;22150;76;187;8421;21104;8497;21291
210990;202005;15756;44758;12421;40364;686;2469;9362;31195;10048;33664
211000;202005;14371;42178;12106;39422;676;2317;9726;32952;10402;35269
211003;202005;5577;16735;4689;15673;127;514;4058;13861;4185;14375
211010;202005;6375;23066;5723;22274;84;420;5222;20666;5306;21086
211020;202005;8157;23658;7055;22398;193;822;6017;19584;6210;20406
211023;202005;1932;6327;1800;6154;86;316;1535;5240;1621;5556
211027;202005;3059;9792;2896;9534;192;524;2503;8323;2695;8847
211030;202005;3855;10642;3437;10133;228;508;2829;8606;3057;9114
211040;202005;4558;16518;4217;15912;110;685;3777;14105;3887;14790
211050;202005;9041;23623;8211;22552;86;301;7557;20760;7643;21061
211060;202005;6868;20910;6278;20115;121;518;5765;18468;5886;18986
211065;202005;2170;6048;1804;5591;83;224;1491;4785;1574;5009
211070;202005;7652;24342;6469;22548;494;1755;5026;17720;5520;19475
211080;202005;1280;3545;1026;3143;37;192;797;2309;834;2501
211085;202005;2031;5735;1723;5320;91;215;1487;4760;1578;4975
211090;202005;3134;8679;2828;8320;36;166;2625;7687;2661;7853
211100;202005;6670;16968;6161;16362;51;162;5691;15205;5742;15367
211102;202005;3016;10367;2761;9995;121;578;2429;8703;2550;9281
211105;202005;2346;7437;1946;6710;166;591;1413;4846;1579;5437
211107;202005;4610;14628;3930;13628;129;580;3211;11481;3340;12061
211110;202005;5795;15958;4482;13949;351;1022;3308;10514;3659;11536
211120;202005;43568;107130;35847;98132;4832;12156;23251;68007;28083;80163
211125;202005;2054;6093;1731;5602;36;149;1481;4809;1517;4958
211130;202005;186304;441436;161229;408932;23366;57532;75058;217795;98424;275327
211140;202005;4904;14620;4281;13807;207;589;3631;11812;3838;12401
211150;202005;9225;25594;7770;23702;341;1037;6556;20126;6897;21163
211153;202005;2420;7116;1969;6572;272;953;1314;4624;1586;5577
211157;202005;1091;3478;913;3155;34;176;672;2299;706;2475
211160;202005;4016;11344;3146;10090;143;522;2370;7520;2513;8042
211163;202005;1618;5199;1475;5002;20;103;1348;4598;1368;4701
211167;202005;1512;4825;1417;4674;28;125;1304;4277;1332;4402
211170;202005;6416;15848;5962;15331;55;167;5670;14540;5725;14707
211172;202005;2477;6719;2152;6240;107;322;1742;4970;1849;5292
211174;202005;2834;8210;2563;7908;40;205;2391;7341;2431;7546
211176;202005;4188;12035;3249;10657;151;658;2585;8443;2736;9101
211178;202005;4572;10780;3937;10087;35;158;3741;9509;3776;9667
211180;202005;3992;13183;3702;12763;200;744;3160;10955;3360;11699
211190;202005;3027;8939;2563;8256;34;202;2271;7242;2305;7444
211195;202005;1380;3896;1179;3588;59;128;999;3118;1058;3246
211200;202005;2104;6005;1680;5429;203;630;1177;3891;1380;4521
211210;202005;6206;19091;5625;18324;241;1000;4886;15784;5127;16784
211220;202005;36651;92551;29826;84130;2783;7378;22077;64056;24860;71434
211223;202005;5144;13581;4270;12430;353;1054;3243;9495;3596;10549
211227;202005;1748;5828;1585;5592;32;153;1402;5029;1434;5182
211230;202005;7448;21615;6496;20177;391;1055;5246;16661;5637;17716
211240;202005;8045;25694;7621;25148;136;751;7075;23088;7211;23839
211245;202005;6998;17644;6242;16861;88;213;6027;16313;6115;16526
211250;202005;12973;40893;11705;39182;615;2476;9667;32113;10282;34589
211260;202005;7896;25725;7044;24603;199;885;6335;22260;6534;23145
211270;202005;10406;33242;8915;31216;382;1755;7254;25582;7636;27337
211280;202005;12512;34671;11122;32909;916;2151;8923;27619;9839;29770
211285;202005;1739;5763;1526;5461;141;557;1105;4058;1246;4615
211290;202005;7416;22343;6667;21361;178;754;5742;18337;5920;19091
211300;202005;7770;22319;6882;20992;181;613;5978;18090;6159;18703
211400;202005;11229;32051;9125;29182;972;3125;6267;21055;7239;24180
220005;202005;1818;4784;1647;4553;34;137;1392;3768;1426;3905
220010;202005;1473;4220;1207;3742;27;110;941;2885;968;2995
220020;202005;3601;9958;3108;9259;134;479;2567;7583;2701;8062
220025;202005;2226;5057;1908;4586;24;64;1598;3724;1622;3788
220027;202005;1267;3204;1081;2959;20;70;921;2473;941;2543
220030;202005;3307;8354;3092;8066;74;228;2750;7081;2824;7309
220040;202005;7046;21366;6130;19597;1403;4115;3233;10904;4636;15019
220045;202005;1469;4475;1203;4026;30;166;975;3198;1005;3364
220050;202005;4731;12802;4003;11842;60;285;3669;10723;3729;11008
220060;202005;2358;4957;1984;4525;25;59;1862;4239;1887;4298
220070;202005;2454;6167;2095;5650;71;149;1752;4753;1823;4902
220080;202005;709;2011;608;1860;25;95;524;1586;549;1681
220090;202005;1754;4230;1447;3797;20;69;1202;3268;1222;3337
220095;202005;643;1606;599;1559;26;43;540;1427;566;1470
220100;202005;1351;3722;1079;3285;45;166;869;2574;914;2740
220105;202005;1989;6210;1743;5715;116;436;1322;4306;1438;4742
220110;202005;3346;9264;3084;8808;39;199;2767;7791;2806;7990
220115;202005;2680;7805;2478;7536;68;230;2245;6779;2313;7009
220117;202005;1348;3252;1049;2839;11;55;886;2344;897;2399
220120;202005;12663;34096;11558;32722;77;273;10847;30695;10924;30968
220130;202005;1094;2960;929;2732;15;81;840;2445;855;2526
220140;202005;2098;4371;1766;3971;104;267;1546;3418;1650;3685
220150;202005;6312;18753;5767;17838;117;574;4893;14848;5010;15422
220155;202005;1149;3311;917;2880;37;126;647;1994;684;2120
220157;202005;1054;2582;894;2340;20;81;723;1830;743;1911
220160;202005;2787;7751;2407;7064;33;158;2007;5791;2040;5949
220170;202005;1534;4004;1307;3673;12;63;1172;3254;1184;3317
220173;202005;2124;5911;1714;5190;41;181;1371;4051;1412;4232
220177;202005;1976;5651;1869;5532;10;37;1846;5456;1856;5493
220180;202005;1113;2724;907;2375;4;21;705;1739;709;1760
220190;202005;6837;17200;5774;15745;360;1033;4325;11973;4685;13006
220191;202005;1492;4484;1350;4242;71;257;999;3059;1070;3316
220192;202005;2024;5335;1473;4351;29;101;1186;3446;1215;3547
220194;202005;1708;4871;1509;4556;56;209;1240;3701;1296;3910
220196;202005;1994;5140;1801;4849;27;109;1547;4092;1574;4201
220198;202005;1279;3536;1077;3277;8;37;994;3043;1002;3080
220200;202005;5088;14661;4418;13788;98;407;3791;11815;3889;12222
220202;202005;2147;6040;1843;5541;28;150;1588;4699;1616;4849
220205;202005;2477;7108;2217;6642;46;181;1875;5535;1921;5716
220207;202005;784;2329;635;2072;62;213;400;1317;462;1530
220208;202005;1649;5073;1341;4475;154;565;812;2652;966;3217
220209;202005;1576;4465;1356;4080;22;100;1119;3331;1141;3431
220210;202005;1673;4150;1440;3791;11;51;1234;3176;1245;3227
220211;202005;1592;4066;1461;3885;14;61;1282;3420;1296;3481
220213;202005;1742;4659;1508;4255;29;103;1210;3325;1239;3428
220217;202005;2134;6431;1988;6262;38;95;1850;5931;1888;6026
220220;202005;10399;27158;8591;24356;549;1374;5853;17428;6402;18802
220225;202005;1024;2692;824;2432;6;36;767;2235;773;2271
220230;202005;5682;14118;4872;13003;160;382;4208;11281;4368;11663
220240;202005;2953;8565;2677;8089;112;360;2170;6562;2282;6922
220245;202005;1723;4062;1329;3566;12;57;1208;3268;1220;3325
220250;202005;2957;8298;2606;7854;18;96;2440;7324;2458;7420
220253;202005;1563;4279;1375;3966;60;213;1164;3259;1224;3472
220255;202005;1871;4472;1593;4080;36;160;1355;3337;1391;3497
220260;202005;4206;13039;3704;12109;157;601;2957;9654;3114;10255
220265;202005;1309;4173;1176;3993;34;169;967;3217;1001;3386
220270;202005;6132;19467;5761;18785;206;1002;4823;15201;5029;16203
220271;202005;1483;3772;1283;3499;28;102;1133;3070;1161;3172
220272;202005;1758;5047;1561;4687;51;157;1184;3460;1235;3617
220273;202005;1216;3442;1013;3067;34;130;783;2329;817;2459
220275;202005;2244;5381;1775;4738;29;81;1562;4198;1591;4279
220277;202005;2121;5353;1818;4905;21;65;1553;4122;1574;4187
220280;202005;1628;3809;1346;3436;26;85;1145;2893;1171;2978
220285;202005;1411;3593;1202;3353;11;48;1102;3049;1113;3097
220290;202005;6326;18012;4969;16072;352;1277;3642;12023;3994;13300
220300;202005;1963;5661;1594;5173;34;187;1325;4280;1359;4467
220310;202005;3032;8160;2348;7359;41;203;1968;6137;2009;6340
220320;202005;3001;8858;2300;7513;84;407;1793;5669;1877;6076
220323;202005;1626;4746;1283;4188;56;214;1050;3369;1106;3583
220325;202005;1255;3701;1072;3398;22;110;898;2793;920;2903
220327;202005;1491;4241;1295;3921;42;179;1076;3175;1118;3354
220330;202005;4345;10491;3629;9619;56;180;3279;8624;3335;8804
220335;202005;1668;5054;1498;4839;32;107;1333;4324;1365;4431
220340;202005;1834;4844;1409;4134;58;192;963;2738;1021;2930
220342;202005;1130;3328;1004;3140;43;197;800;2463;843;2660
220345;202005;3101;6979;2394;5959;13;42;2173;5386;2186;5428
220350;202005;3273;8349;2596;7338;135;410;1846;5228;1981;5638
220360;202005;1239;3156;977;2726;19;54;779;2162;798;2216
220370;202005;8645;25043;7841;23754;167;733;6846;20464;7013;21197
220375;202005;1596;4529;1410;4300;2;13;1338;4102;1340;4115
220380;202005;1483;3509;1202;3105;16;40;1053;2693;1069;2733
220385;202005;853;2045;679;1723;7;21;591;1481;598;1502
220390;202005;9953;25950;7576;22249;1954;5606;2839;9231;4793;14837
220400;202005;1465;3463;1111;2925;23;69;854;2184;877;2253
220410;202005;1149;3152;921;2769;50;149;745;2206;795;2355
220415;202005;800;2047;670;1837;19;56;540;1460;559;1516
220420;202005;2009;5565;1613;4805;52;161;1247;3664;1299;3825
220430;202005;2455;6620;2305;6401;78;264;1968;5393;2046;5657
220435;202005;1733;4471;1497;4124;38;127;1238;3354;1276;3481
220440;202005;2384;7438;2037;6900;93;389;1712;5709;1805;6098
220450;202005;2464;6376;2003;5801;60;205;1711;4976;1771;5181
220455;202005;1283;3958;1217;3865;11;59;1083;3438;1094;3497
220460;202005;972;2378;903;2289;37;94;770;1930;807;2024
220465;202005;2335;7221;2057;6784;180;600;1509;5091;1689;5691
220470;202005;3458;9556;3097;8994;80;216;2534;7268;2614;7484
220480;202005;2725;7093;2182;6210;170;411;1455;4172;1625;4583
220490;202005;2477;6200;2137;5765;26;128;1862;4954;1888;5082
220500;202005;2769;7102;2415;6532;55;183;1981;5217;2036;5400
220510;202005;2524;7139;1977;6157;81;235;1555;4882;1636;5117
220515;202005;1629;3946;1490;3752;34;57;1304;3278;1338;3335
220520;202005;4895;12708;4410;12024;101;286;3836;10386;3937;10672
220525;202005;1311;3310;1126;3075;9;42;1037;2798;1046;2840
220527;202005;1293;3617;1105;3344;12;53;949;2922;961;2975
220530;202005;1427;3550;1221;3287;30;96;1115;2974;1145;3070
220535;202005;793;2197;741;2128;29;98;607;1730;636;1828
220540;202005;3196;10213;2989;9820;115;400;2559;8374;2674;8774
220545;202005;1385;4188;1269;4000;67;260;1059;3290;1126;3550
220550;202005;8518;26155;7522;24429;490;1719;5681;18294;6171;20013
220551;202005;1386;3960;1208;3653;27;124;990;2928;1017;3052
220552;202005;1586;4591;1286;4060;27;135;1032;3142;1059;3277
220553;202005;1718;4430;1413;4027;57;105;1145;3392;1202;3497
220554;202005;884;2313;643;1914;49;112;412;1233;461;1345
220555;202005;2242;6723;1993;6385;45;184;1684;5429;1729;5613
220556;202005;1190;3457;1030;3154;57;233;740;2168;797;2401
220557;202005;1587;4862;1338;4363;68;270;982;3103;1050;3373
220558;202005;1388;3593;1088;3175;18;81;941;2717;959;2798
220559;202005;1731;4303;1461;3889;9;22;1175;3179;1184;3201
220560;202005;1758;3948;1418;3515;36;70;1290;3219;1326;3289
220570;202005;7133;21285;6480;20368;447;1414;5142;16270;5589;17684
220580;202005;6910;18899;6319;17947;80;297;5728;16148;5808;16445
220585;202005;2002;6307;1662;5681;41;148;1365;4715;1406;4863
220590;202005;1306;3553;1069;3194;69;204;773;2323;842;2527
220595;202005;2526;6906;2289;6587;21;100;2037;5812;2058;5912
220600;202005;1378;3090;1160;2818;87;108;964;2430;1051;2538
220605;202005;1606;4687;1366;4260;19;116;1105;3339;1124;3455
220610;202005;2707;7961;2534;7706;34;151;2362;7163;2396;7314
220620;202005;7776;24121;7151;23274;169;893;6510;20929;6679;21822
220630;202005;371;1083;284;921;22;76;192;617;214;693
220635;202005;1599;5079;1404;4649;54;267;1060;3412;1114;3679
220640;202005;2472;6821;2106;6292;79;316;1708;5037;1787;5353
220650;202005;2051;5657;1778;5243;37;137;1423;4200;1460;4337
220660;202005;2608;8122;2217;7461;80;412;1854;6091;1934;6503
220665;202005;1197;3641;1008;3326;31;173;836;2669;867;2842
220667;202005;1575;4912;1407;4595;59;236;1157;3751;1216;3987
220669;202005;1603;4894;1534;4787;51;242;1357;4135;1408;4377
220670;202005;2166;5652;1736;5048;16;82;1511;4379;1527;4461
220672;202005;3182;7793;2570;7052;104;336;2267;6163;2371;6499
220675;202005;1238;3405;1107;3164;31;103;925;2612;956;2715
220680;202005;2666;7263;2546;7092;98;236;2331;6518;2429;6754
220690;202005;1556;4114;1374;3836;59;168;1088;3053;1147;3221
220695;202005;889;2450;820;2331;20;63;719;2032;739;2095
220700;202005;9795;24150;7845;21450;339;958;6012;16327;6351;17285
220710;202005;891;2453;658;2007;32;104;492;1473;524;1577
220720;202005;2099;4978;1892;4700;15;62;1648;4040;1663;4102
220730;202005;1302;3632;1093;3276;14;77;930;2722;944;2799
220735;202005;950;2220;741;1902;18;63;625;1546;643;1609
220740;202005;1357;3536;1080;3184;31;81;896;2699;927;2780
220750;202005;3835;9736;3341;9024;191;466;2889;7839;3080;8305
220755;202005;1306;3205;1085;2875;23;89;886;2285;909;2374
220760;202005;3069;8561;2678;8033;71;236;2397;7258;2468;7494
220770;202005;22339;66573;18748;60343;5736;19453;6623;22130;12359;41583
220775;202005;1144;2910;1017;2751;10;39;976;2623;986;2662
220777;202005;1603;4052;1213;3452;30;78;932;2667;962;2745
220779;202005;1287;3249;1111;2994;20;62;971;2602;991;2664
220780;202005;5542;13996;4814;12891;200;654;3943;10315;4143;10969
220785;202005;1462;3237;1278;3002;8;20;1234;2884;1242;2904
220790;202005;9960;28448;8930;26970;210;992;7519;22454;7729;23446
220793;202005;911;2393;721;2061;10;23;602;1742;612;1765
220795;202005;1377;3551;1209;3320;17;77;1075;2939;1092;3016
220800;202005;17683;39303;14934;35664;625;1460;11564;27566;12189;29026
220810;202005;2981;8227;2506;7387;53;161;2068;6040;2121;6201
220820;202005;4982;12988;4300;11994;277;677;3253;9066;3530;9743
220830;202005;7236;19236;6490;18200;237;788;5388;14884;5625;15672
220840;202005;12132;37185;10057;32917;2267;7120;4660;15910;6927;23030
220850;202005;3111;9620;2774;9206;59;319;2448;8135;2507;8454
220855;202005;685;1736;591;1606;13;48;539;1454;552;1502
220860;202005;1038;2583;897;2357;16;67;810;2097;826;2164
220865;202005;2422;6427;1899;5513;95;353;1384;3894;1479;4247
220870;202005;2902;8257;2421;7620;35;184;2227;6989;2262;7173
220880;202005;5267;12439;4527;11518;80;293;4127;10382;4207;10675
220885;202005;1370;4201;1130;3792;57;233;905;3069;962;3302
220887;202005;1550;3353;1288;3015;13;30;1193;2773;1206;2803
220890;202005;1389;4254;1215;3988;46;160;1007;3360;1053;3520
220900;202005;2012;4783;1676;4346;31;78;1468;3792;1499;3870
220910;202005;1510;4130;1266;3774;54;166;1051;3146;1105;3312
220915;202005;942;2552;763;2225;5;20;573;1625;578;1645
220920;202005;1361;4338;1172;4084;58;248;971;3399;1029;3647
220930;202005;1722;4641;1445;4237;21;69;1343;3928;1364;3997
220935;202005;1072;3081;867;2649;24;91;575;1665;599;1756
220937;202005;1426;3777;1228;3472;22;79;978;2731;1000;2810
220940;202005;1503;4217;1196;3657;37;135;929;2802;966;2937
220945;202005;440;1531;379;1390;21;120;280;985;301;1105
220950;202005;1422;3263;923;2484;18;62;733;1904;751;1966
220955;202005;1583;4096;1318;3631;24;74;1119;3040;1143;3114
220960;202005;802;2038;597;1696;16;56;423;1135;439;1191
220965;202005;1769;4846;1543;4505;21;130;1337;3812;1358;3942
220970;202005;1907;4580;1395;3809;36;88;1157;3146;1193;3234
220975;202005;687;1980;586;1853;16;93;518;1576;534;1669
220980;202005;1141;3212;1011;3039;37;150;846;2511;883;2661
220985;202005;1205;3144;1046;2918;43;126;847;2292;890;2418
220987;202005;1422;4241;1237;3908;56;211;996;3127;1052;3338
220990;202005;1688;4622;1480;4317;19;103;1248;3580;1267;3683
220995;202005;1053;3211;852;2842;35;121;624;2071;659;2192
220997;202005;2370;7098;2189;6808;48;216;1960;6034;2008;6250
221000;202005;4450;12147;3924;11359;85;405;3345;9542;3430;9947
221005;202005;1473;3856;1343;3644;22;122;1165;3039;1187;3161
221010;202005;1195;2741;964;2457;20;60;836;2081;856;2141
221020;202005;1493;4570;1379;4353;22;88;1065;3318;1087;3406
221030;202005;1622;4032;1390;3750;23;71;1196;3277;1219;3348
221035;202005;1481;3903;1291;3644;23;30;1140;3310;1163;3340
221037;202005;662;1845;549;1649;7;24;385;1117;392;1141
221038;202005;516;1450;402;1242;12;42;284;874;296;916
221039;202005;860;2340;736;2128;19;83;599;1661;618;1744
221040;202005;3979;11878;3475;10974;147;527;2764;8706;2911;9233
221050;202005;3896;10200;3418;9590;67;244;3081;8623;3148;8867
221060;202005;8379;23285;6925;20985;253;716;5633;17203;5886;17919
221062;202005;1161;3756;986;3461;41;187;791;2740;832;2927
221063;202005;1036;2859;886;2640;55;183;688;2015;743;2198
221065;202005;2592;6704;2287;6153;21;84;2010;5308;2031;5392
221070;202005;3300;10303;2652;8946;280;941;1638;5642;1918;6583
221080;202005;3466;8514;2808;7543;61;232;2305;6085;2366;6317
221090;202005;1396;3592;1142;3173;9;34;981;2665;990;2699
221093;202005;1354;3804;1232;3556;125;348;848;2404;973;2752
221095;202005;885;2292;737;2062;10;33;617;1695;627;1728
221097;202005;839;2183;644;1837;24;76;474;1297;498;1373
221100;202005;113211;302498;93732;269066;10033;30900;60902;170115;70935;201015
221110;202005;9816;29250;8992;28177;146;744;8045;24946;8191;25690
221120;202005;4744;13053;4214;12197;160;480;3673;10618;3833;11098
221130;202005;5232;13690;3869;11021;750;2039;1873;5392;2623;7431
221135;202005;1629;4296;1465;4077;45;137;1296;3611;1341;3748
221140;202005;1312;3101;1102;2830;11;37;989;2494;1000;2531
221150;202005;1108;2724;859;2286;24;106;665;1654;689;1760
221160;202005;724;1801;635;1684;13;16;520;1385;533;1401
221170;202005;990;2835;898;2667;20;68;776;2275;796;2343
230010;202005;3033;7965;2491;7031;36;133;2025;5598;2061;5731
230015;202005;3017;9729;2638;8976;172;658;1852;6262;2024;6920
230020;202005;12883;40550;12026;39233;330;1369;10212;33139;10542;34508
230030;202005;12940;32356;10778;29548;182;565;9460;25924;9642;26489
230040;202005;4394;11411;3637;10193;44;222;3046;8412;3090;8634
230050;202005;2779;8599;2088;6946;338;1074;929;3018;1267;4092
230060;202005;2345;6406;1855;5537;36;158;1468;4304;1504;4462
230070;202005;3872;10325;3103;8836;141;449;2177;6122;2318;6571
230075;202005;8930;28956;8157;27585;471;1976;6490;21661;6961;23637
230080;202005;3076;6411;2324;5481;7;24;2120;5018;2127;5042
230090;202005;4297;10622;3616;9530;169;441;2887;7563;3056;8004
230100;202005;17716;46135;15545;43171;1158;3329;11178;31154;12336;34483
230110;202005;12678;37597;10632;33571;1714;5383;5624;17878;7338;23261
230120;202005;7328;19774;6434;18302;500;1259;4739;13700;5239;14959
230125;202005;3133;8252;2542;7295;88;299;1951;5521;2039;5820
230130;202005;5727;17587;4628;15144;312;1104;3133;10066;3445;11170
230140;202005;3411;10207;2889;9120;99;409;2199;6775;2298;7184
230150;202005;1565;4691;1293;4088;194;534;756;2480;950;3014
230160;202005;6476;16794;5518;15287;197;690;4469;12162;4666;12852
230170;202005;6238;17685;5062;15253;310;910;3631;10772;3941;11682
230180;202005;1638;4527;1383;4045;21;99;1118;3166;1139;3265
230185;202005;4371;12413;3670;11242;245;847;2742;8369;2987;9216
230190;202005;13118;38148;10999;34204;1450;4721;6246;19246;7696;23967
230195;202005;5249;15469;4750;14526;335;1019;3645;11112;3980;12131
230200;202005;4991;13742;4170;12189;147;475;3187;9115;3334;9590
230205;202005;4043;12096;3534;11311;188;675;2658;8429;2846;9104
230210;202005;10358;24885;8707;22647;339;1116;6865;17547;7204;18663
230220;202005;13925;34894;12139;32302;621;1671;9981;26295;10602;27966
230230;202005;6791;20477;6053;18922;396;1226;4466;13951;4862;15177
230240;202005;13017;34657;11215;31573;276;1158;9252;25445;9528;26603
230250;202005;8887;24924;8259;23941;229;816;6615;18607;6844;19423
230260;202005;14590;43650;12608;40073;1693;5242;7209;23449;8902;28691
230270;202005;7520;20356;5714;16921;471;1361;3779;11253;4250;12614
230280;202005;20337;54243;16518;47763;471;1996;13000;36224;13471;38220
230290;202005;4827;13367;3992;11775;267;709;3006;8884;3273;9593
230300;202005;4762;12740;4292;12092;95;292;3755;10507;3850;10799
230310;202005;4604;13106;3879;11815;132;577;2795;8275;2927;8852
230320;202005;7706;22228;6460;19929;242;990;4928;14874;5170;15864
230330;202005;4681;12753;3676;10807;140;465;2755;7919;2895;8384
230340;202005;3560;11076;3016;9963;261;913;2027;6631;2288;7544
230350;202005;17713;48792;15468;45416;863;2905;10396;30745;11259;33650
230360;202005;2887;7685;2249;6555;142;414;1518;4381;1660;4795
230365;202005;3009;7542;2481;6749;52;253;2109;5645;2161;5898
230370;202005;58478;162408;49551;149035;7364;22405;29353;89747;36717;112152
230380;202005;6284;17438;4921;14910;129;525;3634;10770;3763;11295
230390;202005;3378;10014;2910;9252;95;422;2241;7035;2336;7457
230393;202005;3203;9579;2541;8211;86;451;1947;6048;2033;6499
230395;202005;5778;15688;5028;14429;317;851;3579;10299;3896;11150
230400;202005;5463;14995;4849;13981;92;486;3912;10950;4004;11436
230410;202005;14170;41664;11611;36902;884;3055;7949;25219;8833;28274
230420;202005;28495;78343;22976;68650;2799;8707;12810;38102;15609;46809
230423;202005;4645;13766;4031;12533;88;394;3299;10083;3387;10477
230425;202005;5526;17038;5012;15978;389;1309;3577;11349;3966;12658
230426;202005;2733;7198;1971;5707;25;99;1482;4211;1507;4310
230427;202005;1850;5202;1316;4070;60;201;877;2604;937;2805
230428;202005;9613;25619;8216;23507;1110;3159;4815;13726;5925;16885
230430;202005;4964;13914;3903;12089;152;542;2910;8880;3062;9422
230435;202005;5834;15317;4834;13519;575;1528;2950;8313;3525;9841
230440;202005;409119;1014303;337952;908922;34148;97325;215939;574715;250087;672040
230445;202005;4263;11280;3423;9827;174;492;2348;6607;2522;7099
230450;202005;3560;10291;3098;9611;238;932;2255;6779;2493;7711
230460;202005;2111;5892;1837;5459;57;230;1533;4531;1590;4761
230465;202005;3983;11187;3372;10016;99;397;2539;7255;2638;7652
230470;202005;11270;37091;10068;34861;878;3457;7139;24289;8017;27746
230480;202005;1431;4124;1211;3727;70;277;894;2648;964;2925
230490;202005;2511;7057;2094;6273;164;558;1313;3696;1477;4254
230495;202005;5707;16928;5010;15675;364;1384;3330;10283;3694;11667
230500;202005;9211;29636;8251;27858;268;1100;6720;22642;6988;23742
230510;202005;1607;4840;1244;4048;171;607;620;1978;791;2585
230520;202005;4493;12728;3874;11606;314;881;2722;8192;3036;9073
230523;202005;15326;45236;12185;38452;2756;8688;3158;10621;5914;19309
230526;202005;3683;10475;3132;9523;183;534;2287;7010;2470;7544
230530;202005;5346;16706;4480;14995;296;1113;3216;10655;3512;11768
230533;202005;4400;10574;3648;9367;85;253;3039;7679;3124;7932
230535;202005;5300;14703;4468;13289;232;696;3135;9444;3367;10140
230540;202005;16166;43802;13840;40350;275;1104;11409;32942;11684;34046
230550;202005;20613;54626;16468;47530;1483;4439;10482;30089;11965;34528
230560;202005;8062;19662;6481;17158;50;209;5567;14634;5617;14843
230565;202005;2992;8342;2499;7435;87;359;1888;5498;1975;5857
230570;202005;3446;8803;2930;8100;81;230;2407;6648;2488;6878
230580;202005;10931;28211;9317;25881;339;960;7689;21240;8028;22200
230590;202005;8812;25052;7264;22209;395;1433;5359;15854;5754;17287
230600;202005;3589;9376;2803;7971;71;220;1962;5613;2033;5833
230610;202005;6631;18283;5842;16952;437;1246;4600;13279;5037;14525
230620;202005;2106;5669;1597;4663;121;369;977;2760;1098;3129
230625;202005;7748;22012;6477;19669;1932;6085;1776;5815;3708;11900
230630;202005;10727;31824;9269;28888;1446;4274;5348;17074;6794;21348
230640;202005;27655;83377;24864;78928;1216;4849;19761;61790;20977;66639
230650;202005;5091;13863;4329;12525;133;551;3524;9960;3657;10511
230655;202005;9193;31153;8628;30157;596;2164;6888;24339;7484;26503
230660;202005;5963;17770;4869;15831;151;808;3978;12667;4129;13475
230670;202005;6151;14663;4479;11966;132;432;3608;9411;3740;9843
230680;202005;2614;7156;2209;6434;125;344;1596;4674;1721;5018
230690;202005;7121;21014;6116;19008;380;1342;3874;11816;4254;13158
230700;202005;10155;25996;8185;22338;316;856;6063;16226;6379;17082
230710;202005;6713;21218;5854;19376;595;1982;3968;12985;4563;14967
230720;202005;1891;5571;1529;4826;118;349;1027;3169;1145;3518
230725;202005;3842;11567;3433;10852;378;1332;1990;6204;2368;7536
230730;202005;56226;152205;43750;132971;9579;31528;14668;46871;24247;78399
230740;202005;6000;16600;5080;15126;127;457;4105;12181;4232;12638
230750;202005;8302;22121;6870;19735;158;569;5477;15340;5635;15909
230760;202005;11058;29088;9607;26907;502;1669;7254;19858;7756;21527
230763;202005;4776;13096;3989;11660;117;551;3212;9106;3329;9657
230765;202005;40369;109600;33357;98142;5211;15885;16692;48851;21903;64736
230770;202005;25341;62691;21102;57028;2145;5838;13983;37895;16128;43733
230780;202005;6294;22089;5728;20760;776;2787;3388;12600;4164;15387
230790;202005;2949;8571;2645;8076;107;452;1986;5914;2093;6366
230800;202005;7958;25332;6970;23322;799;2910;4204;13818;5003;16728
230810;202005;11336;33785;10111;31804;392;1446;7820;24145;8212;25591
230820;202005;3427;11195;2787;9686;249;1039;1697;5613;1946;6652
230830;202005;7493;20357;6355;18431;129;549;5257;14895;5386;15444
230835;202005;4236;10091;3220;8468;84;254;2603;6738;2687;6992
230837;202005;3097;9495;2691;8777;105;494;2143;6800;2248;7294
230840;202005;8929;26184;7660;24044;770;2303;5505;17425;6275;19728
230850;202005;9429;27387;7875;24288;356;1297;5677;17242;6033;18539
230860;202005;5134;13106;4241;11823;55;198;3757;10421;3812;10619
230870;202005;16391;40054;14002;36077;372;1076;11467;29036;11839;30112
230880;202005;2098;6361;1910;6048;39;223;1524;4709;1563;4932
230890;202005;4547;14505;4116;13629;325;1196;2989;9709;3314;10905
230900;202005;2971;8552;2527;7692;178;616;1710;5092;1888;5708
230910;202005;3118;8305;2504;7330;61;284;2043;5951;2104;6235
230920;202005;4566;12874;3838;11713;129;530;3030;9058;3159;9588
230930;202005;6439;18046;5372;16128;287;836;3746;11262;4033;12098
230940;202005;7929;20299;6819;18598;190;485;5707;15486;5897;15971
230945;202005;6444;18535;5517;16754;299;1072;3925;11710;4224;12782
230950;202005;6164;15548;5440;14557;94;244;4719;12657;4813;12901
230960;202005;13085;38026;11483;35019;1846;5606;5833;17997;7679;23603
230970;202005;13415;35556;11150;32011;1724;4895;6300;18389;8024;23284
230980;202005;2655;7783;2327;7203;347;1024;1439;4575;1786;5599
230990;202005;1615;4551;1338;3995;61;263;959;2724;1020;2987
231000;202005;2465;6582;1999;5654;73;191;1490;4135;1563;4326
231010;202005;3517;8257;2765;6946;41;155;2397;5842;2438;5997
231020;202005;7890;24918;7023;23171;1281;3907;3978;13703;5259;17610
231025;202005;7414;20487;6421;18851;715;2057;4456;13204;5171;15261
231030;202005;7224;21492;5625;18109;884;2752;2940;9522;3824;12274
231040;202005;2885;8377;2510;7672;118;372;1966;5922;2084;6294
231050;202005;11607;29831;9327;25786;636;1714;6930;18737;7566;20451
231060;202005;2864;8066;2501;7480;60;207;2054;6140;2114;6347
231070;202005;7719;22387;6573;20382;695;2222;4258;13126;4953;15348
231080;202005;3934;11225;3337;10248;127;540;2549;7662;2676;8202
231085;202005;6732;16356;5315;14654;200;534;4171;11508;4371;12042
231090;202005;4492;11638;3308;9351;111;429;2278;6201;2389;6630
231095;202005;2272;6745;1768;5646;134;432;1177;3748;1311;4180
231100;202005;3139;9067;2584;8021;118;436;1934;5930;2052;6366
231110;202005;3518;10349;3190;9739;115;423;2407;7236;2522;7659
231120;202005;2207;6461;1817;5784;69;277;1310;4117;1379;4394
231123;202005;1868;4838;1560;4309;68;150;1140;3171;1208;3321
231126;202005;5381;14899;4328;12898;240;731;3155;9285;3395;10016
231130;202005;21057;54059;17474;49515;996;3688;12973;36027;13969;39715
231135;202005;4125;11601;3399;10174;150;500;2430;7144;2580;7644
231140;202005;16364;46026;12994;40049;583;2436;9131;27397;9714;29833
231150;202005;5695;15520;4369;12988;664;2000;1959;5982;2623;7982
231160;202005;6180;18811;5402;17361;761;2324;3117;10287;3878;12611
231170;202005;4320;12636;3546;11147;187;682;2464;7484;2651;8166
231180;202005;14233;40342;11494;34538;3166;9223;3913;12257;7079;21480
231190;202005;3856;10880;3170;9620;68;303;2436;7199;2504;7502
231195;202005;4880;14816;4025;13019;225;846;2914;9334;3139;10180
231200;202005;7712;24189;6712;22159;197;1010;5257;16830;5454;17840
231210;202005;4795;14047;4073;12838;180;678;3084;9526;3264;10204
231220;202005;11903;31078;9198;25934;376;1184;6756;18374;7132;19558
231230;202005;9144;29132;8024;27098;481;1900;5914;19961;6395;21861
231240;202005;11378;33253;9984;30591;1511;4505;6068;18803;7579;23308
231250;202005;2111;5443;1369;3796;98;276;834;2267;932;2543
231260;202005;3184;9045;2748;8357;253;764;1890;5874;2143;6638
231270;202005;6363;16648;5134;14637;146;576;3887;10834;4033;11410
231280;202005;1715;5348;1562;5063;89;300;1171;3763;1260;4063
231290;202005;37338;111256;30844;97931;5190;16318;14299;45171;19489;61489
231300;202005;4032;11181;3137;9369;207;670;2075;6073;2282;6743
231310;202005;7129;18562;5669;15844;462;1310;3911;10741;4373;12051
231320;202005;7739;21236;6031;18193;85;406;4746;14114;4831;14520
231325;202005;2416;6383;1978;5717;165;395;1334;3943;1499;4338
231330;202005;9369;28078;7670;24686;1370;4207;4097;13785;5467;17992
231335;202005;5671;14976;4786;13537;84;359;4215;11796;4299;12155
231340;202005;17206;53334;15395;50080;1271;4188;11216;36878;12487;41066
231350;202005;15708;42899;14234;40803;274;996;12740;36176;13014;37172
231355;202005;4349;12973;3888;12099;234;786;3013;9277;3247;10063
231360;202005;7247;21979;6279;20284;248;925;5003;16077;5251;17002
231370;202005;2145;5917;1712;5147;35;112;1312;3943;1347;4055
231375;202005;4332;13473;3947;12835;130;597;3317;10643;3447;11240
231380;202005;5986;16257;5400;15444;182;485;4397;12763;4579;13248
231390;202005;3288;9603;2932;9013;121;476;2176;6507;2297;6983
231395;202005;3965;11664;3276;10551;401;1284;1948;6367;2349;7651
231400;202005;9613;27562;8030;24645;267;1129;6082;18267;6349;19396
231410;202005;14501;45205;13141;42934;586;2260;10609;34254;11195;36514
240010;202005;2542;6719;1973;5667;198;586;1179;3310;1377;3896
240020;202005;12275;34439;10262;30829;622;2324;6905;20428;7527;22752
240030;202005;2847;6953;2579;6537;89;257;2233;5613;2322;5870
240040;202005;804;2322;666;2052;33;125;463;1374;496;1499
240050;202005;3249;8721;2643;7616;47;146;2038;5773;2085;5919
240060;202005;1387;3727;1141;3282;23;86;934;2625;957;2711
240070;202005;2115;6146;1913;5732;177;576;1389;4042;1566;4618
240080;202005;2927;7889;2373;6865;52;205;1824;5170;1876;5375
240090;202005;2230;5481;1811;4772;17;48;1532;3991;1549;4039
240100;202005;10062;24817;7972;20987;206;634;6239;15866;6445;16500
240110;202005;4599;12925;3864;11589;189;682;2799;8228;2988;8910
240120;202005;3256;9037;2602;8234;179;602;1840;5977;2019;6579
240130;202005;3602;7529;3001;6749;27;83;2743;6085;2770;6168
240140;202005;1798;5382;1529;4853;156;544;1031;3245;1187;3789
240145;202005;6592;18259;5367;16153;820;2520;3026;9223;3846;11743
240150;202005;915;2680;805;2446;51;180;622;1831;673;2011
240160;202005;1439;4335;1200;3880;45;206;895;2909;940;3115
240165;202005;959;2622;795;2308;34;112;641;1831;675;1943
240170;202005;2469;6695;2061;5945;188;619;1408;3931;1596;4550
240180;202005;2962;8789;2361;7556;555;1677;1060;3615;1615;5292
240185;202005;1190;3750;1092;3583;51;215;910;2939;961;3154
240190;202005;1035;3087;886;2836;21;99;756;2429;777;2528
240200;202005;10760;27551;8547;23748;852;2592;4910;13316;5762;15908
240210;202005;3194;7927;2611;7004;25;134;2197;5718;2222;5852
240220;202005;7208;21568;6429;20339;328;1448;5063;15729;5391;17177
240230;202005;5789;14742;4632;12793;195;553;3689;10198;3884;10751
240240;202005;1842;5272;1144;3604;114;379;426;1198;540;1577
240250;202005;2918;7673;2567;7192;94;284;2153;5999;2247;6283
240260;202005;14073;41314;12114;37982;1705;4996;7521;24746;9226;29742
240270;202005;2261;6719;1969;6229;99;319;1433;4680;1532;4999
240280;202005;1674;4289;1419;3866;50;141;1138;3059;1188;3200
240290;202005;1180;3436;948;2913;30;137;673;1937;703;2074
240300;202005;2277;5790;1630;4595;68;208;1032;2830;1100;3038
240310;202005;8463;22340;6666;19114;882;2690;3470;9772;4352;12462
240320;202005;2009;5481;1479;4432;33;148;1102;3157;1135;3305
240325;202005;31164;82910;24651;71377;4323;12882;10972;31977;15295;44859
240330;202005;1739;4736;1324;3943;54;195;901;2554;955;2749
240340;202005;1961;4513;1592;3947;64;152;1302;3173;1366;3325
240350;202005;2151;5467;1920;5214;25;76;1752;4774;1777;4850
240360;202005;8696;24028;7732;22500;811;2402;5453;16025;6264;18427
240370;202005;1895;5019;1464;4120;62;185;1042;2859;1104;3044
240375;202005;901;2269;742;1968;27;98;608;1555;635;1653
240380;202005;2237;6330;1636;4974;143;411;954;2866;1097;3277
240390;202005;1002;2469;698;1885;26;59;439;1111;465;1170
240400;202005;1433;3499;1119;2952;34;124;788;1950;822;2074
240410;202005;561;1691;469;1485;38;146;298;889;336;1035
240420;202005;4537;15903;3985;14663;456;1997;2376;8552;2832;10549
240430;202005;3335;8660;2773;7658;166;536;2065;5532;2231;6068
240440;202005;2504;5470;2110;4928;137;265;1711;4008;1848;4273
240450;202005;4496;12214;3513;10351;342;1060;2092;5936;2434;6996
240460;202005;2841;8122;2562;7666;232;754;1980;5897;2212;6651
240470;202005;3622;10837;2751;9017;478;1471;1423;4890;1901;6361
240480;202005;576;1595;390;1182;33;104;181;530;214;634
240485;202005;2118;5975;1729;5250;121;383;1207;3665;1328;4048
240490;202005;1608;4121;1258;3470;81;191;933;2592;1014;2783
240500;202005;2134;5745;1863;5291;100;271;1504;4278;1604;4549
240510;202005;1667;4327;1465;4035;61;219;1223;3292;1284;3511
240520;202005;1427;3508;1113;3072;48;156;845;2325;893;2481
240530;202005;2135;6101;1919;5760;90;275;1574;4715;1664;4990
240540;202005;2264;5669;1974;5215;58;119;1714;4528;1772;4647
240550;202005;676;1920;610;1787;18;75;510;1450;528;1525
240560;202005;3289;8505;2762;7795;268;685;2011;5776;2279;6461
240570;202005;2777;7282;1830;5173;285;814;719;1909;1004;2723
240580;202005;8057;23432;7105;21660;548;1588;5666;17424;6214;19012
240590;202005;726;1900;631;1740;12;40;481;1293;493;1333
240600;202005;1767;4807;1297;3820;45;143;863;2458;908;2601
240610;202005;4186;11292;3530;10095;126;429;2705;7582;2831;8011
240615;202005;1233;3157;970;2683;96;260;664;1796;760;2056
240620;202005;1825;5144;1573;4698;93;258;1263;3759;1356;4017
240630;202005;2084;5883;1881;5533;147;310;1329;4082;1476;4392
240640;202005;939;2511;746;2187;28;110;559;1613;587;1723
240650;202005;4031;11206;3468;10057;215;638;2655;7594;2870;8232
240660;202005;3090;7900;2741;7447;50;155;2482;6749;2532;6904
240670;202005;2434;6854;1951;5866;137;446;1266;3702;1403;4148
240680;202005;1617;4293;1296;3741;46;142;987;2773;1033;2915
240690;202005;999;2500;791;2150;16;69;627;1634;643;1703
240700;202005;2400;6935;1950;6090;56;204;1540;4725;1596;4929
240710;202005;16121;41665;13445;37042;1733;4665;8318;22954;10051;27619
240720;202005;5142;12653;4441;11668;379;1042;3276;8500;3655;9542
240725;202005;1120;3177;855;2640;35;119;573;1705;608;1824
240730;202005;2207;6197;1782;5354;60;221;1359;3999;1419;4220
240740;202005;1784;4804;1427;4100;41;160;1057;2875;1098;3035
240750;202005;2117;6980;1782;6265;262;1005;955;3397;1217;4402
240760;202005;1605;3776;1135;3051;62;96;866;2417;928;2513
240770;202005;3194;8767;2674;8018;126;465;2150;6362;2276;6827
240780;202005;4802;13220;3889;11680;496;1480;2422;7432;2918;8912
240790;202005;859;2436;712;2142;14;62;542;1588;556;1650
240800;202005;46051;110843;35607;94947;4859;13351;18425;49194;23284;62545
240810;202005;88213;229166;74332;205926;9232;26228;47102;128719;56334;154947
240820;202005;5795;17211;5010;15785;685;2120;3096;9928;3781;12048
240830;202005;8704;24766;7711;23273;237;1036;6402;19048;6639;20084
240840;202005;1117;2750;883;2375;29;74;631;1627;660;1701
240850;202005;1348;3672;963;2860;46;148;533;1522;579;1670
240860;202005;1280;3415;963;2841;15;74;715;2006;730;2080
240870;202005;1102;2796;828;2313;130;367;449;1283;579;1650
240880;202005;1255;3965;1110;3680;84;356;856;2759;940;3115
240890;202005;4375;11934;3313;9885;441;1425;1702;4882;2143;6307
240895;202005;2773;8554;2537;8182;136;440;2211;7184;2347;7624
240910;202005;3320;9037;2834;8155;50;180;2326;6586;2376;6766
240920;202005;880;2409;723;2152;62;173;416;1292;478;1465
240930;202005;3679;8353;3040;7575;198;286;2281;5998;2479;6284
240933;202005;1769;4278;1446;3806;41;163;1255;3247;1296;3410
240940;202005;6064;14926;4690;12579;539;1456;2813;7345;3352;8801
240950;202005;1007;3008;878;2770;26;110;718;2207;744;2317
240960;202005;670;2067;601;1927;28;104;469;1471;497;1575
240970;202005;1825;4695;1477;4102;54;202;1213;3262;1267;3464
240980;202005;3304;9812;2923;9123;112;485;2362;7247;2474;7732
240990;202005;2539;7148;2244;6569;268;869;1579;4465;1847;5334
241000;202005;935;2490;744;2135;26;70;554;1562;580;1632
241010;202005;2773;8871;2528;8341;158;640;1867;6059;2025;6699
241020;202005;2118;5620;1563;4506;132;385;1017;2881;1149;3266
241025;202005;1766;5032;1402;4343;49;202;1018;3107;1067;3309
241030;202005;2491;7761;1987;6680;221;761;1277;4302;1498;5063
241040;202005;2278;7213;2019;6777;95;422;1620;5398;1715;5820
241050;202005;1325;3679;1091;3260;32;123;806;2343;838;2466
241060;202005;740;2091;654;1908;27;87;461;1289;488;1376
241070;202005;663;1800;570;1634;11;36;450;1243;461;1279
241080;202005;1125;3173;850;2620;9;36;614;1867;623;1903
241090;202005;2009;5868;1635;5221;43;218;1292;4063;1335;4281
241100;202005;1167;3261;917;2750;67;206;599;1740;666;1946
241105;202005;974;2946;793;2601;252;800;256;880;508;1680
241110;202005;951;2690;706;2171;32;102;469;1392;501;1494
241120;202005;7604;21434;6445;19376;956;2809;3809;11758;4765;14567
241140;202005;3285;8646;2582;7231;153;440;1863;5093;2016;5533
241142;202005;770;2065;566;1669;25;86;339;942;364;1028
241150;202005;5911;15352;5205;14190;142;493;4279;11450;4421;11943
241160;202005;1132;3034;914;2633;131;381;587;1651;718;2032
241170;202005;1325;3374;1132;3041;28;109;945;2433;973;2542
241180;202005;1026;2634;741;2073;93;271;378;1042;471;1313
241190;202005;1126;2969;937;2590;17;71;689;1834;706;1905
241200;202005;19082;50030;16379;45630;2588;7214;9548;26651;12136;33865
241210;202005;1410;3771;1007;2963;118;378;573;1638;691;2016
241220;202005;8749;25760;7589;23776;1732;5353;3585;11733;5317;17086
241230;202005;2917;7623;2570;7083;103;320;2138;5825;2241;6145
241240;202005;1195;3339;736;2313;63;202;327;1031;390;1233
241250;202005;5370;15582;4290;13537;164;758;3120;9460;3284;10218
241255;202005;2247;6980;1978;6406;112;449;1507;4782;1619;5231
241260;202005;4875;12692;3818;10915;79;326;3028;8465;3107;8791
241270;202005;1729;4969;1424;4382;103;358;1024;3134;1127;3492
241280;202005;2163;5420;1849;4848;58;151;1571;4060;1629;4211
241290;202005;3396;8285;2520;6854;76;249;1991;5268;2067;5517
241300;202005;1449;3870;1153;3333;34;118;790;2227;824;2345
241310;202005;2118;5243;1816;4813;15;62;1549;4134;1564;4196
241320;202005;941;3049;801;2781;85;365;520;1779;605;2144
241330;202005;1732;4526;1351;4018;16;82;1174;3469;1190;3551
241335;202005;3227;8993;2848;8298;101;337;2353;6782;2454;7119
241340;202005;1554;4377;1200;3633;255;808;491;1449;746;2257
241350;202005;2074;5884;1819;5425;88;301;1415;4151;1503;4452
241355;202005;1288;3490;1052;3028;16;45;824;2362;840;2407
241360;202005;2031;5265;1518;4215;37;118;1092;2919;1129;3037
241370;202005;1340;3706;1034;3064;47;165;721;2043;768;2208
241380;202005;616;1744;477;1469;74;192;243;772;317;964
241390;202005;2724;7971;2422;7523;191;535;1875;5924;2066;6459
241400;202005;3566;9852;3169;9226;155;492;2572;7425;2727;7917
241410;202005;2372;7056;1924;6131;338;1092;977;3124;1315;4216
241415;202005;1653;4876;1350;4283;61;228;948;2953;1009;3181
241420;202005;2230;7061;1909;6504;444;1688;956;3236;1400;4924
241430;202005;602;1663;411;1226;18;59;258;742;276;801
241440;202005;7460;23007;6663;21598;351;1289;5286;17044;5637;18333
241445;202005;1106;2818;976;2649;22;56;870;2417;892;2473
241450;202005;2582;6452;2215;5852;380;851;1461;3999;1841;4850
241460;202005;3746;10130;3033;8613;188;572;2144;5939;2332;6511
241470;202005;1401;3697;1136;3305;25;92;946;2754;971;2846
241475;202005;1186;3338;930;2838;23;112;668;1948;691;2060
241480;202005;2905;9064;2386;7919;717;2354;799;2951;1516;5305
241490;202005;626;1489;513;1335;22;55;370;945;392;1000
241500;202005;797;2278;708;2164;3;10;655;2023;658;2033
250010;202005;2522;7541;2089;6648;59;238;1523;4739;1582;4977
250020;202005;1601;4308;1148;3416;32;75;828;2454;860;2529
250030;202005;6923;18865;6092;17548;519;1517;4553;12979;5072;14496
250040;202005;4002;12248;3450;11222;228;846;2500;8001;2728;8847
250050;202005;3600;9675;3244;9192;126;432;2642;7504;2768;7936
250053;202005;1162;3234;1052;3056;70;206;771;2250;841;2456
250057;202005;651;2326;607;2258;10;44;542;2051;552;2095
250060;202005;5460;14226;4898;13532;289;776;4036;11218;4325;11994
250070;202005;3951;11024;3346;9958;36;153;2697;7854;2733;8007
250073;202005;761;2016;619;1798;10;28;507;1437;517;1465
250077;202005;2196;5898;1642;4981;61;216;1244;3745;1305;3961
250080;202005;4860;12108;4113;11144;67;290;3586;9582;3653;9872
250090;202005;3322;8113;2898;7546;53;159;2495;6381;2548;6540
250100;202005;3634;11055;3275;10374;161;567;2563;7952;2724;8519
250110;202005;4893;13681;4394;12946;258;964;3420;9857;3678;10821
250115;202005;683;1784;494;1492;9;45;345;1039;354;1084
250120;202005;1818;5327;1523;4837;30;142;1204;3797;1234;3939
250130;202005;5464;15006;4602;13783;71;382;3897;11518;3968;11900
250135;202005;1194;3301;1038;3026;24;92;901;2606;925;2698
250140;202005;2243;6540;2080;6333;108;450;1783;5367;1891;5817
250150;202005;4792;14898;4296;14044;135;622;3462;11119;3597;11741
250153;202005;1404;3696;1170;3340;30;85;939;2662;969;2747
250157;202005;1709;5075;1550;4769;54;230;1239;3746;1293;3976
250160;202005;3910;9704;3114;8626;39;147;2740;7592;2779;7739
250170;202005;1841;4715;1641;4431;24;95;1433;3822;1457;3917
250180;202005;20087;48466;17086;44611;734;2308;13328;33926;14062;36234
250190;202005;4039;10769;3364;9754;317;964;2327;6581;2644;7545
250200;202005;1931;5133;1640;4722;59;187;1380;3976;1439;4163
250205;202005;862;2644;740;2451;17;85;612;1995;629;2080
250210;202005;1553;4690;1397;4437;71;314;1088;3396;1159;3710
250215;202005;1537;4227;1281;3853;75;251;769;2321;844;2572
250220;202005;660;1825;530;1632;27;103;348;1047;375;1150
250230;202005;1668;3736;1109;2868;17;60;922;2295;939;2355
250240;202005;2296;6964;2010;6436;41;204;1666;5248;1707;5452
250250;202005;4565;12644;3968;11759;83;294;3393;10060;3476;10354
250260;202005;1698;4726;1410;4232;49;134;1116;3324;1165;3458
250270;202005;1204;3609;1086;3463;58;203;807;2672;865;2875
250280;202005;3323;9230;2964;8692;105;305;2358;6915;2463;7220
250290;202005;1593;4194;1352;3846;22;69;1062;3024;1084;3093
250300;202005;5497;14619;4928;13954;184;826;4112;11227;4296;12053
250310;202005;1135;3117;937;2786;36;120;726;2130;762;2250
250320;202005;11787;26559;10092;24605;256;730;8999;21638;9255;22368
250330;202005;2407;6607;2014;6064;108;337;1627;4892;1735;5229
250340;202005;1094;2776;975;2623;10;27;896;2402;906;2429
250350;202005;4097;11410;3617;10605;196;478;2838;8572;3034;9050
250355;202005;1964;5905;1759;5620;27;142;1577;5006;1604;5148
250360;202005;1773;4887;1577;4622;38;145;1322;3841;1360;3986
250370;202005;13337;34498;10978;30922;239;900;9212;25581;9451;26481
250375;202005;1183;3085;948;2798;5;17;893;2662;898;2679
250380;202005;1603;4131;1467;3958;26;113;1288;3363;1314;3476
250390;202005;1846;4681;1541;4189;84;234;1224;3290;1308;3524
250400;202005;69174;169818;50411;140364;13963;41474;14600;42937;28563;84411
250403;202005;1732;4829;1543;4603;73;366;1189;3381;1262;3747
250407;202005;1226;3048;983;2682;73;156;694;1949;767;2105
250410;202005;641;1714;555;1565;4;9;463;1279;467;1288
250415;202005;1868;5203;1632;4821;32;146;1411;4136;1443;4282
250420;202005;1179;3336;1073;3191;25;96;958;2831;983;2927
250430;202005;6249;15295;5269;13976;137;427;4360;11317;4497;11744
250435;202005;1526;4252;1224;3720;10;48;941;2823;951;2871
250440;202005;4577;12067;3909;11223;69;193;3468;9956;3537;10149
250450;202005;1807;4787;1475;4331;29;104;1229;3620;1258;3724
250460;202005;7293;19738;6443;18482;318;975;5197;14827;5515;15802
250470;202005;1536;3958;1265;3536;51;158;989;2714;1040;2872
250480;202005;4036;10849;3418;10109;41;146;3016;8991;3057;9137
250485;202005;712;1615;521;1337;35;62;386;959;421;1021
250490;202005;5164;12249;4579;11577;171;516;4045;10038;4216;10554
250500;202005;1974;5467;1747;5071;71;236;1421;4115;1492;4351
250510;202005;5445;13659;4658;12610;75;199;4071;11117;4146;11316
250520;202005;1817;4917;1550;4527;124;395;1102;3196;1226;3591
250523;202005;2227;5468;1968;5141;66;282;1657;4170;1723;4452
250527;202005;1671;4299;1500;4105;24;76;1330;3660;1354;3736
250530;202005;626;1611;531;1481;5;11;468;1304;473;1315
250535;202005;1348;3951;1215;3693;27;114;996;2934;1023;3048
250540;202005;2947;6756;2452;6202;66;123;2149;5529;2215;5652
250550;202005;773;2463;675;2270;22;86;504;1663;526;1749
250560;202005;1716;4720;1514;4428;35;137;1282;3662;1317;3799
250570;202005;2627;7885;2252;7202;77;298;1778;5591;1855;5889
250580;202005;1050;2709;923;2532;47;178;774;2071;821;2249
250590;202005;816;2274;726;2145;19;65;594;1766;613;1831
250600;202005;8167;20805;6806;19039;234;728;5640;15662;5874;16390
250610;202005;2965;8295;2648;7832;117;440;2205;6441;2322;6881
250620;202005;777;2048;659;1846;10;30;487;1334;497;1364
250625;202005;2478;7141;2209;6695;40;217;1877;5525;1917;5742
250630;202005;10053;27842;8091;24380;850;2607;5171;15269;6021;17876
250640;202005;3395;9297;3060;8865;85;357;2638;7501;2723;7858
250650;202005;934;2247;782;2043;13;35;680;1759;693;1794
250660;202005;1632;4023;1309;3578;38;105;1079;2882;1117;2987
250670;202005;2325;7212;2111;6833;43;191;1838;5841;1881;6032
250680;202005;5796;13316;5166;12606;59;225;4787;11530;4846;11755
250690;202005;6793;15246;5746;13941;90;221;5111;12285;5201;12506
250700;202005;4272;11970;3717;11122;423;1251;2593;7725;3016;8976
250710;202005;4403;12582;3778;11724;271;939;2760;8557;3031;9496
250720;202005;2727;7259;2440;6852;36;178;2140;5936;2176;6114
250730;202005;4113;10903;3584;10204;101;416;3003;8306;3104;8722
250740;202005;1914;4777;1584;4336;92;216;1234;3398;1326;3614
250750;202005;104046;255261;87605;232159;7029;20252;63387;164775;70416;185027
250760;202005;2352;6075;2053;5595;84;261;1634;4318;1718;4579
250770;202005;4004;12023;3581;11455;385;1200;2576;8335;2961;9535
250780;202005;1727;4650;1435;4115;48;171;1114;3109;1162;3280
250790;202005;2441;7228;2101;6707;133;531;1425;4434;1558;4965
250800;202005;2456;6487;2134;5968;86;181;1727;4871;1813;5052
250810;202005;1267;3350;1046;3036;26;57;884;2601;910;2658
250820;202005;1972;5483;1815;5310;32;139;1658;4824;1690;4963
250830;202005;5791;17306;4761;15222;259;1005;3291;10207;3550;11212
250840;202005;759;2397;649;2177;14;56;491;1655;505;1711
250850;202005;1787;5309;1594;4964;33;157;1318;3999;1351;4156
250855;202005;940;2777;814;2552;55;195;611;1899;666;2094
250860;202005;3151;9312;2605;8382;438;1484;1528;4912;1966;6396
250870;202005;1032;2826;869;2550;31;118;715;2069;746;2187
250880;202005;1615;4119;1327;3704;74;214;1016;2827;1090;3041
250890;202005;10090;26297;8898;24684;398;1689;7102;18748;7500;20437
250900;202005;2784;7749;2404;7056;62;228;2037;5866;2099;6094
250905;202005;2397;6778;2197;6487;43;171;1999;5894;2042;6065
250910;202005;5898;14673;4848;13482;80;286;4219;11788;4299;12074
250915;202005;2155;5004;1500;4297;24;53;1307;3832;1331;3885
250920;202005;3502;8798;3067;8132;329;745;2251;6009;2580;6754
250930;202005;2247;5950;2024;5665;52;212;1757;4819;1809;5031
250933;202005;1156;3432;1019;3182;22;112;786;2381;808;2493
250937;202005;698;1865;570;1654;24;74;434;1281;458;1355
250939;202005;1750;4657;1519;4351;62;196;1191;3389;1253;3585
250940;202005;3970;10638;3480;9995;17;61;3092;8895;3109;8956
250950;202005;1711;4328;1377;3904;24;93;1141;3188;1165;3281
250960;202005;1125;3271;983;3044;26;140;799;2381;825;2521
250970;202005;8293;21187;7244;19503;223;688;6013;15886;6236;16574
250980;202005;2425;6408;2169;6024;35;149;1868;5056;1903;5205
250990;202005;2051;6173;1708;5573;54;255;1263;4069;1317;4324
251000;202005;2055;5751;1666;5079;37;159;1360;4113;1397;4272
251010;202005;2664;7428;2409;7044;19;88;2177;6364;2196;6452
251020;202005;1631;4428;1458;4153;32;146;1265;3529;1297;3675
251030;202005;1002;2650;821;2316;33;94;580;1613;613;1707
251040;202005;1817;5129;1532;4643;38;188;1237;3716;1275;3904
251050;202005;1055;2868;879;2527;48;157;628;1742;676;1899
251060;202005;1070;2292;807;1961;8;26;642;1529;650;1555
251065;202005;476;1299;368;1098;11;33;250;727;261;760
251070;202005;727;1872;618;1711;10;41;529;1437;539;1478
251080;202005;18435;47162;14967;41915;1802;5240;9722;27308;11524;32548
251090;202005;2774;7975;2330;7178;56;205;1862;5693;1918;5898
251100;202005;804;2556;717;2395;23;89;550;1768;573;1857
251110;202005;1694;4532;1437;4087;46;124;1090;3083;1136;3207
251120;202005;7230;20231;6076;18816;258;986;4838;14941;5096;15927
251130;202005;3866;8652;3407;8141;58;164;3086;7336;3144;7500
251140;202005;4229;11787;3781;11156;74;313;3170;9237;3244;9550
251150;202005;2635;7663;2365;7228;101;423;1939;5795;2040;6218
251160;202005;2132;6236;1848;5821;39;189;1589;4911;1628;5100
251170;202005;1557;4232;1351;3960;33;117;1168;3405;1201;3522
251180;202005;2630;7013;2149;6331;168;498;1465;4296;1633;4794
251190;202005;4390;11409;3993;10961;44;247;3632;9766;3676;10013
251200;202005;4328;12637;3808;11965;72;304;3350;10556;3422;10860
251203;202005;936;3030;861;2867;22;103;653;2117;675;2220
251207;202005;1073;2937;828;2527;19;100;578;1725;597;1825
251210;202005;7523;19121;6129;17224;270;643;4689;13442;4959;14085
251220;202005;1180;2837;926;2499;54;122;711;1963;765;2085
251230;202005;4592;12718;3950;11609;114;420;3118;8927;3232;9347
251240;202005;3610;9863;3034;8897;148;406;2291;6609;2439;7015
251250;202005;10243;27536;8954;25365;720;2153;6625;18207;7345;20360
251260;202005;480;1372;437;1305;12;62;349;1007;361;1069
251270;202005;4238;13177;3804;12598;109;448;3108;10516;3217;10964
251272;202005;1338;3617;1202;3437;43;165;1014;2821;1057;2986
251274;202005;892;2468;712;2140;63;209;471;1349;534;1558
251275;202005;1213;3389;1034;3098;29;131;813;2368;842;2499
251276;202005;1317;3567;1145;3337;31;161;933;2619;964;2780
251278;202005;579;1591;518;1502;46;110;377;1125;423;1235
251280;202005;2219;6030;1981;5663;49;170;1661;4681;1710;4851
251290;202005;5882;13872;5304;13164;146;489;4632;11134;4778;11623
251300;202005;856;2503;774;2379;8;41;657;2017;665;2058
251310;202005;2698;7763;2347;7211;49;258;1885;5646;1934;5904
251315;202005;1690;5273;1543;5004;82;252;1170;3747;1252;3999
251320;202005;1610;4261;1151;3472;32;113;864;2558;896;2671
251330;202005;2106;4883;1718;4428;21;77;1550;4023;1571;4100
251335;202005;1074;3127;955;2941;26;116;836;2515;862;2631
251340;202005;3677;8871;2937;7880;115;348;2255;6010;2370;6358
251350;202005;1057;3043;948;2859;25;99;782;2317;807;2416
251360;202005;1818;5080;1467;4586;20;97;1246;3902;1266;3999
251365;202005;716;1945;565;1645;6;23;444;1278;450;1301
251370;202005;24397;64216;20896;59168;2780;8015;12769;36882;15549;44897
251380;202005;1200;3390;1048;3132;19;108;878;2546;897;2654
251385;202005;744;1914;568;1589;15;43;424;1146;439;1189
251390;202005;6402;18572;5637;17362;461;1475;3753;11592;4214;13067
251392;202005;961;2608;803;2370;25;107;628;1816;653;1923
251394;202005;607;1756;498;1563;18;80;373;1147;391;1227
251396;202005;664;1783;567;1612;14;41;403;1120;417;1161
251398;202005;944;2383;667;1907;17;71;493;1367;510;1438
251400;202005;1213;2967;971;2639;25;95;774;2031;799;2126
251410;202005;1461;3468;1198;3094;17;73;1027;2557;1044;2630
251420;202005;1897;4994;1534;4568;37;148;1219;3592;1256;3740
251430;202005;1513;4644;1359;4376;28;128;1175;3785;1203;3913
251440;202005;1096;3075;883;2677;35;97;702;2139;737;2236
251445;202005;1526;4271;1403;4100;36;121;1183;3407;1219;3528
251450;202005;4491;13089;3975;12317;85;337;3303;10141;3388;10478
251455;202005;846;2572;769;2439;22;100;608;1883;630;1983
251460;202005;879;2542;769;2371;17;56;631;1959;648;2015
251465;202005;449;1305;384;1186;6;22;287;865;293;887
251470;202005;1178;3245;880;2621;71;228;510;1449;581;1677
251480;202005;987;2604;802;2270;19;80;619;1666;638;1746
251490;202005;1878;4937;1485;4388;55;176;1105;3267;1160;3443
251500;202005;1926;5422;1765;5210;27;102;1606;4740;1633;4842
251510;202005;2646;7906;2184;6977;106;397;1483;4625;1589;5022
251520;202005;962;2534;729;2102;63;180;475;1334;538;1514
251530;202005;14645;35102;11741;31475;102;570;10390;27357;10492;27927
251540;202005;2953;8447;2661;7900;79;283;2210;6462;2289;6745
251550;202005;3760;8868;3004;7923;102;206;2505;6660;2607;6866
251560;202005;541;1641;473;1534;59;208;326;1022;385;1230
251570;202005;941;2641;763;2288;19;87;606;1761;625;1848
251580;202005;1882;4451;1677;4151;36;152;1465;3481;1501;3633
251590;202005;1567;3887;1315;3591;51;141;1096;2942;1147;3083
251593;202005;897;2612;800;2456;83;262;519;1567;602;1829
251597;202005;2100;5879;1888;5600;20;101;1680;4918;1700;5019
251600;202005;6396;17227;5588;15985;164;532;4626;13036;4790;13568
251610;202005;3215;9128;2751;8260;249;691;1909;5833;2158;6524
251615;202005;1228;3072;991;2712;23;62;797;2123;820;2185
251620;202005;18863;43545;14524;38220;108;368;12418;33170;12526;33538
251630;202005;4696;11047;3771;9763;193;511;2838;7287;3031;7798
251640;202005;2144;5825;1896;5435;27;131;1646;4605;1673;4736
251650;202005;3912;10545;3420;9888;120;395;2915;8401;3035;8796
251660;202005;3454;10344;3030;9592;70;330;2537;7893;2607;8223
251670;202005;3957;11236;3525;10618;49;249;3141;9368;3190;9617
251675;202005;640;1834;578;1758;76;231;382;1177;458;1408
251680;202005;2501;6621;2080;6076;44;145;1678;4945;1722;5090
251690;202005;3101;8684;2611;7828;89;270;1953;5799;2042;6069
251700;202005;2069;5887;1736;5468;42;194;1476;4567;1518;4761
251710;202005;786;2038;533;1520;39;134;312;859;351;993
251720;202005;1298;3668;1043;3222;23;103;800;2398;823;2501
251740;202005;612;1712;490;1481;43;154;327;951;370;1105
260005;202005;29618;62456;24315;55642;1598;3608;18795;42216;20393;45824
260010;202005;10206;26741;8403;23807;453;1376;5016;14261;5469;15637
260020;202005;6754;15890;5749;14447;108;493;4857;11987;4965;12480
260030;202005;6747;17287;5684;15750;134;409;4618;12742;4752;13151
260040;202005;7556;19631;6296;17786;438;1207;4426;12727;4864;13934
260050;202005;13848;35956;11447;33295;148;674;10529;30622;10677;31296
260060;202005;3973;9949;3407;9031;186;460;2697;7148;2883;7608
260070;202005;10478;26331;8947;24119;328;1145;7231;18975;7559;20120
260080;202005;6500;14792;5670;13691;110;360;4777;11317;4887;11677
260090;202005;4637;11944;4105;11214;456;1273;2906;7943;3362;9216
260100;202005;3004;8095;2506;7358;53;267;2063;5950;2116;6217
260105;202005;4995;13626;4462;12913;124;441;3759;10738;3883;11179
260110;202005;22149;61202;19661;57584;924;3167;16206;46802;17130;49969
260120;202005;14331;38181;11998;34673;1419;4047;7675;22532;9094;26579
260130;202005;3070;7899;2740;7411;247;661;1996;5328;2243;5989
260140;202005;12928;29280;11123;27121;533;1463;9340;22432;9873;23895
260150;202005;3595;8304;3078;7666;85;249;2704;6667;2789;6916
260160;202005;6450;16905;5447;15681;86;319;4903;14258;4989;14577
260170;202005;19990;47352;16920;43159;883;2282;13531;34088;14414;36370
260180;202005;3473;9251;3002;8610;74;269;2580;7294;2654;7563
260190;202005;18141;36426;15229;32991;160;435;13514;28715;13674;29150
260200;202005;11111;26562;9533;24552;432;982;7962;20798;8394;21780
260210;202005;11805;33308;9975;30303;321;1221;7941;23963;8262;25184
260220;202005;10230;24720;9444;23720;166;552;8318;20589;8484;21141
260230;202005;10696;26208;9313;24365;193;636;7855;20188;8048;20824
260240;202005;2658;7972;2322;7326;107;373;1798;5621;1905;5994
260250;202005;2177;5734;1890;5285;118;269;1444;4037;1562;4306
260260;202005;12996;33669;11553;31443;365;1217;9178;24479;9543;25696
260270;202005;4244;10208;3725;9580;135;496;3117;7852;3252;8348
260280;202005;12661;38151;11337;36272;439;1918;9654;30439;10093;32357
260290;202005;40207;101756;34514;93489;3696;10225;23443;63265;27139;73490
260300;202005;9557;25816;8285;24084;191;865;6970;20199;7161;21064
260310;202005;5048;13004;4435;12213;296;774;3443;9612;3739;10386
260320;202005;7633;21938;6430;19884;255;812;5235;16191;5490;17003
260330;202005;2542;7780;2221;7126;68;255;1760;5501;1828;5756
260340;202005;2029;5417;1747;4993;28;128;1497;4186;1525;4314
260345;202005;24827;64447;20673;58369;3035;9169;11000;30545;14035;39714
260350;202005;5483;12985;4756;12139;67;196;4217;10715;4284;10911
260360;202005;2512;6531;2263;6075;45;194;1589;4155;1634;4349
260370;202005;5530;15814;4751;14499;231;807;3668;11105;3899;11912
260380;202005;4926;14563;4198;13368;145;531;3152;9906;3297;10437
260390;202005;4459;13327;3696;11756;210;661;2487;7764;2697;8425
260392;202005;3312;10656;2970;10219;116;694;2394;8233;2510;8927
260400;202005;18005;41604;15516;38329;469;1347;12236;29082;12705;30429
260410;202005;72734;176467;56149;153121;9884;28272;25268;71057;35152;99329
260415;202005;4487;12101;3874;11078;61;256;3170;8927;3231;9183
260420;202005;12685;26302;10735;24134;99;281;9953;22167;10052;22448
260430;202005;2703;8446;2323;7690;99;396;1667;5462;1766;5858
260440;202005;3699;9620;3261;8939;66;242;2738;7370;2804;7612
260450;202005;5719;14391;5113;13615;292;601;4212;11431;4504;12032
260460;202005;5190;15418;4412;14039;473;1673;2636;8246;3109;9919
260470;202005;4908;12935;4138;12036;80;195;3791;11192;3871;11387
260480;202005;3960;10537;3318;9612;210;765;2308;6683;2518;7448
260490;202005;5322;12223;4705;11314;34;141;4281;10111;4315;10252
260500;202005;6096;15281;5209;14032;456;1166;3654;9984;4110;11150
260510;202005;9665;23906;8070;21677;117;464;7119;18942;7236;19406
260515;202005;4139;11343;3217;9584;141;425;2165;6283;2306;6708
260520;202005;17087;39445;14892;36623;756;1836;12134;29451;12890;31287
260530;202005;9722;27785;8267;25534;148;710;7086;21583;7234;22293
260540;202005;7174;15518;6316;14428;151;350;5666;12860;5817;13210
260545;202005;52;160;22;81;2;7;8;23;10;30
260550;202005;3032;8389;2483;7487;113;466;1672;4921;1785;5387
260560;202005;5877;15056;4956;13732;121;477;4174;11329;4295;11806
260570;202005;7708;20906;6766;19624;374;1185;5327;15503;5701;16688
260580;202005;4447;10551;3997;9955;19;72;3677;9133;3696;9205
260590;202005;6680;15489;5603;14283;225;541;4661;12042;4886;12583
260600;202005;30700;79383;24848;70353;1097;3450;18771;52262;19868;55712
260610;202005;7254;18635;6479;17631;391;1139;4870;13171;5261;14310
260620;202005;16248;42079;14140;39030;1246;3889;10266;27751;11512;31640
260630;202005;2374;6402;1937;5702;35;148;1560;4490;1595;4638
260640;202005;21443;48467;17912;44405;843;2073;14378;35472;15221;37545
260650;202005;5982;15714;4747;14201;146;587;4069;12078;4215;12665
260660;202005;7015;18512;6048;17218;155;679;5175;14399;5330;15078
260670;202005;2201;5756;1848;5217;77;193;1357;3775;1434;3968
260680;202005;28257;67131;23714;60636;1656;4503;16775;42052;18431;46555
260690;202005;3498;9048;2908;8132;89;346;2284;6333;2373;6679
260700;202005;6080;17525;5679;17063;20;69;5495;16633;5515;16702
260710;202005;1342;3538;1157;3276;32;127;908;2566;940;2693
260720;202005;23169;57829;19963;53510;1911;5264;14498;38555;16409;43819
260730;202005;7542;21784;6580;20434;259;993;5474;16725;5733;17718
260740;202005;1329;3763;1117;3416;12;64;879;2752;891;2816
260750;202005;7028;19333;5851;17854;120;383;5220;16188;5340;16571
260760;202005;5667;13382;4860;12423;184;525;3994;10235;4178;10760
260765;202005;8015;23027;6958;21567;398;1671;4940;14968;5338;16639
260770;202005;3816;9716;3171;8652;112;362;2496;6719;2608;7081
260775;202005;5214;13837;4571;12856;184;685;3562;9672;3746;10357
260780;202005;3605;10669;3206;10026;275;1035;2067;6243;2342;7278
260790;202005;118990;265651;98155;238400;14854;34958;60683;147884;75537;182842
260795;202005;2979;7633;2549;7068;78;265;1992;5565;2070;5830
260800;202005;5380;12411;4786;11590;123;387;4197;9840;4320;10227
260805;202005;3612;10214;3036;9190;161;569;2269;6748;2430;7317
260810;202005;6479;17531;5671;15974;458;1228;4098;11306;4556;12534
260820;202005;4539;10457;4010;9830;99;355;3375;8122;3474;8477
260825;202005;2901;8640;2518;7973;105;380;1883;5882;1988;6262
260830;202005;4214;12220;3492;10899;450;1232;2235;7199;2685;8431
260840;202005;4156;10826;3702;10197;202;522;3075;8497;3277;9019
260845;202005;4302;11372;3825;10553;225;630;2870;7818;3095;8448
260850;202005;5040;13792;4180;12128;337;1054;2709;7602;3046;8656
260860;202005;3500;9835;2953;8895;101;359;2353;6904;2454;7263
260870;202005;4542;10888;3867;10059;69;260;3447;8841;3516;9101
260875;202005;7042;17298;5765;15427;561;1511;3898;10516;4459;12027
260880;202005;9717;27178;8404;24895;483;1460;6582;19464;7065;20924
260890;202005;13012;33348;11258;30660;593;1733;8228;21863;8821;23596
260900;202005;5389;14938;4417;13553;312;1021;2933;8981;3245;10002
260910;202005;3211;8665;2771;7996;93;307;2183;6250;2276;6557
260915;202005;5177;15097;4521;14330;50;261;4135;13108;4185;13369
260920;202005;3287;8107;2751;7527;90;234;2354;6505;2444;6739
260930;202005;3724;11674;3158;10658;175;713;2337;7697;2512;8410
260940;202005;14584;34705;12679;32051;959;2388;9570;23840;10529;26228
260950;202005;6833;18250;5493;15928;358;1210;3531;9809;3889;11019
260960;202005;69768;155505;55822;137512;6098;15463;35543;86447;41641;101910
260970;202005;5517;14510;4907;13680;232;532;3741;10549;3973;11081
260980;202005;4508;13120;3967;12438;52;193;3617;11442;3669;11635
260990;202005;17839;49279;15044;45466;842;2844;11686;34973;12528;37817
261000;202005;16182;37994;13558;34653;367;1322;10952;27305;11319;28627
261010;202005;2387;6211;2082;5810;75;196;1807;5067;1882;5263
261020;202005;6128;16573;5247;15049;187;697;4252;11716;4439;12413
261030;202005;4030;11594;3481;10651;125;515;2763;8213;2888;8728
261040;202005;5210;15186;4190;13237;149;605;3127;9636;3276;10241
261050;202005;7743;20158;7029;19034;436;868;5357;14614;5793;15482
261060;202005;14121;35240;12255;32971;269;879;10207;27199;10476;28078
261070;202005;64346;139669;53215;124967;2743;6401;40771;93628;43514;100029
261080;202005;6668;15967;6078;15224;131;329;5595;13995;5726;14324
261090;202005;19075;45026;16937;42265;286;969;14835;36412;15121;37381
261100;202005;8351;23044;7224;21368;500;1591;5262;15569;5762;17160
261110;202005;64549;179704;53836;160434;7716;24216;31200;92106;38916;116322
261120;202005;3693;9218;3178;8517;85;219;2738;7351;2823;7570
261130;202005;7302;17783;6401;16565;116;353;5666;14560;5782;14913
261140;202005;3643;8388;3238;7845;166;429;2593;6182;2759;6611
261150;202005;5313;13823;4688;12878;71;268;4075;11066;4146;11334
261153;202005;1877;5658;1596;5110;56;201;1084;3486;1140;3687
261160;202005;209449;485516;168788;428901;40954;107318;69987;180962;110941;288280
261170;202005;6016;14965;5339;13949;314;752;4260;11069;4574;11821
261180;202005;9541;23668;8329;22064;443;1157;6071;16134;6514;17291
261190;202005;4568;13338;4070;12500;186;794;3187;9485;3373;10279
261200;202005;3365;7748;2998;7253;129;335;2526;5998;2655;6333
261210;202005;1905;4574;1612;4160;61;178;1358;3442;1419;3620
261220;202005;13755;38755;11380;34350;1415;4644;6487;19255;7902;23899
261230;202005;4023;11506;3363;10586;52;211;2802;8892;2854;9103
261240;202005;5332;13317;4664;12265;246;654;3843;9957;4089;10611
261245;202005;3562;10095;2993;9086;72;345;2380;7002;2452;7347
261247;202005;2870;8591;2374;7704;142;509;1633;5267;1775;5776
261250;202005;22387;50960;19375;47436;1720;3781;14733;36989;16453;40770
261255;202005;4070;11959;3291;10438;138;621;2417;7415;2555;8036
261260;202005;12657;34107;10912;31831;347;1419;9360;26923;9707;28342
261270;202005;4412;10865;3856;10149;185;526;3203;8297;3388;8823
261280;202005;2580;7121;2263;6580;66;239;1806;5103;1872;5342
261290;202005;2967;7608;2481;7051;68;279;2010;5748;2078;6027
261300;202005;12319;34334;10388;31018;578;2070;7534;22005;8112;24075
261310;202005;8784;22283;7471;20485;628;1940;5483;14662;6111;16602
261320;202005;5938;16776;5171;15510;80;354;4346;12838;4426;13192
261330;202005;5847;14255;5253;13478;122;439;4570;11495;4692;11934
261340;202005;4232;11824;3646;11066;134;501;3011;9044;3145;9545
261350;202005;8780;25483;7778;23809;122;571;6333;19101;6455;19672
261360;202005;8163;19634;6894;17837;236;682;5491;13830;5727;14512
261370;202005;23433;58481;19674;53247;2087;5580;12736;34707;14823;40287
261380;202005;4053;12226;3561;11358;448;1509;2329;7319;2777;8828
261390;202005;16425;46573;13786;42278;1168;3920;9174;27910;10342;31830
261400;202005;4596;14572;3980;13245;163;731;2988;9691;3151;10422
261410;202005;9513;23671;7803;21022;467;1329;6113;16100;6580;17429
261420;202005;7367;21971;6623;21050;778;2855;4655;14704;5433;17559
261430;202005;3420;9618;2867;8747;61;268;2381;7152;2442;7420
261440;202005;1471;4365;1223;3879;36;177;877;2649;913;2826
261450;202005;14946;40259;13182;37510;188;689;10917;31112;11105;31801
261460;202005;7482;20661;6612;19287;203;730;5374;15540;5577;16270
261470;202005;4186;10351;3643;9635;24;125;3142;8289;3166;8414
261480;202005;5034;15415;4324;14218;188;781;3355;10789;3543;11570
261485;202005;4940;14023;4249;12939;338;1115;3031;9079;3369;10194
261500;202005;5883;15019;5146;14016;379;921;3603;10184;3982;11105
261510;202005;1891;5626;1638;5205;64;242;1234;3947;1298;4189
261520;202005;2337;7179;2098;6682;68;245;1534;4866;1602;5111
261530;202005;11888;34751;9617;30558;901;3430;4875;14897;5776;18327
261540;202005;8147;23242;7312;22033;1061;3165;4165;13226;5226;16391
261550;202005;3654;9681;3152;8887;222;678;2260;6239;2482;6917
261560;202005;7807;23102;6744;21516;280;1071;5192;16570;5472;17641
261570;202005;3532;9406;2821;8270;196;688;1948;5592;2144;6280
261580;202005;6695;17556;5760;16286;110;532;5151;14346;5261;14878
261590;202005;2703;6880;2164;6118;69;225;1647;4615;1716;4840
261600;202005;5116;12881;4287;11630;301;736;2999;8372;3300;9108
261610;202005;2199;6192;1762;5399;94;348;1203;3644;1297;3992
261618;202005;2526;6277;2199;5796;59;173;1783;4659;1842;4832
261620;202005;4172;11673;3806;11141;837;2172;2364;7305;3201;9477
261630;202005;6317;17675;5341;15825;364;1291;3584;10183;3948;11474
261640;202005;37352;83503;31705;76493;1806;3484;23949;59509;25755;62993
261650;202005;4123;10188;3506;9366;148;473;2638;6982;2786;7455
270010;202005;4292;14355;3684;13307;166;939;2917;10234;3083;11173
270020;202005;3866;9662;3368;9017;128;442;2881;7532;3009;7974
270030;202005;33287;90017;27634;80920;3593;10253;18318;53791;21911;64044
270040;202005;10804;28985;9251;27148;363;1378;7671;22300;8034;23678
270050;202005;5517;12753;4694;11823;208;511;4115;10402;4323;10913
270060;202005;2137;5346;1776;4938;149;365;1412;3984;1561;4349
270070;202005;4662;13044;4051;12182;137;511;3395;10027;3532;10538
270080;202005;1432;3887;1191;3482;42;129;917;2577;959;2706
270090;202005;1758;5366;1573;5005;67;279;1286;3985;1353;4264
270100;202005;5464;14403;4702;13282;147;572;3917;10850;4064;11422
270110;202005;3232;7559;2601;6822;138;337;2070;5654;2208;5991
270120;202005;2766;7498;2387;6992;69;306;2015;5796;2084;6102
270130;202005;5086;13027;4392;12199;122;390;3788;10537;3910;10927
270135;202005;2029;4825;1713;4474;50;161;1548;4023;1598;4184
270140;202005;9663;22410;7715;19718;309;1070;6096;14846;6405;15916
270150;202005;2699;8079;2466;7744;4;27;2325;7274;2329;7301
270160;202005;6171;16687;5213;15607;59;325;4827;14420;4886;14745
270170;202005;3371;9836;2835;9084;179;856;2152;6595;2331;7451
270180;202005;2219;6865;2018;6605;40;197;1815;5894;1855;6091
270190;202005;1637;4866;1445;4626;36;185;1263;4008;1299;4193
270200;202005;2393;7235;2076;6806;111;423;1525;4962;1636;5385
270210;202005;5725;13457;4870;12500;76;317;4473;11298;4549;11615
270220;202005;1511;3938;1199;3495;199;607;698;1996;897;2603
270230;202005;9236;25633;7593;23081;633;2143;5401;16230;6034;18373
270235;202005;5647;17350;4860;16088;115;525;4007;13122;4122;13647
270240;202005;10510;28888;8445;25990;912;3061;5907;18193;6819;21254
270250;202005;2709;6868;2365;6370;184;481;1859;5011;2043;5492
270255;202005;4436;12665;3430;10814;109;450;2619;8125;2728;8575
270260;202005;5578;16369;5048;15493;99;506;4419;13242;4518;13748
270270;202005;1042;2685;858;2457;100;299;630;1782;730;2081
270280;202005;3949;9361;3115;8314;482;788;2173;6260;2655;7048
270290;202005;7411;23565;6625;22252;182;865;5739;19062;5921;19927
270300;202005;4137;10720;3207;9718;146;400;2505;7769;2651;8169
270310;202005;6917;19344;5925;17810;100;535;5046;14771;5146;15306
270320;202005;5534;16178;4804;14768;436;1387;3390;10160;3826;11547
270330;202005;3836;12547;3403;11885;259;1048;2603;9047;2862;10095
270340;202005;1603;4332;1384;4040;46;149;1172;3369;1218;3518
270350;202005;1893;4438;1554;4034;143;409;1102;2867;1245;3276
270360;202005;2584;6484;2298;6161;69;161;2114;5692;2183;5853
270370;202005;1357;4235;1235;4004;36;173;1029;3282;1065;3455
270375;202005;3109;7235;2573;6646;18;51;2415;6260;2433;6311
270380;202005;5422;15322;4553;14187;616;1872;2954;9559;3570;11431
270390;202005;1202;3018;978;2760;23;93;803;2263;826;2356
270400;202005;6202;16309;5190;14767;238;690;4045;11409;4283;12099
270410;202005;4594;13200;3957;12209;151;537;3283;10084;3434;10621
270420;202005;5493;16243;4928;15416;125;606;4269;13094;4394;13700
270430;202005;133391;316389;104610;279515;20772;57753;49779;135114;70551;192867
270440;202005;4707;12688;4048;11875;88;384;3518;10177;3606;10561
270450;202005;6943;18675;6084;17640;249;867;5102;14868;5351;15735
270460;202005;3802;8378;3264;7740;155;318;2927;6959;3082;7277
270470;202005;11000;30629;9520;28507;648;2150;7322;21888;7970;24038
270480;202005;2944;7814;2478;7137;94;374;2021;5686;2115;6060
270490;202005;953;2613;824;2456;47;153;661;1950;708;2103
270500;202005;4868;14862;4300;13918;283;1056;3350;10699;3633;11755
270510;202005;5563;14707;4681;13585;333;1329;3497;9658;3830;10987
270520;202005;3876;11067;3041;9624;631;2075;1264;4136;1895;6211
270530;202005;1254;3571;1067;3288;52;153;760;2374;812;2527
270540;202005;2210;6356;1899;5955;59;275;1645;5059;1704;5334
270550;202005;6669;17146;5293;15641;573;1375;3976;12210;4549;13585
270560;202005;2945;7668;2533;7115;132;426;2041;5677;2173;6103
270570;202005;4079;11404;3439;10452;114;374;2803;8463;2917;8837
270580;202005;2257;6380;2045;6069;93;279;1771;5211;1864;5490
270590;202005;1596;4791;1469;4626;16;81;1384;4329;1400;4410
270600;202005;2756;8436;2492;8042;47;244;2211;7045;2258;7289
270610;202005;3621;9480;3116;8813;68;261;2792;7814;2860;8075
270620;202005;1211;3711;1101;3492;35;153;938;2881;973;3034
270630;202005;17446;42477;14938;39016;566;1817;12580;32126;13146;33943
270640;202005;5355;15403;4619;14216;160;666;3756;11314;3916;11980
270642;202005;2515;8046;2222;7566;158;684;1702;5659;1860;6343
270644;202005;3590;8937;2936;8082;275;675;2198;6213;2473;6888
270650;202005;3124;9162;2733;8604;357;1213;1932;6023;2289;7236
270660;202005;2020;5108;1675;4611;79;299;1257;3404;1336;3703
270670;202005;16236;37206;13410;33726;399;1210;11398;28039;11797;29249
270680;202005;5435;13018;4826;12351;117;167;4509;11701;4626;11868
270690;202005;9001;22084;7483;20187;513;1350;5865;15815;6378;17165
270700;202005;511;1532;446;1422;31;126;322;1007;353;1133
270710;202005;5428;16353;4796;15379;222;960;3858;12131;4080;13091
270720;202005;3544;10432;3121;9717;65;350;2740;8363;2805;8713
270730;202005;8109;17921;7065;16800;233;474;5565;14647;5798;15121
270740;202005;2379;6202;2094;5866;91;311;1741;4800;1832;5111
270750;202005;5692;14950;4972;14029;83;385;4417;12388;4500;12773
270760;202005;3258;9175;2816;8578;51;264;2390;7186;2441;7450
270770;202005;20449;49786;16241;44663;2514;6243;10215;29640;12729;35883
270780;202005;1767;4957;1625;4751;83;304;1372;3942;1455;4246
270790;202005;1568;4364;1304;3993;99;321;944;2875;1043;3196
270800;202005;10674;29334;9548;27732;334;1228;8192;23411;8526;24639
270810;202005;3299;9404;2597;8208;168;653;1823;5654;1991;6307
270820;202005;1639;4906;1379;4485;54;261;1082;3425;1136;3686
270830;202005;5169;12273;4163;11041;165;545;3381;8818;3546;9363
270840;202005;8189;24338;7283;23053;174;961;6372;19656;6546;20617
270850;202005;9008;21331;7949;20058;639;1855;6566;16264;7205;18119
270860;202005;14146;31413;11169;28000;589;1386;9036;22612;9625;23998
270870;202005;2136;6018;1761;5409;228;679;1159;3643;1387;4322
270880;202005;8068;24083;7169;22723;221;941;5929;18454;6150;19395
270890;202005;2771;7507;2323;6865;175;544;1626;4792;1801;5336
270895;202005;3058;9430;2771;9052;72;396;2444;7821;2516;8217
270900;202005;1782;4585;1339;3869;36;101;1042;2989;1078;3090
270910;202005;3871;11174;3315;10295;92;319;2699;8290;2791;8609
270915;202005;9295;26676;7511;23731;645;2388;5131;15820;5776;18208
270920;202005;5028;15743;4537;14890;163;795;3721;11811;3884;12606
270930;202005;17109;39742;13224;35217;1852;4501;8914;24845;10766;29346
270940;202005;6498;17051;5516;15873;184;882;4492;12544;4676;13426
280010;202005;683;1887;531;1553;15;59;374;982;389;1041
280020;202005;4818;12172;4090;11023;480;1192;2756;7530;3236;8722
280030;202005;74012;173922;58070;151224;12222;32150;25915;70344;38137;102494
280040;202005;2898;8118;2517;7520;245;777;1696;5011;1941;5788
280050;202005;3821;10855;3272;9977;545;1736;1944;5911;2489;7647
280060;202005;5850;15347;4654;13489;878;2677;2176;6556;3054;9233
280067;202005;6873;16952;5833;15386;315;841;4281;11130;4596;11971
280070;202005;1921;5642;1783;5422;127;394;1469;4438;1596;4832
280100;202005;3994;10605;3356;9586;312;925;2301;6569;2613;7494
280110;202005;1379;3733;1199;3465;17;85;1054;2966;1071;3051
280120;202005;7578;21793;6742;20446;742;2094;4923;15288;5665;17382
280130;202005;9183;21355;8025;19697;414;1111;6502;15788;6916;16899
280140;202005;5409;12934;4751;12060;196;583;4042;10139;4238;10722
280150;202005;4197;10535;3629;9755;328;826;2788;7516;3116;8342
280160;202005;1218;3455;1015;3114;91;313;701;2092;792;2405
280170;202005;5180;13634;4625;12898;229;633;3734;10420;3963;11053
280190;202005;1287;2807;1116;2582;57;142;912;2062;969;2204
280200;202005;1266;3299;1037;2972;76;276;767;2150;843;2426
280210;202005;16461;41128;14276;37993;1499;4145;9194;24434;10693;28579
280220;202005;1745;4669;1493;4328;46;218;1231;3527;1277;3745
280230;202005;4244;10716;3565;9709;280;664;2544;6976;2824;7640
280240;202005;3306;8813;2954;8269;52;273;2543;6891;2595;7164
280250;202005;878;2159;710;1904;69;205;470;1218;539;1423
280260;202005;2187;5266;1942;4967;32;90;1768;4555;1800;4645
280270;202005;2325;6372;2048;5939;115;371;1695;4838;1810;5209
280280;202005;4197;12407;3715;11693;484;1310;2607;8591;3091;9901
280290;202005;18031;47555;15425;43875;1347;4094;10335;29623;11682;33717
280300;202005;11725;28529;10197;26882;284;834;7670;22057;7954;22891
280310;202005;1390;3554;1145;3136;35;123;866;2298;901;2421
280320;202005;8589;23140;7444;21417;893;2586;4992;14217;5885;16803
280330;202005;4620;11433;3908;10442;259;721;2879;7637;3138;8358
280340;202005;5455;11408;4552;10430;214;373;3957;9242;4171;9615
280350;202005;25728;60292;22498;56014;1107;2974;17693;43291;18800;46265
280360;202005;5767;15820;5009;14559;751;2215;2934;8656;3685;10871
280370;202005;2115;5240;1765;4660;56;161;1404;3637;1460;3798
280380;202005;978;2614;836;2419;74;213;572;1681;646;1894
280390;202005;3660;9003;3049;8033;134;352;2444;6377;2578;6729
280400;202005;3906;9845;3364;9083;514;1233;2051;5848;2565;7081
280410;202005;2235;6170;1800;5461;196;613;1040;3094;1236;3707
280420;202005;4298;11447;3940;10989;73;284;3615;10018;3688;10302
280430;202005;2064;4997;1798;4646;68;258;1457;3644;1525;3902
280440;202005;4210;11260;3677;10476;143;487;3091;8614;3234;9101
280445;202005;2299;5831;2044;5391;47;150;1549;3911;1596;4061
280450;202005;10282;23672;8919;21815;981;2013;6097;15518;7078;17531
280460;202005;6885;16285;6222;15355;333;804;5308;12944;5641;13748
280470;202005;1683;4754;1445;4327;62;219;1072;3125;1134;3344
280480;202005;42387;102966;36474;94525;2946;8265;25932;65754;28878;74019
280490;202005;3679;10439;3168;9553;90;393;2454;7156;2544;7549
280500;202005;994;2385;852;2194;37;130;709;1785;746;1915
280510;202005;2534;6425;2191;5933;71;270;1714;4515;1785;4785
280520;202005;1603;4075;1400;3794;58;161;1126;3008;1184;3169
280530;202005;2440;6092;2095;5609;289;647;1465;4049;1754;4696
280540;202005;8940;23909;8113;22710;261;901;7096;19575;7357;20476
280550;202005;6598;15360;5404;13668;184;665;4439;10823;4623;11488
280560;202005;7119;19847;6644;19128;130;512;5856;16650;5986;17162
280570;202005;6445;15624;5222;14073;209;662;3935;10522;4144;11184
280580;202005;5561;14863;4796;13712;567;1467;3356;9773;3923;11240
280590;202005;2923;6558;2486;6059;108;410;1967;4599;2075;5009
280600;202005;3570;9429;3137;8819;168;535;2251;6330;2419;6865
280610;202005;2449;6011;2203;5642;139;356;1812;4607;1951;4963
280620;202005;5392;13199;4616;12176;406;892;3239;8907;3645;9799
280630;202005;3782;10628;3453;10162;165;606;2838;8248;3003;8854
280640;202005;2361;6330;2079;6005;56;181;1847;5331;1903;5512
280650;202005;1185;3103;951;2747;85;292;707;1951;792;2243
280660;202005;3703;8095;3162;7452;209;391;2629;6315;2838;6706
280670;202005;19675;44174;16922;40670;912;2299;13513;32231;14425;34530
280680;202005;2789;6648;2382;6075;226;419;1717;4457;1943;4876
280690;202005;958;2341;810;2145;51;117;632;1657;683;1774
280700;202005;1166;2921;1007;2682;27;102;796;2082;823;2184
280710;202005;15272;34276;12876;31555;511;963;10911;27464;11422;28427
280720;202005;2648;6022;2197;5492;58;181;1595;4134;1653;4315
280730;202005;1055;2709;945;2526;42;135;728;1875;770;2010
280740;202005;14072;34261;11940;31010;720;2041;8605;21772;9325;23813
280750;202005;3580;9996;3109;9188;176;605;2235;6466;2411;7071
280760;202005;6329;16856;5492;15550;559;1439;3675;10747;4234;12186
290010;202005;3172;6646;2064;4918;4;13;1692;3854;1696;3867
290020;202005;5376;14264;4860;13598;336;642;4088;11848;4424;12490
290030;202005;4513;10361;3625;9382;165;393;3074;8041;3239;8434
290035;202005;5112;11151;4227;10000;367;559;3341;8269;3708;8828
290040;202005;4172;10222;3545;9459;108;295;2809;7854;2917;8149
290050;202005;2021;6509;1696;5803;116;476;1133;3775;1249;4251
290060;202005;1321;3175;968;2615;76;241;632;1681;708;1922
290070;202005;37348;81283;31990;74596;1771;4318;24881;57374;26652;61692
290080;202005;5308;15497;4541;14343;455;1556;3178;10120;3633;11676
290090;202005;2156;4130;1514;3445;18;61;1381;3109;1399;3170
290100;202005;9789;25494;7895;22630;1292;3470;4270;12860;5562;16330
290110;202005;5224;13722;4622;12778;327;929;3338;9129;3665;10058
290115;202005;3930;11346;3296;10205;221;753;2446;7508;2667;8261
290120;202005;6492;15982;5462;14558;134;461;4678;12247;4812;12708
290130;202005;4725;11415;3673;10049;161;470;2853;7778;3014;8248
290135;202005;4206;9891;3424;8607;192;488;2651;6488;2843;6976
290140;202005;4545;11868;3469;10423;100;371;2908;8687;3008;9058
290150;202005;2467;6340;2117;5902;138;379;1635;4590;1773;4969
290160;202005;3352;7651;2954;7100;285;592;2308;5583;2593;6175
290170;202005;3387;8510;2982;8065;111;306;2659;7255;2770;7561
290180;202005;2965;8120;2443;7256;82;295;1988;5857;2070;6152
290190;202005;4251;11835;3716;11111;143;574;3059;9017;3202;9591
290195;202005;2355;5809;1875;5175;27;136;1585;4333;1612;4469
290200;202005;4100;11375;3325;10083;186;623;2502;7510;2688;8133
290205;202005;3433;8845;3009;8201;123;435;2349;6178;2472;6613
290210;202005;12977;36053;11466;33752;875;2354;8821;26413;9696;28767
290220;202005;2850;7081;2496;6623;120;334;2042;5396;2162;5730
290225;202005;3235;6884;2484;6088;159;281;2064;5167;2223;5448
290230;202005;2443;6440;2220;6172;30;94;1999;5551;2029;5645
290240;202005;3724;9360;2955;8374;70;252;2489;7042;2559;7294
290250;202005;3934;11455;3280;10480;105;358;2710;8773;2815;9131
290260;202005;5393;13206;4464;11854;161;548;3710;9604;3871;10152
290265;202005;3495;10122;2821;8817;194;631;2015;6263;2209;6894
290270;202005;11070;37445;10323;36160;526;2305;8311;28818;8837;31123
290280;202005;6048;18040;5233;16429;290;1040;3780;11691;4070;12731
290290;202005;9917;28733;7986;25166;789;2700;5231;16259;6020;18959
290300;202005;4231;11472;3105;9336;158;519;2226;6660;2384;7179
290310;202005;1595;3916;1260;3506;55;230;972;2614;1027;2844
290320;202005;24176;63045;18996;55040;4160;11867;9044;27633;13204;39500
290323;202005;3784;10278;3279;9490;105;333;2591;7467;2696;7800
290327;202005;4092;11911;3474;10697;244;703;2483;7615;2727;8318
290330;202005;2205;4627;1709;4092;47;85;1514;3684;1561;3769
290340;202005;5716;14261;4390;12621;436;1301;3165;9233;3601;10534
290350;202005;4702;13011;3875;11608;271;832;2780;8372;3051;9204
290360;202005;5033;13204;4409;12384;130;367;3800;10763;3930;11130
290370;202005;5235;12748;3832;10891;155;407;2771;8040;2926;8447
290380;202005;5572;14822;4682;13606;113;272;4023;11918;4136;12190
290390;202005;14575;41213;12046;37221;1290;3925;7850;24662;9140;28587
290395;202005;2826;8172;2265;7190;65;306;1736;5410;1801;5716
290400;202005;3768;10090;3010;8843;81;348;2303;6578;2384;6926
290405;202005;4623;13453;3936;12259;294;954;2705;8599;2999;9553
290410;202005;5739;15550;4386;13360;106;497;3314;9821;3420;10318
290420;202005;2978;8311;2460;7492;70;251;1895;5726;1965;5977
290430;202005;3149;8621;2579;7735;223;703;1745;5160;1968;5863
290440;202005;2872;7099;2049;5797;46;126;1430;4127;1476;4253
290450;202005;3457;8837;2695;7679;140;400;1984;5715;2124;6115
290460;202005;11652;32742;9755;29129;1948;5917;4383;13048;6331;18965
290470;202005;4568;11218;3346;9517;390;1220;1894;5469;2284;6689
290475;202005;6469;18761;5438;16924;98;535;4426;13468;4524;14003
290480;202005;1793;4528;1464;4040;82;279;1011;2660;1093;2939
290485;202005;4508;13139;3976;12393;101;522;3400;10410;3501;10932
290490;202005;9255;21621;8253;20255;501;1115;6451;16083;6952;17198
290500;202005;4020;12017;3080;9973;542;1832;1348;4241;1890;6073
290510;202005;3492;8669;2896;7892;74;248;2499;6768;2573;7016
290515;202005;3645;10073;3145;9396;44;132;2824;8590;2868;8722
290520;202005;11550;32770;8880;27602;589;1977;5401;16559;5990;18536
290530;202005;4978;14163;4178;12859;133;505;3523;10800;3656;11305
290540;202005;3380;8872;3008;8442;50;166;2776;7764;2826;7930
290550;202005;4303;11238;3714;10544;10;54;3415;9811;3425;9865
290560;202005;6462;16649;4879;14288;418;1506;3193;9047;3611;10553
290570;202005;44742;109432;39519;102772;2449;6556;31746;82012;34195;88568
290580;202005;7799;22672;6698;21062;598;1846;4903;15788;5501;17634
290590;202005;7087;21741;5966;19732;143;590;4816;15997;4959;16587
290600;202005;18791;52163;16535;48464;679;2098;13317;38943;13996;41041
290610;202005;2550;7965;1978;6790;96;403;1381;4684;1477;5087
290620;202005;6380;17871;5498;16417;198;570;4619;13768;4817;14338
290630;202005;9264;22339;7332;19840;549;1485;5659;15428;6208;16913
290640;202005;2776;7151;2122;6198;82;247;1545;4576;1627;4823
290650;202005;13108;32444;11566;30701;2549;6475;7146;19852;9695;26327
290660;202005;3652;9322;3028;8409;50;140;2289;6564;2339;6704
290670;202005;6750;18593;5676;16810;372;1048;4312;12938;4684;13986
290680;202005;10825;29947;9064;27323;196;1061;7487;22068;7683;23129
290682;202005;4791;12305;4134;11430;125;294;3490;9752;3615;10046
290685;202005;3475;7817;2475;6374;202;483;1526;4205;1728;4688
290687;202005;6632;17803;5360;15711;712;2004;3411;10261;4123;12265
290689;202005;2833;7857;2169;6624;202;676;1483;4493;1685;5169
290690;202005;5557;14353;4484;12832;305;945;3246;9146;3551;10091
290700;202005;2626;7159;2305;6750;71;240;1934;5685;2005;5925
290710;202005;8288;23311;7087;21636;156;625;5978;18275;6134;18900
290720;202005;18467;50348;16752;47738;927;2930;13425;37786;14352;40716
290730;202005;7045;16730;5984;15491;290;599;4735;12440;5025;13039
290740;202005;1025;2772;791;2391;32;109;654;1976;686;2085
290750;202005;11126;27645;9602;25188;636;1796;7112;18111;7748;19907
290755;202005;2100;5898;1677;5122;92;286;1165;3584;1257;3870
290760;202005;3743;10854;3003;9437;185;542;2036;6590;2221;7132
290770;202005;2621;8371;2393;8082;52;261;1999;6811;2051;7072
290780;202005;8234;20281;7096;18780;268;599;5566;15069;5834;15668
290790;202005;4683;12853;4057;11965;157;456;3362;10049;3519;10505
290800;202005;7130;14763;5036;12294;290;683;3740;9200;4030;9883
290810;202005;5404;14132;4316;12527;111;357;3253;9644;3364;10001
290820;202005;4852;13108;4341;12368;182;524;3272;9453;3454;9977
290830;202005;4488;10151;3971;9508;29;81;3497;8271;3526;8352
290840;202005;17045;44973;14603;41189;1894;4385;9403;28185;11297;32570
290850;202005;6674;16002;5964;15237;204;512;5109;13186;5313;13698
290860;202005;6172;17623;5363;16682;217;721;4511;14313;4728;15034
290870;202005;4740;13025;3572;10795;140;449;2531;7591;2671;8040
290880;202005;1381;3451;1101;3083;71;180;763;2225;834;2405
290890;202005;9294;18672;8320;17576;153;332;7805;16417;7958;16749
290900;202005;2357;6155;1785;5157;98;241;1118;3197;1216;3438
290910;202005;5139;12302;3920;10448;48;155;3319;8763;3367;8918
290920;202005;5051;12791;4591;12255;42;93;4330;11679;4372;11772
290930;202005;7657;21302;6108;18589;194;827;4776;14165;4970;14992
290940;202005;3687;10317;3024;9354;160;586;2420;7476;2580;8062
290950;202005;1456;3652;1187;3250;62;177;835;2295;897;2472
290960;202005;5477;14331;4897;13602;181;453;4128;11528;4309;11981
290970;202005;3357;9838;2729;8698;107;393;2094;6672;2201;7065
290980;202005;12157;29082;10149;25983;797;2227;6322;15719;7119;17946
290990;202005;9531;25407;8382;23529;250;1032;7028;19049;7278;20081
291000;202005;3409;8847;2636;7864;108;346;2161;6506;2269;6852
291005;202005;15290;37518;13438;35091;1209;2896;10473;27552;11682;30448
291010;202005;3043;9186;2453;7926;117;430;1609;5066;1726;5496
291020;202005;1248;3085;997;2636;22;74;723;1805;745;1879
291030;202005;2506;6083;1734;4746;110;277;1074;2857;1184;3134
291040;202005;5382;14774;4471;13476;155;610;3513;10545;3668;11155
291050;202005;7665;19931;6528;18355;633;2003;4750;13084;5383;15087
291060;202005;5945;18160;5040;16944;314;1372;3828;12788;4142;14160
291070;202005;15856;42570;13168;38256;420;1479;10743;31019;11163;32498
291072;202005;24741;63295;17686;51086;3226;9631;7508;21955;10734;31586
291075;202005;5408;13307;4837;12422;103;276;4037;10175;4140;10451
291077;202005;1583;4126;1226;3501;53;123;861;2454;914;2577
291080;202005;101339;252254;79322;221307;24022;68583;21964;66111;45986;134694
291085;202005;5630;14179;4725;12786;183;558;3926;10593;4109;11151
291090;202005;2011;3789;1446;3155;45;102;1166;2500;1211;2602
291100;202005;3223;7008;2208;5795;101;274;1684;4381;1785;4655
291110;202005;5944;17600;5019;16011;316;1300;3806;11694;4122;12994
291120;202005;7590;18472;6378;16923;301;867;4913;13001;5214;13868
291125;202005;2181;3831;1635;3225;99;149;1317;2659;1416;2808
291130;202005;3252;9198;2383;7479;64;290;1771;5378;1835;5668
291140;202005;4872;13104;3542;10674;449;1179;2186;6628;2635;7807
291150;202005;2481;5372;1906;4722;6;22;1796;4440;1802;4462
291160;202005;5123;13927;4218;12623;371;1179;2821;8372;3192;9551
291165;202005;2126;5781;1601;4764;30;131;1173;3379;1203;3510
291170;202005;20973;53070;17443;47038;928;2754;11493;30481;12421;33235
291180;202005;6277;14520;4563;12202;264;685;3512;9398;3776;10083
291185;202005;3086;8282;2695;7644;88;272;2077;5906;2165;6178
291190;202005;7602;18658;6232;16890;293;925;4913;13268;5206;14193
291200;202005;2756;7562;2035;6195;92;291;1249;3667;1341;3958
291210;202005;7015;14999;5233;12949;136;440;3907;9704;4043;10144
291220;202005;4082;11535;3661;10904;184;667;2894;8503;3078;9170
291230;202005;4464;9568;3361;8360;36;97;3027;7601;3063;7698
291240;202005;4221;10765;3616;9757;64;222;3102;8244;3166;8466
291250;202005;3412;10022;2641;8607;157;501;1704;5572;1861;6073
291260;202005;1417;3322;1161;2992;30;99;950;2459;980;2558
291270;202005;5396;13902;4156;12070;632;1832;2583;7674;3215;9506
291280;202005;2585;6324;1919;5345;136;417;1253;3408;1389;3825
291290;202005;5860;15336;4506;13227;334;1064;3106;9034;3440;10098
291300;202005;3841;10321;2961;8872;111;406;2256;6655;2367;7061
291310;202005;5131;13598;4361;12191;116;378;3683;10149;3799;10527
291320;202005;6131;16965;4747;14384;1059;3003;2333;7510;3392;10513
291330;202005;1781;4487;1468;3975;80;214;1096;2934;1176;3148
291340;202005;4280;11064;3451;9615;79;251;2626;7189;2705;7440
291345;202005;2948;8790;2671;8357;111;391;2241;7012;2352;7403
291350;202005;6883;16958;5342;15081;60;198;4635;13319;4695;13517
291360;202005;37610;85578;29337;75592;2731;7201;19214;50556;21945;57757
291370;202005;7993;21748;7044;20283;511;1547;5236;14816;5747;16363
291380;202005;3408;9263;2980;8673;101;414;2476;7153;2577;7567
291390;202005;13205;28289;10206;24961;432;1046;8451;20653;8883;21699
291400;202005;13886;35429;11392;31655;1538;3751;6744;20216;8282;23967
291410;202005;2901;7633;2243;6501;31;138;1662;4730;1693;4868
291420;202005;1903;4703;1471;4166;31;125;1272;3593;1303;3718
291430;202005;2745;7764;2365;7135;82;363;1902;5555;1984;5918
291440;202005;6347;18209;5449;16723;314;1035;4258;13062;4572;14097
291450;202005;9330;22743;7662;20821;73;126;6726;18867;6799;18993
291460;202005;15484;40966;13525;38045;657;2089;10246;28598;10903;30687
291465;202005;9381;22965;7371;20664;138;617;6366;17715;6504;18332
291470;202005;16655;37188;13864;34034;737;1595;10289;26033;11026;27628
291480;202005;41515;91865;30369;76570;3533;9227;16062;40540;19595;49767
291490;202005;5624;13905;4835;13003;141;450;4354;11649;4495;12099
291500;202005;4994;12192;4129;11038;70;308;3751;9973;3821;10281
291510;202005;4302;10593;3189;9191;52;295;2661;7595;2713;7890
291520;202005;4570;10343;3430;8838;178;494;2631;6721;2809;7215
291530;202005;2300;5261;1605;4342;306;757;915;2715;1221;3472
291535;202005;3428;9980;3034;9283;170;470;2337;7307;2507;7777
291540;202005;2299;5091;1573;4214;65;217;1291;3400;1356;3617
291550;202005;5653;12912;4388;11305;384;828;2996;7900;3380;8728
291560;202005;18676;43916;13355;36864;1290;3437;8011;22997;9301;26434
291570;202005;2411;5727;1891;5086;58;158;1546;4324;1604;4482
291580;202005;6294;16212;4955;14409;216;696;3686;10636;3902;11332
291590;202005;2151;5200;1863;4865;72;261;1650;4208;1722;4469
291600;202005;5566;12817;4264;10820;379;1022;2907;7152;3286;8174
291610;202005;5666;14817;5082;14167;80;301;4657;12961;4737;13262
291620;202005;3174;7015;2331;6091;105;268;1817;4845;1922;5113
291630;202005;3290;7389;2448;6279;286;812;1718;4312;2004;5124
291640;202005;15639;38675;11766;33050;1693;4627;5303;15493;6996;20120
291650;202005;9527;23594;8395;22246;558;1044;7076;19224;7634;20268
291660;202005;2088;5106;1512;4211;130;424;984;2584;1114;3008
291670;202005;2068;5423;1745;4958;103;255;1312;3790;1415;4045
291680;202005;4166;10170;3365;9002;291;802;2369;6292;2660;7094
291685;202005;4683;11158;3736;9942;222;463;2835;7831;3057;8294
291690;202005;4187;9204;2876;7290;231;472;2183;5583;2414;6055
291700;202005;8602;24838;7516;22921;315;1175;6118;18301;6433;19476
291710;202005;5333;12613;3911;10616;214;674;2850;7587;3064;8261
291720;202005;4464;13543;3700;12011;387;1341;2434;7730;2821;9071
291730;202005;6395;16237;5480;15041;267;814;4531;12361;4798;13175
291733;202005;2892;7333;2428;6717;58;166;1763;5120;1821;5286
291735;202005;2909;7635;2302;6557;71;165;1758;4981;1829;5146
291740;202005;3872;9985;2866;8122;86;236;2064;5744;2150;5980
291750;202005;19456;46299;15791;40931;1513;3831;10695;28033;12208;31864
291760;202005;10310;29647;8039;25975;2426;8880;2202;7097;4628;15977
291770;202005;7073;18948;5887;16914;348;1083;4411;12342;4759;13425
291780;202005;5158;13627;4633;12886;84;318;4075;11206;4159;11524
291790;202005;2726;7515;2467;7180;226;557;1856;5587;2082;6144
291800;202005;29054;73050;21501;61729;3363;9385;10538;31460;13901;40845
291810;202005;10599;25113;8822;22934;261;669;7516;19637;7777;20306
291820;202005;3796;9985;3277;9314;92;307;2627;7489;2719;7796
291830;202005;4448;10485;3630;9392;187;422;2886;7491;3073;7913
291835;202005;6513;19409;5099;16677;531;1853;3243;10750;3774;12603
291840;202005;47887;130654;41302;120425;4305;13383;28929;83864;33234;97247
291845;202005;2505;6465;1955;5784;108;345;1579;4718;1687;5063
291850;202005;3913;11155;3205;9969;257;758;2285;7292;2542;8050
291855;202005;2211;4314;1715;3763;42;99;1548;3400;1590;3499
291860;202005;2240;5817;1556;4500;45;124;1055;2937;1100;3061
291870;202005;1283;3210;854;2473;46;133;582;1655;628;1788
291875;202005;2900;8673;2498;7833;64;265;1837;5589;1901;5854
291880;202005;5638;15830;4761;14345;219;638;3561;10772;3780;11410
291890;202005;1656;3372;1065;2687;126;299;717;1812;843;2111
291900;202005;1220;2934;927;2477;23;89;732;1902;755;1991
291905;202005;2498;6314;2019;5553;78;281;1535;4069;1613;4350
291910;202005;2958;7419;2516;6891;52;186;2166;6062;2218;6248
291915;202005;7397;20861;6021;18534;222;777;4575;14243;4797;15020
291920;202005;26651;68868;22410;62942;2158;6597;15546;42844;17704;49441
291930;202005;2506;6766;2140;6250;236;700;1429;4218;1665;4918
291940;202005;3899;9906;2593;7680;194;573;1523;4493;1717;5066
291950;202005;9211;27617;7820;24930;292;1099;5439;17119;5731;18218
291955;202005;15613;39152;13867;36903;1173;3261;10813;28856;11986;32117
291960;202005;3047;8049;2523;7328;121;365;1973;5856;2094;6221
291970;202005;4542;11390;3786;10437;141;479;2848;7870;2989;8349
291980;202005;9658;27521;7593;23901;914;2688;4675;15059;5589;17747
291990;202005;2302;5915;1882;5412;29;122;1747;5022;1776;5144
291992;202005;3955;9497;3133;8434;224;522;2482;6809;2706;7331
291995;202005;2082;5753;1707;5150;52;236;1296;3809;1348;4045
292000;202005;2644;6189;2152;5595;98;371;1673;4288;1771;4659
292010;202005;5744;13391;4674;11860;170;524;3875;9629;4045;10153
292020;202005;4568;13194;3770;11766;202;731;2736;8284;2938;9015
292030;202005;1815;5551;1654;5250;70;249;1055;3283;1125;3532
292040;202005;4381;11238;3393;9766;220;575;2587;7605;2807;8180
292045;202005;4013;10536;2966;8999;31;88;2622;8118;2653;8206
292050;202005;6515;18183;5236;15902;243;855;3381;10081;3624;10936
292060;202005;11462;26266;10480;25043;487;1093;9159;21677;9646;22770
292070;202005;5803;14981;5051;14082;295;833;4328;12000;4623;12833
292080;202005;3115;7823;2571;7119;78;260;2280;6271;2358;6531
292090;202005;4657;10014;3298;8378;258;670;2473;6333;2731;7003
292100;202005;11022;26644;9389;24593;936;2574;6561;17136;7497;19710
292105;202005;3509;8708;3051;8084;100;238;2502;6657;2602;6895
292110;202005;5931;14448;4163;11619;972;2766;1914;5358;2886;8124
292120;202005;6901;17572;5687;15544;360;1047;4334;11632;4694;12679
292130;202005;3427;8155;2815;7398;98;295;2223;5762;2321;6057
292140;202005;5053;11918;4227;10662;316;792;3352;8422;3668;9214
292145;202005;2375;6813;1998;6169;62;161;1538;4804;1600;4965
292150;202005;14060;38293;12183;35226;314;1200;9941;28385;10255;29585
292160;202005;2965;7168;2233;6222;42;118;1820;5307;1862;5425
292170;202005;8426;22270;7000;19944;340;1136;5303;14805;5643;15941
292180;202005;2811;7695;2055;6298;161;490;1281;3859;1442;4349
292190;202005;2960;7747;2518;7061;90;313;1986;5500;2076;5813
292200;202005;8439;20924;6292;17884;1044;3065;3277;9601;4321;12666
292205;202005;3871;10649;3341;9860;58;267;2918;8563;2976;8830
292210;202005;6530;15135;5257;13533;90;389;4725;12027;4815;12416
292220;202005;2133;5116;1868;4708;47;136;1486;3612;1533;3748
292225;202005;3202;9327;2801;8715;72;333;2366;7232;2438;7565
292230;202005;8588;20408;7667;19242;157;521;6626;16346;6783;16867
292240;202005;4717;13612;4086;12473;299;896;2858;8749;3157;9645
292250;202005;5763;14831;5175;13944;420;1107;3854;10346;4274;11453
292260;202005;3422;8861;3019;8335;93;249;2624;7256;2717;7505
292265;202005;3390;9138;2833;8297;75;317;2247;6451;2322;6768
292270;202005;4424;10022;3511;8938;114;280;2920;7431;3034;7711
292273;202005;2757;5845;2182;5146;55;91;1610;4060;1665;4151
292275;202005;1645;4262;1289;3779;58;164;971;2899;1029;3063
292280;202005;2627;6221;2106;5620;77;154;1789;4913;1866;5067
292285;202005;2542;6133;2025;5436;78;175;1647;4462;1725;4637
292290;202005;7424;19625;5859;17423;162;617;4791;14218;4953;14835
292300;202005;10293;25790;8092;22830;757;2277;5618;15917;6375;18194
292303;202005;2941;8371;2550;7751;77;194;2133;6533;2210;6727
292305;202005;2326;6193;2146;5946;43;195;1948;5303;1991;5498
292310;202005;6687;16778;5761;15660;148;500;5022;13515;5170;14015
292320;202005;6089;16620;4817;14253;261;856;3513;10118;3774;10974
292330;202005;2730;5997;2191;5391;98;197;1705;4364;1803;4561
292335;202005;4722;12220;4195;11467;205;484;3552;9797;3757;10281
292340;202005;5618;15627;4621;13709;224;672;3415;10053;3639;10725
292350;202005;2479;6709;2060;6134;76;283;1664;4968;1740;5251
292360;202005;4889;13014;4048;11586;219;716;2882;8055;3101;8771
292370;202005;10533;24374;9030;22417;129;422;8376;20525;8505;20947
292380;202005;6787;18875;6064;17580;389;1131;4614;13259;5003;14390
292390;202005;4537;8692;3333;7288;108;197;2920;6397;3028;6594
292400;202005;22434;63420;19341;58505;1893;5818;13266;40349;15159;46167
292405;202005;4376;10695;3688;9612;93;245;3066;7878;3159;8123
292410;202005;2216;5249;1844;4777;65;144;1626;4238;1691;4382
292420;202005;3455;10425;3141;9924;109;549;2698;8293;2807;8842
292430;202005;4859;14462;3663;12266;279;967;2397;8015;2676;8982
292440;202005;8427;26749;7782;25777;128;648;6967;22983;7095;23631
292450;202005;4019;11424;3140;9710;83;317;2452;7528;2535;7845
292460;202005;4901;13399;3996;11856;334;945;2873;8543;3207;9488
292465;202005;2650;6830;2248;6311;88;193;1515;4651;1603;4844
292467;202005;1908;5330;1680;5020;239;635;1162;3610;1401;4245
292470;202005;2975;7544;2300;6493;55;118;1794;5073;1849;5191
292480;202005;6300;14931;5075;13446;75;294;4607;12093;4682;12387
292490;202005;2058;5325;1718;4825;114;264;1304;3743;1418;4007
292500;202005;6594;17948;5255;15563;505;1565;3416;9972;3921;11537
292510;202005;13210;35585;10280;30879;525;1867;7195;21545;7720;23412
292520;202005;7006;17390;6204;16242;450;1212;4826;12527;5276;13739
292525;202005;5860;14060;4765;12830;115;278;4121;11287;4236;11565
292530;202005;28103;74734;21410;63233;5157;15365;8209;24878;13366;40243
292540;202005;4423;8126;3451;7090;113;185;3108;6421;3221;6606
292550;202005;8396;21592;6413;19216;465;1389;4549;14507;5014;15896
292560;202005;4354;10847;3772;10083;82;232;3130;8435;3212;8667
292570;202005;3586;9457;2999;8355;73;278;2528;6865;2601;7143
292575;202005;6945;19687;6353;18900;371;1080;5117;15379;5488;16459
292580;202005;7544;18961;6246;17045;134;455;5267;14230;5401;14685
292590;202005;7348;19528;6284;17694;259;834;5237;14474;5496;15308
292593;202005;2821;6999;2332;6181;64;168;1959;5135;2023;5303
292595;202005;5396;14304;4612;13342;149;503;3891;11182;4040;11685
292600;202005;10913;29572;9375;27216;299;886;7464;21734;7763;22620
292610;202005;4098;10732;3453;9584;179;418;2616;7345;2795;7763
292620;202005;6428;17527;5322;16195;123;280;4862;15085;4985;15365
292630;202005;8547;20864;6863;18166;695;1851;4440;11797;5135;13648
292640;202005;8159;23941;7072;22136;195;774;5054;15926;5249;16700
292650;202005;4462;10960;4017;10379;106;287;3651;9331;3757;9618
292660;202005;11428;30601;9675;28021;447;1452;7423;21476;7870;22928
292665;202005;2164;6365;1870;5980;66;194;1575;5113;1641;5307
292670;202005;3576;9564;2733;7993;115;364;1860;5332;1975;5696
292680;202005;3970;10412;3124;8938;191;498;2284;6427;2475;6925
292690;202005;2642;6753;1817;5402;194;539;1076;3353;1270;3892
292700;202005;9805;26536;8515;24574;727;1862;5888;17583;6615;19445
292710;202005;2425;7559;2242;7306;45;163;2026;6641;2071;6804
292720;202005;8996;21359;7609;19760;209;572;6053;15993;6262;16565
292730;202005;4555;10339;4260;9986;266;433;3647;8753;3913;9186
292740;202005;326484;784145;280266;717356;38922;99720;174460;444687;213382;544407
292750;202005;6159;16482;5380;15350;222;646;4163;12051;4385;12697
292760;202005;3904;11181;3383;10251;225;766;2470;7431;2695;8197
292770;202005;6134;16055;4929;14376;764;2293;3117;9365;3881;11658
292780;202005;2115;4177;1561;3493;44;134;1268;2678;1312;2812
292790;202005;4080;8656;3115;7610;152;372;2604;6418;2756;6790
292800;202005;11322;28194;9662;25688;297;852;8080;21197;8377;22049
292805;202005;3602;8621;2811;7580;99;317;2217;5924;2316;6241
292810;202005;10653;27845;8398;24320;206;887;6330;17740;6536;18627
292820;202005;7430;20392;5396;16976;432;1442;3748;11601;4180;13043
292830;202005;2878;6779;2464;6262;90;265;2091;5329;2181;5594
292840;202005;8720;22633;7367;20791;144;543;6449;17887;6593;18430
292850;202005;2489;6578;2088;5977;144;436;1478;4198;1622;4634
292860;202005;17206;37556;15412;35428;410;999;13346;30298;13756;31297
292870;202005;17962;44246;15372;40602;931;2508;10515;27480;11446;29988
292880;202005;11003;29843;9361;27389;269;1112;7385;20898;7654;22010
292890;202005;7022;19440;6193;18234;184;747;5419;15834;5603;16581
292895;202005;3000;6414;2169;5178;96;231;1754;4143;1850;4374
292900;202005;2597;6955;2355;6583;61;238;1935;5248;1996;5486
292905;202005;4305;11071;3391;9728;135;452;2515;7135;2650;7587
292910;202005;4903;13240;4447;12583;213;602;3404;9572;3617;10174
292920;202005;9712;26524;8961;25458;251;951;7757;21637;8008;22588
292925;202005;5418;15269;4522;13657;217;663;3269;9764;3486;10427
292930;202005;6488;18962;5570;17262;465;1605;3570;10780;4035;12385
292935;202005;2463;6168;1898;5537;23;126;1701;4982;1724;5108
292937;202005;2836;7038;2440;6504;51;148;2117;5641;2168;5789
292940;202005;2835;7155;2262;6305;176;403;1642;4756;1818;5159
292950;202005;9559;24125;8347;22339;528;1225;6305;16850;6833;18075
292960;202005;5225;12586;4370;11368;127;331;3500;9013;3627;9344
292970;202005;3783;10873;3336;10190;83;387;2779;8523;2862;8910
292975;202005;4484;9505;3968;8925;127;216;3615;8222;3742;8438
292980;202005;3302;7925;2639;6949;87;276;2150;5555;2237;5831
292990;202005;11362;31031;9471;27672;649;1994;6941;19965;7590;21959
293000;202005;2611;6188;2234;5617;42;148;1786;4495;1828;4643
293010;202005;17986;45902;14446;40311;1926;5550;8817;24565;10743;30115
293015;202005;8260;25195;6456;21648;421;1523;4352;14788;4773;16311
293020;202005;9800;28341;8812;26928;135;588;7941;24319;8076;24907
293030;202005;5272;13865;3997;11873;99;329;2776;8468;2875;8797
293040;202005;4115;11119;3460;10191;69;265;3004;8843;3073;9108
293050;202005;22145;54497;19558;50689;999;2699;14818;37867;15817;40566
293060;202005;3489;9258;2831;8029;233;698;1962;5473;2195;6171
293070;202005;25067;60199;21326;55464;1959;5355;15349;39975;17308;45330
293075;202005;3455;10956;2989;10155;158;696;2373;8066;2531;8762
293076;202005;3538;8647;3217;8267;55;146;2869;7438;2924;7584
293077;202005;6103;16863;4948;14992;423;1411;3227;9998;3650;11409
293080;202005;4701;13864;4041;12735;90;428;3277;10134;3367;10562
293090;202005;3210;9300;2443;8032;206;671;1605;5336;1811;6007
293100;202005;5743;15244;4741;13443;224;658;3724;10455;3948;11113
293105;202005;3725;11779;3258;10832;233;808;2302;7591;2535;8399
293110;202005;2398;5947;1976;5326;68;245;1619;4254;1687;4499
293120;202005;4368;11859;3881;11093;114;304;3232;9247;3346;9551
293130;202005;3676;10098;3202;9472;75;287;2753;8069;2828;8356
293135;202005;30802;71711;22671;60910;3405;9946;10786;29283;14191;39229
293140;202005;2381;5269;2063;4877;61;139;1739;4103;1800;4242
293150;202005;5487;16205;4503;14327;334;1077;3089;9869;3423;10946
293160;202005;3854;9341;3264;8701;245;410;2715;7605;2960;8015
293170;202005;4933;10260;4284;9457;116;252;3748;8239;3864;8491
293180;202005;4341;12165;3571;10764;87;335;2837;8365;2924;8700
293190;202005;13956;37977;12245;35498;145;641;10853;31264;10998;31905
293200;202005;8349;20724;6648;18040;203;746;5315;14111;5518;14857
293210;202005;5161;13668;4416;12531;277;783;3404;9646;3681;10429
293220;202005;5032;12937;3668;10597;850;2454;1460;4324;2310;6778
293230;202005;3863;9904;2835;8429;207;695;1937;5809;2144;6504
293240;202005;4517;11907;3610;10430;66;158;2745;8248;2811;8406
293245;202005;3813;10268;3416;9700;144;484;2914;8142;3058;8626
293250;202005;5922;13652;4822;12250;133;347;4054;10290;4187;10637
293260;202005;4525;12104;3735;10866;142;455;2579;7534;2721;7989
293270;202005;7238;15938;5695;14286;393;598;4473;12058;4866;12656
293280;202005;4506;11846;3915;11011;231;577;3049;8667;3280;9244
293290;202005;14269;41592;12526;38866;1689;5345;8221;25843;9910;31188
293300;202005;5745;13894;4918;12692;276;723;3605;9307;3881;10030
293305;202005;4076;9653;3546;8999;49;121;3201;8130;3250;8251
293310;202005;2082;5320;1750;4809;51;153;1398;3791;1449;3944
293315;202005;4057;9613;3340;8529;192;432;2768;7065;2960;7497
293317;202005;2623;6136;2316;5711;142;272;1838;4547;1980;4819
293320;202005;12002;28941;10605;27379;259;715;9458;24314;9717;25029
293325;202005;1790;4404;1388;3864;200;540;842;2387;1042;2927
293330;202005;55414;158096;44834;139281;8421;26986;20742;64928;29163;91914
293340;202005;2210;6190;1820;5498;81;272;1297;3862;1378;4134
293345;202005;3507;9455;2802;8393;361;840;1826;5973;2187;6813
293350;202005;6612;18884;5695;17790;61;308;5189;16409;5250;16717
293360;202005;15521;38514;13148;35351;297;1224;11573;30549;11870;31773
310010;202005;943;2126;599;1644;48;174;224;555;272;729
310020;202005;2554;6927;1852;5672;404;1333;390;1132;794;2465
310030;202005;1900;5323;1457;4549;212;739;937;2812;1149;3551
310040;202005;896;2336;711;2023;29;129;488;1301;517;1430
310050;202005;1494;4470;1254;4084;131;537;820;2563;951;3100
310060;202005;3155;8903;2734;8343;78;325;2275;6852;2353;7177
310070;202005;343;777;239;629;7;15;179;467;186;482
310080;202005;682;1806;483;1445;71;236;220;620;291;856
310090;202005;4631;12359;3781;10968;288;901;2749;7847;3037;8748
310100;202005;3453;9576;2878;8607;79;369;2334;6787;2413;7156
310110;202005;4592;12086;3561;10266;763;2405;1548;4291;2311;6696
310120;202005;637;1559;402;1179;44;155;238;645;282;800
310130;202005;367;949;304;856;25;101;225;596;250;697
310140;202005;264;751;186;622;36;138;73;221;109;359
310150;202005;5299;13980;3899;11374;509;1705;1839;5063;2348;6768
310160;202005;7585;18932;5378;15294;1038;3246;1908;5479;2946;8725
310163;202005;1019;3009;810;2613;182;668;271;806;453;1474
310170;202005;9103;23222;7223;20270;603;1751;5110;14314;5713;16065
310180;202005;1764;4377;1292;3595;164;498;760;2043;924;2541
310190;202005;2512;7312;2014;6408;446;1601;341;1003;787;2604
310200;202005;1845;5443;1327;4431;193;729;615;2019;808;2748
310205;202005;1101;3053;843;2643;149;530;378;1163;527;1693
310210;202005;2594;6934;2102;6061;119;369;1535;4323;1654;4692
310220;202005;1234;3367;942;2800;86;280;624;1786;710;2066
310230;202005;2166;5999;1734;5189;219;733;1084;3035;1303;3768
310240;202005;944;2892;791;2620;47;176;568;1850;615;2026
310250;202005;1029;2744;824;2406;19;76;588;1699;607;1775
310260;202005;2968;7628;1860;5685;534;1905;500;1179;1034;3084
310270;202005;2673;6641;2104;5869;99;331;1706;4749;1805;5080
310280;202005;2386;5511;1834;4717;263;717;1050;2607;1313;3324
310285;202005;1843;5829;1527;5266;168;652;935;3192;1103;3844
310290;202005;1121;2946;908;2563;207;676;475;1195;682;1871
310300;202005;1471;4267;1246;3887;139;530;740;2160;879;2690
310310;202005;294;710;192;536;32;94;101;283;133;377
310320;202005;520;1323;351;1049;24;95;199;561;223;656
310330;202005;479;1130;283;782;40;129;117;294;157;423
310340;202005;7724;20794;6160;18135;869;2487;3064;9315;3933;11802
310350;202005;12333;29683;8333;23207;1602;4795;3681;9909;5283;14704
310360;202005;491;1117;373;965;12;36;253;660;265;696
310370;202005;1254;3888;1050;3494;204;741;352;1196;556;1937
310375;202005;858;2114;599;1730;92;274;325;933;417;1207
310380;202005;396;889;216;600;35;104;97;251;132;355
310390;202005;432;1284;336;1101;77;274;94;263;171;537
310400;202005;9819;23744;6929;19412;696;2273;4176;11431;4872;13704
310410;202005;892;2557;581;1974;89;330;220;698;309;1028
310420;202005;4169;10678;2807;8088;381;1242;1151;3083;1532;4325
310430;202005;1486;4027;957;3040;214;751;327;917;541;1668
310440;202005;649;1688;440;1301;41;148;233;650;274;798
310445;202005;1354;3869;977;3109;63;210;688;2152;751;2362
310450;202005;4683;11693;3504;9839;135;518;2664;7250;2799;7768
310460;202005;1560;4098;1112;3283;193;621;379;1051;572;1672
310470;202005;3743;8172;2894;7066;283;668;2050;5139;2333;5807
310480;202005;915;2366;709;2032;78;239;465;1306;543;1545
310490;202005;2796;7555;2179;6550;225;850;1237;3491;1462;4341
310500;202005;1328;3756;992;3182;174;637;526;1631;700;2268
310510;202005;2047;5315;1309;3947;232;796;481;1451;713;2247
310520;202005;1187;3096;854;2493;142;407;445;1299;587;1706
310530;202005;688;1732;425;1250;61;229;147;346;208;575
310540;202005;2970;8447;2456;7560;551;1798;1120;3312;1671;5110
310550;202005;1246;3183;865;2525;74;272;497;1354;571;1626
310560;202005;14472;37591;10199;30100;1519;5148;4302;11475;5821;16623
310570;202005;1028;2679;811;2378;53;189;602;1737;655;1926
310590;202005;3988;10609;3172;9093;196;672;1860;5044;2056;5716
310600;202005;1301;3860;1061;3373;147;525;542;1608;689;2133
310610;202005;464;1213;289;925;52;183;139;423;191;606
310620;202005;171088;432495;123096;345916;17861;58226;59832;152549;77693;210775
310630;202005;4378;11949;3417;10086;305;991;2192;6263;2497;7254
310640;202005;1008;3020;817;2635;165;582;352;1080;517;1662
310650;202005;2327;6699;1670;5422;166;584;971;3063;1137;3647
310660;202005;1297;3471;1058;3150;32;106;894;2643;926;2749
310665;202005;1399;3607;1120;3195;30;111;907;2612;937;2723
310670;202005;55612;143130;46637;127785;4345;13728;32194;84040;36539;97768
310680;202005;753;1770;611;1569;16;56;521;1289;537;1345
310690;202005;1928;5045;1385;4118;109;373;783;2218;892;2591
310700;202005;479;1056;379;937;22;73;300;714;322;787
310710;202005;5404;15403;3941;13260;880;3500;683;2116;1563;5616
310720;202005;999;2322;775;2038;33;112;589;1503;622;1615
310730;202005;9666;26026;8278;23842;322;1195;6244;17645;6566;18840
310740;202005;5863;16134;3962;12148;649;2201;1369;3850;2018;6051
310750;202005;1201;2850;872;2377;107;322;443;1134;550;1456
310760;202005;569;1468;406;1223;31;96;217;675;248;771
310770;202005;1079;2912;741;2396;76;303;382;1156;458;1459
310780;202005;4244;10295;3502;9300;70;207;2852;7619;2922;7826
310790;202005;1767;5580;1527;5064;352;1246;247;727;599;1973
310800;202005;2200;6507;1581;5234;353;1401;103;281;456;1682
310810;202005;1212;2997;978;2607;41;123;697;1791;738;1914
310820;202005;1097;2823;669;2101;149;507;165;524;314;1031
310825;202005;2524;7650;2011;6789;69;404;1616;5259;1685;5663
310830;202005;1787;5044;1238;3936;246;892;518;1548;764;2440
310840;202005;1907;5179;1356;4249;344;1218;333;925;677;2143
310850;202005;1473;4025;1228;3683;45;229;955;2732;1000;2961
310855;202005;3035;8026;2344;6910;156;560;1684;4821;1840;5381
310860;202005;6890;19907;5489;17136;525;1741;3383;10641;3908;12382
310870;202005;931;2245;727;1953;51;138;546;1471;597;1609
310880;202005;974;2927;761;2487;104;350;443;1413;547;1763
310890;202005;2238;6364;1431;4727;260;932;225;629;485;1561
310900;202005;3785;10581;2556;7876;373;1213;1085;3136;1458;4349
310910;202005;1994;4911;1376;3914;110;385;283;749;393;1134
310920;202005;1897;4936;1433;4225;200;638;811;2346;1011;2984
310925;202005;936;2545;750;2246;69;242;510;1444;579;1686
310930;202005;5720;14969;4040;12218;771;2385;1854;5844;2625;8229
310940;202005;6652;15743;5341;13829;178;586;4098;10308;4276;10894
310945;202005;1316;3439;1030;2971;158;490;528;1488;686;1978
310950;202005;1882;5594;1221;4087;229;860;413;1216;642;2076
310960;202005;720;1925;402;1261;72;264;83;231;155;495
310970;202005;1111;3287;778;2568;200;727;143;433;343;1160
310980;202005;270;649;174;504;19;65;107;299;126;364
310990;202005;1294;3605;1001;3090;159;527;518;1566;677;2093
311000;202005;3973;11039;2880;9196;707;2437;1186;3659;1893;6096
311010;202005;861;2504;689;2154;198;699;294;884;492;1583
311020;202005;1063;2728;677;2030;35;101;376;1112;411;1213
311030;202005;1628;3984;1110;3140;195;625;522;1399;717;2024
311040;202005;276;867;227;758;69;241;70;220;139;461
311050;202005;2782;6801;2043;5728;353;1141;1038;2784;1391;3925
311060;202005;3077;7865;2239;6280;326;1047;896;2284;1222;3331
311070;202005;2273;5652;1630;4646;173;644;878;2324;1051;2968
311080;202005;1120;2519;905;2181;50;160;708;1619;758;1779
311090;202005;1991;6330;1545;5482;352;1381;468;1603;820;2984
311100;202005;2329;6595;1356;4581;245;950;247;736;492;1686
311110;202005;3596;7347;2000;5132;357;981;746;1964;1103;2945
311115;202005;1350;3053;1127;2749;61;158;923;2231;984;2389
311120;202005;6220;16310;4659;13498;689;2289;1785;4553;2474;6842
311130;202005;1846;4783;1392;4154;106;395;803;2331;909;2726
311140;202005;1378;3387;1062;2952;82;270;710;1934;792;2204
311150;202005;1461;4639;1133;3995;182;714;605;2074;787;2788
311160;202005;3704;10601;2575;8468;645;2353;770;2420;1415;4773
311170;202005;878;2218;689;1964;38;110;439;1325;477;1435
311180;202005;1335;2999;822;2239;155;461;366;985;521;1446
311190;202005;863;2388;660;1991;115;394;266;702;381;1096
311200;202005;1952;5289;1389;4202;266;892;498;1351;764;2243
311205;202005;862;2593;698;2263;47;213;437;1338;484;1551
311210;202005;998;2913;867;2739;112;316;629;2043;741;2359
311220;202005;723;2012;603;1800;48;163;382;1080;430;1243
311230;202005;7538;22767;5676;18943;1007;3548;2129;7240;3136;10788
311240;202005;1008;2625;771;2286;162;511;328;971;490;1482
311250;202005;984;2846;756;2411;163;499;303;930;466;1429
311260;202005;2601;6431;1641;4760;265;864;693;1832;958;2696
311265;202005;1305;3396;957;2805;41;160;658;1875;699;2035
311270;202005;2939;8776;2552;8129;157;693;1853;5629;2010;6322
311280;202005;1075;2748;494;1570;98;361;47;130;145;491
311290;202005;1847;5604;1679;5252;148;484;1138;3543;1286;4027
311300;202005;4628;12962;3775;11526;197;838;2978;8887;3175;9725
311310;202005;561;1561;473;1406;45;136;283;812;328;948
311320;202005;3103;9456;2633;8435;386;1461;1238;3582;1624;5043
311330;202005;4998;13117;3969;11440;433;1378;2225;6518;2658;7896
311340;202005;10201;28571;8019;24678;2110;7071;2186;6380;4296;13451
311350;202005;2350;5808;1660;4540;145;443;902;2202;1047;2645
311360;202005;1112;2718;697;2084;199;671;223;639;422;1310
311370;202005;4616;11110;3373;9159;138;532;2256;5777;2394;6309
311380;202005;353;1072;256;867;64;207;107;384;171;591
311390;202005;1708;5185;1341;4670;589;2296;323;1019;912;3315
311400;202005;1454;3985;1045;3195;162;505;391;1069;553;1574
311410;202005;1625;4748;1294;4266;189;724;756;2453;945;3177
311420;202005;1408;4089;968;3180;179;670;240;638;419;1308
311430;202005;3908;10322;2574;7682;491;1514;812;2412;1303;3926
311440;202005;2654;7496;1940;6264;441;1681;514;1592;955;3273
311450;202005;1668;4962;1183;4049;314;1220;325;962;639;2182
311455;202005;971;2151;637;1656;165;431;254;699;419;1130
311460;202005;467;1456;313;1128;63;297;85;257;148;554
311470;202005;492;1532;332;1152;74;302;50;159;124;461
311480;202005;1040;2677;857;2398;46;134;663;1849;709;1983
311490;202005;247;729;184;603;31;124;87;250;118;374
311500;202005;432;1075;331;931;23;72;219;596;242;668
311510;202005;3127;8184;2087;6368;295;1028;862;2471;1157;3499
311520;202005;615;1728;541;1585;68;256;302;861;370;1117
311530;202005;8599;20017;5349;14774;1293;3989;1416;3702;2709;7691
311535;202005;778;2128;500;1558;81;264;170;488;251;752
311540;202005;476;1511;422;1408;78;292;280;902;358;1194
311545;202005;2005;5741;1708;5278;98;349;1320;4026;1418;4375
311547;202005;1451;3703;1254;3400;41;113;868;2376;909;2489
311550;202005;2700;7557;2137;6513;301;1041;928;2696;1229;3737
311560;202005;288;631;181;476;45;116;68;164;113;280
311570;202005;1654;3810;1167;3140;38;110;924;2527;962;2637
311580;202005;2142;3979;1404;3108;141;296;943;2085;1084;2381
311590;202005;486;1292;385;1138;62;210;215;621;277;831
311600;202005;1738;3890;1451;3520;60;145;1246;2982;1306;3127
311610;202005;2195;7153;1805;6321;198;762;1015;3504;1213;4266
311615;202005;3152;8868;2543;7845;117;439;1996;6036;2113;6475
311620;202005;432;1109;372;1043;8;30;320;889;328;919
311630;202005;1317;3617;1066;3098;100;327;699;1946;799;2273
311640;202005;609;1669;479;1442;65;230;217;597;282;827
311650;202005;1838;4754;1515;4253;150;463;993;2711;1143;3174
311660;202005;2778;7846;2030;6400;360;1274;581;1554;941;2828
311670;202005;1498;3928;1088;3192;165;551;457;1344;622;1895
311680;202005;2134;6089;1582;5056;167;534;1055;3364;1222;3898
311690;202005;591;1260;461;1095;39;75;331;835;370;910
311700;202005;2203;5293;1714;4614;26;129;1443;3755;1469;3884
311710;202005;1484;4264;1063;3503;246;883;402;1305;648;2188
311720;202005;398;1177;317;1027;24;96;178;565;202;661
311730;202005;3756;9628;2396;7007;700;2207;472;1417;1172;3624
311740;202005;862;2263;723;2099;33;84;621;1861;654;1945
311750;202005;3808;11412;3019;9965;423;1517;1708;5435;2131;6952
311760;202005;600;1694;489;1495;69;261;244;646;313;907
311770;202005;2044;5875;1586;5044;243;818;745;2298;988;3116
311780;202005;1248;3574;838;2743;161;602;260;729;421;1331
311783;202005;2213;6006;1784;5258;41;190;1439;4063;1480;4253
311787;202005;714;2047;532;1628;76;254;227;590;303;844
311790;202005;1460;3930;948;2994;235;820;255;757;490;1577
311800;202005;4625;13922;3746;11996;796;2788;658;1812;1454;4600
311810;202005;920;2803;725;2457;56;213;467;1570;523;1783
311820;202005;765;1863;567;1559;70;226;351;905;421;1131
311830;202005;8262;23662;5583;17828;1544;5334;688;2158;2232;7492
311840;202005;3498;8922;2809;7933;252;759;2053;5766;2305;6525
311850;202005;362;956;293;826;13;41;195;527;208;568
311860;202005;56530;142589;42840;119408;6341;19097;23751;63301;30092;82398
311870;202005;1839;4875;1239;3781;202;704;496;1375;698;2079
311880;202005;6169;15981;5143;14558;276;703;3879;11202;4155;11905
311890;202005;1633;3943;1247;3384;92;292;883;2276;975;2568
311900;202005;720;1859;534;1604;56;202;352;1029;408;1231
311910;202005;4123;10559;3087;9202;547;1603;1556;4784;2103;6387
311920;202005;2075;5491;1647;4866;122;327;1036;3166;1158;3493
311930;202005;3675;8585;2578;7026;807;2381;774;1957;1581;4338
311940;202005;14661;38570;10757;31164;1521;4882;4944;13324;6465;18206
311950;202005;2264;6136;1688;5155;107;393;1038;3185;1145;3578
311960;202005;488;1192;393;1052;22;84;256;626;278;710
311970;202005;412;1330;298;1039;52;217;70;210;122;427
311980;202005;441;1205;228;770;23;77;78;257;101;334
311990;202005;533;1231;332;933;68;242;143;351;211;593
311995;202005;944;2595;468;1494;21;70;66;145;87;215
312000;202005;674;1754;550;1571;50;146;355;1021;405;1167
312010;202005;936;2596;720;2232;54;195;455;1340;509;1535
312015;202005;1338;3955;1176;3693;47;215;951;2915;998;3130
312020;202005;1528;4679;1148;3854;245;879;287;905;532;1784
312030;202005;1981;4952;1724;4668;20;76;1606;4340;1626;4416
312040;202005;844;2473;581;1949;64;224;264;857;328;1081
312050;202005;1170;3644;933;3181;218;876;286;860;504;1736
312060;202005;845;2096;554;1734;137;421;266;859;403;1280
312070;202005;878;2542;624;2038;48;174;341;1053;389;1227
312080;202005;2622;6454;1946;5448;107;349;1268;3393;1375;3742
312083;202005;848;2214;619;1857;51;188;418;1210;469;1398
312087;202005;2440;6360;1964;5613;45;144;1549;4440;1594;4584
312090;202005;9883;25826;7580;22163;1120;3637;3809;10813;4929;14450
312100;202005;1533;4454;1188;3821;106;425;689;2110;795;2535
312110;202005;1016;3135;839;2773;189;724;298;883;487;1607
312120;202005;822;2242;555;1768;151;553;171;445;322;998
312125;202005;1709;4398;1423;3982;114;374;1059;2846;1173;3220
312130;202005;967;2337;716;1920;57;168;316;773;373;941
312140;202005;670;1934;545;1682;109;375;247;703;356;1078
312150;202005;448;1251;377;1104;12;55;270;734;282;789
312160;202005;8337;22829;6267;19134;777;2779;3062;8896;3839;11675
312170;202005;884;2412;666;1981;36;136;446;1287;482;1423
312180;202005;1352;3614;1067;3071;147;448;543;1514;690;1962
312190;202005;627;1742;441;1376;77;266;149;429;226;695
312200;202005;4506;12258;3544;10708;1076;3248;1236;3853;2312;7101
312210;202005;1335;2992;958;2441;36;114;723;1796;759;1910
312220;202005;1620;5012;1395;4589;101;360;885;2913;986;3273
312230;202005;12551;32528;8158;24442;1956;6638;1632;4199;3588;10837
312235;202005;1899;4860;1496;4247;86;302;1075;2965;1161;3267
312240;202005;687;2254;521;1902;119;470;145;517;264;987
312245;202005;2622;6769;2139;6037;58;168;1749;4904;1807;5072
312247;202005;936;2279;668;1886;123;370;346;991;469;1361
312250;202005;973;2579;622;1875;82;262;235;691;317;953
312260;202005;900;2438;711;2148;39;167;539;1562;578;1729
312270;202005;676;1842;512;1521;23;102;302;818;325;920
312280;202005;407;1198;316;1036;96;322;43;131;139;453
312290;202005;710;2100;567;1841;103;380;202;633;305;1013
312300;202005;963;2926;640;2122;157;566;122;338;279;904
312310;202005;914;2769;717;2344;114;399;330;1041;444;1440
312320;202005;1941;5000;1396;4021;325;986;325;894;650;1880
312330;202005;842;2497;668;2129;61;217;413;1290;474;1507
312340;202005;261;680;184;550;44;156;78;204;122;360
312350;202005;243;491;170;412;14;44;117;269;131;313
312352;202005;1585;4752;1408;4436;85;274;866;2903;951;3177
312360;202005;2580;7496;1869;6104;374;1334;587;1839;961;3173
312370;202005;1796;4691;1458;4124;178;569;850;2288;1028;2857
312380;202005;2112;4805;1733;4326;6;25;1550;3828;1556;3853
312385;202005;1196;3285;933;2812;138;440;446;1342;584;1782
312390;202005;1853;5337;1373;4423;201;748;522;1534;723;2282
312400;202005;2779;7995;2278;7108;695;2335;737;2271;1432;4606
312410;202005;11406;31507;9229;27822;1591;4999;5074;15120;6665;20119
312420;202005;3594;9822;2977;8792;543;1781;1592;4573;2135;6354
312430;202005;7603;20396;6194;17832;390;1314;4375;12278;4765;13592
312440;202005;896;2880;703;2436;353;1298;91;281;444;1579
312450;202005;1160;3412;883;2923;251;884;294;1010;545;1894
312460;202005;428;1122;291;911;42;142;151;488;193;630
312470;202005;467;1116;292;809;34;101;108;268;142;369
312480;202005;1033;2564;719;2103;101;326;353;967;454;1293
312490;202005;2054;5009;1565;4285;202;575;851;2277;1053;2852
312500;202005;961;2369;777;2111;49;176;536;1433;585;1609
312510;202005;3630;9606;2576;7611;650;1854;687;2072;1337;3926
312520;202005;168;462;128;394;34;111;54;165;88;276
312530;202005;580;1430;496;1328;16;57;437;1173;453;1230
312540;202005;1528;4308;1022;3254;145;505;558;1713;703;2218
312550;202005;761;2011;575;1637;47;151;370;968;417;1119
312560;202005;1922;4956;1535;4346;66;212;1170;3309;1236;3521
312570;202005;2106;5179;1570;4504;447;1342;615;1827;1062;3169
312580;202005;616;1704;434;1317;56;198;196;547;252;745
312590;202005;1575;4593;1251;3942;87;396;786;2291;873;2687
312595;202005;1895;5614;1579;5072;260;788;939;3167;1199;3955
312600;202005;1135;2742;633;1777;111;393;121;386;232;779
312610;202005;6192;15675;3998;11586;609;1932;1387;3730;1996;5662
312620;202005;2507;6476;1847;5545;55;243;1461;4475;1516;4718
312630;202005;282;820;200;674;36;139;80;262;116;401
312640;202005;499;1368;342;1098;40;134;133;443;173;577
312650;202005;2010;5160;1365;3942;66;211;966;2666;1032;2877
312660;202005;1318;3206;988;2644;89;261;671;1728;760;1989
312670;202005;4792;12756;3966;11433;171;745;2894;7976;3065;8721
312675;202005;1233;3271;998;2923;59;195;800;2318;859;2513
312680;202005;1362;3858;1176;3570;53;231;967;2844;1020;3075
312690;202005;2860;6077;2221;5306;51;145;1845;4416;1896;4561
312695;202005;951;2580;790;2303;40;92;619;1811;659;1903
312700;202005;2090;5508;1506;4432;149;512;846;2355;995;2867
312705;202005;1384;3319;1174;3005;17;56;1062;2700;1079;2756
312707;202005;1360;3961;1047;3387;62;299;680;2069;742;2368
312710;202005;6465;14807;3760;10539;952;2867;1066;3088;2018;5955
312720;202005;1054;2823;792;2406;106;338;483;1431;589;1769
312730;202005;1612;3808;1137;3147;92;298;661;1743;753;2041
312733;202005;1367;3615;1038;2983;37;144;712;1943;749;2087
312735;202005;670;1819;565;1613;66;215;336;857;402;1072
312737;202005;772;1766;532;1409;66;189;338;855;404;1044
312738;202005;640;1638;455;1329;51;169;249;686;300;855
312740;202005;418;1020;240;720;50;169;64;151;114;320
312750;202005;1553;4488;1152;3733;205;704;494;1517;699;2221
312760;202005;1758;5175;1237;4094;217;780;453;1426;670;2206
312770;202005;43407;104031;26930;75724;5574;16797;8857;24455;14431;41252
312780;202005;2382;7132;2015;6539;239;831;1296;4191;1535;5022
312790;202005;242;580;129;400;7;38;41;106;48;144
312800;202005;4770;13506;3594;11239;882;2918;1234;3767;2116;6685
312810;202005;1532;4069;996;3197;256;920;346;1010;602;1930
312820;202005;1721;4607;1360;3977;38;152;1032;2947;1070;3099
312825;202005;1309;3087;1133;2857;19;67;966;2387;985;2454
312830;202005;2767;7786;1602;5348;333;1258;389;1233;722;2491
312840;202005;1258;3468;980;2982;93;365;507;1446;600;1811
312850;202005;887;2165;625;1775;26;101;374;976;400;1077
312860;202005;1135;2937;763;2359;199;658;172;487;371;1145
312870;202005;5978;16136;3638;11609;620;2125;805;2402;1425;4527
312880;202005;1401;3502;1075;2945;37;132;640;1750;677;1882
312890;202005;2205;5537;1572;4466;103;286;812;2338;915;2624
312900;202005;1145;2917;929;2652;88;284;505;1577;593;1861
312910;202005;1614;2949;839;1930;162;312;314;741;476;1053
312920;202005;980;2624;668;2098;115;416;283;818;398;1234
312930;202005;2264;5583;1740;4805;387;1109;788;2187;1175;3296
312940;202005;929;2548;717;2234;76;288;361;1063;437;1351
312950;202005;3091;7661;1996;5865;518;1665;629;1786;1147;3451
312960;202005;1782;4749;1501;4308;70;187;1172;3449;1242;3636
312965;202005;1591;4470;1329;4049;110;354;925;2759;1035;3113
312970;202005;1303;3651;1007;3164;148;568;575;1683;723;2251
312980;202005;22723;62551;18223;54435;3502;11468;8820;24782;12322;36250
312990;202005;475;1206;296;887;50;171;143;410;193;581
313000;202005;477;1358;358;1137;28;120;210;619;238;739
313005;202005;2465;7113;2066;6432;159;482;1459;4513;1618;4995
313010;202005;4852;13414;3840;11760;679;2278;2238;6721;2917;8999
313020;202005;984;2992;676;2281;124;446;132;380;256;826
313030;202005;1067;2493;717;1974;78;271;470;1224;548;1495
313040;202005;788;2412;650;2131;44;184;386;1205;430;1389
313050;202005;1721;4744;1193;3939;200;793;387;1126;587;1919
313055;202005;1879;5056;1660;4736;56;182;1436;4073;1492;4255
313060;202005;943;2256;675;1802;181;591;128;303;309;894
313065;202005;1608;4829;1402;4483;47;187;1080;3372;1127;3559
313070;202005;929;2459;695;2045;71;223;402;1157;473;1380
313080;202005;382;1063;277;860;49;175;102;267;151;442
313090;202005;5004;13335;4247;12108;329;1079;2847;8041;3176;9120
313100;202005;1310;3409;1007;2972;28;118;769;2209;797;2327
313110;202005;1453;3821;1050;3113;95;353;589;1625;684;1978
313115;202005;2556;7392;2061;6421;267;925;1083;3166;1350;4091
313120;202005;3734;8806;2711;7457;224;714;1764;4809;1988;5523
313130;202005;29786;77311;22580;63984;2481;7966;12744;34091;15225;42057
313140;202005;601;1312;356;953;30;76;239;648;269;724
313150;202005;1337;3752;986;3106;301;1031;221;625;522;1656
313160;202005;1120;2826;876;2449;26;97;662;1803;688;1900
313170;202005;10908;30992;7718;25019;1325;4700;3050;9323;4375;14023
313180;202005;2050;5420;1442;4213;180;556;826;2361;1006;2917
313190;202005;4050;11569;2944;9360;549;1901;1016;3015;1565;4916
313200;202005;1056;2945;917;2703;15;55;776;2221;791;2276
313210;202005;3721;10876;3010;9596;351;1271;1809;5549;2160;6820
313220;202005;1688;4443;1101;3282;159;537;441;1168;600;1705
313230;202005;2928;8236;2414;7608;47;178;2017;6503;2064;6681
313240;202005;9427;23041;5771;17131;978;3338;2443;6737;3421;10075
313250;202005;6160;17981;4582;14654;841;2727;1983;6207;2824;8934
313260;202005;588;1564;418;1257;57;226;206;576;263;802
313270;202005;5594;14138;4439;12494;559;1569;2961;8514;3520;10083
313280;202005;451;1266;293;939;34;122;126;382;160;504
313290;202005;933;2885;684;2441;215;832;217;762;432;1594
313300;202005;1532;4090;1087;3286;276;907;253;662;529;1569
313310;202005;1070;3165;813;2626;132;498;218;589;350;1087
313320;202005;2077;5517;1485;4545;262;914;617;1898;879;2812
313330;202005;4014;10548;3019;9039;170;656;1962;5830;2132;6486
313340;202005;1372;3083;959;2513;87;242;665;1737;752;1979
313350;202005;2564;7231;1640;5079;223;754;593;1613;816;2367
313360;202005;1416;3452;967;2736;152;531;511;1332;663;1863
313370;202005;1373;3872;1138;3413;128;462;646;1784;774;2246
313375;202005;1684;4403;1016;3143;185;631;220;633;405;1264
313380;202005;6059;15184;4288;11926;767;2388;1986;4921;2753;7309
313390;202005;800;2566;691;2382;49;233;461;1520;510;1753
313400;202005;3677;9089;2826;7910;157;489;2172;5985;2329;6474
313410;202005;1289;3357;987;2817;53;180;731;2038;784;2218
313420;202005;15006;33240;7456;20498;1674;5145;1087;2921;2761;8066
313430;202005;927;2724;700;2253;124;487;292;824;416;1311
313440;202005;6164;13427;4018;10582;388;1065;2455;6475;2843;7540
313450;202005;700;1888;482;1439;78;246;171;440;249;686
313460;202005;2059;5915;1630;5237;328;1195;768;2336;1096;3531
313470;202005;2825;7249;2215;6343;251;704;1436;4172;1687;4876
313480;202005;994;2852;544;1823;72;269;161;490;233;759
313490;202005;2501;6042;1166;3633;302;1044;187;579;489;1623
313500;202005;495;1402;372;1128;47;142;148;418;195;560
313505;202005;9837;26136;8358;24117;337;1182;6729;19405;7066;20587
313507;202005;1446;3772;1175;3354;27;113;953;2655;980;2768
313510;202005;13375;36928;10438;31232;1235;3911;4969;14510;6204;18421
313520;202005;14003;39619;11089;34561;589;2230;8217;25023;8806;27253
313530;202005;518;1532;386;1247;47;161;151;443;198;604
313535;202005;2346;6506;1957;5745;264;703;1194;3510;1458;4213
313540;202005;751;2222;596;1846;108;342;248;721;356;1063
313545;202005;1137;3742;946;3344;150;558;509;1738;659;2296
313550;202005;1713;5230;1402;4496;314;1131;711;2169;1025;3300
313560;202005;2630;5210;1957;4388;61;117;1646;3717;1707;3834
313570;202005;952;2799;779;2480;189;628;319;973;508;1601
313580;202005;5513;14536;4214;12350;488;1527;2408;7146;2896;8673
313590;202005;999;2838;802;2559;203;679;364;1234;567;1913
313600;202005;3947;10584;3272;9532;94;385;2737;7821;2831;8206
313610;202005;1022;2569;826;2239;87;267;528;1355;615;1622
313620;202005;5422;14327;4214;12115;538;1712;2387;6630;2925;8342
313630;202005;8463;20361;5901;16498;589;1913;3531;9666;4120;11579
313640;202005;1056;2419;666;1916;141;434;291;840;432;1274
313650;202005;1702;5075;1347;4473;93;366;890;2984;983;3350
313652;202005;738;2327;662;2167;109;380;414;1324;523;1704
313655;202005;1124;2856;886;2549;46;139;689;1979;735;2118
313657;202005;1170;3129;922;2739;39;151;675;1893;714;2044
313660;202005;864;2416;694;2107;76;274;432;1238;508;1512
313665;202005;4607;12350;3537;10412;409;1356;2170;6102;2579;7458
313670;202005;48076;117426;30125;86890;4491;14210;13106;35786;17597;49996
313680;202005;1009;2700;826;2404;60;205;552;1556;612;1761
313690;202005;796;2460;614;2122;152;583;162;537;314;1120
313695;202005;1773;4863;1346;4152;85;273;904;2794;989;3067
313700;202005;2873;9188;2468;8646;250;898;1841;6481;2091;7379
313710;202005;1360;3156;976;2643;75;208;648;1773;723;1981
313720;202005;5279;14572;3623;11099;578;1977;1471;4090;2049;6067
313730;202005;1290;2941;972;2507;79;180;640;1649;719;1829
313740;202005;1608;5741;1316;4980;313;1363;231;754;544;2117
313750;202005;1951;5207;1481;4365;260;850;708;1956;968;2806
313753;202005;2152;5122;1429;3955;144;433;792;2133;936;2566
313760;202005;5014;13827;3725;11340;784;2624;1600;4536;2384;7160
313770;202005;3888;10976;3062;9635;197;662;2258;7192;2455;7854
313780;202005;3959;10584;2841;8680;233;843;826;2585;1059;3428
313790;202005;477;1486;425;1391;50;184;240;763;290;947
313800;202005;1348;3102;976;2568;124;380;526;1314;650;1694
313810;202005;1550;3993;1226;3532;49;192;946;2653;995;2845
313820;202005;17451;44163;10865;30211;1717;5052;3004;8057;4721;13109
313830;202005;373;1063;256;788;47;156;84;239;131;395
313835;202005;899;2655;738;2357;59;241;413;1235;472;1476
313840;202005;6780;17678;4966;14641;1235;3855;1048;3168;2283;7023
313850;202005;963;2340;763;2070;137;454;367;875;504;1329
313860;202005;2502;6743;1858;5525;294;1000;772;2101;1066;3101
313862;202005;1349;2844;642;1805;40;116;310;872;350;988
313865;202005;2495;6677;2052;5951;84;263;1546;4400;1630;4663
313867;202005;1272;3816;1049;3398;144;463;672;2226;816;2689
313868;202005;1679;5175;1374;4554;43;218;1054;3382;1097;3600
313870;202005;727;1962;518;1577;92;292;195;544;287;836
313880;202005;1632;4290;1196;3553;161;540;568;1493;729;2033
313890;202005;2015;4395;1509;3734;46;153;1119;2699;1165;2852
313900;202005;4037;11719;2873;9320;738;2643;697;2056;1435;4699
313910;202005;629;1854;472;1556;96;344;105;333;201;677
313920;202005;2898;8951;2416;7937;495;1606;1195;3964;1690;5570
313925;202005;1559;3945;1245;3387;185;491;807;2175;992;2666
313930;202005;4571;13873;3690;12275;273;1038;2399;7887;2672;8925
313940;202005;8490;24641;6063;20403;781;3214;1462;5426;2243;8640
313950;202005;5066;11335;3659;9590;411;1339;2183;5685;2594;7024
313960;202005;5657;13742;3764;10546;713;2274;1278;3270;1991;5544
313970;202005;1472;3993;1228;3581;18;59;789;2251;807;2310
313980;202005;1332;3445;867;2715;134;489;342;1005;476;1494
313990;202005;1863;5968;1322;4710;340;1399;406;1258;746;2657
314000;202005;9329;24082;7810;21487;565;1998;5213;14178;5778;16176
314010;202005;1458;3510;1135;3068;47;159;858;2247;905;2406
314015;202005;1858;5161;1398;4372;186;686;735;2255;921;2941
314020;202005;448;1218;291;948;64;252;59;206;123;458
314030;202005;785;2262;621;1947;58;185;332;1027;390;1212
314040;202005;615;1656;489;1422;73;244;263;733;336;977
314050;202005;1751;4668;1257;3754;148;524;656;1821;804;2345
314053;202005;1783;5314;1426;4600;276;886;746;2494;1022;3380
314055;202005;2256;6083;1897;5519;42;162;1554;4513;1596;4675
314060;202005;1270;3365;951;2857;33;127;673;1994;706;2121
314070;202005;4515;12464;3501;10609;720;2179;1522;4556;2242;6735
314080;202005;2051;5349;1382;4198;182;655;582;1588;764;2243
314085;202005;2080;5918;1690;5307;227;749;958;3070;1185;3819
314090;202005;4515;12212;3852;11227;239;912;2444;7233;2683;8145
314100;202005;3112;7398;2396;6407;42;121;1800;4827;1842;4948
314110;202005;4489;12721;3630;11068;402;1439;2097;5992;2499;7431
314120;202005;766;1788;310;931;64;233;68;187;132;420
314130;202005;604;1557;371;1140;23;97;229;696;252;793
314140;202005;4444;12697;3487;10834;472;1553;1738;5297;2210;6850
314150;202005;1469;3675;1073;2991;84;241;717;1942;801;2183
314160;202005;2124;5629;1541;4567;211;687;661;1968;872;2655
314170;202005;916;2591;733;2228;44;168;481;1374;525;1542
314180;202005;5338;14855;4296;13165;362;1196;2589;7944;2951;9140
314190;202005;610;1514;426;1236;79;262;199;513;278;775
314200;202005;2926;8194;2390;7277;146;508;1698;5023;1844;5531
314210;202005;1962;5173;1543;4402;176;510;772;2167;948;2677
314220;202005;1321;3616;940;2952;203;725;351;1012;554;1737
314225;202005;1072;3019;881;2714;76;198;631;2004;707;2202
314230;202005;755;1959;614;1784;74;246;398;1183;472;1429
314240;202005;1000;2721;767;2358;188;595;292;918;480;1513
314250;202005;501;1404;314;1023;48;156;114;340;162;496
314260;202005;925;2521;718;2238;159;535;398;1207;557;1742
314270;202005;3276;9282;2686;8359;78;327;1970;6079;2048;6406
314280;202005;3366;7826;2218;6066;264;803;1188;3094;1452;3897
314290;202005;4416;11467;3596;9997;289;832;2454;6686;2743;7518
314300;202005;1892;5427;1223;3976;249;902;397;1219;646;2121
314310;202005;4059;10507;2673;8121;856;2848;430;1155;1286;4003
314315;202005;895;3100;763;2828;50;238;537;1921;587;2159
314320;202005;2871;7856;1844;5892;334;1165;687;2125;1021;3290
314330;202005;48981;137193;36763;115271;9811;32179;7558;24988;17369;57167
314340;202005;2358;5828;1419;4136;276;932;367;906;643;1838
314345;202005;1378;4098;1113;3616;154;508;644;2075;798;2583
314350;202005;804;2197;510;1663;111;387;120;341;231;728
314360;202005;558;1611;336;1124;50;189;108;322;158;511
314370;202005;723;1923;575;1698;38;122;410;1172;448;1294
314380;202005;1116;3041;741;2362;163;595;158;480;321;1075
314390;202005;13075;33133;8411;24594;1601;5087;2692;7090;4293;12177
314400;202005;3917;11694;2939;9791;754;2594;1089;3775;1843;6369
314410;202005;2658;7398;1821;5838;246;902;620;2108;866;3010
314420;202005;821;2030;588;1646;40;151;393;1030;433;1181
314430;202005;7714;18888;5336;14867;807;2377;2473;6560;3280;8937
314435;202005;1748;4654;1376;4025;54;199;1014;2899;1068;3098
314437;202005;896;2302;648;1880;70;222;317;909;387;1131
314440;202005;611;1744;429;1367;120;419;86;228;206;647
314450;202005;1383;3694;1154;3338;114;382;674;1867;788;2249
314460;202005;3222;9791;2324;7883;594;2129;544;1778;1138;3907
314465;202005;2158;6256;1831;5631;47;184;1407;4181;1454;4365
314467;202005;895;2348;754;2121;24;68;604;1655;628;1723
314470;202005;2124;6108;1700;5233;293;999;788;2256;1081;3255
314480;202005;6351;18133;4568;14350;765;2673;1662;4630;2427;7303
314490;202005;1054;2837;768;2235;70;215;465;1301;535;1516
314500;202005;1691;4052;1199;3359;302;833;420;1227;722;2060
314505;202005;2006;4932;1625;4387;101;290;1177;3094;1278;3384
314510;202005;1869;4891;1314;4036;257;893;593;1782;850;2675
314520;202005;4927;15103;3602;12284;740;2760;448;1355;1188;4115
314530;202005;5329;17219;4763;16120;315;1337;3496;11560;3811;12897
314535;202005;2493;6525;2002;5810;86;314;1528;4386;1614;4700
314537;202005;1079;3072;826;2662;46;177;591;1869;637;2046
314540;202005;381;956;253;732;17;60;142;393;159;453
314545;202005;1831;4447;1634;4217;33;97;1412;3741;1445;3838
314550;202005;631;1564;470;1334;36;134;259;669;295;803
314560;202005;4070;12321;2983;9858;471;1735;1028;3075;1499;4810
314570;202005;293;809;215;662;27;99;94;289;121;388
314580;202005;437;1303;341;1106;82;275;117;370;199;645
314585;202005;638;2001;479;1642;67;285;208;690;275;975
314587;202005;1989;5405;1493;4604;200;580;851;2703;1051;3283
314590;202005;3824;10499;2703;8353;373;1303;1160;3325;1533;4628
314600;202005;1870;5101;1083;3582;211;757;133;408;344;1165
314610;202005;8599;21511;5952;17550;1002;3518;2481;7497;3483;11015
314620;202005;2203;5181;1734;4584;38;130;1442;3790;1480;3920
314625;202005;1503;4157;1282;3852;32;193;1105;3236;1137;3429
314630;202005;5233;13462;4254;12152;105;445;3560;10167;3665;10612
314640;202005;660;1582;473;1291;64;202;262;671;326;873
314650;202005;815;1874;491;1369;46;145;267;658;313;803
314655;202005;1573;4348;1106;3496;165;518;538;1680;703;2198
314660;202005;322;733;205;520;14;30;133;324;147;354
314670;202005;1603;3685;1100;2964;17;53;728;1936;745;1989
314675;202005;1669;4453;1417;4027;75;252;1102;3044;1177;3296
314690;202005;2039;5693;1555;4965;414;1466;537;1672;951;3138
314700;202005;9789;27425;6337;20701;1220;4398;1903;6064;3123;10462
314710;202005;7523;21087;5378;16559;910;3092;1843;4965;2753;8057
314720;202005;2022;5947;1375;4604;295;1112;357;1120;652;2232
314730;202005;2218;5811;1600;4680;256;835;661;1776;917;2611
314740;202005;2862;8110;2212;6922;288;975;1108;3380;1396;4355
314750;202005;294;797;225;657;27;92;136;358;163;450
314760;202005;1892;5672;1210;4076;190;744;309;817;499;1561
314770;202005;1077;3151;566;1829;47;170;170;505;217;675
314780;202005;347;814;232;639;40;135;126;304;166;439
314790;202005;10128;27172;6845;21059;1453;5185;2302;6535;3755;11720
314795;202005;1459;3882;1223;3461;28;120;970;2640;998;2760
314800;202005;10438;26443;6143;18429;1127;3759;1457;3855;2584;7614
314810;202005;8616;22751;6229;18555;1533;4943;2138;6062;3671;11005
314820;202005;1188;2880;927;2490;51;197;597;1525;648;1722
314830;202005;1452;4430;1205;3955;217;800;582;1854;799;2654
314840;202005;837;2648;660;2361;47;236;467;1602;514;1838
314850;202005;1982;4715;1608;4234;38;125;1398;3702;1436;3827
314860;202005;3140;9269;2586;8251;195;795;1774;5506;1969;6301
314870;202005;6264;15875;4723;13811;278;901;3486;10280;3764;11181
314875;202005;1740;5189;1509;4884;113;297;1212;4010;1325;4307
314880;202005;818;2003;626;1707;30;83;379;1043;409;1126
314890;202005;415;1232;314;1016;50;183;133;409;183;592
314900;202005;705;1904;547;1622;92;318;233;634;325;952
314910;202005;1621;4602;1192;3899;210;801;576;1769;786;2570
314915;202005;2162;6438;1808;5816;115;383;1190;3774;1305;4157
314920;202005;462;1198;294;939;7;22;196;642;203;664
314930;202005;5242;14784;3887;12234;672;2320;1533;4509;2205;6829
314940;202005;393;993;323;872;31;81;210;533;241;614
314950;202005;488;1245;318;960;25;101;167;450;192;551
314960;202005;831;1984;637;1666;27;85;451;1109;478;1194
314970;202005;888;2573;672;2126;137;473;284;818;421;1291
314980;202005;1458;3747;1066;3166;189;643;505;1468;694;2111
314990;202005;2333;6692;1608;5057;331;1108;337;955;668;2063
314995;202005;1562;4371;1231;3770;39;174;819;2381;858;2555
315000;202005;1100;2801;779;2306;62;200;511;1493;573;1693
315010;202005;371;1033;281;875;46;166;132;388;178;554
315015;202005;2231;6295;1931;5787;188;629;1275;3759;1463;4388
315020;202005;789;2304;551;1758;71;281;237;689;308;970
315030;202005;572;1528;384;1177;87;268;84;234;171;502
315040;202005;808;2272;652;1998;85;282;398;1207;483;1489
315050;202005;1191;3089;849;2537;48;175;452;1320;500;1495
315053;202005;1084;2830;824;2373;51;164;483;1330;534;1494
315057;202005;1705;5167;1382;4598;139;467;926;3107;1065;3574
315060;202005;535;1621;391;1342;74;265;101;329;175;594
315070;202005;510;1345;346;1057;81;275;90;256;171;531
315080;202005;2884;8143;2198;6814;237;817;1378;4062;1615;4879
315090;202005;773;2344;559;1927;83;307;221;741;304;1048
315100;202005;1314;3852;849;2783;140;545;378;1093;518;1638
315110;202005;1782;4343;1281;3568;133;352;639;1844;772;2196
315120;202005;11761;27608;8615;22832;1148;2838;4659;12802;5807;15640
315130;202005;1525;4179;1258;3715;134;456;526;1448;660;1904
315140;202005;2911;8073;2230;6832;396;1317;1115;3244;1511;4561
315150;202005;4272;10262;2970;8158;458;1474;1395;3721;1853;5195
315160;202005;1693;4171;1108;3226;241;744;491;1421;732;2165
315170;202005;1345;4291;918;3247;219;851;214;725;433;1576
315180;202005;16275;39291;8464;24872;1155;3859;2623;6776;3778;10635
315190;202005;2177;4763;1681;4109;194;466;1237;3058;1431;3524
315200;202005;3818;10900;2730;8941;783;2747;723;2275;1506;5022
315210;202005;8236;21496;5557;15761;659;2030;2757;7086;3416;9116
315213;202005;1094;2871;939;2664;21;73;779;2178;800;2251
315217;202005;2742;7999;2069;6867;90;451;1425;4507;1515;4958
315220;202005;8335;22653;6505;19388;1145;3632;2747;8194;3892;11826
315230;202005;3048;7155;2541;6493;193;279;1939;5295;2132;5574
315240;202005;2413;7115;2029;6435;461;1517;975;3097;1436;4614
315250;202005;12269;33233;8664;26323;1397;4617;3664;10637;5061;15254
315260;202005;897;2490;475;1571;78;261;37;101;115;362
315270;202005;821;2348;580;1885;80;277;204;568;284;845
315280;202005;2881;7189;1691;5033;421;1365;263;759;684;2124
315290;202005;1151;2818;672;2055;189;645;193;559;382;1204
315300;202005;616;1502;421;1218;85;275;212;613;297;888
315310;202005;1247;3510;918;2877;76;267;514;1528;590;1795
315320;202005;648;1894;451;1490;68;269;193;582;261;851
315330;202005;738;2534;400;1607;65;303;124;448;189;751
315340;202005;2948;7153;2109;5946;261;770;1134;3178;1395;3948
315350;202005;1531;4175;1182;3633;161;578;661;2007;822;2585
315360;202005;1644;4873;1219;3966;192;673;487;1493;679;2166
315370;202005;467;1359;366;1152;68;208;147;451;215;659
315380;202005;189;555;139;446;39;136;30;68;69;204
315390;202005;1028;2929;812;2524;146;524;366;1046;512;1570
315400;202005;3879;10691;3036;9160;428;1360;1639;4764;2067;6124
315410;202005;2274;5261;1695;4421;469;1311;252;694;721;2005
315415;202005;1340;3662;1073;3258;219;779;425;1308;644;2087
315420;202005;1337;3796;904;2953;180;615;180;564;360;1179
315430;202005;3554;8656;2488;7039;442;1470;1082;2851;1524;4321
315440;202005;999;2649;796;2317;60;201;478;1322;538;1523
315445;202005;1934;4675;1374;3879;86;290;999;2772;1085;3062
315450;202005;2176;6140;1773;5487;224;680;1094;3398;1318;4078
315460;202005;34823;97463;28542;86154;4486;15294;15288;43512;19774;58806
315470;202005;613;1738;434;1294;31;101;251;716;282;817
315480;202005;1160;3338;811;2583;155;523;264;812;419;1335
315490;202005;2888;7290;1981;5822;286;863;720;2048;1006;2911
315500;202005;519;1386;315;936;41;146;161;422;202;568
315510;202005;1208;3172;1020;2904;24;104;886;2482;910;2586
315520;202005;972;2709;781;2377;53;200;588;1738;641;1938
315530;202005;571;1607;455;1412;133;474;225;642;358;1116
315540;202005;1371;3725;953;2931;99;367;431;1291;530;1658
315550;202005;1908;4963;1229;3698;258;892;303;895;561;1787
315560;202005;6206;18872;5220;17051;297;940;3489;11626;3786;12566
315570;202005;1978;5374;1574;4708;88;325;930;2709;1018;3034
315580;202005;2633;6252;1949;5187;273;861;755;1890;1028;2751
315590;202005;875;2236;671;1907;73;259;372;978;445;1237
315600;202005;2417;7652;1724;6261;256;891;898;3408;1154;4299
315610;202005;918;2354;676;1895;102;359;299;726;401;1085
315620;202005;485;1310;359;1118;46;171;209;656;255;827
315630;202005;1009;2691;745;2209;131;404;326;888;457;1292
315640;202005;348;865;258;753;27;103;156;432;183;535
315645;202005;968;2493;652;1969;154;506;164;474;318;980
315650;202005;1713;4123;1365;3636;35;110;1113;2881;1148;2991
315660;202005;2427;5973;1814;4913;106;318;1284;3345;1390;3663
315670;202005;13129;36050;9917;30190;1962;6254;4441;13019;6403;19273
315680;202005;3043;8864;2215;7275;301;1128;1136;3547;1437;4675
315690;202005;3217;7834;1869;5489;402;1195;565;1791;967;2986
315700;202005;7857;21824;5893;17835;934;3009;2655;7697;3589;10706
315710;202005;1818;4526;1277;3702;41;181;907;2524;948;2705
315720;202005;4262;11884;3589;10683;172;700;2565;7317;2737;8017
315725;202005;2094;5519;1589;4642;170;480;1011;3073;1181;3553
315727;202005;543;1412;404;1184;53;183;162;458;215;641
315730;202005;554;1735;486;1588;82;304;186;570;268;874
315733;202005;1138;2889;805;2316;117;408;313;857;430;1265
315737;202005;1135;3231;888;2737;26;109;640;1892;666;2001
315740;202005;822;2282;652;1940;71;247;420;1166;491;1413
315750;202005;1256;3316;981;2864;90;279;595;1773;685;2052
315760;202005;1103;2640;971;2468;38;110;822;2049;860;2159
315765;202005;1870;4994;1531;4553;26;114;1347;3984;1373;4098
315770;202005;1003;2774;764;2438;317;1112;156;407;473;1519
315780;202005;27710;75840;23126;67817;1326;4823;16088;45297;17414;50120
315790;202005;3520;10916;2981;9876;392;1362;1767;5945;2159;7307
315800;202005;1199;4246;860;3349;131;583;259;896;390;1479
315810;202005;1296;3215;1050;2788;58;196;810;2054;868;2250
315820;202005;2520;6886;2036;6176;170;630;1418;4247;1588;4877
315830;202005;1186;3517;806;2695;86;314;283;875;369;1189
315840;202005;817;1981;557;1519;44;139;275;688;319;827
315850;202005;1151;3411;904;2959;181;639;441;1355;622;1994
315860;202005;456;1318;313;1053;68;239;92;278;160;517
315870;202005;453;1184;361;1041;19;65;260;712;279;777
315880;202005;1054;2755;690;2107;95;363;162;468;257;831
315890;202005;1661;4768;1331;4308;327;1159;659;2102;986;3261
315895;202005;5974;16110;4455;13137;429;1414;2322;6366;2751;7780
315900;202005;801;2051;687;1885;58;177;517;1374;575;1551
315910;202005;500;1414;421;1289;56;190;293;876;349;1066
315920;202005;1442;3647;782;2390;123;447;243;682;366;1129
315930;202005;1064;2411;703;1895;129;336;302;828;431;1164
315935;202005;780;2354;610;2025;119;416;212;702;331;1118
315940;202005;578;1614;460;1430;48;162;246;730;294;892
315950;202005;1158;3199;951;2860;82;242;731;2195;813;2437
315960;202005;4813;13544;3040;9943;925;3423;251;510;1176;3933
315970;202005;611;1623;481;1452;63;214;316;956;379;1170
315980;202005;4251;9199;2303;6013;414;1149;845;2016;1259;3165
315990;202005;3587;9110;2787;7748;263;789;1595;4295;1858;5084
316000;202005;561;1437;414;1223;52;191;198;547;250;738
316010;202005;832;2204;611;1832;42;145;382;1063;424;1208
316020;202005;890;2751;717;2410;84;334;420;1322;504;1656
316030;202005;2699;7624;2031;6421;234;766;1286;4112;1520;4878
316040;202005;2358;6660;1713;5450;310;1113;422;1159;732;2272
316045;202005;2047;5332;1876;5125;73;153;1618;4549;1691;4702
316050;202005;357;995;272;849;32;111;157;466;189;577
316060;202005;653;1645;473;1379;19;84;330;923;349;1007
316070;202005;5176;14445;4192;12565;728;2252;1977;5768;2705;8020
316080;202005;721;2268;561;1940;142;509;80;255;222;764
316090;202005;398;1146;291;928;40;147;140;415;180;562
316095;202005;1264;3939;1002;3276;269;916;325;1040;594;1956
316100;202005;2378;6979;1702;5537;307;1097;628;1867;935;2964
316105;202005;799;2159;652;1917;38;132;451;1355;489;1487
316110;202005;13305;38860;11069;35064;791;2939;7506;23474;8297;26413
316120;202005;1176;3365;745;2347;114;374;223;573;337;947
316130;202005;1255;2854;795;2091;60;187;456;1170;516;1357
316140;202005;1180;3148;753;2357;94;327;374;1139;468;1466
316150;202005;1812;3947;1474;3511;173;530;618;1417;791;1947
316160;202005;969;2663;796;2362;40;145;546;1565;586;1710
316165;202005;830;2081;633;1763;94;312;335;861;429;1173
316170;202005;1137;2803;854;2380;53;197;592;1562;645;1759
316180;202005;1310;3706;862;2765;141;545;156;453;297;998
316190;202005;2533;7185;1474;4673;214;715;557;1574;771;2289
316200;202005;3145;9048;2321;7592;571;1996;546;1727;1117;3723
316210;202005;4381;12878;3163;10110;1155;3983;190;500;1345;4483
316220;202005;577;1762;382;1313;95;374;41;160;136;534
316225;202005;1515;3464;1119;2819;49;192;842;1963;891;2155
316230;202005;398;1092;302;924;35;114;172;531;207;645
316240;202005;5534;16003;4839;14795;370;1216;3651;10988;4021;12204
316245;202005;2918;9530;2622;9020;122;707;2029;6654;2151;7361
316250;202005;9716;23477;6994;19153;1484;4481;2488;6764;3972;11245
316255;202005;2932;8116;2551;7498;117;362;1915;5695;2032;6057
316257;202005;1333;3274;947;2593;130;364;522;1370;652;1734
316260;202005;2048;5254;1556;4417;172;490;825;2402;997;2892
316265;202005;1123;3012;865;2576;20;71;635;1840;655;1911
316270;202005;3572;11103;3047;9933;491;1724;1455;4521;1946;6245
316280;202005;2781;8054;2357;7250;324;1081;1311;3929;1635;5010
316290;202005;3373;9263;2681;7994;295;1034;1148;3306;1443;4340
316292;202005;4850;12974;3871;11323;485;1550;2511;7058;2996;8608
316294;202005;785;2342;574;1968;105;415;149;479;254;894
316295;202005;3000;8406;2433;7426;138;518;1716;4994;1854;5512
316300;202005;969;2789;791;2508;45;160;571;1798;616;1958
316310;202005;770;2061;502;1587;102;381;86;231;188;612
316320;202005;635;1781;488;1545;55;212;228;701;283;913
316330;202005;1072;2795;808;2327;54;190;601;1668;655;1858
316340;202005;976;2668;726;2212;68;276;415;1189;483;1465
316350;202005;1265;3593;1045;3240;90;308;733;2235;823;2543
316360;202005;608;1617;491;1419;47;145;360;1018;407;1163
316370;202005;4778;12864;3488;10489;674;2338;1256;3343;1930;5681
316380;202005;1692;4051;1319;3520;49;106;931;2498;980;2604
316390;202005;794;2117;556;1696;225;784;97;265;322;1049
316400;202005;1143;3229;733;2404;112;405;238;710;350;1115
316410;202005;1083;3061;903;2794;56;184;715;2170;771;2354
316420;202005;1905;5225;1652;4892;48;187;1363;3952;1411;4139
316430;202005;831;2200;524;1650;91;320;165;483;256;803
316440;202005;822;2495;646;2174;110;425;159;487;269;912
316443;202005;524;1453;381;1178;101;359;80;225;181;584
316447;202005;1923;5175;1680;4772;28;108;1444;4025;1472;4133
316450;202005;2093;6394;1590;5345;210;772;952;3109;1162;3881
316460;202005;1104;2822;880;2459;123;387;556;1457;679;1844
316470;202005;6557;18818;4629;14724;769;2783;1769;5158;2538;7941
316480;202005;198;544;164;495;44;130;76;225;120;355
316490;202005;316;848;224;684;35;113;83;210;118;323
316500;202005;1142;3596;756;2662;156;611;170;566;326;1177
316510;202005;722;2366;577;2085;113;429;271;983;384;1412
316520;202005;1162;2865;885;2414;115;396;458;1146;573;1542
316530;202005;1077;2821;776;2280;83;335;399;1028;482;1363
316540;202005;815;2124;631;1839;109;364;302;800;411;1164
316550;202005;1345;3924;1147;3539;53;189;892;2734;945;2923
316553;202005;3987;11908;2767;8871;447;1601;970;2747;1417;4348
316555;202005;2413;7814;2185;7497;108;394;1790;6208;1898;6602
316556;202005;531;1302;380;1039;30;84;209;521;239;605
316557;202005;1003;3150;858;2905;292;1062;270;896;562;1958
316560;202005;330;914;226;757;50;213;71;202;121;415
316570;202005;1188;3473;970;3067;234;749;352;1135;586;1884
316580;202005;381;808;218;540;35;104;109;254;144;358
316590;202005;1298;3379;912;2623;181;469;461;1294;642;1763
316600;202005;919;2845;783;2567;123;437;424;1363;547;1800
316610;202005;591;1855;480;1676;55;239;286;974;341;1213
316620;202005;1971;5345;1725;4999;88;283;1345;3895;1433;4178
316630;202005;1517;4578;1236;4047;324;1079;498;1752;822;2831
316640;202005;140;367;109;320;16;53;51;124;67;177
316650;202005;1009;3232;806;2911;74;298;499;1827;573;2125
316660;202005;179;453;77;240;7;24;12;35;19;59
316670;202005;1773;4513;1298;3732;304;955;480;1345;784;2300
316680;202005;2229;5679;1630;4536;92;283;1251;3387;1343;3670
316690;202005;1350;3849;1007;3223;174;609;462;1434;636;2043
316695;202005;1010;2931;825;2595;31;128;566;1748;597;1876
316700;202005;400;933;331;845;14;47;260;626;274;673
316710;202005;2938;9665;2233;8183;462;1811;876;3195;1338;5006
316720;202005;19738;54116;14319;43663;2547;8269;6014;17476;8561;25745
316730;202005;413;1133;331;973;42;143;172;472;214;615
316740;202005;711;2088;612;1926;64;234;392;1240;456;1474
316750;202005;373;1130;287;968;56;222;135;419;191;641
316760;202005;3466;11060;2820;9758;1127;4228;614;2000;1741;6228
316770;202005;1596;3673;1221;3145;25;75;995;2636;1020;2711
316780;202005;544;1627;418;1375;163;599;65;181;228;780
316790;202005;674;1822;472;1418;96;313;143;386;239;699
316800;202005;6014;17052;4781;14786;482;1722;2502;7453;2984;9175
316805;202005;995;2207;800;1994;57;160;620;1557;677;1717
316810;202005;612;1712;410;1294;77;281;209;616;286;897
316820;202005;301;718;166;474;9;29;82;219;91;248
316830;202005;704;1916;556;1674;67;239;354;1027;421;1266
316840;202005;2683;7027;2131;6082;187;668;1459;3962;1646;4630
316850;202005;1880;4973;1337;3973;211;674;593;1718;804;2392
316860;202005;18836;48551;13809;40995;2230;7685;6276;18169;8506;25854
316870;202005;7714;21070;5702;17169;859;2860;2556;7164;3415;10024
316880;202005;820;2227;662;2007;134;460;312;893;446;1353
316890;202005;1123;2495;651;1854;97;351;384;990;481;1341
316900;202005;2180;5900;1666;4858;342;1087;543;1469;885;2556
316905;202005;519;1549;418;1349;110;383;162;532;272;915
316910;202005;888;2333;537;1703;133;467;45;132;178;599
316920;202005;1703;4214;1168;3399;220;696;516;1458;736;2154
316930;202005;7206;20917;5224;17272;1170;4163;1381;4350;2551;8513
316935;202005;3929;10701;2840;8644;514;1693;1132;3308;1646;5001
316940;202005;6273;18529;4763;15364;725;2598;1854;5551;2579;8149
316950;202005;1820;4321;1411;3760;43;137;1168;3065;1211;3202
316960;202005;5007;11322;3588;9360;346;995;2417;6154;2763;7149
316970;202005;3626;10384;3146;9472;490;1547;1345;3867;1835;5414
316980;202005;657;1960;495;1648;162;604;64;229;226;833
316990;202005;10808;29294;7612;22707;2055;6634;1152;3057;3207;9691
317000;202005;2515;7428;2208;6977;165;491;1631;5190;1796;5681
317005;202005;2542;7265;2004;6151;324;1057;1047;3150;1371;4207
317010;202005;23782;55803;14483;41512;2942;9284;5390;15957;8332;25241
317020;202005;62630;148795;35549;101478;6461;20295;10857;28641;17318;48936
317030;202005;668;1779;515;1569;18;83;398;1196;416;1279
317040;202005;10848;27504;7500;21698;1641;5141;2693;7978;4334;13119
317043;202005;838;1883;591;1540;53;144;426;1099;479;1243
317047;202005;1164;2797;804;2220;87;243;497;1327;584;1570
317050;202005;1149;3537;801;2726;107;382;333;1002;440;1384
317052;202005;2350;6595;1891;5845;278;849;1159;3593;1437;4442
317057;202005;1795;4361;1308;3554;35;139;847;2276;882;2415
317060;202005;476;1264;292;886;32;99;128;349;160;448
317065;202005;1153;3399;936;2974;58;199;580;1734;638;1933
317070;202005;7386;20247;5115;15869;974;3415;1451;4252;2425;7667
317075;202005;897;2331;642;1889;105;346;280;749;385;1095
317080;202005;5975;14070;4385;11517;1184;3351;1422;3591;2606;6942
317090;202005;4461;13307;3958;12481;308;943;2919;9252;3227;10195
317100;202005;2647;6304;1669;4658;378;1102;613;1662;991;2764
317103;202005;2092;5769;1772;5267;90;418;1339;3795;1429;4213
317107;202005;1405;3745;1067;3091;75;270;656;1694;731;1964
317110;202005;711;1645;361;1099;54;192;121;383;175;575
317115;202005;1068;3059;904;2756;53;148;620;1897;673;2045
317120;202005;12971;35368;10172;30804;1112;3937;5894;17253;7006;21190
317130;202005;10855;25296;6749;18506;1091;3344;2226;6075;3317;9419
317140;202005;823;2002;628;1710;39;109;437;1224;476;1333
317150;202005;994;2364;741;2047;32;95;581;1578;613;1673
317160;202005;3532;8556;2296;6567;174;543;1270;3705;1444;4248
317170;202005;1809;4494;1300;3631;219;725;534;1284;753;2009
317180;202005;1930;6050;1416;4809;280;1013;358;1135;638;2148
317190;202005;1200;3237;885;2744;105;342;515;1578;620;1920
317200;202005;4904;12869;3691;10765;995;3145;763;2058;1758;5203
317210;202005;1168;2867;907;2508;26;103;670;1884;696;1987
317220;202005;244;756;207;684;49;165;76;269;125;434
320010;202005;4437;12949;3548;11181;358;1252;2301;7073;2659;8325
320013;202005;1869;5190;1244;3927;199;642;552;1805;751;2447
320016;202005;2977;7634;2316;6619;169;456;1761;5057;1930;5513
320020;202005;3843;10030;2811;8236;629;2035;988;3018;1617;5053
320030;202005;1702;4749;1100;3530;207;729;389;1194;596;1923
320035;202005;1874;5172;1518;4537;377;1256;643;1867;1020;3123
320040;202005;3854;11019;3156;9723;453;1484;1766;5297;2219;6781
320050;202005;1748;3975;1497;3610;184;535;895;2069;1079;2604
320060;202005;11850;32928;8817;26981;1346;4567;4172;12130;5518;16697
320070;202005;1438;4084;997;3175;181;640;355;1085;536;1725
320080;202005;5535;14261;3870;10999;803;2431;1403;3778;2206;6209
320090;202005;8172;21906;5357;16020;1174;3777;1938;5424;3112;9201
320100;202005;2843;7923;2298;6955;382;1305;1215;3639;1597;4944
320110;202005;1992;4676;1322;3584;192;543;631;1649;823;2192
320115;202005;1782;5740;1516;5294;643;2366;422;1523;1065;3889
320120;202005;21424;55027;14587;42786;2116;6758;6636;18589;8752;25347
320130;202005;43655;122085;35621;107472;4752;15843;20664;60643;25416;76486
320140;202005;3498;9602;2318;7268;350;1257;926;2872;1276;4129
320150;202005;12895;33581;8996;26017;2328;7359;1595;4128;3923;11487
320160;202005;5660;15925;4131;12954;686;2357;1916;5887;2602;8244
320170;202005;1551;4493;1118;3629;301;971;425;1454;726;2425
320180;202005;681;2170;549;1909;209;771;146;475;355;1246
320190;202005;2700;8693;2068;7279;508;1897;540;1810;1048;3707
320200;202005;1209;3265;818;2545;184;620;305;959;489;1579
320210;202005;4318;11060;3296;9272;524;1611;1756;4735;2280;6346
320220;202005;2591;6962;1926;5848;347;1166;928;2687;1275;3853
320225;202005;1329;4150;932;3190;336;1234;190;644;526;1878
320230;202005;4781;13327;3612;11357;827;2833;1391;4267;2218;7100
320240;202005;15355;39341;11292;32758;2693;8530;3822;10766;6515;19296
320245;202005;3007;8958;2372;7657;888;3014;453;1437;1341;4451
320250;202005;2114;6032;1400;4329;319;1097;395;1092;714;2189
320255;202005;1768;5585;1520;5141;419;1453;740;2604;1159;4057
320260;202005;1359;3824;823;2627;178;638;196;524;374;1162
320265;202005;2453;7594;1991;6654;924;3273;348;1163;1272;4436
320270;202005;2158;6240;1621;5187;387;1336;639;2054;1026;3390
320280;202005;6778;18230;5430;15895;1213;3806;2402;6801;3615;10607
320290;202005;1326;3964;854;2808;224;811;222;681;446;1492
320300;202005;3534;10773;2808;9273;813;2891;650;2005;1463;4896
320305;202005;5059;14396;3905;12093;745;2505;1891;5652;2636;8157
320310;202005;2000;5621;1354;4241;252;824;577;1735;829;2559
320313;202005;2334;5895;1478;4251;311;1013;381;1002;692;2015
320316;202005;1430;4049;1153;3579;176;563;708;2206;884;2769
320320;202005;21169;55834;14822;44837;3461;10983;5404;16421;8865;27404
320330;202005;2924;7970;2253;6748;426;1267;1176;3608;1602;4875
320332;202005;6554;17931;5147;15440;1266;4090;2297;6841;3563;10931
320334;202005;1657;4761;1164;3757;253;975;270;685;523;1660
320335;202005;1334;3968;918;2998;231;837;232;698;463;1535
320340;202005;4680;11808;3875;10619;495;1494;2279;6281;2774;7775
320350;202005;5268;13120;3671;10206;466;1387;1926;5098;2392;6485
320360;202005;1399;3562;1032;2872;125;341;524;1404;649;1745
320370;202005;2547;7848;1873;6363;571;2033;595;2000;1166;4033
320380;202005;2437;6602;2016;5914;236;749;1275;3648;1511;4397
320390;202005;6908;18822;5070;15137;1066;3381;2030;5728;3096;9109
320400;202005;3210;9133;2436;7488;683;2234;871;2558;1554;4792
320405;202005;4460;11852;3332;9928;554;1783;1531;4485;2085;6268
320410;202005;4726;12299;3536;10362;630;1822;1766;5401;2396;7223
320420;202005;3076;8123;2318;6818;685;2261;417;1224;1102;3485
320425;202005;2062;4973;1564;4133;94;282;1038;2661;1132;2943
320430;202005;2967;7441;2326;6272;300;899;1493;3854;1793;4753
320435;202005;2153;6741;1691;5825;601;2192;515;1794;1116;3986
320440;202005;1405;3880;1012;3129;147;483;457;1376;604;1859
320450;202005;1594;4638;1235;3951;276;998;544;1622;820;2620
320455;202005;4036;12272;2692;9096;688;2500;648;1988;1336;4488
320460;202005;2061;6102;1442;4771;349;1231;368;1133;717;2364
320465;202005;1160;3326;879;2780;125;415;493;1565;618;1980
320470;202005;3642;10063;2532;7688;577;1858;607;1644;1184;3502
320480;202005;1618;4506;1317;3995;196;676;774;2283;970;2959
320490;202005;20626;54232;15039;44336;2550;8232;6225;18176;8775;26408
320495;202005;1260;3463;870;2704;189;674;331;981;520;1655
320500;202005;51793;138069;41077;119482;5764;18193;23675;66069;29439;84262
320501;202005;4350;12635;3201;10536;906;3320;1063;3435;1969;6755
320503;202005;2287;6597;1499;4969;407;1470;437;1358;844;2828
320506;202005;2463;7368;1757;5797;540;1928;185;606;725;2534
320510;202005;9726;26427;7827;23129;875;3002;4856;13881;5731;16883
320515;202005;1699;4659;1297;3840;356;1150;439;1254;795;2404
320517;202005;2083;6326;1652;5404;542;1930;474;1520;1016;3450
320520;202005;34878;90619;25732;75167;4588;14773;10776;30517;15364;45290
320530;202005;30202;80608;23531;68761;2276;7879;14677;40632;16953;48511
330010;202005;21112;56818;17082;50003;2377;7454;10762;30873;13139;38327
330015;202005;1470;3629;1134;3111;200;621;613;1594;813;2215
330020;202005;19915;49708;16667;44979;2386;7237;11482;30240;13868;37477
330022;202005;1860;5026;1424;4264;239;737;831;2464;1070;3201
330023;202005;4923;11726;3470;9668;594;1830;1885;5125;2479;6955
330025;202005;5793;13927;3589;10128;899;2806;818;2172;1717;4978
330030;202005;10127;27179;7605;22983;829;2897;4637;13405;5466;16302
330040;202005;14449;37669;11362;32401;1094;3509;7584;20773;8678;24282
330045;202005;83373;197345;68115;178038;5097;13375;54025;140574;59122;153949
330050;202005;2444;6509;1773;5364;362;1184;840;2415;1202;3599
330060;202005;4853;12910;3913;11229;777;2472;1699;4488;2476;6960
330070;202005;22525;57105;17992;50434;2865;8542;10549;29390;13414;37932
330080;202005;8746;22175;7408;20256;930;2701;5121;13837;6051;16538
330090;202005;3471;7260;2347;5699;161;416;1609;3909;1770;4325
330093;202005;2477;6063;1821;5124;116;353;1390;3909;1506;4262
330095;202005;1225;3475;934;2917;77;290;567;1638;644;1928
330100;202005;69595;185292;58967;169413;3615;12435;44931;127210;48546;139645
330110;202005;2065;5793;1647;5076;273;925;916;2721;1189;3646
330115;202005;2494;6009;1745;4841;235;756;1000;2664;1235;3420
330120;202005;3518;7895;2607;6711;226;654;1795;4447;2021;5101
330130;202005;4220;11563;3423;10342;485;1541;2120;6351;2605;7892
330140;202005;3665;9556;2869;8395;414;1354;1825;5199;2239;6553
330150;202005;2151;5748;1623;4901;292;936;782;2303;1074;3239
330160;202005;1355;3686;1005;3062;174;577;534;1552;708;2129
330170;202005;105093;262372;83407;232812;11222;31190;55469;156945;66691;188135
330180;202005;1971;4763;1507;4106;97;301;1037;2752;1134;3053
330185;202005;9541;24088;7916;21804;492;1662;6297;16909;6789;18571
330187;202005;4264;10852;3281;9244;461;1408;1904;5325;2365;6733
330190;202005;32756;79615;27513;72389;1926;5504;21721;56475;23647;61979
330200;202005;15712;40068;12644;36257;2478;6775;7891;23298;10369;30073
330205;202005;2066;5105;1546;4265;89;292;1074;2840;1163;3132
330210;202005;3393;8555;2433;6859;349;1089;1175;3060;1524;4149
330220;202005;11531;28820;8044;22931;1722;5516;2786;7354;4508;12870
330225;202005;3811;9615;2838;8113;198;686;2029;5665;2227;6351
330227;202005;17405;41878;14496;38311;586;1730;12385;32354;12971;34084
330230;202005;1907;4316;1284;3513;115;329;787;2148;902;2477
330240;202005;23512;61201;19087;54220;2420;7525;12421;34454;14841;41979
330245;202005;1648;4101;980;2924;195;616;364;1091;559;1707
330250;202005;37433;96164;30819;86366;5461;15660;18583;52108;24044;67768
330260;202005;4565;11144;3388;9536;346;1093;2318;6327;2664;7420
330270;202005;28805;63511;17591;45800;2900;8101;7152;18007;10052;26108
330280;202005;2332;6151;1736;5124;190;617;1019;2900;1209;3517
330285;202005;22887;55224;17948;48116;1450;4534;13078;33900;14528;38434
330290;202005;3691;9026;2931;8019;319;979;2053;5458;2372;6437
330300;202005;5730;13525;4103;11162;309;956;2851;7611;3160;8567
330310;202005;2563;6369;1830;5140;121;309;1214;3412;1335;3721
330320;202005;16404;38953;12374;33907;1395;3813;8921;24555;10316;28368
330330;202005;36414;80278;27695;68586;2503;6816;19876;48369;22379;55185
330340;202005;14319;35431;10378;29220;1683;5267;5265;14183;6948;19450
330350;202005;132737;309050;107909;278686;7020;18935;87829;225841;94849;244776
330360;202005;7419;18013;6343;16693;205;553;5372;14075;5577;14628
330370;202005;4752;13647;3576;11621;827;2755;1502;5094;2329;7849
330380;202005;5332;14375;3974;11925;705;2435;1947;5570;2652;8005
330385;202005;3887;11233;3137;10122;756;2695;1492;4767;2248;7462
330390;202005;25846;69959;19413;58697;2767;9583;11051;31610;13818;41193
330395;202005;3150;7832;2576;7075;161;512;1855;4991;2016;5503
330400;202005;3293;8740;2776;7921;149;535;2086;5616;2235;6151
330410;202005;3167;8485;2250;6863;430;1440;1008;2928;1438;4368
330411;202005;2765;7471;2118;6241;143;497;1482;4213;1625;4710
330412;202005;1480;4199;1182;3706;131;483;724;2136;855;2619
330414;202005;23131;58254;18499;51918;1591;4623;13513;37643;15104;42266
330415;202005;4157;11287;3192;9605;324;1037;1900;5683;2224;6720
330420;202005;10920;27036;7458;21407;934;3045;3810;10242;4744;13287
330430;202005;9447;22734;7871;20557;322;1063;6176;15649;6498;16712
330440;202005;2435;6562;1806;5488;302;1071;1009;2929;1311;4000
330450;202005;1281;3672;1014;3219;142;495;550;1714;692;2209
330452;202005;16358;41857;12919;36577;1683;5342;8133;22374;9816;27716
330455;202005;549883;1302207;417521;1111125;59462;168771;263338;689978;322800;858749
330460;202005;1184;3231;874;2772;155;522;470;1455;625;1977
330470;202005;4796;11997;3422;9850;1093;3245;1017;3021;2110;6266
330475;202005;9459;24552;7598;22114;1190;3985;4847;13795;6037;17780
330480;202005;5889;15258;4917;13832;400;1259;3410;9324;3810;10583
330490;202005;112181;259074;90208;229527;9967;26383;64598;163205;74565;189588
330500;202005;7371;18145;6110;16409;618;1858;4423;11706;5041;13564
330510;202005;39978;99012;29305;83790;4908;15031;17686;49909;22594;64940
330513;202005;1221;3167;957;2794;208;655;473;1394;681;2049
330515;202005;2449;6465;1932;5736;367;1176;1062;3079;1429;4255
330520;202005;11212;29611;9016;26120;1196;3826;5495;15538;6691;19364
330530;202005;1654;4024;1217;3362;254;764;554;1496;808;2260
330540;202005;2876;7634;2205;6469;508;1549;942;2678;1450;4227
330550;202005;8906;23200;6734;20318;1909;6258;2697;8054;4606;14312
330555;202005;17390;37007;14324;33387;852;2223;11501;27063;12353;29286
330560;202005;4130;11053;3303;9658;505;1522;1958;5587;2463;7109
330570;202005;2687;7396;2238;6700;358;1151;1434;4260;1792;5411
330575;202005;5459;14092;4679;12760;283;884;3743;9878;4026;10762
330580;202005;16831;45129;12818;37808;2369;7589;6008;16953;8377;24542
330590;202005;1442;3902;1183;3567;220;664;731;2242;951;2906
330600;202005;11623;30717;9382;27071;908;3064;5956;16702;6864;19766
330610;202005;9208;24556;7380;21660;573;1986;5152;14716;5725;16702
330615;202005;2056;5627;1583;4974;302;976;977;3133;1279;4109
330620;202005;3998;11426;3121;9890;702;2409;1312;3906;2014;6315
330630;202005;23912;60003;18593;51656;1381;4528;13201;35488;14582;40016
350010;202005;2043;5238;1017;3043;219;710;179;389;398;1099
350020;202005;684;1752;379;1166;45;145;154;431;199;576
350030;202005;3527;9885;2580;8218;649;2254;1043;3166;1692;5420
350040;202005;709;2027;398;1352;53;208;130;345;183;553
350050;202005;1220;3028;774;2241;183;616;256;600;439;1216
350055;202005;908;2384;696;2038;76;242;401;1115;477;1357
350060;202005;160;411;97;287;12;41;49;147;61;188
350070;202005;3359;8869;2084;6531;418;1459;629;1792;1047;3251
350075;202005;565;1670;419;1375;172;605;32;101;204;706
350080;202005;646;1668;404;1231;56;191;159;434;215;625
350090;202005;584;1382;348;964;70;209;148;384;218;593
350100;202005;2240;5971;1520;4684;123;464;917;2670;1040;3134
350110;202005;476;1208;322;935;18;65;183;522;201;587
350115;202005;1257;3649;1022;3150;191;656;513;1425;704;2081
350120;202005;655;1523;355;957;37;119;186;439;223;558
350130;202005;2997;7936;2328;6707;411;1219;1138;3121;1549;4340
350140;202005;763;2164;497;1621;49;219;270;809;319;1028
350150;202005;501;1532;407;1348;94;301;111;341;205;642
350160;202005;10733;26827;7045;20121;916;2986;4215;11367;5131;14353
350170;202005;2054;5955;1609;4979;317;1039;667;1921;984;2960
350180;202005;1023;2532;509;1529;115;359;74;201;189;560
350190;202005;2799;7922;1901;5996;359;1306;786;2104;1145;3410
350200;202005;429;1224;336;1050;18;62;215;633;233;695
350210;202005;5604;12833;3751;10043;500;1446;2277;5881;2777;7327
350220;202005;2833;7794;1882;5888;413;1364;613;1743;1026;3107
350230;202005;1020;2624;833;2348;156;471;460;1255;616;1726
350240;202005;633;1845;401;1299;86;278;102;310;188;588
350250;202005;2304;6639;1707;5634;608;2194;315;1072;923;3266
350260;202005;810;1926;509;1402;56;173;307;816;363;989
350270;202005;4371;11824;3441;10031;538;1714;1799;4894;2337;6608
350275;202005;2338;6295;1839;5480;302;1005;1069;3025;1371;4030
350280;202005;18466;41371;10720;28818;1832;5223;4101;10563;5933;15786
350290;202005;3097;8538;2055;6373;376;1280;818;2359;1194;3639
350300;202005;618;1691;453;1376;67;202;233;672;300;874
350310;202005;860;2488;616;1981;107;400;232;673;339;1073
350315;202005;564;1417;365;1074;25;85;183;498;208;583
350320;202005;14782;37932;10701;30682;2300;7270;3945;10522;6245;17792
350330;202005;13984;34466;9787;26332;1066;3176;6115;15435;7181;18611
350335;202005;353;1006;271;855;34;120;132;389;166;509
350340;202005;1139;2937;673;2073;119;411;258;718;377;1129
350350;202005;733;1868;561;1674;68;248;332;967;400;1215
350360;202005;1085;3213;826;2665;220;722;253;831;473;1553
350370;202005;603;1516;409;1163;145;390;118;352;263;742
350380;202005;4182;11469;2898;8857;826;2496;710;2218;1536;4714
350390;202005;9994;26655;7715;22712;1753;5341;3302;9483;5055;14824
350395;202005;428;1101;219;691;22;67;77;219;99;286
350400;202005;7883;19441;5389;15307;1329;4078;1491;4156;2820;8234
350410;202005;9394;26204;6692;20929;1443;5040;2468;7142;3911;12182
350420;202005;680;1803;475;1383;78;259;116;294;194;553
350430;202005;648;1756;518;1540;68;238;316;862;384;1100
350440;202005;1991;5019;1601;4424;122;359;1051;2846;1173;3205
350450;202005;6592;18100;5072;15433;1118;3717;2097;5983;3215;9700
350460;202005;1699;4405;851;2646;152;502;181;492;333;994
350470;202005;251;634;194;537;10;31;135;359;145;390
350480;202005;963;2413;599;1761;124;431;128;295;252;726
350490;202005;1855;4898;1313;4008;302;953;401;1129;703;2082
350500;202005;683;1815;516;1505;68;213;257;706;325;919
350510;202005;1148;2992;848;2446;96;311;494;1367;590;1678
350520;202005;2087;6386;1595;5405;265;991;698;2149;963;3140
350530;202005;2691;6751;1957;5378;222;680;1157;2990;1379;3670
350535;202005;1380;3791;1183;3513;169;574;733;2101;902;2675
350540;202005;1846;4461;1344;3699;181;515;813;2176;994;2691
350550;202005;8280;20448;5681;16138;625;2104;3314;8763;3939;10867
350560;202005;3896;10984;3066;9479;302;998;1889;5652;2191;6650
350570;202005;24095;67242;19220;57709;3650;12006;9633;27717;13283;39723
350580;202005;2062;5588;1186;3707;306;1040;211;542;517;1582
350590;202005;4768;13006;3434;10015;478;1578;1990;5359;2468;6937
350600;202005;35453;81893;21623;57687;3226;9680;10190;25028;13416;34708
350610;202005;6575;18096;4668;14247;831;2774;2135;6189;2966;8963
350620;202005;398;1014;255;806;27;88;148;449;175;537
350630;202005;1422;3708;1031;3002;72;270;665;1807;737;2077
350635;202005;8485;21132;6341;17829;1061;3311;3575;9517;4636;12828
350640;202005;892;2443;474;1491;73;234;132;360;205;594
350650;202005;7917;21233;5295;16000;1032;3376;1910;5353;2942;8729
350660;202005;4518;11873;3449;10089;581;1720;1773;5200;2354;6920
350670;202005;1834;4870;1496;4378;156;472;1004;2940;1160;3412
350680;202005;1097;2974;719;2267;139;446;278;839;417;1285
350690;202005;1262;3256;877;2606;148;476;472;1353;620;1829
350700;202005;4637;11757;3195;9504;584;1998;1372;3830;1956;5828
350710;202005;2719;7543;2277;6756;395;1359;1227;3353;1622;4712
350715;202005;808;2318;659;2046;71;290;357;1010;428;1300
350720;202005;152;401;113;334;17;49;34;80;51;129
350730;202005;597;1596;499;1424;28;107;375;1004;403;1111
350740;202005;1572;4234;1044;3142;208;656;321;903;529;1559
350745;202005;593;1498;319;967;40;150;123;335;163;485
350750;202005;9698;25199;7276;20984;1300;4339;3265;8407;4565;12746
350760;202005;13873;34649;9781;27542;2161;6701;3844;9781;6005;16482
350770;202005;960;2407;594;1758;39;125;380;1101;419;1226
350775;202005;653;1548;439;1222;44;127;213;592;257;719
350780;202005;1993;4948;1394;4077;246;806;508;1689;754;2495
350790;202005;1611;4324;984;3161;196;682;264;695;460;1377
350800;202005;3384;9792;2898;8929;246;873;1993;5952;2239;6825
350810;202005;2651;6562;2083;5732;311;832;1165;3273;1476;4105
350820;202005;907;2140;502;1405;52;176;246;618;298;794
350830;202005;838;2354;457;1496;72;227;138;395;210;622
350840;202005;3082;9066;2242;7432;525;1930;941;2842;1466;4772
350850;202005;6778;18907;5170;15980;1064;3581;2315;6830;3379;10411
350860;202005;3542;9505;3021;8795;122;452;2288;6576;2410;7028
350870;202005;2587;7290;1877;6131;263;962;1031;3284;1294;4246
350880;202005;1235;3549;958;3000;245;792;279;839;524;1631
350890;202005;525;1352;325;936;50;151;119;314;169;465
350900;202005;6870;18660;4263;13066;984;3321;1308;3658;2292;6979
350910;202005;880;2183;749;1980;92;257;538;1393;630;1650
350920;202005;11591;28905;9667;25745;445;1456;7769;19932;8214;21388
350925;202005;4311;11754;3046;9435;586;1962;1425;4076;2011;6038
350930;202005;1461;3842;995;2917;93;285;608;1742;701;2027
350940;202005;2211;5872;1685;5005;183;602;1057;3027;1240;3629
350945;202005;827;2318;611;1897;92;339;324;917;416;1256
350950;202005;84152;217284;63736;178694;8585;26525;38344;102534;46929;129059
350960;202005;6270;17067;4825;14332;586;1998;2875;8103;3461;10101
350970;202005;3518;9956;2518;7995;755;2678;485;1318;1240;3996
350980;202005;632;1748;509;1530;133;422;226;674;359;1096
350990;202005;1725;4840;1255;4061;305;1109;433;1312;738;2421
350995;202005;749;2341;668;2177;53;213;472;1464;525;1677
351000;202005;2761;7192;1923;5694;336;1054;728;2087;1064;3141
351010;202005;321;792;212;607;26;88;114;314;140;402
351015;202005;782;2369;626;2036;93;338;295;861;388;1199
351020;202005;8655;23613;6542;19949;1367;4278;3146;9350;4513;13628
351030;202005;2770;8250;2215;7112;326;1147;1180;3696;1506;4843
351040;202005;4940;12262;4109;11004;210;685;3356;8743;3566;9428
351050;202005;16906;41283;11864;33313;2427;7210;5035;13971;7462;21181
351060;202005;48449;122040;36600;101495;3842;11724;24357;65344;28199;77068
351070;202005;1430;3546;765;2369;185;625;131;392;316;1017
351080;202005;2772;6691;1949;5706;222;787;1301;3618;1523;4405
351090;202005;321;946;228;769;49;169;61;204;110;373
351100;202005;2515;6822;1601;4934;357;1154;456;1452;813;2606
351110;202005;6121;15695;3924;11584;660;2141;1657;4580;2317;6721
351120;202005;775;1964;511;1523;58;185;194;566;252;751
351130;202005;1159;3039;515;1655;97;316;127;392;224;708
351140;202005;2021;5803;1489;4747;314;1130;588;1698;902;2828
351150;202005;2376;6816;1545;4961;267;959;595;1701;862;2660
351160;202005;1116;3465;828;2785;181;649;215;625;396;1274
351170;202005;1362;3742;1171;3394;94;295;826;2323;920;2618
351190;202005;998;2765;645;2030;121;385;230;665;351;1050
351200;202005;1581;3795;1160;3167;94;290;810;2084;904;2374
351210;202005;1506;3708;912;2571;76;255;541;1417;617;1672
351220;202005;3204;9094;2712;8279;316;1005;1779;5382;2095;6387
351230;202005;1722;4698;1251;3858;226;801;556;1564;782;2365
351240;202005;2385;6103;1430;4087;308;938;535;1367;843;2305
351250;202005;1037;2782;594;1877;78;262;212;666;290;928
351260;202005;902;2279;642;1804;131;372;243;651;374;1023
351270;202005;432;1159;359;1035;36;127;221;553;257;680
351280;202005;3709;9759;2796;8043;527;1554;1296;3607;1823;5161
351290;202005;1215;3018;831;2344;118;355;484;1312;602;1667
351300;202005;16891;46145;11310;35257;2081;7060;4715;14119;6796;21179
351310;202005;3299;8112;2464;6810;182;634;1780;4653;1962;5287
351320;202005;903;2620;657;2088;125;427;234;666;359;1093
351330;202005;478;1124;392;966;24;71;285;638;309;709
351340;202005;6284;17923;4997;15640;1200;3933;2191;6810;3391;10743
351350;202005;11417;28567;9355;25307;1003;2914;6802;17908;7805;20822
351360;202005;3760;10101;3084;9068;746;2352;1199;3255;1945;5607
351370;202005;2030;5684;1337;4227;318;1088;426;1226;744;2314
351380;202005;46619;113299;32392;88247;4313;12625;18112;47175;22425;59800
351385;202005;324;858;152;466;27;81;42;120;69;201
351390;202005;1369;3339;814;2515;121;443;458;1325;579;1768
351400;202005;907;2554;744;2214;122;365;448;1301;570;1666
351410;202005;2599;7247;1829;5730;327;1054;708;2172;1035;3226
351420;202005;400;940;217;617;25;65;128;340;153;405
351430;202005;923;2520;704;2154;60;185;477;1422;537;1607
351440;202005;3269;8634;2098;6192;391;1203;578;1469;969;2672
351450;202005;1651;4408;1048;3271;217;737;153;369;370;1106
351460;202005;803;2109;614;1797;151;432;329;963;480;1395
351470;202005;1177;2982;898;2512;85;292;582;1524;667;1816
351480;202005;2464;7273;1925;6304;368;1328;812;2487;1180;3815
351490;202005;1939;5514;1640;4974;73;295;1318;3851;1391;4146
351492;202005;338;922;278;795;8;24;205;574;213;598
351495;202005;181;470;130;366;17;43;69;192;86;235
351500;202005;36082;89391;26515;73082;4097;12145;15357;40500;19454;52645
351510;202005;12901;32161;9274;25800;1144;3638;5745;15214;6889;18852
351512;202005;471;1274;333;971;59;170;117;313;176;483
351515;202005;3117;6943;1883;5014;323;970;543;1546;866;2516
351518;202005;2382;6011;1505;4422;204;675;828;2202;1032;2877
351519;202005;709;1962;428;1402;89;286;63;196;152;482
351520;202005;1224;3023;490;1502;57;194;200;533;257;727
351530;202005;344;910;198;593;27;84;78;182;105;266
351535;202005;1853;4512;1309;3585;209;624;666;1730;875;2354
351540;202005;2333;5819;1537;4437;306;1024;529;1346;835;2370
351550;202005;6860;17012;4490;12664;455;1490;2551;6710;3006;8200
351560;202005;439;1259;335;1049;84;287;100;286;184;573
351565;202005;199;569;156;491;39;138;43;117;82;255
351570;202005;20004;54111;14946;43683;1642;5192;9122;25537;10764;30729
351580;202005;244;626;135;416;14;44;58;184;72;228
351590;202005;504;1142;265;726;21;74;149;369;170;443
351600;202005;1333;3517;1017;2934;92;284;621;1694;713;1978
351610;202005;731;1744;457;1264;28;84;260;680;288;764
351620;202005;22398;59462;16138;48496;2679;9102;7245;19691;9924;28793
351630;202005;26501;70120;20997;60493;3151;9557;12793;35772;15944;45329
351640;202005;16230;43217;12424;36160;1229;4096;8354;23385;9583;27481
351650;202005;372;985;167;543;20;70;48;133;68;203
351660;202005;736;2082;459;1448;84;286;68;167;152;453
351670;202005;5899;15829;3765;11158;810;2394;1623;4529;2433;6923
351680;202005;435;1243;273;879;45;143;65;173;110;316
351685;202005;422;1205;337;1066;92;293;105;311;197;604
351690;202005;1051;2686;600;1765;82;271;254;673;336;944
351700;202005;1355;3376;960;2677;163;470;522;1373;685;1843
351710;202005;727;1963;505;1540;47;164;262;722;309;886
351720;202005;1396;3630;907;2763;144;475;365;1054;509;1529
351730;202005;898;2349;742;2104;58;202;489;1318;547;1520
351740;202005;3476;8750;2689;7242;474;1374;1332;3329;1806;4703
351750;202005;1320;3491;814;2567;154;496;305;943;459;1439
351760;202005;3263;9223;2350;7365;477;1710;851;2390;1328;4100
351770;202005;1725;5148;1396;4499;270;922;719;2258;989;3180
351780;202005;1222;3139;710;2153;103;362;240;692;343;1054
351790;202005;1323;3156;1024;2760;164;456;602;1634;766;2090
351800;202005;516;1200;247;690;21;59;92;219;113;278
351810;202005;1009;2629;812;2328;35;106;597;1629;632;1735
351820;202005;2487;6982;1715;5476;443;1548;379;1110;822;2658
351830;202005;4414;11919;3350;10061;331;1204;2072;5898;2403;7102
351840;202005;8413;23327;6223;19211;910;3129;3209;9282;4119;12411
351850;202005;1571;4250;1015;3164;169;608;344;916;513;1524
351860;202005;2724;7884;2087;6686;367;1248;1114;3607;1481;4855
351870;202005;23271;59535;17221;49488;4633;13680;6789;19902;11422;33582
351880;202005;122648;318466;90039;261855;21236;67939;39178;108601;60414;176540
351885;202005;897;2417;702;2085;67;246;459;1294;526;1540
351890;202005;782;2037;494;1549;120;394;80;208;200;602
351900;202005;1082;2900;836;2528;119;360;473;1424;592;1784
351905;202005;417;1133;290;884;24;84;132;352;156;436
351907;202005;20606;54169;15724;45391;1870;5932;9980;27811;11850;33743
351910;202005;1457;3837;1002;2843;72;228;572;1470;644;1698
351920;202005;852;2260;644;1860;101;341;288;754;389;1095
351925;202005;854;2295;657;1921;84;288;351;951;435;1239
351930;202005;3175;8916;2843;8307;583;1708;1885;5447;2468;7155
351940;202005;1060;2738;751;2192;117;373;371;1067;488;1440
351950;202005;1625;3764;1176;3083;64;188;818;2078;882;2266
351960;202005;5156;13013;3693;10393;819;2471;1657;4340;2476;6811
351970;202005;7095;21101;5574;18388;879;3234;3028;9689;3907;12923
351980;202005;990;2343;621;1739;88;278;351;909;439;1187
351990;202005;1384;3272;984;2685;57;212;473;1171;530;1383
352000;202005;2533;7239;2161;6478;262;898;1412;3955;1674;4853
352010;202005;2199;5900;1737;5113;451;1451;375;1129;826;2580
352020;202005;1430;3924;1087;3335;171;567;522;1518;693;2085
352030;202005;5368;14288;4160;12335;805;2622;2096;6052;2901;8674
352040;202005;2823;7605;1871;5639;278;933;675;1726;953;2659
352042;202005;2957;7237;1899;5531;378;1241;802;2239;1180;3480
352044;202005;2058;5515;1162;3774;183;677;253;755;436;1432
352050;202005;11799;31419;7408;22653;1877;6550;1355;3458;3232;10008
352060;202005;681;1835;492;1486;66;215;225;627;291;842
352070;202005;902;1812;570;1370;62;160;270;576;332;736
352080;202005;461;1167;275;785;29;100;105;268;134;368
352090;202005;1440;4218;1175;3682;131;483;571;1612;702;2095
352100;202005;3210;9042;2599;7902;579;1935;1156;3370;1735;5305
352110;202005;571;1674;435;1399;95;315;169;509;264;824
352115;202005;489;1335;400;1200;49;172;238;696;287;868
352120;202005;861;2573;696;2232;83;276;413;1233;496;1509
352130;202005;1942;5495;1293;3891;209;675;515;1428;724;2103
352140;202005;1155;3148;803;2447;145;469;376;1111;521;1580
352150;202005;815;2201;626;1872;83;266;414;1201;497;1467
352160;202005;971;2395;695;1963;77;267;386;1033;463;1300
352170;202005;2961;7970;2305;6651;335;1083;1360;3631;1695;4714
352180;202005;2504;6786;1908;5674;451;1512;562;1456;1013;2968
352190;202005;1187;3219;925;2814;163;471;445;1420;608;1891
352200;202005;339;1023;235;812;32;121;88;291;120;412
352210;202005;19074;45443;14826;39800;1057;3156;11321;29867;12378;33023
352215;202005;616;1615;529;1493;65;202;346;936;411;1138
352220;202005;18961;47584;12460;35789;2833;8633;4616;12467;7449;21100
352230;202005;13422;39104;10199;32957;2460;8855;3716;11039;6176;19894
352240;202005;10499;27030;7941;22713;1725;5564;3454;9092;5179;14656
352250;202005;23237;64936;18378;56411;3041;9963;10809;32629;13850;42592
352260;202005;4789;12026;3208;8939;472;1516;1816;4558;2288;6074
352265;202005;905;2497;794;2338;51;175;602;1723;653;1898
352270;202005;1431;4283;1052;3450;229;814;364;1116;593;1930
352280;202005;2404;6125;1813;5251;189;676;1067;2854;1256;3530
352290;202005;1149;3335;919;2878;125;441;497;1415;622;1856
352300;202005;901;2448;593;1787;82;279;313;878;395;1157
352310;202005;44339;117862;32512;96887;8067;24708;13736;41142;21803;65850
352320;202005;6360;16854;4812;13807;738;2398;2537;6575;3275;8973
352330;202005;2153;5713;1598;4937;291;1053;831;2400;1122;3453
352340;202005;5485;14446;3948;11631;637;2148;1967;5327;2604;7475
352350;202005;2122;6046;1643;4970;179;663;896;2428;1075;3091
352360;202005;1231;3288;1015;2908;82;287;762;2099;844;2386
352370;202005;1043;2965;902;2732;19;77;726;2158;745;2235
352380;202005;823;2254;614;1869;123;388;221;633;344;1021
352390;202005;15068;36858;10110;28196;1639;5000;5552;14603;7191;19603
352400;202005;3448;9511;2805;8303;605;2090;1445;3960;2050;6050
352410;202005;3151;8109;2349;6757;223;774;1449;3958;1672;4732
352420;202005;828;2011;582;1650;107;320;216;578;323;898
352430;202005;7582;18945;5334;14993;1165;3727;2414;6381;3579;10108
352440;202005;17258;46943;12725;38098;3130;9714;4690;13712;7820;23426
352450;202005;764;1889;377;1207;52;182;129;387;181;569
352460;202005;2900;8066;1966;6320;404;1426;745;2248;1149;3674
352470;202005;3231;8106;2387;6739;284;907;1407;3760;1691;4667
352480;202005;3837;9095;2491;6678;389;1201;1227;2952;1616;4153
352490;202005;693;2012;552;1751;99;330;264;796;363;1126
352500;202005;10195;26366;6841;20033;2896;9340;761;1264;3657;10604
352510;202005;3610;9734;2673;8096;566;1864;1230;3531;1796;5395
352520;202005;2669;7019;2039;5954;395;1295;1121;2967;1516;4262
352530;202005;9677;25191;6178;18361;1148;3905;1738;4317;2886;8222
352540;202005;545;1645;396;1299;65;235;125;368;190;603
352550;202005;987;2767;685;2182;138;479;219;621;357;1100
352560;202005;568;1595;429;1319;76;246;201;580;277;826
352570;202005;2174;6329;1326;4411;324;1171;127;345;451;1516
352580;202005;653;1682;538;1479;48;157;362;946;410;1103
352585;202005;299;787;217;649;16;62;134;358;150;420
352590;202005;13053;34280;9010;26503;2356;7544;3899;10659;6255;18203
352600;202005;1942;5215;1499;4379;159;512;939;2597;1098;3109
352610;202005;2906;8162;2174;6882;440;1583;883;2623;1323;4206
352620;202005;5585;14369;4240;12403;1255;3776;1597;4713;2852;8489
352630;202005;806;2012;595;1693;109;357;273;705;382;1062
352640;202005;2920;7547;2067;6034;216;669;1182;3314;1398;3983
352650;202005;584;1660;403;1253;61;222;146;433;207;655
352660;202005;1037;3041;833;2620;121;398;436;1323;557;1721
352670;202005;9306;25025;5981;18390;1543;5085;1332;3868;2875;8953
352680;202005;3209;9568;2210;7266;356;1414;1081;3193;1437;4607
352690;202005;26286;66132;20111;55533;1374;4528;14078;37312;15452;41840
352700;202005;555;1380;402;1170;149;490;88;243;237;733
352710;202005;5013;12958;3518;10214;819;2620;1473;3924;2292;6544
352720;202005;7623;20888;5870;17574;2475;7537;1198;3398;3673;10935
352725;202005;557;1390;326;936;20;50;159;438;179;488
352730;202005;2952;8519;2453;7366;333;1098;1442;3970;1775;5068
352740;202005;2267;5322;1660;4430;174;546;1021;2563;1195;3109
352750;202005;400;994;235;699;36;115;96;251;132;366
352760;202005;1615;4491;1227;3713;142;448;639;1922;781;2370
352770;202005;861;2333;581;1776;121;383;229;670;350;1053
352780;202005;604;1727;426;1378;85;273;120;382;205;655
352790;202005;438;1169;299;886;28;92;114;300;142;392
352800;202005;1251;3881;873;2980;242;858;111;330;353;1188
352810;202005;1147;2721;716;1952;93;268;440;1136;533;1404
352820;202005;490;1361;340;1101;70;228;75;259;145;487
352830;202005;576;1464;256;787;23;71;55;136;78;207
352840;202005;3848;11012;3136;9744;1067;3579;1006;3024;2073;6603
352850;202005;10515;25747;7056;20090;1917;5964;2224;5691;4141;11655
352860;202005;970;2672;701;2177;138;464;258;768;396;1232
352870;202005;856;2141;602;1621;36;122;404;1025;440;1147
352880;202005;1726;4065;1210;3168;182;498;706;1764;888;2262
352885;202005;295;827;217;686;24;84;130;390;154;474
352890;202005;685;1646;425;1107;43;120;243;572;286;692
352900;202005;17527;45763;11421;33647;1921;6039;5037;13969;6958;20008
352910;202005;427;1142;227;711;20;64;67;184;87;248
352920;202005;2644;6769;1905;5490;138;431;1299;3639;1437;4070
352930;202005;5572;15109;4055;12139;733;2394;1886;5232;2619;7626
352940;202005;21711;59488;15452;46197;3239;10617;6294;17740;9533;28357
352950;202005;519;1384;307;984;86;275;55;159;141;434
352960;202005;734;1956;400;1241;65;217;104;273;169;490
352965;202005;236;662;145;478;45;150;36;107;81;257
352970;202005;2947;7051;2226;5867;238;672;1452;3777;1690;4449
352980;202005;1375;3655;1086;3215;263;848;548;1575;811;2423
352990;202005;4051;11442;3152;9943;636;2216;1547;4671;2183;6887
353000;202005;453;1248;240;751;37;123;54;141;91;264
353010;202005;2515;6192;1643;4654;338;1102;676;1749;1014;2851
353020;202005;3551;9234;2019;5985;282;944;682;1884;964;2828
353030;202005;4414;11209;3004;8702;689;2177;860;2362;1549;4539
353040;202005;625;1449;438;1174;68;188;247;629;315;817
353050;202005;5100;14627;3572;11487;703;2450;1594;4906;2297;7356
353060;202005;47466;121265;38777;107418;2762;9217;28920;77294;31682;86511
353070;202005;9017;25875;6411;20259;1257;4323;2551;7469;3808;11792
353080;202005;4050;11233;2698;8598;516;1863;1041;2912;1557;4775
353090;202005;558;1675;422;1389;31;110;262;832;293;942
353100;202005;306;826;136;437;26;86;37;94;63;180
353110;202005;7399;20013;5979;17935;1196;3665;3200;9879;4396;13544
353120;202005;394;984;285;807;41;136;126;314;167;450
353130;202005;2377;5592;1487;4137;385;1184;495;1251;880;2435
353140;202005;2693;6699;1926;5359;113;372;1350;3595;1463;3967
353150;202005;1491;3676;1041;2927;189;555;470;1256;659;1811
353160;202005;567;1493;404;1221;68;215;171;474;239;689
353170;202005;528;1420;390;1219;78;275;170;520;248;795
353180;202005;9598;23602;7443;20094;662;1992;5554;14574;6216;16566
353190;202005;3137;8505;2482;7205;295;915;1521;4171;1816;5086
353200;202005;1887;4982;946;3020;153;546;223;638;376;1184
353205;202005;351;1066;299;951;55;186;152;473;207;659
353210;202005;917;2136;573;1563;29;96;376;1004;405;1100
353215;202005;378;1048;292;888;44;146;145;403;189;549
353220;202005;721;1979;442;1374;94;283;58;172;152;455
353230;202005;823;2271;635;1971;177;615;248;695;425;1310
353240;202005;2253;6135;1812;5388;258;883;1049;2991;1307;3874
353250;202005;1247;2805;744;1961;102;304;406;1017;508;1321
353260;202005;1134;2633;613;1761;91;303;289;784;380;1087
353270;202005;668;1725;559;1531;47;150;385;989;432;1139
353280;202005;686;1870;473;1474;118;375;134;399;252;774
353282;202005;1761;4959;1466;4404;155;527;933;2646;1088;3173
353284;202005;353;816;177;481;21;78;80;190;101;268
353286;202005;169;425;101;314;13;40;34;100;47;140
353290;202005;1474;3920;905;2754;149;465;297;826;446;1291
353300;202005;1814;4899;1308;3886;211;704;585;1561;796;2265
353310;202005;393;951;282;745;21;73;190;468;211;541
353320;202005;651;1596;536;1431;9;39;467;1232;476;1271
353325;202005;646;1889;441;1441;92;287;162;514;254;801
353330;202005;525;1343;356;1025;42;124;201;547;243;671
353340;202005;2827;7631;1955;5925;411;1387;865;2444;1276;3831
353350;202005;3375;8750;2300;6579;500;1562;671;1673;1171;3235
353360;202005;610;1726;463;1441;58;187;259;799;317;986
353370;202005;550;1597;453;1445;36;124;319;981;355;1105
353380;202005;270;812;223;717;25;84;121;353;146;437
353390;202005;5853;14503;4302;11907;493;1545;2467;6444;2960;7989
353400;202005;421;1154;313;945;51;183;117;290;168;473
353410;202005;516;1379;389;1155;72;222;217;643;289;865
353420;202005;419;1101;244;716;59;169;19;43;78;212
353430;202005;2144;5968;1606;4967;362;1224;681;1979;1043;3203
353440;202005;62516;169661;44510;134627;7451;24439;23221;66791;30672;91230
353450;202005;361;921;241;713;35;126;118;317;153;443
353460;202005;3193;8693;2268;6859;166;577;1050;3053;1216;3630
353470;202005;7610;19986;5352;15790;883;2994;2309;6212;3192;9206
353475;202005;1450;3765;990;2807;146;461;499;1311;645;1772
353480;202005;1600;4301;1265;3704;63;232;878;2484;941;2716
353490;202005;1080;2846;701;2113;103;338;308;878;411;1216
353500;202005;1019;2399;760;2007;165;443;415;1096;580;1539
353510;202005;770;2326;554;1792;138;494;140;377;278;871
353520;202005;1061;2782;666;2057;86;294;308;876;394;1170
353530;202005;2369;6284;1824;5300;252;828;967;2611;1219;3439
353540;202005;2024;5450;1638;4838;266;825;972;2807;1238;3632
353550;202005;5705;14677;4552;12830;744;2220;2593;7044;3337;9264
353560;202005;2132;5790;1549;4872;441;1516;426;1212;867;2728
353570;202005;590;1536;437;1290;48;152;257;713;305;865
353580;202005;2078;5494;1560;4465;332;962;746;2087;1078;3049
353590;202005;698;1830;449;1346;89;287;186;552;275;839
353600;202005;1695;4193;1264;3444;155;430;699;1854;854;2284
353610;202005;526;1548;372;1247;85;345;113;344;198;689
353620;202005;2628;7058;1824;5636;362;1251;592;1664;954;2915
353625;202005;477;1187;313;902;19;66;199;561;218;627
353630;202005;1249;3888;1026;3380;227;842;352;1058;579;1900
353640;202005;1346;3445;1070;3034;149;440;611;1728;760;2168
353650;202005;7747;20663;5720;16796;599;1989;3442;9494;4041;11483
353657;202005;389;1007;275;808;31;98;123;332;154;430
353660;202005;1242;2648;837;2103;371;930;199;484;570;1414
353670;202005;3995;11137;3068;9298;612;2074;1511;4239;2123;6313
353680;202005;648;1697;467;1427;81;270;252;730;333;1000
353690;202005;423;1088;186;574;20;59;34;93;54;152
353700;202005;1977;5207;1617;4599;117;385;1186;3240;1303;3625
353710;202005;4634;10284;2676;6836;237;643;1655;3835;1892;4478
353715;202005;425;1118;247;777;10;41;81;237;91;278
353720;202005;1913;5131;1466;4466;194;668;879;2620;1073;3288
353730;202005;4276;11318;3165;9293;474;1606;1578;4227;2052;5833
353740;202005;2003;5297;1385;4191;341;1116;455;1232;796;2348
353750;202005;816;2447;564;1948;136;511;102;354;238;865
353760;202005;12410;29056;9352;24854;1803;4936;5123;13339;6926;18275
353770;202005;703;2121;400;1351;66;248;58;170;124;418
353780;202005;5067;14200;3947;12015;801;2722;1872;5252;2673;7974
353790;202005;2529;7712;1833;6231;527;2017;385;1117;912;3134
353800;202005;17343;45525;13303;38964;1932;6024;7397;21630;9329;27654
353810;202005;1101;2986;694;2110;111;375;289;834;400;1209
353820;202005;1673;4525;1152;3471;237;771;376;1066;613;1837
353830;202005;606;1540;441;1263;75;230;193;517;268;747
353850;202005;1569;4416;1189;3670;273;855;417;1264;690;2119
353860;202005;2506;6995;1920;5932;462;1627;841;2338;1303;3965
353870;202005;28717;75612;19996;58379;2630;8731;10429;27682;13059;36413
353880;202005;3042;8425;2391;7176;195;686;1490;4294;1685;4980
353890;202005;2489;5440;1652;4280;136;368;1136;2815;1272;3183
353900;202005;741;2082;524;1643;82;284;206;598;288;882
353910;202005;2269;6315;1863;5655;199;717;1264;3761;1463;4478
353920;202005;1773;4920;1236;3871;291;1033;323;825;614;1858
353930;202005;4187;11170;2825;8638;507;1776;1140;3065;1647;4841
353940;202005;1039;2986;705;2296;127;425;240;729;367;1154
353950;202005;3175;8644;2414;7239;433;1426;1350;3754;1783;5180
353960;202005;694;1823;459;1367;89;288;191;541;280;829
353970;202005;664;1597;491;1337;47;143;329;869;376;1012
353980;202005;15352;39126;11782;32799;846;2695;8400;22489;9246;25184
353990;202005;895;2190;527;1515;87;267;241;661;328;928
354000;202005;2423;5875;1333;3789;301;907;223;601;524;1508
354010;202005;354;923;253;763;44;140;139;403;183;543
354020;202005;3334;9304;2606;7749;665;2129;1033;2810;1698;4939
354025;202005;702;1951;453;1442;62;226;121;368;183;594
354030;202005;487;1072;252;678;51;149;124;311;175;460
354040;202005;792;1867;500;1377;23;80;367;978;390;1058
354050;202005;935;2623;635;2077;146;505;198;645;344;1150
354060;202005;3263;9278;2221;7079;511;1741;785;2314;1296;4055
354070;202005;3550;9435;2389;7163;423;1458;978;2497;1401;3955
354075;202005;2510;7356;1905;6198;230;865;1083;3414;1313;4279
354080;202005;1333;3652;874;2751;189;634;209;586;398;1220
354085;202005;410;868;317;744;0;0;235;511;235;511
354090;202005;1600;4514;1361;4002;79;249;1053;3022;1132;3271
354100;202005;19083;52183;12931;41298;2861;9825;4916;15573;7777;25398
354105;202005;1488;3753;1002;2854;129;377;466;1249;595;1626
354110;202005;472;1307;318;1018;47;161;117;374;164;535
354120;202005;1381;3722;913;2712;186;606;310;798;496;1404
354130;202005;5349;14181;3497;10595;889;2883;212;423;1101;3306
354140;202005;18491;45308;12227;33773;2131;6516;5196;13258;7327;19774
354150;202005;2955;7030;2180;5786;488;1353;871;2246;1359;3599
354160;202005;2914;8458;2132;6860;610;2111;594;1741;1204;3852
354165;202005;608;1835;466;1553;81;312;241;757;322;1069
354170;202005;1676;4681;1395;4133;74;253;915;2600;989;2853
354180;202005;384;1074;271;831;52;165;106;296;158;461
354190;202005;1429;4025;984;3102;67;237;444;1349;511;1586
354200;202005;834;2040;636;1734;70;209;412;1073;482;1282
354210;202005;771;2029;611;1757;39;140;450;1221;489;1361
354220;202005;3051;8263;2233;6612;387;1230;1112;3137;1499;4367
354230;202005;717;1794;564;1605;38;141;409;1122;447;1263
354240;202005;1588;4426;1059;3342;184;639;319;896;503;1535
354250;202005;510;1253;317;949;94;276;76;241;170;517
354260;202005;8097;21553;6067;17960;1264;3985;2491;7118;3755;11103
354270;202005;999;3020;804;2641;187;606;317;1019;504;1625
354280;202005;777;1972;659;1798;61;202;418;1060;479;1262
354290;202005;902;2869;753;2552;126;420;385;1341;511;1761
354300;202005;3491;10290;2935;9251;853;2696;1057;3329;1910;6025
354310;202005;695;2068;566;1795;130;436;212;624;342;1060
354320;202005;943;2299;603;1711;92;294;233;587;325;881
354323;202005;449;1089;299;820;35;76;131;347;166;423
354325;202005;1313;3911;916;3012;140;454;347;1101;487;1555
354330;202005;9087;23119;5895;16550;721;2383;3413;8880;4134;11263
354340;202005;30882;77861;20276;59127;3321;10825;10080;28039;13401;38864
354350;202005;1155;2979;914;2570;85;265;627;1686;712;1951
354360;202005;586;1509;332;1077;66;220;68;219;134;439
354370;202005;994;2874;784;2520;129;450;446;1407;575;1857
354380;202005;709;1864;502;1524;93;367;121;280;214;647
354390;202005;13059;31653;8191;23012;1530;4557;3203;8606;4733;13163
354400;202005;1543;4951;1154;4024;193;733;429;1467;622;2200
354410;202005;5570;15177;4166;12330;895;2871;1813;5084;2708;7955
354420;202005;1445;3807;1050;3074;135;423;646;1807;781;2230
354425;202005;2590;6320;1807;4953;424;1186;766;2089;1190;3275
354430;202005;1506;4005;1151;3433;126;440;679;1889;805;2329
354440;202005;552;1478;359;1078;57;191;159;437;216;628
354450;202005;413;1088;227;731;35;114;70;198;105;312
354460;202005;859;2167;556;1620;77;238;306;863;383;1101
354470;202005;464;1177;301;858;18;57;150;380;168;437
354480;202005;1184;2690;756;2001;69;192;504;1274;573;1466
354490;202005;803;2386;574;1875;96;344;268;812;364;1156
354500;202005;1995;5649;1630;5089;505;1708;383;1192;888;2900
354510;202005;713;2013;563;1708;55;178;301;829;356;1007
354515;202005;328;957;241;772;40;149;99;300;139;449
354520;202005;6493;17927;4419;13404;648;2257;2406;6789;3054;9046
354530;202005;4175;11950;3168;9932;750;2401;1228;3879;1978;6280
354540;202005;1282;3406;918;2758;216;686;345;1039;561;1725
354550;202005;534;1404;410;1165;56;177;239;639;295;816
354560;202005;2110;5135;1122;3203;139;407;559;1490;698;1897
354570;202005;1192;2996;475;1362;80;242;62;173;142;415
354580;202005;8792;23025;5607;16943;856;2829;2789;8074;3645;10903
354600;202005;1834;4939;1388;4091;154;537;896;2497;1050;3034
354610;202005;430;1118;240;722;25;74;111;315;136;389
354620;202005;427;1215;265;887;50;191;98;297;148;488
354625;202005;306;818;159;514;30;100;24;52;54;152
354630;202005;1904;5726;1510;4900;543;1853;255;760;798;2613
354640;202005;3187;9139;2314;7376;402;1394;845;2506;1247;3900
354650;202005;857;2234;676;1934;54;151;424;1197;478;1348
354660;202005;3692;8610;1895;5570;175;628;896;2394;1071;3022
354670;202005;1070;2999;727;2291;153;513;262;748;415;1261
354680;202005;5030;13312;3817;11282;888;2728;1889;5710;2777;8438
354690;202005;495;1584;349;1252;77;284;94;330;171;614
354700;202005;859;2282;601;1775;88;279;295;831;383;1110
354710;202005;462;1262;332;1005;39;130;148;393;187;523
354720;202005;283;684;124;368;40;127;28;82;68;209
354730;202005;9598;26990;7104;22147;1018;3480;3964;11898;4982;15378
354740;202005;308;835;116;387;19;75;18;52;37;127
354750;202005;2447;6331;1535;4603;261;848;672;1815;933;2663
354760;202005;1939;5269;1312;4051;325;1098;404;1127;729;2225
354765;202005;374;995;141;455;21;70;28;78;49;148
354770;202005;2239;5572;1624;4521;303;946;774;1996;1077;2942
354780;202005;52901;135002;39435;108108;4435;13660;24337;62630;28772;76290
354790;202005;959;2647;744;2287;82;278;452;1328;534;1606
354800;202005;2533;6510;1961;5626;495;1452;842;2288;1337;3740
354805;202005;1335;3059;895;2410;100;270;529;1324;629;1594
354810;202005;649;1908;362;1283;45;188;83;268;128;456
354820;202005;940;2693;659;2134;116;412;187;488;303;900
354830;202005;443;1091;279;791;55;168;96;255;151;423
354840;202005;926;2294;550;1542;50;150;318;839;368;989
354850;202005;21344;55371;14589;43043;1678;5732;8653;24113;10331;29845
354860;202005;1716;4865;1027;3351;177;630;302;889;479;1519
354870;202005;55811;141283;42553;116533;4764;14393;26221;67884;30985;82277
354880;202005;5732;14179;2681;7601;325;1078;1020;2344;1345;3422
354890;202005;16396;40883;12587;34428;1712;5303;7489;19762;9201;25065
354900;202005;396;990;246;721;40;128;69;178;109;306
354910;202005;5276;13860;3085;9816;683;2302;519;1579;1202;3881
354920;202005;476;1277;217;744;27;109;44;157;71;266
354925;202005;286;816;169;542;18;59;39;111;57;170
354930;202005;398;943;230;658;15;52;114;301;129;353
354940;202005;2260;6843;1557;5244;532;1915;269;827;801;2742
354950;202005;1453;3772;1143;3336;62;252;844;2321;906;2573
354960;202005;904;2410;682;2077;55;198;393;1135;448;1333
354970;202005;4092;11467;3148;9812;365;1279;1990;6003;2355;7282
354980;202005;31963;75692;20972;56653;2321;7500;12611;31637;14932;39137
354990;202005;62430;158575;46050;128498;3968;12830;29684;78216;33652;91046
354995;202005;2768;6326;2074;5405;182;569;1484;3681;1666;4250
355000;202005;1560;3901;1162;3323;178;597;565;1488;743;2085
355010;202005;3719;10156;2158;6801;717;2337;225;733;942;3070
355020;202005;3545;10010;2563;8248;615;2178;910;2778;1525;4956
355030;202005;1324537;3258308;935621;2498327;145361;426597;459492;1130121;604853;1556718
355040;202005;2812;7100;2181;6268;322;918;1485;4314;1807;5232
355050;202005;967;2264;686;1844;176;523;261;639;437;1162
355060;202005;6022;16337;4323;13093;725;2549;2084;5727;2809;8276
355070;202005;8598;22308;6830;19443;799;2635;4363;11710;5162;14345
355080;202005;908;2602;548;1900;108;410;77;213;185;623
355090;202005;1083;3166;804;2670;214;706;236;814;450;1520
355100;202005;22353;58612;17064;50625;2780;8726;10108;29700;12888;38426
355110;202005;808;2273;578;1900;176;650;103;310;279;960
355120;202005;681;1791;481;1491;35;122;204;594;239;716
355130;202005;871;1957;408;1104;28;90;231;589;259;679
355140;202005;1846;4232;1547;3813;99;292;1275;3047;1374;3339
355150;202005;4202;11124;3304;9513;389;1255;2086;5756;2475;7011
355160;202005;1916;5270;1362;4253;344;1168;320;955;664;2123
355170;202005;9923;25273;7610;21330;1473;4473;3987;10805;5460;15278
355180;202005;2752;7460;1919;6021;415;1444;689;1973;1104;3417
355190;202005;1852;4845;1445;4211;348;1007;761;2349;1109;3356
355200;202005;825;2543;689;2318;183;680;285;910;468;1590
355210;202005;2824;7760;2180;6429;424;1417;1101;3027;1525;4444
355220;202005;43470;115863;33798;97082;8069;24710;13659;36310;21728;61020
355230;202005;1134;2847;608;1798;110;307;212;587;322;894
355240;202005;23330;61899;16007;47096;2271;7250;8522;23668;10793;30918
355250;202005;36665;98562;26527;78606;6649;20799;9743;27474;16392;48273
355255;202005;693;1748;360;1113;60;208;136;403;196;611
355260;202005;1397;3515;1010;2844;134;454;578;1507;712;1961
355270;202005;1166;3491;896;2921;206;693;298;901;504;1594
355280;202005;29031;74955;20073;57679;3007;9346;9447;25603;12454;34949
355290;202005;859;2381;639;1967;138;406;258;773;396;1179
355300;202005;1230;3631;944;3025;185;672;319;947;504;1619
355310;202005;959;2665;721;2263;100;310;395;1261;495;1571
355320;202005;525;1390;385;1134;74;249;159;385;233;634
355330;202005;2723;6996;2044;5813;142;519;1525;4128;1667;4647
355340;202005;3951;8766;3021;7513;385;863;1889;4811;2274;5674
355350;202005;1273;3712;935;3055;204;685;326;1057;530;1742
355360;202005;1144;2944;872;2542;118;372;531;1529;649;1901
355365;202005;360;952;186;636;41;130;30;105;71;235
355370;202005;5295;13558;4054;11608;976;2601;1803;5679;2779;8280
355380;202005;2841;7627;2107;6230;389;1238;753;1945;1142;3183
355385;202005;1430;3768;1160;3361;107;376;735;1953;842;2329
355390;202005;804;2227;567;1695;129;420;225;606;354;1026
355395;202005;1923;5295;1317;4072;235;781;452;1236;687;2017
355400;202005;8943;25787;7003;21881;1743;6195;2436;6803;4179;12998
355410;202005;21911;59974;13414;42653;2883;10120;3337;10450;6220;20570
355420;202005;615;1989;497;1751;143;554;122;418;265;972
355430;202005;3652;9354;2712;7644;659;1814;1222;3439;1881;5253
355440;202005;791;2153;469;1467;84;273;137;398;221;671
355450;202005;3079;7984;1957;5727;359;1127;801;2117;1160;3244
355460;202005;485;1199;305;898;45;170;137;357;182;527
355465;202005;395;1046;300;887;44;139;154;444;198;583
355470;202005;1062;2745;593;1813;161;552;183;497;344;1049
355475;202005;354;843;280;733;17;41;205;520;222;561
355480;202005;3724;10389;3027;9347;455;1629;1957;5847;2412;7476
355490;202005;932;2494;496;1536;33;116;261;731;294;847
355495;202005;773;2212;562;1828;70;263;199;594;269;857
355500;202005;6500;16921;3756;11405;589;1966;1252;3524;1841;5490
355510;202005;1279;3128;795;2293;106;356;348;890;454;1246
355520;202005;369;820;166;487;28;80;47;128;75;208
355530;202005;407;948;143;425;20;73;52;136;72;209
355535;202005;506;1396;379;1182;76;297;170;472;246;769
355540;202005;10351;26266;8371;23410;1334;4042;5282;14342;6616;18384
355550;202005;621;1843;504;1627;68;247;270;817;338;1064
355560;202005;1085;2811;573;1809;131;463;37;119;168;582
355570;202005;243;698;131;431;23;75;33;106;56;181
355580;202005;1188;2923;783;2230;143;451;320;852;463;1303
355590;202005;170;425;129;357;17;52;77;201;94;253
355600;202005;1418;3458;944;2674;183;559;396;1084;579;1643
355610;202005;1710;4252;1129;3233;131;419;595;1619;726;2038
355620;202005;4447;11926;3242;9570;369;1321;1772;4808;2141;6129
355630;202005;2271;6278;1569;4932;255;837;776;2407;1031;3244
355635;202005;868;2532;631;2063;118;440;184;534;302;974
355640;202005;2945;8263;1937;6210;382;1324;580;1784;962;3108
355645;202005;4117;11589;2965;9543;435;1513;1589;5027;2024;6540
355650;202005;6513;17559;5078;14905;1402;4272;1695;4488;3097;8760
355660;202005;1263;3309;862;2553;138;471;295;852;433;1323
355670;202005;3363;9096;2185;6442;278;987;1102;2853;1380;3840
355680;202005;2691;7438;1142;3790;304;1062;119;415;423;1477
355690;202005;793;2363;500;1749;110;420;21;50;131;470
355695;202005;239;668;138;448;12;59;26;58;38;117
355700;202005;7038;20295;5663;17189;998;3185;2972;8570;3970;11755
355710;202005;8488;20100;5365;14351;829;2443;2402;5723;3231;8166
355715;202005;476;1272;243;750;51;170;45;123;96;293
355720;202005;1451;4089;1133;3517;187;625;603;1757;790;2382
355730;202005;900;2504;728;2172;136;444;325;880;461;1324
410010;202005;1214;3393;907;2729;195;638;186;545;381;1183
410020;202005;981;3042;752;2497;269;837;172;599;441;1436
410030;202005;1485;4142;1249;3763;171;575;681;2056;852;2631
410040;202005;11883;32986;8600;26804;1880;6254;2731;7914;4611;14168
410045;202005;834;2240;577;1760;81;281;208;585;289;866
410050;202005;2291;5763;1505;4371;304;964;487;1316;791;2280
410060;202005;1976;5667;1511;4708;356;1186;474;1414;830;2600
410070;202005;1854;4750;1339;3789;220;687;531;1378;751;2065
410080;202005;1326;3576;938;2846;210;661;307;941;517;1602
410090;202005;1066;2760;910;2509;86;228;564;1618;650;1846
410100;202005;1818;5284;1196;3753;173;617;157;470;330;1087
410105;202005;461;1175;251;766;29;95;77;224;106;319
410110;202005;2979;7644;2038;5808;265;809;880;2400;1145;3209
410115;202005;562;1459;398;1170;50;168;155;440;205;608
410120;202005;2545;7258;2214;6722;492;1647;1125;3291;1617;4938
410130;202005;1176;3181;1018;2883;196;649;512;1335;708;1984
410140;202005;14831;35950;9187;25693;1734;5315;2251;5754;3985;11069
410150;202005;16013;37813;7753;21525;1315;4040;1785;4535;3100;8575
410160;202005;2810;7811;2237;6794;509;1690;780;2371;1289;4061
410165;202005;718;1923;585;1649;54;187;347;910;401;1097
410170;202005;2640;6898;1727;4922;393;1219;131;383;524;1602
410180;202005;14617;40782;11107;33531;1515;4998;5859;16539;7374;21537
410185;202005;428;1245;300;922;54;176;86;240;140;416
410190;202005;2196;5455;1559;4317;328;934;417;1108;745;2042
410200;202005;5076;11773;2738;7692;447;1465;442;1193;889;2658
410210;202005;2999;7568;1825;5395;296;992;623;1581;919;2573
410220;202005;507;1315;322;965;52;170;77;221;129;391
410230;202005;1646;4411;1247;3595;164;545;656;1764;820;2309
410240;202005;4755;12675;3237;9725;809;2694;278;772;1087;3466
410250;202005;2576;6143;1876;4992;141;474;931;2407;1072;2881
410260;202005;1836;4627;1131;3279;189;559;490;1406;679;1965
410270;202005;454;1208;325;984;46;154;121;354;167;508
410275;202005;601;1698;404;1289;55;190;190;560;245;750
410280;202005;2255;6068;1475;4496;228;770;580;1625;808;2395
410290;202005;3229;9131;2184;6861;585;1854;561;1745;1146;3599
410300;202005;635;1606;499;1379;40;127;255;662;295;789
410302;202005;380;947;199;602;25;85;96;281;121;366
410304;202005;1213;3156;1007;2781;114;307;604;1626;718;1933
410305;202005;1723;4136;1163;3323;123;384;718;1984;841;2368
410310;202005;2480;7074;1952;6031;339;1136;888;2744;1227;3880
410315;202005;660;1578;343;1061;121;377;82;253;203;630
410320;202005;1050;2913;704;2185;110;381;130;380;240;761
410322;202005;540;1438;293;883;29;89;154;433;183;522
410330;202005;1486;3646;1011;2741;167;495;295;788;462;1283
410335;202005;819;2229;630;1872;96;313;284;787;380;1100
410337;202005;815;1971;565;1485;62;164;239;595;301;759
410340;202005;475;1330;317;935;26;85;150;370;176;455
410345;202005;2374;6129;1180;3483;247;773;328;864;575;1637
410347;202005;698;1786;507;1436;44;150;160;457;204;607
410350;202005;1347;3446;963;2783;131;396;403;1110;534;1506
410360;202005;4260;10418;3263;8685;374;1100;1824;4660;2198;5760
410370;202005;12801;34833;8123;23611;997;3184;3384;8710;4381;11894
410380;202005;1495;3790;1091;3042;146;427;389;998;535;1425
410390;202005;2584;6631;1666;4925;383;1258;493;1331;876;2589
410395;202005;857;2478;697;2137;142;472;290;885;432;1357
410400;202005;6011;16052;4371;12786;664;2076;2048;5665;2712;7741
410405;202005;800;1930;587;1614;108;339;255;651;363;990
410410;202005;1205;3285;1125;3158;164;545;705;2049;869;2594
410420;202005;9199;25725;6821;20956;1185;4034;2445;6750;3630;10784
410425;202005;3090;8686;2088;6603;352;1217;757;2168;1109;3385
410430;202005;12537;31607;8578;24300;1375;4293;2935;7831;4310;12124
410440;202005;2279;6833;1938;6183;290;1035;1019;3189;1309;4224
410442;202005;2123;6535;1769;5750;509;1703;556;1751;1065;3454
410445;202005;2227;6501;1622;5291;316;1177;375;1296;691;2473
410450;202005;1404;3524;1027;2911;195;613;371;990;566;1603
410460;202005;1967;4846;1513;4127;161;455;761;2011;922;2466
410465;202005;2623;7649;2033;6503;382;1285;729;2182;1111;3467
410470;202005;1972;5478;1382;4370;362;1307;221;743;583;2050
410480;202005;36480;86565;18909;55112;3035;9934;4003;9946;7038;19880
410490;202005;10860;30296;7669;23594;1420;4765;2981;8629;4401;13394
410500;202005;1751;4709;1197;3611;267;932;346;909;613;1841
410510;202005;1833;4521;1190;3321;238;655;328;929;566;1584
410520;202005;2987;9442;2650;8740;909;3082;925;3135;1834;6217
410530;202005;1575;3929;754;2179;102;302;181;426;283;728
410540;202005;2674;7258;1824;5523;275;906;844;2474;1119;3380
410550;202005;7072;19027;4499;13249;786;2520;1217;3100;2003;5620
410560;202005;1419;3758;1037;2959;238;745;361;897;599;1642
410570;202005;2421;6743;1773;5564;482;1778;200;670;682;2448
410580;202005;24586;64332;17664;51522;3511;10968;7317;19998;10828;30966
410590;202005;1538;4411;1019;3153;151;487;292;792;443;1279
410600;202005;1737;4693;1315;3862;280;787;479;1458;759;2245
410610;202005;696;1854;508;1487;57;204;222;614;279;818
410620;202005;2284;6639;1470;4707;326;1149;276;822;602;1971
410630;202005;2330;6174;1495;4437;286;970;287;684;573;1654
410640;202005;4532;10640;3018;7997;672;2094;408;1066;1080;3160
410645;202005;1026;2943;832;2690;270;896;345;1142;615;2038
410650;202005;2123;5820;1424;4368;282;935;510;1432;792;2367
410655;202005;891;2148;627;1681;25;79;325;828;350;907
410657;202005;622;1686;383;1158;51;193;139;345;190;538
410660;202005;3282;8499;1821;5274;324;987;465;1270;789;2257
410670;202005;1035;2596;616;1778;127;377;223;582;350;959
410680;202005;2599;7890;1859;6007;454;1517;338;1112;792;2629
410685;202005;524;1342;394;1118;94;312;158;398;252;710
410690;202005;123920;304857;80019;222591;12947;41208;29624;72692;42571;113900
410700;202005;2401;6130;2005;5503;287;816;1057;2823;1344;3639
410710;202005;847;2146;550;1581;83;247;228;620;311;867
410712;202005;624;1819;513;1600;128;440;188;558;316;998
410715;202005;799;2317;484;1596;70;234;168;523;238;757
410720;202005;3093;7867;2402;6532;322;1032;520;1388;842;2420
410725;202005;1049;2585;598;1746;118;371;85;202;203;573
410730;202005;619;1652;471;1383;106;359;96;270;202;629
410740;202005;922;2582;673;2107;92;317;266;818;358;1135
410750;202005;1744;4417;1371;3719;205;631;625;1606;830;2237
410752;202005;359;915;175;534;24;76;76;216;100;292
410753;202005;286;862;191;646;31;125;44;135;75;260
410754;202005;1065;2757;879;2471;53;127;607;1808;660;1935
410755;202005;573;1483;388;1111;56;174;167;416;223;590
410760;202005;3464;8984;2452;7138;624;2058;551;1445;1175;3503
410765;202005;12475;35120;9592;29384;1624;5456;1942;5331;3566;10787
410770;202005;1036;2479;713;1933;65;185;366;988;431;1173
410773;202005;1236;3325;1074;3079;109;353;658;1828;767;2181
410775;202005;1468;3664;1273;3369;69;208;845;2191;914;2399
410780;202005;608;1508;394;1095;60;181;98;261;158;442
410785;202005;708;1866;539;1575;91;293;188;560;279;853
410790;202005;745;2113;600;1827;168;569;66;142;234;711
410800;202005;3316;7371;2666;6417;45;160;1736;4080;1781;4240
410810;202005;385;1032;295;858;23;70;148;393;171;463
410820;202005;836;2379;424;1322;85;282;78;219;163;501
410830;202005;33415;81586;22020;62231;4549;14711;7610;20238;12159;34949
410832;202005;966;2519;757;2145;89;285;439;1174;528;1459
410840;202005;7920;20308;4650;13959;857;2784;1204;3360;2061;6144
410845;202005;1131;2831;888;2471;168;496;374;1015;542;1511
410850;202005;2173;6304;1886;5776;300;1015;946;2801;1246;3816
410855;202005;767;1923;499;1412;43;116;234;617;277;733
410860;202005;4313;10645;3361;9077;349;1089;1888;4831;2237;5920
410865;202005;1332;3959;1164;3623;132;461;695;2200;827;2661
410870;202005;1262;3386;1039;3005;80;252;707;2023;787;2275
410880;202005;4376;11865;3057;9388;534;1743;458;1547;992;3290
410890;202005;946;2699;691;2191;151;528;180;565;331;1093
410895;202005;970;3110;821;2782;250;932;182;571;432;1503
410900;202005;820;2163;555;1645;101;301;104;255;205;556
410910;202005;368;875;224;607;12;46;136;341;148;387
410920;202005;830;1982;572;1568;77;230;281;755;358;985
410930;202005;1623;4189;1106;3266;265;918;232;667;497;1585
410940;202005;22011;60436;15674;48782;3234;11154;4810;14641;8044;25795
410950;202005;1893;5547;1674;5209;47;182;1395;4288;1442;4470
410960;202005;7289;18352;4842;14098;1119;3583;1790;5167;2909;8750
410965;202005;1026;2626;701;2008;85;270;397;1120;482;1390
410970;202005;3838;10363;2642;8029;607;2196;368;943;975;3139
410975;202005;1305;3261;986;2746;101;309;489;1351;590;1660
410980;202005;6738;17043;4173;12336;498;1662;1756;4816;2254;6478
410990;202005;1356;3318;882;2571;218;740;287;800;505;1540
411000;202005;589;1579;384;1178;48;175;116;307;164;482
411005;202005;432;1128;262;763;47;149;74;190;121;339
411007;202005;2251;6313;1833;5586;438;1403;637;1936;1075;3339
411010;202005;4108;12321;3221;10486;835;2953;366;1079;1201;4032
411020;202005;2187;6299;1784;5560;523;1697;499;1519;1022;3216
411030;202005;741;1849;511;1368;29;105;296;704;325;809
411040;202005;921;2322;461;1299;48;154;155;390;203;544
411050;202005;1842;5756;1489;4971;401;1445;228;650;629;2095
411060;202005;1823;4741;1141;3414;261;912;189;502;450;1414
411065;202005;381;997;255;749;34;114;112;304;146;418
411070;202005;6854;17617;5378;15124;759;2371;2630;7149;3389;9520
411080;202005;2065;5462;1613;4656;415;1370;323;907;738;2277
411090;202005;825;2183;535;1617;44;167;153;430;197;597
411095;202005;1536;3636;1037;2858;120;358;336;886;456;1244
411100;202005;1132;2949;768;2287;83;289;247;744;330;1033
411110;202005;632;1623;280;866;35;107;17;37;52;144
411120;202005;1201;3376;986;2969;313;1080;227;608;540;1688
411125;202005;5064;14808;4464;13654;955;2875;2165;6922;3120;9797
411130;202005;689;1865;482;1473;91;255;177;573;268;828
411140;202005;2187;6784;1836;6017;543;1903;485;1549;1028;3452
411150;202005;3745;9637;2498;7100;502;1643;250;520;752;2163
411155;202005;953;2431;553;1674;81;237;228;653;309;890
411160;202005;357;821;235;658;31;94;53;153;84;247
411170;202005;688;2075;507;1647;117;375;165;521;282;896
411180;202005;5327;14092;4094;11904;602;1956;1979;5402;2581;7358
411190;202005;1585;4072;1165;3323;193;584;463;1207;656;1791
411200;202005;4870;13217;3343;10291;853;2915;639;1697;1492;4612
411210;202005;3047;6800;1956;4996;338;974;631;1519;969;2493
411220;202005;826;2141;580;1666;131;410;170;461;301;871
411230;202005;839;2239;595;1759;115;367;220;638;335;1005
411240;202005;1492;3630;965;2647;108;351;468;1179;576;1530
411250;202005;2188;5845;1600;4778;319;1094;511;1473;830;2567
411260;202005;323;855;205;613;27;81;81;218;108;299
411270;202005;1958;5268;1457;4249;208;632;722;1948;930;2580
411275;202005;1414;3260;963;2514;146;458;429;1041;575;1499
411280;202005;1304;3524;855;2655;228;721;118;354;346;1075
411290;202005;802;2119;512;1544;50;137;265;828;315;965
411295;202005;1212;3051;856;2348;102;296;377;969;479;1265
411300;202005;1002;2511;621;1767;56;176;278;692;334;868
411310;202005;843;1963;639;1665;49;121;286;732;335;853
411320;202005;5303;13825;3818;11123;668;2087;1574;4120;2242;6207
411325;202005;1387;3974;1175;3609;193;586;665;2109;858;2695
411330;202005;3298;8889;2364;7169;532;1760;743;2259;1275;4019
411340;202005;808;2209;473;1460;65;220;162;474;227;694
411342;202005;1010;2462;595;1644;101;299;247;651;348;950
411345;202005;1023;2665;768;2241;61;196;552;1625;613;1821
411350;202005;2560;7006;1637;5112;424;1440;230;657;654;2097
411360;202005;677;1640;482;1332;64;182;157;416;221;598
411370;202005;52318;128661;36777;102221;2669;8990;22114;57820;24783;66810
411373;202005;1355;3450;1094;3060;93;321;594;1674;687;1995
411375;202005;1073;2716;776;2151;129;374;307;820;436;1194
411380;202005;1101;2570;727;1856;34;99;443;1055;477;1154
411390;202005;1476;4071;1141;3340;181;586;461;1189;642;1775
411400;202005;2233;5589;1676;4534;172;553;845;2171;1017;2724
411410;202005;2358;6543;1698;5104;371;1225;392;1137;763;2362
411420;202005;3982;9827;2105;6188;293;999;383;876;676;1875
411430;202005;3319;9026;2486;7437;543;1775;853;2324;1396;4099
411435;202005;408;1147;253;809;51;154;78;207;129;361
411440;202005;2409;6807;1929;5888;396;1315;683;2021;1079;3336
411450;202005;2452;6563;1865;5591;241;726;1006;3062;1247;3788
411460;202005;3797;9880;2293;6952;402;1433;431;1193;833;2626
411470;202005;726;1889;522;1490;100;297;187;488;287;785
411480;202005;4620;12392;3325;9953;681;2396;1148;3112;1829;5508
411490;202005;1600;4135;1214;3488;155;516;511;1336;666;1852
411500;202005;1257;3393;825;2452;149;493;166;407;315;900
411510;202005;2248;5774;1774;4939;386;1258;417;1172;803;2430
411520;202005;29796;72501;16656;46840;1953;6391;6266;15832;8219;22223
411530;202005;912;2410;544;1685;93;320;87;247;180;567
411535;202005;461;1349;268;883;27;102;74;193;101;295
411540;202005;2683;6571;1798;4953;169;543;904;2394;1073;2937
411545;202005;907;2623;750;2345;72;222;489;1550;561;1772
411550;202005;689;1757;477;1359;68;214;84;246;152;460
411560;202005;1919;5168;1087;3383;156;541;80;227;236;768
411570;202005;7200;16749;4735;12934;1050;3144;839;2267;1889;5411
411573;202005;748;2029;633;1851;95;293;328;939;423;1232
411575;202005;1903;5226;1403;4196;276;900;342;1015;618;1915
411580;202005;4530;10373;2652;7465;371;1298;485;1258;856;2556
411585;202005;627;1871;284;937;70;242;52;148;122;390
411590;202005;375;1047;253;781;29;88;133;379;162;467
411600;202005;290;741;186;577;41;132;55;160;96;292
411605;202005;1516;3520;930;2573;118;410;496;1350;614;1760
411610;202005;2499;6001;1752;4633;73;245;1160;2847;1233;3092
411620;202005;2780;7432;2351;6756;401;1214;1279;3668;1680;4882
411630;202005;732;1909;484;1428;77;273;170;451;247;724
411640;202005;458;1200;319;901;45;142;119;309;164;451
411650;202005;197;582;125;420;24;86;22;59;46;145
411660;202005;888;2227;636;1772;51;153;297;803;348;956
411670;202005;1349;3323;904;2434;102;300;419;1051;521;1351
411680;202005;1432;3830;1051;3079;141;468;465;1311;606;1779
411690;202005;3550;9143;2653;7583;565;1646;816;2456;1381;4102
411695;202005;647;1979;407;1322;46;167;169;514;215;681
411700;202005;1583;4117;1001;3002;223;731;151;423;374;1154
411705;202005;1849;5768;1562;5271;296;958;892;3231;1188;4189
411710;202005;1828;4664;1233;3548;282;835;222;618;504;1453
411720;202005;1053;2458;744;1916;147;397;291;703;438;1100
411721;202005;938;2378;687;1907;135;372;168;466;303;838
411722;202005;795;2124;439;1283;61;204;168;402;229;606
411725;202005;1144;3216;774;2482;181;623;168;551;349;1174
411727;202005;1441;4040;926;2916;211;695;166;492;377;1187
411729;202005;693;1676;432;1173;51;191;165;386;216;577
411730;202005;5024;13473;3857;11148;810;2518;1604;4547;2414;7065
411740;202005;530;1371;258;783;52;145;58;161;110;306
411745;202005;722;2050;475;1494;72;245;74;168;146;413
411750;202005;4953;13153;3546;10369;480;1529;1738;4803;2218;6332
411760;202005;6578;17674;5022;14941;1679;5190;991;3273;2670;8463
411770;202005;2905;8459;2101;6660;516;1733;308;913;824;2646
411780;202005;2743;7746;2321;6938;645;2017;781;2353;1426;4370
411790;202005;2763;6693;1452;4307;312;1055;220;561;532;1616
411800;202005;941;2668;670;2062;112;363;135;398;247;761
411810;202005;1519;3987;1120;3176;186;541;518;1393;704;1934
411820;202005;10944;31494;8773;27630;2184;7363;3694;11360;5878;18723
411830;202005;572;1414;427;1172;82;246;101;298;183;544
411840;202005;11567;31046;7630;22742;1330;4301;1975;5392;3305;9693
411845;202005;526;1543;282;936;31;123;61;193;92;316
411850;202005;7101;18193;4770;14061;1211;4027;784;2105;1995;6132
411860;202005;662;1875;474;1477;69;219;128;360;197;579
411870;202005;583;1698;402;1282;86;309;100;280;186;589
411880;202005;2205;5536;1598;4552;224;727;552;1518;776;2245
411885;202005;1013;2591;706;2042;99;336;235;625;334;961
411890;202005;1232;3275;815;2483;145;489;88;258;233;747
411900;202005;783;2160;472;1486;110;373;71;205;181;578
411910;202005;897;2663;638;2101;156;577;227;684;383;1261
411915;202005;14727;36183;9596;26850;1458;4595;3675;9213;5133;13808
411920;202005;1054;3146;871;2747;194;710;304;886;498;1596
411925;202005;459;1212;324;965;69;234;128;354;197;588
411930;202005;4888;15109;4092;13558;1758;6354;269;1044;2027;7398
411940;202005;3225;9634;2459;7924;602;2021;766;2226;1368;4247
411950;202005;13544;36679;11041;32540;1587;5294;6379;18053;7966;23347
411960;202005;5773;15610;4542;13079;838;2668;1730;4706;2568;7374
411965;202005;449;1255;316;983;46;160;131;371;177;531
411970;202005;1050;2474;803;2141;160;402;357;1075;517;1477
411980;202005;1467;3660;1050;2965;258;742;382;1042;640;1784
411990;202005;38009;99783;23840;73356;4467;15192;8129;23921;12596;39113
411995;202005;3125;7762;2327;6518;664;2080;655;1727;1319;3807
412000;202005;1919;4417;1345;3444;30;96;953;2289;983;2385
412010;202005;574;1788;415;1438;70;254;118;352;188;606
412015;202005;533;1513;433;1333;55;184;254;776;309;960
412020;202005;439;1221;271;852;39;151;116;337;155;488
412030;202005;591;1649;412;1315;65;212;122;381;187;593
412033;202005;861;2302;610;1778;73;212;220;562;293;774
412035;202005;758;2046;482;1530;53;207;262;782;315;989
412040;202005;575;1541;359;1100;48;140;69;210;117;350
412050;202005;1587;3974;1063;3009;213;692;267;746;480;1438
412060;202005;7078;20831;5858;18351;1552;5539;1689;5027;3241;10566
412065;202005;606;1674;437;1325;99;321;108;327;207;648
412070;202005;1104;2853;865;2372;108;319;358;907;466;1226
412080;202005;1973;5564;1238;3996;181;610;227;659;408;1269
412085;202005;280;673;93;290;9;23;16;46;25;69
412090;202005;5717;14978;4225;12144;1110;3322;1484;4359;2594;7681
412100;202005;1541;4259;1159;3545;334;1119;262;875;596;1994
412110;202005;809;2122;552;1601;81;240;185;510;266;750
412120;202005;1921;5594;1467;4681;287;1015;423;1166;710;2181
412125;202005;627;1795;439;1398;92;302;119;353;211;655
412130;202005;765;1956;522;1488;77;240;143;412;220;652
412135;202005;615;1639;274;835;43;132;93;251;136;383
412140;202005;1603;3889;1042;2899;196;667;203;533;399;1200
412150;202005;2699;7168;2273;6408;325;1060;1378;3653;1703;4713
412160;202005;935;2891;519;1769;94;342;87;263;181;605
412170;202005;4201;11647;3499;10517;726;2377;1420;3957;2146;6334
412175;202005;1265;3660;1046;3280;227;731;453;1441;680;2172
412180;202005;1587;4405;1138;3550;142;522;530;1519;672;2041
412190;202005;3296;8288;2422;6738;323;981;1062;2938;1385;3919
412200;202005;1685;5044;1203;3906;325;1163;194;575;519;1738
412210;202005;598;1437;350;987;48;153;130;329;178;482
412215;202005;3252;8853;2549;7480;633;1825;1088;3530;1721;5355
412217;202005;935;2454;789;2199;56;171;524;1413;580;1584
412220;202005;5856;16194;4637;13939;1201;3582;1473;4706;2674;8288
412230;202005;2536;7547;2016;6531;351;1279;549;1524;900;2803
412240;202005;6724;17272;4205;12372;755;2418;1247;3344;2002;5762
412250;202005;2004;5169;1485;4187;351;1044;341;901;692;1945
412260;202005;1187;3193;839;2435;146;448;258;703;404;1151
412265;202005;870;2381;681;2049;135;424;286;823;421;1247
412270;202005;953;2585;607;1857;78;273;238;652;316;925
412280;202005;390;1097;305;959;61;206;95;273;156;479
412290;202005;985;2523;653;1913;103;320;205;564;308;884
412300;202005;1643;4244;1127;3316;249;773;246;749;495;1522
412310;202005;729;2024;590;1755;85;310;235;648;320;958
412320;202005;837;2185;548;1583;67;233;190;551;257;784
412330;202005;1495;4041;988;3042;189;645;330;1035;519;1680
412340;202005;1130;3182;689;2188;100;372;117;339;217;711
412350;202005;2762;7164;1735;5118;351;1089;314;831;665;1920
412360;202005;260;717;173;519;5;26;103;287;108;313
412370;202005;848;2441;566;1820;113;413;48;162;161;575
412380;202005;1498;4068;1049;3161;286;890;139;489;425;1379
412382;202005;507;1269;330;978;45;160;134;337;179;497
412385;202005;2133;5879;1720;5066;537;1499;535;1761;1072;3260
412390;202005;2333;5701;1884;5024;313;835;735;1978;1048;2813
412395;202005;675;1932;463;1442;54;151;200;637;254;788
412400;202005;877;2350;624;1852;126;414;174;510;300;924
412402;202005;1947;4819;1299;3716;324;954;171;495;495;1449
412405;202005;2920;7716;1875;5714;493;1810;45;132;538;1942
412410;202005;5616;14667;4072;12102;735;2514;1345;3806;2080;6320
412420;202005;509;1308;326;944;23;83;158;397;181;480
412430;202005;579;1467;300;876;29;97;124;342;153;439
412440;202005;2612;7194;1736;5480;441;1498;283;918;724;2416
412450;202005;408;1201;271;846;43;129;25;58;68;187
412460;202005;1007;2645;784;2259;143;451;369;1043;512;1494
412470;202005;1432;4707;1172;4101;309;1140;253;885;562;2025
412480;202005;980;2630;626;1849;116;377;182;467;298;844
412490;202005;1249;3178;985;2681;122;338;505;1303;627;1641
412500;202005;1868;4710;1382;3795;297;805;404;1076;701;1881
412510;202005;1843;5701;1260;4187;284;1017;122;335;406;1352
412520;202005;1192;3131;626;1882;149;445;55;169;204;614
412530;202005;667;1754;482;1368;76;245;106;292;182;537
412535;202005;777;2021;518;1516;85;267;107;264;192;531
412540;202005;1161;2994;829;2356;91;331;272;803;363;1134
412545;202005;661;1703;454;1268;68;188;167;456;235;644
412550;202005;30781;82728;21271;63404;3623;11757;8319;22756;11942;34513
412555;202005;282;744;184;524;20;59;52;109;72;168
412560;202005;4598;13448;3351;10484;582;1998;986;3081;1568;5079
412570;202005;4262;10916;2374;7161;507;1713;298;995;805;2708
412575;202005;968;2456;765;2095;84;259;423;1088;507;1347
412580;202005;1390;3683;963;2838;90;319;502;1424;592;1743
412590;202005;411;1090;222;703;31;102;21;51;52;153
412600;202005;1523;4181;1126;3368;179;619;475;1330;654;1949
412610;202005;765;2008;540;1527;51;146;287;727;338;873
412620;202005;1204;3146;914;2707;165;570;289;799;454;1369
412625;202005;8453;22429;5091;15637;705;2490;337;911;1042;3401
412627;202005;1112;3115;691;2232;136;468;189;609;325;1077
412630;202005;2824;8257;1989;6404;386;1256;607;1791;993;3047
412635;202005;376;1023;253;753;38;132;85;209;123;341
412640;202005;993;2642;544;1672;64;203;153;431;217;634
412650;202005;1569;4358;1243;3675;217;713;473;1226;690;1939
412660;202005;2314;5923;1599;4552;261;809;491;1247;752;2056
412665;202005;376;965;289;804;45;134;140;376;185;510
412667;202005;1684;4462;1243;3596;175;546;497;1376;672;1922
412670;202005;777;1850;511;1413;89;285;163;419;252;704
412680;202005;1783;4759;1195;3603;166;570;426;1135;592;1705
412690;202005;1048;2779;768;2228;117;366;313;850;430;1216
412700;202005;1949;5185;1600;4627;188;642;881;2462;1069;3104
412710;202005;5649;16623;4155;13344;828;2993;1146;3285;1974;6278
412720;202005;1159;3407;883;2788;143;482;178;477;321;959
412730;202005;2241;6028;1433;4340;273;915;453;1301;726;2216
412740;202005;1805;5036;1210;3799;214;785;172;542;386;1327
412750;202005;3836;10110;3165;9145;308;1082;2092;5682;2400;6764
412760;202005;2840;7724;2343;6879;432;1435;1250;3450;1682;4885
412770;202005;10000;25177;5182;15598;737;2345;1174;3023;1911;5368
412780;202005;1166;3095;858;2527;187;600;341;981;528;1581
412785;202005;1985;4865;1377;3793;145;416;878;2364;1023;2780
412788;202005;1299;3645;1066;3236;285;874;458;1363;743;2237
412790;202005;1283;3397;691;2146;106;378;221;614;327;992
412795;202005;1218;3179;638;1971;101;333;125;354;226;687
412796;202005;2177;6296;1780;5514;373;1220;589;1706;962;2926
412800;202005;3404;8244;2281;6167;266;815;1045;2512;1311;3327
412810;202005;10968;27969;6774;19372;834;2794;2591;6582;3425;9376
412820;202005;6337;17365;4405;13453;1060;3425;1274;3890;2334;7315
412830;202005;333;940;230;719;34;97;59;186;93;283
412840;202005;1767;4494;1239;3462;140;439;524;1354;664;1793
412850;202005;2814;7409;2018;5995;327;1039;841;2460;1168;3499
412853;202005;1510;3809;1246;3334;179;524;631;1513;810;2037
412855;202005;1212;3247;785;2322;143;501;226;631;369;1132
412860;202005;765;1875;518;1487;71;231;285;774;356;1005
412862;202005;674;1652;442;1265;80;238;188;517;268;755
412863;202005;1244;3771;1116;3531;203;656;659;2073;862;2729
412865;202005;699;1908;507;1519;128;389;145;452;273;841
412870;202005;848;2191;614;1812;169;562;122;384;291;946
412880;202005;788;2140;524;1592;90;313;91;239;181;552
420005;202005;400;1184;234;813;35;128;106;368;141;496
420010;202005;3232;7895;2124;6019;129;416;1558;4434;1687;4850
420020;202005;429;1354;280;972;44;180;63;173;107;353
420030;202005;73;249;53;206;17;73;17;62;34;135
420040;202005;508;1543;292;1054;59;237;17;44;76;281
420050;202005;705;1634;458;1185;68;203;281;662;349;865
420055;202005;156;479;86;308;20;94;31;91;51;185
420060;202005;100;273;56;169;12;40;14;32;26;72
420070;202005;670;2068;498;1698;106;373;198;661;304;1034
420075;202005;76;195;37;106;6;19;12;22;18;41
420080;202005;333;967;259;800;62;208;104;326;166;534
420090;202005;404;1255;234;835;53;198;42;129;95;327
420100;202005;1213;3204;1000;2876;50;177;807;2285;857;2462
420110;202005;236;758;213;709;44;170;98;302;142;472
420120;202005;507;1374;333;1003;68;236;147;373;215;609
420125;202005;332;1013;230;786;55;202;98;319;153;521
420127;202005;248;671;92;304;15;55;22;73;37;128
420130;202005;2994;8267;2242;6972;350;1321;1089;3103;1439;4424
420140;202005;3396;9188;2377;7396;663;2356;329;1023;992;3379
420150;202005;621;1597;419;1250;45;151;252;734;297;885
420160;202005;202;493;78;248;10;30;20;63;30;93
420165;202005;147;421;81;265;17;62;27;78;44;140
420170;202005;253;796;171;596;23;71;49;158;72;229
420180;202005;171;539;98;357;10;35;30;100;40;135
420190;202005;187;602;113;406;34;134;30;104;64;238
420195;202005;1342;3470;960;2844;295;1032;109;235;404;1267
420200;202005;4115;10049;2375;6777;316;1112;926;2269;1242;3381
420205;202005;1687;4580;1135;3483;167;541;624;1918;791;2459
420207;202005;1669;4384;1016;3133;195;690;405;1163;600;1853
420208;202005;314;892;182;645;56;216;47;157;103;373
420209;202005;143;486;81;292;21;89;24;85;45;174
420210;202005;2806;7220;1795;5568;332;1146;832;2536;1164;3682
420213;202005;745;2335;623;2080;135;490;310;1011;445;1501
420215;202005;174;532;117;402;31;116;20;65;51;181
420220;202005;240;698;143;480;24;97;67;199;91;296
420230;202005;4675;12850;3503;10633;536;1768;1841;5412;2377;7180
420240;202005;12356;34216;7474;23021;986;3475;3618;9834;4604;13309
420243;202005;369;1060;289;895;47;166;172;504;219;670
420245;202005;1192;3092;832;2470;64;234;500;1425;564;1659
420250;202005;425;1190;350;1060;53;180;197;556;250;736
420253;202005;478;1184;339;983;32;110;194;556;226;666
420257;202005;155;403;98;300;18;68;48;145;66;213
420260;202005;1054;2783;758;2365;124;439;471;1443;595;1882
420270;202005;490;1308;236;709;31;105;105;320;136;425
420280;202005;1076;3245;812;2706;160;602;277;892;437;1494
420285;202005;116;236;46;135;9;39;8;16;17;55
420287;202005;423;984;299;811;79;219;109;301;188;520
420290;202005;4409;12627;3346;10187;454;1617;1962;5492;2416;7109
420300;202005;6832;19309;3854;12313;734;2616;1058;2985;1792;5601
420310;202005;790;1820;391;1083;40;127;216;556;256;683
420315;202005;748;2119;514;1693;112;391;202;672;314;1063
420320;202005;4800;13224;3446;10885;993;3479;839;2448;1832;5927
420325;202005;268;761;183;587;31;102;82;238;113;340
420330;202005;924;2701;577;1952;106;405;171;501;277;906
420340;202005;919;2558;677;2123;160;534;101;276;261;810
420350;202005;1133;3001;824;2440;70;239;574;1665;644;1904
420360;202005;2614;7277;1389;4565;258;928;134;432;392;1360
420370;202005;1017;2770;815;2435;86;303;548;1568;634;1871
420380;202005;4202;11116;2758;8515;588;1937;1011;3010;1599;4947
420390;202005;1058;2540;722;1852;131;412;298;515;429;927
420395;202005;961;2765;647;2121;99;392;85;208;184;600
420400;202005;912;2643;620;2001;112;405;221;684;333;1089
420410;202005;527;1438;403;1179;43;135;268;761;311;896
420415;202005;280;839;214;692;57;208;79;254;136;462
420417;202005;584;1747;461;1488;127;414;164;541;291;955
420419;202005;133;468;101;391;35;144;8;30;43;174
420420;202005;10504;27306;6863;20628;1960;6707;1875;5139;3835;11846
420425;202005;642;1716;422;1271;41;142;206;598;247;740
420430;202005;2980;8067;1700;5228;394;1273;540;1533;934;2806
420435;202005;241;611;114;369;16;53;53;165;69;218
420440;202005;722;1980;436;1354;114;395;172;491;286;886
420445;202005;255;631;162;460;31;91;75;202;106;293
420450;202005;641;1870;460;1474;84;326;165;456;249;782
420455;202005;1911;4740;1361;3895;191;669;683;1832;874;2501
420460;202005;8434;22547;6157;18359;931;3114;3123;8926;4054;12040
420470;202005;585;1531;311;984;59;215;66;176;125;391
420475;202005;74;191;29;92;10;30;3;11;13;41
420480;202005;5319;13115;3183;9522;650;2133;1055;3153;1705;5286
420490;202005;334;938;239;747;52;185;94;284;146;469
420500;202005;1381;3843;877;2875;156;568;377;1234;533;1802
420510;202005;154;432;85;270;9;39;26;74;35;113
420515;202005;54;134;32;86;2;10;15;33;17;43
420517;202005;747;2065;649;1893;52;153;480;1421;532;1574
420519;202005;284;686;203;569;28;89;112;324;140;413
420520;202005;291;781;144;484;25;88;12;40;37;128
420530;202005;764;2218;516;1692;89;344;190;537;279;881
420535;202005;230;680;92;316;11;44;41;130;52;174
420540;202005;34156;80812;21257;59038;3225;10171;7222;17202;10447;27373
420543;202005;204;617;156;501;20;72;82;243;102;315
420545;202005;1063;3182;793;2589;148;525;309;913;457;1438
420550;202005;3332;8912;2069;6758;341;1289;856;2842;1197;4131
420555;202005;286;826;189;615;24;86;109;340;133;426
420560;202005;380;948;250;751;51;168;141;413;192;581
420570;202005;2064;5763;1603;4885;295;1014;684;1995;979;3009
420580;202005;1801;4584;1264;3753;298;966;429;1291;727;2257
420590;202005;2696;7149;1539;4648;281;1020;403;921;684;1941
420600;202005;948;2777;712;2312;104;394;396;1229;500;1623
420610;202005;346;1002;188;635;42;149;63;220;105;369
420620;202005;690;1707;451;1312;100;305;191;542;291;847
420630;202005;847;2570;611;1985;85;294;350;1084;435;1378
420640;202005;472;1285;220;756;70;237;19;69;89;306
420650;202005;3383;8906;1969;5926;289;958;731;1889;1020;2847
420660;202005;408;1045;254;721;46;134;74;188;120;322
420665;202005;563;1471;351;1104;63;232;155;431;218;663
420670;202005;1261;3464;810;2554;133;508;315;877;448;1385
420675;202005;158;449;88;303;15;69;42;128;57;197
420680;202005;314;735;156;516;29;111;79;246;108;357
420690;202005;814;2415;479;1607;69;281;116;317;185;598
420700;202005;2533;6670;1878;5554;239;775;1052;3012;1291;3787
420710;202005;806;2345;604;1909;62;259;359;1044;421;1303
420720;202005;1172;3261;829;2653;177;594;401;1243;578;1837
420730;202005;2915;7598;2123;6279;352;1142;1130;3221;1482;4363
420740;202005;511;1542;303;1077;88;337;26;107;114;444
420750;202005;1801;5253;1153;3732;201;767;457;1344;658;2111
420757;202005;74;187;37;120;4;8;16;49;20;57
420760;202005;337;1000;157;495;37;124;40;109;77;233
420765;202005;450;1301;196;666;26;108;89;293;115;401
420768;202005;1284;3615;1108;3319;140;421;823;2447;963;2868
420770;202005;434;1170;209;716;36;139;87;276;123;415
420775;202005;263;799;181;602;43;159;49;138;92;297
420780;202005;848;2307;511;1595;116;400;98;266;214;666
420785;202005;194;513;135;385;14;47;68;161;82;208
420790;202005;967;2976;705;2432;118;480;376;1231;494;1711
420800;202005;629;1589;293;898;85;298;69;195;154;493
420810;202005;1338;4205;1075;3675;316;1239;329;950;645;2189
420820;202005;11032;27469;7745;22092;1489;4802;3590;9375;5079;14177
420830;202005;3501;9245;2552;7499;470;1516;1099;3138;1569;4654
420840;202005;459;1339;213;775;63;257;25;77;88;334
420845;202005;2230;5712;1310;4045;242;924;532;1535;774;2459
420850;202005;1000;3227;603;2184;108;429;103;332;211;761
420860;202005;286;738;148;492;32;117;36;111;68;228
420870;202005;752;2094;563;1738;142;516;238;666;380;1182
420880;202005;931;2880;716;2431;153;626;267;832;420;1458
420890;202005;7486;20296;4473;14032;686;2395;1506;4140;2192;6535
420895;202005;161;466;99;305;26;83;30;92;56;175
420900;202005;1401;3455;838;2478;111;399;383;980;494;1379
420910;202005;26722;70244;16202;49778;2499;8749;6346;17498;8845;26247
420915;202005;509;1841;369;1431;53;206;195;780;248;986
420917;202005;325;801;166;456;29;84;82;224;111;308
420920;202005;68;180;22;80;0;0;3;9;3;9
420930;202005;16039;41880;11146;33206;2053;6811;4892;13823;6945;20634
420940;202005;2663;6500;1499;4480;377;1294;272;649;649;1943
420945;202005;129;370;101;308;23;81;42;116;65;197
420950;202005;322;941;171;573;28;114;39;116;67;230
420960;202005;954;2352;677;1874;122;409;295;715;417;1124
420970;202005;2249;6303;1557;4979;433;1466;394;1235;827;2701
420980;202005;255;846;222;779;109;387;64;237;173;624
420985;202005;297;850;142;507;35;137;45;139;80;276
420990;202005;293;905;153;545;30;108;31;94;61;202
421000;202005;494;1481;337;1128;75;264;90;270;165;534
421003;202005;461;1097;156;460;10;37;25;66;35;103
421005;202005;54;153;42;135;9;30;20;63;29;93
421010;202005;2972;8174;2112;6583;448;1597;555;1541;1003;3138
421020;202005;353;1106;272;955;44;184;139;465;183;649
421030;202005;716;2192;553;1842;167;630;172;529;339;1159
421040;202005;638;1504;402;1148;28;93;247;697;275;790
421050;202005;947;2561;604;1785;122;403;224;573;346;976
421055;202005;168;451;90;272;11;38;55;151;66;189
421060;202005;578;1700;391;1256;73;266;179;514;252;780
421070;202005;615;1854;342;1171;75;288;97;321;172;609
421080;202005;490;1410;410;1256;42;152;253;764;295;916
421085;202005;360;1023;116;412;16;53;14;34;30;87
421090;202005;229;583;147;427;10;37;51;135;61;172
421100;202005;791;1765;318;969;96;341;82;203;178;544
421105;202005;1476;4092;1003;3102;178;563;445;1305;623;1868
421110;202005;1040;2741;857;2506;20;59;637;1970;657;2029
421120;202005;859;2645;629;2118;88;329;212;661;300;990
421125;202005;278;731;195;577;73;238;67;160;140;398
421130;202005;4636;13622;3773;11903;903;3247;1871;5531;2774;8778
421140;202005;324;881;182;567;32;99;55;158;87;257
421145;202005;421;1181;270;854;61;218;99;280;160;498
421150;202005;595;1609;368;1156;61;230;189;554;250;784
421160;202005;495;1323;348;1044;48;158;228;666;276;824
421165;202005;192;560;121;394;24;83;51;161;75;244
421170;202005;1030;2722;808;2379;134;384;491;1492;625;1876
421175;202005;981;2466;591;1855;115;404;255;780;370;1184
421180;202005;370;961;198;610;37;145;75;210;112;355
421185;202005;306;823;206;614;28;97;121;356;149;453
421187;202005;269;817;166;547;30;99;56;173;86;272
421189;202005;346;1006;263;841;43;151;101;299;144;450
421190;202005;10036;27175;6605;20655;1270;4375;2261;6520;3531;10895
421200;202005;614;1802;493;1573;53;193;317;984;370;1177
421205;202005;178;469;129;387;25;93;58;151;83;244
421210;202005;1042;2685;603;1923;129;419;233;751;362;1170
421220;202005;1271;3846;975;3212;230;828;302;908;532;1736
421223;202005;321;895;196;659;47;156;90;307;137;463
421225;202005;865;2556;725;2311;125;447;433;1371;558;1818
421227;202005;641;1831;397;1310;79;286;172;578;251;864
421230;202005;572;1511;359;1115;65;237;139;418;204;655
421240;202005;267;800;125;452;10;41;20;69;30;110
421250;202005;1818;4628;1262;3728;148;513;719;2032;867;2545
421260;202005;177;520;49;186;15;68;9;31;24;99
421265;202005;616;1605;550;1524;6;20;521;1447;527;1467
421270;202005;323;856;137;489;19;63;53;182;72;245
421280;202005;1667;4583;1227;3811;188;716;686;1997;874;2713
421290;202005;933;2527;469;1442;82;270;105;300;187;570
421300;202005;273;706;138;436;13;49;22;63;35;112
421310;202005;176;499;118;388;24;82;62;207;86;289
421315;202005;214;598;136;426;42;114;30;106;72;220
421320;202005;601;1835;300;1030;33;105;39;97;72;202
421330;202005;574;1709;417;1379;84;323;115;359;199;682
421335;202005;323;982;264;879;66;250;112;363;178;613
421340;202005;1283;3605;907;2876;174;623;371;1084;545;1707
421350;202005;1364;3544;894;2722;186;660;369;1038;555;1698
421360;202005;2157;5851;1246;3963;231;897;485;1340;716;2237
421370;202005;586;1933;355;1293;62;233;98;312;160;545
421380;202005;772;2068;661;1891;88;281;392;1090;480;1371
421390;202005;161;436;54;188;12;35;20;62;32;97
421400;202005;295;958;208;749;37;145;107;370;144;515
421410;202005;204;555;87;308;23;92;27;82;50;174
421415;202005;176;531;99;320;21;65;21;64;42;129
421420;202005;509;1370;412;1193;39;123;264;739;303;862
421430;202005;99;304;75;246;8;28;20;59;28;87
421440;202005;575;1554;340;1121;70;227;145;464;215;691
421450;202005;423;1255;245;834;32;135;42;148;74;283
421460;202005;348;1025;185;670;24;101;37;109;61;210
421470;202005;239;702;136;471;28;99;51;182;79;281
421480;202005;2629;7085;1693;5209;361;1323;643;1791;1004;3114
421490;202005;113;390;67;256;5;21;18;49;23;70
421500;202005;2018;5964;1402;4696;378;1481;334;973;712;2454
421505;202005;274;782;228;717;35;125;146;443;181;568
421507;202005;412;1175;219;742;54;192;75;241;129;433
421510;202005;280;798;169;528;25;84;87;248;112;332
421520;202005;471;1230;298;844;28;88;181;472;209;560
421530;202005;294;881;169;591;31;136;49;140;80;276
421535;202005;373;987;226;723;36;137;117;355;153;492
421540;202005;276;649;130;398;19;64;47;126;66;190
421545;202005;660;1959;493;1654;109;434;238;745;347;1179
421550;202005;1922;5200;1543;4630;275;865;887;2654;1162;3519
421555;202005;164;496;68;234;12;46;8;19;20;65
421560;202005;76;252;50;192;10;36;17;58;27;94
421565;202005;867;2254;568;1774;147;507;153;485;300;992
421567;202005;419;1385;271;955;97;360;67;213;164;573
421568;202005;330;990;247;797;35;127;111;345;146;472
421569;202005;149;436;71;238;16;59;34;109;50;168
421570;202005;1062;2879;746;2278;176;609;216;601;392;1210
421575;202005;281;822;203;615;30;104;86;224;116;328
421580;202005;3431;9508;2236;6992;371;1373;884;2380;1255;3753
421590;202005;132;410;106;350;34;123;28;77;62;200
421600;202005;539;1464;364;1098;77;259;114;287;191;546
421605;202005;704;1822;492;1478;87;234;249;800;336;1034
421610;202005;1015;2779;659;2097;117;401;208;636;325;1037
421620;202005;3737;9937;2155;6996;469;1716;581;1800;1050;3516
421625;202005;128;358;57;185;13;44;14;45;27;89
421630;202005;2219;5848;1322;4067;232;842;422;1076;654;1918
421635;202005;245;670;173;518;17;54;104;288;121;342
421640;202005;695;1866;497;1559;97;346;212;649;309;995
421650;202005;2177;5962;1378;4449;331;1273;397;1052;728;2325
421660;202005;9140;25513;6235;19874;979;3497;2673;7809;3652;11306
421670;202005;720;2095;504;1581;86;304;251;763;337;1067
421680;202005;988;2729;740;2282;194;646;351;992;545;1638
421690;202005;1225;3548;825;2692;164;604;300;974;464;1578
421700;202005;462;1376;287;966;59;215;91;289;150;504
421710;202005;200;637;88;298;19;67;22;66;41;133
421715;202005;98;281;75;229;18;48;44;134;62;182
421720;202005;1787;4868;1038;3259;264;904;279;757;543;1661
421725;202005;225;552;114;355;22;74;48;116;70;190
421730;202005;400;1155;207;621;26;85;104;291;130;376
421740;202005;635;1791;426;1334;108;348;111;313;219;661
421750;202005;825;1945;367;1089;84;278;136;361;220;639
421755;202005;149;411;87;260;15;61;44;110;59;171
421760;202005;837;2219;540;1687;83;292;202;552;285;844
421770;202005;2316;6185;1662;5027;427;1275;602;1982;1029;3257
421775;202005;203;518;122;363;16;49;56;156;72;205
421780;202005;763;2273;485;1666;101;401;192;614;293;1015
421790;202005;741;1911;421;1346;90;300;212;654;302;954
421795;202005;172;476;121;359;23;83;42;113;65;196
421800;202005;2350;6380;1679;5134;213;766;959;2774;1172;3540
421810;202005;581;1611;395;1254;47;178;231;713;278;891
421820;202005;900;2619;507;1655;103;381;157;412;260;793
421825;202005;1259;3602;1115;3376;120;384;780;2317;900;2701
421830;202005;1920;5719;1558;5032;317;1094;663;2080;980;3174
421835;202005;192;482;111;344;20;75;32;98;52;173
421840;202005;209;673;138;499;28;106;35;117;63;223
421850;202005;358;1001;189;639;36;132;57;151;93;283
421860;202005;300;842;160;553;23;88;55;172;78;260
421870;202005;3858;9771;2726;7656;482;1609;1311;3265;1793;4874
421875;202005;225;663;100;334;15;59;27;70;42;129
421880;202005;545;1565;355;1139;93;348;86;272;179;620
421885;202005;199;570;120;385;30;94;27;81;57;175
421890;202005;794;2439;584;2014;113;464;295;961;408;1425
421895;202005;391;993;324;905;39;124;221;639;260;763
421900;202005;939;2470;670;1911;101;333;301;776;402;1109
421910;202005;289;848;197;635;32;127;57;156;89;283
421915;202005;362;1030;197;638;41;130;31;89;72;219
421917;202005;544;1280;303;969;112;392;73;248;185;640
421920;202005;364;1121;263;921;107;393;70;236;177;629
421930;202005;2423;6145;1188;3737;281;1003;353;973;634;1976
421935;202005;383;1220;301;1035;60;217;168;556;228;773
421940;202005;337;984;154;495;27;95;35;97;62;192
421950;202005;2796;7049;1514;4655;306;1050;370;1005;676;2055
421960;202005;173;443;90;286;18;67;20;55;38;122
421970;202005;1819;4668;1072;3164;218;762;398;985;616;1747
421985;202005;271;718;148;476;16;53;56;169;72;222
422000;202005;1862;4872;1500;4270;155;520;1031;2892;1186;3412
430003;202005;546;1496;355;1129;66;224;150;475;216;699
430005;202005;256;672;161;502;30;102;72;212;102;314
430010;202005;1671;4084;1325;3546;138;411;940;2435;1078;2846
430020;202005;568;1308;425;1114;44;138;279;705;323;843
430030;202005;965;2283;525;1489;134;433;164;428;298;861
430040;202005;9859;23785;5700;16366;1491;4636;659;2023;2150;6659
430045;202005;492;1228;332;935;24;78;223;618;247;696
430047;202005;236;513;84;240;23;72;21;57;44;129
430050;202005;849;2148;486;1413;108;330;120;326;228;656
430055;202005;241;599;110;328;14;54;63;170;77;224
430057;202005;78;168;28;77;6;22;9;19;15;41
430060;202005;15983;42973;12170;36978;2578;8315;5572;16898;8150;25213
430063;202005;828;2322;653;1953;123;365;358;1070;481;1435
430064;202005;983;2702;720;2158;213;652;279;817;492;1469
430066;202005;93;198;67;159;5;11;53;121;58;132
430070;202005;732;1861;89;297;7;26;17;50;24;76
430080;202005;792;1947;482;1338;79;262;256;623;335;885
430085;202005;819;1872;493;1349;99;284;208;558;307;842
430087;202005;563;1430;467;1300;60;149;321;912;381;1061
430090;202005;519;1326;170;531;12;45;61;177;73;222
430100;202005;699;1674;405;1111;68;225;196;468;264;693
430105;202005;1081;2910;690;2223;122;457;323;1014;445;1471
430107;202005;161;473;92;295;18;68;26;68;44;136
430110;202005;2052;5168;1482;4324;227;710;805;2325;1032;3035
430120;202005;1134;3387;729;2367;128;442;333;1081;461;1523
430130;202005;3369;7785;2452;6491;902;2399;433;1393;1335;3792
430140;202005;856;2358;596;1858;139;426;286;864;425;1290
430150;202005;534;1371;286;872;63;207;101;295;164;502
430155;202005;243;622;108;331;17;48;22;62;39;110
430160;202005;18545;44076;14183;37832;1656;4846;8324;22065;9980;26911
430163;202005;2760;6730;1903;5329;90;303;1348;3733;1438;4036
430165;202005;297;726;78;253;16;36;9;26;25;62
430170;202005;892;2366;319;1105;49;178;49;157;98;335
430175;202005;632;1925;528;1699;132;429;248;783;380;1212
430180;202005;629;1527;496;1311;56;147;346;910;402;1057
430185;202005;547;1373;277;814;73;195;64;169;137;364
430187;202005;657;1495;462;1249;76;220;236;680;312;900
430190;202005;1343;3567;1074;3136;223;705;501;1391;724;2096
430192;202005;125;336;42;126;6;18;11;29;17;47
430195;202005;407;1216;58;209;5;14;9;31;14;45
430200;202005;1054;3156;841;2770;277;948;241;817;518;1765
430205;202005;448;1175;391;1076;13;42;336;902;349;944
430210;202005;4911;12630;3263;9079;583;1748;1118;2539;1701;4287
430215;202005;297;765;183;533;39;121;69;201;108;322
430220;202005;619;1541;175;601;26;115;35;89;61;204
430222;202005;171;489;123;386;11;40;45;137;56;177
430223;202005;235;621;182;531;17;54;117;334;134;388
430225;202005;17;34;12;26;1;2;9;19;10;21
430230;202005;1778;4967;1503;4539;135;449;1116;3328;1251;3777
430235;202005;310;883;201;639;44;170;63;170;107;340
430237;202005;490;1175;352;941;20;57;255;662;275;719
430240;202005;1179;2730;655;1815;80;281;358;902;438;1183
430245;202005;677;1960;511;1630;145;477;237;778;382;1255
430250;202005;865;2174;617;1785;218;693;48;122;266;815
430258;202005;125;328;91;261;6;10;48;147;54;157
430260;202005;629;1671;431;1283;57;188;242;714;299;902
430265;202005;189;532;124;409;28;87;37;126;65;213
430270;202005;2757;6858;2162;5922;391;1184;1274;3379;1665;4563
430280;202005;4849;11520;3293;8819;688;1879;1395;3705;2083;5584
430290;202005;2169;5025;1758;4542;47;160;1507;3806;1554;3966
430300;202005;9154;23560;6851;19468;1112;3452;3606;10029;4718;13481
430310;202005;11147;27760;7321;20533;957;3008;3491;9114;4448;12122
430320;202005;968;2534;516;1612;63;190;280;892;343;1082
430330;202005;640;1573;391;1080;65;197;173;423;238;620
430340;202005;689;1507;372;1025;47;140;217;583;264;723
430350;202005;7201;18483;5287;15022;786;2400;2960;8073;3746;10473
430355;202005;321;847;107;348;17;58;14;38;31;96
430360;202005;834;1958;529;1434;104;318;208;524;312;842
430367;202005;305;704;166;454;31;96;90;237;121;333
430370;202005;468;1270;212;657;41;138;55;145;96;283
430380;202005;665;1654;327;1020;74;272;93;278;167;550
430390;202005;2884;6944;1595;4551;289;938;236;472;525;1410
430400;202005;1028;2205;786;1863;64;182;546;1243;610;1425
430410;202005;518;1246;355;979;52;157;220;583;272;740
430420;202005;2562;7057;1952;5706;512;1568;840;2335;1352;3903
430430;202005;571;1458;266;813;65;192;62;200;127;392
430435;202005;1427;3646;1087;3093;195;595;560;1602;755;2197
430440;202005;3381;9419;2561;7934;275;965;1554;4766;1829;5731
430450;202005;6384;16192;5047;13820;761;2317;2698;7137;3459;9454
430460;202005;29263;74801;21090;61258;3813;12252;10322;28695;14135;40947
430461;202005;281;725;85;266;12;40;31;83;43;123
430462;202005;227;621;125;414;19;61;45;153;64;214
430463;202005;5518;14604;4066;12001;828;2706;1846;5217;2674;7923
430465;202005;406;1052;338;932;53;166;211;557;264;723
430466;202005;3929;9921;3032;8454;750;2184;1405;3719;2155;5903
430467;202005;471;1145;323;907;43;140;168;450;211;590
430468;202005;1201;2986;923;2567;83;249;596;1626;679;1875
430469;202005;552;1498;66;214;7;23;12;18;19;41
430470;202005;5311;13643;3473;10335;1022;3340;905;2517;1927;5857
430471;202005;519;1475;419;1290;60;208;243;707;303;915
430480;202005;709;1877;383;1176;52;184;86;228;138;412
430485;202005;165;437;64;198;17;46;7;25;24;71
430490;202005;364;950;203;607;25;90;98;265;123;355
430495;202005;367;981;231;712;32;103;107;312;139;415
430500;202005;944;2451;641;1942;210;693;178;484;388;1177
430510;202005;23791;62413;16801;48574;2822;9288;7585;20101;10407;29389
430511;202005;315;920;131;429;15;54;20;55;35;109
430512;202005;924;2091;711;1776;164;414;267;683;431;1097
430513;202005;752;1881;343;999;49;156;172;472;221;628
430515;202005;365;1032;259;816;32;93;140;440;172;533
430517;202005;1068;3310;781;2627;133;455;395;1354;528;1809
430520;202005;1235;3183;624;1860;121;386;136;372;257;758
430530;202005;922;2337;358;1122;72;219;90;272;162;491
430535;202005;3233;8393;2323;6714;329;996;1170;3266;1499;4262
430537;202005;310;1103;290;1041;20;64;233;838;253;902
430540;202005;590;1434;337;992;57;166;157;463;214;629
430543;202005;740;1325;406;947;51;102;188;489;239;591
430544;202005;686;1936;480;1478;119;379;180;541;299;920
430545;202005;2180;5685;1605;4783;324;1002;794;2423;1118;3425
430550;202005;337;937;240;732;46;149;92;261;138;410
430558;202005;111;253;48;128;7;14;18;49;25;63
430560;202005;330;750;139;425;19;65;45;136;64;201
430570;202005;806;1970;558;1507;93;282;295;748;388;1030
430580;202005;813;2033;576;1658;144;440;249;707;393;1147
430583;202005;195;485;32;103;2;7;9;23;11;30
430585;202005;221;540;107;295;15;48;49;124;64;172
430587;202005;190;535;139;428;16;49;59;185;75;234
430590;202005;1372;3294;1127;2928;53;161;939;2387;992;2548
430593;202005;16;54;11;36;1;3;5;16;6;19
430595;202005;424;1056;112;363;12;50;23;56;35;106
430597;202005;422;1090;216;651;20;63;71;164;91;227
430600;202005;1897;4842;836;2395;150;457;223;571;373;1028
430605;202005;1095;2974;800;2411;109;394;366;1051;475;1445
430607;202005;514;1209;416;1050;26;70;301;747;327;817
430610;202005;5511;12964;3635;10077;1045;3256;791;2154;1836;5410
430613;202005;254;593;67;194;8;24;18;41;26;65
430620;202005;576;1409;415;1107;61;183;239;586;300;769
430630;202005;401;1110;109;356;18;59;22;66;40;125
430632;202005;470;1238;197;608;24;80;91;267;115;347
430635;202005;516;1229;379;1000;46;124;270;718;316;842
430637;202005;441;1093;341;947;36;117;215;566;251;683
430640;202005;991;2590;589;1773;87;278;211;586;298;864
430642;202005;347;946;261;749;42;113;138;374;180;487
430645;202005;153;357;58;154;8;23;20;50;28;73
430650;202005;1545;4478;1228;3954;334;1078;577;1932;911;3010
430655;202005;266;671;158;446;23;75;78;192;101;267
430660;202005;4975;12863;3723;10736;835;2559;1604;4547;2439;7106
430670;202005;643;1561;487;1286;34;97;293;778;327;875
430673;202005;524;1197;204;601;37;113;76;206;113;319
430675;202005;239;688;56;199;8;28;24;86;32;114
430676;202005;4690;11700;3681;10150;447;1365;2332;6260;2779;7625
430680;202005;854;2316;517;1622;142;456;129;398;271;854
430690;202005;2746;7516;2156;6437;742;2333;587;1659;1329;3992
430692;202005;213;656;161;561;12;46;121;427;133;473
430693;202005;933;2466;552;1696;104;374;145;398;249;772
430695;202005;428;1108;236;699;32;83;124;355;156;438
430697;202005;380;967;286;817;73;192;142;439;215;631
430700;202005;6626;16435;3780;11104;797;2563;720;1939;1517;4502
430705;202005;387;941;189;572;21;74;78;204;99;278
430710;202005;1607;3501;1117;2828;144;406;674;1676;818;2082
430720;202005;666;1615;337;1031;49;148;173;534;222;682
430730;202005;996;2734;676;2117;95;286;359;1118;454;1404
430740;202005;567;1553;285;952;54;189;71;257;125;446
430745;202005;352;975;218;679;41;148;68;181;109;329
430750;202005;1281;3287;884;2605;192;587;458;1324;650;1911
430755;202005;445;1076;271;727;20;57;156;386;176;443
430760;202005;1962;4826;1476;4063;344;1026;661;1728;1005;2754
430770;202005;5918;14855;4501;12729;585;1894;2840;7759;3425;9653
430780;202005;1807;4412;1017;3032;203;672;394;1129;597;1801
430781;202005;440;1237;237;753;30;94;68;184;98;278
430783;202005;349;809;207;593;19;67;128;341;147;408
430786;202005;30;107;22;85;3;9;3;15;6;24
430790;202005;4130;10147;2821;7876;322;1078;1713;4471;2035;5549
430800;202005;739;1722;542;1419;35;97;359;944;394;1041
430805;202005;356;961;217;653;16;58;135;382;151;440
430807;202005;435;1062;226;654;23;67;96;258;119;325
430810;202005;668;1571;264;785;32;122;113;309;145;431
430820;202005;1157;3084;660;2106;132;441;188;590;320;1031
430825;202005;225;565;78;204;13;33;23;55;36;88
430830;202005;1649;4734;1315;4084;62;216;942;2897;1004;3113
430840;202005;996;2490;699;1979;91;283;473;1309;564;1592
430843;202005;122;290;53;149;3;11;25;65;28;76
430845;202005;415;996;277;764;53;162;116;302;169;464
430850;202005;2248;5851;1508;4397;236;759;593;1747;829;2506
430860;202005;868;2015;376;1070;46;162;180;439;226;601
430865;202005;508;1263;376;1039;73;202;174;475;247;677
430870;202005;599;1559;254;796;38;144;83;224;121;368
430880;202005;1429;3263;962;2550;159;442;511;1326;670;1768
430885;202005;176;479;88;302;6;20;52;175;58;195
430890;202005;954;2382;625;1814;54;232;131;354;185;586
430900;202005;2954;6479;2007;5102;166;498;1323;3163;1489;3661
430905;202005;729;1862;452;1333;83;280;169;456;252;736
430910;202005;1485;3929;1016;2968;172;598;494;1276;666;1874
430912;202005;487;1355;325;1031;25;76;221;715;246;791
430915;202005;463;1417;348;1195;127;434;93;328;220;762
430920;202005;22424;56878;16887;47557;2319;7231;10086;27652;12405;34883
430925;202005;94;213;34;103;5;13;15;49;20;62
430930;202005;9997;23729;6245;17885;1205;3527;2571;7696;3776;11223
430940;202005;917;2403;538;1577;145;459;137;332;282;791
430950;202005;742;1741;468;1264;37;133;293;720;330;853
430955;202005;333;890;84;256;21;65;22;52;43;117
430957;202005;174;599;159;560;25;90;97;338;122;428
430960;202005;1305;3122;721;2038;155;469;311;852;466;1321
430965;202005;1589;3777;1220;3199;66;180;937;2507;1003;2687
430970;202005;345;836;168;484;23;72;83;213;106;285
430975;202005;481;1448;364;1173;78;261;185;576;263;837
430980;202005;377;863;219;592;29;92;104;253;133;345
430990;202005;526;1511;322;1016;41;129;160;508;201;637
430995;202005;536;1381;385;1133;44;140;212;611;256;751
431000;202005;1315;3103;520;1512;92;297;38;102;130;399
431010;202005;1968;5070;1188;3742;236;823;221;589;457;1412
431020;202005;7857;17031;4572;12063;1047;3130;1531;3501;2578;6631
431030;202005;319;878;155;525;28;100;22;70;50;170
431033;202005;3477;8245;2173;6179;476;1374;765;2220;1241;3594
431036;202005;334;726;73;209;6;18;22;53;28;71
431040;202005;871;2242;556;1670;86;295;247;681;333;976
431041;202005;455;1051;332;867;27;67;200;516;227;583
431043;202005;328;819;174;538;36;127;84;254;120;381
431046;202005;102;267;39;119;2;5;10;30;12;35
431050;202005;1305;3191;927;2582;171;524;469;1323;640;1847
431053;202005;618;1681;342;1070;74;266;107;294;181;560
431055;202005;576;1412;483;1270;57;138;339;891;396;1029
431057;202005;235;671;116;384;26;85;33;100;59;185
431060;202005;5207;13477;3460;10414;839;2760;911;2698;1750;5458
431065;202005;393;987;273;785;48;150;131;367;179;517
431070;202005;410;1149;226;729;53;184;53;167;106;351
431075;202005;208;615;125;418;24;87;38;128;62;215
431080;202005;534;1462;357;1087;63;220;125;365;188;585
431085;202005;719;1880;449;1250;64;177;219;595;283;772
431087;202005;402;1143;325;979;21;62;226;702;247;764
431090;202005;400;940;153;470;28;95;43;136;71;231
431100;202005;3313;7253;2248;5826;323;851;1148;3028;1471;3879
431110;202005;1333;3065;887;2305;273;726;328;793;601;1519
431112;202005;551;1535;457;1351;66;222;280;794;346;1016
431113;202005;351;980;304;889;48;156;189;538;237;694
431115;202005;939;2694;724;2292;101;384;413;1225;514;1609
431120;202005;2322;6459;1562;4877;485;1711;359;1009;844;2720
431123;202005;395;1083;248;766;44;120;136;438;180;558
431125;202005;957;2768;723;2299;263;810;252;859;515;1669
431127;202005;195;508;59;189;6;19;12;33;18;52
431130;202005;2847;7321;2054;5971;301;1004;1156;3257;1457;4261
431140;202005;4928;11659;2789;7632;348;1050;1246;2985;1594;4035
431142;202005;482;1293;355;1062;46;144;220;657;266;801
431150;202005;989;2656;688;2084;130;424;295;870;425;1294
431160;202005;631;1809;419;1333;71;243;126;400;197;643
431162;202005;483;1169;258;758;27;91;142;389;169;480
431164;202005;172;391;39;118;9;29;4;7;13;36
431170;202005;452;1260;313;960;98;298;89;258;187;556
431171;202005;622;1476;500;1311;105;245;298;813;403;1058
431173;202005;390;1036;287;878;77;264;120;344;197;608
431175;202005;1169;2734;694;1911;111;306;257;680;368;986
431177;202005;778;2127;590;1823;133;471;347;1019;480;1490
431179;202005;336;733;95;282;18;54;22;61;40;115
431180;202005;2083;5284;1251;3642;323;931;344;1000;667;1931
431190;202005;439;1141;217;658;29;94;79;191;108;285
431198;202005;332;976;270;868;102;345;72;252;174;597
431200;202005;355;884;74;202;15;43;10;23;25;66
431205;202005;192;526;95;302;25;84;36;114;61;198
431210;202005;586;1474;467;1306;117;328;218;651;335;979
431213;202005;237;635;176;522;13;42;90;276;103;318
431215;202005;554;1319;238;698;23;73;116;322;139;395
431217;202005;148;381;98;290;9;30;57;159;66;189
431220;202005;530;1374;309;937;30;109;174;487;204;596
431225;202005;1471;3496;1113;2892;111;309;778;2029;889;2338
431230;202005;661;1894;508;1543;65;215;312;912;377;1127
431235;202005;152;387;24;83;4;11;5;21;9;32
431237;202005;312;989;255;855;48;175;133;427;181;602
431238;202005;26;65;21;55;5;16;8;13;13;29
431240;202005;4076;10169;3117;8661;463;1440;1775;4731;2238;6171
431242;202005;236;643;199;582;42;130;106;302;148;432
431244;202005;313;754;163;457;24;80;58;138;82;218
431245;202005;1255;2937;777;2097;77;227;411;1051;488;1278
431247;202005;234;620;128;391;27;88;46;120;73;208
431250;202005;1579;3985;1145;3393;248;762;596;1835;844;2597
431260;202005;229;635;148;477;22;82;49;149;71;231
431261;202005;226;699;181;626;14;57;98;322;112;379
431262;202005;363;1007;176;569;9;23;118;387;127;410
431265;202005;1525;3606;599;1756;75;269;212;533;287;802
431267;202005;272;725;165;482;7;33;118;311;125;344
431270;202005;2688;6119;1407;3944;337;980;446;1263;783;2243
431275;202005;115;332;57;184;23;74;10;31;33;105
431280;202005;221;587;63;198;5;18;6;12;11;30
431290;202005;287;844;186;588;34;126;32;73;66;199
431295;202005;70;178;21;66;2;7;7;21;9;28
431300;202005;284;731;49;154;3;10;13;30;16;40
431301;202005;300;859;64;212;7;19;5;15;12;34
431303;202005;542;1440;316;940;23;80;146;409;169;489
431306;202005;2074;4832;1172;3320;170;537;493;1237;663;1774
431308;202005;24;73;21;67;9;31;10;31;19;62
431310;202005;516;1456;360;1102;47;152;162;455;209;607
431320;202005;593;1628;288;958;39;119;54;154;93;273
431330;202005;1606;3764;758;2190;146;478;287;750;433;1228
431333;202005;214;571;105;312;19;55;39;108;58;163
431335;202005;40;108;21;64;4;8;3;7;7;15
431337;202005;2527;6722;1820;5541;338;1169;933;2729;1271;3898
431339;202005;400;1046;291;842;82;243;118;338;200;581
431340;202005;18369;44425;12444;34426;2171;6641;5479;14246;7650;20887
431342;202005;404;874;293;717;14;31;261;641;275;672
431344;202005;384;980;224;668;9;33;129;366;138;399
431346;202005;241;587;92;292;15;53;25;76;40;129
431349;202005;615;1614;321;955;80;232;118;350;198;582
431350;202005;3824;9961;2778;8127;407;1354;1459;4114;1866;5468
431360;202005;555;1323;271;772;81;235;73;207;154;442
431365;202005;1919;4559;1507;3990;120;350;1122;2946;1242;3296
431370;202005;4231;10404;3001;8337;640;1860;1475;4191;2115;6051
431380;202005;772;2079;621;1835;34;109;438;1297;472;1406
431390;202005;2510;6095;1478;4241;161;554;709;1782;870;2336
431395;202005;1247;3112;868;2527;204;613;378;1139;582;1752
431400;202005;318;885;170;531;30;90;38;111;68;201
431402;202005;837;1888;599;1525;76;207;399;992;475;1199
431403;202005;190;535;149;459;24;87;71;187;95;274
431405;202005;4257;11201;3222;9481;588;1920;1554;4350;2142;6270
431406;202005;515;1463;369;1156;79;241;188;609;267;850
431407;202005;426;1196;290;908;61;215;147;438;208;653
431410;202005;15648;39685;10028;29566;1525;5183;4913;13564;6438;18747
431413;202005;223;589;61;201;7;24;8;28;15;52
431415;202005;648;1591;397;1168;72;255;188;490;260;745
431417;202005;528;1176;360;922;55;159;202;508;257;667
431420;202005;1543;3484;1142;2926;165;430;635;1622;800;2052
431430;202005;526;1357;246;781;38;128;73;198;111;326
431440;202005;29229;68576;20083;54072;3459;10047;7807;19814;11266;29861
431442;202005;102;272;46;149;8;22;8;22;16;44
431445;202005;376;1058;118;384;15;42;11;33;26;75
431446;202005;262;779;194;640;35;129;98;309;133;438
431447;202005;691;1837;400;1220;77;265;142;430;219;695
431449;202005;726;1903;431;1277;80;220;178;538;258;758
431450;202005;2183;4506;1716;3855;87;209;1339;2937;1426;3146
431454;202005;31;100;27;91;7;22;9;31;16;53
431455;202005;603;1442;296;799;35;101;151;370;186;471
431460;202005;2711;6690;1919;5277;496;1447;538;1501;1034;2948
431470;202005;1391;3920;1000;3081;200;627;434;1368;634;1995
431475;202005;249;670;42;152;5;18;6;13;11;31
431477;202005;391;1012;232;684;43;125;92;238;135;363
431478;202005;254;665;51;161;12;33;8;19;20;52
431480;202005;3011;7544;2333;6473;553;1556;1173;3290;1726;4846
431490;202005;106444;251156;80101;210501;5931;18417;58165;147011;64096;165428
431500;202005;464;1169;338;929;60;168;183;485;243;653
431505;202005;268;642;183;514;11;35;129;361;140;396
431507;202005;336;793;130;387;40;127;36;100;76;227
431510;202005;1508;3903;1003;2919;216;686;361;1036;577;1722
431513;202005;191;416;110;292;10;23;75;200;85;223
431514;202005;97;246;65;187;4;11;47;128;51;139
431515;202005;443;1113;312;881;66;182;156;444;222;626
431517;202005;61;184;49;153;8;24;22;65;30;89
431520;202005;409;995;154;479;23;83;66;175;89;258
431530;202005;4018;8575;2250;5942;517;1386;548;1461;1065;2847
431531;202005;203;505;120;344;13;39;55;144;68;183
431532;202005;535;1243;316;852;71;216;124;318;195;534
431535;202005;242;648;110;347;20;67;25;69;45;136
431540;202005;1749;5648;1624;5475;57;243;1330;4484;1387;4727
431545;202005;336;863;63;192;5;11;13;39;18;50
431550;202005;1919;4931;1429;4004;242;758;730;1949;972;2707
431555;202005;645;1466;400;1049;26;79;237;611;263;690
431560;202005;21638;52731;14492;41451;2959;8906;4866;14672;7825;23578
431570;202005;4373;10577;3477;9274;404;1202;2447;6250;2851;7452
431575;202005;225;565;166;460;48;115;46;136;94;251
431580;202005;588;1522;353;1038;41;148;194;539;235;687
431590;202005;568;1576;430;1292;94;296;167;519;261;815
431595;202005;346;947;221;668;47;144;88;244;135;388
431600;202005;1305;2990;882;2381;226;662;343;945;569;1607
431610;202005;1350;3477;911;2661;132;370;471;1417;603;1787
431620;202005;464;1189;209;612;34;98;80;225;114;323
431630;202005;1308;3256;607;1797;101;323;213;576;314;899
431640;202005;6039;14604;5099;13421;502;1354;3774;10025;4276;11379
431642;202005;531;1306;326;887;23;59;165;417;188;476
431643;202005;361;892;172;494;17;44;56;159;73;203
431645;202005;1789;4029;1384;3474;61;188;1108;2747;1169;2935
431647;202005;248;613;80;233;7;13;23;60;30;73
431650;202005;112;304;74;240;5;19;44;130;49;149
431660;202005;855;2290;424;1384;71;269;114;331;185;600
431670;202005;1110;2650;688;1874;104;301;352;903;456;1204
431673;202005;229;587;80;272;14;49;16;52;30;101
431675;202005;514;1274;104;334;11;41;20;53;31;94
431680;202005;7290;18730;5208;14810;1220;3640;2229;6173;3449;9813
431690;202005;22234;54503;14293;40163;2959;8911;5523;15513;8482;24424
431695;202005;154;368;94;278;21;77;50;123;71;200
431697;202005;443;1049;339;887;47;114;201;539;248;653
431700;202005;1306;3392;1097;3015;160;409;663;1811;823;2220
431710;202005;12257;29716;8375;24067;1496;4616;4065;11912;5561;16528
431720;202005;6045;15062;3468;9987;866;2669;646;1628;1512;4297
431725;202005;31;88;24;74;4;11;10;30;14;41
431730;202005;3786;9102;2305;6739;545;1696;705;2202;1250;3898
431740;202005;4918;11701;3149;8675;850;2706;805;1869;1655;4575
431750;202005;7169;18414;5391;15534;1220;3787;2288;6471;3508;10258
431755;202005;315;868;68;240;9;32;12;44;21;76
431760;202005;5104;11470;3356;8676;365;1078;2014;4931;2379;6009
431770;202005;1822;4302;1410;3750;80;259;1088;2815;1168;3074
431775;202005;197;513;103;316;21;67;14;36;35;103
431780;202005;1961;4944;1230;3558;206;670;513;1428;719;2098
431790;202005;777;2116;558;1686;101;299;251;735;352;1034
431795;202005;226;573;108;326;24;64;28;80;52;144
431800;202005;7873;18963;4759;13947;1254;4262;525;1587;1779;5849
431805;202005;290;681;86;279;7;25;30;96;37;121
431810;202005;3179;7550;1975;5332;380;1080;837;2176;1217;3256
431820;202005;2091;5648;1632;4905;455;1438;559;1777;1014;3215
431830;202005;8753;18914;6377;15752;1627;4721;2005;4924;3632;9645
431840;202005;2474;6553;1956;5698;316;920;1201;3534;1517;4454
431842;202005;543;1363;183;567;22;76;60;164;82;240
431843;202005;328;876;241;689;31;101;120;316;151;417
431844;202005;193;501;57;187;11;38;19;67;30;105
431845;202005;510;1341;353;1025;31;88;206;598;237;686
431846;202005;279;725;234;658;9;29;210;590;219;619
431848;202005;101;261;63;189;9;29;11;26;20;55
431849;202005;408;983;62;179;4;7;7;15;11;22
431850;202005;3972;10819;3027;8907;713;2263;957;2795;1670;5058
431860;202005;618;1500;342;969;56;169;188;511;244;680
431861;202005;92;252;49;155;10;37;15;43;25;80
431862;202005;432;1371;353;1234;67;259;179;598;246;857
431870;202005;18302;47051;14588;41141;1802;5705;8841;24085;10643;29790
431880;202005;3890;10002;2713;7872;432;1430;1238;3410;1670;4840
431890;202005;4384;11022;2657;7704;757;2427;470;1507;1227;3934
431900;202005;932;2366;591;1737;93;309;308;851;401;1160
431910;202005;727;1753;250;713;42;120;74;171;116;291
431912;202005;452;1249;354;1075;69;223;206;613;275;836
431915;202005;1004;2521;782;2161;30;97;596;1613;626;1710
431920;202005;1187;2823;983;2551;28;71;846;2194;874;2265
431930;202005;648;1737;438;1351;133;371;192;627;325;998
431935;202005;83;231;57;177;15;51;12;37;27;88
431936;202005;298;861;161;516;34;114;62;182;96;296
431937;202005;160;398;102;274;17;51;46;98;63;149
431940;202005;2917;6949;1656;4625;189;578;817;2189;1006;2767
431950;202005;1724;4559;1368;3977;440;1309;508;1455;948;2764
431960;202005;2810;6933;2005;5463;561;1597;520;1403;1081;3000
431970;202005;404;1027;157;460;37;107;42;105;79;212
431971;202005;82;211;32;105;2;9;4;8;6;17
431973;202005;467;1497;384;1337;37;137;283;982;320;1119
431975;202005;110;229;22;74;2;10;2;6;4;16
431980;202005;993;2595;762;2211;158;482;356;999;514;1481
431990;202005;5448;13093;3606;10411;491;1698;1738;4785;2229;6483
432000;202005;10645;25440;7650;20767;1827;5059;3342;9171;5169;14230
432010;202005;2048;5107;1495;4128;228;704;868;2269;1096;2973
432020;202005;1736;4458;1068;3075;222;671;449;1224;671;1895
432023;202005;497;1201;257;735;35;113;120;303;155;416
432026;202005;935;2627;683;2135;174;550;236;737;410;1287
432030;202005;343;849;191;537;22;60;109;304;131;364
432032;202005;331;863;228;660;28;95;125;340;153;435
432035;202005;643;1831;556;1681;172;527;231;724;403;1251
432040;202005;1010;2331;352;1089;57;193;117;328;174;521
432045;202005;161;447;97;317;23;74;34;117;57;191
432050;202005;450;1155;334;946;72;208;138;410;210;618
432055;202005;578;1562;375;1172;130;414;75;219;205;633
432057;202005;219;586;164;450;25;61;71;181;96;242
432060;202005;446;1080;133;419;30;105;43;117;73;222
432065;202005;203;568;143;436;29;87;60;181;89;268
432067;202005;700;2049;586;1798;51;178;439;1295;490;1473
432070;202005;1611;4267;1032;3114;242;805;318;874;560;1679
432080;202005;4299;10290;3272;8632;580;1779;1545;3845;2125;5624
432085;202005;338;870;228;700;62;194;90;286;152;480
432090;202005;1408;3604;921;2651;185;567;452;1223;637;1790
432100;202005;887;2282;415;1303;82;272;78;191;160;463
432110;202005;1980;5309;1322;4098;319;1124;127;360;446;1484
432120;202005;2670;7272;2036;6168;390;1306;792;2290;1182;3596
432130;202005;2449;6297;2010;5651;586;1687;901;2582;1487;4269
432132;202005;166;466;98;317;20;64;44;123;64;187
432135;202005;990;2337;646;1747;36;115;466;1245;502;1360
432140;202005;1419;4259;1077;3583;159;568;670;2227;829;2795
432143;202005;1375;3589;1050;3081;69;222;698;2035;767;2257
432145;202005;1370;3611;810;2420;112;368;266;665;378;1033
432146;202005;99;270;65;211;22;77;21;62;43;139
432147;202005;460;1310;265;885;87;314;68;195;155;509
432149;202005;422;1038;213;605;14;45;102;260;116;305
432150;202005;2896;7421;2067;5936;449;1445;786;2207;1235;3652
432160;202005;4959;13124;3584;10886;904;3027;1267;3655;2171;6682
432162;202005;254;557;35;100;5;10;5;14;10;24
432163;202005;119;292;24;64;0;0;3;4;3;4
432166;202005;585;1656;435;1338;81;276;145;403;226;679
432170;202005;1296;3455;821;2554;153;526;307;886;460;1412
432180;202005;2770;6612;1515;4214;295;875;537;1319;832;2194
432183;202005;348;1029;228;742;57;211;59;179;116;390
432185;202005;786;2038;456;1385;35;122;247;707;282;829
432190;202005;1731;4229;1107;3218;203;649;547;1499;750;2148
432195;202005;884;2222;576;1666;164;442;199;610;363;1052
432200;202005;3074;7924;2187;6482;378;1137;1204;3622;1582;4759
432210;202005;362;957;221;677;41;158;103;264;144;422
432215;202005;608;1781;549;1690;53;146;407;1273;460;1419
432218;202005;245;611;107;305;17;59;49;126;66;185
432220;202005;3415;8090;2517;6666;442;1245;1386;3597;1828;4842
432225;202005;86;248;64;203;11;41;37;115;48;156
432230;202005;679;1587;357;981;40;114;159;398;199;512
432232;202005;469;1149;291;837;59;185;104;273;163;458
432234;202005;266;664;120;353;21;53;14;38;35;91
432235;202005;46;131;16;50;4;12;4;13;8;25
432237;202005;321;825;279;755;11;22;229;608;240;630
432240;202005;14965;37438;10680;31627;788;2580;6773;21001;7561;23581
432250;202005;4787;13905;3688;11777;973;3247;1514;4817;2487;8064
432252;202005;440;1047;272;751;35;103;141;373;176;476
432253;202005;876;2704;544;1844;128;468;45;141;173;609
432254;202005;646;1506;155;461;28;85;28;70;56;155
432255;202005;109;276;56;170;3;9;27;73;30;82
432260;202005;4566;11812;3350;9482;987;2897;1046;2857;2033;5754
432270;202005;1716;4818;1358;4119;401;1318;279;788;680;2106
432280;202005;1249;3125;623;1868;97;304;229;571;326;875
432285;202005;138;414;19;57;2;6;2;4;4;10
432290;202005;322;906;166;525;57;183;33;76;90;259
432300;202005;25059;63500;18535;52834;2714;8728;10711;29474;13425;38202
432310;202005;795;2153;566;1721;52;160;391;1191;443;1351
432320;202005;214;503;78;239;10;33;28;78;38;111
432330;202005;208;471;59;191;9;22;10;34;19;56
432335;202005;180;498;61;214;6;26;15;50;21;76
432340;202005;291;689;124;386;10;31;45;132;55;163
432345;202005;649;1516;570;1420;18;48;464;1142;482;1190
432350;202005;342;898;185;586;27;92;74;231;101;323
432360;202005;234;680;48;154;3;6;17;55;20;61
432370;202005;302;753;199;575;14;47;136;387;150;434
432375;202005;462;1163;339;920;60;156;169;464;229;620
432377;202005;176;548;33;110;7;28;5;12;12;40
432380;202005;1571;4183;993;3110;174;620;499;1494;673;2114
500020;202005;2409;6272;1726;5105;160;556;1062;3053;1222;3609
500025;202005;1184;2901;736;2050;70;214;404;1063;474;1277
500060;202005;7562;21437;5117;16314;624;2078;2962;9712;3586;11790
500070;202005;4165;10807;2862;8564;531;1623;1225;3754;1756;5377
500080;202005;1516;3773;929;2681;180;576;356;903;536;1479
500085;202005;1976;4971;1338;3908;307;943;629;1764;936;2707
500090;202005;2045;5488;1363;4271;243;800;481;1582;724;2382
500100;202005;3499;8930;2634;7513;451;1445;1269;3431;1720;4876
500110;202005;7743;19910;4893;15312;1047;3585;1500;5509;2547;9094
500124;202005;1992;5876;1575;5166;255;790;838;2887;1093;3677
500150;202005;1262;2877;777;2166;140;399;309;862;449;1261
500190;202005;4642;12019;2925;8683;634;1915;750;2148;1384;4063
500200;202005;2168;5200;1582;4215;174;487;964;2454;1138;2941
500210;202005;4506;11047;3182;9295;848;2472;1394;4172;2242;6644
500215;202005;1318;3716;930;2989;89;316;507;1621;596;1937
500220;202005;2415;6818;1507;5058;256;924;359;1158;615;2082
500230;202005;2017;4743;1514;4036;180;449;1014;2687;1194;3136
500240;202005;3673;10962;2545;8575;395;1482;1007;3504;1402;4986
500260;202005;3087;6585;1903;4959;271;700;977;2464;1248;3164
500270;202005;132404;311963;77582;218019;13077;40329;28115;74615;41192;114944
500280;202005;1277;3244;869;2605;122;390;477;1405;599;1795
500290;202005;3479;8281;1955;5726;321;1071;616;1641;937;2712
500295;202005;3270;7960;1997;5672;315;986;756;1844;1071;2830
500310;202005;939;1966;627;1568;101;218;315;819;416;1037
500315;202005;3552;10004;2771;8820;234;764;1946;6348;2180;7112
500320;202005;18781;50886;12950;41191;3295;11030;4447;15032;7742;26062
500325;202005;4142;9260;2826;7523;225;633;1912;5161;2137;5794
500330;202005;6516;14888;4241;11547;320;961;2357;6583;2677;7544
500345;202005;1974;4855;1298;3801;311;947;431;1239;742;2186
500348;202005;2285;5943;1756;5061;234;694;1012;2973;1246;3667
500350;202005;1263;3453;692;2204;81;251;282;867;363;1118
500370;202005;24402;63188;16827;50665;2268;7821;8733;26188;11001;34009
500375;202005;2398;6349;1576;4654;293;937;521;1442;814;2379
500380;202005;3351;8392;2266;6538;634;1979;535;1556;1169;3535
500390;202005;579;1175;341;887;54;169;212;528;266;697
500400;202005;1400;3585;920;2648;169;558;307;793;476;1351
500410;202005;2336;5793;1637;4735;178;506;947;2846;1125;3352
500430;202005;2500;6175;1679;4950;221;761;720;2229;941;2990
500440;202005;1081;2680;677;2037;104;344;262;840;366;1184
500450;202005;1396;3468;763;2296;133;423;186;526;319;949
500460;202005;3573;9646;2149;6798;358;1285;676;2096;1034;3381
500470;202005;2415;6525;1448;4508;410;1420;310;845;720;2265
500480;202005;2064;6320;1738;5795;154;569;1294;4355;1448;4924
500490;202005;972;2263;558;1643;122;437;156;453;278;890
500500;202005;4130;11089;2621;8600;929;3580;448;1515;1377;5095
500510;202005;674;1722;432;1261;26;91;265;752;291;843
500515;202005;1696;4348;1290;3699;137;430;814;2233;951;2663
500520;202005;2996;9487;2351;8256;630;2245;956;3568;1586;5813
500525;202005;838;2520;685;2283;59;207;428;1450;487;1657
500540;202005;4379;11411;2607;8244;686;2696;241;679;927;3375
500560;202005;5375;14633;4294;13269;276;874;3442;10815;3718;11689
500568;202005;4181;9157;2486;6630;577;1697;876;2335;1453;4032
500570;202005;7311;17097;4351;12028;798;2401;1559;4052;2357;6453
500580;202005;2972;7948;2147;6478;472;1488;996;3020;1468;4508
500600;202005;3158;7932;2228;6478;508;1509;915;2738;1423;4247
500620;202005;7344;19519;4879;14771;1049;3336;1714;5112;2763;8448
500625;202005;521;1429;324;1002;57;187;88;246;145;433
500627;202005;726;1890;441;1383;75;251;145;456;220;707
500630;202005;6407;14860;3655;10254;755;2325;1071;3011;1826;5336
500635;202005;2803;8891;2168;8057;162;667;1519;6138;1681;6805
500640;202005;1661;3655;1084;2885;38;119;746;1959;784;2078
500660;202005;17104;44284;11648;36316;3672;13011;2915;9348;6587;22359
500690;202005;2245;6297;1462;4929;520;2041;81;199;601;2240
500710;202005;2746;7422;2108;6318;600;1899;657;1859;1257;3758
500720;202005;4674;11917;3001;9114;689;2234;896;2793;1585;5027
500730;202005;981;2467;570;1719;107;311;143;457;250;768
500740;202005;4459;10681;3024;8397;384;1111;1586;4410;1970;5521
500750;202005;936;2424;617;1827;83;243;242;654;325;897
500755;202005;846;2241;455;1479;83;290;87;258;170;548
500769;202005;4849;11927;2597;7663;495;1650;370;864;865;2514
500770;202005;1436;3897;915;2953;163;603;311;990;474;1593
500780;202005;1174;2860;755;2155;156;501;202;553;358;1054
500790;202005;6981;18581;5404;15945;1102;3490;2663;7908;3765;11398
500793;202005;1961;5089;1371;4045;353;1115;434;1188;787;2303
500795;202005;2616;6531;2127;5911;97;243;1736;5063;1833;5306
500797;202005;667;1709;439;1280;124;375;138;405;262;780
500800;202005;2989;6857;1836;5156;578;1922;204;625;782;2547
500830;202005;17662;44513;11924;33882;2504;7634;4321;11603;6825;19237
500840;202005;1353;3305;817;2295;94;271;327;867;421;1138
510010;202005;1772;4013;1170;3233;104;267;836;2351;940;2618
510020;202005;3307;8404;1743;5328;372;1219;389;1080;761;2299
510025;202005;6497;15893;3943;11711;585;1979;1627;4677;2212;6656
510030;202005;2429;5457;1585;4199;337;907;612;1592;949;2499
510035;202005;1191;3112;748;2400;85;296;445;1523;530;1819
510040;202005;2211;4945;1608;4165;151;382;1028;2776;1179;3158
510050;202005;2033;4300;1326;3375;144;407;930;2318;1074;2725
510060;202005;1295;3286;937;2707;196;624;267;721;463;1345
510080;202005;1208;3190;771;2448;265;877;211;577;476;1454
510100;202005;635;1489;435;1172;55;156;229;595;284;751
510120;202005;265;484;146;343;9;18;108;260;117;278
510125;202005;2004;4963;1565;4331;161;580;831;2155;992;2735
510130;202005;1408;3558;979;2870;202;655;307;921;509;1576
510140;202005;2985;7766;2022;6548;720;2734;701;2128;1421;4862
510160;202005;1672;4325;1219;3734;160;477;881;2756;1041;3233
510170;202005;4374;11567;3168;9613;772;2465;1235;3844;2007;6309
510180;202005;14008;31567;8686;23683;1892;5676;2577;7984;4469;13660
510185;202005;1653;4300;1085;3487;438;1426;279;1164;717;2590
510190;202005;1995;5719;1279;4494;352;1361;222;859;574;2220
510250;202005;16132;41071;11995;34901;2311;7045;6074;18394;8385;25439
510260;202005;1877;7911;1551;7318;262;1334;939;4826;1201;6160
510263;202005;2976;8282;1805;5891;302;1100;246;696;548;1796
510267;202005;4674;13353;2640;8794;482;1691;351;1069;833;2760
510268;202005;1216;2979;922;2533;110;291;605;1659;715;1950
510269;202005;983;2672;596;1935;144;515;184;549;328;1064
510270;202005;2815;8091;1923;6454;342;1271;783;2586;1125;3857
510279;202005;1725;4454;1066;3297;200;689;438;1316;638;2005
510285;202005;1084;2838;735;2237;228;785;155;423;383;1208
510300;202005;3591;9097;2619;7778;369;1145;1532;4749;1901;5894
510305;202005;1381;3821;831;2748;181;641;192;716;373;1357
510310;202005;891;2188;594;1690;166;493;166;495;332;988
510320;202005;3560;8880;2412;6892;551;1722;616;1743;1167;3465
510325;202005;4137;12263;3090;10345;890;3138;944;3278;1834;6416
510330;202005;2649;8013;1784;6473;348;1272;661;2765;1009;4037
510335;202005;4684;13504;3526;11641;535;1911;2004;6793;2539;8704
510336;202005;436;1237;311;1036;53;182;153;559;206;741
510337;202005;1463;4275;939;3315;363;1409;183;656;546;2065
510340;202005;87912;195773;54918;147675;13338;42616;16206;40810;29544;83426
510343;202005;978;2697;666;2115;120;430;281;847;401;1277
510345;202005;1223;3508;917;2906;155;488;416;1297;571;1785
510350;202005;2691;7035;1739;5406;376;1241;681;2092;1057;3333
510360;202005;1846;3841;1183;3061;70;138;816;2283;886;2421
510370;202005;1724;4892;1243;4060;171;620;733;2479;904;3099
510380;202005;539;1337;294;910;54;189;111;335;165;524
510385;202005;1196;4008;873;3398;94;425;546;2199;640;2624
510390;202005;1235;3283;833;2760;248;834;277;1073;525;1907
510395;202005;711;1615;474;1265;27;74;293;834;320;908
510410;202005;4637;12980;3355;10679;650;2159;1734;5719;2384;7878
510420;202005;2387;5033;1612;4006;129;351;1051;2593;1180;2944
510450;202005;421;1051;247;716;59;173;38;125;97;298
510452;202005;719;2002;500;1590;71;250;282;869;353;1119
510454;202005;898;2496;691;2141;72;212;426;1398;498;1610
510455;202005;886;2477;635;1965;103;353;250;719;353;1072
510460;202005;1736;4309;1226;3551;95;342;780;2160;875;2502
510480;202005;4367;10527;2840;7729;558;1678;1144;3028;1702;4706
510490;202005;1615;4208;1193;3676;165;516;778;2424;943;2940
510500;202005;1487;3748;913;2811;183;597;303;952;486;1549
510510;202005;3302;9685;2425;8097;598;2245;760;2686;1358;4931
510515;202005;5082;13098;3277;9840;793;2646;820;2199;1613;4845
510517;202005;1008;2957;761;2541;228;848;142;414;370;1262
510520;202005;2034;4146;1154;3048;83;219;599;1693;682;1912
510523;202005;1052;2631;774;2179;173;466;437;1276;610;1742
510525;202005;6780;18646;5051;15291;800;2697;2412;6903;3212;9600
510530;202005;547;1410;399;1192;29;93;253;743;282;836
510550;202005;2287;6790;1641;5652;385;1394;729;2537;1114;3931
510558;202005;2210;5947;1592;4974;215;646;740;2511;955;3157
510560;202005;1589;4551;939;3251;193;760;236;884;429;1644
510562;202005;5359;13993;3811;11192;889;2830;1307;4021;2196;6851
510590;202005;3071;7579;2180;6451;169;522;1560;4711;1729;5233
510600;202005;1382;3124;886;2404;161;439;397;1094;558;1533
510610;202005;2578;6243;1760;5168;170;564;1101;3251;1271;3815
510615;202005;2544;6399;1748;5113;309;922;904;2744;1213;3666
510617;202005;976;2942;748;2568;101;398;469;1672;570;2070
510618;202005;1200;3217;817;2546;185;638;372;1106;557;1744
510619;202005;720;1819;454;1370;66;210;123;350;189;560
510620;202005;1390;3126;653;1948;177;643;37;84;214;727
510621;202005;1478;3955;880;2801;185;647;266;799;451;1446
510622;202005;4441;12543;3006;9452;1011;3398;429;1220;1440;4618
510623;202005;2560;6351;1780;5120;419;1420;575;1606;994;3026
510624;202005;1613;4070;750;2485;90;319;165;504;255;823
510625;202005;2783;6817;1483;4475;249;894;332;1014;581;1908
510626;202005;1453;3512;903;2635;248;827;210;615;458;1442
510627;202005;594;1541;333;1031;82;281;83;273;165;554
510628;202005;1419;3285;930;2627;191;574;353;988;544;1562
510629;202005;1544;4390;1139;3660;225;772;420;1347;645;2119
510630;202005;3202;8944;1844;6337;429;1574;329;1214;758;2788
510631;202005;567;1367;410;1135;14;38;313;896;327;934
510637;202005;3308;7989;2357;6607;590;1859;663;1875;1253;3734
510642;202005;5278;15123;3988;13154;975;3490;1707;5791;2682;9281
510645;202005;871;1751;529;1307;155;365;217;537;372;902
510650;202005;6850;17592;5421;16020;618;1631;3740;12196;4358;13827
510665;202005;1835;3995;1128;2855;222;543;421;1145;643;1688
510670;202005;426;910;245;649;25;66;139;379;164;445
510675;202005;5850;16163;3925;12529;1101;3903;649;1993;1750;5896
510677;202005;2021;5222;1384;4258;200;710;733;2190;933;2900
510680;202005;684;1757;381;1188;74;254;76;220;150;474
510682;202005;1484;4396;1079;3722;379;1451;241;802;620;2253
510685;202005;525;1530;374;1218;58;205;188;606;246;811
510700;202005;3968;9575;2745;7837;266;826;2000;5707;2266;6533
510704;202005;10345;24374;6719;18112;1462;4256;1748;4572;3210;8828
510706;202005;1907;5784;1369;4892;262;956;725;2812;987;3768
510710;202005;2546;6388;1646;4699;360;1069;560;1529;920;2598
510715;202005;577;1287;415;1065;36;110;204;512;240;622
510718;202005;2289;5149;1320;3852;390;1149;444;1586;834;2735
510719;202005;430;904;248;666;22;61;144;367;166;428
510720;202005;876;2046;563;1572;93;297;265;698;358;995
510724;202005;776;2126;537;1688;78;261;289;883;367;1144
510726;202005;1033;1875;550;1291;61;165;270;637;331;802
510729;202005;593;1385;260;754;33;111;61;193;94;304
510730;202005;2828;6855;1887;5385;246;799;939;2621;1185;3420
510735;202005;994;2858;752;2514;75;314;552;1825;627;2139
510740;202005;899;2230;561;1592;92;264;250;699;342;963
510757;202005;497;1531;386;1358;121;474;140;473;261;947
510760;202005;42778;94061;25319;67193;5169;15790;7959;19393;13128;35183
510770;202005;4177;9425;2824;7726;238;609;1923;5537;2161;6146
510774;202005;341;868;232;687;36;106;122;371;158;477
510775;202005;597;1596;378;1236;79;283;83;252;162;535
510776;202005;416;1044;294;817;71;196;97;290;168;486
510777;202005;1483;3961;1057;3410;145;544;674;2151;819;2695
510779;202005;658;1767;508;1530;57;164;290;954;347;1118
510780;202005;3534;9092;2580;7754;614;1821;1134;3860;1748;5681
510785;202005;1969;5214;1135;3676;296;1034;185;685;481;1719
510787;202005;2540;7210;1662;5357;544;1858;201;649;745;2507
510788;202005;585;1400;411;1130;64;187;197;613;261;800
510790;202005;16811;43532;10064;30928;2132;7389;1579;4327;3711;11716
510792;202005;8842;24145;5492;17694;1175;4310;937;2662;2112;6972
510794;202005;1203;3201;813;2527;245;848;157;431;402;1279
510795;202005;7856;20655;5034;15518;1150;3923;1289;3900;2439;7823
510800;202005;1649;4275;1063;3272;353;1106;117;360;470;1466
510805;202005;1454;4049;990;3170;234;803;321;930;555;1733
510810;202005;613;1255;383;946;104;259;152;400;256;659
510820;202005;740;1407;402;977;32;95;212;522;244;617
510830;202005;821;1984;581;1677;47;133;408;1256;455;1389
510835;202005;536;1296;344;1016;39;129;204;588;243;717
510840;202005;51052;109257;34976;89672;6795;16418;17713;50220;24508;66638
510850;202005;1781;4281;1004;3043;332;1151;120;333;452;1484
510860;202005;2271;6055;1401;4561;438;1658;113;359;551;2017
510880;202005;690;1965;518;1643;127;417;185;597;312;1014
510885;202005;547;1334;375;1093;76;244;123;350;199;594
510890;202005;615;1817;468;1567;106;380;210;704;316;1084
510895;202005;1236;3175;814;2486;161;582;350;1002;511;1584
520005;202005;2504;6432;1919;5707;571;1697;806;2722;1377;4419
520010;202005;2177;6223;1554;5034;385;1412;471;1335;856;2747
520013;202005;2745;7049;1794;5294;398;1209;509;1640;907;2849
520015;202005;494;1247;349;1031;81;246;137;427;218;673
520017;202005;1123;2881;836;2436;132;420;488;1396;620;1816
520020;202005;387;866;295;750;24;82;228;550;252;632
520025;202005;32678;91603;27965;84984;2772;9205;20110;60824;22882;70029
520030;202005;5470;14027;4348;12455;297;937;3107;8822;3404;9759
520050;202005;399;939;249;682;13;37;158;444;171;481
520055;202005;1729;4194;1123;3029;93;243;646;1701;739;1944
520060;202005;1376;3802;987;3088;254;878;246;770;500;1648
520080;202005;1761;4563;1307;3948;236;716;636;2101;872;2817
520082;202005;890;2254;696;1935;76;194;367;1076;443;1270
520085;202005;799;2150;617;1851;109;334;300;885;409;1219
520090;202005;831;1628;569;1341;56;89;437;1085;493;1174
520110;202005;37495;100823;25773;81270;7887;28362;2240;6423;10127;34785
520120;202005;197;465;110;322;14;49;45;127;59;176
520130;202005;3512;8640;2726;7433;517;1428;1181;3295;1698;4723
520140;202005;39445;105392;27188;84354;9723;32766;3546;11448;13269;44214
520145;202005;584;1353;392;1083;59;187;229;589;288;776
520150;202005;601;1348;432;1144;73;194;236;640;309;834
520160;202005;726;1689;525;1376;98;243;241;672;339;915
520170;202005;4889;9850;3230;7952;180;511;2481;6051;2661;6562
520180;202005;2137;5807;1732;5224;309;1042;973;2913;1282;3955
520215;202005;1679;4045;1188;3287;280;838;407;1068;687;1906
520235;202005;594;1357;338;959;37;128;130;355;167;483
520250;202005;1507;3869;1033;3065;324;1051;250;793;574;1844
520260;202005;781;1826;492;1366;89;254;208;595;297;849
520280;202005;690;1694;532;1449;110;304;254;734;364;1038
520310;202005;1014;2225;658;1694;152;448;254;684;406;1132
520320;202005;1596;4284;1201;3653;158;537;661;1971;819;2508
520330;202005;3813;10281;2742;8527;409;1518;1430;4340;1839;5858
520340;202005;2405;5303;1479;4018;169;428;870;2486;1039;2914
520350;202005;2806;6702;1978;5448;584;1688;755;2120;1339;3808
520355;202005;1789;4886;1260;3826;414;1361;291;772;705;2133
520357;202005;732;1763;522;1455;29;75;391;1120;420;1195
520360;202005;688;1814;520;1535;137;423;151;476;288;899
520380;202005;1406;3482;818;2390;87;266;416;1140;503;1406
520390;202005;1002;2205;589;1694;162;501;202;624;364;1125
520393;202005;489;1179;327;924;38;121;151;395;189;516
520396;202005;823;2123;685;1903;39;129;509;1371;548;1500
520400;202005;1551;3825;1177;3316;150;463;790;2229;940;2692
520410;202005;1943;4383;1166;3191;193;570;447;1172;640;1742
520420;202005;357;829;275;700;21;59;214;525;235;584
520425;202005;1450;3523;812;2352;212;634;178;486;390;1120
520430;202005;2248;5151;1247;3591;237;806;47;128;284;934
520440;202005;2876;6986;1711;4922;417;1331;444;1214;861;2545
520450;202005;11554;27405;7513;21311;2356;7304;1420;4152;3776;11456
520455;202005;681;1863;498;1590;143;480;140;462;283;942
520460;202005;1005;2339;779;2052;74;170;624;1678;698;1848
520465;202005;757;1925;606;1720;79;265;423;1150;502;1415
520470;202005;2024;5234;1542;4591;475;1468;602;1913;1077;3381
520480;202005;895;2487;622;2023;195;652;141;482;336;1134
520485;202005;1529;4327;1278;3980;165;530;905;2810;1070;3340
520490;202005;3890;10713;2883;9112;990;3241;1040;3438;2030;6679
520495;202005;1555;3415;1167;2890;48;120;942;2345;990;2465
520500;202005;1194;3219;811;2469;190;621;326;994;516;1615
520505;202005;746;1633;515;1339;61;164;329;843;390;1007
520510;202005;7476;18557;4879;14522;1111;3718;1345;4316;2456;8034
520520;202005;1123;2826;828;2360;195;608;296;849;491;1457
520530;202005;1994;5722;1490;4886;422;1443;560;1949;982;3392
520540;202005;2797;7401;1713;5250;319;1065;408;1190;727;2255
520545;202005;935;2438;694;2042;144;417;280;840;424;1257
520547;202005;789;2150;627;1880;151;451;313;952;464;1403
520549;202005;12999;34868;10685;31475;1465;4573;7165;21024;8630;25597
520551;202005;4429;11965;3672;10851;389;1357;2612;7551;3001;8908
520552;202005;811;2091;667;1909;139;398;384;1160;523;1558
520570;202005;517;1151;340;904;82;197;134;402;216;599
520580;202005;2142;4911;1605;4283;110;361;1182;3107;1292;3468
520590;202005;1185;3008;822;2416;250;741;225;677;475;1418
520620;202005;7892;21378;6159;18847;1539;4849;2742;8672;4281;13521
520630;202005;708;1827;484;1438;81;255;136;376;217;631
520640;202005;2313;5753;1757;4780;406;1091;739;2080;1145;3171
520650;202005;820;1929;598;1619;95;253;330;945;425;1198
520660;202005;524;1254;273;813;54;187;71;204;125;391
520670;202005;918;2490;773;2283;69;206;500;1460;569;1666
520680;202005;674;1715;503;1444;78;217;261;756;339;973
520690;202005;323;749;220;601;66;165;69;215;135;380
520710;202005;406;978;283;767;12;28;207;551;219;579
520725;202005;1481;3480;1011;2722;116;365;633;1633;749;1998
520735;202005;750;1837;491;1408;105;287;183;568;288;855
520740;202005;2054;4638;1532;4023;268;647;865;2457;1133;3104
520750;202005;648;1570;445;1239;69;191;227;635;296;826
520753;202005;1239;3306;935;2740;181;566;378;1039;559;1605
520760;202005;1170;2622;1025;2448;31;58;937;2275;968;2333
520780;202005;1456;3407;1031;2818;113;326;518;1386;631;1712
520790;202005;3298;7834;2334;6270;315;857;1295;3666;1610;4523
520800;202005;15841;41075;12219;35781;1884;5753;7122;21487;9006;27240
520810;202005;1286;2682;943;2289;156;392;597;1535;753;1927
520815;202005;561;1711;417;1416;74;279;121;422;195;701
520830;202005;1786;3792;1267;3211;44;110;1045;2618;1089;2728
520840;202005;2497;6724;2015;6096;851;2791;534;1731;1385;4522
520850;202005;622;1608;457;1364;157;547;111;344;268;891
520860;202005;6283;16896;4534;14052;1198;4014;1652;5055;2850;9069
520870;202005;102052;236358;67590;185102;14940;44404;23801;64112;38741;108516
520880;202005;6600;18967;5056;16194;1166;3918;1866;6024;3032;9942
520890;202005;3813;9198;2572;7241;514;1583;1102;3114;1616;4697
520910;202005;4517;11405;2835;8460;696;2240;641;1886;1337;4126
520915;202005;701;1961;411;1302;71;247;139;422;210;669
520920;202005;4271;9602;2967;7954;354;985;1675;4684;2029;5669
520929;202005;675;1580;503;1327;63;140;262;742;325;882
520940;202005;948;2510;734;2211;41;132;540;1595;581;1727
520945;202005;468;1068;377;939;17;39;271;665;288;704
520960;202005;1011;2447;794;2115;162;379;457;1257;619;1636
520970;202005;2454;6751;1903;5868;478;1659;493;1629;971;3288
520980;202005;763;1855;554;1569;97;289;225;628;322;917
520990;202005;2938;7823;2344;7037;342;991;1535;4710;1877;5701
520993;202005;1113;2623;759;2075;109;338;429;1111;538;1449
520995;202005;2234;5655;1665;4856;262;776;656;1974;918;2750
521000;202005;8447;22041;5524;16766;1120;3524;1659;5029;2779;8553
521010;202005;3574;9308;2660;7727;259;759;1547;4450;1806;5209
521015;202005;772;1906;527;1476;42;134;330;879;372;1013
521020;202005;3095;7901;1774;5351;527;1763;128;409;655;2172
521030;202005;472;1038;311;794;66;154;129;359;195;513
521040;202005;7511;18417;5497;15231;1181;3419;2321;6584;3502;10003
521056;202005;903;2376;703;2082;226;663;193;639;419;1302
521060;202005;929;2473;677;2012;73;224;311;926;384;1150
521080;202005;1106;2376;557;1517;72;212;232;549;304;761
521090;202005;3144;8401;2106;6363;581;1879;280;884;861;2763
521100;202005;1721;3996;1210;3269;192;515;714;1954;906;2469
521120;202005;4606;10771;3304;9167;204;517;1628;5264;1832;5781
521130;202005;992;2234;552;1470;20;61;294;834;314;895
521140;202005;1220;3140;881;2554;111;335;425;1249;536;1584
521150;202005;12218;26713;7502;20005;1264;3912;3549;9639;4813;13551
521160;202005;628;1306;438;1030;48;110;292;666;340;776
521170;202005;1009;2357;725;1938;55;153;493;1294;548;1447
521180;202005;7016;19465;5721;17203;913;2991;2967;8650;3880;11641
521190;202005;10332;25709;5862;18134;1471;4865;1150;3840;2621;8705
521200;202005;690;1688;476;1340;48;143;269;757;317;900
521205;202005;622;1537;466;1287;16;50;351;925;367;975
521210;202005;684;1751;389;1157;82;263;72;165;154;428
521220;202005;3575;8724;2285;6698;391;1292;863;2504;1254;3796
521225;202005;354;774;253;666;40;112;146;378;186;490
521230;202005;1306;3332;1144;3133;365;1013;582;1692;947;2705
521250;202005;29997;80300;23113;70154;8528;27192;6759;21857;15287;49049
521260;202005;552;1274;396;1026;54;142;227;581;281;723
521270;202005;1777;4498;1541;4221;88;206;1173;3254;1261;3460
521280;202005;1755;4701;1295;3930;307;1036;543;1667;850;2703
521290;202005;472;1102;331;919;42;133;207;558;249;691
521295;202005;1093;2361;822;2063;64;117;669;1742;733;1859
521300;202005;1819;4498;1424;3942;265;690;905;2581;1170;3271
521305;202005;707;1701;500;1389;74;192;285;797;359;989
521308;202005;4651;12444;3208;9680;285;873;1875;5563;2160;6436
521310;202005;8129;20727;5574;16436;1212;3899;2292;6484;3504;10383
521340;202005;407;955;297;794;21;55;202;524;223;579
521350;202005;2001;5095;1503;4342;125;448;1068;2939;1193;3387
521370;202005;1214;3071;710;2198;205;733;87;294;292;1027
521375;202005;1292;3141;867;2531;200;582;265;862;465;1444
521377;202005;1455;3080;1047;2580;83;147;848;2193;931;2340
521380;202005;6044;16002;3886;12017;400;1355;1042;3445;1442;4800
521385;202005;639;1544;489;1352;57;145;280;842;337;987
521390;202005;701;1717;486;1394;143;450;179;542;322;992
521400;202005;2590;5989;1991;5259;226;590;1373;3717;1599;4307
521405;202005;1276;3243;919;2632;177;517;447;1273;624;1790
521410;202005;792;2124;587;1762;107;299;294;941;401;1240
521440;202005;1150;2892;813;2379;271;870;229;677;500;1547
521450;202005;3821;11341;2782;9306;729;2458;720;2564;1449;5022
521460;202005;5590;14663;3894;11641;1316;4122;894;2756;2210;6878
521470;202005;606;1633;361;1119;49;146;119;362;168;508
521480;202005;359;909;211;625;42;126;70;200;112;326
521483;202005;2376;5661;1648;4545;358;1054;635;1738;993;2792
521486;202005;1722;4049;1267;3405;75;203;925;2466;1000;2669
521487;202005;405;986;285;819;44;130;143;419;187;549
521490;202005;893;2378;658;1992;35;137;468;1376;503;1513
521500;202005;2240;5448;1642;4510;97;332;1188;3170;1285;3502
521520;202005;721;1669;509;1358;76;214;213;580;289;794
521523;202005;11194;34429;9138;31085;2482;9301;2481;8722;4963;18023
521525;202005;1019;2340;747;1960;72;191;537;1401;609;1592
521530;202005;2197;5676;1257;3752;277;865;308;935;585;1800
521540;202005;820;2062;549;1614;76;253;259;791;335;1044
521550;202005;1447;3697;807;2379;144;487;216;655;360;1142
521560;202005;4445;11649;3037;9743;448;1701;1544;5238;1992;6939
521565;202005;629;1512;480;1303;74;189;293;787;367;976
521570;202005;3386;9228;2217;6957;436;1604;202;672;638;2276
521580;202005;477;1156;275;815;43;134;80;212;123;346
521590;202005;627;1476;457;1233;83;245;259;686;342;931
521600;202005;368;993;236;737;33;82;101;319;134;401
521630;202005;1644;3598;996;2649;203;582;346;892;549;1474
521640;202005;1762;4097;1176;3258;256;743;408;1110;664;1853
521645;202005;545;1420;344;1057;82;229;114;359;196;588
521680;202005;1079;3260;824;2764;238;872;118;435;356;1307
521690;202005;521;1270;431;1149;60;169;272;716;332;885
521710;202005;3144;7817;1977;5901;355;1207;490;1366;845;2573
521720;202005;2159;4976;1380;3789;146;450;782;2152;928;2602
521730;202005;3485;9728;2640;8256;736;2689;720;1905;1456;4594
521740;202005;3802;9967;2831;8542;695;2265;1073;3375;1768;5640
521760;202005;14568;39896;11207;34698;2857;9812;4130;13358;6987;23170
521770;202005;2917;6998;1904;5353;574;1745;485;1371;1059;3116
521800;202005;6220;16726;4445;13731;1009;3195;1739;5829;2748;9024
521805;202005;474;1160;351;982;105;269;145;415;250;684
521810;202005;608;1434;426;1187;63;179;250;707;313;886
521830;202005;5458;15089;4294;13282;287;1076;3093;9386;3380;10462
521839;202005;720;1702;499;1345;82;252;271;657;353;909
521850;202005;5371;12518;3334;9479;581;1853;530;1434;1111;3287
521860;202005;1500;3962;1023;3130;182;609;320;970;502;1579
521870;202005;680;1898;482;1502;102;353;123;342;225;695
521878;202005;653;1689;437;1265;55;185;231;608;286;793
521880;202005;18132;44050;12063;34687;3035;9271;4220;12344;7255;21615
521890;202005;3003;7762;1963;5937;557;1823;359;998;916;2821
521900;202005;1460;3415;819;2424;248;704;90;272;338;976
521910;202005;1221;2586;797;2091;74;191;443;1276;517;1467
521920;202005;462;1273;338;1054;62;221;142;427;204;648
521925;202005;739;1919;530;1614;82;260;290;876;372;1136
521930;202005;5314;12723;3454;9874;880;2369;1310;4160;2190;6529
521935;202005;987;2371;669;1801;64;179;403;1039;467;1218
521940;202005;1320;2913;843;2260;194;576;335;880;529;1456
521945;202005;549;1499;445;1322;100;301;236;721;336;1022
521950;202005;735;1785;507;1425;121;348;217;581;338;929
521960;202005;709;1824;455;1351;57;184;241;665;298;849
521970;202005;2510;6135;1988;5512;158;426;1525;4284;1683;4710
521971;202005;739;1745;517;1422;146;393;149;425;295;818
521973;202005;1344;3482;1057;3046;41;127;804;2295;845;2422
521975;202005;11690;30762;9547;27793;1505;4570;6009;17568;7514;22138
521980;202005;2522;5884;1924;5088;147;376;1448;3931;1595;4307
521990;202005;1060;2993;836;2591;177;575;301;935;478;1510
522000;202005;2448;6527;1982;5944;274;797;1309;4085;1583;4882
522005;202005;331;794;250;674;50;128;125;350;175;478
522010;202005;3889;9443;2712;7543;618;1890;976;2645;1594;4535
522015;202005;975;2559;709;2150;217;646;258;816;475;1462
522020;202005;5434;12905;3530;9882;726;2128;1398;4041;2124;6169
522026;202005;755;2009;504;1553;91;304;177;505;268;809
522028;202005;417;1034;308;856;66;192;134;362;200;554
522040;202005;3051;6898;2156;5695;267;745;1445;3783;1712;4528
522045;202005;17111;47528;12536;39359;2959;10044;3425;10473;6384;20517
522050;202005;1060;2791;709;2174;184;638;247;671;431;1309
522060;202005;2859;7491;1956;5988;166;508;1124;3559;1290;4067
522068;202005;1792;4581;1395;4105;116;319;1087;3238;1203;3557
522070;202005;628;1524;504;1337;19;60;419;1088;438;1148
522100;202005;721;1845;483;1466;60;207;253;739;313;946
522108;202005;975;2499;752;2178;55;207;596;1671;651;1878
522119;202005;1505;3734;1145;3257;187;544;615;1826;802;2370
522130;202005;386;980;273;821;27;76;182;577;209;653
522140;202005;17098;45409;11783;35827;3072;10033;3130;9138;6202;19171
522145;202005;788;1951;525;1544;146;423;190;567;336;990
522150;202005;1051;2576;742;2061;206;567;220;641;426;1208
522155;202005;1063;2676;807;2268;153;388;451;1310;604;1698
522157;202005;576;1368;470;1233;27;87;369;973;396;1060
522160;202005;5943;15338;3802;11401;1028;3319;301;992;1329;4311
522170;202005;2602;6645;1938;5649;300;897;1087;3222;1387;4119
522180;202005;494;1142;330;865;58;155;79;229;137;384
522185;202005;18279;45145;12860;37694;5047;16078;2801;8873;7848;24951
522190;202005;761;1826;513;1396;96;275;194;516;290;791
522200;202005;1622;4579;1065;3508;220;793;187;554;407;1347
522205;202005;1649;3833;1248;3293;130;362;858;2269;988;2631
522220;202005;1246;3082;919;2587;112;332;535;1547;647;1879
522230;202005;1102;2806;879;2481;187;651;446;1189;633;1840
530010;202005;167752;449759;134321;400338;20889;68179;78006;229358;98895;297537
110001;202004;3919;11006;2606;8518;590;2072;1013;3368;1603;5440
110002;202004;11944;31321;8291;24952;2336;7461;2212;6746;4548;14207
110003;202004;618;1811;432;1422;102;361;105;328;207;689
110004;202004;10920;28661;7197;21956;1525;5067;2094;6563;3619;11630
110005;202004;2451;6401;1647;5051;357;1187;446;1479;803;2666
110006;202004;1760;4891;1087;3460;198;737;208;621;406;1358
110007;202004;1180;3024;731;2267;234;783;177;675;411;1458
110008;202004;3276;9107;2392;7747;262;838;1585;5461;1847;6299
110009;202004;4276;12042;2729;9189;603;2131;1090;3716;1693;5847
110010;202004;7461;24195;5429;20137;1104;4164;2630;10593;3734;14757
110011;202004;6703;17952;4507;13947;1615;5233;638;2069;2253;7302
110012;202004;14730;36863;8511;25809;2067;6755;779;2579;2846;9334
110013;202004;5150;15064;3722;12102;1515;5187;461;1666;1976;6853
110014;202004;3702;9929;2485;7610;587;1911;980;2946;1567;4857
110015;202004;5359;13971;3058;9392;704;2366;611;1747;1315;4113
110018;202004;3683;9282;2092;6468;403;1453;594;1810;997;3263
110020;202004;73422;177036;51975;147373;11411;33396;21425;66822;32836;100218
110025;202004;5006;12158;3262;9115;684;2050;1421;4011;2105;6061
110026;202004;490;1246;342;1031;83;274;147;467;230;741
110028;202004;6745;17244;4001;12219;1012;3364;601;1870;1613;5234
110029;202004;1480;3642;844;2519;197;595;303;950;500;1545
110030;202004;12612;29143;7760;21876;1688;5583;1531;4680;3219;10263
110032;202004;2990;8549;1890;6181;597;1936;390;1375;987;3311
110033;202004;3590;11283;2760;9740;984;3531;688;2701;1672;6232
110034;202004;3402;7983;2234;6363;673;2159;755;2322;1428;4481
110037;202004;1608;4764;1193;4033;254;860;581;2009;835;2869
110040;202004;2899;8121;2053;6532;584;2000;625;1940;1209;3940
110045;202004;4940;14354;3688;12055;985;3460;1299;4318;2284;7778
110050;202004;1755;4780;1223;3853;482;1653;222;723;704;2376
110060;202004;825;2503;556;1855;203;719;75;253;278;972
110070;202004;1566;4974;1167;4091;372;1384;230;736;602;2120
110080;202004;6230;14578;4575;12611;604;1582;3008;8856;3612;10438
110090;202004;551;1489;393;1211;89;299;174;524;263;823
110092;202004;1123;3288;819;2721;147;501;414;1480;561;1981
110094;202004;2739;8266;2049;6927;867;3122;292;988;1159;4110
110100;202004;1674;4965;1334;4300;372;1266;562;1828;934;3094
110110;202004;1688;4686;1164;3776;381;1272;269;949;650;2221
110120;202004;1256;3688;939;3064;234;824;308;977;542;1801
110130;202004;2594;6568;1652;4869;334;1122;619;1818;953;2940
110140;202004;2017;5974;1349;4591;334;1194;346;1221;680;2415
110143;202004;1312;3585;887;2731;282;869;149;469;431;1338
110145;202004;875;2310;530;1665;123;403;186;604;309;1007
110146;202004;454;1185;319;979;63;183;155;515;218;698
110147;202004;774;2019;480;1432;70;230;182;479;252;709
110148;202004;731;2013;403;1363;108;411;42;144;150;555
110149;202004;2960;8155;2039;6665;704;2438;449;1561;1153;3999
110150;202004;2691;6590;1793;5326;533;1750;448;1602;981;3352
110155;202004;722;2135;502;1597;113;385;166;502;279;887
110160;202004;1447;4533;1062;3666;312;1099;256;908;568;2007
110170;202004;2149;5512;1299;3888;237;756;670;1928;907;2684
110175;202004;1659;4701;1166;3835;180;647;521;1793;701;2440
110180;202004;1375;3804;935;2909;147;479;469;1458;616;1937
120001;202004;3194;9453;2617;8593;412;1409;1670;5658;2082;7067
120005;202004;1945;7444;1759;7178;151;679;1407;5828;1558;6507
120010;202004;5255;15894;4430;14656;414;1354;3212;10971;3626;12325
120013;202004;2161;7637;1907;7328;415;1533;1192;4895;1607;6428
120017;202004;2446;8300;2153;7852;343;1271;1386;5326;1729;6597
120020;202004;14928;58591;13687;56158;1082;5057;10783;44562;11865;49619
120025;202004;3121;8898;2492;8136;374;1206;1720;5811;2094;7017
120030;202004;6501;25659;6021;24753;432;2294;4663;19338;5095;21632
120032;202004;1688;7593;1596;7422;106;680;1322;6038;1428;6718
120033;202004;4073;15138;3827;14702;126;725;3343;12724;3469;13449
120034;202004;2634;9642;2245;8950;114;695;1856;7260;1970;7955
120035;202004;3719;14694;3527;14359;289;1412;2893;11766;3182;13178
120038;202004;2690;8656;2287;7991;529;1902;1226;4384;1755;6286
120039;202004;2038;8805;1902;8523;123;759;1533;6828;1656;7587
120040;202004;44511;140107;37728;128952;5348;19353;23458;81370;28806;100723
120042;202004;3296;12408;3026;11903;147;797;2523;9842;2670;10639
120043;202004;1381;5610;1257;5408;35;214;1155;4974;1190;5188
120045;202004;6215;15983;5386;15057;123;502;4903;13571;5026;14073
120050;202004;9329;33678;8518;32423;393;2077;7127;27169;7520;29246
120060;202004;9538;36999;8729;35793;383;2305;7613;31007;7996;33312
120070;202004;3136;10117;2710;9533;248;896;1950;7114;2198;8010
120080;202004;4188;13616;3714;12904;459;1704;2725;9651;3184;11355
130002;202004;3067;12143;2737;11660;196;842;2311;10044;2507;10886
130006;202004;2412;8990;1993;8230;180;785;1489;6205;1669;6990
130008;202004;2675;9350;2363;8890;68;369;2049;7705;2117;8074
130010;202004;3970;11581;3330;10851;81;230;3052;10101;3133;10331
130014;202004;3079;9195;2360;7991;410;1403;1443;5035;1853;6438
130020;202004;2843;11024;2545;10570;138;804;2041;8424;2179;9228
130030;202004;10085;32873;9162;31785;327;1120;8099;28582;8426;29702
130040;202004;3846;11546;3191;10667;187;626;2647;8967;2834;9593
130050;202004;7581;27803;6361;26220;163;847;5799;24119;5962;24966
130060;202004;7514;29919;6441;28510;431;2412;5349;23616;5780;26028
130063;202004;6373;20829;5669;20042;212;912;5132;18264;5344;19176
130068;202004;3768;13327;3171;12444;213;1210;2399;9321;2612;10531
130070;202004;7602;21414;6203;19879;292;904;5117;16934;5409;17838
130080;202004;7052;25643;6156;24596;255;1406;5245;21286;5500;22692
130083;202004;2752;9008;2436;8609;154;646;2087;7388;2241;8034
130090;202004;3507;10927;3104;10413;54;240;2747;9392;2801;9632
130100;202004;8044;24245;6837;22980;54;126;6456;22236;6510;22362
130110;202004;8607;24609;7073;22703;1016;2584;5145;17864;6161;20448
130115;202004;5300;16495;4569;15687;106;352;4071;14209;4177;14561
130120;202004;14244;50342;12542;48062;1084;4571;10181;39417;11265;43988
130130;202004;5333;17013;4116;15403;387;1591;3059;11479;3446;13070
130140;202004;7367;25617;6485;24603;188;1069;5711;21756;5899;22825
130150;202004;3639;13666;3418;13420;81;507;3135;12335;3216;12842
130160;202004;5100;18147;4358;17194;272;1169;3708;14900;3980;16069
130165;202004;3223;12243;3030;11998;117;532;2743;10932;2860;11464
130170;202004;11772;34522;9402;31743;697;2672;7580;25994;8277;28666
130180;202004;4478;14495;4242;14231;43;225;4092;13700;4135;13925
130185;202004;18488;45772;15092;42160;1004;1831;12715;37615;13719;39446
130190;202004;18825;62393;15114;56848;1709;6706;10710;41552;12419;48258
130195;202004;2488;9045;2027;8443;72;403;1775;7411;1847;7814
130200;202004;2590;7295;2146;6715;98;390;1796;5601;1894;5991
130210;202004;1304;4917;1170;4760;101;589;938;3717;1039;4306
130220;202004;2304;7995;1964;7548;55;303;1725;6657;1780;6960
130230;202004;4615;19065;4005;18190;230;1451;3435;15575;3665;17026
130240;202004;12228;36736;9890;33629;186;1104;8890;30214;9076;31318
130250;202004;26347;79091;22575;74845;1655;5124;18150;62560;19805;67684
130255;202004;4384;14715;3817;13725;159;742;3102;11153;3261;11895
130260;202004;264283;736766;214617;664578;58019;190628;98793;316125;156812;506753
130270;202004;9474;33639;7793;31023;1181;4705;5179;21532;6360;26237
130280;202004;3545;14386;3254;14060;92;460;3027;13245;3119;13705
130290;202004;13191;44449;11394;42129;663;2622;9602;36281;10265;38903
130300;202004;4703;16510;4275;15924;150;829;3728;13848;3878;14677
130310;202004;6239;21011;5414;19936;292;1315;4596;16931;4888;18246
130320;202004;3457;11251;2877;10493;360;1280;2125;8008;2485;9288
130330;202004;4619;14829;3725;13729;207;924;3183;11732;3390;12656
130340;202004;23643;74198;20293;70380;1463;4411;17021;61100;18484;65511
130350;202004;3979;14430;3582;13928;149;771;3166;12269;3315;13040
130353;202004;7558;20442;6072;18567;777;2259;4362;13858;5139;16117
130356;202004;5218;16688;4315;15283;748;2596;2645;9939;3393;12535
130360;202004;2976;9829;2576;9283;94;419;2293;8202;2387;8621
130370;202004;5739;22601;4988;21534;298;1666;4054;17408;4352;19074
130380;202004;7383;30671;6835;29897;393;2217;5809;25242;6202;27459
130390;202004;5788;24520;5122;23406;537;2810;3852;17688;4389;20498
130395;202004;2329;7434;1993;6878;187;680;1526;5260;1713;5940
130400;202004;2758;8662;2362;8131;85;260;2128;7459;2213;7719
130406;202004;11101;38779;9335;36604;1766;6942;6247;25456;8013;32398
130410;202004;4135;14812;3516;13759;1055;4344;1598;6438;2653;10782
130420;202004;13654;48144;11408;45333;912;4652;8936;35765;9848;40417
130423;202004;4352;13725;3802;13101;190;852;3333;11386;3523;12238
130426;202004;2792;11126;2599;10892;70;398;2398;10102;2468;10500
130430;202004;4275;12120;3702;11355;239;890;3118;9430;3357;10320
130440;202004;4801;15200;4101;14361;90;401;3789;13361;3879;13762
140002;202004;2175;6454;1891;6103;89;341;1598;5209;1687;5550
140005;202004;3319;9172;2893;8683;135;359;2477;7636;2612;7995
140010;202004;56416;149736;44983;132671;11150;34631;19527;58766;30677;93397
140015;202004;3800;11364;3216;10648;220;709;2803;9441;3023;10150
140017;202004;4428;12350;3847;11617;257;712;3160;9836;3417;10548
140020;202004;5305;15479;4559;14495;231;971;3759;11850;3990;12821
140023;202004;2490;7405;2033;6743;199;667;1544;5244;1743;5911
140028;202004;2056;5296;1739;4890;89;282;1404;3943;1493;4225
140030;202004;5266;13471;4650;12762;334;663;4050;11503;4384;12166
140040;202004;2573;10168;2358;9884;95;584;2125;8786;2220;9370
140045;202004;2603;9484;2186;8911;347;1230;1489;6536;1836;7766
140047;202004;6256;17882;5259;16425;601;1911;3764;11955;4365;13866
140050;202004;1443;4221;1209;3885;115;363;925;3044;1040;3407
140060;202004;1668;4443;1428;4086;111;286;1151;3377;1262;3663
140070;202004;1890;9864;1830;9741;122;849;1520;8015;1642;8864
150010;202004;45526;113706;41115;108041;953;2261;36887;96862;37840;99123
150013;202004;1955;5015;1626;4663;151;304;1270;3887;1421;4191
150020;202004;14484;43625;13391;42197;1440;3804;10957;35622;12397;39426
150030;202004;8902;33370;8091;32367;468;2017;7017;28332;7485;30349
150034;202004;4169;10273;3424;9356;233;578;2849;7966;3082;8544
150040;202004;16410;42573;14419;40366;1244;1932;12077;36739;13321;38671
150050;202004;6968;24503;6344;23673;132;590;5826;21979;5958;22569
150060;202004;22028;59872;17618;53201;2793;8602;11168;34559;13961;43161
150070;202004;6758;25239;5915;24226;227;1121;5284;21851;5511;22972
150080;202004;94389;210873;78438;189066;18997;50086;22661;66897;41658;116983
150085;202004;7694;22331;6948;21442;115;382;6521;20271;6636;20653
150090;202004;9809;36597;9220;35439;677;2673;7424;28739;8101;31412
150095;202004;5659;16609;4920;15685;265;607;4178;13895;4443;14502
150100;202004;2851;10057;2529;9513;196;655;1982;7619;2178;8274
150110;202004;4427;18201;4102;17826;186;874;3774;16515;3960;17389
150120;202004;8122;25366;7698;24853;255;666;6860;22809;7115;23475
150125;202004;738;1983;549;1723;98;366;324;1001;422;1367
150130;202004;22400;64970;19378;60406;3356;9374;12639;41781;15995;51155
150140;202004;250203;580941;210413;525762;31292;75796;122617;319262;153909;395058
150145;202004;4265;13194;3620;12196;925;2850;1965;7334;2890;10184
150150;202004;16181;41730;14112;39073;543;1659;11785;32628;12328;34287
150157;202004;3503;9582;2819;8691;293;912;1987;6407;2280;7319
150160;202004;3021;8955;2809;8645;537;1558;1746;5617;2283;7175
150170;202004;24575;80545;21460;75232;3901;12866;13182;49212;17083;62078
150172;202004;4834;13310;3876;11959;264;743;2940;9371;3204;10114
150175;202004;1614;5123;1343;4588;242;868;768;2654;1010;3522
150178;202004;10379;28143;8599;26061;209;545;7687;23644;7896;24189
150180;202004;22508;79592;20290;77027;1096;3638;17806;69249;18902;72887
150190;202004;6744;22754;6263;22147;253;1165;5559;19547;5812;20712
150195;202004;5128;16568;4867;16161;71;388;4517;14846;4588;15234
150200;202004;5887;17168;5384;16610;64;172;5092;15826;5156;15998
150210;202004;26293;91092;24489;88675;1681;6100;20287;75613;21968;81713
150215;202004;7667;21758;6594;20185;1186;3532;3920;12557;5106;16089
150220;202004;12343;34913;10762;32656;1057;3099;7478;23208;8535;26307
150230;202004;12208;34904;10745;32949;1133;3090;7457;23925;8590;27015
150240;202004;32026;89208;26516;79770;7243;22244;9194;28116;16437;50360
150250;202004;4258;16248;3963;15908;607;2358;3045;12573;3652;14931
150260;202004;2745;8986;2489;8591;153;503;1990;6968;2143;7471
150270;202004;8703;25069;6128;20518;1981;6910;1661;5948;3642;12858
150275;202004;6864;21922;6266;21090;239;916;5441;18256;5680;19172
150276;202004;2321;6157;1978;5750;250;646;1366;4384;1616;5030
150277;202004;5178;13567;4169;12397;309;815;3219;10221;3528;11036
150280;202004;6836;27626;6586;27219;471;1930;5589;23375;6060;25305
150285;202004;3294;11518;2884;10873;238;917;2121;8142;2359;9059
150290;202004;10478;28713;9450;27614;288;624;8553;25606;8841;26230
150293;202004;9280;22976;7058;20041;920;2637;4358;13022;5278;15659
150295;202004;7623;20581;5595;17843;1838;6253;1948;7114;3786;13367
150300;202004;2389;7157;2136;6836;34;122;1949;6271;1983;6393
150304;202004;4066;12123;3346;11007;605;1901;2026;6987;2631;8888
150307;202004;6161;19807;5673;18992;343;1148;4628;15666;4971;16814
150309;202004;6227;18798;5015;16695;870;2855;2817;9808;3687;12663
150310;202004;7297;29002;6945;28584;207;1175;6208;25768;6415;26943
150320;202004;9430;25760;8594;24542;411;1260;6680;19021;7091;20281
150330;202004;14047;45090;12944;43329;1236;3864;9756;33700;10992;37564
150340;202004;2524;7397;2236;6965;331;963;1531;4929;1862;5892
150345;202004;8151;23881;7307;22747;436;1425;6215;19427;6651;20852
150350;202004;8972;22502;8269;21592;698;1306;6835;18427;7533;19733
150360;202004;24328;66919;19457;60751;2002;5067;13855;46122;15857;51189
150370;202004;10757;32712;8826;30109;1007;2903;6417;23578;7424;26481
150375;202004;3543;14335;3184;13810;229;1105;2700;11818;2929;12923
150380;202004;11093;28407;9092;25784;119;447;8035;22812;8154;23259
150390;202004;7971;31790;7148;30496;1083;4033;5090;23009;6173;27042
150400;202004;6464;23377;6199;22878;276;1056;5407;20036;5683;21092
150405;202004;9275;24395;8098;22985;483;1135;6550;19194;7033;20329
150410;202004;1932;6159;1635;5647;220;685;1040;3707;1260;4392
150420;202004;40703;112234;31270;98255;8686;28608;10725;39296;19411;67904
150430;202004;8469;24769;7710;23785;866;1985;6009;19451;6875;21436
150440;202004;5665;18201;5153;17466;759;2261;3616;12863;4375;15124
150442;202004;26301;62644;21604;56764;2257;5823;14986;40221;17243;46044
150445;202004;6307;19544;5535;18369;206;734;4730;15733;4936;16467
150450;202004;5097;21840;4713;21315;365;1797;4053;18340;4418;20137
150460;202004;8389;27646;7668;26730;250;1009;6560;23689;6810;24698
150470;202004;21914;56628;19520;53906;365;1031;18356;50721;18721;51752
150475;202004;4914;15445;4237;14420;159;608;3549;12218;3708;12826
150480;202004;13692;44425;12236;42231;2188;6855;8114;29897;10302;36752
150490;202004;8387;29043;7693;28182;274;1153;6830;25170;7104;26323
150495;202004;5294;18196;5058;17866;112;561;4590;16129;4702;16690
150497;202004;2876;9088;2308;8101;508;1813;1205;4558;1713;6371
150500;202004;3284;8446;2924;7944;234;563;2285;6222;2519;6785
150503;202004;4814;12366;3322;10419;990;3349;1063;3827;2053;7176
150506;202004;10447;30927;8762;28638;1869;5355;5427;19726;7296;25081
150510;202004;9897;35950;8544;33402;1252;4588;5613;23108;6865;27696
150520;202004;6985;27334;6677;26948;232;1400;5980;24048;6212;25448
150530;202004;12443;42413;10764;39996;1525;4581;7723;30666;9248;35247
150540;202004;4979;13592;4232;12479;234;628;3530;10484;3764;11112
150543;202004;7425;19858;6114;18210;496;1484;4685;14593;5181;16077
150548;202004;10112;31710;9103;30325;250;1029;8064;26913;8314;27942
150549;202004;2000;5976;1718;5589;44;191;1467;4782;1511;4973
150550;202004;19882;58559;16548;53061;3966;12956;7280;24980;11246;37936
150553;202004;28440;82226;22403;71384;6590;21353;8030;27479;14620;48832
150555;202004;1917;5116;1496;4463;134;317;1033;3235;1167;3552
150560;202004;1843;5622;1634;5208;266;817;976;3228;1242;4045
150563;202004;2459;7507;2066;6827;429;1516;1147;3818;1576;5334
150565;202004;4353;13952;3873;13197;100;437;3231;11118;3331;11555
150570;202004;6321;20118;5880;19501;273;1028;5084;16846;5357;17874
150580;202004;10561;41362;9090;39714;625;3200;7363;33314;7988;36514
150590;202004;8121;27926;6951;26534;178;1048;6307;23991;6485;25039
150600;202004;9735;32254;9024;31393;218;836;8346;29241;8564;30077
150610;202004;2867;8472;2557;7972;90;378;2152;6631;2242;7009
150611;202004;3222;9045;2853;8530;93;352;2521;7490;2614;7842
150613;202004;13438;37004;10119;31276;1877;6166;4990;15426;6867;21592
150616;202004;3391;9303;2458;7765;582;1920;1059;3327;1641;5247
150618;202004;6833;19778;5512;17734;486;1528;3561;12120;4047;13648
150619;202004;6367;17846;5262;16303;180;624;4457;13926;4637;14550
150620;202004;6799;22506;5850;20907;665;2258;4008;14770;4673;17028
150630;202004;6296;16990;5748;16311;423;1116;4782;13727;5205;14843
150635;202004;4690;12958;3935;11758;540;1519;2527;7827;3067;9346
150640;202004;2258;6652;2051;6396;36;107;1905;6023;1941;6130
150650;202004;11621;32326;10115;29891;2966;8278;4457;14404;7423;22682
150655;202004;5825;16645;5268;15832;203;626;4547;13664;4750;14290
150658;202004;4376;12402;3450;11004;519;1756;2092;7040;2611;8796
150660;202004;5750;16425;5106;15509;464;1339;3593;11197;4057;12536
150670;202004;8430;19484;6569;17380;644;1388;5156;14399;5800;15787
150680;202004;68506;200378;52572;175034;12593;41043;23614;88899;36207;129942
150690;202004;2867;7439;2474;6976;92;211;2207;6369;2299;6580
150700;202004;6185;18246;5511;17369;357;934;4376;14190;4733;15124
150710;202004;3789;12634;3439;12067;277;952;2611;9367;2888;10319
150715;202004;4994;14368;4084;12987;299;919;3208;10368;3507;11287
150720;202004;6860;24415;6355;23623;420;1688;5300;19905;5720;21593
150730;202004;12028;36529;10414;34238;1199;4076;7692;26009;8891;30085
150740;202004;3974;11140;3514;10424;313;779;2655;8057;2968;8836
150745;202004;5085;14466;4094;12998;821;2761;2589;8309;3410;11070
150746;202004;1632;4999;1485;4789;77;252;1217;3940;1294;4192
150747;202004;4877;15562;4286;14584;676;2046;2916;10394;3592;12440
150750;202004;3691;11522;3097;10614;216;806;2346;8296;2562;9102
150760;202004;11953;35124;10834;33569;1482;4195;7677;24564;9159;28759
150770;202004;6352;22810;5976;22379;186;575;5442;21023;5628;21598
150775;202004;931;2600;717;2309;136;483;387;1245;523;1728
150780;202004;4525;13614;4004;13006;151;440;3592;11968;3743;12408
150790;202004;5651;16050;4841;15182;221;509;3903;13551;4124;14060
150795;202004;13980;43174;12181;40379;2976;9306;6978;24657;9954;33963
150796;202004;3859;9439;3352;8856;186;445;2850;7641;3036;8086
150797;202004;3942;12235;3401;11460;138;358;2909;9977;3047;10335
150800;202004;13472;42142;12105;40328;1441;4520;9185;31590;10626;36110
150803;202004;7043;22680;6590;21970;367;1175;5602;18830;5969;20005
150805;202004;3492;10717;2957;9934;211;712;2314;7920;2525;8632
150808;202004;6014;17014;4404;14365;1719;6209;616;2288;2335;8497
150810;202004;20783;54445;15712;48344;3274;10302;7996;27190;11270;37492
150812;202004;5318;14994;4669;13933;415;1305;3455;10130;3870;11435
150815;202004;9468;27916;7895;26050;619;2052;6520;21851;7139;23903
150820;202004;11937;32815;10071;30470;1095;2825;7660;24279;8755;27104
150830;202004;11913;43572;11033;42494;420;1812;9595;37930;10015;39742
150835;202004;2365;7827;2010;7196;340;1194;1154;4200;1494;5394
150840;202004;7534;21242;5976;18721;984;3320;3341;10395;4325;13715
160005;202004;1197;3310;1057;3132;61;215;887;2639;948;2854
160010;202004;2456;6472;2289;6289;20;106;2223;6035;2243;6141
160015;202004;2806;8205;2489;7813;70;236;2292;7222;2362;7458
160020;202004;2089;6710;1826;6382;155;519;1437;5193;1592;5712
160021;202004;1075;4223;987;4116;61;351;813;3370;874;3721
160023;202004;1265;4474;1117;4227;119;410;786;3160;905;3570
160025;202004;1866;5675;1770;5565;12;38;1722;5437;1734;5475
160027;202004;9055;25084;8086;23844;640;1806;6510;19601;7150;21407
160030;202004;70565;200850;56865;182439;12014;36162;31007;109689;43021;145851
160040;202004;5716;19544;5191;18878;71;336;4858;17801;4929;18137
160050;202004;4739;14452;3698;13036;1388;4689;1303;5696;2691;10385
160053;202004;3717;11619;3371;11194;238;693;2790;9577;3028;10270
160055;202004;908;2650;873;2610;32;101;806;2412;838;2513
160060;202004;24747;65897;19992;60495;907;2946;15876;50375;16783;53321
160070;202004;2744;10391;2457;9947;195;779;1930;8075;2125;8854
160080;202004;3340;10639;2985;10240;31;164;2788;9634;2819;9798
170025;202004;604;1577;431;1321;68;217;224;708;292;925
170030;202004;1215;3705;931;3191;146;501;452;1593;598;2094
170035;202004;1452;3796;1065;3177;90;291;648;1952;738;2243
170040;202004;1874;5318;1473;4753;94;357;908;3044;1002;3401
170070;202004;1804;4252;1263;3558;71;234;762;2225;833;2459
170100;202004;2418;6938;2005;6251;184;532;1286;4137;1470;4669
170105;202004;717;2095;489;1603;127;367;164;558;291;925
170110;202004;922;2848;701;2424;119;425;321;1091;440;1516
170130;202004;1308;3921;932;3194;173;639;446;1563;619;2202
170190;202004;1326;3803;939;3174;332;1170;177;771;509;1941
170200;202004;1929;4693;1204;3483;204;620;456;1329;660;1949
170210;202004;24818;67431;18701;57181;6414;21365;2335;8226;8749;29591
170215;202004;1297;3468;1039;3122;39;162;829;2478;868;2640
170220;202004;5741;17886;4800;16181;1307;4223;1973;7281;3280;11504
170230;202004;1207;3627;899;3019;262;898;162;605;424;1503
170240;202004;2583;7275;1988;6305;141;533;1392;4308;1533;4841
170255;202004;3909;11374;2761;9261;486;1675;1260;4343;1746;6018
170270;202004;951;2297;626;1835;37;107;373;1093;410;1200
170290;202004;2843;8530;2431;7995;114;386;1912;6478;2026;6864
170300;202004;1962;5331;1579;4760;178;538;1057;3243;1235;3781
170305;202004;606;1673;502;1494;62;214;264;775;326;989
170307;202004;919;3163;737;2805;99;409;411;1585;510;1994
170310;202004;1565;3923;1070;3124;166;539;506;1482;672;2021
170320;202004;997;2600;748;2192;64;204;485;1456;549;1660
170330;202004;906;2792;821;2663;40;185;683;2155;723;2340
170360;202004;495;1355;338;1090;24;91;221;671;245;762
170370;202004;1255;3396;891;2766;280;826;222;822;502;1648
170380;202004;1746;5063;1292;4353;98;394;754;2598;852;2992
170382;202004;529;1587;432;1417;29;120;315;1002;344;1122
170384;202004;1543;5510;1254;4944;252;1033;641;2572;893;3605
170386;202004;913;2490;562;1794;74;273;200;615;274;888
170388;202004;608;1738;422;1393;62;227;191;641;253;868
170389;202004;1023;3197;843;2899;44;174;618;2179;662;2353
170390;202004;1703;3942;1271;3406;48;119;1044;2885;1092;3004
170410;202004;554;1639;395;1340;31;133;239;793;270;926
170460;202004;358;944;286;827;37;99;184;552;221;651
170510;202004;882;2600;641;2156;46;197;402;1299;448;1496
170550;202004;6495;17364;4721;14468;1189;3912;1132;3757;2321;7669
170555;202004;1369;3738;1065;3259;66;212;526;1684;592;1896
170560;202004;1009;2860;749;2494;59;225;480;1689;539;1914
170600;202004;1292;3490;1046;3144;227;541;584;1914;811;2455
170610;202004;1642;4358;1178;3661;89;301;721;2213;810;2514
170625;202004;423;1172;261;831;43;138;82;247;125;385
170650;202004;1215;3615;943;3164;143;507;531;1855;674;2362
170700;202004;3312;9791;2464;8154;496;1665;1099;3750;1595;5415
170710;202004;1493;3939;1130;3356;153;489;707;2104;860;2593
170720;202004;1719;4349;1321;3727;174;476;769;2273;943;2749
170730;202004;1016;2780;744;2331;135;379;371;1240;506;1619
170740;202004;2034;6818;1741;6268;163;661;1260;4507;1423;5168
170755;202004;884;2454;604;1964;55;201;303;960;358;1161
170765;202004;1131;2945;785;2388;164;498;341;1085;505;1583
170770;202004;1813;5300;1475;4771;169;523;970;3242;1139;3765
170820;202004;3308;9988;2605;8682;519;1798;1205;4150;1724;5948
170825;202004;952;2253;761;1994;80;202;554;1458;634;1660
170830;202004;1395;3729;1141;3333;143;406;767;2287;910;2693
170900;202004;2633;8394;2199;7764;180;640;1742;6233;1922;6873
170930;202004;3649;10186;2777;8544;643;2082;914;2824;1557;4906
170950;202004;11022;30559;7524;24177;2131;7804;890;3105;3021;10909
170980;202004;437;1177;350;1044;14;63;260;737;274;800
171050;202004;1584;5030;1366;4655;44;222;1141;3863;1185;4085
171070;202004;1321;3805;1123;3512;299;943;489;1779;788;2722
171090;202004;1034;2564;819;2257;74;205;549;1503;623;1708
171110;202004;558;1503;388;1183;58;178;186;519;244;697
171150;202004;1095;2719;655;1963;62;215;392;1158;454;1373
171180;202004;784;2156;518;1640;88;256;218;697;306;953
171190;202004;1733;5858;1491;5432;235;931;892;3362;1127;4293
171195;202004;801;2570;638;2261;87;363;383;1336;470;1699
171200;202004;534;1504;395;1258;72;244;180;571;252;815
171215;202004;337;968;277;861;34;116;191;577;225;693
171240;202004;744;2486;603;2203;36;183;407;1456;443;1639
171245;202004;643;1944;493;1627;46;178;299;942;345;1120
171250;202004;1003;2651;723;2235;134;437;332;1045;466;1482
171270;202004;444;1603;340;1372;66;276;152;659;218;935
171280;202004;862;2616;669;2263;64;225;380;1345;444;1570
171320;202004;3918;11036;2997;9401;621;1935;1133;3757;1754;5692
171330;202004;2698;7448;2063;6336;401;1221;975;3119;1376;4340
171360;202004;1388;4036;1093;3602;79;286;789;2660;868;2946
171370;202004;682;1730;515;1493;50;138;347;1015;397;1153
171380;202004;1453;4170;1209;3823;100;300;888;2904;988;3204
171395;202004;956;2652;662;2094;58;229;401;1218;459;1447
171420;202004;1916;5684;1371;4575;222;811;619;2088;841;2899
171430;202004;1010;3006;832;2671;58;206;566;1752;624;1958
171488;202004;2292;6856;1792;6002;270;888;918;3219;1188;4107
171500;202004;985;2448;741;2076;42;117;571;1611;613;1728
171510;202004;787;2607;680;2403;46;211;476;1658;522;1869
171515;202004;450;1167;315;949;28;90;195;561;223;651
171525;202004;688;1984;520;1708;24;90;300;949;324;1039
171550;202004;335;974;247;828;30;119;140;456;170;575
171570;202004;1098;3389;914;3051;116;386;548;1877;664;2263
171575;202004;1814;4847;1152;3640;113;386;520;1642;633;2028
171610;202004;5710;15947;4255;13432;889;3158;1189;4018;2078;7176
171620;202004;2589;7336;2171;6728;102;390;1769;5502;1871;5892
171630;202004;952;2510;748;2230;107;318;505;1550;612;1868
171650;202004;2030;5797;1554;4986;386;1349;461;1623;847;2972
171660;202004;2313;5887;1561;4621;229;625;808;2453;1037;3078
171665;202004;1243;3486;956;3017;163;578;448;1438;611;2016
171670;202004;1872;4985;1424;4248;195;651;783;2337;978;2988
171700;202004;1196;3442;865;2837;109;352;463;1555;572;1907
171720;202004;788;2027;613;1754;51;177;444;1237;495;1414
171750;202004;1280;3608;867;2826;223;744;107;455;330;1199
171780;202004;1226;3125;872;2602;93;303;576;1683;669;1986
171790;202004;1374;4558;1122;4033;213;803;522;1918;735;2721
171800;202004;712;1971;530;1689;59;245;304;952;363;1197
171820;202004;10973;30929;8021;25785;2010;6691;2440;8467;4450;15158
171830;202004;1495;4859;1250;4419;107;477;809;2860;916;3337
171840;202004;758;2028;587;1753;25;75;387;1148;412;1223
171845;202004;597;1506;444;1278;52;176;279;790;331;966
171850;202004;847;2877;725;2594;66;315;519;1793;585;2108
171855;202004;1028;3156;868;2859;72;243;536;1734;608;1977
171865;202004;370;1164;299;1040;50;196;147;485;197;681
171870;202004;796;2244;560;1805;62;213;290;941;352;1154
171875;202004;1264;3719;994;3277;41;172;752;2475;793;2647
171880;202004;1145;3530;1001;3338;40;137;799;2722;839;2859
171884;202004;826;2352;603;1972;106;400;224;765;330;1165
171886;202004;1361;3772;964;3112;283;1036;192;630;475;1666
171888;202004;718;2011;486;1578;30;118;308;976;338;1094
171889;202004;378;1172;301;1021;65;242;122;410;187;652
171890;202004;1164;3258;851;2752;178;543;470;1571;648;2114
171900;202004;545;1884;391;1494;78;291;161;637;239;928
172000;202004;557;1670;464;1494;47;161;265;825;312;986
172010;202004;991;3427;841;3119;72;303;516;1888;588;2191
172015;202004;366;1291;270;1095;68;276;106;449;174;725
172020;202004;2613;7516;2289;7088;159;534;1706;5479;1865;6013
172025;202004;701;1942;515;1634;35;131;370;1173;405;1304
172030;202004;1219;3628;1034;3326;52;205;803;2576;855;2781
172049;202004;1281;3098;859;2516;173;484;439;1404;612;1888
172065;202004;1442;3586;1108;3169;102;220;871;2683;973;2903
172080;202004;2289;6783;1840;6006;100;364;1225;3988;1325;4352
172085;202004;473;1287;304;920;48;137;112;323;160;460
172090;202004;3915;9969;3007;8765;118;387;2291;6735;2409;7122
172093;202004;467;1392;334;1159;22;108;194;640;216;748
172097;202004;642;1713;450;1377;61;188;200;625;261;813
172100;202004;48101;119439;33351;95781;5940;18930;11848;35053;17788;53983
172110;202004;1571;5775;1347;5412;126;520;988;4178;1114;4698
172120;202004;4918;14555;3832;12785;501;1763;2173;7454;2674;9217
172125;202004;333;896;245;751;22;60;140;421;162;481
172130;202004;632;1538;489;1312;27;96;342;840;369;936
172208;202004;2500;6183;1998;5534;179;419;1441;4099;1620;4518
172210;202004;2648;6752;2023;5945;325;1038;1157;3543;1482;4581
210005;202004;18613;53645;14162;46199;4122;13976;5404;18518;9526;32494
210010;202004;1924;5943;1733;5710;73;315;1505;4977;1578;5292
210015;202004;3298;9877;2941;9411;109;308;2590;8383;2699;8691
210020;202004;7304;17314;6245;16088;73;218;5794;14995;5867;15213
210030;202004;4691;15516;4323;14963;196;877;3739;12922;3935;13799
210040;202004;1764;4255;1595;4048;25;44;1507;3863;1532;3907
210043;202004;6100;17566;5145;16249;434;1302;3936;12734;4370;14036
210047;202004;6575;20459;5338;18801;130;667;4638;16332;4768;16999
210050;202004;2197;7492;1719;6604;152;698;1206;4614;1358;5312
210055;202004;1850;5992;1669;5714;67;270;1412;4837;1479;5107
210060;202004;7234;26580;6408;25094;693;2863;4583;18406;5276;21269
210070;202004;7113;20317;6655;19725;38;178;6302;18633;6340;18811
210080;202004;4249;14554;4030;14314;43;267;3690;13196;3733;13463
210083;202004;5502;16109;4536;15087;40;199;4311;14396;4351;14595
210087;202004;3018;8231;2611;7705;100;236;2267;6864;2367;7100
210090;202004;9164;28842;8520;27702;498;1338;7237;23788;7735;25126
210095;202004;6295;20350;5744;19649;219;897;4938;17319;5157;18216
210100;202004;6781;20725;6068;19613;306;1082;4942;16046;5248;17128
210110;202004;2952;9792;2727;9525;50;303;2502;8708;2552;9011
210120;202004;22650;62545;18681;57304;1829;4616;12761;41617;14590;46233
210125;202004;4394;11759;3843;11115;717;1617;2779;8633;3496;10250
210130;202004;4364;11494;3616;10562;157;343;3081;9133;3238;9476
210135;202004;1447;4358;1242;4030;62;180;1006;3334;1068;3514
210140;202004;18525;48839;14120;43166;2693;7914;7929;25727;10622;33641
210150;202004;4323;10477;3839;9814;134;371;3353;8487;3487;8858
210160;202004;16436;48162;14169;45305;1259;4269;10067;33346;11326;37615
210170;202004;14966;46632;13905;45273;754;2172;12236;40240;12990;42412
210173;202004;2246;8638;2099;8376;73;442;1844;7350;1917;7792
210177;202004;3436;9416;2991;8878;116;223;2661;8187;2777;8410
210180;202004;1434;3885;1265;3683;25;66;1149;3355;1174;3421
210190;202004;5276;14383;4468;13291;74;358;3872;11369;3946;11727
210193;202004;1280;3756;1133;3527;31;141;892;2820;923;2961
210197;202004;2061;6484;1894;6253;136;462;1557;5213;1693;5675
210200;202004;7617;24579;6748;23129;404;1562;5413;18532;5817;20094
210203;202004;6949;20570;5954;19236;386;1291;4899;16136;5285;17427
210207;202004;3876;9578;2976;8620;131;297;2499;7428;2630;7725
210210;202004;8032;26205;7346;25272;131;801;6615;22619;6746;23420
210215;202004;2430;7729;2069;7185;52;269;1838;6404;1890;6673
210220;202004;6086;21144;5762;20651;176;1161;5100;17882;5276;19043
210230;202004;5062;15459;4575;14730;386;1004;3830;12649;4216;13653
210232;202004;11089;35053;9093;32018;1539;5416;5689;21368;7228;26784
210235;202004;3311;9994;2910;9442;65;285;2595;8442;2660;8727
210237;202004;2741;9105;2347;8643;32;197;2170;7996;2202;8193
210240;202004;2576;8202;2374;7843;81;318;2047;6695;2128;7013
210250;202004;5578;17107;5071;16483;74;441;4577;14829;4651;15270
210255;202004;2497;7664;2110;6977;279;946;1351;4472;1630;5418
210260;202004;5457;16347;4826;15429;214;786;4186;13379;4400;14165
210270;202004;4777;13331;4262;12688;106;478;3787;11199;3893;11677
210275;202004;3492;8887;3085;8401;57;124;2806;7750;2863;7874
210280;202004;5516;15793;4414;14081;260;1044;3202;10088;3462;11132
210290;202004;7206;19442;6437;18480;110;359;5976;17160;6086;17519
210300;202004;33319;90071;27011;81062;1871;5911;19356;60164;21227;66075
210310;202004;3043;7854;2684;7331;117;267;2345;6442;2462;6709
210312;202004;2659;6837;2340;6491;31;138;2192;6015;2223;6153
210315;202004;2908;8240;2480;7756;55;160;2269;7235;2324;7395
210317;202004;4037;12913;3654;12462;100;546;3293;11158;3393;11704
210320;202004;18667;57107;17059;54961;390;1941;15142;48486;15532;50427
210325;202004;3572;10193;3062;9523;89;274;2725;8640;2814;8914
210330;202004;24468;69092;19669;62896;5955;17152;9349;34682;15304;51834
210340;202004;9946;29351;8802;27803;694;2191;6761;21965;7455;24156
210350;202004;9169;26628;8011;25206;152;533;7156;22645;7308;23178
210355;202004;4252;14328;3731;13510;100;499;3181;11592;3281;12091
210360;202004;13387;42261;11941;40117;603;2750;9144;30257;9747;33007
210370;202004;10699;24233;8300;21694;233;407;7620;20394;7853;20801
210375;202004;3215;8570;2452;7539;645;2014;1115;3810;1760;5824
210380;202004;5405;13911;4664;13048;203;484;3997;11291;4200;11775
210390;202004;2541;9030;2344;8682;115;550;1986;7312;2101;7862
210400;202004;4403;13616;3909;13004;121;392;3514;11847;3635;12239
210405;202004;6850;18572;5508;16638;1041;2918;3107;10009;4148;12927
210407;202004;1945;6493;1623;5902;75;334;1309;4708;1384;5042
210408;202004;2495;9331;2338;9103;144;698;1916;7474;2060;8172
210409;202004;3760;13065;3433;12612;104;593;2851;10534;2955;11127
210410;202004;3390;10443;2877;9599;148;602;2201;7263;2349;7865
210420;202004;3814;12235;3454;11611;208;639;2896;9847;3104;10486
210430;202004;2235;6578;1993;6272;70;190;1765;5632;1835;5822
210440;202004;4359;11715;3786;10995;65;230;3493;10097;3558;10327
210450;202004;2419;7167;2074;6662;83;300;1714;5477;1797;5777
210455;202004;4215;11154;3194;9852;928;2885;1490;4862;2418;7747
210460;202004;3657;10446;3092;9732;62;263;2758;8629;2820;8892
210462;202004;1629;4961;1384;4561;36;146;1124;3735;1160;3881
210465;202004;2644;7751;2310;7304;51;207;2013;6349;2064;6556
210467;202004;5852;18799;5081;17775;299;1209;4208;14884;4507;16093
210470;202004;2004;5306;1410;4459;82;192;1083;3573;1165;3765
210480;202004;16309;47798;13455;44266;1142;3440;9884;35064;11026;38504
210490;202004;3661;9323;2962;8345;60;181;2578;7292;2638;7473
210500;202004;6227;24101;5718;23226;334;1701;4759;19197;5093;20898
210510;202004;5911;19635;5169;18831;128;571;4618;17113;4746;17684
210515;202004;3656;10845;3196;10322;101;386;2771;9092;2872;9478
210520;202004;2504;7191;2246;6866;70;245;1985;6037;2055;6282
210530;202004;51558;125771;39857;108465;6585;22241;10801;37354;17386;59595
210535;202004;3023;10399;2823;10083;116;463;2389;8602;2505;9065
210540;202004;14437;41851;12010;38453;1391;4139;8456;28347;9847;32486
210542;202004;6431;14974;5173;13599;323;524;4284;12051;4607;12575
210545;202004;2180;6827;2054;6619;41;174;1814;5784;1855;5958
210547;202004;3497;12655;3084;11835;296;1136;2285;8980;2581;10116
210550;202004;6110;18423;4827;16412;331;1293;3576;12469;3907;13762
210560;202004;3503;10750;3123;10138;116;384;2628;8465;2744;8849
210565;202004;1459;4815;1215;4453;56;305;964;3557;1020;3862
210570;202004;10306;28191;9160;26790;272;749;8167;24335;8439;25084
210580;202004;2960;7931;2441;7293;133;270;1964;6168;2097;6438
210590;202004;4248;12764;3666;12018;70;387;3263;10633;3333;11020
210592;202004;2631;7818;2425;7485;26;127;2148;6574;2174;6701
210594;202004;2486;6709;1899;5802;80;233;1402;4436;1482;4669
210596;202004;2474;8858;2217;8338;100;451;1811;6834;1911;7285
210598;202004;1794;5282;1653;5068;30;127;1493;4540;1523;4667
210600;202004;3000;8052;2431;7258;89;209;1979;6023;2068;6232
210610;202004;2658;7533;2282;7068;58;281;1934;5977;1992;6258
210620;202004;2724;7442;2274;6901;56;166;2095;6453;2151;6619
210630;202004;2978;10075;2721;9653;109;572;2271;7937;2380;8509
210632;202004;4379;14180;3875;13454;206;942;3095;10645;3301;11587
210635;202004;1728;6188;1626;6008;99;364;1356;5100;1455;5464
210637;202004;2394;7970;2085;7526;144;627;1576;5761;1720;6388
210640;202004;4543;16396;4262;16053;67;346;3869;14608;3936;14954
210650;202004;7340;21046;6683;20224;75;307;6200;18816;6275;19123
210660;202004;8022;23972;7107;22504;247;999;6198;19380;6445;20379
210663;202004;2537;7466;2330;7223;126;311;2004;6378;2130;6689
210667;202004;1939;6317;1742;6029;35;142;1581;5532;1616;5674
210670;202004;4470;15131;4074;14506;106;539;3572;12639;3678;13178
210675;202004;4987;13543;4251;12586;185;454;3591;10900;3776;11354
210680;202004;4435;11004;3730;10150;111;182;3368;9364;3479;9546
210690;202004;7625;23385;6399;22029;238;1051;5676;19664;5914;20715
210700;202004;2700;7653;2138;6844;140;442;1585;5299;1725;5741
210710;202004;4868;15340;4273;14498;107;601;3772;12647;3879;13248
210720;202004;2908;9621;2612;9252;53;316;2357;8295;2410;8611
210725;202004;1273;4346;1111;4103;37;158;817;3133;854;3291
210730;202004;1172;3108;983;2843;48;127;826;2395;874;2522
210735;202004;4596;13652;3915;12742;186;588;3372;11223;3558;11811
210740;202004;5240;14200;4559;13433;96;322;3863;11400;3959;11722
210745;202004;4351;11982;4036;11579;110;338;3705;10602;3815;10940
210750;202004;22888;58463;19811;54612;1610;4182;13946;40568;15556;44750
210760;202004;5892;15623;4981;14661;28;64;4736;14072;4764;14136
210770;202004;6070;15714;5228;14745;56;249;4928;13831;4984;14080
210780;202004;7228;22993;6334;21498;530;1600;5012;17357;5542;18957
210790;202004;4182;13316;3755;12757;179;451;3110;11076;3289;11527
210800;202004;4859;12927;4160;12004;53;223;3774;10776;3827;10999
210805;202004;3899;14298;3719;14035;102;563;3343;12533;3445;13096
210810;202004;4815;14077;4390;13525;286;621;3677;11717;3963;12338
210820;202004;6859;19526;5706;17680;664;2124;3413;10932;4077;13056
210825;202004;6668;20751;6021;19896;246;827;5219;17483;5465;18310
210830;202004;7636;21582;6944;20736;345;795;6027;18464;6372;19259
210840;202004;3165;8437;2830;7987;63;219;2519;7012;2582;7231
210845;202004;6421;17519;5767;16806;19;83;5562;16276;5581;16359
210850;202004;5901;20092;4916;18624;234;1185;3876;14738;4110;15923
210860;202004;20803;53924;17311;49527;741;1852;14019;42220;14760;44072
210870;202004;7278;19034;5741;17272;225;630;5012;15201;5237;15831
210880;202004;4219;13069;3816;12595;175;682;3188;10522;3363;11204
210890;202004;3823;11326;3384;10713;211;561;2769;9070;2980;9631
210900;202004;4438;13064;3364;11011;1317;4614;553;2056;1870;6670
210905;202004;1977;5496;1641;5064;44;79;1496;4732;1540;4811
210910;202004;7164;21688;5942;19697;792;2675;3899;13077;4691;15752
210920;202004;3195;10556;2767;9990;69;403;2498;8939;2567;9342
210923;202004;1482;4491;1277;4160;71;237;950;3137;1021;3374
210927;202004;5193;16520;4574;15790;218;776;3809;13425;4027;14201
210930;202004;2452;8526;2151;7936;169;687;1602;5909;1771;6596
210940;202004;4049;11500;3758;11157;110;449;3452;10141;3562;10590
210945;202004;6344;18433;5685;17650;221;652;4783;15230;5004;15882
210950;202004;5123;14309;3952;12693;601;1541;2617;9178;3218;10719
210955;202004;1542;4896;1324;4511;127;454;936;3263;1063;3717
210960;202004;8944;26701;7669;24788;1250;3768;4959;16804;6209;20572
210970;202004;1318;4067;1048;3610;64;237;803;2711;867;2948
210975;202004;1685;5327;1505;5040;61;228;1210;4070;1271;4298
210980;202004;10119;23455;8853;22147;77;188;8404;21096;8481;21284
210990;202004;15735;44730;12401;40338;682;2474;9361;31188;10043;33662
211000;202004;14360;42196;12100;39445;672;2325;9730;32976;10402;35301
211003;202004;5575;16742;4687;15680;127;514;4056;13866;4183;14380
211010;202004;6381;23147;5729;22355;85;428;5224;20729;5309;21157
211020;202004;8115;23595;7017;22341;193;823;6007;19557;6200;20380
211023;202004;1930;6333;1798;6160;84;314;1535;5248;1619;5562
211027;202004;3059;9799;2896;9541;193;526;2501;8324;2694;8850
211030;202004;3854;10641;3437;10134;228;508;2830;8608;3058;9116
211040;202004;4556;16516;4216;15910;112;688;3772;14093;3884;14781
211050;202004;9042;23630;8212;22559;87;303;7557;20764;7644;21067
211060;202004;6865;20911;6273;20113;119;501;5765;18490;5884;18991
211065;202004;2170;6048;1803;5589;83;224;1490;4783;1573;5007
211070;202004;7644;24311;6464;22523;497;1765;5019;17686;5516;19451
211080;202004;1273;3541;1020;3139;36;193;792;2301;828;2494
211085;202004;2016;5734;1708;5319;85;201;1483;4775;1568;4976
211090;202004;3120;8667;2817;8311;36;166;2610;7662;2646;7828
211100;202004;6666;17000;6159;16397;52;168;5685;15224;5737;15392
211102;202004;3001;10353;2748;9989;121;580;2415;8690;2536;9270
211105;202004;2337;7428;1936;6700;166;587;1405;4840;1571;5427
211107;202004;4608;14659;3929;13660;127;575;3206;11502;3333;12077
211110;202004;5793;15961;4481;13950;352;1025;3307;10514;3659;11539
211120;202004;43549;107144;35850;98166;4833;12170;23254;68032;28087;80202
211125;202004;2054;6113;1732;5624;36;149;1480;4814;1516;4963
211130;202004;186190;441291;161140;408833;23344;57493;75023;217783;98367;275276
211140;202004;4911;14631;4288;13818;207;589;3637;11821;3844;12410
211150;202004;9242;25950;7789;24060;346;1075;6580;20478;6926;21553
211153;202004;2419;7116;1969;6573;272;954;1312;4619;1584;5573
211157;202004;1081;3454;903;3131;33;173;670;2298;703;2471
211160;202004;3987;11284;3119;10032;143;527;2351;7485;2494;8012
211163;202004;1619;5202;1476;5005;20;103;1348;4600;1368;4703
211167;202004;1505;4834;1413;4687;28;125;1299;4285;1327;4410
211170;202004;6417;15850;5963;15333;54;165;5672;14545;5726;14710
211172;202004;2438;6688;2111;6208;101;317;1720;4945;1821;5262
211174;202004;2834;8211;2563;7909;40;205;2391;7342;2431;7547
211176;202004;4188;12035;3249;10657;151;658;2585;8443;2736;9101
211178;202004;4570;10780;3935;10087;34;157;3739;9509;3773;9666
211180;202004;3981;13172;3692;12752;201;755;3147;10922;3348;11677
211190;202004;3017;8936;2553;8253;35;203;2258;7225;2293;7428
211195;202004;1356;3874;1159;3571;49;115;992;3117;1041;3232
211200;202004;2073;5949;1659;5390;199;624;1167;3882;1366;4506
211210;202004;6199;19080;5618;18313;240;997;4885;15786;5125;16783
211220;202004;36660;92576;29831;84150;2784;7378;22082;64079;24866;71457
211223;202004;5137;13568;4266;12421;355;1057;3238;9487;3593;10544
211227;202004;1738;5824;1578;5593;32;150;1397;5039;1429;5189
211230;202004;7370;21483;6430;20066;388;1044;5187;16558;5575;17602
211240;202004;8045;25697;7621;25151;136;751;7075;23091;7211;23842
211245;202004;6967;17710;6210;16925;88;213;5996;16382;6084;16595
211250;202004;12973;40896;11705;39185;616;2482;9667;32114;10283;34596
211260;202004;7888;25720;7038;24601;199;885;6330;22259;6529;23144
211270;202004;10410;33252;8920;31227;383;1756;7258;25592;7641;27348
211280;202004;12491;34642;11105;32886;911;2150;8913;27606;9824;29756
211285;202004;1737;5782;1525;5481;143;561;1099;4057;1242;4618
211290;202004;7410;22320;6664;21341;178;757;5740;18323;5918;19080
211300;202004;7777;22335;6888;21010;179;599;5988;18128;6167;18727
211400;202004;11226;32067;9122;29198;974;3135;6265;21067;7239;24202
220005;202004;1803;4777;1634;4548;36;144;1381;3767;1417;3911
220010;202004;1473;4222;1207;3744;27;110;941;2884;968;2994
220020;202004;3538;9904;3046;9197;130;479;2502;7491;2632;7970
220025;202004;2220;5047;1900;4573;24;64;1594;3721;1618;3785
220027;202004;1263;3204;1076;2958;19;64;915;2468;934;2532
220030;202004;3308;8357;3093;8069;74;228;2751;7084;2825;7312
220040;202004;7039;21343;6119;19563;1402;4116;3229;10888;4631;15004
220045;202004;1455;4461;1194;4020;31;172;971;3202;1002;3374
220050;202004;4733;12808;4005;11848;60;285;3671;10729;3731;11014
220060;202004;2352;4961;1978;4529;24;58;1857;4243;1881;4301
220070;202004;2451;6176;2098;5667;71;147;1753;4765;1824;4912
220080;202004;707;2009;606;1858;24;92;523;1587;547;1679
220090;202004;1740;4214;1433;3781;20;69;1192;3256;1212;3325
220095;202004;641;1606;597;1559;26;43;538;1427;564;1470
220100;202004;1350;3725;1078;3288;46;168;867;2575;913;2743
220105;202004;1978;6192;1733;5701;112;427;1320;4319;1432;4746
220110;202004;3344;9257;3082;8801;40;205;2768;7792;2808;7997
220115;202004;2671;7798;2470;7530;67;229;2238;6773;2305;7002
220117;202004;1342;3249;1042;2833;11;56;879;2339;890;2395
220120;202004;12640;34204;11540;32837;76;271;10830;30811;10906;31082
220130;202004;1093;2959;928;2731;15;81;839;2442;854;2523
220140;202004;2094;4371;1763;3973;103;265;1545;3423;1648;3688
220150;202004;6314;18807;5772;17894;122;584;4888;14871;5010;15455
220155;202004;1143;3289;910;2858;32;115;650;2001;682;2116
220157;202004;1046;2568;886;2324;20;81;719;1824;739;1905
220160;202004;2774;7731;2395;7051;33;158;2004;5801;2037;5959
220170;202004;1529;4014;1301;3680;12;63;1166;3259;1178;3322
220173;202004;2110;5894;1697;5165;42;187;1356;4028;1398;4215
220177;202004;1975;5657;1869;5539;10;37;1846;5463;1856;5500
220180;202004;1108;2719;903;2374;4;21;701;1733;705;1754
220190;202004;6800;17161;5743;15709;357;1046;4293;11906;4650;12952
220191;202004;1457;4446;1318;4209;70;256;983;3051;1053;3307
220192;202004;2017;5330;1465;4334;29;106;1186;3452;1215;3558
220194;202004;1687;4846;1493;4537;55;211;1227;3682;1282;3893
220196;202004;1982;5137;1789;4844;28;114;1534;4079;1562;4193
220198;202004;1274;3541;1072;3282;8;37;989;3050;997;3087
220200;202004;5042;14573;4372;13701;106;427;3741;11729;3847;12156
220202;202004;2137;6026;1836;5534;28;150;1580;4692;1608;4842
220205;202004;2457;7095;2203;6635;49;198;1862;5522;1911;5720
220207;202004;784;2331;635;2074;62;213;400;1319;462;1532
220208;202004;1650;5075;1342;4477;154;565;813;2654;967;3219
220209;202004;1569;4458;1352;4077;21;95;1117;3334;1138;3429
220210;202004;1661;4137;1428;3775;11;51;1221;3159;1232;3210
220211;202004;1567;4060;1438;3881;14;62;1257;3409;1271;3471
220213;202004;1741;4658;1506;4250;29;103;1210;3323;1239;3426
220217;202004;2109;6423;1963;6254;35;91;1831;5934;1866;6025
220220;202004;10391;27159;8581;24347;552;1377;5843;17422;6395;18799
220225;202004;1013;2676;819;2423;6;36;763;2229;769;2265
220230;202004;5675;14105;4863;12987;157;379;4207;11279;4364;11658
220240;202004;2907;8503;2635;8031;111;361;2129;6503;2240;6864
220245;202004;1691;4065;1296;3565;10;53;1177;3268;1187;3321
220250;202004;2959;8310;2608;7866;18;96;2442;7336;2460;7432
220253;202004;1563;4278;1375;3965;60;213;1164;3259;1224;3472
220255;202004;1851;4466;1577;4080;34;152;1339;3333;1373;3485
220260;202004;4205;13071;3705;12142;157;600;2958;9687;3115;10287
220265;202004;1309;4175;1175;3993;33;168;968;3222;1001;3390
220270;202004;6129;19474;5760;18802;204;994;4824;15230;5028;16224
220271;202004;1472;3762;1273;3490;27;101;1126;3069;1153;3170
220272;202004;1760;5052;1563;4692;51;157;1186;3465;1237;3622
220273;202004;1210;3448;1007;3072;34;130;775;2324;809;2454
220275;202004;2240;5375;1769;4729;29;81;1556;4190;1585;4271
220277;202004;2101;5315;1803;4874;20;63;1547;4117;1567;4180
220280;202004;1617;3795;1332;3418;27;92;1133;2871;1160;2963
220285;202004;1405;3597;1197;3359;11;48;1095;3052;1106;3100
220290;202004;6241;17889;4895;15968;344;1272;3585;11939;3929;13211
220300;202004;1961;5659;1591;5170;32;184;1324;4280;1356;4464
220310;202004;3030;8159;2344;7355;41;203;1968;6138;2009;6341
220320;202004;3001;8860;2301;7517;84;407;1793;5669;1877;6076
220323;202004;1618;4740;1273;4175;54;210;1045;3373;1099;3583
220325;202004;1248;3689;1065;3384;22;110;893;2786;915;2896
220327;202004;1490;4247;1294;3924;42;179;1075;3180;1117;3359
220330;202004;4299;10431;3588;9566;57;181;3237;8566;3294;8747
220335;202004;1668;5057;1499;4844;33;108;1332;4326;1365;4434
220340;202004;1815;4798;1392;4095;56;192;954;2720;1010;2912
220342;202004;1126;3327;1000;3138;41;195;798;2462;839;2657
220345;202004;3100;6974;2395;5955;13;42;2174;5382;2187;5424
220350;202004;3272;8348;2594;7335;136;412;1847;5230;1983;5642
220360;202004;1223;3131;958;2691;15;49;774;2155;789;2204
220370;202004;8639;25045;7838;23758;168;740;6843;20467;7011;21207
220375;202004;1597;4535;1410;4305;2;13;1338;4107;1340;4120
220380;202004;1476;3505;1194;3099;16;43;1045;2683;1061;2726
220385;202004;853;2042;678;1719;7;21;590;1477;597;1498
220390;202004;9948;25942;7573;22243;1956;5616;2839;9232;4795;14848
220400;202004;1462;3452;1109;2917;23;69;853;2184;876;2253
220410;202004;1149;3157;921;2773;48;141;747;2220;795;2361
220415;202004;800;2045;670;1835;19;56;540;1458;559;1514
220420;202004;1993;5528;1595;4758;52;158;1236;3640;1288;3798
220430;202004;2455;6621;2305;6402;78;264;1968;5394;2046;5658
220435;202004;1721;4442;1484;4096;38;127;1225;3324;1263;3451
220440;202004;2374;7433;2029;6897;93;389;1700;5689;1793;6078
220450;202004;2462;6378;2002;5804;60;205;1709;4977;1769;5182
220455;202004;1283;3959;1218;3867;11;59;1084;3440;1095;3499
220460;202004;960;2356;890;2267;36;89;761;1918;797;2007
220465;202004;2335;7225;2057;6788;182;608;1509;5093;1691;5701
220470;202004;3443;9536;3084;8974;79;212;2526;7261;2605;7473
220480;202004;2684;7000;2150;6138;162;399;1446;4154;1608;4553
220490;202004;2469;6209;2134;5780;26;128;1859;4964;1885;5092
220500;202004;2768;7103;2414;6535;56;185;1982;5222;2038;5407
220510;202004;2518;7139;1968;6146;80;234;1552;4887;1632;5121
220515;202004;1622;3934;1484;3741;31;51;1304;3277;1335;3328
220520;202004;4882;12732;4395;12042;100;289;3826;10405;3926;10694
220525;202004;1311;3312;1126;3077;9;42;1037;2800;1046;2842
220527;202004;1294;3623;1107;3351;12;53;951;2929;963;2982
220530;202004;1425;3554;1218;3291;31;101;1111;2974;1142;3075
220535;202004;792;2196;740;2127;29;98;606;1729;635;1827
220540;202004;3196;10217;2989;9824;116;404;2561;8386;2677;8790
220545;202004;1383;4191;1267;4003;67;261;1057;3292;1124;3553
220550;202004;8516;26158;7522;24436;490;1719;5680;18297;6170;20016
220551;202004;1374;3936;1199;3635;27;123;988;2930;1015;3053
220552;202004;1577;4582;1277;4052;28;142;1023;3130;1051;3272
220553;202004;1708;4419;1407;4019;58;111;1138;3381;1196;3492
220554;202004;877;2317;640;1919;46;105;414;1247;460;1352
220555;202004;2201;6684;1961;6355;44;183;1671;5420;1715;5603
220556;202004;1189;3456;1029;3153;58;237;737;2161;795;2398
220557;202004;1584;4861;1336;4361;68;269;978;3096;1046;3365
220558;202004;1381;3597;1080;3178;19;87;933;2719;952;2806
220559;202004;1693;4265;1430;3859;8;21;1150;3161;1158;3182
220560;202004;1756;3949;1415;3514;37;71;1286;3217;1323;3288
220570;202004;7127;21281;6474;20364;447;1413;5139;16273;5586;17686
220580;202004;6904;18923;6313;17967;80;296;5723;16168;5803;16464
220585;202004;1999;6305;1660;5680;40;143;1364;4717;1404;4860
220590;202004;1304;3551;1066;3188;69;204;772;2319;841;2523
220595;202004;2521;6894;2286;6579;21;100;2032;5798;2053;5898
220600;202004;1373;3083;1154;2809;87;108;962;2426;1049;2534
220605;202004;1606;4690;1366;4263;19;116;1105;3342;1124;3458
220610;202004;2708;7968;2535;7713;34;151;2363;7170;2397;7321
220620;202004;7774;24125;7150;23279;169;893;6509;20933;6678;21826
220630;202004;363;1071;276;906;22;75;184;604;206;679
220635;202004;1597;5074;1400;4640;54;268;1055;3397;1109;3665
220640;202004;2472;6823;2106;6293;79;316;1708;5038;1787;5354
220650;202004;2047;5659;1775;5240;37;137;1423;4204;1460;4341
220660;202004;2608;8133;2217;7469;81;419;1854;6097;1935;6516
220665;202004;1197;3643;1009;3330;31;173;836;2671;867;2844
220667;202004;1575;4916;1407;4599;60;241;1156;3750;1216;3991
220669;202004;1601;4890;1532;4783;51;241;1355;4134;1406;4375
220670;202004;2165;5664;1735;5059;16;82;1510;4387;1526;4469
220672;202004;3162;7774;2552;7037;104;336;2249;6148;2353;6484
220675;202004;1239;3408;1108;3167;31;103;925;2612;956;2715
220680;202004;2648;7261;2530;7093;95;235;2321;6526;2416;6761
220690;202004;1544;4095;1362;3817;59;170;1079;3038;1138;3208
220695;202004;884;2446;816;2329;21;65;714;2028;735;2093
220700;202004;9787;24147;7836;21445;341;963;6007;16328;6348;17291
220710;202004;885;2440;654;2000;30;98;488;1467;518;1565
220720;202004;2098;4978;1892;4701;15;62;1647;4039;1662;4101
220730;202004;1298;3627;1090;3272;14;80;926;2713;940;2793
220735;202004;948;2217;739;1898;18;63;623;1542;641;1605
220740;202004;1355;3540;1076;3187;33;87;887;2687;920;2774
220750;202004;3836;9740;3342;9028;191;466;2889;7842;3080;8308
220755;202004;1285;3190;1068;2863;23;85;867;2262;890;2347
220760;202004;3064;8560;2675;8038;73;243;2391;7251;2464;7494
220770;202004;21975;65796;18413;59610;5643;19263;6555;22002;12198;41265
220775;202004;1136;2914;1011;2759;10;43;968;2622;978;2665
220777;202004;1602;4051;1212;3451;30;78;931;2666;961;2744
220779;202004;1284;3244;1108;2989;20;62;967;2594;987;2656
220780;202004;5540;14000;4812;12895;200;656;3942;10317;4142;10973
220785;202004;1450;3232;1267;2999;7;19;1224;2882;1231;2901
220790;202004;9938;28447;8914;26979;211;1002;7512;22471;7723;23473
220793;202004;904;2388;715;2056;10;23;598;1742;608;1765
220795;202004;1374;3553;1206;3322;17;77;1071;2937;1088;3014
220800;202004;17684;39321;14930;35671;625;1460;11559;27573;12184;29033
220810;202004;2975;8213;2501;7373;53;161;2066;6037;2119;6198
220820;202004;4989;13014;4307;12019;279;683;3258;9084;3537;9767
220830;202004;7202;19156;6465;18133;237;779;5373;14864;5610;15643
220840;202004;12135;37195;10061;32928;2267;7121;4663;15917;6930;23038
220850;202004;3100;9616;2764;9203;60;325;2444;8142;2504;8467
220855;202004;685;1741;590;1607;13;48;537;1453;550;1501
220860;202004;1013;2553;870;2324;14;62;782;2060;796;2122
220865;202004;2421;6430;1898;5515;99;364;1378;3876;1477;4240
220870;202004;2901;8259;2419;7621;36;190;2225;6988;2261;7178
220880;202004;5253;12432;4509;11506;80;296;4111;10370;4191;10666
220885;202004;1372;4208;1132;3799;57;233;906;3073;963;3306
220887;202004;1534;3346;1273;3009;11;28;1180;2767;1191;2795
220890;202004;1383;4249;1210;3984;46;160;1001;3350;1047;3510
220900;202004;2005;4772;1670;4336;30;74;1463;3787;1493;3861
220910;202004;1509;4128;1265;3773;55;168;1050;3145;1105;3313
220915;202004;929;2532;752;2208;5;20;568;1626;573;1646
220920;202004;1334;4327;1147;4075;60;267;952;3383;1012;3650
220930;202004;1703;4641;1428;4239;23;72;1318;3906;1341;3978
220935;202004;1071;3078;868;2655;23;88;577;1671;600;1759
220937;202004;1397;3731;1208;3441;22;77;968;2730;990;2807
220940;202004;1483;4196;1178;3637;37;138;910;2767;947;2905
220945;202004;437;1521;376;1380;21;120;279;984;300;1104
220950;202004;1420;3257;921;2475;16;54;734;1907;750;1961
220955;202004;1582;4099;1317;3632;24;74;1117;3036;1141;3110
220960;202004;796;2032;591;1692;16;57;420;1138;436;1195
220965;202004;1761;4839;1534;4495;21;130;1329;3805;1350;3935
220970;202004;1909;4586;1398;3817;37;90;1158;3147;1195;3237
220975;202004;679;1973;580;1850;16;93;511;1566;527;1659
220980;202004;1141;3216;1011;3043;37;151;846;2515;883;2666
220985;202004;1200;3139;1041;2912;41;124;845;2291;886;2415
220987;202004;1423;4247;1238;3914;56;211;996;3128;1052;3339
220990;202004;1677;4614;1472;4313;18;101;1244;3582;1262;3683
220995;202004;1049;3197;847;2825;34;120;623;2069;657;2189
220997;202004;2370;7093;2189;6803;47;213;1962;6034;2009;6247
221000;202004;4444;12150;3920;11367;87;417;3341;9543;3428;9960
221005;202004;1467;3854;1336;3640;22;122;1160;3039;1182;3161
221010;202004;1178;2722;947;2439;21;61;823;2072;844;2133
221020;202004;1492;4570;1378;4353;22;88;1065;3321;1087;3409
221030;202004;1602;4004;1379;3732;24;77;1187;3259;1211;3336
221035;202004;1471;3897;1282;3639;21;28;1136;3312;1157;3340
221037;202004;655;1841;544;1644;7;24;382;1115;389;1139
221038;202004;516;1450;402;1242;13;43;284;874;297;917
221039;202004;848;2332;724;2115;19;83;594;1667;613;1750
221040;202004;3976;11916;3476;11016;148;529;2764;8749;2912;9278
221050;202004;3874;10181;3402;9577;64;241;3072;8625;3136;8866
221060;202004;8351;23212;6899;20920;251;716;5615;17163;5866;17879
221062;202004;1159;3760;984;3466;40;186;789;2744;829;2930
221063;202004;1027;2876;875;2653;55;191;674;2007;729;2198
221065;202004;2585;6695;2284;6150;21;83;2008;5310;2029;5393
221070;202004;3300;10308;2652;8951;280;942;1636;5639;1916;6581
221080;202004;3459;8501;2800;7531;59;227;2297;6078;2356;6305
221090;202004;1374;3555;1123;3141;9;35;965;2639;974;2674
221093;202004;1342;3774;1221;3527;122;342;846;2402;968;2744
221095;202004;885;2291;737;2061;10;33;616;1692;626;1725
221097;202004;835;2184;642;1838;22;70;473;1301;495;1371
221100;202004;112668;301292;93286;268052;9998;30822;60662;169633;70660;200455
221110;202004;9815;29255;8991;28182;146;744;8043;24950;8189;25694
221120;202004;4726;13025;4200;12175;161;488;3660;10594;3821;11082
221130;202004;5221;13679;3862;11014;754;2051;1863;5374;2617;7425
221135;202004;1598;4265;1433;4045;39;135;1270;3579;1309;3714
221140;202004;1313;3112;1103;2841;11;37;990;2503;1001;2540
221150;202004;1099;2709;852;2275;23;100;656;1638;679;1738
221160;202004;719;1793;632;1680;13;16;519;1386;532;1402
221170;202004;975;2804;883;2633;20;68;764;2253;784;2321
230010;202004;2985;7892;2452;6979;35;130;1987;5544;2022;5674
230015;202004;2972;9653;2595;8903;163;648;1827;6215;1990;6863
230020;202004;12865;40522;12008;39202;330;1372;10200;33117;10530;34489
230030;202004;12909;32350;10747;29543;178;551;9440;25945;9618;26496
230040;202004;4376;11400;3620;10181;43;216;3031;8405;3074;8621
230050;202004;2764;8570;2079;6930;337;1068;923;3009;1260;4077
230060;202004;2341;6402;1850;5529;37;165;1465;4294;1502;4459
230070;202004;3873;10328;3104;8839;141;447;2178;6127;2319;6574
230075;202004;8917;28916;8146;27553;470;1980;6486;21649;6956;23629
230080;202004;3070;6405;2323;5480;7;24;2118;5016;2125;5040
230090;202004;4256;10567;3579;9477;162;426;2864;7531;3026;7957
230100;202004;17706;46116;15535;43149;1157;3326;11175;31146;12332;34472
230110;202004;12679;37605;10634;33580;1714;5383;5626;17886;7340;23269
230120;202004;7299;19711;6413;18262;505;1272;4726;13684;5231;14956
230125;202004;3130;8251;2534;7283;88;303;1943;5506;2031;5809
230130;202004;5715;17560;4614;15105;310;1101;3122;10038;3432;11139
230140;202004;3391;10162;2876;9089;102;413;2190;6767;2292;7180
230150;202004;1565;4696;1293;4091;194;534;758;2488;952;3022
230160;202004;6472;16795;5519;15297;197;690;4469;12167;4666;12857
230170;202004;6238;17686;5061;15252;311;911;3630;10772;3941;11683
230180;202004;1638;4526;1384;4048;21;99;1119;3168;1140;3267
230185;202004;4327;12367;3635;11209;243;856;2713;8329;2956;9185
230190;202004;13034;37962;10935;34047;1453;4726;6200;19147;7653;23873
230195;202004;5249;15470;4750;14526;335;1019;3645;11112;3980;12131
230200;202004;4979;13707;4159;12157;148;479;3186;9116;3334;9595
230205;202004;4016;12068;3510;11288;183;672;2626;8375;2809;9047
230210;202004;10357;24884;8705;22645;338;1115;6865;17550;7203;18665
230220;202004;13922;34894;12138;32304;621;1671;9979;26295;10600;27966
230230;202004;6776;20470;6038;18915;389;1215;4458;13950;4847;15165
230240;202004;13015;34656;11216;31577;275;1154;9259;25462;9534;26616
230250;202004;8860;24878;8232;23893;221;800;6602;18596;6823;19396
230260;202004;14539;43562;12556;39975;1676;5208;7203;23451;8879;28659
230270;202004;7468;20313;5662;16866;455;1343;3767;11262;4222;12605
230280;202004;20309;54199;16492;47719;469;1986;12974;36185;13443;38171
230290;202004;4821;13361;3989;11768;265;699;3005;8884;3270;9583
230300;202004;4758;12739;4290;12093;95;292;3753;10507;3848;10799
230310;202004;4603;13114;3878;11821;132;578;2794;8276;2926;8854
230320;202004;7689;22202;6445;19905;242;1001;4922;14876;5164;15877
230330;202004;4682;12756;3678;10811;140;465;2757;7923;2897;8388
230340;202004;3552;11062;3009;9950;262;919;2019;6609;2281;7528
230350;202004;17714;48799;15470;45422;862;2900;10398;30753;11260;33653
230360;202004;2875;7689;2238;6562;140;412;1512;4384;1652;4796
230365;202004;2999;7531;2474;6740;51;247;2103;5642;2154;5889
230370;202004;58481;162423;49554;149047;7363;22407;29359;89761;36722;112168
230380;202004;6285;17443;4924;14917;129;525;3637;10777;3766;11302
230390;202004;3361;9988;2894;9229;97;431;2228;7016;2325;7447
230393;202004;3185;9557;2520;8181;84;447;1928;6017;2012;6464
230395;202004;5776;15690;5025;14429;318;854;3572;10288;3890;11142
230400;202004;5443;14976;4832;13964;95;500;3904;10960;3999;11460
230410;202004;14137;41595;11587;36849;884;3055;7937;25198;8821;28253
230420;202004;28415;78187;22916;68523;2785;8667;12783;38052;15568;46719
230423;202004;4632;13740;4018;12506;87;388;3292;10077;3379;10465
230425;202004;5518;17032;5006;15974;388;1306;3574;11354;3962;12660
230426;202004;2720;7172;1958;5678;27;103;1472;4193;1499;4296
230427;202004;1850;5198;1315;4060;60;200;875;2600;935;2800
230428;202004;9607;25608;8215;23501;1108;3155;4816;13727;5924;16882
230430;202004;4963;13914;3901;12086;152;542;2908;8877;3060;9419
230435;202004;5834;15317;4832;13517;574;1527;2950;8313;3524;9840
230440;202004;408967;1014058;337820;908702;34160;97364;215821;574524;249981;671888
230445;202004;4237;11235;3400;9788;172;483;2327;6575;2499;7058
230450;202004;3556;10288;3096;9609;237;929;2254;6782;2491;7711
230460;202004;2110;5896;1835;5460;57;229;1532;4536;1589;4765
230465;202004;3967;11175;3358;10005;98;395;2522;7225;2620;7620
230470;202004;11251;37059;10051;34836;875;3464;7129;24266;8004;27730
230480;202004;1412;4100;1194;3701;73;287;873;2608;946;2895
230490;202004;2511;7055;2095;6273;165;560;1312;3691;1477;4251
230495;202004;5704;16922;5010;15673;364;1384;3330;10280;3694;11664
230500;202004;9180;29616;8229;27856;269;1104;6700;22638;6969;23742
230510;202004;1596;4835;1230;4039;168;598;614;1978;782;2576
230520;202004;4492;12726;3873;11602;315;884;2721;8189;3036;9073
230523;202004;15326;45243;12185;38459;2757;8691;3158;10624;5915;19315
230526;202004;3680;10469;3131;9519;183;534;2287;7010;2470;7544
230530;202004;5344;16701;4477;14989;295;1112;3217;10662;3512;11774
230533;202004;4391;10575;3642;9373;82;249;3030;7674;3112;7923
230535;202004;5297;14697;4466;13285;231;694;3134;9438;3365;10132
230540;202004;16163;43805;13837;40353;274;1102;11409;32948;11683;34050
230550;202004;20512;54437;16375;47355;1486;4458;10420;29976;11906;34434
230560;202004;8043;19661;6460;17152;49;207;5550;14632;5599;14839
230565;202004;2987;8327;2494;7420;85;348;1886;5496;1971;5844
230570;202004;3444;8804;2928;8101;78;226;2408;6654;2486;6880
230580;202004;10918;28209;9309;25886;341;967;7678;21239;8019;22206
230590;202004;8790;25024;7245;22189;386;1415;5350;15849;5736;17264
230600;202004;3598;9401;2805;7984;72;222;1964;5629;2036;5851
230610;202004;6610;18266;5825;16940;440;1267;4586;13264;5026;14531
230620;202004;2075;5601;1568;4596;118;365;962;2734;1080;3099
230625;202004;7709;21937;6446;19606;1913;6043;1770;5794;3683;11837
230630;202004;10711;31791;9254;28852;1446;4284;5338;17049;6784;21333
230640;202004;27543;83240;24774;78819;1234;4934;19676;61665;20910;66599
230650;202004;5064;13827;4297;12477;133;567;3498;9915;3631;10482
230655;202004;9186;31155;8621;30160;595;2171;6881;24331;7476;26502
230660;202004;5961;17775;4866;15832;150;806;3975;12668;4125;13474
230670;202004;6131;14647;4457;11942;130;437;3591;9393;3721;9830
230680;202004;2604;7132;2201;6412;127;351;1590;4665;1717;5016
230690;202004;7107;21000;6103;18993;383;1352;3862;11797;4245;13149
230700;202004;10115;25932;8153;22281;314;852;6054;16223;6368;17075
230710;202004;6639;21086;5788;19256;584;1966;3933;12924;4517;14890
230720;202004;1891;5574;1529;4829;118;349;1027;3172;1145;3521
230725;202004;3838;11560;3430;10849;377;1330;1988;6196;2365;7526
230730;202004;56081;151887;43619;132680;9563;31517;14625;46774;24188;78291
230740;202004;5982;16562;5061;15086;129;465;4088;12143;4217;12608
230750;202004;8296;22119;6868;19740;160;579;5479;15349;5639;15928
230760;202004;11056;29091;9605;26910;502;1669;7253;19863;7755;21532
230763;202004;4749;13059;3965;11621;118;558;3188;9066;3306;9624
230765;202004;40357;109572;33349;98126;5204;15864;16691;48848;21895;64712
230770;202004;25333;62677;21095;57013;2146;5839;13978;37887;16124;43726
230780;202004;6161;21840;5610;20545;740;2730;3348;12555;4088;15285
230790;202004;2939;8573;2634;8071;107;457;1976;5903;2083;6360
230800;202004;7951;25320;6966;23317;796;2899;4207;13829;5003;16728
230810;202004;11335;33787;10111;31809;392;1447;7821;24150;8213;25597
230820;202004;3428;11198;2788;9687;252;1054;1694;5601;1946;6655
230830;202004;7465;20324;6331;18408;132;561;5232;14866;5364;15427
230835;202004;4232;10095;3224;8485;85;257;2603;6743;2688;7000
230837;202004;3092;9495;2686;8772;108;507;2141;6801;2249;7308
230840;202004;8918;26166;7651;24031;774;2314;5495;17409;6269;19723
230850;202004;9427;27397;7876;24304;353;1292;5678;17251;6031;18543
230860;202004;5130;13116;4237;11834;55;200;3752;10426;3807;10626
230870;202004;16389;40058;14003;36084;373;1082;11468;29043;11841;30125
230880;202004;2087;6348;1900;6036;41;232;1512;4682;1553;4914
230890;202004;4548;14508;4118;13634;326;1198;2987;9705;3313;10903
230900;202004;2970;8548;2527;7688;179;623;1710;5082;1889;5705
230910;202004;3086;8267;2474;7294;60;282;2020;5921;2080;6203
230920;202004;4551;12864;3832;11726;130;532;3017;9042;3147;9574
230930;202004;6439;18048;5374;16133;287;836;3749;11274;4036;12110
230940;202004;7905;20329;6795;18625;190;489;5681;15503;5871;15992
230945;202004;6444;18533;5517;16752;299;1072;3925;11708;4224;12780
230950;202004;6161;15549;5467;14600;88;208;4833;12971;4921;13179
230960;202004;13030;37907;11436;34913;1838;5585;5819;17980;7657;23565
230970;202004;13416;35557;11150;32014;1724;4895;6302;18396;8026;23291
230980;202004;2654;7781;2326;7203;346;1023;1439;4576;1785;5599
230990;202004;1604;4522;1329;3970;63;268;952;2710;1015;2978
231000;202004;2462;6572;1998;5652;73;191;1489;4133;1562;4324
231010;202004;3509;8250;2757;6933;40;154;2390;5835;2430;5989
231020;202004;7891;24922;7023;23173;1279;3902;3981;13713;5260;17615
231025;202004;7405;20474;6413;18839;715;2059;4449;13196;5164;15255
231030;202004;7226;21501;5626;18115;885;2758;2940;9522;3825;12280
231040;202004;2868;8352;2495;7652;117;372;1960;5915;2077;6287
231050;202004;11575;29810;9305;25775;635;1713;6919;18750;7554;20463
231060;202004;2793;7964;2436;7388;62;228;2008;6085;2070;6313
231070;202004;7720;22396;6574;20391;694;2220;4260;13137;4954;15357
231080;202004;3896;11147;3307;10183;127;546;2529;7630;2656;8176
231085;202004;6725;16349;5309;14649;198;529;4166;11504;4364;12033
231090;202004;4433;11570;3256;9292;98;392;2237;6160;2335;6552
231095;202004;2269;6739;1765;5640;134;433;1173;3739;1307;4172
231100;202004;3138;9065;2584;8020;117;430;1933;5932;2050;6362
231110;202004;3503;10319;3176;9711;112;412;2399;7227;2511;7639
231120;202004;2197;6443;1806;5767;73;292;1298;4098;1371;4390
231123;202004;1857;4822;1552;4296;68;152;1139;3170;1207;3322
231126;202004;5360;14882;4306;12867;234;715;3147;9288;3381;10003
231130;202004;21038;54036;17453;49485;996;3700;12957;35993;13953;39693
231135;202004;4124;11602;3394;10167;147;495;2429;7142;2576;7637
231140;202004;16349;45994;12984;40028;582;2434;9127;27390;9709;29824
231150;202004;5694;15521;4368;12989;665;2001;1956;5976;2621;7977
231160;202004;6168;18789;5392;17344;759;2319;3113;10281;3872;12600
231170;202004;4323;12637;3549;11148;190;692;2465;7484;2655;8176
231180;202004;14175;40198;11437;34388;3145;9164;3902;12228;7047;21392
231190;202004;3852;10876;3164;9610;68;303;2433;7197;2501;7500
231195;202004;4880;14816;4026;13022;224;845;2914;9330;3138;10175
231200;202004;7713;24192;6714;22165;197;1010;5258;16831;5455;17841
231210;202004;4761;14033;4040;12821;179;686;3054;9502;3233;10188
231220;202004;11878;31046;9182;25913;374;1179;6745;18367;7119;19546
231230;202004;9147;29139;8027;27105;481;1900;5916;19967;6397;21867
231240;202004;11379;33259;9985;30596;1511;4505;6069;18808;7580;23313
231250;202004;2111;5443;1369;3796;98;276;834;2267;932;2543
231260;202004;3175;9035;2741;8349;251;758;1888;5877;2139;6635
231270;202004;6358;16645;5135;14642;145;571;3892;10856;4037;11427
231280;202004;1710;5337;1560;5057;89;300;1170;3761;1259;4061
231290;202004;37319;111200;30833;97886;5184;16297;14296;45160;19480;61457
231300;202004;4028;11186;3137;9379;207;674;2073;6069;2280;6743
231310;202004;7130;18591;5670;15869;463;1320;3911;10753;4374;12073
231320;202004;7694;21203;5982;18148;85;414;4700;14057;4785;14471
231325;202004;2413;6398;1973;5725;160;389;1336;3963;1496;4352
231330;202004;9369;28089;7669;24690;1371;4212;4098;13792;5469;18004
231335;202004;5665;14969;4778;13526;85;365;4211;11796;4296;12161
231340;202004;17149;53226;15341;49982;1274;4196;11173;36816;12447;41012
231350;202004;15688;42898;14212;40803;274;1004;12722;36180;12996;37184
231355;202004;4319;12955;3865;12098;231;781;2991;9260;3222;10041
231360;202004;7243;21981;6275;20284;252;939;5000;16082;5252;17021
231370;202004;2141;5914;1708;5143;34;110;1308;3937;1342;4047
231375;202004;4332;13476;3947;12838;130;597;3317;10646;3447;11243
231380;202004;5982;16261;5397;15449;181;483;4399;12781;4580;13264
231390;202004;3280;9578;2925;8991;122;479;2173;6498;2295;6977
231395;202004;3902;11561;3225;10482;401;1306;1913;6315;2314;7621
231400;202004;9612;27564;8028;24644;267;1129;6082;18273;6349;19402
231410;202004;14487;45219;13133;42961;583;2272;10603;34259;11186;36531
240010;202004;2515;6670;1952;5627;190;568;1177;3313;1367;3881
240020;202004;12268;34428;10254;30817;623;2333;6901;20421;7524;22754
240030;202004;2840;6940;2575;6529;88;256;2232;5611;2320;5867
240040;202004;789;2264;653;2004;33;125;460;1366;493;1491
240050;202004;3203;8600;2601;7493;48;148;2025;5750;2073;5898
240060;202004;1379;3713;1135;3269;23;86;928;2610;951;2696
240070;202004;2114;6144;1912;5730;176;574;1390;4045;1566;4619
240080;202004;2929;7903;2377;6876;53;207;1831;5190;1884;5397
240090;202004;2217;5463;1800;4756;17;48;1523;3979;1540;4027
240100;202004;9989;24697;7913;20884;207;633;6190;15787;6397;16420
240110;202004;4568;12877;3836;11540;188;684;2779;8196;2967;8880
240120;202004;3210;8971;2562;8179;176;620;1819;5941;1995;6561
240130;202004;3596;7522;2995;6741;26;82;2739;6080;2765;6162
240140;202004;1798;5381;1528;4850;156;544;1031;3245;1187;3789
240145;202004;6580;18242;5359;16140;819;2521;3025;9225;3844;11746
240150;202004;910;2660;803;2437;50;177;623;1831;673;2008
240160;202004;1436;4332;1196;3875;46;208;893;2908;939;3116
240165;202004;949;2600;787;2288;35;114;633;1811;668;1925
240170;202004;2462;6693;2059;5955;187;613;1402;3929;1589;4542
240180;202004;2956;8776;2357;7543;557;1686;1060;3614;1617;5300
240185;202004;1170;3717;1074;3554;53;220;894;2914;947;3134
240190;202004;1033;3091;884;2840;23;109;751;2418;774;2527
240200;202004;10654;27390;8459;23612;833;2562;4871;13258;5704;15820
240210;202004;3167;7893;2590;6980;27;138;2178;5695;2205;5833
240220;202004;7201;21574;6422;20344;325;1439;5060;15744;5385;17183
240230;202004;5749;14684;4593;12730;186;536;3674;10187;3860;10723
240240;202004;1842;5276;1142;3597;113;374;425;1195;538;1569
240250;202004;2898;7656;2552;7179;91;279;2147;6006;2238;6285
240260;202004;14055;41293;12098;37959;1698;4987;7520;24760;9218;29747
240270;202004;2242;6685;1953;6200;96;311;1431;4683;1527;4994
240280;202004;1670;4280;1417;3862;49;140;1138;3058;1187;3198
240290;202004;1171;3419;946;2912;28;130;670;1927;698;2057
240300;202004;2208;5658;1578;4497;71;214;1015;2821;1086;3035
240310;202004;8436;22296;6644;19075;882;2693;3462;9758;4344;12451
240320;202004;2008;5477;1478;4428;33;148;1101;3149;1134;3297
240325;202004;30232;81024;23790;69606;4200;12653;10504;31044;14704;43697
240330;202004;1712;4692;1301;3906;53;197;883;2528;936;2725
240340;202004;1955;4507;1590;3949;63;150;1302;3178;1365;3328
240350;202004;2116;5426;1897;5186;24;74;1730;4745;1754;4819
240360;202004;8586;23798;7636;22291;797;2365;5405;15953;6202;18318
240370;202004;1883;5002;1450;4098;64;194;1033;2839;1097;3033
240375;202004;895;2261;733;1954;27;98;600;1546;627;1644
240380;202004;2223;6302;1619;4928;142;408;954;2877;1096;3285
240390;202004;997;2470;686;1870;26;68;431;1095;457;1163
240400;202004;1412;3482;1103;2933;35;128;775;1946;810;2074
240410;202004;562;1698;470;1492;38;146;299;895;337;1041
240420;202004;4524;15880;3975;14644;458;2001;2369;8539;2827;10540
240430;202004;3334;8665;2773;7660;166;536;2066;5538;2232;6074
240440;202004;2503;5470;2108;4927;136;264;1712;4011;1848;4275
240450;202004;4433;12090;3472;10276;338;1059;2066;5889;2404;6948
240460;202004;2829;8096;2554;7644;236;766;1967;5861;2203;6627
240470;202004;3583;10756;2714;8930;461;1433;1411;4860;1872;6293
240480;202004;575;1594;389;1181;33;104;181;530;214;634
240485;202004;2107;5959;1722;5238;122;386;1204;3662;1326;4048
240490;202004;1608;4121;1258;3470;82;194;932;2589;1014;2783
240500;202004;2125;5743;1855;5291;99;269;1499;4283;1598;4552
240510;202004;1657;4307;1459;4020;62;226;1217;3274;1279;3500
240520;202004;1405;3484;1094;3048;43;145;835;2310;878;2455
240530;202004;2121;6086;1904;5743;90;274;1565;4713;1655;4987
240540;202004;2251;5661;1964;5208;60;121;1707;4525;1767;4646
240550;202004;673;1918;608;1786;19;76;508;1453;527;1529
240560;202004;3284;8490;2757;7781;269;687;2004;5763;2273;6450
240570;202004;2706;7116;1786;5060;276;792;713;1889;989;2681
240580;202004;8059;23444;7106;21670;549;1596;5669;17433;6218;19029
240590;202004;705;1870;615;1719;13;45;467;1280;480;1325
240600;202004;1760;4790;1288;3796;45;148;861;2453;906;2601
240610;202004;4183;11291;3524;10085;128;435;2699;7575;2827;8010
240615;202004;1212;3123;955;2656;90;243;659;1785;749;2028
240620;202004;1821;5152;1569;4707;92;258;1261;3771;1353;4029
240630;202004;2082;5884;1880;5535;147;309;1329;4088;1476;4397
240640;202004;935;2507;743;2184;28;111;556;1611;584;1722
240650;202004;4023;11164;3464;10028;210;623;2665;7606;2875;8229
240660;202004;3087;7900;2738;7447;50;155;2481;6751;2531;6906
240670;202004;2432;6848;1949;5858;137;446;1266;3704;1403;4150
240680;202004;1613;4288;1293;3742;46;142;984;2773;1030;2915
240690;202004;979;2463;772;2114;16;69;615;1617;631;1686
240700;202004;2391;6930;1942;6090;56;204;1530;4714;1586;4918
240710;202004;16102;41626;13428;37009;1725;4651;8311;22937;10036;27588
240720;202004;5108;12604;4407;11617;362;1012;3262;8491;3624;9503
240725;202004;1120;3181;856;2646;35;119;574;1711;609;1830
240730;202004;2208;6199;1782;5354;60;221;1359;3999;1419;4220
240740;202004;1784;4804;1427;4100;42;163;1058;2877;1100;3040
240750;202004;2113;6982;1779;6267;261;1006;956;3403;1217;4409
240760;202004;1572;3759;1097;3026;58;102;843;2407;901;2509
240770;202004;3184;8749;2666;8001;127;470;2147;6354;2274;6824
240780;202004;4793;13200;3883;11667;499;1487;2413;7415;2912;8902
240790;202004;843;2403;699;2121;14;62;531;1572;545;1634
240800;202004;45456;109689;35091;93905;4785;13224;18255;48900;23040;62124
240810;202004;87480;227743;73674;204608;9203;26184;46565;127657;55768;153841
240820;202004;5757;17160;4977;15739;677;2110;3082;9908;3759;12018
240830;202004;8696;24806;7704;23318;237;1042;6398;19096;6635;20138
240840;202004;1112;2750;880;2374;29;74;628;1628;657;1702
240850;202004;1333;3641;951;2832;45;146;528;1516;573;1662
240860;202004;1259;3394;941;2818;15;76;698;1994;713;2070
240870;202004;1103;2798;828;2313;129;365;450;1285;579;1650
240880;202004;1258;3971;1111;3682;84;356;857;2761;941;3117
240890;202004;4363;11900;3309;9873;441;1422;1704;4887;2145;6309
240895;202004;2730;8492;2498;8131;127;423;2193;7174;2320;7597
240910;202004;3282;9014;2797;8128;51;188;2301;6581;2352;6769
240920;202004;862;2376;710;2127;62;178;405;1271;467;1449
240930;202004;3658;8338;3024;7567;197;285;2277;6003;2474;6288
240933;202004;1757;4269;1436;3799;41;163;1244;3238;1285;3401
240940;202004;6035;14867;4665;12516;533;1440;2817;7360;3350;8800
240950;202004;1001;2996;873;2759;26;110;712;2194;738;2304
240960;202004;669;2065;600;1925;28;104;469;1471;497;1575
240970;202004;1815;4684;1462;4077;54;201;1201;3253;1255;3454
240980;202004;3297;9808;2918;9121;114;492;2357;7245;2471;7737
240990;202004;2518;7104;2228;6531;260;852;1571;4445;1831;5297
241000;202004;925;2465;738;2117;26;70;550;1551;576;1621
241010;202004;2756;8842;2517;8325;162;659;1859;6046;2021;6705
241020;202004;2098;5586;1542;4468;134;393;997;2845;1131;3238
241025;202004;1735;4994;1376;4317;49;212;992;3071;1041;3283
241030;202004;2476;7725;1975;6650;218;757;1276;4299;1494;5056
241040;202004;2266;7192;2008;6760;96;419;1610;5383;1706;5802
241050;202004;1300;3620;1064;3193;31;121;802;2341;833;2462
241060;202004;733;2067;647;1884;27;87;459;1285;486;1372
241070;202004;654;1792;562;1628;11;36;444;1244;455;1280
241080;202004;1119;3167;844;2614;9;36;610;1861;619;1897
241090;202004;2007;5878;1635;5233;45;225;1293;4076;1338;4301
241100;202004;1160;3256;910;2739;65;202;594;1735;659;1937
241105;202004;972;2947;791;2601;253;806;257;886;510;1692
241110;202004;942;2664;698;2144;34;108;466;1390;500;1498
241120;202004;7595;21428;6436;19368;950;2796;3806;11755;4756;14551
241140;202004;3283;8641;2582;7232;153;440;1863;5094;2016;5534
241142;202004;758;2035;556;1639;27;92;331;920;358;1012
241150;202004;5902;15339;5195;14170;146;496;4270;11439;4416;11935
241160;202004;1125;3019;907;2616;127;371;586;1647;713;2018
241170;202004;1325;3372;1132;3039;28;109;945;2431;973;2540
241180;202004;1019;2620;735;2059;86;250;378;1044;464;1294
241190;202004;1096;2906;908;2530;17;71;674;1808;691;1879
241200;202004;18880;49627;16206;45273;2565;7182;9455;26496;12020;33678
241210;202004;1402;3759;998;2945;118;375;570;1637;688;2012
241220;202004;8590;25426;7442;23454;1711;5315;3541;11646;5252;16961
241230;202004;2904;7615;2560;7078;104;326;2128;5817;2232;6143
241240;202004;1170;3291;715;2262;62;205;327;1042;389;1247
241250;202004;5354;15560;4278;13519;162;758;3115;9458;3277;10216
241255;202004;2190;6867;1924;6299;110;448;1450;4655;1560;5103
241260;202004;4778;12537;3735;10784;77;333;2978;8407;3055;8740
241270;202004;1728;4978;1423;4387;105;363;1021;3131;1126;3494
241280;202004;2154;5423;1842;4855;58;159;1563;4050;1621;4209
241290;202004;3382;8276;2514;6849;74;247;1991;5274;2065;5521
241300;202004;1431;3837;1135;3296;34;124;785;2219;819;2343
241310;202004;2077;5229;1775;4798;15;63;1511;4120;1526;4183
241320;202004;937;3038;799;2772;85;365;521;1782;606;2147
241330;202004;1723;4525;1345;4021;15;77;1167;3472;1182;3549
241335;202004;3223;8985;2846;8297;103;347;2349;6771;2452;7118
241340;202004;1538;4353;1184;3606;253;804;492;1456;745;2260
241350;202004;2055;5888;1804;5438;87;305;1402;4152;1489;4457
241355;202004;1271;3461;1038;3004;14;43;821;2369;835;2412
241360;202004;2033;5266;1519;4210;41;125;1098;2936;1139;3061
241370;202004;1340;3706;1034;3064;48;168;720;2040;768;2208
241380;202004;614;1743;476;1469;74;192;243;773;317;965
241390;202004;2705;7959;2404;7509;187;528;1865;5920;2052;6448
241400;202004;3502;9761;3113;9154;152;488;2535;7405;2687;7893
241410;202004;2358;7028;1909;6096;334;1085;972;3114;1306;4199
241415;202004;1652;4872;1349;4278;61;228;948;2952;1009;3180
241420;202004;2194;6993;1878;6451;441;1686;933;3184;1374;4870
241430;202004;601;1662;412;1229;18;59;259;745;277;804
241440;202004;7368;22846;6577;21451;344;1284;5233;16948;5577;18232
241445;202004;1097;2819;968;2650;21;53;869;2434;890;2487
241450;202004;2573;6430;2210;5835;379;847;1454;3981;1833;4828
241460;202004;3718;10083;3004;8552;188;579;2133;5924;2321;6503
241470;202004;1400;3696;1135;3304;23;88;945;2754;968;2842
241475;202004;1185;3336;929;2836;23;112;668;1949;691;2061
241480;202004;2882;9017;2366;7885;715;2349;797;2953;1512;5302
241490;202004;617;1476;507;1326;21;55;364;935;385;990
241500;202004;794;2279;704;2164;3;10;651;2023;654;2033
250010;202004;2522;7546;2089;6653;59;239;1523;4741;1582;4980
250020;202004;1594;4297;1139;3398;32;76;820;2431;852;2507
250030;202004;6863;18785;6034;17468;503;1489;4523;12949;5026;14438
250040;202004;4002;12249;3449;11222;228;846;2499;7999;2727;8845
250050;202004;3597;9690;3240;9204;123;423;2635;7508;2758;7931
250053;202004;1156;3231;1045;3052;72;218;765;2235;837;2453
250057;202004;650;2327;606;2261;10;44;539;2047;549;2091
250060;202004;5459;14226;4898;13533;290;777;4036;11220;4326;11997
250070;202004;3950;11023;3345;9955;36;153;2696;7852;2732;8005
250073;202004;757;2013;616;1795;11;36;504;1429;515;1465
250077;202004;2197;5904;1643;4986;63;219;1243;3746;1306;3965
250080;202004;4845;12102;4103;11147;63;285;3582;9595;3645;9880
250090;202004;3319;8111;2892;7537;54;160;2493;6379;2547;6539
250100;202004;3635;11066;3275;10380;163;579;2565;7968;2728;8547
250110;202004;4890;13676;4394;12944;258;964;3421;9857;3679;10821
250115;202004;681;1782;491;1488;9;45;343;1036;352;1081
250120;202004;1818;5331;1523;4841;30;142;1204;3801;1234;3943
250130;202004;5459;15002;4594;13770;72;383;3892;11509;3964;11892
250135;202004;1188;3289;1035;3023;24;92;899;2605;923;2697
250140;202004;2239;6546;2075;6337;106;448;1779;5367;1885;5815
250150;202004;4796;14917;4299;14058;135;622;3465;11132;3600;11754
250153;202004;1404;3697;1175;3349;30;85;949;2684;979;2769
250157;202004;1694;5054;1537;4752;55;241;1228;3732;1283;3973
250160;202004;3908;9710;3112;8632;39;147;2740;7600;2779;7747
250170;202004;1838;4711;1640;4429;24;95;1433;3824;1457;3919
250180;202004;20087;48466;17085;44606;733;2305;13331;33929;14064;36234
250190;202004;4035;10763;3360;9745;317;967;2326;6579;2643;7546
250200;202004;1925;5130;1635;4719;59;187;1375;3971;1434;4158
250205;202004;860;2642;738;2450;15;68;616;2027;631;2095
250210;202004;1544;4681;1389;4431;71;316;1080;3385;1151;3701
250215;202004;1521;4193;1268;3828;75;251;764;2313;839;2564
250220;202004;657;1826;527;1631;28;110;346;1042;374;1152
250230;202004;1658;3725;1100;2856;18;66;915;2286;933;2352
250240;202004;2295;6960;2008;6429;40;196;1667;5251;1707;5447
250250;202004;4563;12646;3968;11766;84;295;3392;10064;3476;10359
250260;202004;1691;4714;1404;4220;50;139;1109;3307;1159;3446
250270;202004;1192;3593;1073;3446;65;226;799;2665;864;2891
250280;202004;3274;9153;2918;8617;102;308;2335;6880;2437;7188
250290;202004;1581;4172;1343;3830;22;69;1055;3015;1077;3084
250300;202004;5494;14618;4926;13953;184;823;4109;11224;4293;12047
250310;202004;1133;3112;934;2779;36;120;725;2129;761;2249
250320;202004;11653;26364;9965;24424;261;742;8866;21435;9127;22177
250330;202004;2375;6581;1983;6038;102;333;1605;4876;1707;5209
250340;202004;1075;2747;959;2596;10;27;881;2375;891;2402
250350;202004;4089;11395;3610;10591;191;467;2833;8560;3024;9027
250355;202004;1956;5901;1751;5616;27;146;1569;5001;1596;5147
250360;202004;1751;4846;1558;4585;38;151;1308;3816;1346;3967
250370;202004;13271;34399;10918;30825;239;898;9145;25459;9384;26357
250375;202004;1178;3083;943;2795;5;17;888;2659;893;2676
250380;202004;1604;4130;1468;3957;26;113;1289;3362;1315;3475
250390;202004;1835;4687;1530;4192;86;240;1212;3291;1298;3531
250400;202004;68575;168513;49929;139245;13802;41036;14628;43088;28430;84124
250403;202004;1725;4822;1537;4597;73;366;1186;3385;1259;3751
250407;202004;1182;2998;950;2647;61;134;693;1959;754;2093
250410;202004;637;1711;552;1565;4;9;460;1277;464;1286
250415;202004;1853;5197;1619;4816;32;146;1399;4132;1431;4278
250420;202004;1179;3338;1073;3193;25;96;958;2833;983;2929
250430;202004;6239;15278;5262;13963;136;430;4357;11312;4493;11742
250435;202004;1525;4252;1223;3720;11;54;942;2827;953;2881
250440;202004;4573;12060;3906;11216;68;192;3466;9952;3534;10144
250450;202004;1800;4777;1470;4325;29;102;1224;3615;1253;3717
250460;202004;7274;19697;6430;18449;317;978;5188;14797;5505;15775
250470;202004;1536;3959;1265;3537;51;158;989;2715;1040;2873
250480;202004;4036;10870;3419;10132;41;146;3016;9010;3057;9156
250485;202004;705;1610;513;1328;34;62;379;950;413;1012
250490;202004;5160;12248;4576;11577;171;516;4045;10046;4216;10562
250500;202004;1971;5464;1744;5066;71;236;1420;4115;1491;4351
250510;202004;5432;13659;4645;12610;73;197;4061;11121;4134;11318
250520;202004;1816;4918;1551;4537;123;393;1103;3203;1226;3596
250523;202004;2224;5483;1966;5157;69;300;1655;4178;1724;4478
250527;202004;1669;4303;1499;4110;23;75;1326;3660;1349;3735
250530;202004;622;1612;527;1482;5;11;465;1307;470;1318
250535;202004;1346;3945;1213;3687;26;111;996;2934;1022;3045
250540;202004;2940;6747;2445;6193;66;123;2146;5528;2212;5651
250550;202004;765;2452;667;2259;21;84;498;1658;519;1742
250560;202004;1705;4699;1502;4404;36;139;1268;3637;1304;3776
250570;202004;2627;7889;2252;7205;77;298;1775;5583;1852;5881
250580;202004;1049;2707;922;2530;48;184;773;2068;821;2252
250590;202004;815;2271;724;2139;18;62;593;1764;611;1826
250600;202004;8137;20753;6778;18992;231;733;5633;15660;5864;16393
250610;202004;2964;8293;2647;7828;117;442;2206;6443;2323;6885
250620;202004;771;2045;654;1844;11;36;485;1340;496;1376
250625;202004;2478;7145;2208;6695;41;221;1874;5516;1915;5737
250630;202004;10053;27851;8091;24386;851;2614;5169;15264;6020;17878
250640;202004;3358;9248;3028;8825;78;344;2616;7479;2694;7823
250650;202004;931;2248;781;2040;12;32;684;1772;696;1804
250660;202004;1632;4015;1309;3570;38;105;1081;2883;1119;2988
250670;202004;2324;7244;2112;6862;44;200;1837;5858;1881;6058
250680;202004;5782;13316;5152;12606;59;225;4774;11533;4833;11758
250690;202004;6773;15237;5738;13947;91;222;5098;12281;5189;12503
250700;202004;4260;11951;3707;11104;420;1244;2595;7745;3015;8989
250710;202004;4403;12583;3776;11719;271;939;2760;8558;3031;9497
250720;202004;2716;7261;2431;6857;36;179;2133;5945;2169;6124
250730;202004;4108;10889;3582;10196;102;420;3000;8301;3102;8721
250740;202004;1910;4784;1584;4348;87;208;1233;3400;1320;3608
250750;202004;103872;254915;87453;231859;7013;20222;63308;164652;70321;184874
250760;202004;2348;6067;2049;5584;84;258;1633;4318;1717;4576
250770;202004;3996;12024;3574;11460;381;1192;2577;8355;2958;9547
250780;202004;1721;4636;1430;4102;48;171;1112;3104;1160;3275
250790;202004;2440;7239;2101;6719;136;544;1420;4428;1556;4972
250800;202004;2446;6486;2125;5968;87;185;1721;4872;1808;5057
250810;202004;1237;3319;1015;3002;19;47;864;2582;883;2629
250820;202004;1964;5485;1808;5313;32;139;1653;4830;1685;4969
250830;202004;5791;17312;4761;15223;260;1007;3292;10213;3552;11220
250840;202004;759;2395;649;2176;14;56;490;1650;504;1706
250850;202004;1753;5269;1566;4935;32;161;1293;3970;1325;4131
250855;202004;940;2773;815;2552;56;196;611;1898;667;2094
250860;202004;3146;9293;2599;8359;439;1488;1521;4890;1960;6378
250870;202004;1023;2829;860;2553;31;118;706;2071;737;2189
250880;202004;1597;4083;1309;3669;77;220;1001;2802;1078;3022
250890;202004;10012;26191;8827;24585;396;1715;7043;18645;7439;20360
250900;202004;2770;7734;2391;7041;61;231;2024;5843;2085;6074
250905;202004;2381;6758;2184;6472;43;171;1987;5881;2030;6052
250910;202004;5894;14673;4844;13482;81;288;4217;11792;4298;12080
250915;202004;2156;5009;1501;4302;24;53;1308;3837;1332;3890
250920;202004;3500;8797;3065;8131;329;748;2250;6009;2579;6757
250930;202004;2244;5965;2023;5682;52;218;1756;4829;1808;5047
250933;202004;1153;3432;1016;3181;21;111;783;2377;804;2488
250937;202004;694;1864;567;1653;21;66;434;1287;455;1353
250939;202004;1750;4653;1518;4346;64;199;1189;3384;1253;3583
250940;202004;3939;10605;3454;9968;17;61;3068;8868;3085;8929
250950;202004;1687;4295;1357;3876;23;97;1124;3168;1147;3265
250960;202004;1125;3273;983;3046;26;140;799;2383;825;2523
250970;202004;8292;21198;7243;19514;221;685;6013;15896;6234;16581
250980;202004;2418;6402;2164;6022;35;149;1862;5049;1897;5198
250990;202004;2033;6147;1691;5547;53;261;1251;4052;1304;4313
251000;202004;2027;5726;1641;5056;37;161;1336;4087;1373;4248
251010;202004;2640;7421;2385;7035;19;88;2166;6383;2185;6471
251020;202004;1631;4428;1458;4153;32;146;1265;3529;1297;3675
251030;202004;1002;2658;820;2322;33;94;582;1629;615;1723
251040;202004;1808;5130;1525;4651;38;188;1230;3721;1268;3909
251050;202004;1054;2868;879;2528;47;156;629;1744;676;1900
251060;202004;1060;2280;797;1949;6;21;638;1531;644;1552
251065;202004;476;1299;368;1098;11;33;251;729;262;762
251070;202004;725;1869;616;1708;10;41;528;1437;538;1478
251080;202004;18394;47109;14940;41875;1789;5212;9723;27324;11512;32536
251090;202004;2773;7968;2329;7171;55;198;1862;5690;1917;5888
251100;202004;792;2524;706;2360;24;94;543;1744;567;1838
251110;202004;1693;4530;1437;4087;46;124;1090;3082;1136;3206
251120;202004;7226;20242;6075;18827;262;999;4831;14938;5093;15937
251130;202004;3864;8656;3405;8145;59;166;3082;7336;3141;7502
251140;202004;4217;11761;3775;11138;74;313;3170;9232;3244;9545
251150;202004;2634;7665;2364;7228;101;423;1937;5791;2038;6214
251160;202004;2127;6231;1842;5813;39;189;1583;4903;1622;5092
251170;202004;1556;4230;1351;3960;33;115;1166;3403;1199;3518
251180;202004;2630;7020;2150;6338;168;498;1465;4301;1633;4799
251190;202004;4388;11397;3993;10951;44;253;3630;9745;3674;9998
251200;202004;4321;12644;3801;11971;72;304;3345;10566;3417;10870
251203;202004;936;3034;861;2871;23;106;652;2116;675;2222
251207;202004;1072;2938;828;2529;19;100;578;1722;597;1822
251210;202004;7429;19008;6044;17125;262;624;4623;13376;4885;14000
251220;202004;1174;2841;922;2505;52;121;711;1972;763;2093
251230;202004;4595;12730;3952;11620;114;420;3119;8935;3233;9355
251240;202004;3571;9803;3005;8856;140;398;2282;6606;2422;7004
251250;202004;10241;27539;8951;25364;720;2153;6624;18210;7344;20363
251260;202004;478;1367;435;1300;12;62;349;1008;361;1070
251270;202004;4236;13184;3805;12610;110;458;3110;10524;3220;10982
251272;202004;1338;3622;1204;3444;42;163;1017;2830;1059;2993
251274;202004;893;2471;712;2141;63;209;472;1351;535;1560
251275;202004;1212;3385;1034;3096;29;131;813;2366;842;2497
251276;202004;1316;3567;1144;3337;31;161;932;2619;963;2780
251278;202004;570;1570;509;1479;41;100;375;1120;416;1220
251280;202004;2219;6029;1981;5660;50;172;1661;4679;1711;4851
251290;202004;5885;13882;5307;13174;146;489;4635;11144;4781;11633
251300;202004;848;2497;765;2372;8;41;653;2021;661;2062
251310;202004;2690;7743;2341;7194;48;258;1881;5632;1929;5890
251315;202004;1684;5253;1538;4987;86;259;1162;3726;1248;3985
251320;202004;1591;4230;1134;3443;32;112;849;2535;881;2647
251330;202004;2095;4865;1709;4412;20;75;1545;4015;1565;4090
251335;202004;1044;3084;929;2902;23;102;811;2472;834;2574
251340;202004;3641;8825;2905;7841;109;339;2234;5981;2343;6320
251350;202004;1054;3049;945;2868;25;99;778;2319;803;2418
251360;202004;1805;5060;1450;4561;21;99;1232;3884;1253;3983
251365;202004;713;1939;563;1640;5;19;443;1275;448;1294
251370;202004;23911;63059;20454;58082;2622;7595;12672;36655;15294;44250
251380;202004;1200;3390;1048;3132;19;108;878;2546;897;2654
251385;202004;744;1918;568;1592;15;43;424;1146;439;1189
251390;202004;6380;18538;5616;17332;458;1478;3741;11574;4199;13052
251392;202004;948;2582;790;2347;25;107;614;1787;639;1894
251394;202004;599;1744;491;1552;18;80;369;1145;387;1225
251396;202004;664;1782;567;1611;14;41;404;1123;418;1164
251398;202004;928;2346;656;1884;15;61;489;1370;504;1431
251400;202004;1198;2947;962;2627;27;97;764;2018;791;2115
251410;202004;1448;3449;1186;3076;17;73;1015;2539;1032;2612
251420;202004;1893;4996;1531;4571;36;146;1217;3595;1253;3741
251430;202004;1513;4648;1359;4380;28;128;1175;3789;1203;3917
251440;202004;1096;3076;882;2674;36;101;701;2137;737;2238
251445;202004;1517;4264;1395;4094;32;117;1180;3408;1212;3525
251450;202004;4478;13068;3962;12296;85;335;3296;10136;3381;10471
251455;202004;845;2571;768;2437;22;100;607;1882;629;1982
251460;202004;875;2535;765;2363;17;60;634;1967;651;2027
251465;202004;437;1282;372;1162;6;22;281;862;287;884
251470;202004;1162;3217;868;2603;67;223;506;1446;573;1669
251480;202004;983;2597;800;2267;19;80;615;1655;634;1735
251490;202004;1876;4935;1484;4387;54;175;1105;3267;1159;3442
251500;202004;1926;5422;1765;5210;27;102;1606;4740;1633;4842
251510;202004;2644;7901;2181;6971;106;397;1482;4625;1588;5022
251520;202004;959;2531;728;2100;64;182;472;1327;536;1509
251530;202004;14632;35080;11728;31453;101;569;10379;27338;10480;27907
251540;202004;2926;8431;2634;7880;80;284;2189;6450;2269;6734
251550;202004;3724;8850;2969;7908;99;208;2479;6654;2578;6862
251560;202004;541;1642;473;1535;59;208;326;1022;385;1230
251570;202004;934;2625;755;2272;19;88;600;1745;619;1833
251580;202004;1876;4442;1671;4142;36;153;1460;3471;1496;3624
251590;202004;1556;3876;1306;3582;53;141;1085;2927;1138;3068
251593;202004;893;2605;797;2450;81;259;519;1566;600;1825
251597;202004;2097;5890;1887;5613;21;105;1673;4910;1694;5015
251600;202004;6389;17219;5583;15981;163;531;4626;13040;4789;13571
251610;202004;3210;9117;2748;8252;248;689;1908;5834;2156;6523
251615;202004;1223;3067;985;2704;23;62;794;2121;817;2183
251620;202004;18721;43390;14401;38083;109;369;12296;33033;12405;33402
251630;202004;4697;11067;3770;9783;195;521;2840;7311;3035;7832
251640;202004;2123;5803;1880;5421;28;136;1634;4595;1662;4731
251650;202004;3912;10548;3421;9892;118;385;2918;8418;3036;8803
251660;202004;3448;10342;3026;9593;71;339;2532;7890;2603;8229
251670;202004;3953;11241;3520;10619;48;245;3138;9375;3186;9620
251675;202004;641;1837;578;1759;75;229;383;1180;458;1409
251680;202004;2491;6611;2071;6068;44;146;1671;4942;1715;5088
251690;202004;3098;8681;2608;7825;89;270;1953;5803;2042;6073
251700;202004;2056;5873;1726;5458;42;196;1467;4560;1509;4756
251710;202004;781;2026;529;1510;39;134;312;861;351;995
251720;202004;1295;3659;1040;3213;23;103;798;2391;821;2494
251740;202004;612;1715;490;1484;43;154;327;954;370;1108
260005;202004;29571;62353;24280;55562;1594;3609;18782;42185;20376;45794
260010;202004;10156;26674;8360;23751;450;1375;4993;14226;5443;15601
260020;202004;6704;15821;5733;14426;108;493;4843;11970;4951;12463
260030;202004;6710;17235;5646;15697;134;415;4589;12705;4723;13120
260040;202004;7555;19637;6296;17794;440;1208;4426;12739;4866;13947
260050;202004;13816;35929;11423;33277;143;669;10508;30606;10651;31275
260060;202004;3969;9939;3402;9016;186;460;2698;7152;2884;7612
260070;202004;10454;26298;8922;24085;328;1150;7195;18915;7523;20065
260080;202004;6499;14792;5669;13691;110;360;4776;11319;4886;11679
260090;202004;4637;11945;4104;11210;454;1267;2907;7948;3361;9215
260100;202004;3001;8101;2504;7367;53;267;2060;5955;2113;6222
260105;202004;4955;13553;4425;12850;125;444;3736;10719;3861;11163
260110;202004;22145;61211;19657;57593;927;3185;16202;46803;17129;49988
260120;202004;14307;38140;11977;34634;1417;4044;7657;22500;9074;26544
260130;202004;3061;7873;2731;7390;242;651;2000;5343;2242;5994
260140;202004;12867;29179;11067;27026;537;1473;9289;22353;9826;23826
260150;202004;3589;8295;3072;7658;85;249;2700;6663;2785;6912
260160;202004;6429;16889;5427;15665;85;317;4884;14239;4969;14556
260170;202004;19638;46793;16616;42691;870;2279;13306;33771;14176;36050
260180;202004;3465;9255;2996;8618;74;266;2571;7289;2645;7555
260190;202004;18138;36427;15227;32993;160;435;13511;28716;13671;29151
260200;202004;11097;26560;9527;24557;437;999;7959;20804;8396;21803
260210;202004;11804;33310;9977;30309;319;1217;7944;23971;8263;25188
260220;202004;10223;24714;9437;23716;165;551;8317;20591;8482;21142
260230;202004;10677;26188;9299;24347;195;644;7848;20183;8043;20827
260240;202004;2654;7969;2319;7324;108;380;1795;5617;1903;5997
260250;202004;2169;5727;1887;5285;121;280;1437;4025;1558;4305
260260;202004;12930;33578;11495;31361;368;1243;9132;24409;9500;25652
260270;202004;4207;10172;3689;9545;136;507;3082;7809;3218;8316
260280;202004;12663;38160;11341;36284;440;1913;9659;30466;10099;32379
260290;202004;40154;101676;34459;93406;3693;10212;23402;63222;27095;73434
260300;202004;9553;25815;8277;24079;191;865;6963;20194;7154;21059
260310;202004;5041;13005;4425;12207;295;774;3437;9606;3732;10380
260320;202004;7627;21910;6429;19867;254;813;5238;16187;5492;17000
260330;202004;2534;7765;2215;7115;64;243;1761;5506;1825;5749
260340;202004;2030;5419;1747;4994;29;130;1497;4186;1526;4316
260345;202004;24835;64481;20684;58405;3038;9185;11004;30554;14042;39739
260350;202004;5458;12961;4733;12115;70;204;4193;10683;4263;10887
260360;202004;2510;6533;2263;6081;46;200;1587;4155;1633;4355
260370;202004;5521;15804;4743;14491;232;807;3660;11091;3892;11898
260380;202004;4900;14514;4175;13322;143;529;3146;9897;3289;10426
260390;202004;4460;13335;3696;11761;210;662;2489;7774;2699;8436
260392;202004;3304;10654;2964;10218;117;695;2389;8240;2506;8935
260400;202004;17625;40958;15159;37718;473;1355;11912;28562;12385;29917
260410;202004;72127;175147;55684;152064;9832;28178;25178;70877;35010;99055
260415;202004;4488;12112;3874;11088;60;254;3171;8936;3231;9190
260420;202004;12662;26281;10718;24119;99;281;9937;22153;10036;22434
260430;202004;2696;8427;2317;7673;103;417;1659;5443;1762;5860
260440;202004;3688;9594;3252;8914;64;239;2732;7354;2796;7593
260450;202004;5698;14360;5095;13592;287;594;4200;11417;4487;12011
260460;202004;5189;15417;4411;14038;473;1673;2636;8247;3109;9920
260470;202004;4901;12969;4134;12072;81;199;3781;11207;3862;11406
260480;202004;3957;10526;3315;9601;211;771;2307;6679;2518;7450
260490;202004;5322;12227;4705;11318;34;141;4282;10116;4316;10257
260500;202004;6074;15245;5196;14007;451;1157;3650;9970;4101;11127
260510;202004;9642;23862;8053;21644;119;467;7103;18922;7222;19389
260515;202004;4139;11345;3218;9588;141;425;2166;6285;2307;6710
260520;202004;17085;39444;14889;36621;756;1838;12134;29450;12890;31288
260530;202004;9702;27748;8250;25500;149;721;7074;21556;7223;22277
260540;202004;7173;15510;6313;14418;151;350;5662;12844;5813;13194
260545;202004;52;160;22;81;2;7;8;23;10;30
260550;202004;3028;8386;2479;7486;114;472;1670;4925;1784;5397
260560;202004;5875;15056;4956;13734;122;484;4173;11325;4295;11809
260570;202004;7704;20922;6764;19643;375;1187;5325;15519;5700;16706
260580;202004;4440;10556;3989;9959;19;72;3671;9142;3690;9214
260590;202004;6670;15488;5599;14291;221;538;4665;12045;4886;12583
260600;202004;30657;79326;24814;70309;1097;3458;18740;52221;19837;55679
260610;202004;7237;18608;6464;17603;389;1139;4862;13147;5251;14286
260620;202004;16212;42028;14109;38986;1251;3906;10229;27685;11480;31591
260630;202004;2371;6398;1933;5696;34;144;1560;4499;1594;4643
260640;202004;21365;48375;17836;44314;840;2066;14318;35404;15158;37470
260650;202004;5980;15720;4741;14203;145;586;4064;12081;4209;12667
260660;202004;7012;18533;6046;17239;155;686;5174;14412;5329;15098
260670;202004;2153;5662;1805;5129;72;185;1335;3739;1407;3924
260680;202004;27961;66592;23440;60133;1630;4452;16555;41666;18185;46118
260690;202004;3481;9059;2895;8146;92;360;2272;6343;2364;6703
260700;202004;6069;17566;5669;17105;20;69;5485;16673;5505;16742
260710;202004;1336;3529;1153;3269;34;130;903;2557;937;2687
260720;202004;22726;57215;19784;53184;1877;5196;14411;38371;16288;43567
260730;202004;7543;21791;6582;20440;259;993;5475;16728;5734;17721
260740;202004;1325;3758;1115;3413;13;67;882;2772;895;2839
260750;202004;7007;19305;5833;17831;110;374;5217;16191;5327;16565
260760;202004;5639;13338;4835;12383;187;537;3974;10205;4161;10742
260765;202004;7954;22906;6908;21465;396;1679;4903;14890;5299;16569
260770;202004;3813;9714;3170;8652;112;360;2493;6715;2605;7075
260775;202004;5211;13837;4566;12853;185;686;3557;9669;3742;10355
260780;202004;3594;10652;3196;10012;277;1045;2063;6242;2340;7287
260790;202004;118802;265276;98009;238086;14832;34891;60628;147805;75460;182696
260795;202004;2981;7638;2551;7073;77;263;1995;5572;2072;5835
260800;202004;5369;12443;4782;11641;122;383;4190;9872;4312;10255
260805;202004;3611;10212;3035;9187;161;569;2268;6744;2429;7313
260810;202004;6475;17531;5668;15973;457;1230;4093;11294;4550;12524
260820;202004;4465;10365;3938;9740;100;359;3303;8027;3403;8386
260825;202004;2900;8637;2516;7967;105;379;1881;5875;1986;6254
260830;202004;4214;12216;3489;10887;450;1232;2230;7184;2680;8416
260840;202004;4158;10843;3707;10218;202;523;3079;8513;3281;9036
260845;202004;4277;11328;3805;10510;229;636;2854;7792;3083;8428
260850;202004;4969;13638;4124;12004;329;1036;2680;7544;3009;8580
260860;202004;3498;9838;2950;8890;102;361;2351;6903;2453;7264
260870;202004;4536;10888;3863;10062;70;269;3444;8842;3514;9111
260875;202004;7010;17240;5739;15375;560;1510;3887;10495;4447;12005
260880;202004;9716;27178;8404;24897;481;1453;6585;19475;7066;20928
260890;202004;12999;33316;11249;30641;587;1715;8227;21860;8814;23575
260900;202004;5381;14932;4413;13550;317;1041;2926;8959;3243;10000
260910;202004;3179;8621;2750;7966;89;294;2166;6224;2255;6518
260915;202004;5156;15089;4511;14337;49;266;4123;13102;4172;13368
260920;202004;3265;8096;2735;7524;88;239;2337;6486;2425;6725
260930;202004;3718;11655;3151;10637;176;714;2334;7692;2510;8406
260940;202004;14547;34676;12649;32034;955;2379;9544;23831;10499;26210
260950;202004;6820;18227;5483;15907;353;1197;3523;9789;3876;10986
260960;202004;69512;155052;55613;137136;6083;15444;35418;86241;41501;101685
260970;202004;5469;14454;4866;13640;218;500;3720;10531;3938;11031
260980;202004;4494;13128;3959;12452;51;192;3612;11462;3663;11654
260990;202004;17800;49216;15013;45418;840;2838;11656;34937;12496;37775
261000;202004;16139;37960;13517;34612;367;1324;10930;27302;11297;28626
261010;202004;2376;6205;2075;5807;73;191;1803;5071;1876;5262
261020;202004;6119;16573;5241;15053;185;693;4246;11718;4431;12411
261030;202004;4009;11547;3472;10629;127;524;2759;8202;2886;8726
261040;202004;5193;15156;4175;13204;148;600;3118;9623;3266;10223
261050;202004;7715;20116;7002;18990;437;877;5329;14555;5766;15432
261060;202004;14113;35234;12251;32970;268;880;10205;27201;10473;28081
261070;202004;63711;138485;52659;123907;2679;6315;40425;93035;43104;99350
261080;202004;6647;15978;6057;15234;131;330;5575;14002;5706;14332
261090;202004;18776;44743;16659;42001;286;999;14560;36116;14846;37115
261100;202004;8299;22959;7178;21296;496;1590;5231;15522;5727;17112
261110;202004;63633;177571;53000;158446;7644;24050;30726;91090;38370;115140
261120;202004;3693;9221;3178;8520;85;219;2738;7354;2823;7573
261130;202004;7299;17786;6399;16569;116;353;5663;14559;5779;14912
261140;202004;3640;8382;3236;7842;167;430;2591;6180;2758;6610
261150;202004;5302;13798;4677;12856;71;268;4069;11062;4140;11330
261153;202004;1875;5655;1593;5102;56;202;1085;3490;1141;3692
261160;202004;208165;482981;167670;426618;40715;106795;69622;180295;110337;287090
261170;202004;6001;14941;5324;13925;317;758;4246;11047;4563;11805
261180;202004;9536;23680;8325;22079;443;1158;6059;16129;6502;17287
261190;202004;4516;13235;4024;12410;190;818;3142;9385;3332;10203
261200;202004;3348;7727;2983;7234;126;331;2511;5973;2637;6304
261210;202004;1895;4561;1603;4147;59;176;1351;3428;1410;3604
261220;202004;13747;38748;11372;34340;1418;4655;6487;19260;7905;23915
261230;202004;4025;11521;3364;10600;52;211;2802;8900;2854;9111
261240;202004;5291;13237;4632;12200;241;646;3827;9936;4068;10582
261245;202004;3551;10074;2987;9076;71;342;2376;6990;2447;7332
261247;202004;2855;8558;2360;7668;142;515;1630;5264;1772;5779
261250;202004;22152;50618;19146;47103;1694;3740;14545;36703;16239;40443
261255;202004;4069;11961;3292;10446;139;625;2417;7418;2556;8043
261260;202004;12652;34111;10906;31833;348;1426;9363;26938;9711;28364
261270;202004;4382;10850;3825;10132;184;535;3180;8286;3364;8821
261280;202004;2556;7078;2244;6549;66;242;1794;5093;1860;5335
261290;202004;2957;7604;2476;7053;70;292;2006;5746;2076;6038
261300;202004;12147;34054;10218;30726;577;2067;7407;21813;7984;23880
261310;202004;8774;22279;7463;20482;628;1942;5477;14657;6105;16599
261320;202004;5924;16767;5160;15503;81;361;4335;12830;4416;13191
261330;202004;5837;14258;5250;13489;122;443;4567;11504;4689;11947
261340;202004;4198;11779;3617;11023;134;498;2979;8996;3113;9494
261350;202004;8770;25493;7771;23826;121;566;6340;19153;6461;19719
261360;202004;8151;19617;6888;17829;238;696;5489;13824;5727;14520
261370;202004;23425;58475;19669;53244;2087;5583;12731;34702;14818;40285
261380;202004;4038;12195;3550;11334;446;1503;2323;7311;2769;8814
261390;202004;16355;46434;13734;42175;1160;3913;9137;27828;10297;31741
261400;202004;4591;14560;3977;13238;161;729;2986;9689;3147;10418
261410;202004;9425;23534;7722;20891;466;1319;6038;15992;6504;17311
261420;202004;7346;21948;6604;21030;775;2848;4643;14698;5418;17546
261430;202004;3417;9613;2864;8742;61;268;2377;7141;2438;7409
261440;202004;1465;4346;1217;3863;36;176;875;2645;911;2821
261450;202004;14916;40229;13161;37493;188;690;10907;31116;11095;31806
261460;202004;7456;20604;6591;19243;199;709;5371;15556;5570;16265
261470;202004;4176;10362;3637;9652;24;126;3134;8289;3158;8415
261480;202004;5035;15425;4327;14233;189;785;3355;10794;3544;11579
261485;202004;4942;14028;4250;12943;336;1110;3034;9087;3370;10197
261500;202004;5871;15000;5138;14002;382;930;3594;10159;3976;11089
261510;202004;1861;5551;1609;5132;61;229;1207;3898;1268;4127
261520;202004;2333;7165;2094;6668;69;251;1532;4857;1601;5108
261530;202004;11850;34690;9581;30490;899;3438;4844;14822;5743;18260
261540;202004;8145;23245;7310;22036;1059;3159;4166;13236;5225;16395
261550;202004;3630;9627;3131;8840;218;666;2242;6201;2460;6867
261560;202004;7806;23098;6743;21514;283;1077;5190;16560;5473;17637
261570;202004;3508;9379;2796;8236;195;687;1930;5564;2125;6251
261580;202004;6679;17558;5746;16291;111;539;5136;14339;5247;14878
261590;202004;2669;6816;2128;6046;69;223;1611;4545;1680;4768
261600;202004;5060;12826;4243;11593;301;738;2967;8332;3268;9070
261610;202004;2191;6168;1761;5390;95;350;1204;3648;1299;3998
261618;202004;2516;6282;2190;5804;60;175;1782;4683;1842;4858
261620;202004;4146;11620;3780;11088;840;2181;2342;7260;3182;9441
261630;202004;6313;17663;5336;15808;362;1287;3586;10191;3948;11478
261640;202004;37326;83472;31684;76470;1795;3467;23948;59519;25743;62986
261650;202004;4125;10196;3509;9376;147;472;2637;6980;2784;7452
270010;202004;4279;14347;3674;13304;166;938;2907;10226;3073;11164
270020;202004;3841;9637;3345;8994;128;443;2856;7502;2984;7945
270030;202004;33174;89804;27539;80736;3584;10244;18265;53708;21849;63952
270040;202004;10800;28993;9250;27162;361;1377;7676;22327;8037;23704
270050;202004;5518;12753;4694;11822;208;511;4115;10401;4323;10912
270060;202004;2099;5298;1740;4892;149;367;1379;3937;1528;4304
270070;202004;4644;13026;4040;12171;142;530;3383;10007;3525;10537
270080;202004;1430;3891;1189;3489;42;129;915;2579;957;2708
270090;202004;1753;5358;1569;4999;65;274;1284;3982;1349;4256
270100;202004;5469;14423;4706;13301;149;578;3919;10861;4068;11439
270110;202004;3217;7539;2583;6797;130;318;2068;5664;2198;5982
270120;202004;2766;7502;2387;6996;69;306;2015;5800;2084;6106
270130;202004;5087;13031;4392;12202;122;390;3789;10542;3911;10932
270135;202004;2016;4822;1701;4472;51;163;1535;4014;1586;4177
270140;202004;9664;22413;7717;19723;309;1070;6100;14855;6409;15925
270150;202004;2689;8086;2461;7757;3;22;2321;7293;2324;7315
270160;202004;6162;16742;5197;15653;58;325;4815;14465;4873;14790
270170;202004;3367;9835;2832;9085;180;860;2147;6588;2327;7448
270180;202004;2216;6860;2016;6601;39;194;1814;5893;1853;6087
270190;202004;1636;4867;1441;4624;38;192;1261;4007;1299;4199
270200;202004;2384;7218;2067;6788;112;428;1523;4959;1635;5387
270210;202004;5725;13471;4870;12514;78;324;4472;11309;4550;11633
270220;202004;1457;3827;1154;3398;186;573;678;1956;864;2529
270230;202004;9191;25557;7549;23003;628;2133;5374;16191;6002;18324
270235;202004;5642;17338;4855;16076;115;525;4002;13109;4117;13634
270240;202004;10487;28833;8427;25950;908;3047;5899;18175;6807;21222
270250;202004;2713;6884;2368;6385;184;483;1862;5024;2046;5507
270255;202004;4437;12673;3431;10822;109;450;2619;8129;2728;8579
270260;202004;5579;16378;5049;15502;99;506;4420;13251;4519;13757
270270;202004;1043;2693;859;2464;100;299;631;1790;731;2089
270280;202004;3947;9355;3115;8311;486;792;2171;6257;2657;7049
270290;202004;7400;23544;6614;22231;180;863;5731;19045;5911;19908
270300;202004;4139;10730;3208;9727;147;402;2504;7774;2651;8176
270310;202004;6909;19322;5920;17792;101;536;5037;14748;5138;15284
270320;202004;5514;16130;4785;14722;433;1382;3379;10138;3812;11520
270330;202004;3835;12548;3403;11887;260;1054;2603;9046;2863;10100
270340;202004;1597;4317;1379;4027;47;148;1169;3368;1216;3516
270350;202004;1830;4366;1498;3970;140;424;1061;2814;1201;3238
270360;202004;2575;6504;2291;6183;66;159;2110;5712;2176;5871
270370;202004;1333;4187;1216;3962;36;173;1012;3247;1048;3420
270375;202004;3091;7222;2554;6629;17;45;2395;6244;2412;6289
270380;202004;5420;15330;4552;14199;620;1892;2941;9531;3561;11423
270390;202004;1203;3021;980;2765;23;93;805;2268;828;2361
270400;202004;6188;16298;5174;14749;238;690;4036;11405;4274;12095
270410;202004;4579;13176;3948;12193;151;537;3276;10072;3427;10609
270420;202004;5494;16250;4929;15423;125;606;4270;13101;4395;13707
270430;202004;133295;316228;104545;279414;20777;57784;49732;135062;70509;192846
270440;202004;4708;12690;4049;11877;88;384;3519;10179;3607;10563
270450;202004;6930;18672;6074;17640;248;866;5103;14878;5351;15744
270460;202004;3792;8359;3257;7726;152;312;2922;6948;3074;7260
270470;202004;11000;30635;9520;28512;649;2155;7322;21893;7971;24048
270480;202004;2938;7793;2474;7122;96;381;2015;5665;2111;6046
270490;202004;943;2606;815;2450;47;157;656;1953;703;2110
270500;202004;4850;14885;4287;13947;285;1078;3329;10682;3614;11760
270510;202004;5564;14712;4683;13591;332;1326;3499;9664;3831;10990
270520;202004;3824;10959;2997;9531;633;2090;1230;4056;1863;6146
270530;202004;1231;3524;1050;3249;49;147;751;2356;800;2503
270540;202004;2197;6338;1890;5941;59;280;1633;5031;1692;5311
270550;202004;6669;17148;5293;15647;574;1383;3979;12222;4553;13605
270560;202004;2933;7637;2524;7087;133;430;2030;5643;2163;6073
270570;202004;4075;11408;3434;10452;110;368;2792;8442;2902;8810
270580;202004;2252;6372;2040;6061;94;280;1766;5206;1860;5486
270590;202004;1591;4798;1463;4632;16;81;1378;4335;1394;4416
270600;202004;2732;8426;2469;8033;48;250;2189;7030;2237;7280
270610;202004;3618;9483;3114;8817;67;258;2791;7821;2858;8079
270620;202004;1199;3694;1091;3479;34;152;930;2874;964;3026
270630;202004;17436;42470;14934;39018;564;1817;12583;32143;13147;33960
270640;202004;5341;15370;4607;14185;161;667;3752;11304;3913;11971
270642;202004;2508;8034;2216;7550;157;687;1700;5646;1857;6333
270644;202004;3590;8939;2936;8084;275;675;2198;6215;2473;6890
270650;202004;3097;9103;2710;8550;355;1217;1906;5948;2261;7165
270660;202004;2018;5111;1674;4616;79;300;1254;3404;1333;3704
270670;202004;16145;37140;13329;33673;393;1212;11336;28021;11729;29233
270680;202004;5396;13020;4786;12352;116;167;4472;11704;4588;11871
270690;202004;8904;21980;7396;20098;520;1366;5764;15685;6284;17051
270700;202004;511;1532;446;1422;31;126;322;1007;353;1133
270710;202004;5422;16348;4789;15372;220;953;3854;12132;4074;13085
270720;202004;3525;10419;3102;9704;65;350;2721;8352;2786;8702
270730;202004;8099;17922;7056;16802;231;471;5568;14662;5799;15133
270740;202004;2354;6153;2070;5818;91;315;1723;4761;1814;5076
270750;202004;5639;14893;4921;13972;85;394;4361;12306;4446;12700
270760;202004;3254;9187;2812;8590;52;269;2388;7205;2440;7474
270770;202004;20448;49795;16242;44674;2513;6249;10217;29645;12730;35894
270780;202004;1690;4880;1550;4677;90;338;1270;3763;1360;4101
270790;202004;1566;4366;1302;3994;98;318;944;2879;1042;3197
270800;202004;10661;29338;9536;27734;336;1231;8177;23401;8513;24632
270810;202004;3285;9380;2582;8177;174;673;1806;5612;1980;6285
270820;202004;1635;4891;1375;4470;53;258;1079;3413;1132;3671
270830;202004;5166;12269;4161;11039;165;550;3378;8813;3543;9363
270840;202004;8162;24302;7257;23015;172;965;6368;19668;6540;20633
270850;202004;8990;21311;7931;20039;634;1856;6551;16239;7185;18095
270860;202004;14112;31377;11137;27964;583;1379;9013;22595;9596;23974
270870;202004;2135;6025;1757;5407;243;728;1145;3610;1388;4338
270880;202004;8057;24063;7160;22707;221;946;5926;18454;6147;19400
270890;202004;2768;7501;2322;6861;175;540;1626;4794;1801;5334
270895;202004;3046;9447;2764;9075;73;398;2435;7832;2508;8230
270900;202004;1783;4589;1338;3870;38;111;1043;2995;1081;3106
270910;202004;3873;11184;3316;10301;92;319;2699;8292;2791;8611
270915;202004;9282;26655;7498;23704;643;2384;5123;15806;5766;18190
270920;202004;5031;15755;4540;14902;162;794;3725;11824;3887;12618
270930;202004;17019;39599;13145;35089;1838;4469;8887;24803;10725;29272
270940;202004;6456;17010;5490;15851;184;890;4467;12520;4651;13410
280010;202004;677;1877;531;1559;15;59;375;991;390;1050
280020;202004;4790;12122;4069;10988;475;1171;2734;7498;3209;8669
280030;202004;73677;173290;57781;150658;12177;32091;25826;70187;38003;102278
280040;202004;2899;8124;2524;7539;246;781;1696;5011;1942;5792
280050;202004;3815;10839;3271;9971;542;1727;1948;5922;2490;7649
280060;202004;5720;15076;4559;13270;864;2644;2153;6524;3017;9168
280067;202004;6808;16876;5777;15328;311;843;4245;11085;4556;11928
280070;202004;1920;5643;1783;5424;126;393;1470;4441;1596;4834
280100;202004;3953;10552;3318;9531;311;926;2280;6541;2591;7467
280110;202004;1380;3737;1200;3469;18;86;1053;2965;1071;3051
280120;202004;7547;21778;6719;20439;742;2105;4913;15305;5655;17410
280130;202004;9105;21277;7961;19640;420;1117;6425;15721;6845;16838
280140;202004;5402;12927;4745;12054;194;578;4037;10136;4231;10714
280150;202004;4158;10483;3592;9704;306;783;2779;7519;3085;8302
280160;202004;1211;3445;1008;3104;91;311;700;2099;791;2410
280170;202004;5181;13635;4623;12894;227;628;3734;10420;3961;11048
280190;202004;1263;2795;1094;2570;55;141;891;2048;946;2189
280200;202004;1264;3304;1036;2977;81;295;761;2136;842;2431
280210;202004;16262;40763;14102;37664;1485;4154;9139;24341;10624;28495
280220;202004;1746;4675;1494;4334;45;216;1231;3531;1276;3747
280230;202004;4208;10630;3540;9642;278;672;2545;6974;2823;7646
280240;202004;3296;8796;2948;8264;53;277;2535;6881;2588;7158
280250;202004;878;2161;710;1906;69;205;470;1220;539;1425
280260;202004;2152;5250;1911;4957;34;97;1738;4548;1772;4645
280270;202004;2316;6380;2043;5956;113;369;1692;4855;1805;5224
280280;202004;4186;12389;3708;11683;479;1300;2610;8608;3089;9908
280290;202004;17996;47513;15395;43836;1340;4087;10321;29602;11661;33689
280300;202004;11677;28505;10153;26860;283;828;7674;22102;7957;22930
280310;202004;1383;3542;1138;3124;33;119;861;2289;894;2408
280320;202004;8582;23136;7445;21427;896;2579;4982;14206;5878;16785
280330;202004;4619;11442;3908;10451;257;719;2877;7636;3134;8355
280340;202004;5441;11386;4538;10409;205;364;3959;9243;4164;9607
280350;202004;25700;60241;22468;55955;1098;2959;17682;43279;18780;46238
280360;202004;5738;15757;4980;14494;748;2222;2928;8647;3676;10869
280370;202004;2113;5239;1764;4658;56;161;1403;3633;1459;3794
280380;202004;963;2599;821;2404;71;206;564;1677;635;1883
280390;202004;3645;8976;3038;8015;132;348;2440;6374;2572;6722
280400;202004;3871;9801;3330;9042;510;1227;2030;5819;2540;7046
280410;202004;2229;6154;1793;5442;196;613;1040;3095;1236;3708
280420;202004;4282;11449;3925;10995;72;283;3602;10023;3674;10306
280430;202004;2049;4971;1785;4625;68;267;1449;3623;1517;3890
280440;202004;4193;11231;3664;10453;144;494;3082;8596;3226;9090
280445;202004;2290;5798;2036;5355;49;154;1548;3906;1597;4060
280450;202004;10255;23614;8945;21845;975;1993;6180;15690;7155;17683
280460;202004;6850;16247;6189;15321;332;803;5276;12911;5608;13714
280470;202004;1684;4766;1449;4344;61;217;1075;3139;1136;3356
280480;202004;42341;102899;36434;94478;2939;8251;25906;65721;28845;73972
280490;202004;3633;10305;3141;9470;87;385;2459;7173;2546;7558
280500;202004;990;2384;847;2191;34;123;712;1800;746;1923
280510;202004;2510;6419;2172;5936;70;280;1700;4516;1770;4796
280520;202004;1589;4059;1390;3785;58;163;1121;3008;1179;3171
280530;202004;2441;6098;2094;5612;289;647;1465;4053;1754;4700
280540;202004;8917;23918;8087;22691;265;921;7067;19540;7332;20461
280550;202004;6575;15318;5386;13635;190;674;4420;10798;4610;11472
280560;202004;7093;19804;6619;19090;132;522;5838;16633;5970;17155
280570;202004;6440;15611;5220;14067;209;661;3936;10521;4145;11182
280580;202004;5557;14861;4792;13710;568;1467;3352;9774;3920;11241
280590;202004;2911;6543;2475;6046;108;406;1969;4608;2077;5014
280600;202004;3567;9420;3135;8811;167;533;2253;6330;2420;6863
280610;202004;2432;5991;2190;5627;139;355;1801;4599;1940;4954
280620;202004;5348;13134;4570;12109;402;887;3218;8884;3620;9771
280630;202004;3774;10634;3446;10167;166;610;2832;8251;2998;8861
280640;202004;2358;6334;2077;6010;56;182;1845;5335;1901;5517
280650;202004;1171;3082;941;2735;83;291;695;1931;778;2222
280660;202004;3699;8093;3156;7446;210;395;2620;6298;2830;6693
280670;202004;19634;44124;16891;40626;905;2284;13512;32261;14417;34545
280680;202004;2785;6647;2378;6074;224;416;1718;4463;1942;4879
280690;202004;936;2314;790;2119;45;111;620;1641;665;1752
280700;202004;1163;2917;1005;2680;25;99;796;2080;821;2179
280710;202004;15237;34274;12853;31567;497;950;10922;27528;11419;28478
280720;202004;2616;5962;2168;5435;60;188;1569;4081;1629;4269
280730;202004;1045;2684;938;2507;39;126;726;1873;765;1999
280740;202004;14037;34183;11920;30955;715;2030;8608;21790;9323;23820
280750;202004;3569;9988;3101;9184;177;611;2229;6463;2406;7074
280760;202004;6307;16859;5478;15563;555;1429;3667;10765;4222;12194
290010;202004;3170;6644;2063;4918;4;13;1688;3848;1692;3861
290020;202004;5375;14257;4859;13591;336;643;4087;11840;4423;12483
290030;202004;4481;10326;3597;9352;157;382;3057;8027;3214;8409
290035;202004;5085;11124;4205;9981;369;559;3322;8255;3691;8814
290040;202004;4171;10217;3543;9453;108;290;2809;7854;2917;8144
290050;202004;2014;6489;1690;5786;117;482;1134;3777;1251;4259
290060;202004;1320;3175;966;2609;76;241;628;1675;704;1916
290070;202004;36978;80684;31665;74060;1730;4227;24683;57101;26413;61328
290080;202004;5308;15498;4541;14344;455;1556;3178;10121;3633;11677
290090;202004;2154;4131;1511;3446;17;60;1378;3110;1395;3170
290100;202004;9768;25461;7885;22617;1291;3471;4268;12858;5559;16329
290110;202004;5226;13735;4624;12790;328;933;3339;9137;3667;10070
290115;202004;3901;11298;3270;10163;217;745;2433;7501;2650;8246
290120;202004;6444;15936;5424;14528;138;476;4641;12223;4779;12699
290130;202004;4729;11426;3677;10060;163;471;2854;7783;3017;8254
290135;202004;4206;9895;3424;8611;192;487;2649;6486;2841;6973
290140;202004;4539;11853;3466;10415;99;369;2912;8695;3011;9064
290150;202004;2452;6326;2109;5901;134;371;1639;4615;1773;4986
290160;202004;3293;7601;2903;7060;277;584;2262;5547;2539;6131
290170;202004;3386;8511;2981;8066;112;308;2657;7254;2769;7562
290180;202004;2948;8084;2433;7236;82;295;1983;5853;2065;6148
290190;202004;4182;11835;3661;11135;138;592;3011;9015;3149;9607
290195;202004;2355;5808;1874;5173;27;136;1584;4331;1611;4467
290200;202004;4091;11357;3316;10065;184;617;2500;7514;2684;8131
290205;202004;3422;8837;3000;8196;125;447;2341;6168;2466;6615
290210;202004;12973;36053;11466;33759;874;2353;8822;26418;9696;28771
290220;202004;2850;7098;2495;6639;123;341;2039;5404;2162;5745
290225;202004;3235;6885;2484;6089;159;281;2064;5168;2223;5449
290230;202004;2438;6442;2217;6176;30;94;2001;5566;2031;5660
290240;202004;3710;9361;2944;8375;69;252;2481;7044;2550;7296
290250;202004;3912;11468;3269;10506;104;358;2698;8792;2802;9150
290260;202004;5277;13101;4367;11771;164;572;3609;9482;3773;10054
290265;202004;3423;10054;2769;8786;179;609;1991;6280;2170;6889
290270;202004;11049;37410;10304;36134;526;2306;8300;28819;8826;31125
290280;202004;5964;17889;5162;16306;286;1036;3744;11651;4030;12687
290290;202004;9864;28678;7946;25117;784;2685;5198;16214;5982;18899
290300;202004;4228;11465;3102;9330;157;518;2227;6664;2384;7182
290310;202004;1579;3885;1245;3476;55;232;963;2603;1018;2835
290320;202004;24161;63016;18984;55016;4159;11869;9044;27629;13203;39498
290323;202004;3783;10276;3278;9488;105;333;2592;7470;2697;7803
290327;202004;4092;11911;3472;10694;244;700;2482;7616;2726;8316
290330;202004;2198;4616;1704;4083;47;85;1510;3677;1557;3762
290340;202004;5707;14253;4384;12616;434;1293;3166;9243;3600;10536
290350;202004;4691;12983;3867;11586;270;829;2778;8365;3048;9194
290360;202004;5002;13176;4383;12365;128;370;3787;10757;3915;11127
290370;202004;5230;12741;3830;10885;155;407;2773;8045;2928;8452
290380;202004;5560;14814;4671;13597;111;270;4017;11921;4128;12191
290390;202004;14567;41202;12045;37223;1291;3923;7858;24698;9149;28621
290395;202004;2815;8167;2255;7182;65;314;1731;5411;1796;5725
290400;202004;3759;10074;3000;8823;81;347;2298;6574;2379;6921
290405;202004;4617;13467;3932;12275;293;953;2702;8612;2995;9565
290410;202004;5715;15585;4371;13403;106;507;3306;9846;3412;10353
290420;202004;2972;8302;2455;7482;69;250;1893;5718;1962;5968
290430;202004;3132;8584;2568;7710;220;696;1742;5160;1962;5856
290440;202004;2832;7090;2002;5784;41;120;1397;4133;1438;4253
290450;202004;3444;8814;2685;7664;140;404;1975;5703;2115;6107
290460;202004;11545;32458;9665;28870;1937;5879;4379;13034;6316;18913
290470;202004;4567;11214;3345;9513;391;1221;1893;5466;2284;6687
290475;202004;6395;18630;5377;16813;99;537;4378;13392;4477;13929
290480;202004;1794;4537;1466;4050;81;275;1013;2671;1094;2946
290485;202004;4501;13135;3971;12391;102;528;3394;10405;3496;10933
290490;202004;9249;21625;8248;20261;500;1113;6449;16093;6949;17206
290500;202004;3981;11925;3048;9895;541;1829;1341;4232;1882;6061
290510;202004;3481;8656;2887;7882;74;248;2491;6759;2565;7007
290515;202004;3647;10078;3147;9401;44;132;2826;8594;2870;8726
290520;202004;11549;32771;8879;27600;591;1985;5400;16558;5991;18543
290530;202004;4959;14133;4162;12828;133;503;3510;10777;3643;11280
290540;202004;3379;8876;3007;8446;50;166;2775;7768;2825;7934
290550;202004;4297;11238;3708;10539;10;54;3411;9812;3421;9866
290560;202004;6458;16644;4878;14291;418;1506;3192;9049;3610;10555
290570;202004;44741;109446;39520;102789;2446;6551;31748;82024;34194;88575
290580;202004;7793;22656;6692;21044;599;1847;4901;15783;5500;17630
290590;202004;7071;21717;5952;19711;143;590;4803;15978;4946;16568
290600;202004;18775;52165;16521;48467;675;2090;13306;38952;13981;41042
290610;202004;2549;7963;1977;6788;98;407;1380;4685;1478;5092
290620;202004;6381;17873;5499;16419;198;570;4620;13770;4818;14340
290630;202004;9252;22344;7320;19845;550;1489;5646;15424;6196;16913
290640;202004;2751;7112;2105;6168;79;240;1541;4568;1620;4808
290650;202004;13060;32352;11519;30610;2546;6474;7111;19789;9657;26263
290660;202004;3636;9317;3022;8421;50;141;2287;6583;2337;6724
290670;202004;6690;18500;5622;16726;372;1055;4292;12920;4664;13975
290680;202004;10794;29900;9039;27283;195;1055;7473;22053;7668;23108
290682;202004;4759;12332;4107;11463;125;299;3471;9794;3596;10093
290685;202004;3445;7768;2459;6342;203;487;1526;4202;1729;4689
290687;202004;6606;17764;5338;15673;711;2004;3398;10239;4109;12243
290689;202004;2829;7864;2167;6633;203;677;1477;4488;1680;5165
290690;202004;5554;14346;4483;12831;305;945;3243;9143;3548;10088
290700;202004;2622;7156;2301;6749;71;240;1930;5681;2001;5921
290710;202004;8267;23307;7069;21637;153;623;5968;18293;6121;18916
290720;202004;18418;50231;16714;47640;926;2941;13403;37728;14329;40669
290730;202004;7033;16710;5973;15476;289;598;4730;12438;5019;13036
290740;202004;1022;2771;789;2389;34;124;652;1967;686;2091
290750;202004;11127;27646;9603;25189;636;1796;7113;18112;7749;19908
290755;202004;2093;5892;1673;5118;92;288;1161;3579;1253;3867
290760;202004;3729;10840;2994;9436;187;557;2031;6585;2218;7142
290770;202004;2609;8396;2386;8111;52;259;1991;6839;2043;7098
290780;202004;8210;20268;7075;18768;271;605;5548;15057;5819;15662
290790;202004;4637;12794;4026;11937;151;447;3353;10072;3504;10519
290800;202004;7125;14753;5029;12279;291;686;3735;9192;4026;9878
290810;202004;5399;14122;4310;12514;110;355;3250;9639;3360;9994
290820;202004;4852;13110;4341;12370;183;525;3271;9457;3454;9982
290830;202004;4465;10141;3954;9503;28;80;3485;8276;3513;8356
290840;202004;16994;44884;14559;41116;1874;4351;9396;28186;11270;32537
290850;202004;6674;16005;5965;15241;207;518;5104;13175;5311;13693
290860;202004;6142;17570;5341;16639;217;717;4496;14297;4713;15014
290870;202004;4740;13051;3570;10815;143;462;2526;7598;2669;8060
290880;202004;1380;3452;1100;3084;71;180;765;2231;836;2411
290890;202004;9292;18684;8321;17591;153;334;7805;16428;7958;16762
290900;202004;2316;6104;1744;5096;98;259;1101;3188;1199;3447
290910;202004;5106;12279;3894;10437;46;155;3298;8757;3344;8912
290920;202004;5001;12788;4557;12268;43;96;4299;11687;4342;11783
290930;202004;7617;21232;6073;18522;193;826;4751;14121;4944;14947
290940;202004;3665;10297;3004;9329;154;583;2413;7482;2567;8065
290950;202004;1444;3629;1174;3227;61;176;831;2289;892;2465
290960;202004;5475;14341;4895;13611;177;449;4133;11548;4310;11997
290970;202004;3357;9840;2729;8700;107;393;2094;6674;2201;7067
290980;202004;12153;29080;10149;25990;797;2227;6323;15724;7120;17951
290990;202004;9516;25388;8369;23515;250;1032;7022;19049;7272;20081
291000;202004;3379;8801;2612;7829;108;348;2144;6488;2252;6836
291005;202004;15251;37458;13403;35033;1199;2891;10454;27512;11653;30403
291010;202004;2977;9058;2399;7826;106;408;1580;5018;1686;5426
291020;202004;1248;3085;996;2635;22;74;724;1807;746;1881
291030;202004;2499;6065;1727;4730;110;278;1073;2858;1183;3136
291040;202004;5377;14773;4471;13485;155;610;3512;10550;3667;11160
291050;202004;7663;19941;6529;18367;631;2000;4754;13101;5385;15101
291060;202004;5945;18163;5040;16947;314;1372;3828;12790;4142;14162
291070;202004;15784;42435;13109;38141;414;1471;10711;30965;11125;32436
291072;202004;24731;63287;17683;51088;3226;9631;7507;21960;10733;31591
291075;202004;5371;13268;4803;12385;104;281;4005;10138;4109;10419
291077;202004;1573;4108;1218;3487;51;121;854;2438;905;2559
291080;202004;98825;247818;77196;217423;23483;67626;21373;64748;44856;132374
291085;202004;5621;14172;4719;12790;189;576;3924;10595;4113;11171
291090;202004;2014;3796;1449;3162;44;99;1169;2507;1213;2606
291100;202004;3209;6988;2194;5775;101;277;1677;4371;1778;4648
291110;202004;5941;17608;5018;16023;316;1303;3803;11692;4119;12995
291120;202004;7590;18478;6382;16934;300;865;4914;13005;5214;13870
291125;202004;2169;3816;1623;3210;102;153;1302;2642;1404;2795
291130;202004;3234;9182;2361;7446;64;292;1746;5341;1810;5633
291140;202004;4816;13016;3495;10601;441;1171;2152;6575;2593;7746
291150;202004;2480;5373;1905;4723;6;22;1796;4442;1802;4464
291160;202004;5123;13928;4220;12626;372;1180;2821;8372;3193;9552
291165;202004;2107;5750;1594;4757;31;135;1168;3376;1199;3511
291170;202004;20854;52880;17337;46872;916;2726;11437;30426;12353;33152
291180;202004;6248;14491;4538;12177;263;687;3492;9377;3755;10064
291185;202004;3087;8285;2696;7647;88;272;2078;5909;2166;6181
291190;202004;7605;18664;6239;16901;293;925;4923;13287;5216;14212
291200;202004;2739;7535;2024;6186;93;294;1240;3658;1333;3952
291210;202004;6978;14973;5214;12947;134;436;3901;9725;4035;10161
291220;202004;4074;11548;3654;10913;182;667;2894;8524;3076;9191
291230;202004;4461;9564;3361;8361;36;97;3026;7599;3062;7696
291240;202004;4220;10769;3615;9761;64;222;3100;8244;3164;8466
291250;202004;3404;10008;2633;8593;156;503;1702;5569;1858;6072
291260;202004;1413;3323;1160;2997;30;94;950;2468;980;2562
291270;202004;5392;13893;4151;12061;633;1830;2575;7664;3208;9494
291280;202004;2524;6216;1872;5263;127;402;1235;3379;1362;3781
291290;202004;5853;15324;4501;13217;334;1061;3102;9028;3436;10089
291300;202004;3824;10283;2952;8853;111;411;2253;6647;2364;7058
291310;202004;5109;13557;4342;12162;115;373;3670;10133;3785;10506
291320;202004;6126;16958;4743;14372;1060;3007;2331;7507;3391;10514
291330;202004;1773;4470;1461;3959;80;211;1090;2922;1170;3133
291340;202004;4264;11020;3433;9568;79;251;2619;7164;2698;7415
291345;202004;2944;8804;2669;8373;111;391;2239;7026;2350;7417
291350;202004;6823;16892;5290;15025;61;201;4583;13263;4644;13464
291360;202004;37599;85543;29326;75554;2732;7207;19206;50514;21938;57721
291370;202004;7844;21574;6910;20138;496;1553;5129;14680;5625;16233
291380;202004;3394;9252;2973;8671;102;420;2465;7146;2567;7566
291390;202004;13175;28275;10186;24958;426;1036;8435;20651;8861;21687
291400;202004;13786;35243;11313;31504;1532;3732;6712;20166;8244;23898
291410;202004;2848;7547;2197;6429;32;141;1640;4715;1672;4856
291420;202004;1903;4706;1471;4169;33;132;1272;3596;1305;3728
291430;202004;2739;7774;2358;7144;85;380;1893;5552;1978;5932
291440;202004;6335;18196;5441;16721;315;1048;4253;13055;4568;14103
291450;202004;9204;22766;7557;20876;77;132;6618;18915;6695;19047
291460;202004;15477;40976;13525;38064;658;2098;10249;28619;10907;30717
291465;202004;9264;22854;7260;20561;141;642;6253;17583;6394;18225
291470;202004;16421;36888;13646;33753;710;1547;10143;25845;10853;27392
291480;202004;41520;91909;30375;76617;3535;9234;16061;40554;19596;49788
291490;202004;5620;13904;4833;13004;138;442;4357;11657;4495;12099
291500;202004;4980;12183;4123;11038;71;317;3746;9968;3817;10285
291510;202004;4280;10563;3173;9169;51;292;2645;7574;2696;7866
291520;202004;4568;10351;3429;8843;182;501;2628;6718;2810;7219
291530;202004;2265;5221;1585;4322;299;745;913;2726;1212;3471
291535;202004;3430;9986;3036;9289;171;471;2338;7312;2509;7783
291540;202004;2294;5102;1570;4231;64;225;1290;3411;1354;3636
291550;202004;5651;12911;4387;11304;382;826;2998;7903;3380;8729
291560;202004;18680;43939;13360;36890;1291;3440;8016;23017;9307;26457
291570;202004;2411;5727;1891;5086;58;158;1546;4324;1604;4482
291580;202004;6272;16171;4926;14351;209;683;3679;10628;3888;11311
291590;202004;2077;5111;1792;4779;71;264;1580;4121;1651;4385
291600;202004;5545;12793;4246;10797;384;1040;2883;7098;3267;8138
291610;202004;5666;14820;5082;14170;80;301;4657;12964;4737;13265
291620;202004;3172;7022;2329;6098;105;269;1816;4847;1921;5116
291630;202004;3258;7372;2415;6256;279;801;1686;4278;1965;5079
291640;202004;15634;38674;11761;33048;1691;4626;5300;15494;6991;20120
291650;202004;9524;23612;8390;22261;563;1057;7068;19236;7631;20293
291660;202004;2063;5067;1492;4183;131;446;968;2547;1099;2993
291670;202004;2070;5429;1745;4961;101;249;1315;3798;1416;4047
291680;202004;4127;10134;3335;8981;292;801;2353;6309;2645;7110
291685;202004;4676;11142;3733;9936;225;469;2831;7823;3056;8292
291690;202004;4181;9223;2869;7309;224;464;2190;5617;2414;6081
291700;202004;8554;24766;7489;22881;316;1182;6100;18278;6416;19460
291710;202004;5334;12623;3912;10625;214;674;2850;7591;3064;8265
291720;202004;4449;13522;3691;11997;388;1347;2432;7731;2820;9078
291730;202004;6392;16243;5478;15048;266;812;4530;12367;4796;13179
291733;202004;2892;7336;2427;6719;58;166;1769;5139;1827;5305
291735;202004;2900;7615;2291;6532;75;182;1748;4951;1823;5133
291740;202004;3868;9978;2866;8124;89;239;2065;5749;2154;5988
291750;202004;19429;46260;15764;40891;1507;3824;10690;28028;12197;31852
291760;202004;10303;29638;8026;25956;2430;8903;2200;7093;4630;15996
291770;202004;7040;18902;5858;16866;352;1091;4391;12320;4743;13411
291780;202004;5122;13585;4606;12853;83;316;4047;11172;4130;11488
291790;202004;2697;7517;2441;7192;227;581;1836;5575;2063;6156
291800;202004;29050;73053;21499;61733;3365;9389;10535;31458;13900;40847
291810;202004;10565;25065;8795;22897;256;665;7516;19650;7772;20315
291820;202004;3795;9986;3276;9315;92;307;2627;7491;2719;7798
291830;202004;4429;10466;3614;9376;183;424;2880;7492;3063;7916
291835;202004;6471;19319;5061;16597;531;1867;3216;10677;3747;12544
291840;202004;47824;130591;41248;120363;4315;13432;28881;83789;33196;97221
291845;202004;2494;6453;1945;5773;107;342;1568;4702;1675;5044
291850;202004;3913;11155;3205;9969;257;758;2285;7292;2542;8050
291855;202004;2187;4302;1693;3755;42;99;1531;3402;1573;3501
291860;202004;2228;5802;1544;4481;44;125;1050;2934;1094;3059
291870;202004;1282;3210;854;2475;47;136;579;1648;626;1784
291875;202004;2878;8622;2475;7782;64;265;1827;5578;1891;5843
291880;202004;5632;15816;4757;14334;220;639;3558;10765;3778;11404
291890;202004;1651;3376;1058;2686;127;303;712;1805;839;2108
291900;202004;1216;2938;924;2483;24;92;729;1906;753;1998
291905;202004;2498;6314;2019;5553;78;281;1535;4069;1613;4350
291910;202004;2925;7398;2487;6875;49;175;2151;6055;2200;6230
291915;202004;7343;20765;5975;18441;225;785;4543;14193;4768;14978
291920;202004;26607;68807;22375;62894;2159;6597;15503;42779;17662;49376
291930;202004;2505;6770;2140;6255;235;699;1430;4222;1665;4921
291940;202004;3900;9908;2594;7681;194;573;1523;4493;1717;5066
291950;202004;9200;27605;7811;24922;289;1086;5440;17136;5729;18222
291955;202004;15614;39151;13870;36904;1172;3259;10818;28862;11990;32121
291960;202004;3044;8050;2519;7326;122;364;1968;5849;2090;6213
291970;202004;4524;11364;3772;10418;140;481;2851;7879;2991;8360
291980;202004;9640;27568;7577;23952;890;2648;4700;15190;5590;17838
291990;202004;2297;5916;1882;5418;29;126;1747;5024;1776;5150
291992;202004;3927;9482;3106;8420;222;518;2460;6797;2682;7315
291995;202004;2062;5712;1690;5113;50;227;1290;3807;1340;4034
292000;202004;2637;6194;2145;5603;97;369;1672;4310;1769;4679
292010;202004;5738;13400;4667;11867;170;524;3869;9636;4039;10160
292020;202004;4544;13165;3753;11750;200;739;2726;8282;2926;9021
292030;202004;1803;5524;1644;5229;74;267;1051;3276;1125;3543
292040;202004;4340;11199;3376;9770;219;581;2577;7612;2796;8193
292045;202004;4014;10543;2967;9006;31;88;2623;8126;2654;8214
292050;202004;6487;18142;5215;15877;244;859;3365;10060;3609;10919
292060;202004;11452;26282;10468;25056;486;1094;9152;21699;9638;22793
292070;202004;5794;14967;5044;14070;297;841;4321;11987;4618;12828
292080;202004;3094;7822;2554;7125;77;257;2265;6284;2342;6541
292090;202004;4657;10025;3300;8391;258;681;2475;6346;2733;7027
292100;202004;10958;26542;9330;24499;928;2568;6520;17053;7448;19621
292105;202004;3477;8688;3021;8064;101;245;2468;6623;2569;6868
292110;202004;5883;14373;4119;11545;968;2763;1897;5324;2865;8087
292120;202004;6833;17429;5644;15448;361;1051;4312;11602;4673;12653
292130;202004;3411;8122;2797;7360;96;288;2217;5756;2313;6044
292140;202004;5039;11885;4215;10634;314;787;3342;8400;3656;9187
292145;202004;2364;6793;1987;6149;62;162;1530;4791;1592;4953
292150;202004;14029;38233;12165;35186;311;1202;9943;28386;10254;29588
292160;202004;2959;7170;2229;6228;43;121;1816;5312;1859;5433
292170;202004;8418;22264;6993;19941;341;1140;5297;14797;5638;15937
292180;202004;2791;7633;2035;6235;160;488;1284;3867;1444;4355
292190;202004;2940;7709;2505;7037;93;319;1978;5488;2071;5807
292200;202004;8313;20722;6173;17683;1019;3028;3255;9585;4274;12613
292205;202004;3868;10656;3341;9870;59;273;2917;8571;2976;8844
292210;202004;6516;15130;5241;13520;89;384;4712;12022;4801;12406
292220;202004;2129;5110;1864;4702;48;139;1484;3610;1532;3749
292225;202004;3195;9327;2793;8711;72;333;2362;7240;2434;7573
292230;202004;8588;20412;7667;19246;157;521;6626;16349;6783;16870
292240;202004;4713;13606;4080;12457;301;900;2856;8746;3157;9646
292250;202004;5627;14665;5046;13785;404;1085;3750;10214;4154;11299
292260;202004;3418;8858;3016;8333;87;241;2626;7260;2713;7501
292265;202004;3381;9133;2828;8298;76;323;2242;6444;2318;6767
292270;202004;4427;10030;3513;8945;119;289;2916;7427;3035;7716
292273;202004;2700;5788;2138;5106;55;96;1592;4042;1647;4138
292275;202004;1644;4261;1288;3778;59;165;970;2898;1029;3063
292280;202004;2618;6207;2098;5606;78;167;1787;4909;1865;5076
292285;202004;2525;6112;2011;5418;78;175;1636;4452;1714;4627
292290;202004;7417;19646;5855;17448;162;619;4787;14235;4949;14854
292300;202004;10220;25681;8028;22738;750;2257;5570;15864;6320;18121
292303;202004;2942;8376;2551;7756;77;194;2133;6534;2210;6728
292305;202004;2319;6190;2140;5944;42;194;1943;5302;1985;5496
292310;202004;6684;16781;5758;15662;149;502;5018;13513;5167;14015
292320;202004;6086;16630;4814;14262;260;856;3513;10132;3773;10988
292330;202004;2727;5996;2189;5392;97;196;1706;4369;1803;4565
292335;202004;4719;12210;4192;11457;205;484;3552;9796;3757;10280
292340;202004;5620;15635;4624;13718;225;674;3415;10055;3640;10729
292350;202004;2470;6697;2052;6123;77;286;1654;4948;1731;5234
292360;202004;4867;12991;4026;11558;215;714;2874;8047;3089;8761
292370;202004;10518;24397;9014;22436;130;431;8366;20552;8496;20983
292380;202004;6779;18860;6058;17571;388;1132;4612;13257;5000;14389
292390;202004;4534;8697;3331;7294;108;197;2917;6402;3025;6599
292400;202004;22156;62882;19097;58018;1855;5741;13132;40103;14987;45844
292405;202004;4256;10568;3591;9521;94;253;2973;7784;3067;8037
292410;202004;2215;5250;1843;4778;65;144;1625;4239;1690;4383
292420;202004;3450;10425;3139;9927;109;549;2699;8305;2808;8854
292430;202004;4843;14439;3657;12252;283;989;2388;7992;2671;8981
292440;202004;8422;26754;7777;25782;128;648;6965;22998;7093;23646
292450;202004;3988;11381;3114;9672;84;325;2431;7502;2515;7827
292460;202004;4899;13397;3995;11856;334;945;2873;8545;3207;9490
292465;202004;2592;6764;2198;6248;85;188;1517;4674;1602;4862
292467;202004;1902;5320;1686;5024;240;640;1168;3614;1408;4254
292470;202004;2968;7531;2292;6480;53;116;1793;5078;1846;5194
292480;202004;6248;14935;5025;13451;73;286;4557;12107;4630;12393
292490;202004;2052;5318;1713;4818;114;265;1301;3745;1415;4010
292500;202004;6591;17946;5251;15558;504;1564;3417;9977;3921;11541
292510;202004;13183;35557;10254;30853;519;1858;7176;21520;7695;23378
292520;202004;6987;17344;6189;16207;449;1209;4815;12505;5264;13714
292525;202004;5843;14058;4748;12826;112;275;4113;11294;4225;11569
292530;202004;28092;74756;21395;63239;5147;15349;8203;24891;13350;40240
292540;202004;4367;8071;3420;7059;113;193;3076;6380;3189;6573
292550;202004;8390;21596;6408;19221;464;1393;4546;14509;5010;15902
292560;202004;4307;10814;3731;10053;75;222;3111;8433;3186;8655
292570;202004;3564;9437;2976;8330;71;273;2510;6854;2581;7127
292575;202004;6940;19678;6349;18892;371;1080;5113;15366;5484;16446
292580;202004;7542;18955;6244;17042;134;455;5266;14236;5400;14691
292590;202004;7329;19516;6275;17699;253;824;5241;14498;5494;15322
292593;202004;2807;6973;2326;6166;63;167;1956;5129;2019;5296
292595;202004;5389;14294;4606;13333;149;501;3885;11175;4034;11676
292600;202004;10888;29543;9351;27187;293;869;7450;21728;7743;22597
292610;202004;4091;10724;3451;9584;179;418;2616;7348;2795;7766
292620;202004;6428;17530;5321;16195;123;280;4862;15087;4985;15367
292630;202004;8502;20773;6835;18104;690;1839;4433;11788;5123;13627
292640;202004;8146;23923;7065;22126;196;773;5042;15897;5238;16670
292650;202004;4443;10939;4003;10361;106;287;3640;9323;3746;9610
292660;202004;11429;30612;9676;28030;446;1452;7426;21485;7872;22937
292665;202004;2160;6370;1868;5989;66;194;1574;5122;1640;5316
292670;202004;3572;9554;2729;7984;115;369;1860;5333;1975;5702
292680;202004;3964;10409;3118;8930;191;500;2278;6417;2469;6917
292690;202004;2624;6719;1803;5376;198;553;1066;3334;1264;3887
292700;202004;9798;26533;8505;24563;722;1848;5902;17632;6624;19480
292710;202004;2411;7564;2230;7314;45;164;2012;6643;2057;6807
292720;202004;8996;21362;7607;19760;208;571;6054;15996;6262;16567
292730;202004;4524;10305;4232;9958;254;418;3642;8767;3896;9185
292740;202004;326406;784069;280248;717355;38910;99691;174471;444760;213381;544451
292750;202004;6140;16466;5361;15333;222;642;4154;12055;4376;12697
292760;202004;3897;11169;3377;10243;224;765;2469;7428;2693;8193
292770;202004;6098;16006;4890;14321;766;2311;3080;9297;3846;11608
292780;202004;2081;4155;1533;3471;41;134;1244;2656;1285;2790
292790;202004;4073;8661;3113;7620;153;381;2601;6417;2754;6798
292800;202004;11258;28084;9607;25601;294;859;8039;21131;8333;21990
292805;202004;3570;8578;2778;7536;98;316;2193;5898;2291;6214
292810;202004;10636;27827;8386;24311;207;891;6318;17732;6525;18623
292820;202004;7429;20391;5396;16979;434;1459;3750;11602;4184;13061
292830;202004;2879;6784;2466;6268;89;265;2092;5331;2181;5596
292840;202004;8705;22638;7357;20808;146;563;6443;17913;6589;18476
292850;202004;2481;6572;2082;5976;142;432;1476;4205;1618;4637
292860;202004;17211;37571;15418;35444;410;998;13350;30311;13760;31309
292870;202004;17947;44233;15363;40596;930;2505;10507;27473;11437;29978
292880;202004;11000;29839;9359;27386;267;1108;7386;20905;7653;22013
292890;202004;7014;19438;6186;18235;183;746;5415;15839;5598;16585
292895;202004;2993;6403;2164;5174;95;227;1751;4145;1846;4372
292900;202004;2570;6906;2334;6542;61;238;1915;5210;1976;5448
292905;202004;4297;11069;3385;9727;136;456;2509;7132;2645;7588
292910;202004;4894;13230;4439;12578;216;610;3391;9543;3607;10153
292920;202004;9695;26503;8945;25438;251;951;7744;21628;7995;22579
292925;202004;5414;15267;4520;13659;217;663;3269;9770;3486;10433
292930;202004;6484;18963;5565;17264;465;1604;3567;10781;4032;12385
292935;202004;2428;6151;1869;5524;23;123;1675;4978;1698;5101
292937;202004;2904;7116;2530;6631;51;161;2235;5835;2286;5996
292940;202004;2835;7155;2262;6305;176;403;1643;4758;1819;5161
292950;202004;9561;24134;8348;22347;529;1231;6305;16852;6834;18083
292960;202004;5207;12569;4355;11353;128;335;3496;9021;3624;9356
292970;202004;3759;10873;3321;10199;79;379;2767;8535;2846;8914
292975;202004;4453;9493;3941;8919;128;215;3586;8217;3714;8432
292980;202004;3302;7928;2639;6952;87;276;2151;5560;2238;5836
292990;202004;11347;31010;9455;27653;646;1988;6925;19944;7571;21932
293000;202004;2581;6145;2205;5579;41;146;1763;4464;1804;4610
293010;202004;17978;45905;14443;40318;1928;5564;8809;24551;10737;30115
293015;202004;8177;25035;6390;21521;410;1500;4332;14784;4742;16284
293020;202004;9788;28310;8800;26896;134;587;7932;24297;8066;24884
293030;202004;5232;13871;3961;11885;98;329;2759;8511;2857;8840
293040;202004;4032;11020;3393;10118;67;261;2939;8772;3006;9033
293050;202004;21980;54263;19406;50470;983;2678;14736;37782;15719;40460
293060;202004;3469;9239;2816;8018;236;713;1957;5479;2193;6192
293070;202004;25054;60191;21321;55472;1957;5359;15351;39991;17308;45350
293075;202004;3455;10961;2989;10160;158;696;2373;8067;2531;8763
293076;202004;3521;8664;3204;8287;57;157;2851;7440;2908;7597
293077;202004;6034;16750;4890;14900;428;1433;3179;9912;3607;11345
293080;202004;4698;13863;4037;12731;91;431;3275;10133;3366;10564
293090;202004;3212;9304;2445;8036;205;669;1608;5342;1813;6011
293100;202004;5636;15067;4644;13275;217;647;3673;10404;3890;11051
293105;202004;3669;11635;3207;10699;228;793;2279;7541;2507;8334
293110;202004;2368;5909;1958;5302;68;245;1605;4236;1673;4481
293120;202004;4363;11853;3876;11087;113;302;3227;9240;3340;9542
293130;202004;3673;10095;3200;9471;75;287;2750;8067;2825;8354
293135;202004;30714;71568;22595;60781;3399;9942;10741;29200;14140;39142
293140;202004;2364;5244;2047;4850;62;145;1727;4083;1789;4228
293150;202004;5485;16193;4501;14315;335;1079;3086;9854;3421;10933
293160;202004;3853;9341;3263;8701;245;410;2715;7602;2960;8012
293170;202004;4842;10196;4195;9394;114;259;3665;8172;3779;8431
293180;202004;4297;12105;3528;10704;88;346;2804;8319;2892;8665
293190;202004;13833;37909;12135;35447;153;680;10753;31227;10906;31907
293200;202004;8334;20689;6639;18013;200;742;5306;14081;5506;14823
293210;202004;5128;13609;4391;12484;282;795;3382;9615;3664;10410
293220;202004;5029;12936;3665;10594;850;2455;1461;4326;2311;6781
293230;202004;3865;9907;2837;8432;207;695;1939;5812;2146;6507
293240;202004;4505;11886;3598;10411;68;161;2741;8241;2809;8402
293245;202004;3800;10254;3406;9689;142;482;2903;8118;3045;8600
293250;202004;5904;13636;4808;12239;134;342;4047;10298;4181;10640
293260;202004;4470;12079;3687;10852;139;459;2557;7551;2696;8010
293270;202004;7235;15939;5694;14289;393;598;4471;12055;4864;12653
293280;202004;4501;11841;3913;11009;233;579;3047;8666;3280;9245
293290;202004;14251;41579;12507;38851;1688;5345;8205;25831;9893;31176
293300;202004;5726;13857;4906;12666;273;716;3609;9316;3882;10032
293305;202004;4031;9628;3508;8979;46;117;3170;8113;3216;8230
293310;202004;2063;5292;1736;4788;45;136;1397;3797;1442;3933
293315;202004;4035;9613;3324;8534;192;444;2752;7051;2944;7495
293317;202004;2613;6134;2310;5720;144;277;1834;4558;1978;4835
293320;202004;11978;28936;10585;27378;260;716;9435;24305;9695;25021
293325;202004;1761;4371;1367;3839;194;532;833;2378;1027;2910
293330;202004;53439;153726;43102;135343;8188;26464;19913;63256;28101;89720
293340;202004;2210;6192;1820;5499;82;274;1297;3864;1379;4138
293345;202004;3486;9417;2785;8365;356;828;1821;5971;2177;6799
293350;202004;6609;18885;5693;17792;61;309;5188;16412;5249;16721
293360;202004;15487;38453;13121;35298;294;1220;11555;30519;11849;31739
310010;202004;931;2099;589;1624;47;169;221;550;268;719
310020;202004;2438;6655;1736;5389;372;1255;379;1105;751;2360
310030;202004;1872;5278;1432;4508;212;743;912;2759;1124;3502
310040;202004;896;2336;711;2023;29;129;488;1301;517;1430
310050;202004;1493;4468;1254;4086;131;537;820;2563;951;3100
310060;202004;3142;8891;2723;8336;83;352;2266;6841;2349;7193
310070;202004;344;782;240;634;7;15;180;472;187;487
310080;202004;676;1794;481;1442;70;233;221;626;291;859
310090;202004;4612;12349;3762;10951;286;905;2735;7836;3021;8741
310100;202004;3384;9532;2814;8558;79;377;2274;6730;2353;7107
310110;202004;4577;12072;3558;10265;760;2391;1549;4294;2309;6685
310120;202004;635;1556;401;1178;44;155;238;645;282;800
310130;202004;360;938;297;845;26;104;221;589;247;693
310140;202004;264;751;187;623;36;138;74;222;110;360
310150;202004;5273;13942;3870;11324;503;1695;1821;5037;2324;6732
310160;202004;7543;18834;5342;15209;1035;3242;1911;5490;2946;8732
310163;202004;1020;3013;809;2611;183;669;271;807;454;1476
310170;202004;8992;23072;7120;20130;596;1758;5041;14239;5637;15997
310180;202004;1749;4358;1277;3569;161;492;756;2040;917;2532
310190;202004;2449;7164;1954;6272;442;1599;329;981;771;2580
310200;202004;1837;5430;1320;4418;191;722;612;2012;803;2734
310205;202004;1100;3054;842;2644;149;530;378;1165;527;1695
310210;202004;2589;6935;2096;6057;119;374;1535;4336;1654;4710
310220;202004;1217;3352;926;2787;89;301;612;1771;701;2072
310230;202004;2159;5992;1727;5182;217;729;1078;3029;1295;3758
310240;202004;912;2836;764;2571;46;178;544;1806;590;1984
310250;202004;1023;2744;819;2409;19;76;586;1707;605;1783
310260;202004;2880;7409;1784;5493;506;1815;475;1126;981;2941
310270;202004;2643;6644;2075;5867;100;339;1682;4751;1782;5090
310280;202004;2351;5457;1805;4679;263;731;1023;2543;1286;3274
310285;202004;1828;5835;1513;5270;165;665;937;3215;1102;3880
310290;202004;1118;2938;907;2560;207;676;474;1192;681;1868
310300;202004;1442;4198;1219;3818;134;525;726;2128;860;2653
310310;202004;288;705;187;532;31;94;99;283;130;377
310320;202004;501;1292;337;1027;24;95;187;541;211;636
310330;202004;479;1130;283;782;40;129;117;294;157;423
310340;202004;7666;20741;6114;18107;864;2485;3035;9308;3899;11793
310350;202004;12195;29366;8211;22919;1591;4766;3591;9718;5182;14484
310360;202004;490;1116;371;962;11;34;253;661;264;695
310370;202004;1247;3888;1046;3501;209;768;349;1189;558;1957
310375;202004;839;2083;583;1705;87;257;319;936;406;1193
310380;202004;394;887;215;599;34;103;97;252;131;355
310390;202004;431;1274;335;1091;77;274;95;264;172;538
310400;202004;9731;23539;6842;19202;704;2298;4087;11220;4791;13518
310410;202004;891;2554;580;1971;89;330;220;698;309;1028
310420;202004;4103;10512;2747;7919;379;1242;1111;2975;1490;4217
310430;202004;1483;4025;956;3044;216;762;326;915;542;1677
310440;202004;646;1681;438;1296;42;150;231;646;273;796
310445;202004;1344;3861;969;3102;57;200;686;2154;743;2354
310450;202004;4685;11696;3507;9845;135;518;2667;7255;2802;7773
310460;202004;1506;3961;1063;3159;184;598;357;1002;541;1600
310470;202004;3717;8126;2872;7025;275;649;2043;5127;2318;5776
310480;202004;903;2334;697;1998;76;229;456;1286;532;1515
310490;202004;2789;7584;2173;6563;227;858;1222;3464;1449;4322
310500;202004;1320;3739;984;3167;174;640;517;1613;691;2253
310510;202004;2000;5212;1264;3846;233;796;463;1420;696;2216
310520;202004;1184;3083;851;2484;143;412;445;1293;588;1705
310530;202004;677;1709;416;1230;59;220;139;328;198;548
310540;202004;2972;8452;2459;7566;551;1798;1121;3313;1672;5111
310550;202004;1227;3150;844;2489;72;269;479;1326;551;1595
310560;202004;14438;37534;10178;30068;1519;5153;4281;11440;5800;16593
310570;202004;1027;2676;809;2373;52;186;602;1737;654;1923
310590;202004;3970;10599;3158;9084;195;671;1851;5043;2046;5714
310600;202004;1296;3843;1058;3364;144;517;544;1618;688;2135
310610;202004;464;1213;289;925;52;183;139;423;191;606
310620;202004;171213;432862;123208;346246;17884;58327;59899;152697;77783;211024
310630;202004;4356;11902;3403;10057;303;993;2193;6276;2496;7269
310640;202004;1000;2992;811;2611;164;580;350;1070;514;1650
310650;202004;2327;6700;1671;5427;164;578;974;3073;1138;3651
310660;202004;1279;3444;1042;3125;31;109;882;2623;913;2732
310665;202004;1395;3596;1115;3183;29;107;905;2609;934;2716
310670;202004;54685;141080;45801;125905;4291;13617;31551;82661;35842;96278
310680;202004;738;1753;598;1553;18;62;502;1255;520;1317
310690;202004;1890;4975;1348;4050;111;382;753;2163;864;2545
310700;202004;474;1048;374;929;22;75;296;706;318;781
310710;202004;5342;15266;3890;13152;880;3510;655;2049;1535;5559
310720;202004;969;2284;747;2002;33;111;563;1471;596;1582
310730;202004;9649;25999;8263;23818;324;1200;6233;17632;6557;18832
310740;202004;5821;16049;3934;12088;650;2208;1344;3795;1994;6003
310750;202004;1192;2840;864;2369;109;331;435;1124;544;1455
310760;202004;564;1459;401;1214;30;92;214;670;244;762
310770;202004;1058;2864;725;2354;78;313;370;1125;448;1438
310780;202004;4232;10281;3488;9279;66;200;2844;7603;2910;7803
310790;202004;1764;5588;1525;5077;355;1259;241;721;596;1980
310800;202004;2167;6409;1549;5132;352;1397;102;271;454;1668
310810;202004;1196;2977;962;2586;41;123;682;1768;723;1891
310820;202004;1094;2829;667;2105;150;517;164;521;314;1038
310825;202004;2481;7621;1972;6763;68;403;1579;5220;1647;5623
310830;202004;1718;4867;1181;3784;235;861;495;1481;730;2342
310840;202004;1876;5104;1330;4185;349;1237;320;891;669;2128
310850;202004;1473;4038;1228;3696;46;236;955;2738;1001;2974
310855;202004;3031;8017;2344;6904;159;564;1682;4815;1841;5379
310860;202004;6891;19921;5489;17147;523;1734;3383;10650;3906;12384
310870;202004;930;2244;726;1953;48;130;549;1480;597;1610
310880;202004;972;2921;759;2481;103;347;443;1413;546;1760
310890;202004;2239;6371;1432;4733;260;932;224;628;484;1560
310900;202004;3750;10485;2511;7730;370;1205;1075;3113;1445;4318
310910;202004;1965;4852;1350;3860;107;376;274;726;381;1102
310920;202004;1894;4924;1430;4213;199;634;812;2345;1011;2979
310925;202004;933;2543;747;2241;70;246;506;1435;576;1681
310930;202004;5709;14962;4033;12215;772;2392;1856;5854;2628;8246
310940;202004;6475;15489;5163;13550;178;613;3949;10047;4127;10660
310945;202004;1313;3437;1029;2971;158;490;527;1487;685;1977
310950;202004;1862;5556;1205;4061;230;875;412;1220;642;2095
310960;202004;714;1898;394;1221;72;257;85;231;157;488
310970;202004;1108;3284;777;2567;200;728;143;433;343;1161
310980;202004;270;649;174;504;17;59;109;305;126;364
310990;202004;1284;3582;992;3067;161;530;511;1547;672;2077
311000;202004;3973;11042;2880;9200;706;2426;1187;3670;1893;6096
311010;202004;843;2487;672;2138;198;701;282;871;480;1572
311020;202004;1043;2680;659;1989;33;98;370;1104;403;1202
311030;202004;1608;3940;1099;3113;196;630;514;1377;710;2007
311040;202004;277;870;228;761;70;245;70;220;140;465
311050;202004;2759;6738;2020;5664;356;1148;1017;2727;1373;3875
311060;202004;2992;7671;2157;6091;317;1030;858;2213;1175;3243
311070;202004;2265;5643;1621;4631;172;641;868;2304;1040;2945
311080;202004;1101;2506;889;2170;48;161;697;1613;745;1774
311090;202004;1990;6328;1543;5478;350;1379;468;1603;818;2982
311100;202004;2316;6560;1345;4548;241;937;246;733;487;1670
311110;202004;3587;7333;1995;5127;358;984;742;1954;1100;2938
311115;202004;1326;3036;1104;2734;59;155;908;2227;967;2382
311120;202004;6190;16240;4631;13434;684;2281;1779;4545;2463;6826
311130;202004;1822;4729;1372;4106;106;404;784;2279;890;2683
311140;202004;1357;3349;1042;2922;79;260;699;1929;778;2189
311150;202004;1462;4651;1134;4007;183;717;604;2080;787;2797
311160;202004;3643;10459;2518;8330;627;2305;754;2399;1381;4704
311170;202004;879;2221;690;1967;38;110;440;1328;478;1438
311180;202004;1317;2960;806;2202;149;443;362;977;511;1420
311190;202004;858;2379;655;1981;117;406;263;695;380;1101
311200;202004;1911;5191;1357;4122;258;873;484;1316;742;2189
311205;202004;855;2584;693;2254;47;214;435;1340;482;1554
311210;202004;998;2916;867;2742;113;319;630;2049;743;2368
311220;202004;723;2012;603;1800;48;163;382;1080;430;1243
311230;202004;7537;22766;5674;18937;1006;3547;2127;7234;3133;10781
311240;202004;994;2597;756;2257;156;495;324;968;480;1463
311250;202004;983;2845;755;2410;163;501;303;931;466;1432
311260;202004;2555;6336;1601;4678;253;825;673;1801;926;2626
311265;202004;1296;3384;948;2789;39;156;657;1877;696;2033
311270;202004;2932;8757;2545;8109;156;691;1853;5633;2009;6324
311280;202004;1073;2743;491;1562;97;359;47;130;144;489
311290;202004;1842;5587;1672;5227;147;478;1136;3540;1283;4018
311300;202004;4621;12964;3774;11534;197;837;2976;8892;3173;9729
311310;202004;550;1526;464;1376;43;127;279;804;322;931
311320;202004;3067;9355;2598;8332;385;1462;1217;3536;1602;4998
311330;202004;4947;13034;3929;11375;430;1380;2204;6484;2634;7864
311340;202004;10111;28379;7931;24490;2104;7054;2154;6331;4258;13385
311350;202004;2290;5736;1598;4446;144;451;874;2183;1018;2634
311360;202004;1104;2706;693;2076;201;678;224;643;425;1321
311370;202004;4588;11103;3346;9141;138;546;2239;5762;2377;6308
311380;202004;349;1066;255;871;63;212;107;383;170;595
311390;202004;1671;5110;1306;4594;572;2265;318;995;890;3260
311400;202004;1409;3878;1013;3111;159;500;388;1072;547;1572
311410;202004;1613;4728;1282;4246;192;734;745;2442;937;3176
311420;202004;1383;4023;944;3117;175;662;232;620;407;1282
311430;202004;3810;10107;2482;7461;486;1519;779;2340;1265;3859
311440;202004;2577;7335;1870;6118;434;1665;500;1558;934;3223
311450;202004;1664;4951;1179;4039;314;1220;325;963;639;2183
311455;202004;968;2146;634;1651;167;438;251;690;418;1128
311460;202004;468;1457;313;1128;63;297;85;257;148;554
311470;202004;483;1502;321;1113;69;283;51;160;120;443
311480;202004;1040;2679;858;2402;47;134;664;1856;711;1990
311490;202004;240;709;178;587;31;122;84;245;115;367
311500;202004;431;1074;330;930;24;77;216;586;240;663
311510;202004;3095;8106;2066;6316;299;1040;850;2443;1149;3483
311520;202004;615;1731;541;1588;68;256;304;867;372;1123
311530;202004;8548;19882;5298;14638;1280;3945;1406;3692;2686;7637
311535;202004;777;2129;499;1561;81;264;168;486;249;750
311540;202004;471;1495;417;1392;80;295;274;887;354;1182
311545;202004;2006;5745;1709;5282;98;349;1321;4030;1419;4379
311547;202004;1447;3708;1249;3401;41;112;872;2394;913;2506
311550;202004;2687;7532;2126;6494;302;1045;921;2687;1223;3732
311560;202004;281;619;177;467;24;75;94;218;118;293
311570;202004;1656;3839;1170;3170;37;108;931;2566;968;2674
311580;202004;2138;3977;1401;3107;136;291;943;2085;1079;2376
311590;202004;484;1286;383;1132;61;207;214;619;275;826
311600;202004;1738;3888;1452;3520;59;143;1248;2984;1307;3127
311610;202004;2165;7099;1781;6281;194;751;1000;3484;1194;4235
311615;202004;3063;8737;2463;7725;115;443;1936;5961;2051;6404
311620;202004;421;1094;363;1031;8;35;312;874;320;909
311630;202004;1298;3589;1046;3064;93;300;691;1944;784;2244
311640;202004;568;1551;441;1330;62;218;206;574;268;792
311650;202004;1836;4748;1512;4245;150;463;992;2709;1142;3172
311660;202004;2674;7580;1949;6188;356;1263;543;1479;899;2742
311670;202004;1463;3853;1065;3151;162;554;449;1330;611;1884
311680;202004;2085;6018;1539;4991;163;538;1020;3299;1183;3837
311690;202004;590;1259;460;1094;39;75;329;831;368;906
311700;202004;2202;5295;1710;4611;28;137;1440;3751;1468;3888
311710;202004;1463;4213;1044;3458;244;878;402;1305;646;2183
311720;202004;396;1176;316;1028;22;91;180;575;202;666
311730;202004;3754;9626;2392;7004;700;2207;467;1410;1167;3617
311740;202004;862;2266;724;2103;32;81;623;1868;655;1949
311750;202004;3805;11420;3017;9969;422;1514;1705;5434;2127;6948
311760;202004;597;1684;488;1490;70;263;242;639;312;902
311770;202004;2045;5878;1587;5047;243;818;746;2301;989;3119
311780;202004;1223;3504;823;2699;161;598;250;711;411;1309
311783;202004;2178;5960;1757;5225;43;204;1414;4036;1457;4240
311787;202004;702;2010;521;1593;73;243;226;594;299;837
311790;202004;1442;3893;936;2964;233;810;253;758;486;1568
311800;202004;4615;13885;3735;11959;798;2792;652;1798;1450;4590
311810;202004;920;2804;725;2458;56;213;467;1571;523;1784
311820;202004;766;1869;568;1565;70;226;352;911;422;1137
311830;202004;8250;23669;5569;17819;1548;5359;679;2122;2227;7481
311840;202004;3459;8869;2776;7884;251;757;2033;5745;2284;6502
311850;202004;354;938;286;809;13;35;191;526;204;561
311860;202004;56212;141851;42548;118697;6314;19048;23567;62911;29881;81959
311870;202004;1822;4836;1227;3751;202;704;489;1359;691;2063
311880;202004;6163;15978;5138;14556;278;712;3872;11191;4150;11903
311890;202004;1598;3881;1222;3336;84;278;875;2275;959;2553
311900;202004;714;1849;529;1594;57;209;349;1019;406;1228
311910;202004;4125;10568;3089;9210;550;1610;1557;4791;2107;6401
311920;202004;2015;5396;1589;4770;116;318;1012;3130;1128;3448
311930;202004;3597;8435;2509;6894;790;2347;745;1919;1535;4266
311940;202004;14351;37906;10493;30585;1513;4885;4791;13027;6304;17912
311950;202004;2226;6081;1645;5095;105;394;1031;3189;1136;3583
311960;202004;479;1172;384;1030;24;92;248;605;272;697
311970;202004;410;1326;295;1033;51;214;69;208;120;422
311980;202004;430;1185;220;761;24;86;70;242;94;328
311990;202004;531;1230;330;931;66;236;143;355;209;591
311995;202004;930;2560;456;1458;21;70;66;153;87;223
312000;202004;648;1705;532;1537;47;138;349;1014;396;1152
312010;202004;915;2562;702;2203;55;200;438;1315;493;1515
312015;202004;1336;3946;1174;3685;47;215;948;2906;995;3121
312020;202004;1460;4511;1088;3703;238;855;261;845;499;1700
312030;202004;1980;4953;1721;4667;20;77;1604;4340;1624;4417
312040;202004;835;2444;576;1929;63;223;264;856;327;1079
312050;202004;1158;3622;921;3159;217;878;284;860;501;1738
312060;202004;845;2096;554;1734;137;421;266;859;403;1280
312070;202004;873;2531;621;2026;47;172;339;1043;386;1215
312080;202004;2615;6444;1944;5445;105;345;1263;3387;1368;3732
312083;202004;839;2188;613;1835;52;191;409;1181;461;1372
312087;202004;2416;6321;1946;5580;43;142;1544;4429;1587;4571
312090;202004;9658;25329;7366;21678;1102;3584;3680;10552;4782;14136
312100;202004;1503;4427;1163;3796;102;421;669;2091;771;2512
312110;202004;1006;3103;830;2745;186;714;295;877;481;1591
312120;202004;785;2150;527;1697;149;545;160;428;309;973
312125;202004;1709;4399;1423;3983;114;372;1058;2846;1172;3218
312130;202004;963;2337;711;1918;55;164;309;761;364;925
312140;202004;671;1936;546;1684;109;375;248;705;357;1080
312150;202004;448;1253;377;1105;12;55;271;738;283;793
312160;202004;8122;22343;6072;18683;748;2708;2956;8683;3704;11391
312170;202004;885;2415;668;1984;35;132;448;1291;483;1423
312180;202004;1334;3588;1055;3055;149;463;542;1519;691;1982
312190;202004;617;1721;430;1354;78;269;142;417;220;686
312200;202004;4505;12260;3544;10710;1075;3245;1239;3861;2314;7106
312210;202004;1319;2978;941;2426;37;116;709;1788;746;1904
312220;202004;1620;5014;1395;4591;101;360;884;2911;985;3271
312230;202004;12392;32147;8024;24107;1932;6560;1600;4144;3532;10704
312235;202004;1883;4850;1481;4237;82;293;1063;2957;1145;3250
312240;202004;687;2254;521;1902;120;473;144;514;264;987
312245;202004;2552;6733;2076;6002;59;188;1687;4842;1746;5030
312247;202004;926;2272;660;1882;118;362;344;995;462;1357
312250;202004;968;2570;618;1866;79;252;232;688;311;940
312260;202004;882;2404;697;2118;41;168;523;1531;564;1699
312270;202004;658;1794;496;1478;25;106;290;794;315;900
312280;202004;398;1171;307;1005;95;315;43;127;138;442
312290;202004;706;2091;563;1830;102;376;200;628;302;1004
312300;202004;963;2932;641;2130;156;563;123;341;279;904
312310;202004;864;2658;672;2238;104;382;316;1011;420;1393
312320;202004;1900;4903;1367;3953;322;976;316;877;638;1853
312330;202004;841;2501;667;2133;62;222;412;1291;474;1513
312340;202004;259;678;182;548;44;156;75;199;119;355
312350;202004;243;491;170;412;14;44;117;269;131;313
312352;202004;1581;4745;1403;4425;84;272;867;2909;951;3181
312360;202004;2505;7297;1799;5909;363;1297;548;1729;911;3026
312370;202004;1760;4640;1427;4080;177;570;828;2258;1005;2828
312380;202004;2104;4799;1726;4322;6;25;1542;3821;1548;3846
312385;202004;1173;3242;915;2781;143;463;448;1345;591;1808
312390;202004;1853;5332;1373;4422;200;745;523;1539;723;2284
312400;202004;2778;8010;2277;7121;700;2358;735;2270;1435;4628
312410;202004;11406;31517;9230;27835;1591;4999;5076;15133;6667;20132
312420;202004;3550;9740;2936;8715;538;1776;1563;4517;2101;6293
312430;202004;7590;20372;6182;17811;391;1318;4361;12250;4752;13568
312440;202004;889;2870;694;2416;356;1315;89;274;445;1589
312450;202004;1131;3329;855;2842;243;856;292;1007;535;1863
312460;202004;424;1114;288;905;40;139;150;488;190;627
312470;202004;460;1100;288;799;33;100;109;267;142;367
312480;202004;1032;2565;718;2104;100;323;353;971;453;1294
312490;202004;2021;4933;1530;4205;198;563;837;2247;1035;2810
312500;202004;941;2337;755;2077;49;174;517;1401;566;1575
312510;202004;3627;9601;2576;7612;653;1862;690;2080;1343;3942
312520;202004;161;442;121;374;32;104;53;162;85;266
312530;202004;579;1428;495;1326;16;58;437;1172;453;1230
312540;202004;1526;4303;1020;3251;145;507;556;1711;701;2218
312550;202004;748;1977;565;1614;46;150;363;953;409;1103
312560;202004;1910;4949;1527;4346;69;219;1158;3306;1227;3525
312570;202004;2106;5187;1572;4514;446;1342;620;1840;1066;3182
312580;202004;611;1698;430;1313;57;202;194;542;251;744
312590;202004;1573;4596;1248;3942;89;400;782;2290;871;2690
312595;202004;1864;5550;1547;5002;261;799;920;3122;1181;3921
312600;202004;1109;2689;618;1744;107;380;117;380;224;760
312610;202004;5977;15130;3797;11056;589;1873;1311;3558;1900;5431
312620;202004;2469;6455;1817;5531;56;271;1433;4443;1489;4714
312630;202004;280;822;198;676;37;145;78;259;115;404
312640;202004;487;1342;330;1068;41;137;126;429;167;566
312650;202004;1984;5119;1343;3905;65;211;952;2648;1017;2859
312660;202004;1298;3168;972;2614;87;261;662;1713;749;1974
312670;202004;4758;12697;3936;11384;169;760;2874;7936;3043;8696
312675;202004;1233;3277;999;2930;57;190;802;2327;859;2517
312680;202004;1355;3856;1169;3567;52;233;961;2837;1013;3070
312690;202004;2836;6047;2199;5279;53;153;1826;4388;1879;4541
312695;202004;931;2567;772;2292;38;98;605;1797;643;1895
312700;202004;2086;5509;1501;4434;149;513;841;2355;990;2868
312705;202004;1349;3288;1141;2975;17;58;1030;2670;1047;2728
312707;202004;1344;3937;1039;3379;62;304;677;2066;739;2370
312710;202004;6467;14815;3761;10548;958;2887;1066;3087;2024;5974
312720;202004;1042;2800;782;2387;102;326;476;1420;578;1746
312730;202004;1606;3806;1134;3144;92;302;664;1756;756;2058
312733;202004;1361;3606;1035;2983;37;145;710;1945;747;2090
312735;202004;642;1748;537;1541;66;219;328;839;394;1058
312737;202004;769;1772;528;1414;68;201;331;843;399;1044
312738;202004;627;1606;441;1291;51;168;244;677;295;845
312740;202004;410;1003;234;709;49;168;62;146;111;314
312750;202004;1546;4470;1148;3721;206;707;497;1528;703;2235
312760;202004;1757;5174;1237;4096;216;778;453;1428;669;2206
312770;202004;42960;103036;26539;74801;5498;16621;8693;24124;14191;40745
312780;202004;2371;7126;2004;6530;233;822;1293;4197;1526;5019
312790;202004;241;576;128;396;7;38;41;106;48;144
312800;202004;4771;13511;3595;11244;882;2918;1235;3768;2117;6686
312810;202004;1532;4069;996;3197;256;920;347;1011;603;1931
312820;202004;1711;4584;1350;3954;40;161;1020;2916;1060;3077
312825;202004;1290;3058;1115;2830;19;67;951;2367;970;2434
312830;202004;2750;7752;1586;5319;335;1268;381;1214;716;2482
312840;202004;1208;3386;940;2908;96;386;478;1390;574;1776
312850;202004;870;2129;613;1749;25;99;365;959;390;1058
312860;202004;1135;2938;763;2360;200;664;172;487;372;1151
312870;202004;5943;16059;3601;11519;617;2130;789;2377;1406;4507
312880;202004;1375;3461;1054;2909;34;125;627;1728;661;1853
312890;202004;2149;5464;1517;4384;96;279;782;2299;878;2578
312900;202004;1134;2896;918;2631;76;251;513;1606;589;1857
312910;202004;1585;2918;826;1920;149;292;314;740;463;1032
312920;202004;969;2611;657;2083;116;428;279;817;395;1245
312930;202004;2221;5493;1705;4731;374;1070;774;2157;1148;3227
312940;202004;927;2545;716;2233;76;288;360;1060;436;1348
312950;202004;3079;7642;1983;5845;518;1668;623;1778;1141;3446
312960;202004;1780;4759;1503;4326;68;186;1170;3455;1238;3641
312965;202004;1581;4470;1321;4048;112;362;917;2767;1029;3129
312970;202004;1279;3590;984;3106;147;568;563;1652;710;2220
312980;202004;22045;60845;17661;52973;3378;11142;8661;24443;12039;35585
312990;202004;463;1189;288;880;49;166;133;396;182;562
313000;202004;478;1362;359;1141;28;120;211;623;239;743
313005;202004;2447;7082;2050;6406;162;495;1447;4488;1609;4983
313010;202004;4828;13360;3820;11713;680;2278;2223;6685;2903;8963
313020;202004;949;2896;644;2186;117;426;126;372;243;798
313030;202004;1054;2469;706;1950;72;255;466;1220;538;1475
313040;202004;761;2325;625;2050;42;177;372;1159;414;1336
313050;202004;1703;4719;1178;3917;199;800;380;1116;579;1916
313055;202004;1874;5063;1655;4742;55;177;1429;4073;1484;4250
313060;202004;943;2259;676;1806;181;592;128;303;309;895
313065;202004;1592;4797;1388;4457;48;193;1070;3353;1118;3546
313070;202004;922;2453;690;2041;74;230;394;1143;468;1373
313080;202004;372;1033;264;817;53;193;96;248;149;441
313090;202004;4975;13303;4223;12085;319;1061;2835;8033;3154;9094
313100;202004;1301;3386;997;2947;28;119;761;2189;789;2308
313110;202004;1427;3772;1027;3071;88;338;583;1618;671;1956
313115;202004;2478;7209;2001;6282;255;894;1061;3121;1316;4015
313120;202004;3685;8682;2673;7352;227;724;1727;4714;1954;5438
313130;202004;29549;76868;22391;63631;2465;7940;12623;33897;15088;41837
313140;202004;591;1300;349;947;28;73;234;645;262;718
313150;202004;1330;3737;979;3091;298;1027;221;625;519;1652
313160;202004;1075;2729;837;2359;26;95;636;1750;662;1845
313170;202004;10894;30971;7704;24996;1325;4702;3040;9309;4365;14011
313180;202004;2044;5411;1437;4208;181;556;814;2337;995;2893
313190;202004;3988;11406;2889;9206;542;1872;992;2950;1534;4822
313200;202004;1040;2921;902;2680;15;60;766;2209;781;2269
313210;202004;3708;10856;3003;9580;354;1293;1816;5564;2170;6857
313220;202004;1672;4405;1091;3260;164;555;435;1153;599;1708
313230;202004;2920;8249;2413;7644;47;181;2009;6505;2056;6686
313240;202004;9313;22761;5673;16889;967;3327;2383;6574;3350;9901
313250;202004;6138;18004;4589;14728;833;2701;1990;6269;2823;8970
313260;202004;583;1545;413;1238;55;219;203;566;258;785
313270;202004;5571;14212;4423;12575;561;1577;2938;8577;3499;10154
313280;202004;444;1248;287;925;34;122;121;373;155;495
313290;202004;929;2870;681;2430;215;834;219;766;434;1600
313300;202004;1517;4058;1076;3273;278;911;240;636;518;1547
313310;202004;1053;3112;794;2567;127;478;213;583;340;1061
313320;202004;2059;5482;1468;4515;258;908;620;1911;878;2819
313330;202004;3999;10542;3000;9024;164;641;1957;5852;2121;6493
313340;202004;1354;3052;949;2493;84;236;658;1726;742;1962
313350;202004;2461;6997;1561;4901;212;727;554;1535;766;2262
313360;202004;1355;3308;906;2593;146;511;470;1252;616;1763
313370;202004;1352;3838;1115;3366;132;478;630;1752;762;2230
313375;202004;1658;4315;988;3056;181;622;214;617;395;1239
313380;202004;5897;14818;4141;11585;755;2358;1904;4757;2659;7115
313390;202004;800;2567;692;2385;49;233;461;1520;510;1753
313400;202004;3667;9089;2822;7918;155;484;2167;5988;2322;6472
313410;202004;1273;3340;971;2794;56;194;715;2012;771;2206
313420;202004;14793;32835;7278;20146;1644;5084;1042;2853;2686;7937
313430;202004;899;2658;674;2192;125;500;278;796;403;1296
313440;202004;6126;13365;3995;10544;383;1058;2445;6465;2828;7523
313450;202004;697;1881;478;1426;78;246;168;433;246;679
313460;202004;2047;5897;1620;5222;326;1192;764;2332;1090;3524
313470;202004;2805;7223;2203;6333;253;714;1420;4145;1673;4859
313480;202004;982;2838;532;1801;69;262;154;478;223;740
313490;202004;2503;6046;1168;3637;302;1044;188;582;490;1626
313500;202004;455;1312;351;1085;42;125;131;389;173;514
313505;202004;9764;26045;8295;24034;327;1157;6679;19349;7006;20506
313507;202004;1439;3768;1173;3360;27;113;951;2661;978;2774
313510;202004;13193;36521;10284;30868;1219;3891;4913;14387;6132;18278
313520;202004;13922;39506;11035;34495;595;2261;8155;24918;8750;27179
313530;202004;515;1528;384;1244;47;161;151;444;198;605
313535;202004;2344;6506;1957;5750;265;708;1195;3513;1460;4221
313540;202004;750;2226;595;1850;108;345;248;725;356;1070
313545;202004;1133;3736;941;3337;151;557;508;1742;659;2299
313550;202004;1709;5224;1397;4488;316;1139;702;2145;1018;3284
313560;202004;2594;5170;1932;4360;60;114;1626;3696;1686;3810
313570;202004;922;2749;752;2431;182;617;310;961;492;1578
313580;202004;5451;14441;4161;12272;488;1533;2382;7120;2870;8653
313590;202004;960;2743;766;2467;195;658;350;1196;545;1854
313600;202004;3894;10529;3224;9483;90;378;2686;7752;2776;8130
313610;202004;991;2511;796;2184;86;263;501;1304;587;1567
313620;202004;5411;14319;4203;12105;541;1722;2379;6620;2920;8342
313630;202004;8345;20135;5793;16291;583;1910;3446;9509;4029;11419
313640;202004;1047;2400;656;1896;142;443;280;810;422;1253
313650;202004;1699;5078;1343;4471;90;361;889;2987;979;3348
313652;202004;727;2323;651;2161;106;380;406;1313;512;1693
313655;202004;1118;2845;882;2540;46;139;689;1980;735;2119
313657;202004;1171;3134;923;2743;39;152;678;1899;717;2051
313660;202004;848;2387;679;2079;77;278;414;1200;491;1478
313665;202004;4550;12235;3478;10287;405;1349;2127;6024;2532;7373
313670;202004;47775;116773;29863;86289;4458;14138;12942;35440;17400;49578
313680;202004;1008;2698;825;2402;60;205;552;1556;612;1761
313690;202004;769;2375;586;2036;144;554;156;518;300;1072
313695;202004;1763;4844;1342;4143;85;276;905;2795;990;3071
313700;202004;2865;9240;2462;8701;249;926;1846;6537;2095;7463
313710;202004;1355;3147;972;2635;76;214;644;1763;720;1977
313720;202004;5246;14507;3599;11050;584;2006;1458;4067;2042;6073
313730;202004;1277;2928;962;2495;76;174;636;1643;712;1817
313740;202004;1606;5743;1313;4978;313;1363;231;757;544;2120
313750;202004;1917;5130;1446;4283;262;862;682;1893;944;2755
313753;202004;2105;5031;1389;3872;134;408;781;2113;915;2521
313760;202004;4957;13698;3663;11192;778;2608;1559;4451;2337;7059
313770;202004;3884;10982;3053;9632;198;663;2247;7171;2445;7834
313780;202004;3946;10579;2828;8675;233;847;815;2573;1048;3420
313790;202004;469;1463;418;1369;48;175;238;761;286;936
313800;202004;1348;3103;976;2569;124;380;526;1315;650;1695
313810;202004;1541;3972;1217;3510;45;181;939;2638;984;2819
313820;202004;17291;43875;10739;29967;1695;4994;2956;7992;4651;12986
313830;202004;372;1063;252;774;48;157;80;228;128;385
313835;202004;896;2654;735;2356;59;241;410;1234;469;1475
313840;202004;6672;17408;4863;14373;1227;3845;1027;3113;2254;6958
313850;202004;936;2295;742;2032;132;442;357;860;489;1302
313860;202004;2491;6717;1845;5489;294;1005;768;2096;1062;3101
313862;202004;1348;2839;638;1793;40;116;309;870;349;986
313865;202004;2473;6633;2028;5904;80;262;1532;4371;1612;4633
313867;202004;1255;3776;1039;3372;142;460;669;2217;811;2677
313868;202004;1675;5173;1370;4550;44;224;1050;3375;1094;3599
313870;202004;727;1964;518;1579;93;297;195;544;288;841
313880;202004;1585;4159;1154;3431;157;517;543;1442;700;1959
313890;202004;2005;4372;1502;3717;45;147;1116;2693;1161;2840
313900;202004;3979;11605;2823;9224;737;2649;674;2023;1411;4672
313910;202004;617;1830;462;1536;92;338;102;329;194;667
313920;202004;2890;8941;2414;7941;498;1626;1197;3966;1695;5592
313925;202004;1532;3915;1220;3358;184;495;791;2160;975;2655
313930;202004;4537;13820;3664;12237;270;1028;2394;7907;2664;8935
313940;202004;8319;24169;5911;19976;779;3211;1455;5413;2234;8624
313950;202004;5048;11311;3641;9568;410;1334;2180;5694;2590;7028
313960;202004;5451;13369;3599;10234;727;2321;1201;3147;1928;5468
313970;202004;1455;3974;1212;3561;16;53;779;2244;795;2297
313980;202004;1331;3446;868;2718;134;489;341;1004;475;1493
313990;202004;1828;5890;1288;4621;342;1406;390;1221;732;2627
314000;202004;9233;23926;7734;21363;559;1997;5175;14138;5734;16135
314010;202004;1442;3497;1122;3056;46;161;847;2234;893;2395
314015;202004;1850;5129;1389;4335;187;692;730;2233;917;2925
314020;202004;448;1222;292;953;64;253;59;207;123;460
314030;202004;744;2142;586;1836;58;190;316;978;374;1168
314040;202004;611;1646;486;1415;73;244;263;733;336;977
314050;202004;1739;4642;1244;3725;150;527;646;1804;796;2331
314053;202004;1762;5278;1405;4557;267;867;741;2485;1008;3352
314055;202004;2256;6084;1896;5518;42;162;1554;4517;1596;4679
314060;202004;1249;3338;933;2831;35;136;648;1940;683;2076
314070;202004;4506;12455;3495;10606;723;2192;1516;4548;2239;6740
314080;202004;2037;5334;1367;4178;179;655;572;1577;751;2232
314085;202004;2077;5916;1687;5304;226;748;957;3069;1183;3817
314090;202004;4445;12085;3786;11106;235;895;2421;7206;2656;8101
314100;202004;3082;7322;2372;6337;42;123;1793;4800;1835;4923
314110;202004;4406;12503;3561;10884;388;1392;2058;5898;2446;7290
314120;202004;761;1779;308;927;64;233;67;186;131;419
314130;202004;591;1524;359;1109;23;99;223;679;246;778
314140;202004;4444;12701;3487;10837;472;1553;1738;5299;2210;6852
314150;202004;1447;3623;1054;2947;85;245;706;1922;791;2167
314160;202004;2096;5578;1517;4522;205;672;659;1967;864;2639
314170;202004;904;2577;725;2223;45;173;472;1360;517;1533
314180;202004;5315;14814;4275;13130;358;1187;2588;7954;2946;9141
314190;202004;594;1482;411;1206;75;241;190;504;265;745
314200;202004;2886;8102;2348;7183;138;485;1677;4990;1815;5475
314210;202004;1932;5123;1520;4364;171;509;763;2157;934;2666
314220;202004;1305;3581;927;2922;202;726;345;994;547;1720
314225;202004;1070;3012;879;2707;76;198;631;2005;707;2203
314230;202004;745;1933;607;1763;71;235;397;1177;468;1412
314240;202004;985;2677;753;2315;187;600;291;906;478;1506
314250;202004;498;1396;313;1015;47;152;117;347;164;499
314260;202004;918;2515;716;2237;158;540;399;1210;557;1750
314270;202004;3259;9250;2667;8319;77;319;1957;6057;2034;6376
314280;202004;3346;7782;2201;6024;267;815;1181;3076;1448;3891
314290;202004;4410;11463;3595;10001;290;834;2453;6686;2743;7520
314300;202004;1892;5427;1223;3976;250;904;396;1217;646;2121
314310;202004;4034;10473;2664;8108;860;2866;425;1140;1285;4006
314315;202004;896;3104;764;2830;51;240;537;1921;588;2161
314320;202004;2822;7746;1801;5784;331;1158;668;2081;999;3239
314330;202004;48857;136889;36665;115030;9795;32168;7555;24980;17350;57148
314340;202004;2279;5634;1342;3938;274;936;345;862;619;1798
314345;202004;1368;4086;1108;3609;152;506;641;2069;793;2575
314350;202004;798;2181;504;1643;111;387;119;342;230;729
314360;202004;558;1612;337;1126;50;189;108;321;158;510
314370;202004;704;1893;560;1677;30;105;409;1184;439;1289
314380;202004;1108;3020;735;2344;163;604;158;480;321;1084
314390;202004;12479;31741;7883;23275;1563;4984;2446;6565;4009;11549
314400;202004;3886;11605;2913;9712;751;2585;1084;3757;1835;6342
314410;202004;2659;7398;1818;5823;250;917;618;2103;868;3020
314420;202004;812;2014;583;1640;40;151;394;1033;434;1184
314430;202004;7507;18484;5160;14507;775;2304;2385;6414;3160;8718
314435;202004;1703;4578;1337;3957;54;201;990;2867;1044;3068
314437;202004;898;2308;650;1885;68;220;319;911;387;1131
314440;202004;607;1736;426;1364;119;420;85;227;204;647
314450;202004;1369;3665;1136;3297;117;387;667;1855;784;2242
314460;202004;3202;9745;2307;7841;590;2115;541;1777;1131;3892
314465;202004;2151;6239;1825;5616;49;199;1399;4160;1448;4359
314467;202004;860;2283;724;2065;18;54;587;1629;605;1683
314470;202004;2064;5936;1644;5069;283;970;758;2181;1041;3151
314480;202004;6337;18118;4552;14329;767;2694;1651;4605;2418;7299
314490;202004;1031;2800;744;2194;66;210;457;1290;523;1500
314500;202004;1693;4047;1194;3346;301;829;420;1226;721;2055
314505;202004;2009;4947;1628;4402;100;288;1179;3108;1279;3396
314510;202004;1851;4871;1294;4016;254;885;585;1778;839;2663
314520;202004;4847;14900;3541;12119;729;2730;438;1335;1167;4065
314530;202004;5295;17159;4729;16058;313;1333;3462;11484;3775;12817
314535;202004;2492;6530;2002;5816;87;317;1529;4396;1616;4713
314537;202004;1078;3073;826;2665;46;176;591;1873;637;2049
314540;202004;382;955;253;730;17;60;143;393;160;453
314545;202004;1799;4421;1603;4193;32;96;1382;3715;1414;3811
314550;202004;630;1566;469;1336;35;133;258;670;293;803
314560;202004;4002;12166;2928;9726;474;1754;1003;3022;1477;4776
314570;202004;292;805;215;662;27;99;94;289;121;388
314580;202004;425;1273;327;1072;85;288;105;334;190;622
314585;202004;637;1997;478;1642;67;285;206;682;273;967
314587;202004;1980;5395;1488;4601;202;583;849;2710;1051;3293
314590;202004;3782;10417;2662;8265;373;1305;1128;3249;1501;4554
314600;202004;1862;5087;1073;3557;205;739;130;404;335;1143
314610;202004;8598;21533;5950;17578;1005;3536;2477;7504;3482;11040
314620;202004;2197;5172;1729;4576;38;130;1437;3785;1475;3915
314625;202004;1480;4138;1263;3837;32;197;1086;3221;1118;3418
314630;202004;5197;13427;4224;12125;104;445;3538;10160;3642;10605
314640;202004;654;1574;470;1287;63;201;259;664;322;865
314650;202004;786;1801;465;1302;40;132;249;610;289;742
314655;202004;1567;4335;1103;3491;163;513;541;1689;704;2202
314660;202004;319;727;203;515;14;30;130;317;144;347
314670;202004;1602;3684;1099;2961;17;53;728;1935;745;1988
314675;202004;1660;4438;1408;4012;75;253;1096;3036;1171;3289
314690;202004;2031;5683;1548;4955;415;1472;531;1667;946;3139
314700;202004;9765;27361;6321;20653;1221;4399;1896;6041;3117;10440
314710;202004;7489;21001;5345;16478;916;3109;1816;4901;2732;8010
314720;202004;1973;5819;1336;4499;285;1081;355;1123;640;2204
314730;202004;2155;5714;1545;4595;252;827;623;1726;875;2553
314740;202004;2844;8053;2196;6870;293;993;1097;3356;1390;4349
314750;202004;295;798;226;658;28;93;136;358;164;451
314760;202004;1845;5571;1167;3977;180;710;281;762;461;1472
314770;202004;1065;3125;558;1807;46;165;166;495;212;660
314780;202004;340;804;226;629;42;142;119;289;161;431
314790;202004;10079;27086;6793;20975;1443;5180;2266;6457;3709;11637
314795;202004;1452;3875;1217;3455;27;117;966;2639;993;2756
314800;202004;10413;26385;6118;18364;1125;3750;1433;3796;2558;7546
314810;202004;8473;22440;6104;18276;1515;4920;2077;5927;3592;10847
314820;202004;1173;2867;913;2479;50;195;585;1520;635;1715
314830;202004;1430;4375;1183;3901;216;801;574;1835;790;2636
314840;202004;839;2657;662;2370;47;236;469;1611;516;1847
314850;202004;1948;4676;1575;4196;35;113;1371;3679;1406;3792
314860;202004;3135;9265;2582;8250;198;800;1767;5493;1965;6293
314870;202004;6234;15875;4697;13803;277;896;3456;10265;3733;11161
314875;202004;1740;5189;1507;4882;110;292;1213;4013;1323;4305
314880;202004;814;1996;622;1700;26;74;382;1052;408;1126
314890;202004;410;1224;310;1012;49;183;134;411;183;594
314900;202004;687;1875;531;1597;90;312;227;634;317;946
314910;202004;1595;4538;1167;3834;213;813;552;1690;765;2503
314915;202004;2163;6442;1809;5821;114;379;1192;3783;1306;4162
314920;202004;454;1179;287;922;7;22;192;635;199;657
314930;202004;5179;14640;3845;12131;671;2318;1511;4448;2182;6766
314940;202004;391;997;320;872;29;79;208;536;237;615
314950;202004;484;1232;313;945;25;101;164;444;189;545
314960;202004;813;1938;623;1630;26;82;447;1106;473;1188
314970;202004;872;2520;657;2078;133;462;278;802;411;1264
314980;202004;1446;3716;1053;3133;186;638;497;1447;683;2085
314990;202004;2282;6575;1559;4936;317;1078;317;905;634;1983
314995;202004;1561;4367;1230;3766;39;174;819;2381;858;2555
315000;202004;1099;2797;779;2306;62;198;512;1497;574;1695
315010;202004;370;1034;280;873;44;158;134;394;178;552
315015;202004;2232;6298;1932;5792;188;629;1275;3758;1463;4387
315020;202004;784;2286;550;1754;72;286;237;686;309;972
315030;202004;556;1482;363;1116;85;263;80;221;165;484
315040;202004;809;2280;652;2000;85;282;398;1210;483;1492
315050;202004;1176;3046;831;2489;48;177;439;1284;487;1461
315053;202004;1065;2795;811;2347;50;160;476;1323;526;1483
315057;202004;1697;5161;1372;4585;138;466;919;3100;1057;3566
315060;202004;530;1616;388;1339;72;262;101;331;173;593
315070;202004;498;1319;337;1038;80;273;89;254;169;527
315080;202004;2823;8037;2135;6704;243;833;1304;3916;1547;4749
315090;202004;770;2341;555;1922;82;305;218;730;300;1035
315100;202004;1283;3796;822;2735;140;543;368;1076;508;1619
315110;202004;1772;4332;1272;3558;133;355;634;1838;767;2193
315120;202004;11538;27205;8422;22461;1136;2834;4528;12565;5664;15399
315130;202004;1455;4030;1193;3579;132;461;504;1411;636;1872
315140;202004;2867;7977;2190;6744;392;1315;1095;3198;1487;4513
315150;202004;4227;10145;2929;8064;453;1463;1381;3689;1834;5152
315160;202004;1673;4136;1094;3201;238;738;487;1417;725;2155
315170;202004;1342;4272;917;3242;221;857;212;723;433;1580
315180;202004;16001;38599;8230;24257;1142;3816;2522;6557;3664;10373
315190;202004;2104;4645;1611;3995;184;437;1193;2997;1377;3434
315200;202004;3775;10819;2689;8862;777;2755;711;2254;1488;5009
315210;202004;8026;21038;5393;15390;643;1988;2654;6873;3297;8861
315213;202004;1091;2867;936;2660;21;73;777;2179;798;2252
315217;202004;2708;7951;2043;6830;86;448;1414;4513;1500;4961
315220;202004;8199;22315;6387;19077;1140;3615;2683;8036;3823;11651
315230;202004;3042;7180;2538;6521;196;294;1934;5309;2130;5603
315240;202004;2406;7091;2026;6419;460;1515;976;3092;1436;4607
315250;202004;11970;32531;8374;25627;1363;4534;3510;10292;4873;14826
315260;202004;897;2491;475;1572;78;261;37;101;115;362
315270;202004;812;2327;570;1862;80;278;197;552;277;830
315280;202004;2841;7099;1663;4963;411;1338;265;767;676;2105
315290;202004;1143;2800;667;2044;188;643;192;557;380;1200
315300;202004;595;1448;400;1165;88;290;194;568;282;858
315310;202004;1245;3509;916;2874;76;267;514;1530;590;1797
315320;202004;646;1888;450;1489;68;269;192;581;260;850
315330;202004;738;2534;401;1607;65;301;125;449;190;750
315340;202004;2933;7134;2104;5946;252;745;1142;3211;1394;3956
315350;202004;1531;4177;1181;3630;161;578;661;2007;822;2585
315360;202004;1633;4847;1212;3952;189;664;483;1487;672;2151
315370;202004;459;1341;361;1140;67;201;147;454;214;655
315380;202004;186;550;136;442;33;112;30;68;63;180
315390;202004;1023;2915;807;2510;146;524;364;1041;510;1565
315400;202004;3856;10684;3017;9153;428;1365;1620;4742;2048;6107
315410;202004;2221;5139;1655;4320;457;1275;247;695;704;1970
315415;202004;1324;3627;1060;3232;221;786;423;1305;644;2091
315420;202004;1297;3709;868;2863;180;623;167;524;347;1147
315430;202004;3551;8654;2483;7032;444;1478;1078;2844;1522;4322
315440;202004;989;2635;787;2303;62;209;474;1314;536;1523
315445;202004;1921;4663;1368;3877;84;282;994;2771;1078;3053
315450;202004;2176;6142;1772;5487;225;684;1098;3414;1323;4098
315460;202004;34768;97343;28492;86041;4485;15291;15247;43420;19732;58711
315470;202004;602;1728;421;1275;30;105;247;714;277;819
315480;202004;1144;3301;797;2554;155;525;257;796;412;1321
315490;202004;2827;7148;1933;5702;289;881;696;1999;985;2880
315500;202004;505;1355;303;911;41;147;149;393;190;540
315510;202004;1193;3146;1013;2889;23;105;883;2475;906;2580
315520;202004;971;2709;780;2377;53;200;588;1741;641;1941
315530;202004;557;1578;441;1379;130;460;217;631;347;1091
315540;202004;1355;3689;939;2903;99;367;421;1274;520;1641
315550;202004;1903;4957;1230;3702;261;900;300;892;561;1792
315560;202004;6186;18832;5204;17018;294;932;3473;11597;3767;12529
315570;202004;1959;5340;1565;4692;84;317;929;2707;1013;3024
315580;202004;2633;6253;1950;5189;273;861;755;1890;1028;2751
315590;202004;845;2184;644;1861;70;249;353;955;423;1204
315600;202004;2418;7659;1725;6272;258;898;898;3411;1156;4309
315610;202004;908;2324;666;1868;103;363;293;710;396;1073
315620;202004;479;1299;353;1105;45;166;205;649;250;815
315630;202004;961;2556;696;2072;128;398;301;820;429;1218
315640;202004;347;863;257;751;28;108;155;428;183;536
315645;202004;946;2439;632;1915;152;498;158;459;310;957
315650;202004;1696;4105;1349;3621;33;109;1103;2876;1136;2985
315660;202004;2393;5934;1786;4880;98;304;1271;3338;1369;3642
315670;202004;13130;36061;9921;30206;1964;6261;4442;13019;6406;19280
315680;202004;3027;8834;2201;7249;300;1126;1124;3524;1424;4650
315690;202004;3173;7739;1833;5399;396;1182;552;1756;948;2938
315700;202004;7671;21447;5743;17525;898;2932;2606;7612;3504;10544
315710;202004;1815;4532;1276;3709;40;180;906;2525;946;2705
315720;202004;4257;11870;3586;10672;173;708;2562;7303;2735;8011
315725;202004;2057;5464;1584;4632;140;390;1071;3213;1211;3603
315727;202004;541;1405;402;1177;52;177;163;461;215;638
315730;202004;554;1736;486;1589;81;298;187;577;268;875
315733;202004;1132;2877;799;2304;116;405;311;851;427;1256
315737;202004;1119;3217;875;2726;30;128;624;1864;654;1992
315740;202004;820;2281;649;1936;71;250;418;1163;489;1413
315750;202004;1256;3327;979;2871;88;269;595;1777;683;2046
315760;202004;1096;2636;964;2465;40;113;819;2055;859;2168
315765;202004;1854;4972;1513;4528;24;108;1334;3971;1358;4079
315770;202004;998;2769;761;2436;315;1108;153;404;468;1512
315780;202004;27326;74910;22784;66962;1325;4852;15835;44686;17160;49538
315790;202004;3520;10916;2981;9876;392;1361;1767;5945;2159;7306
315800;202004;1198;4246;859;3347;131;583;259;896;390;1479
315810;202004;1293;3220;1049;2795;57;192;810;2064;867;2256
315820;202004;2513;6877;2030;6169;169;626;1414;4250;1583;4876
315830;202004;1182;3508;806;2697;87;322;281;869;368;1191
315840;202004;806;1963;546;1500;44;140;267;673;311;813
315850;202004;1136;3383;895;2943;180;632;432;1342;612;1974
315860;202004;455;1316;312;1051;67;237;92;278;159;515
315870;202004;450;1179;358;1036;19;65;256;704;275;769
315880;202004;1023;2683;667;2047;91;351;160;461;251;812
315890;202004;1636;4707;1307;4244;320;1133;647;2071;967;3204
315895;202004;5854;15834;4359;12914;422;1402;2270;6267;2692;7669
315900;202004;796;2049;684;1889;55;170;517;1383;572;1553
315910;202004;500;1414;421;1289;56;190;293;876;349;1066
315920;202004;1425;3619;764;2358;122;448;235;666;357;1114
315930;202004;1055;2393;694;1873;128;332;300;824;428;1156
315935;202004;779;2348;609;2021;118;413;211;697;329;1110
315940;202004;579;1618;461;1434;49;166;246;730;295;896
315950;202004;1141;3161;934;2822;84;247;713;2157;797;2404
315960;202004;4392;12444;2684;8975;856;3265;230;492;1086;3757
315970;202004;612;1628;483;1459;62;210;317;963;379;1173
315980;202004;4197;9132;2261;5959;404;1134;815;1967;1219;3101
315990;202004;3586;9120;2786;7753;263;788;1595;4308;1858;5096
316000;202004;553;1415;409;1204;52;191;195;534;247;725
316010;202004;818;2175;597;1801;42;145;372;1047;414;1192
316020;202004;888;2744;715;2403;82;326;421;1324;503;1650
316030;202004;2696;7616;2027;6408;235;767;1284;4109;1519;4876
316040;202004;2310;6547;1673;5350;297;1067;405;1120;702;2187
316045;202004;2021;5301;1850;5093;71;155;1598;4516;1669;4671
316050;202004;354;992;270;847;32;111;155;464;187;575
316060;202004;653;1645;474;1380;19;84;331;924;350;1008
316070;202004;5152;14398;4174;12533;723;2239;1973;5776;2696;8015
316080;202004;721;2272;561;1944;143;513;79;254;222;767
316090;202004;393;1137;286;917;40;148;140;416;180;564
316095;202004;1249;3911;991;3247;267;916;321;1029;588;1945
316100;202004;2368;6973;1690;5515;308;1101;623;1858;931;2959
316105;202004;771;2137;633;1915;37;127;450;1383;487;1510
316110;202004;13294;38860;11059;35069;789;2942;7499;23475;8288;26417
316120;202004;1150;3292;715;2258;115;388;214;556;329;944
316130;202004;1250;2850;788;2084;60;187;451;1167;511;1354
316140;202004;1164;3126;742;2343;96;327;367;1133;463;1460
316150;202004;1801;3924;1468;3492;173;534;612;1399;785;1933
316160;202004;967;2663;792;2356;40;145;544;1566;584;1711
316165;202004;830;2088;633;1769;93;316;335;863;428;1179
316170;202004;1099;2754;812;2319;51;185;554;1519;605;1704
316180;202004;1292;3664;847;2728;138;530;156;456;294;986
316190;202004;2482;7054;1436;4567;218;730;534;1514;752;2244
316200;202004;3089;8905;2268;7453;566;1985;519;1669;1085;3654
316210;202004;4360;12846;3150;10089;1151;3964;188;495;1339;4459
316220;202004;574;1758;380;1313;94;368;42;162;136;530
316225;202004;1511;3462;1114;2813;46;177;837;1960;883;2137
316230;202004;393;1077;297;909;34;109;171;527;205;636
316240;202004;5473;15888;4780;14685;355;1189;3626;10956;3981;12145
316245;202004;2864;9435;2572;8935;122;705;1988;6585;2110;7290
316250;202004;9617;23300;6910;19001;1475;4466;2431;6649;3906;11115
316255;202004;2915;8100;2537;7487;116;360;1912;5706;2028;6066
316257;202004;1301;3225;914;2533;136;381;488;1309;624;1690
316260;202004;1988;5169;1502;4343;141;432;802;2379;943;2811
316265;202004;1120;3010;864;2580;20;71;634;1841;654;1912
316270;202004;3559;11082;3033;9908;489;1721;1447;4504;1936;6225
316280;202004;2727;7966;2310;7163;316;1062;1289;3891;1605;4953
316290;202004;3374;9268;2683;8001;294;1030;1149;3314;1443;4344
316292;202004;4830;12938;3844;11265;480;1534;2496;7040;2976;8574
316294;202004;784;2339;573;1965;105;415;148;477;253;892
316295;202004;2953;8312;2389;7336;139;526;1680;4918;1819;5444
316300;202004;968;2801;791;2522;44;154;569;1803;613;1957
316310;202004;751;2003;485;1540;101;381;81;222;182;603
316320;202004;622;1749;476;1509;56;214;223;685;279;899
316330;202004;1053;2779;788;2304;47;181;592;1663;639;1844
316340;202004;975;2669;723;2208;67;274;413;1183;480;1457
316350;202004;1260;3597;1044;3252;90;306;730;2242;820;2548
316360;202004;609;1621;490;1418;47;145;360;1020;407;1165
316370;202004;4748;12802;3471;10457;681;2368;1241;3305;1922;5673
316380;202004;1672;4007;1302;3485;48;105;929;2499;977;2604
316390;202004;784;2099;552;1690;225;785;96;264;321;1049
316400;202004;1123;3193;713;2360;111;405;233;701;344;1106
316410;202004;1063;3031;888;2773;59;189;699;2150;758;2339
316420;202004;1903;5230;1653;4904;48;187;1365;3966;1413;4153
316430;202004;820;2183;515;1635;94;330;156;464;250;794
316440;202004;696;2164;553;1914;99;407;145;465;244;872
316443;202004;520;1453;378;1178;98;354;79;224;177;578
316447;202004;1896;5127;1656;4731;30;116;1410;3960;1440;4076
316450;202004;2083;6388;1581;5335;208;766;945;3098;1153;3864
316460;202004;1065;2735;850;2390;126;399;532;1402;658;1801
316470;202004;6429;18485;4525;14442;748;2718;1736;5084;2484;7802
316480;202004;197;543;163;494;43;129;76;225;119;354
316490;202004;312;839;220;675;31;99;83;211;114;310
316500;202004;1120;3542;735;2607;152;592;164;557;316;1149
316510;202004;722;2375;578;2096;113;424;271;984;384;1408
316520;202004;1142;2822;865;2371;115;396;440;1108;555;1504
316530;202004;1062;2787;762;2252;84;337;384;1000;468;1337
316540;202004;802;2096;620;1811;109;366;296;787;405;1153
316550;202004;1344;3925;1145;3534;52;187;890;2728;942;2915
316553;202004;3854;11542;2659;8578;427;1545;916;2636;1343;4181
316555;202004;2412;7817;2184;7506;107;393;1790;6215;1897;6608
316556;202004;523;1291;373;1028;29;80;205;519;234;599
316557;202004;999;3135;855;2891;289;1053;270;891;559;1944
316560;202004;329;912;225;755;50;213;71;202;121;415
316570;202004;1167;3429;953;3033;230;740;355;1150;585;1890
316580;202004;378;800;217;537;36;105;108;252;144;357
316590;202004;1285;3352;903;2600;182;476;459;1288;641;1764
316600;202004;916;2836;783;2565;124;438;424;1364;548;1802
316610;202004;575;1830;469;1667;48;219;284;979;332;1198
316620;202004;1937;5307;1693;4966;87;275;1312;3857;1399;4132
316630;202004;1503;4537;1222;4006;320;1063;499;1761;819;2824
316640;202004;140;368;109;321;17;56;50;122;67;178
316650;202004;1008;3231;805;2910;74;298;499;1831;573;2129
316660;202004;179;453;77;240;7;24;12;35;19;59
316670;202004;1761;4497;1286;3714;301;951;479;1349;780;2300
316680;202004;2214;5650;1615;4510;93;279;1238;3370;1331;3649
316690;202004;1321;3794;984;3175;171;602;452;1421;623;2023
316695;202004;1005;2921;820;2584;34;142;562;1736;596;1878
316700;202004;397;930;328;848;15;49;254;615;269;664
316710;202004;2920;9639;2217;8154;465;1827;868;3180;1333;5007
316720;202004;19705;54033;14290;43587;2550;8284;5984;17384;8534;25668
316730;202004;402;1115;322;960;41;140;169;467;210;607
316740;202004;690;2062;593;1903;63;232;375;1211;438;1443
316750;202004;373;1130;287;968;56;222;135;419;191;641
316760;202004;3464;11063;2819;9763;1127;4229;613;1999;1740;6228
316770;202004;1590;3670;1216;3144;24;74;992;2637;1016;2711
316780;202004;533;1593;409;1347;162;599;63;175;225;774
316790;202004;674;1822;472;1418;96;313;143;386;239;699
316800;202004;5970;16961;4741;14704;475;1710;2489;7435;2964;9145
316805;202004;987;2196;791;1982;58;164;615;1554;673;1718
316810;202004;606;1706;406;1290;74;274;208;619;282;893
316820;202004;295;709;161;466;10;34;79;212;89;246
316830;202004;694;1883;548;1646;70;257;351;1009;421;1266
316840;202004;2678;7030;2128;6086;187;670;1457;3965;1644;4635
316850;202004;1860;4932;1317;3931;206;663;589;1716;795;2379
316860;202004;18793;48457;13773;40907;2223;7665;6259;18126;8482;25791
316870;202004;7518;20604;5535;16761;825;2779;2484;7009;3309;9788
316880;202004;811;2205;654;1986;133;458;307;881;440;1339
316890;202004;1111;2467;640;1826;96;349;372;962;468;1311
316900;202004;2147;5849;1640;4819;332;1077;536;1453;868;2530
316905;202004;505;1515;404;1315;102;361;162;539;264;900
316910;202004;873;2296;529;1677;134;469;44;130;178;599
316920;202004;1654;4122;1119;3303;215;687;484;1391;699;2078
316930;202004;7196;20905;5214;17260;1167;4157;1368;4313;2535;8470
316935;202004;3916;10683;2829;8628;512;1684;1130;3316;1642;5000
316940;202004;6243;18456;4737;15299;729;2612;1845;5539;2574;8151
316950;202004;1822;4326;1413;3765;43;137;1170;3070;1213;3207
316960;202004;4994;11303;3580;9343;347;999;2411;6143;2758;7142
316970;202004;3613;10365;3134;9453;486;1542;1340;3864;1826;5406
316980;202004;643;1936;483;1628;158;588;66;237;224;825
316990;202004;10438;28443;7265;21873;1986;6472;1051;2842;3037;9314
317000;202004;2517;7444;2211;6994;164;491;1635;5205;1799;5696
317005;202004;2529;7258;1994;6148;323;1057;1043;3153;1366;4210
317010;202004;23622;55448;14351;41206;2928;9253;5315;15790;8243;25043
317020;202004;62165;147771;35157;100570;6418;20190;10672;28232;17090;48422
317030;202004;663;1772;511;1564;18;83;393;1187;411;1270
317040;202004;10735;27292;7400;21496;1629;5121;2664;7928;4293;13049
317043;202004;836;1885;589;1542;55;153;423;1093;478;1246
317047;202004;1139;2760;779;2175;87;244;481;1310;568;1554
317050;202004;1148;3534;800;2723;108;386;330;989;438;1375
317052;202004;2311;6559;1857;5812;271;849;1133;3562;1404;4411
317057;202004;1793;4367;1309;3563;35;139;847;2279;882;2418
317060;202004;451;1197;268;824;31;106;119;326;150;432
317065;202004;1146;3391;930;2967;55;192;578;1738;633;1930
317070;202004;7379;20236;5112;15873;979;3444;1441;4217;2420;7661
317075;202004;890;2320;634;1871;102;337;273;732;375;1069
317080;202004;5978;14080;4389;11526;1187;3357;1421;3589;2608;6946
317090;202004;4393;13202;3899;12396;299;926;2880;9204;3179;10130
317100;202004;2639;6291;1664;4653;377;1103;610;1653;987;2756
317103;202004;1978;5650;1664;5150;93;468;1228;3625;1321;4093
317107;202004;1386;3705;1050;3056;73;263;647;1680;720;1943
317110;202004;709;1641;359;1093;54;192;120;382;174;574
317115;202004;1051;3019;892;2733;53;141;607;1874;660;2015
317120;202004;12434;34061;9660;29542;1094;3918;5469;16230;6563;20148
317130;202004;10815;25245;6702;18433;1095;3370;2189;6011;3284;9381
317140;202004;789;1957;595;1665;41;117;412;1187;453;1304
317150;202004;982;2362;730;2045;31;96;569;1569;600;1665
317160;202004;3532;8560;2298;6575;173;542;1272;3710;1445;4252
317170;202004;1785;4459;1267;3563;219;722;519;1264;738;1986
317180;202004;1897;5977;1386;4733;272;986;347;1114;619;2100
317190;202004;1200;3237;883;2743;102;330;517;1592;619;1922
317200;202004;4846;12743;3641;10655;990;3138;745;2011;1735;5149
317210;202004;1160;2849;900;2494;26;103;665;1877;691;1980
317220;202004;244;756;207;684;49;165;76;269;125;434
320010;202004;4409;12886;3529;11138;359;1264;2301;7091;2660;8355
320013;202004;1823;5120;1198;3840;184;599;526;1754;710;2353
320016;202004;2967;7619;2307;6605;159;432;1763;5068;1922;5500
320020;202004;3816;9966;2793;8194;622;2010;983;3020;1605;5030
320030;202004;1678;4699;1075;3475;202;716;383;1182;585;1898
320035;202004;1875;5183;1518;4547;377;1257;640;1864;1017;3121
320040;202004;3825;10943;3129;9647;449;1477;1750;5251;2199;6728
320050;202004;1727;3948;1483;3588;183;533;885;2057;1068;2590
320060;202004;11683;32547;8668;26610;1313;4464;4090;11971;5403;16435
320070;202004;1411;4004;973;3106;178;633;345;1066;523;1699
320080;202004;5521;14252;3855;10982;804;2438;1392;3761;2196;6199
320090;202004;8041;21664;5247;15802;1157;3741;1889;5330;3046;9071
320100;202004;2778;7788;2237;6827;369;1279;1192;3601;1561;4880
320110;202004;1832;4395;1232;3397;176;514;604;1602;780;2116
320115;202004;1780;5753;1518;5312;649;2393;424;1532;1073;3925
320120;202004;20599;52930;13975;41118;2012;6461;6361;17941;8373;24402
320130;202004;43422;121530;35422;106975;4729;15785;20541;60335;25270;76120
320140;202004;3417;9448;2290;7212;348;1255;920;2868;1268;4123
320150;202004;12705;33145;8842;25638;2330;7389;1567;4040;3897;11429
320160;202004;5466;15386;3972;12516;670;2309;1862;5748;2532;8057
320170;202004;1494;4344;1072;3503;281;908;419;1449;700;2357
320180;202004;679;2164;548;1903;209;772;148;479;357;1251
320190;202004;2672;8600;2051;7219;502;1877;536;1797;1038;3674
320200;202004;1186;3204;803;2499;181;612;299;946;480;1558
320210;202004;4309;11048;3292;9269;524;1611;1754;4736;2278;6347
320220;202004;2550;6859;1894;5761;343;1154;908;2636;1251;3790
320225;202004;1330;4153;931;3184;336;1234;190;645;526;1879
320230;202004;4673;13099;3517;11155;823;2835;1354;4198;2177;7033
320240;202004;14955;38466;10951;31992;2609;8306;3722;10599;6331;18905
320245;202004;2947;8824;2336;7571;890;3029;455;1448;1345;4477
320250;202004;2021;5820;1317;4127;312;1085;367;1029;679;2114
320255;202004;1756;5562;1513;5127;418;1451;738;2600;1156;4051
320260;202004;1313;3740;800;2581;173;627;196;528;369;1155
320265;202004;2402;7467;1956;6568;909;3223;350;1185;1259;4408
320270;202004;2145;6213;1611;5160;381;1312;641;2065;1022;3377
320280;202004;6556;17732;5242;15459;1152;3653;2304;6573;3456;10226
320290;202004;1306;3907;837;2754;220;794;215;666;435;1460
320300;202004;3483;10666;2776;9194;810;2881;639;1981;1449;4862
320305;202004;5053;14396;3898;12088;746;2512;1888;5655;2634;8167
320310;202004;1991;5601;1348;4223;253;824;575;1734;828;2558
320313;202004;2279;5774;1431;4141;306;1001;370;984;676;1985
320316;202004;1419;4027;1146;3567;170;547;711;2220;881;2767
320320;202004;20873;55097;14590;44253;3406;10847;5351;16310;8757;27157
320330;202004;2929;7977;2255;6749;426;1267;1179;3611;1605;4878
320332;202004;6411;17621;5030;15183;1242;4019;2250;6752;3492;10771
320334;202004;1661;4777;1167;3768;254;978;271;689;525;1667
320335;202004;1331;3964;915;2992;233;842;231;695;464;1537
320340;202004;4671;11806;3864;10611;499;1510;2273;6272;2772;7782
320350;202004;5203;13013;3622;10126;459;1367;1896;5054;2355;6421
320360;202004;1387;3561;1023;2873;122;330;521;1412;643;1742
320370;202004;2533;7831;1865;6357;572;2044;592;1998;1164;4042
320380;202004;2439;6613;2018;5925;236;749;1277;3659;1513;4408
320390;202004;6909;18838;5071;15156;1067;3388;2034;5747;3101;9135
320400;202004;3182;9080;2421;7464;682;2235;868;2555;1550;4790
320405;202004;4417;11769;3297;9860;554;1781;1514;4464;2068;6245
320410;202004;4681;12230;3498;10311;624;1817;1750;5382;2374;7199
320420;202004;2911;7731;2189;6490;658;2214;400;1178;1058;3392
320425;202004;2050;4962;1555;4136;92;276;1029;2661;1121;2937
320430;202004;2907;7316;2272;6164;296;897;1460;3793;1756;4690
320435;202004;2145;6729;1686;5818;601;2189;514;1796;1115;3985
320440;202004;1360;3764;980;3035;148;492;449;1348;597;1840
320450;202004;1586;4618;1228;3932;276;1003;539;1606;815;2609
320455;202004;3982;12116;2637;8929;667;2428;636;1966;1303;4394
320460;202004;2015;5994;1400;4665;339;1212;346;1067;685;2279
320465;202004;1142;3283;870;2756;117;397;493;1567;610;1964
320470;202004;3633;10049;2523;7674;573;1849;603;1637;1176;3486
320480;202004;1610;4490;1307;3973;199;698;763;2241;962;2939
320490;202004;20575;54110;14994;44218;2544;8213;6220;18169;8764;26382
320495;202004;1255;3455;867;2701;189;675;328;974;517;1649
320500;202004;51816;138151;41097;119554;5769;18211;23685;66114;29454;84325
320501;202004;4251;12369;3118;10307;888;3267;1048;3402;1936;6669
320503;202004;2283;6593;1499;4976;406;1471;438;1363;844;2834
320506;202004;2359;7092;1670;5549;509;1843;183;601;692;2444
320510;202004;9708;26375;7810;23077;873;2998;4846;13851;5719;16849
320515;202004;1674;4607;1280;3805;352;1140;426;1223;778;2363
320517;202004;2050;6248;1624;5338;535;1913;463;1491;998;3404
320520;202004;34571;89887;25518;74601;4566;14723;10697;30332;15263;45055
320530;202004;30074;80287;23415;68466;2282;7906;14588;40416;16870;48322
330010;202004;21001;56570;16992;49790;2383;7486;10697;30709;13080;38195
330015;202004;1471;3635;1137;3121;201;625;615;1600;816;2225
330020;202004;19893;49662;16656;44953;2385;7237;11478;30236;13863;37473
330022;202004;1845;5001;1414;4249;240;741;821;2449;1061;3190
330023;202004;4896;11710;3447;9656;598;1846;1858;5081;2456;6927
330025;202004;5004;12239;3223;9227;885;2771;776;2108;1661;4879
330030;202004;10110;27130;7591;22939;830;2903;4623;13362;5453;16265
330040;202004;14432;37643;11352;32386;1095;3512;7573;20756;8668;24268
330045;202004;83319;197286;68076;177993;5100;13396;54003;140552;59103;153948
330050;202004;2445;6513;1774;5368;362;1185;841;2418;1203;3603
330060;202004;4826;12873;3906;11231;778;2478;1705;4512;2483;6990
330070;202004;22513;57095;17984;50432;2865;8547;10539;29375;13404;37922
330080;202004;8729;22160;7392;20243;929;2702;5109;13824;6038;16526
330090;202004;3332;6968;2248;5502;143;375;1561;3840;1704;4215
330093;202004;2395;5906;1757;5000;112;351;1333;3798;1445;4149
330095;202004;1215;3454;926;2902;75;286;562;1627;637;1913
330100;202004;69443;185128;58845;169295;3615;12453;44820;127084;48435;139537
330110;202004;2066;5798;1648;5081;272;923;918;2728;1190;3651
330115;202004;2285;5563;1653;4622;234;761;975;2610;1209;3371
330120;202004;3502;7864;2596;6689;226;654;1787;4435;2013;5089
330130;202004;4215;11560;3418;10339;481;1530;2117;6346;2598;7876
330140;202004;3621;9474;2831;8321;409;1333;1793;5141;2202;6474
330150;202004;2151;5749;1623;4902;292;936;782;2304;1074;3240
330160;202004;1346;3664;999;3045;174;577;528;1536;702;2113
330170;202004;104335;260927;82752;231505;11132;30995;55090;156173;66222;187168
330180;202004;1975;4771;1509;4112;98;304;1038;2755;1136;3059
330185;202004;9528;24075;7907;21799;493;1666;6287;16900;6780;18566
330187;202004;4221;10762;3250;9172;452;1394;1883;5277;2335;6671
330190;202004;32682;79485;27451;72270;1934;5518;21665;56383;23599;61901
330200;202004;15693;40068;12629;36262;2477;6786;7878;23297;10355;30083
330205;202004;2029;5040;1526;4223;85;287;1066;2824;1151;3111
330210;202004;3390;8565;2431;6866;352;1097;1170;3055;1522;4152
330220;202004;11414;28573;7974;22768;1721;5516;2754;7285;4475;12801
330225;202004;3724;9421;2770;7963;191;665;1991;5592;2182;6257
330227;202004;17398;41875;14487;38305;582;1730;12384;32361;12966;34091
330230;202004;1770;4059;1225;3370;109;312;790;2170;899;2482
330240;202004;23415;61022;18996;54045;2417;7527;12338;34281;14755;41808
330245;202004;1641;4095;973;2918;196;621;359;1084;555;1705
330250;202004;37430;96181;30817;86379;5465;15670;18578;52111;24043;67781
330260;202004;4396;10770;3250;9206;348;1105;2205;6059;2553;7164
330270;202004;28721;63303;17536;45651;2890;8074;7121;17923;10011;25997
330280;202004;2320;6130;1728;5113;189;615;1013;2893;1202;3508
330285;202004;22855;55207;17923;48102;1449;4540;13056;33890;14505;38430
330290;202004;3678;9018;2920;8012;322;987;2039;5437;2361;6424
330300;202004;5682;13457;4057;11096;308;955;2807;7550;3115;8505
330310;202004;2559;6359;1826;5133;123;315;1211;3403;1334;3718
330320;202004;16403;38978;12375;33934;1395;3815;8919;24574;10314;28389
330330;202004;36012;79480;27373;67895;2476;6752;19650;47888;22126;54640
330340;202004;14241;35267;10309;29073;1681;5261;5227;14118;6908;19379
330350;202004;130764;305334;106119;275228;6942;18814;86279;222894;93221;241708
330360;202004;7401;17986;6329;16670;206;556;5357;14047;5563;14603
330370;202004;4700;13522;3530;11506;811;2707;1483;5039;2294;7746
330380;202004;5328;14371;3972;11925;707;2448;1943;5558;2650;8006
330385;202004;3885;11229;3137;10125;757;2699;1491;4763;2248;7462
330390;202004;25815;69904;19394;58669;2767;9580;11035;31586;13802;41166
330395;202004;3148;7835;2575;7079;161;512;1854;4995;2015;5507
330400;202004;3192;8530;2685;7727;141;518;2027;5514;2168;6032
330410;202004;3169;8500;2254;6882;426;1425;1015;2955;1441;4380
330411;202004;2745;7441;2106;6221;146;511;1470;4188;1616;4699
330412;202004;1472;4181;1175;3689;130;479;719;2123;849;2602
330414;202004;22955;57913;18337;51596;1587;4618;13374;37360;14961;41978
330415;202004;4146;11264;3186;9588;323;1032;1899;5683;2222;6715
330420;202004;10714;26534;7267;20933;928;3031;3666;9910;4594;12941
330430;202004;9432;22712;7858;20538;323;1064;6165;15634;6488;16698
330440;202004;2414;6543;1788;5466;303;1082;991;2891;1294;3973
330450;202004;1281;3672;1014;3219;142;495;550;1714;692;2209
330452;202004;16290;41749;12866;36502;1692;5393;8073;22249;9765;27642
330455;202004;546883;1296655;414882;1106062;59344;168683;261124;685680;320468;854363
330460;202004;1183;3231;875;2774;155;522;471;1457;626;1979
330470;202004;4796;12000;3423;9856;1094;3252;1018;3023;2112;6275
330475;202004;9423;24481;7567;22046;1197;4012;4825;13745;6022;17757
330480;202004;5879;15245;4909;13821;401;1261;3406;9322;3807;10583
330490;202004;112074;258969;90164;229498;9964;26368;64570;163231;74534;189599
330500;202004;7307;18033;6056;16314;618;1867;4380;11632;4998;13499
330510;202004;39928;98935;29288;83768;4912;15040;17673;49893;22585;64933
330513;202004;1204;3130;940;2758;204;645;471;1392;675;2037
330515;202004;2451;6472;1934;5745;368;1182;1064;3085;1432;4267
330520;202004;11205;29617;9018;26136;1199;3838;5489;15525;6688;19363
330530;202004;1620;3958;1194;3320;248;746;549;1503;797;2249
330540;202004;2871;7624;2201;6462;508;1551;937;2667;1445;4218
330550;202004;8892;23198;6723;20320;1908;6264;2688;8048;4596;14312
330555;202004;17153;36703;14149;33154;849;2225;11335;26825;12184;29050
330560;202004;4128;11055;3302;9660;505;1522;1955;5587;2460;7109
330570;202004;2686;7410;2237;6715;353;1139;1438;4284;1791;5423
330575;202004;5459;14097;4680;12767;283;886;3743;9880;4026;10766
330580;202004;16755;44954;12749;37650;2362;7575;5964;16863;8326;24438
330590;202004;1439;3888;1181;3554;219;654;732;2245;951;2899
330600;202004;11555;30607;9310;26950;914;3088;5880;16559;6794;19647
330610;202004;9210;24570;7390;21696;578;2010;5161;14750;5739;16760
330615;202004;2050;5619;1579;4969;302;976;974;3129;1276;4105
330620;202004;3995;11420;3120;9888;702;2409;1312;3905;2014;6314
330630;202004;23907;60013;18597;51677;1389;4555;13207;35511;14596;40066
350010;202004;2041;5236;1014;3036;219;710;176;384;395;1094
350020;202004;685;1756;379;1167;46;149;154;431;200;580
350030;202004;3522;9877;2580;8218;648;2252;1044;3168;1692;5420
350040;202004;694;1995;387;1330;54;214;124;333;178;547
350050;202004;1192;2952;754;2175;173;585;253;586;426;1171
350055;202004;906;2398;694;2047;77;251;397;1113;474;1364
350060;202004;131;327;79;230;12;40;42;127;54;167
350070;202004;3359;8874;2085;6535;418;1459;628;1792;1046;3251
350075;202004;561;1665;414;1364;172;607;29;90;201;697
350080;202004;634;1644;395;1212;54;185;156;435;210;620
350090;202004;583;1378;346;958;70;209;148;386;218;595
350100;202004;2174;5832;1461;4553;116;450;874;2574;990;3024
350110;202004;474;1206;320;933;19;72;182;519;201;591
350115;202004;1257;3650;1021;3147;191;656;512;1421;703;2077
350120;202004;634;1479;333;904;36;115;169;402;205;517
350130;202004;2996;7941;2326;6709;413;1224;1133;3113;1546;4337
350140;202004;761;2157;495;1613;48;217;269;803;317;1020
350150;202004;493;1504;399;1320;92;295;109;336;201;631
350160;202004;10668;26656;6988;19965;911;2970;4183;11293;5094;14263
350170;202004;2021;5857;1575;4878;309;1012;648;1869;957;2881
350180;202004;1014;2520;502;1515;112;349;75;209;187;558
350190;202004;2786;7897;1888;5969;358;1306;778;2091;1136;3397
350200;202004;406;1156;316;990;17;58;208;621;225;679
350210;202004;5445;12474;3620;9727;487;1412;2200;5710;2687;7122
350220;202004;2834;7800;1882;5890;414;1371;611;1734;1025;3105
350230;202004;1021;2628;834;2352;157;475;460;1255;617;1730
350240;202004;627;1834;398;1295;83;270;108;332;191;602
350250;202004;2289;6609;1693;5602;606;2195;306;1057;912;3252
350260;202004;801;1915;503;1395;56;172;303;813;359;985
350270;202004;4373;11828;3443;10035;539;1715;1801;4898;2340;6613
350275;202004;2335;6292;1837;5478;300;1001;1070;3027;1370;4028
350280;202004;18208;40780;10500;28302;1819;5200;3950;10223;5769;15423
350290;202004;3088;8515;2045;6350;375;1275;812;2348;1187;3623
350300;202004;619;1695;452;1373;67;202;234;675;301;877
350310;202004;857;2477;615;1976;107;400;232;672;339;1072
350315;202004;559;1412;363;1074;24;85;182;498;206;583
350320;202004;14721;37804;10654;30573;2293;7250;3912;10455;6205;17705
350330;202004;13868;34173;9685;26045;1066;3175;6044;15265;7110;18440
350335;202004;352;1002;270;849;34;120;134;394;168;514
350340;202004;1140;2939;673;2074;118;409;259;721;377;1130
350350;202004;732;1867;558;1669;68;248;330;965;398;1213
350360;202004;1086;3217;826;2669;221;725;252;830;473;1555
350370;202004;602;1514;408;1161;143;383;118;356;261;739
350380;202004;4072;11174;2798;8578;791;2410;688;2152;1479;4562
350390;202004;9887;26416;7608;22479;1746;5340;3221;9290;4967;14630
350395;202004;423;1085;216;683;23;69;75;212;98;281
350400;202004;7867;19402;5373;15265;1324;4058;1486;4150;2810;8208
350410;202004;9285;25979;6595;20713;1433;5026;2402;6977;3835;12003
350420;202004;666;1776;467;1374;78;258;115;292;193;550
350430;202004;643;1742;515;1528;68;238;313;851;381;1089
350440;202004;1974;4985;1586;4393;117;352;1045;2834;1162;3186
350450;202004;6594;18112;5073;15446;1121;3732;2095;5977;3216;9709
350460;202004;1682;4369;836;2603;146;481;175;482;321;963
350470;202004;249;632;192;535;10;31;133;357;143;388
350480;202004;936;2370;579;1728;121;420;115;277;236;697
350490;202004;1821;4819;1286;3942;302;968;392;1104;694;2072
350500;202004;684;1819;516;1510;69;215;256;703;325;918
350510;202004;1121;2929;820;2378;92;302;479;1332;571;1634
350520;202004;2079;6373;1589;5397;267;998;696;2149;963;3147
350530;202004;2691;6747;1957;5374;220;671;1159;2995;1379;3666
350535;202004;1359;3739;1159;3455;170;574;726;2091;896;2665
350540;202004;1805;4409;1313;3662;179;510;783;2134;962;2644
350550;202004;8270;20418;5678;16125;622;2091;3316;8764;3938;10855
350560;202004;3894;10981;3063;9468;302;998;1886;5642;2188;6640
350570;202004;24098;67279;19225;57745;3652;12015;9636;27731;13288;39746
350580;202004;2008;5450;1129;3554;290;989;202;526;492;1515
350590;202004;4742;12954;3411;9968;476;1569;1976;5342;2452;6911
350600;202004;35397;81813;21580;57615;3220;9660;10166;24999;13386;34659
350610;202004;6498;17904;4598;14073;826;2771;2100;6112;2926;8883
350620;202004;391;997;250;793;27;92;146;443;173;535
350630;202004;1421;3702;1029;2993;72;270;663;1798;735;2068
350635;202004;8325;20788;6201;17506;1031;3221;3500;9367;4531;12588
350640;202004;892;2443;474;1491;73;234;132;360;205;594
350650;202004;7811;20975;5199;15767;1024;3362;1843;5187;2867;8549
350660;202004;4504;11846;3440;10066;578;1715;1772;5193;2350;6908
350670;202004;1834;4871;1497;4380;157;479;1004;2937;1161;3416
350680;202004;1101;2991;723;2280;138;443;281;847;419;1290
350690;202004;1263;3259;878;2610;148;476;472;1355;620;1831
350700;202004;4629;11733;3186;9482;585;2000;1368;3824;1953;5824
350710;202004;2688;7474;2244;6680;391;1344;1201;3303;1592;4647
350715;202004;807;2312;656;2034;71;288;357;1005;428;1293
350720;202004;152;399;112;330;17;49;34;80;51;129
350730;202004;589;1579;491;1409;28;108;372;1002;400;1110
350740;202004;1548;4194;1030;3122;207;658;319;902;526;1560
350745;202004;592;1493;317;962;40;150;123;336;163;486
350750;202004;9685;25172;7265;20956;1299;4338;3266;8416;4565;12754
350760;202004;13334;33430;9292;26387;2084;6536;3547;9096;5631;15632
350770;202004;961;2414;594;1760;39;125;378;1097;417;1222
350775;202004;647;1536;434;1212;42;124;212;587;254;711
350780;202004;1975;4904;1378;4034;249;814;502;1672;751;2486
350790;202004;1611;4323;985;3162;197;686;266;700;463;1386
350800;202004;3319;9661;2835;8803;247;871;1933;5828;2180;6699
350810;202004;2614;6488;2050;5663;301;809;1157;3260;1458;4069
350820;202004;905;2135;499;1400;52;175;244;611;296;786
350830;202004;836;2349;458;1497;72;227;138;397;210;624
350840;202004;2981;8801;2146;7178;515;1921;884;2693;1399;4614
350850;202004;6639;18554;5037;15635;1043;3508;2217;6611;3260;10119
350860;202004;3543;9509;3022;8799;122;452;2289;6579;2411;7031
350870;202004;2587;7310;1878;6153;264;964;1030;3300;1294;4264
350880;202004;1224;3524;947;2973;243;788;275;829;518;1617
350890;202004;525;1352;325;936;50;151;119;314;169;465
350900;202004;6784;18427;4193;12861;985;3325;1238;3444;2223;6769
350910;202004;860;2164;729;1961;85;245;523;1379;608;1624
350920;202004;11600;28922;9675;25760;446;1457;7776;19946;8222;21403
350925;202004;4314;11770;3050;9452;587;1969;1426;4079;2013;6048
350930;202004;1433;3766;973;2856;96;291;588;1691;684;1982
350940;202004;2211;5877;1686;5012;183;602;1057;3032;1240;3634
350945;202004;823;2308;606;1886;93;341;322;912;415;1253
350950;202004;84078;217177;63674;178583;8587;26534;38279;102396;46866;128930
350960;202004;6255;17040;4812;14300;584;1991;2860;8062;3444;10053
350970;202004;3506;9931;2508;7980;748;2663;480;1296;1228;3959
350980;202004;628;1737;505;1519;133;425;225;669;358;1094
350990;202004;1708;4805;1236;4021;303;1110;428;1304;731;2414
350995;202004;746;2337;667;2177;54;218;469;1456;523;1674
351000;202004;2734;7123;1909;5644;333;1042;723;2065;1056;3107
351010;202004;319;790;210;605;24;81;113;313;137;394
351015;202004;762;2311;611;1988;91;334;289;846;380;1180
351020;202004;8556;23442;6441;19769;1342;4231;3105;9296;4447;13527
351030;202004;2761;8236;2208;7093;326;1154;1181;3693;1507;4847
351040;202004;4925;12236;4094;10979;209;684;3342;8718;3551;9402
351050;202004;16914;41320;11871;33351;2429;7221;5039;13997;7468;21218
351060;202004;48059;121155;36238;100648;3822;11681;24051;64646;27873;76327
351070;202004;1428;3550;765;2376;187;633;130;390;317;1023
351080;202004;2760;6673;1937;5687;222;787;1289;3591;1511;4378
351090;202004;313;921;220;745;47;158;59;199;106;357
351100;202004;2461;6660;1562;4812;347;1120;448;1428;795;2548
351110;202004;6049;15480;3852;11363;652;2114;1619;4460;2271;6574
351120;202004;770;1958;506;1518;57;180;191;568;248;748
351130;202004;1130;2967;488;1576;92;300;108;338;200;638
351140;202004;1916;5556;1399;4525;305;1118;537;1573;842;2691
351150;202004;2279;6526;1468;4722;263;942;561;1592;824;2534
351160;202004;1113;3463;827;2787;180;644;215;630;395;1274
351170;202004;1362;3746;1172;3399;94;295;827;2328;921;2623
351190;202004;995;2761;641;2024;118;379;229;665;347;1044
351200;202004;1573;3778;1154;3156;92;285;807;2080;899;2365
351210;202004;1493;3688;900;2547;76;256;530;1390;606;1646
351220;202004;3179;9046;2691;8239;318;1010;1760;5349;2078;6359
351230;202004;1724;4703;1253;3863;226;801;557;1565;783;2366
351240;202004;2360;6052;1407;4035;298;898;534;1377;832;2275
351250;202004;1039;2788;596;1883;78;262;212;666;290;928
351260;202004;885;2241;630;1781;129;358;233;641;362;999
351270;202004;408;1111;336;986;33;114;201;508;234;622
351280;202004;3710;9762;2797;8046;527;1554;1296;3607;1823;5161
351290;202004;1196;2980;813;2309;114;345;471;1289;585;1634
351300;202004;16654;45523;11106;34697;2043;6926;4584;13781;6627;20707
351310;202004;3293;8102;2457;6794;186;649;1768;4620;1954;5269
351320;202004;878;2559;637;2041;127;437;219;628;346;1065
351330;202004;468;1098;383;942;26;80;277;614;303;694
351340;202004;6275;17908;4993;15642;1199;3932;2192;6822;3391;10754
351350;202004;11414;28568;9352;25308;1003;2914;6799;17910;7802;20824
351360;202004;3723;10032;3052;9008;742;2340;1171;3204;1913;5544
351370;202004;2032;5692;1341;4238;321;1095;426;1225;747;2320
351380;202004;46277;112558;32136;87648;4303;12597;17910;46719;22213;59316
351385;202004;320;849;153;466;25;76;46;132;71;208
351390;202004;1351;3295;798;2475;119;433;449;1305;568;1738
351400;202004;908;2557;745;2217;122;365;449;1304;571;1669
351410;202004;2599;7248;1829;5731;327;1054;708;2172;1035;3226
351420;202004;393;928;212;609;24;61;124;336;148;397
351430;202004;914;2511;692;2139;62;190;461;1395;523;1585
351440;202004;3217;8498;2049;6062;377;1163;561;1427;938;2590
351450;202004;1639;4379;1039;3243;213;730;152;363;365;1093
351460;202004;803;2105;614;1793;150;430;330;961;480;1391
351470;202004;1171;2966;892;2496;84;288;578;1513;662;1801
351480;202004;2463;7270;1924;6301;368;1328;812;2487;1180;3815
351490;202004;1921;5472;1625;4941;73;296;1306;3827;1379;4123
351492;202004;335;912;276;788;8;24;204;570;212;594
351495;202004;178;463;129;365;17;43;67;188;84;231
351500;202004;36068;89417;26502;73098;4087;12129;15346;40511;19433;52640
351510;202004;12816;31974;9188;25605;1144;3642;5661;15012;6805;18654
351512;202004;463;1255;326;952;59;171;116;313;175;484
351515;202004;3109;6926;1875;4997;320;961;542;1549;862;2510
351518;202004;2383;6014;1506;4425;204;675;829;2205;1033;2880
351519;202004;709;1969;429;1407;89;286;62;194;151;480
351520;202004;1210;2999;477;1480;52;180;191;517;243;697
351530;202004;341;901;194;580;26;80;77;181;103;261
351535;202004;1852;4512;1311;3591;210;624;665;1730;875;2354
351540;202004;2263;5655;1464;4266;301;1009;493;1265;794;2274
351550;202004;6804;16884;4433;12527;452;1489;2506;6600;2958;8089
351560;202004;438;1256;335;1049;84;287;100;286;184;573
351565;202004;196;558;154;481;40;141;42;114;82;255
351570;202004;19741;53461;14692;43036;1638;5199;8920;25024;10558;30223
351580;202004;243;625;136;418;13;41;59;187;72;228
351590;202004;501;1137;262;721;22;76;145;362;167;438
351600;202004;1322;3485;1008;2907;91;286;616;1674;707;1960
351610;202004;725;1723;452;1245;28;87;258;669;286;756
351620;202004;22268;59204;16062;48317;2673;9092;7203;19608;9876;28700
351630;202004;25846;68581;20418;59078;3106;9428;12362;34749;15468;44177
351640;202004;16132;42956;12337;35921;1229;4104;8297;23234;9526;27338
351650;202004;371;981;166;538;20;70;47;130;67;200
351660;202004;735;2080;458;1446;88;295;66;163;154;458
351670;202004;5889;15824;3756;11149;810;2396;1616;4526;2426;6922
351680;202004;436;1246;273;880;44;138;65;173;109;311
351685;202004;421;1204;336;1065;92;293;104;311;196;604
351690;202004;1049;2677;598;1756;82;271;252;664;334;935
351700;202004;1355;3381;960;2682;163;470;522;1377;685;1847
351710;202004;713;1925;493;1506;47;164;257;713;304;877
351720;202004;1396;3631;907;2764;144;475;364;1052;508;1527
351730;202004;889;2319;737;2081;57;201;491;1325;548;1526
351740;202004;3472;8748;2690;7246;476;1382;1331;3326;1807;4708
351750;202004;1319;3486;813;2562;154;496;303;935;457;1431
351760;202004;3234;9149;2316;7272;476;1706;833;2349;1309;4055
351770;202004;1724;5146;1396;4496;270;922;718;2252;988;3174
351780;202004;1223;3144;710;2156;103;362;239;692;342;1054
351790;202004;1320;3153;1021;2757;165;459;597;1624;762;2083
351800;202004;507;1168;240;665;21;59;89;211;110;270
351810;202004;1010;2636;813;2336;34;104;598;1637;632;1741
351820;202004;2463;6929;1693;5426;439;1535;371;1100;810;2635
351830;202004;4405;11907;3344;10057;329;1211;2070;5897;2399;7108
351840;202004;8407;23327;6221;19218;911;3134;3207;9292;4118;12426
351850;202004;1573;4259;1016;3171;170;614;344;917;514;1531
351860;202004;2723;7905;2085;6705;366;1255;1124;3645;1490;4900
351870;202004;23223;59428;17190;49413;4637;13686;6770;19865;11407;33551
351880;202004;120103;312245;87680;255902;20884;66934;37553;104670;58437;171604
351885;202004;900;2425;705;2093;68;248;461;1300;529;1548
351890;202004;761;2004;488;1543;117;388;75;201;192;589
351900;202004;1077;2888;830;2514;119;360;468;1410;587;1770
351905;202004;395;1070;269;825;20;72;119;316;139;388
351907;202004;20558;54090;15677;45311;1866;5922;9948;27770;11814;33692
351910;202004;1432;3794;984;2808;69;218;558;1440;627;1658
351920;202004;834;2217;629;1823;96;322;287;765;383;1087
351925;202004;844;2276;647;1902;79;273;346;945;425;1218
351930;202004;3165;8904;2834;8298;586;1717;1875;5434;2461;7151
351940;202004;1060;2739;751;2193;117;373;372;1069;489;1442
351950;202004;1603;3741;1156;3058;63;185;797;2046;860;2231
351960;202004;5138;12998;3676;10380;814;2455;1645;4326;2459;6781
351970;202004;7042;20995;5523;18280;873;3215;2994;9629;3867;12844
351980;202004;990;2343;621;1739;88;278;351;909;439;1187
351990;202004;1384;3277;984;2690;57;212;470;1169;527;1381
352000;202004;2535;7254;2161;6487;265;909;1409;3953;1674;4862
352010;202004;2181;5863;1718;5074;448;1442;367;1114;815;2556
352020;202004;1430;3929;1087;3335;173;572;521;1516;694;2088
352030;202004;5322;14195;4119;12246;814;2656;2070;5991;2884;8647
352040;202004;2823;7608;1872;5644;277;929;675;1726;952;2655
352042;202004;2955;7231;1896;5522;379;1243;798;2230;1177;3473
352044;202004;2055;5502;1159;3763;183;678;254;756;437;1434
352050;202004;11706;31162;7304;22367;1834;6429;1289;3274;3123;9703
352060;202004;682;1837;493;1488;66;215;225;627;291;842
352070;202004;898;1809;567;1370;63;163;267;573;330;736
352080;202004;453;1146;267;766;28;96;100;254;128;350
352090;202004;1423;4182;1160;3649;129;480;558;1590;687;2070
352100;202004;2984;8492;2431;7454;547;1847;1117;3263;1664;5110
352110;202004;559;1646;427;1385;96;328;166;500;262;828
352115;202004;495;1355;405;1217;51;182;235;690;286;872
352120;202004;860;2581;695;2239;86;286;405;1226;491;1512
352130;202004;1880;5345;1238;3751;204;661;486;1355;690;2016
352140;202004;1121;3040;779;2369;144;468;364;1069;508;1537
352150;202004;816;2205;627;1876;83;266;415;1205;498;1471
352160;202004;958;2375;684;1947;77;266;375;1016;452;1282
352170;202004;2907;7858;2261;6561;337;1092;1318;3530;1655;4622
352180;202004;2506;6797;1911;5686;451;1514;562;1457;1013;2971
352190;202004;1178;3191;917;2788;165;476;442;1407;607;1883
352200;202004;337;1013;233;800;32;121;88;291;120;412
352210;202004;19087;45501;14840;39859;1057;3156;11337;29930;12394;33086
352215;202004;607;1605;520;1481;63;196;340;930;403;1126
352220;202004;18467;46359;12008;34621;2775;8439;4326;11793;7101;20232
352230;202004;13128;38407;9939;32310;2384;8642;3616;10835;6000;19477
352240;202004;10486;27015;7929;22694;1732;5599;3438;9061;5170;14660
352250;202004;23245;64962;18386;56437;3043;9971;10815;32646;13858;42617
352260;202004;4794;12035;3213;8948;472;1516;1820;4563;2292;6079
352265;202004;897;2484;786;2323;46;172;600;1715;646;1887
352270;202004;1420;4252;1043;3420;225;801;364;1108;589;1909
352280;202004;2398;6117;1807;5243;191;681;1060;2839;1251;3520
352290;202004;1140;3320;911;2865;124;437;485;1383;609;1820
352300;202004;894;2429;585;1768;81;274;307;869;388;1143
352310;202004;44359;117972;32530;96991;8071;24745;13741;41172;21812;65917
352320;202004;6351;16860;4803;13799;743;2419;2528;6566;3271;8985
352330;202004;2150;5710;1597;4936;292;1062;829;2389;1121;3451
352340;202004;5441;14319;3914;11528;634;2142;1954;5284;2588;7426
352350;202004;2119;6044;1641;4968;179;663;894;2427;1073;3090
352360;202004;1228;3291;1012;2908;82;287;757;2089;839;2376
352370;202004;1043;2972;900;2735;19;77;724;2159;743;2236
352380;202004;815;2236;606;1852;122;386;219;630;341;1016
352390;202004;15057;36864;10096;28192;1639;5003;5541;14602;7180;19605
352400;202004;3426;9456;2789;8260;609;2101;1436;3935;2045;6036
352410;202004;3146;8105;2347;6757;225;781;1447;3958;1672;4739
352420;202004;826;2008;580;1646;107;320;215;576;322;896
352430;202004;7557;18916;5318;14976;1170;3744;2393;6345;3563;10089
352440;202004;17260;46942;12729;38103;3131;9717;4690;13707;7821;23424
352450;202004;765;1891;378;1209;52;182;129;387;181;569
352460;202004;2891;8050;1958;6305;403;1425;738;2227;1141;3652
352470;202004;3121;7799;2267;6425;284;903;1314;3526;1598;4429
352480;202004;3656;8693;2334;6323;370;1150;1126;2765;1496;3915
352490;202004;682;1985;540;1720;101;342;254;764;355;1106
352500;202004;10198;26377;6844;20043;2897;9343;763;1269;3660;10612
352510;202004;3598;9706;2665;8076;565;1862;1228;3524;1793;5386
352520;202004;2620;6895;1991;5829;391;1286;1085;2879;1476;4165
352530;202004;9576;24958;6078;18108;1145;3899;1639;4065;2784;7964
352540;202004;529;1599;379;1249;62;227;117;346;179;573
352550;202004;985;2764;684;2180;139;482;217;616;356;1098
352560;202004;570;1601;431;1325;77;250;202;582;279;832
352570;202004;2143;6246;1297;4331;321;1168;125;330;446;1498
352580;202004;651;1675;535;1471;48;157;359;938;407;1095
352585;202004;298;787;217;651;17;65;133;357;150;422
352590;202004;12918;33926;8888;26165;2345;7511;3808;10413;6153;17924
352600;202004;1942;5215;1497;4376;161;521;938;2593;1099;3114
352610;202004;2908;8165;2176;6885;440;1583;885;2626;1325;4209
352620;202004;5577;14359;4239;12401;1251;3762;1597;4718;2848;8480
352630;202004;806;2012;595;1693;109;357;273;705;382;1062
352640;202004;2890;7466;2043;5969;216;666;1171;3291;1387;3957
352650;202004;578;1642;399;1241;61;221;144;425;205;646
352660;202004;1017;2986;813;2561;127;420;417;1262;544;1682
352670;202004;8895;24048;5619;17508;1486;4924;1147;3452;2633;8376
352680;202004;3195;9536;2195;7232;359;1422;1065;3158;1424;4580
352690;202004;26062;65607;19906;55044;1379;4555;13914;36944;15293;41499
352700;202004;555;1384;402;1174;148;489;87;242;235;731
352710;202004;4896;12675;3409;9944;791;2553;1415;3784;2206;6337
352720;202004;7621;20887;5869;17573;2475;7540;1197;3395;3672;10935
352725;202004;549;1367;317;908;20;52;156;428;176;480
352730;202004;2724;7798;2245;6696;311;1029;1369;3771;1680;4800
352740;202004;2231;5248;1626;4362;173;547;1000;2530;1173;3077
352750;202004;387;969;223;674;36;117;88;237;124;354
352760;202004;1605;4484;1214;3698;138;439;635;1916;773;2355
352770;202004;862;2336;582;1779;122;386;229;670;351;1056
352780;202004;597;1702;420;1355;81;264;118;369;199;633
352790;202004;436;1166;296;879;27;90;114;301;141;391
352800;202004;1251;3886;873;2984;242;858;111;330;353;1188
352810;202004;1119;2667;694;1902;88;253;416;1074;504;1327
352820;202004;471;1288;321;1028;66;214;74;252;140;466
352830;202004;576;1468;256;787;23;71;55;136;78;207
352840;202004;3820;10944;3109;9675;1060;3556;995;3001;2055;6557
352850;202004;10480;25686;7032;20046;1917;5971;2200;5640;4117;11611
352860;202004;971;2680;702;2185;139;471;258;771;397;1242
352870;202004;855;2141;602;1621;38;126;401;1022;439;1148
352880;202004;1727;4070;1212;3175;183;500;706;1765;889;2265
352885;202004;295;827;217;686;24;84;130;390;154;474
352890;202004;679;1630;425;1108;46;128;240;566;286;694
352900;202004;17506;45695;11406;33602;1916;6019;5036;13966;6952;19985
352910;202004;422;1135;221;698;19;60;66;186;85;246
352920;202004;2636;6751;1897;5472;138;429;1293;3627;1431;4056
352930;202004;5494;14903;3983;11939;720;2356;1851;5152;2571;7508
352940;202004;21693;59454;15436;46156;3241;10622;6278;17716;9519;28338
352950;202004;493;1307;282;901;73;243;47;130;120;373
352960;202004;693;1860;368;1167;62;213;85;235;147;448
352965;202004;235;660;145;479;45;150;36;108;81;258
352970;202004;2944;7052;2223;5866;243;685;1448;3769;1691;4454
352980;202004;1369;3644;1080;3204;263;848;545;1571;808;2419
352990;202004;4053;11452;3155;9954;637;2219;1548;4676;2185;6895
353000;202004;452;1245;239;748;37;123;53;138;90;261
353010;202004;2472;6120;1608;4601;343;1126;652;1708;995;2834
353020;202004;3539;9207;2014;5981;285;960;679;1877;964;2837
353030;202004;4252;10840;2860;8354;657;2094;801;2232;1458;4326
353040;202004;626;1456;438;1180;67;187;250;641;317;828
353050;202004;5099;14629;3574;11496;704;2454;1596;4912;2300;7366
353060;202004;47439;121242;38754;107404;2765;9227;28898;77280;31663;86507
353070;202004;8947;25712;6332;20074;1252;4308;2487;7312;3739;11620
353080;202004;4053;11236;2702;8602;516;1863;1045;2916;1561;4779
353090;202004;540;1642;404;1351;31;110;246;802;277;912
353100;202004;305;822;135;433;26;86;37;94;63;180
353110;202004;7343;19912;5926;17838;1185;3650;3172;9832;4357;13482
353120;202004;386;970;278;795;40;137;118;294;158;431
353130;202004;2378;5592;1488;4139;386;1189;495;1249;881;2438
353140;202004;2694;6713;1929;5376;113;372;1350;3600;1463;3972
353150;202004;1476;3640;1028;2895;186;553;465;1240;651;1793
353160;202004;564;1489;400;1215;69;223;167;465;236;688
353170;202004;527;1419;389;1218;78;275;169;519;247;794
353180;202004;9581;23580;7430;20078;658;1984;5549;14578;6207;16562
353190;202004;3133;8494;2476;7191;295;915;1518;4162;1813;5077
353200;202004;1873;4962;935;3001;154;553;215;623;369;1176
353205;202004;352;1069;300;954;55;186;153;476;208;662
353210;202004;917;2137;573;1564;29;96;376;1005;405;1101
353215;202004;377;1048;291;888;43;144;145;401;188;545
353220;202004;712;1961;433;1351;94;285;53;162;147;447
353230;202004;811;2232;625;1935;171;596;243;680;414;1276
353240;202004;2224;6072;1784;5320;258;890;1028;2939;1286;3829
353250;202004;1248;2812;745;1968;102;304;406;1018;508;1322
353260;202004;1121;2613;603;1745;91;309;281;764;372;1073
353270;202004;664;1719;554;1523;46;147;384;990;430;1137
353280;202004;686;1871;473;1475;118;375;134;399;252;774
353282;202004;1750;4946;1459;4398;155;524;924;2632;1079;3156
353284;202004;351;813;176;479;21;78;80;190;101;268
353286;202004;164;407;96;296;12;38;35;101;47;139
353290;202004;1470;3917;903;2755;151;471;293;820;444;1291
353300;202004;1795;4863;1292;3851;205;685;579;1555;784;2240
353310;202004;384;936;272;728;22;78;181;451;203;529
353320;202004;649;1595;537;1435;9;39;467;1232;476;1271
353325;202004;641;1881;437;1434;94;295;157;499;251;794
353330;202004;514;1318;346;998;40;120;195;525;235;645
353340;202004;2816;7619;1944;5916;409;1384;856;2432;1265;3816
353350;202004;3377;8762;2301;6589;502;1568;671;1678;1173;3246
353360;202004;602;1706;455;1421;57;186;255;789;312;975
353370;202004;548;1596;451;1444;36;124;317;980;353;1104
353380;202004;266;794;219;699;25;84;118;342;143;426
353390;202004;5668;14076;4126;11490;489;1530;2342;6171;2831;7701
353400;202004;421;1159;313;950;51;183;116;290;167;473
353410;202004;517;1382;390;1158;72;222;218;646;290;868
353420;202004;419;1101;244;716;59;169;19;43;78;212
353430;202004;2103;5877;1567;4883;363;1233;649;1909;1012;3142
353440;202004;62383;169418;44402;134417;7452;24466;23152;66664;30604;91130
353450;202004;361;921;241;713;35;126;118;317;153;443
353460;202004;3191;8687;2269;6860;164;571;1053;3058;1217;3629
353470;202004;7609;19995;5353;15800;886;3003;2304;6208;3190;9211
353475;202004;1429;3717;973;2769;143;448;488;1291;631;1739
353480;202004;1594;4287;1262;3695;65;237;874;2472;939;2709
353490;202004;1069;2822;687;2081;100;325;299;863;399;1188
353500;202004;1018;2400;759;2008;167;447;411;1091;578;1538
353510;202004;770;2327;555;1796;139;498;140;377;279;875
353520;202004;1059;2780;665;2057;87;297;308;878;395;1175
353530;202004;2361;6268;1816;5284;248;818;966;2612;1214;3430
353540;202004;2014;5421;1635;4824;265;824;970;2803;1235;3627
353550;202004;5688;14673;4534;12823;742;2219;2583;7054;3325;9273
353560;202004;2060;5618;1486;4706;429;1495;409;1164;838;2659
353570;202004;582;1507;427;1257;45;141;254;710;299;851
353580;202004;2076;5493;1559;4465;333;963;744;2086;1077;3049
353590;202004;689;1821;441;1337;88;286;179;539;267;825
353600;202004;1693;4192;1262;3440;152;425;701;1863;853;2288
353610;202004;524;1544;371;1247;85;345;112;342;197;687
353620;202004;2618;7050;1814;5623;356;1229;587;1654;943;2883
353625;202004;473;1173;310;891;19;66;197;555;216;621
353630;202004;1247;3883;1026;3381;225;835;350;1053;575;1888
353640;202004;1335;3422;1064;3024;144;428;611;1728;755;2156
353650;202004;7733;20648;5712;16790;598;1986;3438;9499;4036;11485
353657;202004;382;992;269;797;32;102;118;323;150;425
353660;202004;1236;2632;834;2091;367;919;204;491;571;1410
353670;202004;3995;11140;3068;9302;614;2091;1513;4246;2127;6337
353680;202004;642;1687;465;1422;81;270;253;732;334;1002
353690;202004;420;1083;183;569;19;57;31;85;50;142
353700;202004;1980;5217;1619;4607;117;385;1188;3248;1305;3633
353710;202004;4456;9872;2523;6455;228;609;1569;3658;1797;4267
353715;202004;418;1105;243;769;10;41;77;232;87;273
353720;202004;1879;5079;1437;4422;188;658;866;2607;1054;3265
353730;202004;4264;11299;3153;9273;476;1615;1565;4199;2041;5814
353740;202004;2005;5302;1386;4194;342;1118;456;1233;798;2351
353750;202004;799;2400;552;1916;131;496;99;352;230;848
353760;202004;12401;29081;9341;24878;1801;4935;5104;13319;6905;18254
353770;202004;694;2091;392;1318;66;245;58;166;124;411
353780;202004;5063;14195;3943;12010;800;2717;1869;5250;2669;7967
353790;202004;2521;7698;1828;6225;526;2019;384;1120;910;3139
353800;202004;17222;45321;13202;38788;1931;6055;7332;21511;9263;27566
353810;202004;1095;2969;689;2095;110;373;286;825;396;1198
353820;202004;1648;4466;1131;3422;241;785;367;1039;608;1824
353830;202004;606;1541;441;1264;75;230;193;518;268;748
353850;202004;1570;4422;1190;3676;273;855;417;1263;690;2118
353860;202004;2493;6969;1907;5906;461;1630;833;2325;1294;3955
353870;202004;28636;75455;19911;58218;2627;8738;10384;27611;13011;36349
353880;202004;2933;8168;2296;6936;183;648;1431;4171;1614;4819
353890;202004;2416;5302;1592;4165;132;357;1089;2736;1221;3093
353900;202004;738;2079;521;1638;82;284;203;593;285;877
353910;202004;2134;5998;1742;5364;196;713;1160;3489;1356;4202
353920;202004;1764;4903;1228;3854;289;1026;320;818;609;1844
353930;202004;4122;11013;2770;8504;513;1799;1103;2981;1616;4780
353940;202004;1038;2983;705;2297;127;425;240;731;367;1156
353950;202004;3175;8647;2414;7240;433;1426;1350;3755;1783;5181
353960;202004;695;1827;460;1371;89;288;191;542;280;830
353970;202004;662;1594;490;1336;45;134;326;865;371;999
353980;202004;14876;38024;11349;31748;834;2678;8041;21649;8875;24327
353990;202004;896;2193;528;1518;87;267;242;664;329;931
354000;202004;2399;5832;1322;3780;296;900;221;601;517;1501
354010;202004;349;910;250;754;44;139;140;406;184;545
354020;202004;3333;9306;2607;7752;662;2119;1037;2823;1699;4942
354025;202004;700;1947;451;1438;63;229;119;363;182;592
354030;202004;487;1072;252;678;51;149;124;311;175;460
354040;202004;793;1875;501;1384;21;70;367;982;388;1052
354050;202004;937;2633;637;2086;146;505;200;654;346;1159
354060;202004;3266;9285;2223;7083;511;1741;784;2313;1295;4054
354070;202004;3523;9355;2363;7085;417;1429;962;2460;1379;3889
354075;202004;2512;7362;1907;6204;230;867;1084;3416;1314;4283
354080;202004;1315;3600;860;2711;189;635;199;564;388;1199
354085;202004;401;851;311;734;0;0;231;508;231;508
354090;202004;1582;4479;1344;3969;85;271;1033;2973;1118;3244
354100;202004;19071;52189;12931;41320;2867;9861;4918;15606;7785;25467
354105;202004;1488;3753;1002;2854;129;377;466;1249;595;1626
354110;202004;472;1307;316;1013;48;167;114;363;162;530
354120;202004;1382;3725;914;2715;185;602;310;798;495;1400
354130;202004;5337;14171;3479;10567;885;2874;214;427;1099;3301
354140;202004;18257;44640;12022;33194;2097;6417;5104;13015;7201;19432
354150;202004;2948;7019;2173;5775;488;1350;872;2255;1360;3605
354160;202004;2915;8461;2133;6863;611;2114;594;1741;1205;3855
354165;202004;599;1810;460;1537;77;299;235;744;312;1043
354170;202004;1635;4586;1361;4051;71;246;888;2539;959;2785
354180;202004;383;1074;271;835;53;170;105;295;158;465
354190;202004;1398;3959;956;3038;62;227;422;1305;484;1532
354200;202004;836;2044;638;1738;70;209;413;1074;483;1283
354210;202004;749;1980;590;1711;38;138;432;1183;470;1321
354220;202004;3052;8267;2232;6608;385;1224;1110;3130;1495;4354
354230;202004;706;1763;554;1577;37;137;398;1095;435;1232
354240;202004;1578;4403;1051;3325;185;643;313;887;498;1530
354250;202004;510;1253;317;949;94;276;76;241;170;517
354260;202004;8105;21580;6075;17986;1266;3989;2494;7130;3760;11119
354270;202004;998;3025;803;2646;188;612;315;1012;503;1624
354280;202004;766;1942;648;1769;63;208;408;1035;471;1243
354290;202004;884;2810;737;2499;123;411;376;1316;499;1727
354300;202004;3495;10298;2940;9264;854;2701;1058;3324;1912;6025
354310;202004;683;2046;556;1777;127;427;206;615;333;1042
354320;202004;916;2255;583;1678;83;278;231;595;314;873
354323;202004;445;1082;295;813;32;71;128;340;160;411
354325;202004;1311;3918;914;3017;141;463;344;1098;485;1561
354330;202004;9025;22979;5833;16415;723;2394;3362;8768;4085;11162
354340;202004;30631;77250;20056;58570;3303;10771;9907;27601;13210;38372
354350;202004;1138;2942;899;2539;83;260;620;1675;703;1935
354360;202004;573;1487;321;1057;61;212;66;220;127;432
354370;202004;993;2875;784;2523;129;450;445;1406;574;1856
354380;202004;702;1852;497;1513;92;361;118;277;210;638
354390;202004;12738;30766;7895;22194;1493;4456;3022;8121;4515;12577
354400;202004;1539;4943;1151;4015;193;733;426;1459;619;2192
354410;202004;5501;15046;4102;12188;897;2893;1759;4948;2656;7841
354420;202004;1449;3819;1053;3085;136;426;648;1815;784;2241
354425;202004;2562;6270;1782;4910;419;1182;753;2071;1172;3253
354430;202004;1509;4016;1154;3444;126;440;682;1897;808;2337
354440;202004;543;1465;354;1072;55;192;158;439;213;631
354450;202004;409;1075;222;716;35;115;65;184;100;299
354460;202004;859;2169;555;1619;78;244;306;863;384;1107
354470;202004;463;1176;298;852;19;61;148;375;167;436
354480;202004;1175;2676;747;1987;67;188;497;1261;564;1449
354490;202004;771;2306;549;1810;114;406;231;702;345;1108
354500;202004;1969;5591;1605;5029;495;1692;373;1163;868;2855
354510;202004;709;2006;558;1696;55;181;301;832;356;1013
354515;202004;321;936;234;751;37;140;98;297;135;437
354520;202004;6408;17707;4349;13214;648;2259;2362;6677;3010;8936
354530;202004;4154;11898;3154;9898;748;2405;1226;3871;1974;6276
354540;202004;1280;3399;917;2754;215;680;345;1041;560;1721
354550;202004;527;1389;403;1148;56;174;232;626;288;800
354560;202004;2112;5144;1123;3211;141;413;557;1490;698;1903
354570;202004;1193;3004;479;1378;80;242;64;181;144;423
354580;202004;8796;23041;5610;16954;855;2828;2793;8087;3648;10915
354600;202004;1816;4915;1373;4068;151;530;886;2483;1037;3013
354610;202004;425;1101;235;702;26;80;105;294;131;374
354620;202004;411;1181;249;844;48;185;90;277;138;462
354625;202004;306;818;159;514;30;100;24;52;54;152
354630;202004;1894;5698;1501;4874;539;1842;252;752;791;2594
354640;202004;3136;9003;2263;7226;404;1434;816;2403;1220;3837
354650;202004;850;2219;669;1920;54;150;420;1193;474;1343
354660;202004;3690;8620;1890;5571;174;630;891;2388;1065;3018
354670;202004;1061;2983;717;2276;155;522;259;746;414;1268
354680;202004;4950;13151;3759;11156;888;2734;1849;5618;2737;8352
354690;202004;494;1581;348;1249;78;289;93;325;171;614
354700;202004;861;2285;605;1780;88;279;299;835;387;1114
354710;202004;463;1266;335;1013;43;148;152;400;195;548
354720;202004;281;677;122;361;38;120;27;78;65;198
354730;202004;9509;26728;7022;21900;1005;3431;3915;11776;4920;15207
354740;202004;309;837;117;389;19;76;19;53;38;129
354750;202004;2393;6216;1486;4489;254;831;648;1765;902;2596
354760;202004;1921;5219;1301;4018;325;1091;400;1127;725;2218
354765;202004;375;1003;142;460;21;70;28;78;49;148
354770;202004;2237;5571;1622;4520;300;938;772;1996;1072;2934
354780;202004;52712;134648;39269;107774;4439;13689;24192;62347;28631;76036
354790;202004;957;2643;742;2283;83;281;450;1323;533;1604
354800;202004;2502;6448;1933;5569;488;1441;829;2264;1317;3705
354805;202004;1335;3061;896;2413;101;272;529;1325;630;1597
354810;202004;641;1871;354;1250;40;171;77;244;117;415
354820;202004;914;2630;634;2075;112;405;174;459;286;864
354830;202004;443;1091;279;791;55;168;96;255;151;423
354840;202004;869;2144;505;1430;43;133;300;804;343;937
354850;202004;21310;55284;14580;43014;1677;5734;8656;24123;10333;29857
354860;202004;1708;4842;1018;3322;180;649;301;887;481;1536
354870;202004;55834;141372;42577;116617;4768;14414;26240;67943;31008;82357
354880;202004;5682;14041;2629;7461;325;1072;978;2231;1303;3303
354890;202004;16403;40910;12594;34456;1713;5306;7492;19777;9205;25083
354900;202004;393;995;246;732;40;128;70;185;110;313
354910;202004;5230;13738;3040;9689;678;2287;497;1526;1175;3813
354920;202004;476;1277;217;744;27;109;44;157;71;266
354925;202004;285;817;170;548;18;62;40;112;58;174
354930;202004;397;938;228;651;15;52;113;296;128;348
354940;202004;2264;6858;1560;5258;532;1915;272;841;804;2756
354950;202004;1435;3749;1128;3316;58;236;832;2313;890;2549
354960;202004;892;2376;672;2045;54;194;389;1125;443;1319
354970;202004;4037;11346;3103;9712;370;1297;1942;5892;2312;7189
354980;202004;31173;73869;20261;54933;2252;7287;12094;30472;14346;37759
354990;202004;61698;156753;45474;126959;3946;12748;29294;77307;33240;90055
354995;202004;2756;6318;2062;5394;184;572;1468;3659;1652;4231
355000;202004;1552;3896;1155;3319;178;601;560;1481;738;2082
355010;202004;3714;10150;2157;6801;717;2338;224;731;941;3069
355020;202004;3520;9958;2540;8197;617;2188;888;2720;1505;4908
355030;202004;1311027;3226297;924512;2470721;144086;423324;452275;1113358;596361;1536682
355040;202004;2799;7081;2169;6248;323;922;1471;4287;1794;5209
355050;202004;968;2265;687;1845;177;526;261;637;438;1163
355060;202004;6027;16353;4329;13112;727;2556;2085;5727;2812;8283
355070;202004;8514;22138;6756;19297;792;2625;4301;11590;5093;14215
355080;202004;908;2601;549;1900;108;410;79;217;187;627
355090;202004;1081;3160;801;2662;215;707;234;810;449;1517
355100;202004;22349;58624;17061;50635;2785;8745;10101;29692;12886;38437
355110;202004;807;2271;577;1898;176;649;102;309;278;958
355120;202004;677;1778;477;1478;35;122;202;592;237;714
355130;202004;866;1948;402;1089;27;85;227;580;254;665
355140;202004;1810;4158;1512;3740;100;298;1240;2965;1340;3263
355150;202004;4203;11131;3304;9518;390;1261;2087;5763;2477;7024
355160;202004;1855;5119;1310;4120;328;1134;298;896;626;2030
355170;202004;9871;25180;7558;21236;1469;4471;3957;10751;5426;15222
355180;202004;2731;7421;1904;5991;418;1449;677;1938;1095;3387
355190;202004;1850;4852;1444;4218;349;1013;760;2348;1109;3361
355200;202004;825;2543;689;2318;183;680;285;910;468;1590
355210;202004;2775;7654;2138;6334;423;1421;1072;2964;1495;4385
355220;202004;43472;115901;33802;97121;8077;24743;13660;36326;21737;61069
355230;202004;1113;2800;595;1767;104;297;208;580;312;877
355240;202004;23250;61693;15953;46954;2270;7251;8493;23621;10763;30872
355250;202004;36587;98416;26470;78501;6640;20786;9709;27403;16349;48189
355255;202004;693;1750;360;1115;61;212;135;401;196;613
355260;202004;1395;3522;1009;2852;135;455;576;1507;711;1962
355270;202004;1167;3497;897;2927;206;693;297;901;503;1594
355280;202004;28579;73881;19686;56704;2989;9334;9188;24976;12177;34310
355290;202004;854;2363;635;1950;137;401;259;777;396;1178
355300;202004;1211;3569;927;2964;183;661;312;929;495;1590
355310;202004;959;2667;721;2265;101;314;395;1261;496;1575
355320;202004;510;1342;371;1088;73;248;151;358;224;606
355330;202004;2644;6836;1985;5689;145;532;1469;4014;1614;4546
355340;202004;3912;8678;2983;7429;377;835;1876;4795;2253;5630
355350;202004;1269;3703;933;3052;202;684;325;1052;527;1736
355360;202004;1134;2920;865;2525;117;368;527;1519;644;1887
355365;202004;359;948;185;632;41;130;30;105;71;235
355370;202004;5295;13562;4055;11613;978;2608;1803;5680;2781;8288
355380;202004;2841;7624;2106;6226;391;1247;751;1937;1142;3184
355385;202004;1403;3705;1139;3308;109;384;717;1915;826;2299
355390;202004;790;2191;554;1661;126;412;222;596;348;1008
355395;202004;1894;5234;1287;4004;231;771;442;1227;673;1998
355400;202004;8916;25721;6989;21839;1733;6168;2434;6784;4167;12952
355410;202004;21819;59739;13341;42452;2879;10114;3306;10363;6185;20477
355420;202004;613;1982;495;1744;143;554;121;413;264;967
355430;202004;3650;9354;2712;7648;661;1820;1221;3439;1882;5259
355440;202004;790;2150;468;1464;84;273;137;398;221;671
355450;202004;3061;7944;1946;5704;362;1136;793;2110;1155;3246
355460;202004;486;1203;306;900;45;170;139;363;184;533
355465;202004;392;1038;297;880;44;139;151;437;195;576
355470;202004;1059;2729;592;1804;161;552;182;485;343;1037
355475;202004;353;841;279;731;17;40;204;521;221;561
355480;202004;3719;10382;3023;9342;452;1624;1961;5862;2413;7486
355490;202004;926;2478;489;1519;33;116;254;715;287;831
355495;202004;764;2185;554;1804;70;262;194;582;264;844
355500;202004;6484;16892;3741;11370;592;1976;1249;3519;1841;5495
355510;202004;1277;3129;792;2292;103;345;349;895;452;1240
355520;202004;369;819;166;486;28;80;48;130;76;210
355530;202004;408;949;143;425;20;73;52;136;72;209
355535;202004;507;1401;380;1187;77;301;170;473;247;774
355540;202004;10315;26188;8335;23333;1336;4057;5241;14245;6577;18302
355550;202004;621;1844;504;1628;68;247;269;814;337;1061
355560;202004;1083;2805;570;1799;131;462;37;119;168;581
355570;202004;243;697;131;430;23;75;33;106;56;181
355580;202004;1188;2926;783;2232;143;451;319;850;462;1301
355590;202004;170;425;129;357;17;52;77;201;94;253
355600;202004;1403;3423;930;2638;184;561;394;1085;578;1646
355610;202004;1713;4264;1132;3244;133;422;595;1620;728;2042
355620;202004;4409;11847;3205;9490;365;1313;1747;4755;2112;6068
355630;202004;2271;6285;1569;4939;256;842;776;2412;1032;3254
355635;202004;862;2518;627;2054;119;441;182;530;301;971
355640;202004;2939;8260;1934;6210;383;1327;576;1778;959;3105
355645;202004;4120;11599;2969;9555;436;1516;1591;5038;2027;6554
355650;202004;6498;17512;5071;14885;1405;4281;1694;4487;3099;8768
355660;202004;1257;3299;856;2544;139;481;295;855;434;1336
355670;202004;3342;9037;2172;6404;280;995;1093;2824;1373;3819
355680;202004;2679;7413;1135;3771;305;1067;119;414;424;1481
355690;202004;794;2361;495;1737;111;421;21;50;132;471
355695;202004;239;668;138;448;12;59;26;58;38;117
355700;202004;7020;20247;5646;17141;993;3168;2961;8542;3954;11710
355710;202004;8311;19685;5207;13962;806;2400;2319;5531;3125;7931
355715;202004;477;1273;243;750;50;169;47;128;97;297
355720;202004;1454;4099;1136;3527;188;629;604;1761;792;2390
355730;202004;900;2504;728;2172;136;444;325;880;461;1324
410010;202004;1213;3391;907;2730;194;634;188;550;382;1184
410020;202004;943;2974;719;2431;266;841;163;580;429;1421
410030;202004;1485;4149;1249;3770;174;586;677;2049;851;2635
410040;202004;11695;32500;8433;26352;1842;6151;2681;7801;4523;13952
410045;202004;831;2234;573;1750;81;283;205;578;286;861
410050;202004;2255;5660;1472;4269;290;921;470;1256;760;2177
410060;202004;1962;5652;1496;4688;360;1200;463;1400;823;2600
410070;202004;1812;4659;1298;3700;209;667;510;1331;719;1998
410080;202004;1326;3583;935;2847;208;656;306;943;514;1599
410090;202004;1069;2769;912;2517;86;228;566;1626;652;1854
410100;202004;1797;5240;1184;3723;172;614;157;473;329;1087
410105;202004;455;1167;244;752;32;102;73;217;105;319
410110;202004;2973;7629;2031;5788;266;810;873;2378;1139;3188
410115;202004;543;1413;379;1121;52;175;142;406;194;581
410120;202004;2450;7094;2118;6551;482;1662;1045;3095;1527;4757
410130;202004;1154;3141;998;2844;196;649;502;1317;698;1966
410140;202004;14021;33824;8524;23877;1639;5055;2005;5138;3644;10193
410150;202004;15771;37354;7576;21150;1283;3967;1711;4390;2994;8357
410160;202004;2810;7823;2239;6811;513;1712;780;2374;1293;4086
410165;202004;720;1938;587;1664;55;190;347;913;402;1103
410170;202004;2601;6803;1697;4836;388;1205;128;371;516;1576
410180;202004;14634;40861;11125;33607;1519;5015;5868;16580;7387;21595
410185;202004;426;1242;297;914;54;176;86;241;140;417
410190;202004;2184;5435;1550;4302;326;933;416;1103;742;2036
410200;202004;4899;11436;2613;7440;429;1423;450;1238;879;2661
410210;202004;2975;7507;1801;5334;288;976;612;1557;900;2533
410220;202004;501;1300;318;952;51;166;76;216;127;382
410230;202004;1621;4353;1222;3535;161;536;647;1755;808;2291
410240;202004;4683;12522;3189;9627;803;2697;261;729;1064;3426
410250;202004;2564;6121;1861;4962;134;459;927;2399;1061;2858
410260;202004;1835;4640;1132;3290;189;562;491;1412;680;1974
410270;202004;453;1202;322;972;44;147;120;349;164;496
410275;202004;592;1677;395;1267;49;175;192;566;241;741
410280;202004;2233;6005;1460;4444;229;778;575;1606;804;2384
410290;202004;3222;9110;2180;6848;585;1857;561;1742;1146;3599
410300;202004;636;1612;501;1387;41;130;255;665;296;795
410302;202004;380;946;198;599;25;83;96;280;121;363
410304;202004;1210;3152;1005;2776;114;307;602;1623;716;1930
410305;202004;1715;4124;1152;3307;123;387;706;1966;829;2353
410310;202004;2482;7085;1954;6042;340;1140;889;2748;1229;3888
410315;202004;661;1584;345;1070;122;382;82;253;204;635
410320;202004;1051;2920;703;2190;110;382;128;374;238;756
410322;202004;538;1434;291;880;29;91;151;426;180;517
410330;202004;1475;3615;1000;2713;167;491;292;780;459;1271
410335;202004;815;2217;626;1859;94;303;282;783;376;1086
410337;202004;794;1922;545;1439;58;155;231;579;289;734
410340;202004;465;1303;307;904;27;87;141;346;168;433
410345;202004;2357;6080;1173;3454;246;765;328;866;574;1631
410347;202004;676;1734;486;1383;43;145;153;443;196;588
410350;202004;1267;3227;898;2601;120;366;372;1016;492;1382
410360;202004;4253;10404;3258;8674;375;1103;1824;4661;2199;5764
410370;202004;12634;34421;7984;23260;989;3170;3286;8500;4275;11670
410380;202004;1426;3651;1037;2923;142;423;373;975;515;1398
410390;202004;2569;6598;1651;4892;384;1260;480;1302;864;2562
410395;202004;846;2459;686;2113;139;465;289;887;428;1352
410400;202004;5912;15838;4273;12573;670;2098;1965;5481;2635;7579
410405;202004;800;1931;588;1616;109;342;255;650;364;992
410410;202004;1207;3294;1125;3165;164;545;707;2055;871;2600
410420;202004;9009;25228;6656;20509;1164;3987;2337;6469;3501;10456
410425;202004;3071;8631;2073;6564;353;1223;751;2155;1104;3378
410430;202004;12446;31429;8490;24124;1370;4292;2883;7727;4253;12019
410440;202004;2266;6804;1925;6158;288;1037;1018;3190;1306;4227
410442;202004;2072;6439;1727;5669;506;1701;541;1725;1047;3426
410445;202004;2217;6480;1619;5293;316;1179;379;1309;695;2488
410450;202004;1381;3468;1003;2855;186;593;357;953;543;1546
410460;202004;1961;4846;1511;4132;162;461;755;1997;917;2458
410465;202004;2599;7598;2013;6457;381;1287;714;2139;1095;3426
410470;202004;1967;5473;1380;4370;363;1309;221;743;584;2052
410480;202004;36483;86588;18909;55126;3043;9952;3998;9947;7041;19899
410490;202004;10758;30079;7575;23389;1401;4729;2944;8546;4345;13275
410500;202004;1700;4608;1149;3513;258;917;335;886;593;1803
410510;202004;1835;4528;1191;3325;238;653;331;938;569;1591
410520;202004;2975;9417;2641;8719;906;3081;926;3142;1832;6223
410530;202004;1542;3831;727;2092;100;285;174;417;274;702
410540;202004;2658;7227;1811;5496;275;916;832;2438;1107;3354
410550;202004;7013;18854;4450;13101;784;2511;1201;3063;1985;5574
410560;202004;1418;3759;1037;2960;236;739;363;904;599;1643
410570;202004;2423;6752;1774;5569;481;1773;201;677;682;2450
410580;202004;24466;64056;17576;51301;3515;10981;7270;19888;10785;30869
410590;202004;1538;4407;1018;3141;152;488;290;787;442;1275
410600;202004;1734;4693;1311;3859;281;795;476;1449;757;2244
410610;202004;692;1842;504;1477;56;202;220;609;276;811
410620;202004;2243;6560;1434;4631;319;1143;271;805;590;1948
410630;202004;2301;6093;1473;4371;277;939;287;685;564;1624
410640;202004;4537;10657;3019;8003;672;2092;408;1070;1080;3162
410645;202004;1022;2940;829;2688;274;910;341;1131;615;2041
410650;202004;2104;5778;1401;4314;279;927;490;1390;769;2317
410655;202004;892;2153;628;1681;25;79;326;826;351;905
410657;202004;613;1660;374;1134;49;187;134;331;183;518
410660;202004;3242;8409;1789;5194;322;977;447;1233;769;2210
410670;202004;1034;2605;615;1786;126;375;225;598;351;973
410680;202004;2588;7880;1856;6006;450;1501;342;1130;792;2631
410685;202004;526;1347;396;1123;95;317;157;395;252;712
410690;202004;120990;298285;77341;216364;12651;40518;28021;69173;40672;109691
410700;202004;2392;6115;1998;5491;287;815;1058;2826;1345;3641
410710;202004;820;2085;524;1522;77;235;228;622;305;857
410712;202004;617;1801;508;1587;128;440;187;555;315;995
410715;202004;803;2332;486;1607;69;232;168;526;237;758
410720;202004;3088;7848;2397;6517;321;1030;519;1386;840;2416
410725;202004;1040;2564;590;1726;115;363;86;205;201;568
410730;202004;620;1655;472;1386;108;368;96;270;204;638
410740;202004;921;2582;674;2110;92;321;266;813;358;1134
410750;202004;1728;4387;1358;3698;208;643;617;1591;825;2234
410752;202004;357;916;172;530;24;80;73;210;97;290
410753;202004;280;846;191;644;31;125;44;137;75;262
410754;202004;1066;2767;880;2480;55;139;610;1819;665;1958
410755;202004;564;1468;382;1104;57;177;160;405;217;582
410760;202004;3394;8849;2380;6992;598;1992;537;1429;1135;3421
410765;202004;12329;34741;9461;29035;1601;5395;1887;5205;3488;10600
410770;202004;1024;2448;698;1894;68;190;357;971;425;1161
410773;202004;1239;3334;1076;3084;109;353;661;1836;770;2189
410775;202004;1454;3636;1258;3341;70;208;837;2182;907;2390
410780;202004;606;1503;392;1090;60;182;97;260;157;442
410785;202004;703;1855;536;1567;94;300;184;547;278;847
410790;202004;729;2064;587;1790;169;572;66;142;235;714
410800;202004;3291;7334;2646;6386;45;162;1723;4065;1768;4227
410810;202004;370;1003;281;832;23;67;136;378;159;445
410820;202004;815;2318;411;1282;79;258;74;211;153;469
410830;202004;32891;80376;21523;61069;4484;14556;7253;19410;11737;33966
410832;202004;970;2529;760;2154;90;288;441;1180;531;1468
410840;202004;7876;20217;4599;13845;849;2778;1180;3275;2029;6053
410845;202004;1110;2802;863;2421;158;471;374;1023;532;1494
410850;202004;2168;6302;1887;5789;298;1010;945;2801;1243;3811
410855;202004;760;1916;493;1402;42;113;232;617;274;730
410860;202004;4268;10538;3326;8991;349;1092;1858;4761;2207;5853
410865;202004;1311;3913;1156;3604;132;461;694;2198;826;2659
410870;202004;1256;3379;1038;3007;78;246;709;2030;787;2276
410880;202004;4279;11688;2977;9238;509;1704;460;1571;969;3275
410890;202004;939;2676;687;2178;150;526;181;569;331;1095
410895;202004;966;3115;818;2788;253;943;178;563;431;1506
410900;202004;804;2118;538;1597;101;310;98;242;199;552
410910;202004;369;874;225;607;13;48;137;342;150;390
410920;202004;819;1964;563;1559;76;227;270;739;346;966
410930;202004;1620;4190;1105;3271;266;925;231;664;497;1589
410940;202004;21907;60222;15570;48563;3214;11105;4759;14558;7973;25663
410950;202004;1889;5542;1670;5204;48;187;1390;4278;1438;4465
410960;202004;7023;17843;4605;13614;1051;3441;1700;4956;2751;8397
410965;202004;992;2553;684;1969;81;258;388;1100;469;1358
410970;202004;3815;10301;2620;7971;603;2184;366;944;969;3128
410975;202004;1283;3217;966;2703;94;281;469;1311;563;1592
410980;202004;6738;17060;4173;12348;498;1661;1751;4810;2249;6471
410990;202004;1335;3270;864;2529;216;737;279;775;495;1512
411000;202004;589;1579;383;1175;49;177;116;309;165;486
411005;202004;410;1080;249;735;46;146;68;181;114;327
411007;202004;2230;6271;1820;5555;433;1392;635;1932;1068;3324
411010;202004;4106;12322;3218;10486;834;2950;364;1083;1198;4033
411020;202004;2184;6309;1783;5575;526;1713;499;1522;1025;3235
411030;202004;726;1809;503;1342;26;99;290;689;316;788
411040;202004;897;2268;449;1278;46;146;147;364;193;510
411050;202004;1843;5758;1488;4974;404;1457;229;654;633;2111
411060;202004;1808;4705;1124;3374;259;924;185;492;444;1416
411065;202004;378;991;252;743;34;115;110;300;144;415
411070;202004;6669;17270;5221;14820;745;2350;2528;6971;3273;9321
411080;202004;2067;5468;1615;4662;416;1372;323;910;739;2282
411090;202004;819;2163;527;1590;44;168;151;425;195;593
411095;202004;1540;3636;1038;2856;120;352;338;893;458;1245
411100;202004;1102;2869;741;2219;81;280;235;710;316;990
411110;202004;633;1627;281;870;35;107;17;37;52;144
411120;202004;1176;3319;961;2911;308;1067;220;594;528;1661
411125;202004;5031;14752;4435;13606;949;2868;2153;6899;3102;9767
411130;202004;689;1868;481;1471;90;254;176;571;266;825
411140;202004;2180;6755;1829;5990;541;1894;485;1551;1026;3445
411150;202004;3697;9538;2452;6995;494;1631;241;501;735;2132
411155;202004;955;2437;555;1680;81;237;228;654;309;891
411160;202004;356;820;235;658;31;94;53;153;84;247
411170;202004;676;2044;495;1614;112;356;158;504;270;860
411180;202004;5220;13868;3998;11692;589;1924;1903;5246;2492;7170
411190;202004;1566;4027;1152;3293;190;572;455;1194;645;1766
411200;202004;4862;13201;3334;10273;854;2922;638;1695;1492;4617
411210;202004;3038;6775;1942;4962;338;976;622;1492;960;2468
411220;202004;826;2141;580;1666;131;410;169;458;300;868
411230;202004;824;2208;581;1724;116;368;218;635;334;1003
411240;202004;1467;3573;940;2593;105;344;458;1156;563;1500
411250;202004;2177;5828;1593;4767;318;1100;506;1463;824;2563
411260;202004;317;853;199;607;24;68;78;221;102;289
411270;202004;1945;5250;1445;4236;208;629;711;1938;919;2567
411275;202004;1395;3230;942;2479;145;459;419;1028;564;1487
411280;202004;1299;3509;849;2637;229;722;115;347;344;1069
411290;202004;797;2106;507;1530;50;137;261;819;311;956
411295;202004;1211;3048;856;2349;104;301;375;965;479;1266
411300;202004;986;2467;611;1742;56;177;263;660;319;837
411310;202004;839;1952;636;1655;47;117;289;740;336;857
411320;202004;5265;13750;3776;11036;664;2079;1550;4065;2214;6144
411325;202004;1385;3972;1173;3607;192;582;663;2105;855;2687
411330;202004;3295;8882;2362;7164;533;1763;746;2266;1279;4029
411340;202004;804;2193;472;1452;64;216;161;470;225;686
411342;202004;1002;2443;588;1625;98;288;248;653;346;941
411345;202004;1023;2668;768;2244;61;196;552;1628;613;1824
411350;202004;2555;6984;1630;5088;424;1441;229;654;653;2095
411360;202004;664;1608;473;1310;63;181;157;417;220;598
411370;202004;51784;127402;36330;101118;2632;8871;21802;57127;24434;65998
411373;202004;1356;3457;1096;3068;93;321;596;1684;689;2005
411375;202004;1062;2690;764;2123;126;365;305;816;431;1181
411380;202004;1099;2566;725;1848;34;99;442;1054;476;1153
411390;202004;1473;4064;1140;3339;180;590;464;1197;644;1787
411400;202004;2224;5574;1672;4529;171;549;841;2164;1012;2713
411410;202004;2349;6514;1692;5080;371;1222;390;1132;761;2354
411420;202004;3939;9726;2060;6081;290;991;372;853;662;1844
411430;202004;3322;9041;2490;7455;543;1774;852;2323;1395;4097
411435;202004;408;1146;253;808;51;154;80;212;131;366
411440;202004;2391;6779;1915;5868;393;1319;682;2035;1075;3354
411450;202004;2446;6538;1861;5572;241;728;1005;3054;1246;3782
411460;202004;3690;9632;2205;6723;389;1399;407;1137;796;2536
411470;202004;716;1873;513;1475;100;301;180;481;280;782
411480;202004;4522;12178;3230;9733;672;2379;1080;2953;1752;5332
411490;202004;1602;4144;1216;3496;155;516;513;1344;668;1860
411500;202004;1258;3396;826;2455;149;493;167;410;316;903
411510;202004;2239;5755;1768;4925;385;1254;418;1173;803;2427
411520;202004;29798;72521;16683;46896;1974;6462;6294;15877;8268;22339
411530;202004;893;2356;529;1635;91;315;83;235;174;550
411535;202004;450;1312;255;837;26;99;67;172;93;271
411540;202004;2687;6586;1802;4969;171;550;903;2393;1074;2943
411545;202004;903;2615;747;2340;71;219;488;1551;559;1770
411550;202004;687;1754;476;1358;69;216;83;244;152;460
411560;202004;1908;5135;1083;3364;155;538;82;232;237;770
411570;202004;6934;16202;4520;12456;987;2995;795;2149;1782;5144
411573;202004;745;2020;631;1845;93;288;329;942;422;1230
411575;202004;1866;5157;1380;4161;282;920;326;984;608;1904
411580;202004;4537;10378;2656;7475;372;1296;495;1284;867;2580
411585;202004;620;1855;285;952;69;240;52;152;121;392
411590;202004;374;1046;252;782;29;89;133;380;162;469
411600;202004;287;726;183;562;40;128;56;163;96;291
411605;202004;1481;3442;892;2482;116;405;471;1290;587;1695
411610;202004;2461;5943;1709;4557;75;251;1121;2776;1196;3027
411620;202004;2762;7403;2336;6730;402;1225;1273;3657;1675;4882
411630;202004;718;1878;474;1402;74;262;166;440;240;702
411640;202004;456;1200;321;910;46;146;120;311;166;457
411650;202004;198;585;126;423;24;86;22;59;46;145
411660;202004;877;2209;624;1750;49;152;294;802;343;954
411670;202004;1332;3298;886;2404;104;307;405;1031;509;1338
411680;202004;1433;3832;1052;3081;141;468;465;1311;606;1779
411690;202004;3531;9092;2635;7541;567;1655;810;2437;1377;4092
411695;202004;630;1937;391;1284;42;150;161;505;203;655
411700;202004;1573;4093;998;2999;222;728;149;416;371;1144
411705;202004;1811;5673;1527;5186;291;938;859;3161;1150;4099
411710;202004;1810;4632;1214;3503;281;835;213;596;494;1431
411720;202004;1054;2461;746;1920;148;399;292;704;440;1103
411721;202004;913;2320;672;1878;130;366;164;457;294;823
411722;202004;766;2055;411;1207;50;170;158;388;208;558
411725;202004;1127;3193;756;2453;177;615;167;556;344;1171
411727;202004;1440;4041;925;2914;210;692;166;493;376;1185
411729;202004;695;1684;435;1182;50;189;165;387;215;576
411730;202004;5019;13461;3851;11135;810;2517;1601;4543;2411;7060
411740;202004;531;1374;260;787;53;152;59;162;112;314
411745;202004;718;2044;474;1496;72;245;72;166;144;411
411750;202004;4931;13099;3525;10314;474;1503;1736;4806;2210;6309
411760;202004;6569;17672;5015;14939;1680;5203;986;3260;2666;8463
411770;202004;2879;8420;2075;6612;515;1743;294;875;809;2618
411780;202004;2747;7768;2326;6962;651;2039;781;2353;1432;4392
411790;202004;2762;6685;1447;4292;313;1061;218;554;531;1615
411800;202004;932;2646;660;2040;108;353;133;394;241;747
411810;202004;1504;3958;1102;3134;181;527;517;1393;698;1920
411820;202004;10912;31418;8735;27543;2176;7340;3677;11320;5853;18660
411830;202004;565;1392;418;1143;80;237;99;297;179;534
411840;202004;11444;30762;7518;22467;1301;4231;1939;5317;3240;9548
411845;202004;510;1493;264;876;27;112;56;177;83;289
411850;202004;7107;18221;4777;14088;1215;4043;785;2108;2000;6151
411860;202004;663;1880;475;1482;69;219;129;365;198;584
411870;202004;585;1708;404;1292;87;312;100;280;187;592
411880;202004;2200;5532;1596;4549;226;732;551;1518;777;2250
411885;202004;1014;2601;706;2051;99;336;236;634;335;970
411890;202004;1195;3169;779;2378;140;476;84;244;224;720
411900;202004;769;2132;457;1454;105;360;65;194;170;554
411910;202004;883;2619;625;2059;157;581;210;629;367;1210
411915;202004;14687;36112;9558;26791;1458;4608;3650;9173;5108;13781
411920;202004;1034;3113;852;2712;199;725;297;882;496;1607
411925;202004;459;1213;324;966;68;231;129;358;197;589
411930;202004;4872;15079;4084;13541;1762;6365;267;1035;2029;7400
411940;202004;3226;9636;2459;7920;601;2019;767;2228;1368;4247
411950;202004;13313;36135;10839;32050;1573;5258;6248;17728;7821;22986
411960;202004;5767;15599;4534;13065;837;2664;1729;4702;2566;7366
411965;202004;420;1187;295;936;47;163;114;331;161;494
411970;202004;1045;2470;800;2139;157;397;360;1084;517;1481
411980;202004;1458;3653;1044;2961;255;738;382;1044;637;1782
411990;202004;37617;98727;23499;72393;4407;15022;8000;23545;12407;38567
411995;202004;3058;7623;2266;6394;646;2042;629;1672;1275;3714
412000;202004;1921;4418;1347;3445;30;95;957;2299;987;2394
412010;202004;560;1754;400;1401;66;245;107;324;173;569
412015;202004;533;1511;435;1336;56;187;254;775;310;962
412020;202004;438;1227;269;856;39;151;116;346;155;497
412030;202004;583;1638;403;1297;66;214;117;376;183;590
412033;202004;836;2249;580;1710;67;195;203;528;270;723
412035;202004;757;2039;480;1521;53;208;261;778;314;986
412040;202004;568;1511;355;1076;49;143;70;211;119;354
412050;202004;1573;3937;1054;2984;210;673;263;738;473;1411
412060;202004;6947;20563;5735;18092;1521;5465;1670;4998;3191;10463
412065;202004;603;1663;434;1314;98;319;108;327;206;646
412070;202004;1081;2797;847;2322;105;311;352;898;457;1209
412080;202004;1965;5547;1230;3977;182;615;218;640;400;1255
412085;202004;274;652;91;288;8;21;15;42;23;63
412090;202004;5707;14955;4218;12124;1109;3320;1479;4342;2588;7662
412100;202004;1535;4262;1153;3545;326;1089;264;891;590;1980
412110;202004;805;2111;551;1598;82;241;185;512;267;753
412120;202004;1914;5570;1460;4656;285;1003;416;1141;701;2144
412125;202004;623;1779;435;1380;93;306;118;348;211;654
412130;202004;747;1912;507;1450;76;234;141;409;217;643
412135;202004;610;1625;272;826;43;132;91;244;134;376
412140;202004;1571;3802;1021;2835;190;648;202;535;392;1183
412150;202004;2694;7158;2269;6395;325;1060;1378;3655;1703;4715
412160;202004;936;2897;524;1784;96;349;88;264;184;613
412170;202004;4131;11514;3440;10408;710;2344;1394;3906;2104;6250
412175;202004;1258;3648;1040;3270;225;724;450;1439;675;2163
412180;202004;1579;4388;1127;3530;142;524;527;1518;669;2042
412190;202004;3289;8263;2419;6725;323;981;1061;2934;1384;3915
412200;202004;1682;5036;1199;3895;323;1158;192;569;515;1727
412210;202004;598;1437;349;983;47;149;130;329;177;478
412215;202004;3247;8847;2547;7480;630;1818;1089;3537;1719;5355
412217;202004;908;2397;765;2151;54;166;508;1392;562;1558
412220;202004;5754;15986;4555;13767;1139;3438;1470;4697;2609;8135
412230;202004;2498;7449;1990;6466;345;1264;539;1507;884;2771
412240;202004;6667;17103;4166;12265;739;2364;1231;3302;1970;5666
412250;202004;1996;5141;1478;4166;347;1034;342;903;689;1937
412260;202004;1162;3135;811;2368;146;445;244;681;390;1126
412265;202004;864;2375;675;2044;132;417;286;828;418;1245
412270;202004;931;2538;588;1816;77;270;229;639;306;909
412280;202004;388;1087;303;949;61;206;95;273;156;479
412290;202004;981;2509;650;1903;101;317;204;567;305;884
412300;202004;1636;4236;1121;3307;247;769;242;737;489;1506
412310;202004;727;2018;590;1755;83;302;236;655;319;957
412320;202004;828;2166;539;1568;66;234;191;558;257;792
412330;202004;1486;4016;979;3016;189;646;327;1031;516;1677
412340;202004;1131;3181;688;2185;100;372;116;336;216;708
412350;202004;2755;7146;1727;5102;354;1094;313;836;667;1930
412360;202004;252;702;166;506;6;28;96;274;102;302
412370;202004;835;2407;553;1783;110;405;48;162;158;567
412380;202004;1484;4041;1039;3142;290;910;133;469;423;1379
412382;202004;498;1236;321;944;44;156;132;332;176;488
412385;202004;2133;5880;1722;5071;538;1502;534;1758;1072;3260
412390;202004;2310;5669;1864;4998;316;849;717;1946;1033;2795
412395;202004;675;1931;463;1444;52;146;199;637;251;783
412400;202004;862;2316;609;1816;123;410;168;497;291;907
412402;202004;1950;4828;1302;3725;324;954;171;495;495;1449
412405;202004;2906;7666;1861;5664;492;1807;45;129;537;1936
412410;202004;5589;14622;4046;12053;739;2530;1327;3772;2066;6302
412420;202004;501;1289;325;943;23;83;153;389;176;472
412430;202004;572;1454;295;864;28;94;121;336;149;430
412440;202004;2606;7202;1734;5488;439;1500;285;931;724;2431
412450;202004;404;1191;267;835;44;132;23;52;67;184
412460;202004;1005;2646;783;2263;142;448;369;1051;511;1499
412470;202004;1433;4709;1174;4105;310;1142;254;887;564;2029
412480;202004;977;2626;623;1845;112;362;182;472;294;834
412490;202004;1249;3178;985;2681;122;338;505;1303;627;1641
412500;202004;1868;4704;1383;3790;298;807;402;1070;700;1877
412510;202004;1842;5699;1260;4187;284;1017;122;335;406;1352
412520;202004;1191;3122;628;1879;150;441;55;165;205;606
412530;202004;644;1704;465;1330;73;227;105;300;178;527
412535;202004;779;2029;520;1524;85;267;107;266;192;533
412540;202004;1154;2987;826;2352;89;321;274;812;363;1133
412545;202004;664;1713;453;1267;68;188;166;453;234;641
412550;202004;30017;80827;20573;61601;3521;11476;7974;21912;11495;33388
412555;202004;275;727;180;512;17;50;51;109;68;159
412560;202004;4601;13460;3353;10493;582;1998;986;3084;1568;5082
412570;202004;4210;10810;2322;7060;508;1720;289;977;797;2697
412575;202004;956;2430;754;2070;81;247;420;1090;501;1337
412580;202004;1384;3673;955;2820;89;316;496;1411;585;1727
412590;202004;411;1091;222;704;30;100;21;51;51;151
412600;202004;1461;4052;1061;3228;175;617;444;1265;619;1882
412610;202004;752;1974;525;1485;51;147;284;729;335;876
412620;202004;1187;3122;906;2701;164;573;297;827;461;1400
412625;202004;8416;22345;5065;15569;703;2483;332;899;1035;3382
412627;202004;1111;3117;691;2235;136;466;188;609;324;1075
412630;202004;2821;8246;1992;6408;386;1255;606;1786;992;3041
412635;202004;363;983;243;722;36;127;82;205;118;332
412640;202004;976;2592;527;1625;65;206;146;415;211;621
412650;202004;1540;4288;1214;3605;216;705;455;1188;671;1893
412660;202004;2305;5909;1592;4541;256;795;489;1246;745;2041
412665;202004;374;962;288;802;45;138;139;373;184;511
412667;202004;1677;4442;1240;3587;175;545;494;1369;669;1914
412670;202004;775;1849;506;1407;88;284;163;420;251;704
412680;202004;1761;4707;1177;3559;166;568;420;1132;586;1700
412690;202004;1001;2667;721;2103;109;339;298;811;407;1150
412700;202004;1950;5185;1601;4627;189;643;882;2466;1071;3109
412710;202004;5625;16575;4135;13302;830;3012;1133;3257;1963;6269
412720;202004;1158;3406;882;2787;142;479;177;475;319;954
412730;202004;2235;6014;1425;4319;271;911;444;1274;715;2185
412740;202004;1783;4978;1200;3768;218;801;171;540;389;1341
412750;202004;3832;10103;3162;9143;306;1073;2091;5689;2397;6762
412760;202004;2830;7705;2333;6853;425;1414;1251;3458;1676;4872
412770;202004;9996;25165;5177;15585;739;2355;1165;2992;1904;5347
412780;202004;1165;3097;860;2535;189;609;341;983;530;1592
412785;202004;1967;4853;1363;3785;145;420;858;2338;1003;2758
412788;202004;1281;3613;1051;3206;281;865;446;1336;727;2201
412790;202004;1270;3368;677;2106;106;377;216;599;322;976
412795;202004;1219;3180;638;1971;101;333;125;354;226;687
412796;202004;2171;6296;1776;5516;374;1230;585;1705;959;2935
412800;202004;3362;8161;2247;6099;267;816;1018;2471;1285;3287
412810;202004;10860;27711;6678;19145;818;2758;2545;6481;3363;9239
412820;202004;6274;17228;4356;13331;1042;3374;1265;3882;2307;7256
412830;202004;332;939;230;719;34;97;58;183;92;280
412840;202004;1763;4487;1240;3468;140;441;522;1351;662;1792
412850;202004;2777;7317;1988;5923;320;1024;837;2448;1157;3472
412853;202004;1510;3810;1249;3338;179;524;634;1517;813;2041
412855;202004;1206;3231;778;2301;141;496;228;638;369;1134
412860;202004;761;1866;517;1485;68;222;287;779;355;1001
412862;202004;665;1626;434;1242;80;238;183;503;263;741
412863;202004;1236;3760;1110;3524;196;627;668;2114;864;2741
412865;202004;685;1883;496;1498;125;384;145;455;270;839
412870;202004;845;2191;611;1810;167;561;122;384;289;945
412880;202004;782;2126;518;1582;91;320;88;232;179;552
420005;202004;392;1167;226;797;34;127;103;367;137;494
420010;202004;3211;7879;2102;6003;128;416;1537;4408;1665;4824
420020;202004;424;1335;275;954;42;168;62;173;104;341
420030;202004;74;253;54;210;17;73;17;62;34;135
420040;202004;509;1547;293;1056;59;237;17;44;76;281
420050;202004;702;1628;456;1181;68;205;280;658;348;863
420055;202004;157;488;87;317;21;100;30;87;51;187
420060;202004;99;274;55;166;11;37;14;32;25;69
420070;202004;649;2005;479;1641;106;379;190;632;296;1011
420075;202004;73;189;36;106;7;23;11;21;18;44
420080;202004;326;953;253;787;64;217;100;313;164;530
420090;202004;400;1247;231;828;52;196;40;128;92;324
420100;202004;1208;3207;996;2880;49;175;806;2296;855;2471
420110;202004;236;756;213;707;44;170;98;300;142;470
420120;202004;490;1333;316;963;61;215;140;361;201;576
420125;202004;328;1006;229;785;55;202;101;329;156;531
420127;202004;241;650;92;304;16;56;21;72;37;128
420130;202004;2905;8085;2173;6831;335;1283;1044;3015;1379;4298
420140;202004;3395;9188;2373;7386;662;2353;330;1022;992;3375
420150;202004;606;1562;409;1226;45;149;246;725;291;874
420160;202004;204;502;80;257;11;34;20;63;31;97
420165;202004;145;415;79;259;17;62;26;75;43;137
420170;202004;246;768;164;568;22;67;44;138;66;205
420180;202004;163;516;92;338;10;35;28;96;38;131
420190;202004;182;590;109;398;35;138;25;88;60;226
420195;202004;1328;3447;945;2816;292;1028;107;232;399;1260
420200;202004;4045;9889;2309;6631;305;1088;895;2205;1200;3293
420205;202004;1668;4533;1120;3439;165;532;610;1883;775;2415
420207;202004;1663;4381;1011;3133;197;696;398;1153;595;1849
420208;202004;306;873;174;626;55;215;44;150;99;365
420209;202004;145;492;83;298;23;94;23;84;46;178
420210;202004;2780;7182;1775;5540;334;1155;815;2511;1149;3666
420213;202004;743;2343;622;2090;136;494;307;1017;443;1511
420215;202004;174;536;116;403;30;114;18;59;48;173
420220;202004;241;707;144;489;25;103;68;204;93;307
420230;202004;4652;12789;3486;10590;530;1747;1838;5411;2368;7158
420240;202004;12172;33743;7320;22606;968;3412;3530;9643;4498;13055
420243;202004;367;1055;288;892;47;166;172;504;219;670
420245;202004;1191;3098;830;2473;64;234;499;1429;563;1663
420250;202004;423;1196;348;1066;56;197;193;546;249;743
420253;202004;473;1174;337;980;35;117;190;546;225;663
420257;202004;155;399;97;295;18;68;47;140;65;208
420260;202004;1059;2804;762;2383;125;445;472;1447;597;1892
420270;202004;480;1278;226;677;30;102;95;290;125;392
420280;202004;1056;3193;793;2655;157;589;269;875;426;1464
420285;202004;75;196;45;133;8;35;9;21;17;56
420287;202004;423;984;299;811;79;219;109;301;188;520
420290;202004;4202;12015;3158;9610;440;1570;1828;5115;2268;6685
420300;202004;6714;19016;3748;12018;723;2588;1008;2850;1731;5438
420310;202004;782;1807;381;1062;40;123;205;531;245;654
420315;202004;742;2106;510;1686;112;396;198;660;310;1056
420320;202004;4705;12998;3362;10675;980;3467;793;2319;1773;5786
420325;202004;254;726;172;556;30;99;74;223;104;322
420330;202004;911;2673;562;1909;106;405;167;491;273;896
420340;202004;894;2486;657;2066;160;531;93;251;253;782
420350;202004;1139;3025;829;2458;71;243;577;1675;648;1918
420360;202004;2482;6959;1299;4343;242;881;130;426;372;1307
420370;202004;986;2688;787;2361;87;305;520;1495;607;1800
420380;202004;4181;11071;2740;8475;590;1953;1002;2988;1592;4941
420390;202004;1058;2542;723;1855;131;412;301;524;432;936
420395;202004;945;2714;632;2079;100;399;82;200;182;599
420400;202004;857;2513;577;1888;107;389;199;625;306;1014
420410;202004;521;1425;397;1164;41;133;264;749;305;882
420415;202004;274;826;209;680;56;203;78;252;134;455
420417;202004;585;1752;462;1493;127;414;161;533;288;947
420419;202004;134;474;102;395;36;149;8;30;44;179
420420;202004;10207;26664;6604;20056;1912;6586;1759;4900;3671;11486
420425;202004;638;1708;417;1261;42;144;199;583;241;727
420430;202004;2978;8075;1697;5230;397;1286;537;1528;934;2814
420435;202004;240;610;113;368;16;53;54;172;70;225
420440;202004;721;1978;433;1347;109;382;173;492;282;874
420445;202004;250;627;159;455;32;96;69;186;101;282
420450;202004;636;1856;458;1466;85;330;165;458;250;788
420455;202004;1905;4733;1359;3893;192;677;675;1820;867;2497
420460;202004;8387;22438;6121;18273;934;3126;3101;8879;4035;12005
420470;202004;578;1532;306;988;59;223;67;188;126;411
420475;202004;73;191;28;92;8;27;3;11;11;38
420480;202004;5308;13094;3176;9510;648;2124;1048;3142;1696;5266
420490;202004;320;912;229;731;53;191;89;283;142;474
420500;202004;1380;3861;876;2891;157;577;374;1234;531;1811
420510;202004;156;437;85;269;10;45;27;77;37;122
420515;202004;51;119;31;76;1;1;14;30;15;31
420517;202004;730;2045;635;1875;51;152;476;1415;527;1567
420519;202004;276;663;196;548;26;81;108;311;134;392
420520;202004;287;769;140;471;25;88;12;40;37;128
420530;202004;755;2189;512;1679;88;339;190;540;278;879
420535;202004;224;667;85;299;11;44;37;119;48;163
420540;202004;34181;80867;21285;59111;3229;10178;7239;17244;10468;27422
420543;202004;204;622;156;506;20;72;82;248;102;320
420545;202004;1061;3176;794;2590;148;525;311;917;459;1442
420550;202004;3317;8900;2057;6747;340;1287;848;2843;1188;4130
420555;202004;287;834;190;623;26;98;108;336;134;434
420560;202004;378;944;248;747;54;176;137;406;191;582
420570;202004;2024;5681;1568;4814;289;995;666;1962;955;2957
420580;202004;1770;4534;1232;3693;290;951;413;1247;703;2198
420590;202004;2703;7181;1546;4681;281;1019;405;930;686;1949
420600;202004;933;2743;699;2280;106;398;380;1188;486;1586
420610;202004;345;1003;188;637;42;149;63;222;105;371
420620;202004;655;1621;418;1227;93;286;172;496;265;782
420630;202004;803;2442;573;1873;81;286;320;991;401;1277
420640;202004;465;1280;216;753;70;237;17;66;87;303
420650;202004;3340;8829;1936;5878;286;957;706;1835;992;2792
420660;202004;349;908;224;648;45;139;68;179;113;318
420665;202004;558;1461;348;1096;62;227;155;433;217;660
420670;202004;1258;3461;811;2559;133;509;317;881;450;1390
420675;202004;154;438;84;292;14;66;38;117;52;183
420680;202004;311;724;153;505;27;106;77;238;104;344
420690;202004;767;2281;438;1489;63;256;99;275;162;531
420700;202004;2529;6669;1877;5555;239;775;1054;3017;1293;3792
420710;202004;799;2328;597;1891;63;263;351;1021;414;1284
420720;202004;1160;3244;822;2650;175;589;395;1228;570;1817
420730;202004;2902;7580;2113;6265;355;1154;1121;3209;1476;4363
420740;202004;500;1515;294;1055;88;337;26;107;114;444
420750;202004;1784;5203;1142;3698;201;766;450;1329;651;2095
420757;202004;73;185;36;118;4;8;17;53;21;61
420760;202004;334;987;154;483;38;128;38;102;76;230
420765;202004;448;1291;197;663;28;116;88;286;116;402
420768;202004;1244;3562;1072;3270;143;434;785;2388;928;2822
420770;202004;427;1155;202;701;35;137;82;268;117;405
420775;202004;247;749;172;574;42;156;44;120;86;276
420780;202004;830;2258;496;1557;113;390;99;277;212;667
420785;202004;186;498;127;369;14;47;63;151;77;198
420790;202004;964;2977;701;2432;119;490;374;1232;493;1722
420800;202004;625;1581;290;894;84;295;65;189;149;484
420810;202004;1321;4176;1061;3650;310;1220;322;934;632;2154
420820;202004;10984;27362;7709;22004;1491;4812;3560;9295;5051;14107
420830;202004;3348;8855;2425;7167;444;1452;1035;2987;1479;4439
420840;202004;461;1348;215;783;64;262;26;79;90;341
420845;202004;2208;5672;1288;3999;242;922;512;1499;754;2421
420850;202004;987;3207;592;2150;106;423;100;323;206;746
420860;202004;286;738;148;492;32;117;36;111;68;228
420870;202004;751;2091;562;1735;143;523;239;670;382;1193
420880;202004;931;2882;718;2439;154;628;267;835;421;1463
420890;202004;7475;20290;4461;14019;687;2404;1491;4113;2178;6517
420895;202004;160;464;97;299;23;74;30;95;53;169
420900;202004;1327;3276;774;2314;106;393;337;866;443;1259
420910;202004;26597;69896;16097;49452;2489;8732;6284;17295;8773;26027
420915;202004;510;1845;367;1429;53;206;193;775;246;981
420917;202004;321;795;162;450;28;83;79;218;107;301
420920;202004;67;177;21;77;0;0;3;9;3;9
420930;202004;16015;41849;11137;33208;2054;6812;4890;13833;6944;20645
420940;202004;2654;6481;1490;4459;376;1289;268;647;644;1936
420945;202004;127;363;99;301;23;80;40;110;63;190
420950;202004;309;901;166;550;27;101;37;111;64;212
420960;202004;943;2329;666;1849;119;404;291;706;410;1110
420970;202004;2162;6152;1482;4837;419;1429;330;1086;749;2515
420980;202004;255;845;223;780;110;388;64;237;174;625
420985;202004;299;855;144;512;36;140;45;139;81;279
420990;202004;292;905;152;545;30;109;31;97;61;206
421000;202004;480;1456;327;1113;77;285;85;263;162;548
421003;202004;451;1071;152;443;11;41;27;74;38;115
421005;202004;53;152;41;134;9;30;20;63;29;93
421010;202004;2947;8116;2093;6532;444;1587;555;1542;999;3129
421020;202004;350;1094;270;946;42;178;138;458;180;636
421030;202004;715;2191;551;1839;167;630;172;533;339;1163
421040;202004;636;1506;400;1150;28;93;247;703;275;796
421050;202004;910;2473;564;1687;113;376;200;515;313;891
421055;202004;165;441;85;260;10;38;51;140;61;178
421060;202004;545;1585;362;1159;72;267;160;452;232;719
421070;202004;607;1862;332;1167;73;282;92;314;165;596
421080;202004;471;1369;395;1223;43;154;246;754;289;908
421085;202004;357;1010;115;404;15;49;14;33;29;82
421090;202004;223;574;144;423;13;43;51;139;64;182
421100;202004;782;1744;310;949;92;330;79;198;171;528
421105;202004;1468;4088;995;3093;180;574;442;1307;622;1881
421110;202004;1039;2743;857;2508;20;59;638;1973;658;2032
421120;202004;818;2514;593;1998;88;331;199;621;287;952
421125;202004;272;718;191;568;71;230;67;161;138;391
421130;202004;4546;13371;3691;11668;899;3242;1800;5327;2699;8569
421140;202004;323;885;180;570;32;102;54;160;86;262
421145;202004;416;1165;266;845;61;218;97;278;158;496
421150;202004;563;1507;332;1046;60;225;158;464;218;689
421160;202004;487;1299;341;1022;48;158;221;644;269;802
421165;202004;190;555;118;386;24;83;49;156;73;239
421170;202004;1023;2703;801;2360;133;380;484;1476;617;1856
421175;202004;972;2440;584;1834;118;417;250;759;368;1176
421180;202004;369;956;196;604;37;145;73;207;110;352
421185;202004;306;826;206;617;28;97;121;359;149;456
421187;202004;265;809;162;537;29;97;52;159;81;256
421189;202004;345;1002;262;837;44;152;101;300;145;452
421190;202004;9818;26626;6416;20153;1238;4270;2176;6319;3414;10589
421200;202004;616;1812;494;1578;53;193;319;994;372;1187
421205;202004;175;461;126;379;25;93;58;157;83;250
421210;202004;1037;2674;599;1919;128;416;229;745;357;1161
421220;202004;1247;3787;957;3163;226;817;292;878;518;1695
421223;202004;323;899;198;661;48;158;90;307;138;465
421225;202004;856;2545;720;2304;125;447;428;1364;553;1811
421227;202004;641;1833;396;1309;79;286;172;579;251;865
421230;202004;565;1499;352;1105;65;239;132;399;197;638
421240;202004;267;804;123;452;11;45;16;57;27;102
421250;202004;1749;4459;1201;3575;146;508;671;1913;817;2421
421260;202004;168;485;46;176;13;61;9;31;22;92
421265;202004;610;1598;543;1516;6;20;514;1439;520;1459
421270;202004;324;861;136;489;18;62;53;186;71;248
421280;202004;1645;4527;1210;3762;186;714;672;1954;858;2668
421290;202004;891;2420;435;1349;76;252;95;276;171;528
421300;202004;271;702;139;440;16;58;20;60;36;118
421310;202004;176;499;118;388;24;82;62;207;86;289
421315;202004;215;600;137;428;42;114;30;106;72;220
421320;202004;579;1773;283;976;31;100;37;89;68;189
421330;202004;562;1673;406;1345;80;313;112;351;192;664
421335;202004;323;976;265;875;66;250;113;359;179;609
421340;202004;1252;3542;884;2826;167;601;363;1075;530;1676
421350;202004;1323;3454;852;2622;183;662;340;969;523;1631
421360;202004;2153;5840;1238;3943;235;912;475;1311;710;2223
421370;202004;544;1816;333;1238;63;249;88;286;151;535
421380;202004;759;2046;649;1870;85;276;390;1097;475;1373
421390;202004;161;435;54;187;12;35;20;61;32;96
421400;202004;292;942;207;742;36;137;108;372;144;509
421410;202004;200;532;82;283;19;75;26;80;45;155
421415;202004;168;513;94;310;21;64;19;56;40;120
421420;202004;487;1329;392;1154;35;117;252;717;287;834
421430;202004;98;303;74;245;8;28;19;57;27;85
421440;202004;574;1557;339;1123;70;227;144;466;214;693
421450;202004;407;1204;235;802;32;137;37;130;69;267
421460;202004;344;1003;182;652;22;86;35;102;57;188
421470;202004;238;701;134;468;28;99;50;181;78;280
421480;202004;2566;6937;1638;5074;357;1321;613;1710;970;3031
421490;202004;109;370;63;236;7;28;15;40;22;68
421500;202004;1988;5881;1377;4616;375;1470;323;937;698;2407
421505;202004;275;784;229;719;35;125;147;445;182;570
421507;202004;412;1175;219;742;55;196;73;233;128;429
421510;202004;262;755;151;485;22;80;77;225;99;305
421520;202004;451;1188;277;794;30;96;167;450;197;546
421530;202004;276;828;156;555;31;138;42;119;73;257
421535;202004;366;972;221;713;32;129;116;353;148;482
421540;202004;271;637;129;398;19;64;45;124;64;188
421545;202004;658;1956;491;1651;109;434;238;745;347;1179
421550;202004;1875;5118;1498;4549;266;851;868;2625;1134;3476
421555;202004;163;492;67;231;12;46;8;19;20;65
421560;202004;76;251;50;191;11;41;16;53;27;94
421565;202004;854;2207;559;1742;148;508;151;477;299;985
421567;202004;414;1389;267;960;99;370;62;209;161;579
421568;202004;321;964;243;781;32;118;113;352;145;470
421569;202004;150;438;72;240;17;61;34;109;51;170
421570;202004;1006;2736;703;2157;173;598;213;596;386;1194
421575;202004;274;799;195;590;29;102;83;213;112;315
421580;202004;3259;9048;2096;6604;365;1383;805;2165;1170;3548
421590;202004;128;400;103;343;33;121;26;72;59;193
421600;202004;528;1444;353;1078;77;259;104;270;181;529
421605;202004;692;1805;481;1463;82;222;248;804;330;1026
421610;202004;964;2659;614;1991;112;395;194;609;306;1004
421620;202004;3685;9772;2103;6840;463;1698;564;1749;1027;3447
421625;202004;128;358;57;185;13;44;14;45;27;89
421630;202004;2152;5666;1260;3899;222;810;401;1033;623;1843
421635;202004;242;664;170;512;19;59;101;283;120;342
421640;202004;692;1864;495;1556;96;343;211;648;307;991
421650;202004;2144;5880;1347;4359;326;1246;377;1010;703;2256
421660;202004;9000;25143;6120;19537;974;3496;2595;7582;3569;11078
421670;202004;709;2070;496;1560;85;302;246;746;331;1048
421680;202004;979;2712;733;2266;194;647;343;969;537;1616
421690;202004;1227;3563;828;2708;164;608;304;986;468;1594
421700;202004;443;1335;268;919;52;192;85;278;137;470
421710;202004;196;618;87;292;18;62;23;73;41;135
421715;202004;90;260;68;210;15;39;43;131;58;170
421720;202004;1759;4802;1015;3206;260;904;272;744;532;1648
421725;202004;221;544;109;343;22;76;44;104;66;180
421730;202004;403;1163;209;625;26;85;106;295;132;380
421740;202004;604;1712;399;1261;105;343;99;275;204;618
421750;202004;825;1946;367;1090;84;278;136;362;220;640
421755;202004;145;402;83;251;13;53;43;113;56;166
421760;202004;819;2177;525;1645;81;288;192;519;273;807
421770;202004;2306;6168;1653;5014;427;1282;597;1963;1024;3245
421775;202004;202;516;122;362;16;49;55;152;71;201
421780;202004;755;2250;477;1640;98;391;194;629;292;1020
421790;202004;733;1897;416;1338;90;298;200;626;290;924
421795;202004;172;477;121;360;23;84;42;113;65;197
421800;202004;2355;6404;1684;5158;214;772;961;2785;1175;3557
421810;202004;571;1582;385;1226;47;181;228;701;275;882
421820;202004;898;2610;506;1649;102;376;157;410;259;786
421825;202004;1247;3555;1103;3328;120;390;772;2282;892;2672
421830;202004;1898;5680;1536;4989;314;1087;651;2055;965;3142
421835;202004;184;468;106;335;20;75;31;96;51;171
421840;202004;209;673;138;499;28;106;35;117;63;223
421850;202004;355;991;186;629;36;132;58;152;94;284
421860;202004;301;848;162;560;23;88;55;172;78;260
421870;202004;3795;9635;2664;7515;480;1610;1269;3165;1749;4775
421875;202004;225;663;100;334;15;59;27;70;42;129
421880;202004;531;1526;345;1111;91;341;83;272;174;613
421885;202004;197;562;118;377;31;101;27;81;58;182
421890;202004;779;2402;570;1983;112;462;284;931;396;1393
421895;202004;388;994;323;908;38;119;221;647;259;766
421900;202004;900;2372;630;1809;93;312;280;729;373;1041
421910;202004;281;827;190;615;33;128;55;152;88;280
421915;202004;357;1015;193;625;38;121;29;84;67;205
421917;202004;535;1272;296;963;115;408;70;241;185;649
421920;202004;364;1119;263;919;107;393;70;234;177;627
421930;202004;2363;6005;1138;3616;284;1006;312;893;596;1899
421935;202004;376;1205;294;1020;59;215;164;548;223;763
421940;202004;310;912;138;449;24;88;33;96;57;184
421950;202004;2752;6948;1479;4568;302;1044;358;980;660;2024
421960;202004;172;439;88;280;19;68;20;56;39;124
421970;202004;1767;4574;1025;3077;213;749;364;919;577;1668
421985;202004;271;718;148;475;16;53;56;168;72;221
422000;202004;1824;4807;1466;4211;154;522;1004;2842;1158;3364
430003;202004;536;1494;350;1130;66;230;145;468;211;698
430005;202004;256;672;161;502;30;102;72;212;102;314
430010;202004;1671;4088;1326;3551;137;407;944;2447;1081;2854
430020;202004;560;1300;416;1102;46;150;273;693;319;843
430030;202004;959;2283;522;1498;135;442;165;429;300;871
430040;202004;9683;23486;5544;16054;1449;4544;631;1954;2080;6498
430045;202004;489;1225;330;936;23;77;222;617;245;694
430047;202004;237;517;85;243;22;69;21;57;43;126
430050;202004;851;2159;489;1423;108;331;119;322;227;653
430055;202004;237;590;108;322;12;50;63;168;75;218
430057;202004;77;167;27;76;7;26;7;12;14;38
430060;202004;15919;42828;12118;36851;2567;8283;5541;16833;8108;25116
430063;202004;825;2320;648;1942;123;365;358;1070;481;1435
430064;202004;968;2670;712;2138;211;652;271;792;482;1444
430066;202004;91;193;65;154;5;11;52;117;57;128
430070;202004;730;1867;86;295;6;23;16;49;22;72
430080;202004;756;1876;454;1284;78;258;236;586;314;844
430085;202004;821;1879;494;1354;99;284;208;558;307;842
430087;202004;504;1281;409;1153;58;151;267;768;325;919
430090;202004;515;1322;167;526;11;42;59;173;70;215
430100;202004;665;1599;373;1041;63;212;175;426;238;638
430105;202004;1059;2854;672;2174;128;480;308;973;436;1453
430107;202004;158;468;90;289;18;69;24;61;42;130
430110;202004;2020;5103;1457;4268;223;702;791;2300;1014;3002
430120;202004;1134;3387;729;2367;128;442;333;1081;461;1523
430130;202004;3331;7755;2422;6469;910;2437;425;1380;1335;3817
430140;202004;851;2350;591;1850;134;410;284;861;418;1271
430150;202004;532;1363;284;862;62;204;100;288;162;492
430155;202004;239;615;106;326;17;48;22;62;39;110
430160;202004;18233;43607;13947;37470;1618;4765;8184;21867;9802;26632
430163;202004;2680;6599;1830;5208;86;279;1282;3632;1368;3911
430165;202004;294;717;77;252;15;35;10;27;25;62
430170;202004;874;2317;310;1078;46;172;47;147;93;319
430175;202004;633;1933;529;1707;132;432;248;785;380;1217
430180;202004;629;1536;498;1323;56;150;349;922;405;1072
430185;202004;540;1357;270;796;68;184;63;165;131;349
430187;202004;652;1492;460;1250;76;223;233;675;309;898
430190;202004;1304;3499;1038;3072;215;700;490;1378;705;2078
430192;202004;122;329;40;120;6;18;10;26;16;44
430195;202004;397;1191;49;180;6;17;7;26;13;43
430200;202004;1053;3158;840;2772;278;954;241;819;519;1773
430205;202004;448;1176;392;1079;13;43;337;904;350;947
430210;202004;4703;12165;3090;8672;576;1735;1020;2349;1596;4084
430215;202004;297;765;183;533;39;123;69;201;108;324
430220;202004;615;1526;168;574;26;115;32;77;58;192
430222;202004;165;475;118;372;11;42;44;135;55;177
430223;202004;232;618;178;527;17;54;114;332;131;386
430225;202004;16;31;11;23;1;2;9;19;10;21
430230;202004;1722;4877;1456;4465;127;428;1073;3257;1200;3685
430235;202004;293;842;186;600;43;162;54;151;97;313
430237;202004;481;1172;345;939;22;62;244;646;266;708
430240;202004;1140;2634;618;1723;80;282;336;855;416;1137
430245;202004;672;1961;506;1631;148;493;231;767;379;1260
430250;202004;858;2169;609;1777;217;691;47;120;264;811
430258;202004;120;319;88;256;7;13;46;143;53;156
430260;202004;626;1661;430;1281;56;185;242;715;298;900
430265;202004;191;538;126;415;28;87;38;129;66;216
430270;202004;2728;6810;2141;5891;390;1180;1261;3358;1651;4538
430280;202004;4817;11469;3273;8778;678;1855;1394;3712;2072;5567
430290;202004;2169;5027;1758;4544;47;160;1506;3804;1553;3964
430300;202004;9123;23511;6833;19436;1109;3441;3598;10020;4707;13461
430310;202004;10911;27238;7113;20049;926;2932;3341;8777;4267;11709
430320;202004;965;2525;515;1604;65;191;278;887;343;1078
430330;202004;630;1560;382;1067;62;191;169;417;231;608
430340;202004;682;1486;367;1008;45;135;215;574;260;709
430350;202004;6936;18000;5048;14562;793;2437;2737;7606;3530;10043
430355;202004;318;838;105;341;17;58;14;38;31;96
430360;202004;833;1952;528;1431;104;318;208;523;312;841
430367;202004;305;706;166;454;30;94;90;236;120;330
430370;202004;464;1261;210;653;38;125;54;144;92;269
430380;202004;646;1609;318;1001;76;287;87;256;163;543
430390;202004;2826;6792;1547;4422;278;917;229;449;507;1366
430400;202004;1029;2212;788;1872;61;177;549;1252;610;1429
430410;202004;519;1246;356;979;52;157;221;583;273;740
430420;202004;2558;7062;1950;5709;510;1561;838;2334;1348;3895
430430;202004;571;1461;265;812;66;196;62;199;128;395
430435;202004;1428;3649;1088;3096;196;598;560;1604;756;2202
430440;202004;3372;9417;2551;7925;273;960;1550;4769;1823;5729
430450;202004;6321;16092;5002;13754;740;2284;2700;7156;3440;9440
430460;202004;28477;73191;20374;59721;3733;12107;9869;27685;13602;39792
430461;202004;277;711;82;257;12;40;29;78;41;118
430462;202004;225;616;124;412;19;61;45;153;64;214
430463;202004;5216;13967;3803;11430;777;2577;1708;4927;2485;7504
430465;202004;402;1046;334;926;51;159;207;552;258;711
430466;202004;3897;9870;3002;8403;751;2201;1384;3676;2135;5877
430467;202004;466;1133;316;892;43;140;165;444;208;584
430468;202004;1203;2991;926;2573;84;252;597;1627;681;1879
430469;202004;553;1500;64;208;6;15;13;19;19;34
430470;202004;5219;13445;3423;10215;1003;3288;906;2520;1909;5808
430471;202004;516;1469;417;1285;60;208;241;702;301;910
430480;202004;702;1859;369;1141;49;166;84;232;133;398
430485;202004;163;436;63;198;16;45;7;25;23;70
430490;202004;365;952;204;609;25;90;99;267;124;357
430495;202004;357;962;221;689;30;95;95;280;125;375
430500;202004;943;2450;640;1940;210;694;179;487;389;1181
430510;202004;23543;61910;16563;48045;2800;9217;7422;19748;10222;28965
430511;202004;311;910;128;420;14;53;20;55;34;108
430512;202004;913;2073;699;1756;166;419;260;670;426;1089
430513;202004;752;1882;343;1000;49;156;172;473;221;629
430515;202004;360;1016;255;803;34;101;134;419;168;520
430517;202004;1063;3303;778;2621;133;457;393;1350;526;1807
430520;202004;1209;3123;601;1791;114;364;132;360;246;724
430530;202004;924;2342;360;1127;72;219;92;277;164;496
430535;202004;3035;7967;2172;6369;311;954;1098;3119;1409;4073
430537;202004;312;1109;291;1044;20;64;234;840;254;904
430540;202004;559;1380;324;973;52;156;154;465;206;621
430543;202004;730;1307;399;933;54;107;187;485;241;592
430544;202004;655;1884;455;1435;112;362;174;539;286;901
430545;202004;2134;5613;1565;4721;309;971;775;2395;1084;3366
430550;202004;331;927;232;714;46;147;86;249;132;396
430558;202004;109;251;46;125;6;12;18;49;24;61
430560;202004;328;746;138;422;18;62;45;136;63;198
430570;202004;794;1941;547;1475;90;273;286;727;376;1000
430580;202004;814;2036;577;1661;145;442;249;708;394;1150
430583;202004;196;489;34;108;4;13;7;19;11;32
430585;202004;216;526;105;287;13;36;49;125;62;161
430587;202004;189;536;138;429;17;52;57;183;74;235
430590;202004;1368;3282;1122;2913;54;164;937;2384;991;2548
430593;202004;15;52;10;34;1;3;5;16;6;19
430595;202004;412;1016;108;348;12;49;24;57;36;106
430597;202004;408;1056;207;627;19;60;70;163;89;223
430600;202004;1830;4694;784;2273;138;422;217;573;355;995
430605;202004;1094;2988;801;2427;112;404;362;1048;474;1452
430607;202004;502;1192;405;1035;24;66;296;744;320;810
430610;202004;5458;12871;3596;10004;1029;3210;785;2153;1814;5363
430613;202004;254;593;67;194;8;24;18;41;26;65
430620;202004;562;1383;406;1091;61;182;233;577;294;759
430630;202004;401;1110;109;356;18;59;22;66;40;125
430632;202004;470;1239;197;609;24;80;91;268;115;348
430635;202004;517;1231;380;1002;47;125;270;719;317;844
430637;202004;441;1093;341;947;36;117;215;566;251;683
430640;202004;959;2511;559;1694;80;260;188;524;268;784
430642;202004;345;943;261;748;41;111;140;377;181;488
430645;202004;149;350;55;148;9;24;16;43;25;67
430650;202004;1535;4475;1220;3947;333;1080;579;1947;912;3027
430655;202004;260;655;152;431;23;75;75;186;98;261
430660;202004;4854;12644;3622;10547;815;2527;1558;4463;2373;6990
430670;202004;641;1557;484;1277;35;99;292;774;327;873
430673;202004;519;1181;201;590;37;113;74;201;111;314
430675;202004;237;681;54;192;8;28;25;90;33;118
430676;202004;4570;11486;3580;9965;440;1357;2263;6140;2703;7497
430680;202004;856;2321;517;1625;143;456;128;393;271;849
430690;202004;2737;7497;2145;6411;740;2324;585;1661;1325;3985
430692;202004;210;644;160;557;11;44;118;417;129;461
430693;202004;934;2468;553;1698;104;374;145;398;249;772
430695;202004;428;1112;235;698;32;89;125;359;157;448
430697;202004;380;970;286;820;72;191;143;443;215;634
430700;202004;6361;15893;3578;10680;769;2517;632;1759;1401;4276
430705;202004;376;915;183;555;22;76;72;192;94;268
430710;202004;1607;3502;1114;2823;141;400;675;1678;816;2078
430720;202004;666;1616;338;1034;49;148;173;534;222;682
430730;202004;993;2732;673;2115;92;279;360;1123;452;1402
430740;202004;561;1540;281;939;51;180;72;259;123;439
430745;202004;352;979;218;682;41;149;69;183;110;332
430750;202004;1272;3267;881;2597;188;574;462;1336;650;1910
430755;202004;447;1078;274;731;18;52;160;391;178;443
430760;202004;1944;4801;1463;4045;344;1032;653;1715;997;2747
430770;202004;5898;14808;4486;12688;586;1895;2830;7735;3416;9630
430780;202004;1809;4422;1020;3043;204;676;394;1131;598;1807
430781;202004;441;1239;238;755;30;94;69;186;99;280
430783;202004;348;806;207;591;20;73;127;336;147;409
430786;202004;29;106;21;81;3;9;3;15;6;24
430790;202004;4128;10147;2827;7888;326;1089;1724;4494;2050;5583
430800;202004;737;1716;540;1413;32;89;359;945;391;1034
430805;202004;357;966;218;658;17;61;134;379;151;440
430807;202004;419;1008;214;607;18;51;94;246;112;297
430810;202004;660;1547;258;766;28;107;112;307;140;414
430820;202004;1141;3044;649;2080;134;447;180;563;314;1010
430825;202004;225;565;78;204;13;33;23;55;36;88
430830;202004;1638;4721;1303;4069;59;213;940;2901;999;3114
430840;202004;970;2452;691;1970;90;283;469;1306;559;1589
430843;202004;119;281;49;136;2;7;25;65;27;72
430845;202004;408;980;270;749;52;160;110;289;162;449
430850;202004;2251;5866;1510;4410;239;770;598;1765;837;2535
430860;202004;866;2006;375;1064;45;159;180;436;225;595
430865;202004;500;1243;368;1019;71;200;175;477;246;677
430870;202004;592;1546;251;796;37;142;79;219;116;361
430880;202004;1375;3180;912;2469;152;435;486;1277;638;1712
430885;202004;175;474;87;298;6;20;51;171;57;191
430890;202004;958;2397;625;1818;54;231;132;355;186;586
430900;202004;2910;6403;1966;5029;163;495;1294;3118;1457;3613
430905;202004;730;1863;453;1334;83;280;169;456;252;736
430910;202004;1444;3826;983;2886;161;568;480;1252;641;1820
430912;202004;479;1334;317;1011;24;72;214;698;238;770
430915;202004;459;1419;344;1193;124;432;93;332;217;764
430920;202004;22418;56895;16885;47580;2325;7245;10078;27655;12403;34900
430925;202004;94;213;34;103;5;13;15;49;20;62
430930;202004;9990;23710;6241;17872;1204;3526;2571;7690;3775;11216
430940;202004;913;2390;535;1566;145;460;138;334;283;794
430950;202004;731;1726;458;1253;38;136;281;703;319;839
430955;202004;330;887;82;254;21;64;20;50;41;114
430957;202004;174;599;159;560;25;90;97;338;122;428
430960;202004;1307;3132;723;2048;156;477;312;855;468;1332
430965;202004;1572;3754;1206;3179;61;173;943;2525;1004;2698
430970;202004;343;833;169;486;24;73;84;218;108;291
430975;202004;479;1448;361;1170;78;263;181;567;259;830
430980;202004;370;846;215;581;30;95;103;250;133;345
430990;202004;526;1511;322;1016;41;129;160;508;201;637
430995;202004;533;1379;384;1136;45;142;210;610;255;752
431000;202004;1304;3075;510;1483;89;290;38;99;127;389
431010;202004;1944;5005;1164;3675;235;818;210;560;445;1378
431020;202004;7835;16995;4549;12019;1044;3127;1521;3488;2565;6615
431030;202004;320;882;155;525;28;100;22;70;50;170
431033;202004;3406;8112;2113;6060;466;1372;728;2123;1194;3495
431036;202004;328;707;68;193;5;15;22;53;27;68
431040;202004;868;2231;554;1661;86;293;244;673;330;966
431041;202004;446;1031;326;851;25;60;199;512;224;572
431043;202004;324;807;172;534;35;125;82;248;117;373
431046;202004;102;267;39;119;2;5;10;30;12;35
431050;202004;1287;3167;913;2563;167;518;470;1334;637;1852
431053;202004;599;1645;321;1024;72;259;91;251;163;510
431055;202004;557;1374;464;1233;51;125;330;876;381;1001
431057;202004;235;671;116;384;26;85;33;100;59;185
431060;202004;5131;13351;3407;10320;824;2714;886;2663;1710;5377
431065;202004;379;953;262;756;47;146;121;342;168;488
431070;202004;409;1155;226;734;53;184;52;164;105;348
431075;202004;208;615;125;418;24;87;38;128;62;215
431080;202004;531;1462;352;1082;65;231;120;355;185;586
431085;202004;703;1851;442;1242;64;176;214;592;278;768
431087;202004;400;1140;322;974;21;62;224;700;245;762
431090;202004;393;927;151;466;28;95;44;139;72;234
431100;202004;3259;7185;2213;5771;318;850;1128;2992;1446;3842
431110;202004;1309;3035;871;2289;271;727;317;774;588;1501
431112;202004;525;1484;436;1308;69;231;256;742;325;973
431113;202004;339;949;292;857;46;152;179;512;225;664
431115;202004;940;2695;724;2292;101;384;413;1225;514;1609
431120;202004;2260;6354;1514;4806;470;1678;354;1008;824;2686
431123;202004;387;1076;242;766;42;118;133;439;175;557
431125;202004;953;2784;725;2326;260;810;250;858;510;1668
431127;202004;192;500;55;178;6;19;10;27;16;46
431130;202004;2841;7318;2054;5978;301;1004;1155;3258;1456;4262
431140;202004;4844;11474;2715;7450;352;1062;1192;2862;1544;3924
431142;202004;479;1284;352;1053;48;152;218;649;266;801
431150;202004;987;2653;686;2081;129;424;293;861;422;1285
431160;202004;628;1806;416;1326;68;233;128;411;196;644
431162;202004;475;1156;251;743;26;89;139;385;165;474
431164;202004;168;384;37;113;9;29;4;7;13;36
431170;202004;444;1249;308;953;97;295;86;252;183;547
431171;202004;614;1460;492;1295;102;239;293;801;395;1040
431173;202004;389;1032;286;874;76;262;117;334;193;596
431175;202004;1139;2692;669;1871;107;302;241;652;348;954
431177;202004;734;2048;548;1744;135;479;308;943;443;1422
431179;202004;331;714;89;259;16;50;20;51;36;101
431180;202004;2080;5279;1252;3646;323;931;342;998;665;1929
431190;202004;427;1124;206;640;30;98;67;166;97;264
431198;202004;327;969;266;862;99;340;72;252;171;592
431200;202004;350;884;67;194;14;41;6;15;20;56
431205;202004;192;526;95;302;25;84;36;114;61;198
431210;202004;583;1480;465;1315;114;324;221;668;335;992
431213;202004;232;627;169;510;13;42;88;271;101;313
431215;202004;548;1307;234;688;25;81;112;312;137;393
431217;202004;145;377;96;289;6;23;58;165;64;188
431220;202004;533;1386;310;942;30;109;175;492;205;601
431225;202004;1469;3499;1111;2897;114;320;774;2026;888;2346
431230;202004;638;1847;485;1494;62;211;294;875;356;1086
431235;202004;148;377;21;73;2;5;4;17;6;22
431237;202004;309;987;254;855;48;176;136;437;184;613
431238;202004;23;60;18;50;5;16;6;11;11;27
431240;202004;3983;9993;3028;8484;468;1466;1695;4569;2163;6035
431242;202004;236;645;199;584;42;131;106;302;148;433
431244;202004;307;735;156;435;22;75;56;134;78;209
431245;202004;1250;2926;772;2085;80;239;407;1039;487;1278
431247;202004;211;557;110;337;21;74;36;85;57;159
431250;202004;1576;3987;1146;3399;248;762;596;1835;844;2597
431260;202004;219;614;139;454;20;83;47;141;67;224
431261;202004;225;695;179;621;14;57;98;323;112;380
431262;202004;358;997;173;561;8;21;117;386;125;407
431265;202004;1514;3580;580;1712;73;263;207;529;280;792
431267;202004;271;722;165;482;7;33;118;311;125;344
431270;202004;2678;6119;1401;3942;340;995;442;1261;782;2256
431275;202004;115;332;57;184;23;74;10;31;33;105
431280;202004;218;580;60;191;6;21;7;14;13;35
431290;202004;287;846;186;589;34;123;34;80;68;203
431295;202004;70;180;22;70;3;9;7;23;10;32
431300;202004;284;731;49;154;3;10;13;30;16;40
431301;202004;299;854;62;204;8;19;5;15;13;34
431303;202004;533;1415;309;919;23;80;142;394;165;474
431306;202004;2082;4846;1180;3333;171;540;498;1242;669;1782
431308;202004;24;73;21;67;9;31;10;31;19;62
431310;202004;505;1437;351;1086;41;133;160;458;201;591
431320;202004;573;1557;275;909;39;120;51;146;90;266
431330;202004;1543;3630;699;2049;143;479;252;661;395;1140
431333;202004;214;571;104;307;18;50;39;108;57;158
431335;202004;40;109;21;65;4;8;3;7;7;15
431337;202004;2493;6631;1787;5451;337;1161;899;2642;1236;3803
431339;202004;388;1017;279;813;79;237;114;330;193;567
431340;202004;18210;44069;12292;34075;2152;6587;5412;14125;7564;20712
431342;202004;404;874;293;717;14;31;261;641;275;672
431344;202004;382;980;221;665;8;31;127;363;135;394
431346;202004;246;602;94;304;15;53;29;93;44;146
431349;202004;609;1603;316;946;79;228;116;348;195;576
431350;202004;3823;9962;2778;8130;408;1357;1458;4114;1866;5471
431360;202004;551;1311;270;767;80;231;75;209;155;440
431365;202004;1870;4483;1462;3921;114;346;1084;2875;1198;3221
431370;202004;4155;10286;2931;8207;638;1860;1413;4062;2051;5922
431380;202004;771;2086;620;1842;34;112;437;1299;471;1411
431390;202004;2463;5992;1435;4144;165;568;678;1718;843;2286
431395;202004;1214;3050;835;2462;192;589;364;1110;556;1699
431400;202004;308;866;162;515;28;86;36;108;64;194
431402;202004;835;1885;597;1522;78;214;396;985;474;1199
431403;202004;186;532;145;456;23;86;68;183;91;269
431405;202004;4239;11192;3205;9477;585;1915;1539;4342;2124;6257
431406;202004;505;1444;359;1137;76;233;188;611;264;844
431407;202004;416;1181;285;903;59;213;145;434;204;647
431410;202004;15630;39686;10014;29556;1530;5206;4894;13525;6424;18731
431413;202004;219;574;57;186;5;14;8;27;13;41
431415;202004;643;1575;392;1152;72;251;186;484;258;735
431417;202004;528;1176;360;922;55;159;202;508;257;667
431420;202004;1518;3453;1117;2889;161;422;619;1601;780;2023
431430;202004;526;1355;246;779;38;128;72;193;110;321
431440;202004;29088;68281;19986;53855;3456;10045;7758;19722;11214;29767
431442;202004;102;276;47;154;8;22;8;22;16;44
431445;202004;373;1052;118;390;16;48;10;31;26;79
431446;202004;260;774;192;635;35;129;97;307;132;436
431447;202004;659;1770;384;1180;77;262;136;418;213;680
431449;202004;721;1899;429;1278;76;215;177;534;253;749
431450;202004;2126;4440;1673;3807;89;218;1301;2889;1390;3107
431454;202004;31;101;27;92;6;19;10;35;16;54
431455;202004;594;1429;290;791;36;104;148;365;184;469
431460;202004;2679;6626;1899;5234;495;1447;535;1499;1030;2946
431470;202004;1376;3877;987;3041;193;607;431;1354;624;1961
431475;202004;241;656;37;144;3;11;3;10;6;21
431477;202004;382;998;226;674;39;114;90;235;129;349
431478;202004;252;658;48;151;11;31;7;18;18;49
431480;202004;2941;7393;2269;6332;541;1543;1132;3196;1673;4739
431490;202004;106140;250651;79948;210220;5928;18409;58101;146939;64029;165348
431500;202004;462;1169;334;923;59;165;182;484;241;649
431505;202004;268;642;183;514;11;35;129;361;140;396
431507;202004;335;794;129;387;41;132;36;97;77;229
431510;202004;1472;3832;978;2875;216;689;359;1033;575;1722
431513;202004;190;410;109;287;10;23;74;195;84;218
431514;202004;95;243;62;182;4;11;43;121;47;132
431515;202004;443;1114;312;882;67;184;155;443;222;627
431517;202004;61;185;50;158;8;25;23;69;31;94
431520;202004;407;993;152;477;22;80;65;173;87;253
431530;202004;3986;8523;2227;5899;510;1383;538;1435;1048;2818
431531;202004;203;508;121;348;13;39;55;144;68;183
431532;202004;534;1243;315;850;71;216;124;318;195;534
431535;202004;231;628;104;339;18;65;24;65;42;130
431540;202004;1746;5642;1621;5469;57;243;1321;4461;1378;4704
431545;202004;331;853;59;181;6;14;13;39;19;53
431550;202004;1918;4933;1430;4010;243;762;730;1951;973;2713
431555;202004;646;1467;400;1050;25;78;238;613;263;691
431560;202004;21254;52002;14154;40777;2881;8742;4789;14529;7670;23271
431570;202004;4350;10559;3455;9258;405;1215;2428;6230;2833;7445
431575;202004;218;548;160;444;41;100;44;128;85;228
431580;202004;576;1496;345;1022;41;148;189;530;230;678
431590;202004;570;1580;432;1296;95;297;168;522;263;819
431595;202004;340;936;215;658;45;139;87;244;132;383
431600;202004;1285;2948;864;2339;221;648;331;918;552;1566
431610;202004;1337;3457;898;2638;127;364;470;1416;597;1780
431620;202004;461;1182;207;607;32;91;80;226;112;317
431630;202004;1277;3200;586;1755;95;314;205;558;300;872
431640;202004;5976;14588;5041;13407;499;1376;3731;10014;4230;11390
431642;202004;528;1303;323;884;22;56;164;416;186;472
431643;202004;356;882;169;488;16;43;55;157;71;200
431645;202004;1787;4026;1383;3472;61;188;1108;2746;1169;2934
431647;202004;242;605;79;235;9;25;23;64;32;89
431650;202004;112;304;74;240;5;19;44;130;49;149
431660;202004;854;2287;423;1381;71;269;115;334;186;603
431670;202004;1108;2644;692;1886;102;297;355;910;457;1207
431673;202004;227;576;77;260;13;44;14;43;27;87
431675;202004;505;1239;100;317;11;43;21;56;32;99
431680;202004;7253;18663;5174;14746;1217;3629;2210;6141;3427;9770
431690;202004;21956;53952;14055;39680;2954;8946;5361;15138;8315;24084
431695;202004;147;343;88;255;18;68;47;109;65;177
431697;202004;436;1033;332;872;46;113;196;527;242;640
431700;202004;1303;3388;1095;3012;159;407;662;1810;821;2217
431710;202004;12154;29568;8294;23946;1502;4638;3988;11779;5490;16417
431720;202004;5879;14743;3327;9689;841;2630;602;1526;1443;4156
431725;202004;25;72;20;63;4;11;9;29;13;40
431730;202004;3751;9036;2275;6677;538;1686;697;2184;1235;3870
431740;202004;4894;11662;3124;8632;852;2718;795;1850;1647;4568
431750;202004;7157;18409;5387;15541;1218;3783;2284;6469;3502;10252
431755;202004;310;859;66;233;8;26;11;38;19;64
431760;202004;5046;11383;3305;8603;353;1068;1984;4889;2337;5957
431770;202004;1798;4275;1390;3729;82;268;1068;2786;1150;3054
431775;202004;194;508;101;312;21;67;14;36;35;103
431780;202004;1953;4939;1219;3544;201;659;506;1417;707;2076
431790;202004;771;2103;552;1673;100;298;247;726;347;1024
431795;202004;225;572;105;320;23;63;28;80;51;143
431800;202004;7771;18778;4680;13792;1246;4264;530;1608;1776;5872
431805;202004;285;670;82;268;5;17;29;94;34;111
431810;202004;3150;7513;1954;5303;376;1076;826;2166;1202;3242
431820;202004;2089;5647;1631;4904;456;1440;558;1776;1014;3216
431830;202004;8581;18617;6226;15476;1601;4647;1998;4940;3599;9587
431840;202004;2479;6567;1961;5712;317;926;1204;3539;1521;4465
431842;202004;553;1384;186;580;20;70;61;168;81;238
431843;202004;317;847;235;674;28;94;119;316;147;410
431844;202004;188;493;52;177;10;37;17;64;27;101
431845;202004;502;1325;345;1009;30;87;202;590;232;677
431846;202004;280;727;235;660;9;29;211;592;220;621
431848;202004;98;253;61;183;9;29;9;20;18;49
431849;202004;406;989;61;188;1;1;7;18;8;19
431850;202004;3880;10586;2942;8685;701;2236;931;2742;1632;4978
431860;202004;619;1501;343;970;57;171;188;510;245;681
431861;202004;92;252;50;156;10;37;16;44;26;81
431862;202004;425;1353;347;1217;67;259;176;595;243;854
431870;202004;18199;46849;14497;40952;1794;5685;8773;23975;10567;29660
431880;202004;3887;9994;2709;7861;436;1446;1234;3397;1670;4843
431890;202004;4347;10960;2629;7649;755;2425;462;1486;1217;3911
431900;202004;924;2350;583;1720;88;298;306;850;394;1148
431910;202004;724;1746;248;708;43;121;75;174;118;295
431912;202004;445;1238;349;1067;68;221;203;610;271;831
431915;202004;1012;2537;790;2177;28;93;606;1633;634;1726
431920;202004;1167;2801;964;2530;28;70;830;2179;858;2249
431930;202004;635;1712;427;1328;125;352;194;638;319;990
431935;202004;82;229;56;175;14;49;13;38;27;87
431936;202004;298;866;160;515;33;113;62;182;95;295
431937;202004;159;395;101;271;17;51;45;95;62;146
431940;202004;2896;6925;1636;4599;187;576;803;2151;990;2727
431950;202004;1724;4566;1371;3990;441;1312;508;1457;949;2769
431960;202004;2794;6920;1995;5456;552;1579;520;1413;1072;2992
431970;202004;397;1019;150;446;38;110;40;102;78;212
431971;202004;82;207;33;103;3;12;5;9;8;21
431973;202004;466;1493;384;1337;37;137;283;982;320;1119
431975;202004;105;217;18;64;2;10;2;6;4;16
431980;202004;992;2598;760;2211;157;480;354;999;511;1479
431990;202004;5385;12936;3546;10256;487;1676;1688;4664;2175;6340
432000;202004;10389;24883;7430;20258;1776;4944;3261;9008;5037;13952
432010;202004;1987;5003;1434;4014;227;713;836;2214;1063;2927
432020;202004;1721;4426;1056;3049;219;662;447;1221;666;1883
432023;202004;497;1201;257;735;35;113;120;303;155;416
432026;202004;932;2624;680;2129;174;551;237;738;411;1289
432030;202004;335;836;186;534;22;62;104;296;126;358
432032;202004;324;852;219;645;26;94;122;335;148;429
432035;202004;643;1831;556;1681;172;527;231;724;403;1251
432040;202004;1001;2310;348;1077;56;189;115;326;171;515
432045;202004;161;447;97;317;23;74;34;117;57;191
432050;202004;446;1145;331;939;74;212;136;410;210;622
432055;202004;576;1559;371;1163;129;413;76;220;205;633
432057;202004;220;588;164;450;25;61;70;178;95;239
432060;202004;447;1083;134;422;31;108;43;117;74;225
432065;202004;197;556;136;421;25;78;58;177;83;255
432067;202004;697;2044;584;1797;50;176;437;1293;487;1469
432070;202004;1599;4251;1022;3095;237;789;317;880;554;1669
432080;202004;4204;10123;3177;8455;569;1755;1487;3747;2056;5502
432085;202004;340;876;229;704;63;197;90;287;153;484
432090;202004;1348;3449;872;2520;175;544;432;1183;607;1727
432100;202004;890;2286;414;1300;82;272;77;190;159;462
432110;202004;1977;5299;1320;4090;319;1127;127;360;446;1487
432120;202004;2655;7261;2021;6155;391;1311;776;2265;1167;3576
432130;202004;2429;6277;1992;5636;585;1694;888;2562;1473;4256
432132;202004;164;463;96;314;18;60;44;124;62;184
432135;202004;969;2300;627;1712;35;109;450;1216;485;1325
432140;202004;1420;4264;1078;3587;158;566;672;2233;830;2799
432143;202004;1377;3603;1053;3099;71;230;696;2032;767;2262
432145;202004;1288;3418;742;2251;99;333;236;600;335;933
432146;202004;94;261;61;204;22;77;17;55;39;132
432147;202004;460;1311;265;886;87;315;68;195;155;510
432149;202004;412;1026;205;597;14;46;98;261;112;307
432150;202004;2867;7359;2040;5877;444;1447;773;2175;1217;3622
432160;202004;4955;13120;3584;10888;907;3031;1263;3650;2170;6681
432162;202004;254;557;35;100;5;10;5;14;10;24
432163;202004;119;292;24;64;0;0;3;4;3;4
432166;202004;579;1648;430;1331;81;276;140;395;221;671
432170;202004;1239;3285;771;2395;151;516;287;839;438;1355
432180;202004;2570;6188;1356;3859;262;801;486;1229;748;2030
432183;202004;346;1015;228;733;56;207;62;182;118;389
432185;202004;782;2029;449;1370;35;123;246;705;281;828
432190;202004;1669;4101;1052;3104;196;641;517;1448;713;2089
432195;202004;883;2224;574;1666;160;433;202;617;362;1050
432200;202004;3014;7821;2145;6404;378;1136;1172;3553;1550;4689
432210;202004;362;960;220;678;42;164;102;263;144;427
432215;202004;602;1767;543;1676;50;137;402;1261;452;1398
432218;202004;244;611;106;303;17;59;48;124;65;183
432220;202004;3412;8094;2513;6668;443;1253;1382;3597;1825;4850
432225;202004;81;233;60;189;11;41;33;103;44;144
432230;202004;669;1564;351;964;42;114;153;386;195;500
432232;202004;469;1150;292;839;59;185;104;273;163;458
432234;202004;263;659;117;343;21;53;15;41;36;94
432235;202004;46;131;16;50;4;12;4;13;8;25
432237;202004;321;828;279;758;10;21;230;612;240;633
432240;202004;14828;37189;10574;31426;772;2564;6709;20874;7481;23438
432250;202004;4696;13707;3635;11668;973;3236;1484;4765;2457;8001
432252;202004;431;1033;266;740;34;101;136;362;170;463
432253;202004;871;2708;540;1847;129;479;45;141;174;620
432254;202004;630;1469;145;428;26;81;24;57;50;138
432255;202004;105;267;55;168;4;12;26;70;30;82
432260;202004;4462;11600;3241;9250;964;2854;985;2734;1949;5588
432270;202004;1678;4727;1327;4034;402;1328;265;751;667;2079
432280;202004;1194;2988;581;1757;94;311;210;526;304;837
432285;202004;138;411;19;55;1;3;3;5;4;8
432290;202004;320;901;167;530;56;180;33;76;89;256
432300;202004;24823;62984;18345;52408;2705;8718;10573;29175;13278;37893
432310;202004;775;2127;549;1700;50;155;379;1179;429;1334
432320;202004;204;481;70;217;7;23;26;75;33;98
432330;202004;207;472;58;189;8;21;11;35;19;56
432335;202004;178;494;60;214;6;26;13;40;19;66
432340;202004;291;689;124;386;10;31;44;128;54;159
432345;202004;647;1510;568;1414;19;49;462;1138;481;1187
432350;202004;337;891;180;579;26;90;69;219;95;309
432360;202004;233;682;47;150;3;6;18;58;21;64
432370;202004;294;729;193;556;12;41;132;374;144;415
432375;202004;462;1163;339;920;60;156;169;464;229;620
432377;202004;176;548;33;110;7;28;5;12;12;40
432380;202004;1563;4163;986;3093;172;612;495;1485;667;2097
500020;202004;2403;6262;1719;5091;160;555;1057;3045;1217;3600
500025;202004;1184;2908;736;2058;66;203;404;1068;470;1271
500060;202004;7523;21373;5087;16261;618;2060;2948;9694;3566;11754
500070;202004;4142;10764;2849;8541;531;1623;1219;3747;1750;5370
500080;202004;1501;3754;917;2664;174;562;354;913;528;1475
500085;202004;1953;4920;1321;3861;305;937;624;1749;929;2686
500090;202004;1985;5378;1320;4186;236;786;476;1574;712;2360
500100;202004;3475;8886;2621;7484;449;1441;1259;3410;1708;4851
500110;202004;7616;19633;4807;15102;1035;3565;1469;5417;2504;8982
500124;202004;1973;5847;1563;5146;255;793;830;2869;1085;3662
500150;202004;1254;2857;768;2147;142;403;301;842;443;1245
500190;202004;4643;12023;2926;8687;633;1914;752;2154;1385;4068
500200;202004;2162;5193;1579;4211;176;496;961;2443;1137;2939
500210;202004;4490;11022;3170;9275;844;2461;1386;4158;2230;6619
500215;202004;1315;3709;925;2978;90;318;502;1608;592;1926
500220;202004;2374;6700;1474;4961;245;891;349;1125;594;2016
500230;202004;2014;4742;1510;4034;178;446;1012;2685;1190;3131
500240;202004;3559;10691;2445;8333;385;1459;965;3395;1350;4854
500260;202004;3014;6458;1842;4844;257;670;947;2419;1204;3089
500270;202004;131162;309541;76586;215931;12980;40145;27527;73454;40507;113599
500280;202004;1225;3149;830;2526;113;373;465;1381;578;1754
500290;202004;3391;8085;1877;5544;317;1087;592;1571;909;2658
500295;202004;3226;7866;1957;5597;311;981;730;1796;1041;2777
500310;202004;927;1941;617;1545;101;216;305;802;406;1018
500315;202004;3536;9970;2755;8786;232;757;1929;6315;2161;7072
500320;202004;18285;49976;12569;40429;3228;10871;4333;14802;7561;25673
500325;202004;4146;9271;2827;7527;229;644;1912;5165;2141;5809
500330;202004;6500;14867;4229;11531;314;944;2355;6584;2669;7528
500345;202004;1931;4777;1265;3736;314;960;415;1202;729;2162
500348;202004;2275;5928;1749;5053;233;691;1004;2964;1237;3655
500350;202004;1245;3404;678;2167;80;249;278;857;358;1106
500370;202004;23957;62215;16431;49771;2234;7730;8469;25633;10703;33363
500375;202004;2399;6353;1578;4659;294;940;520;1440;814;2380
500380;202004;3344;8387;2261;6535;631;1971;540;1574;1171;3545
500390;202004;498;1076;315;850;52;165;189;498;241;663
500400;202004;1342;3448;868;2530;168;560;284;747;452;1307
500410;202004;2300;5731;1606;4675;172;490;941;2839;1113;3329
500430;202004;2493;6178;1671;4950;224;777;714;2214;938;2991
500440;202004;1048;2621;658;1995;99;330;258;836;357;1166
500450;202004;1393;3463;764;2298;133;423;186;528;319;951
500460;202004;3571;9654;2149;6808;359;1291;670;2089;1029;3380
500470;202004;2409;6513;1449;4513;411;1424;309;843;720;2267
500480;202004;2038;6264;1718;5750;153;563;1279;4336;1432;4899
500490;202004;927;2179;523;1578;119;437;147;436;266;873
500500;202004;4099;11014;2603;8551;923;3572;449;1517;1372;5089
500510;202004;672;1721;429;1257;25;90;263;751;288;841
500515;202004;1689;4325;1285;3681;135;426;813;2228;948;2654
500520;202004;2912;9328;2286;8130;614;2219;941;3538;1555;5757
500525;202004;830;2505;677;2268;59;203;420;1430;479;1633
500540;202004;4380;11428;2609;8262;685;2695;241;684;926;3379
500560;202004;5299;14547;4229;13189;257;849;3400;10766;3657;11615
500568;202004;4182;9156;2487;6627;576;1693;877;2339;1453;4032
500570;202004;7277;17026;4316;11947;794;2401;1533;3990;2327;6391
500580;202004;2971;7950;2147;6482;471;1486;998;3028;1469;4514
500600;202004;3052;7676;2132;6239;478;1417;877;2656;1355;4073
500620;202004;7188;19228;4785;14583;1037;3305;1675;5055;2712;8360
500625;202004;474;1294;278;872;52;170;89;247;141;417
500627;202004;703;1840;424;1337;69;230;140;440;209;670
500630;202004;6314;14670;3564;10054;743;2318;1040;2953;1783;5271
500635;202004;2766;8827;2138;8001;165;686;1507;6107;1672;6793
500640;202004;1655;3648;1080;2880;38;121;742;1952;780;2073
500660;202004;16748;43549;11336;35609;3582;12761;2792;9107;6374;21868
500690;202004;2214;6190;1441;4851;518;2016;81;194;599;2210
500710;202004;2745;7427;2107;6323;601;1905;654;1857;1255;3762
500720;202004;4645;11849;2979;9063;682;2214;883;2764;1565;4978
500730;202004;940;2380;544;1661;95;282;152;490;247;772
500740;202004;4421;10626;3006;8367;390;1131;1590;4441;1980;5572
500750;202004;932;2408;611;1807;82;239;240;648;322;887
500755;202004;836;2208;453;1468;82;290;89;261;171;551
500769;202004;4760;11756;2531;7536;478;1624;363;855;841;2479
500770;202004;1438;3902;916;2957;165;610;310;987;475;1597
500780;202004;1177;2867;758;2161;156;501;203;555;359;1056
500790;202004;7004;18643;5420;15998;1108;3507;2675;7945;3783;11452
500793;202004;1947;5055;1357;4012;350;1105;429;1182;779;2287
500795;202004;2470;6365;2032;5797;85;232;1728;5054;1813;5286
500797;202004;667;1710;439;1281;124;375;138;405;262;780
500800;202004;2923;6717;1813;5091;574;1907;204;631;778;2538
500830;202004;17253;43753;11592;33232;2421;7471;4193;11366;6614;18837
500840;202004;1320;3245;787;2238;91;262;316;854;407;1116
510010;202004;1763;3994;1162;3216;103;269;829;2332;932;2601
510020;202004;3309;8414;1744;5335;371;1217;388;1078;759;2295
510025;202004;6489;15894;3939;11714;584;1978;1624;4682;2208;6660
510030;202004;2371;5364;1539;4121;329;898;584;1535;913;2433
510035;202004;1188;3108;745;2396;87;301;440;1514;527;1815
510040;202004;2196;4923;1595;4145;151;386;1022;2764;1173;3150
510050;202004;1999;4245;1300;3326;142;417;909;2267;1051;2684
510060;202004;1298;3295;938;2713;200;639;266;717;466;1356
510080;202004;1203;3182;767;2443;260;868;212;577;472;1445
510100;202004;635;1489;436;1173;56;157;229;595;285;752
510120;202004;261;479;142;339;6;15;104;253;110;268
510125;202004;2005;4973;1566;4341;162;584;830;2155;992;2739
510130;202004;1406;3557;978;2870;202;655;304;916;506;1571
510140;202004;2945;7671;1984;6456;707;2701;684;2093;1391;4794
510160;202004;1663;4309;1210;3713;161;478;869;2732;1030;3210
510170;202004;4370;11556;3161;9601;766;2450;1234;3845;2000;6295
510180;202004;13545;30724;8281;22919;1824;5556;2409;7663;4233;13219
510185;202004;1655;4307;1088;3495;441;1435;278;1161;719;2596
510190;202004;1990;5703;1277;4482;355;1373;222;853;577;2226
510250;202004;15964;40749;11880;34659;2301;7029;6029;18315;8330;25344
510260;202004;1876;7911;1550;7318;262;1334;938;4826;1200;6160
510263;202004;2949;8200;1780;5820;293;1067;236;675;529;1742
510267;202004;4608;13211;2591;8672;480;1701;334;1032;814;2733
510268;202004;1222;3000;928;2554;111;295;611;1677;722;1972
510269;202004;983;2671;594;1932;144;513;183;549;327;1062
510270;202004;2814;8096;1923;6460;342;1274;783;2587;1125;3861
510279;202004;1726;4460;1066;3301;201;696;441;1321;642;2017
510285;202004;1074;2821;730;2229;229;787;151;418;380;1205
510300;202004;3586;9094;2612;7771;370;1152;1525;4733;1895;5885
510305;202004;1378;3821;826;2745;182;645;188;708;370;1353
510310;202004;882;2171;590;1683;163;488;162;485;325;973
510320;202004;3545;8872;2402;6890;549;1733;616;1751;1165;3484
510325;202004;4138;12278;3093;10363;890;3136;947;3295;1837;6431
510330;202004;2649;8013;1787;6482;349;1275;662;2767;1011;4042
510335;202004;4593;13292;3445;11452;522;1877;1964;6709;2486;8586
510336;202004;436;1237;311;1036;54;183;152;558;206;741
510337;202004;1459;4270;936;3310;361;1408;184;656;545;2064
510340;202004;86484;192825;53682;144921;13045;41960;15794;39859;28839;81819
510343;202004;979;2703;666;2117;120;430;280;845;400;1275
510345;202004;1204;3454;902;2860;151;471;413;1292;564;1763
510350;202004;2673;7020;1719;5388;376;1238;666;2070;1042;3308
510360;202004;1836;3840;1178;3064;69;136;809;2280;878;2416
510370;202004;1727;4910;1244;4075;170;619;734;2487;904;3106
510380;202004;531;1319;285;887;52;184;108;327;160;511
510385;202004;1193;4011;871;3398;94;426;543;2196;637;2622
510390;202004;1199;3231;800;2710;245;823;279;1088;524;1911
510395;202004;709;1606;472;1256;26;69;292;830;318;899
510410;202004;4609;12923;3334;10627;643;2141;1733;5714;2376;7855
510420;202004;2349;4983;1576;3950;124;332;1021;2559;1145;2891
510450;202004;421;1052;247;717;59;173;39;130;98;303
510452;202004;695;1944;477;1533;66;234;263;819;329;1053
510454;202004;880;2457;674;2107;74;221;410;1358;484;1579
510455;202004;867;2442;622;1948;100;352;244;704;344;1056
510460;202004;1737;4315;1227;3556;96;343;777;2155;873;2498
510480;202004;4350;10505;2825;7712;553;1674;1133;3010;1686;4684
510490;202004;1604;4195;1182;3662;161;516;771;2408;932;2924
510500;202004;1481;3748;907;2815;178;588;304;965;482;1553
510510;202004;3262;9604;2387;8013;596;2235;741;2640;1337;4875
510515;202004;5081;13102;3278;9846;795;2653;817;2194;1612;4847
510517;202004;1001;2950;758;2539;229;852;138;408;367;1260
510520;202004;2017;4111;1138;3013;83;220;593;1684;676;1904
510523;202004;1023;2591;746;2135;160;445;423;1248;583;1693
510525;202004;6566;18114;4847;14751;782;2656;2282;6586;3064;9242
510530;202004;543;1399;396;1183;29;93;247;726;276;819
510550;202004;2265;6736;1620;5599;385;1398;713;2496;1098;3894
510558;202004;2201;5943;1581;4963;212;639;729;2490;941;3129
510560;202004;1587;4546;936;3243;192;758;235;881;427;1639
510562;202004;5278;13829;3717;10995;885;2835;1266;3934;2151;6769
510590;202004;3060;7585;2173;6459;169;526;1556;4729;1725;5255
510600;202004;1383;3126;887;2406;161;439;398;1095;559;1534
510610;202004;2575;6236;1757;5160;170;565;1097;3238;1267;3803
510615;202004;2505;6339;1705;5045;301;909;875;2696;1176;3605
510617;202004;969;2931;739;2550;99;394;465;1668;564;2062
510618;202004;1195;3206;814;2540;183;635;371;1107;554;1742
510619;202004;714;1815;449;1363;67;221;118;336;185;557
510620;202004;1381;3109;651;1947;175;643;41;91;216;734
510621;202004;1474;3955;877;2807;186;656;266;806;452;1462
510622;202004;4446;12567;3011;9477;1012;3398;429;1219;1441;4617
510623;202004;2529;6292;1752;5066;410;1406;564;1582;974;2988
510624;202004;1591;4017;733;2446;87;314;163;500;250;814
510625;202004;2787;6838;1486;4491;250;898;334;1023;584;1921
510626;202004;1448;3509;902;2645;247;828;205;610;452;1438
510627;202004;591;1534;330;1024;82;281;84;277;166;558
510628;202004;1418;3292;930;2636;190;575;352;989;542;1564
510629;202004;1533;4367;1130;3645;220;760;419;1352;639;2112
510630;202004;3173;8895;1816;6278;424;1577;323;1194;747;2771
510631;202004;567;1367;410;1135;14;38;313;896;327;934
510637;202004;3244;7848;2303;6476;569;1797;668;1905;1237;3702
510642;202004;5257;15095;3971;13123;979;3517;1687;5732;2666;9249
510645;202004;868;1749;526;1302;151;361;216;534;367;895
510650;202004;6836;17587;5411;16020;616;1631;3741;12203;4357;13834
510665;202004;1743;3846;1059;2739;189;481;432;1187;621;1668
510670;202004;426;913;244;651;25;66;139;383;164;449
510675;202004;5734;15900;3821;12290;1077;3852;618;1934;1695;5786
510677;202004;2010;5202;1377;4246;202;721;721;2160;923;2881
510680;202004;679;1746;374;1173;75;260;71;208;146;468
510682;202004;1480;4400;1076;3728;373;1435;243;810;616;2245
510685;202004;525;1528;374;1216;59;208;187;604;246;812
510700;202004;3923;9509;2704;7769;269;837;1953;5614;2222;6451
510704;202004;10320;24332;6694;18066;1448;4223;1757;4599;3205;8822
510706;202004;1896;5761;1361;4876;260;948;728;2827;988;3775
510710;202004;2518;6348;1625;4668;349;1047;552;1517;901;2564
510715;202004;569;1274;411;1056;35;107;201;509;236;616
510718;202004;2288;5151;1320;3856;391;1152;443;1586;834;2738
510719;202004;421;884;240;647;23;64;136;348;159;412
510720;202004;874;2044;563;1573;93;297;265;699;358;996
510724;202004;765;2097;526;1662;78;266;280;858;358;1124
510726;202004;1037;1893;553;1308;62;169;270;642;332;811
510729;202004;591;1386;257;752;34;115;61;195;95;310
510730;202004;2803;6808;1868;5345;245;798;925;2587;1170;3385
510735;202004;991;2858;749;2514;76;315;546;1818;622;2133
510740;202004;880;2176;546;1547;90;256;245;687;335;943
510757;202004;496;1527;386;1355;122;480;141;470;263;950
510760;202004;41985;92537;24687;65897;5086;15618;7637;18812;12723;34430
510770;202004;4143;9358;2804;7684;229;592;1913;5516;2142;6108
510774;202004;339;868;228;682;33;98;119;365;152;463
510775;202004;595;1595;378;1238;80;286;82;250;162;536
510776;202004;417;1046;295;819;71;196;97;290;168;486
510777;202004;1482;3959;1056;3408;145;544;674;2151;819;2695
510779;202004;646;1754;496;1521;56;163;286;952;342;1115
510780;202004;3459;8931;2514;7609;585;1749;1133;3859;1718;5608
510785;202004;1968;5216;1134;3679;297;1038;185;686;482;1724
510787;202004;2524;7180;1647;5323;542;1851;198;644;740;2495
510788;202004;571;1375;399;1106;63;183;191;605;254;788
510790;202004;16534;42868;9812;30271;2083;7262;1504;4141;3587;11403
510792;202004;8454;23027;5165;16726;1093;4023;859;2463;1952;6486
510794;202004;1182;3152;794;2480;241;837;154;424;395;1261
510795;202004;7748;20413;4940;15297;1138;3919;1257;3821;2395;7740
510800;202004;1639;4264;1051;3254;353;1112;113;350;466;1462
510805;202004;1451;4046;989;3173;231;792;320;928;551;1720
510810;202004;608;1250;379;941;104;260;150;397;254;657
510820;202004;736;1407;399;977;31;92;210;526;241;618
510830;202004;821;1983;582;1677;50;141;404;1243;454;1384
510835;202004;533;1289;341;1009;39;129;200;576;239;705
510840;202004;50284;107713;34339;88325;6654;16128;17511;49776;24165;65904
510850;202004;1782;4286;1006;3055;332;1151;122;340;454;1491
510860;202004;2264;6051;1396;4558;439;1662;112;359;551;2021
510880;202004;682;1945;512;1626;127;419;184;599;311;1018
510885;202004;536;1313;364;1071;72;234;120;345;192;579
510890;202004;618;1822;471;1572;106;383;211;698;317;1081
510895;202004;1219;3149;802;2469;163;593;333;958;496;1551
520005;202004;2481;6400;1897;5677;567;1688;801;2719;1368;4407
520010;202004;2165;6206;1536;4993;388;1421;465;1322;853;2743
520013;202004;2745;7055;1795;5298;399;1212;511;1646;910;2858
520015;202004;493;1244;346;1024;77;235;138;431;215;666
520017;202004;1089;2808;810;2383;113;366;499;1442;612;1808
520020;202004;375;849;285;737;25;88;218;536;243;624
520025;202004;32624;91494;27924;84901;2759;9191;20109;60837;22868;70028
520030;202004;5436;13963;4316;12396;294;937;3081;8773;3375;9710
520050;202004;398;941;248;683;12;34;158;446;170;480
520055;202004;1687;4106;1104;2992;91;236;631;1676;722;1912
520060;202004;1364;3782;983;3075;257;887;243;761;500;1648
520080;202004;1759;4561;1307;3950;237;719;636;2101;873;2820
520082;202004;887;2251;694;1933;76;195;365;1072;441;1267
520085;202004;797;2147;617;1850;108;339;301;881;409;1220
520090;202004;828;1628;567;1342;55;88;436;1087;491;1175
520110;202004;37354;100509;25679;81047;7874;28327;2234;6415;10108;34742
520120;202004;195;466;109;324;15;53;43;124;58;177
520130;202004;3503;8627;2717;7416;511;1416;1179;3292;1690;4708
520140;202004;39462;105437;27203;84395;9727;32779;3549;11452;13276;44231
520145;202004;569;1325;379;1058;60;194;215;559;275;753
520150;202004;586;1317;422;1119;73;193;230;628;303;821
520160;202004;725;1688;525;1379;98;242;243;679;341;921
520170;202004;4889;9869;3232;7973;181;513;2480;6062;2661;6575
520180;202004;2128;5785;1725;5208;310;1049;969;2897;1279;3946
520215;202004;1676;4050;1188;3295;280;836;403;1059;683;1895
520235;202004;592;1357;335;955;36;127;131;357;167;484
520250;202004;1480;3811;1018;3033;322;1045;249;791;571;1836
520260;202004;773;1802;483;1335;87;249;207;585;294;834
520280;202004;676;1661;520;1421;109;302;245;714;354;1016
520310;202004;1008;2223;657;1698;153;453;252;683;405;1136
520320;202004;1600;4293;1204;3654;158;539;668;1991;826;2530
520330;202004;3794;10243;2721;8487;402;1498;1411;4300;1813;5798
520340;202004;2389;5283;1469;4008;170;432;864;2478;1034;2910
520350;202004;2790;6668;1967;5423;579;1678;750;2101;1329;3779
520355;202004;1771;4857;1246;3809;402;1338;300;798;702;2136
520357;202004;733;1763;522;1454;29;75;391;1119;420;1194
520360;202004;684;1806;513;1524;136;426;149;475;285;901
520380;202004;1397;3464;812;2378;88;270;410;1129;498;1399
520390;202004;992;2185;580;1676;161;503;199;622;360;1125
520393;202004;478;1149;317;897;36;120;150;394;186;514
520396;202004;807;2095;669;1874;37;125;498;1359;535;1484
520400;202004;1529;3795;1158;3286;146;451;782;2228;928;2679
520410;202004;1921;4338;1154;3161;190;560;445;1173;635;1733
520420;202004;357;828;275;699;21;59;214;524;235;583
520425;202004;1451;3528;814;2359;212;634;180;492;392;1126
520430;202004;2253;5157;1249;3593;238;807;49;130;287;937
520440;202004;2876;6988;1711;4922;417;1331;444;1214;861;2545
520450;202004;11524;27356;7485;21263;2354;7322;1396;4093;3750;11415
520455;202004;663;1810;483;1541;139;472;139;456;278;928
520460;202004;1006;2341;779;2053;74;169;624;1679;698;1848
520465;202004;753;1921;602;1716;79;265;419;1145;498;1410
520470;202004;2025;5250;1546;4615;471;1453;619;1976;1090;3429
520480;202004;881;2440;610;1986;196;652;137;474;333;1126
520485;202004;1521;4293;1271;3949;166;530;903;2801;1069;3331
520490;202004;3875;10694;2870;9092;982;3218;1042;3453;2024;6671
520495;202004;1548;3403;1161;2882;48;120;934;2331;982;2451
520500;202004;1195;3224;813;2475;189;617;330;1005;519;1622
520505;202004;730;1606;500;1311;62;166;314;817;376;983
520510;202004;7445;18491;4850;14461;1107;3708;1330;4286;2437;7994
520520;202004;1114;2819;817;2349;192;604;290;844;482;1448
520530;202004;1946;5668;1447;4835;422;1466;523;1870;945;3336
520540;202004;2782;7371;1692;5194;315;1054;397;1164;712;2218
520545;202004;932;2436;691;2040;143;416;280;841;423;1257
520547;202004;786;2146;625;1877;151;452;312;950;463;1402
520549;202004;12817;34519;10515;31144;1438;4514;7038;20793;8476;25307
520551;202004;4412;11959;3657;10850;388;1379;2602;7544;2990;8923
520552;202004;811;2095;668;1914;138;397;387;1168;525;1565
520570;202004;518;1153;342;907;81;193;137;409;218;602
520580;202004;2124;4884;1590;4258;110;355;1167;3088;1277;3443
520590;202004;1168;2975;806;2384;245;734;214;652;459;1386
520620;202004;7880;21351;6149;18823;1538;4849;2734;8654;4272;13503
520630;202004;689;1796;461;1398;81;259;116;335;197;594
520640;202004;2309;5752;1755;4781;409;1099;735;2069;1144;3168
520650;202004;805;1895;583;1585;94;253;321;922;415;1175
520660;202004;508;1214;261;784;52;186;68;195;120;381
520670;202004;898;2471;756;2267;71;221;480;1418;551;1639
520680;202004;661;1677;491;1410;78;218;255;740;333;958
520690;202004;322;749;220;602;65;163;70;218;135;381
520710;202004;400;968;278;758;12;26;199;537;211;563
520725;202004;1475;3469;1007;2714;116;365;633;1635;749;2000
520735;202004;745;1829;490;1403;106;287;182;565;288;852
520740;202004;2052;4637;1530;4022;267;644;865;2458;1132;3102
520750;202004;649;1572;447;1243;71;194;225;631;296;825
520753;202004;1237;3303;934;2737;183;573;377;1035;560;1608
520760;202004;1168;2624;1024;2451;32;61;936;2278;968;2339
520780;202004;1436;3372;1019;2797;113;326;508;1362;621;1688
520790;202004;3270;7781;2306;6217;314;845;1274;3631;1588;4476
520800;202004;15777;40969;12162;35688;1890;5778;7070;21381;8960;27159
520810;202004;1263;2655;919;2260;152;398;578;1502;730;1900
520815;202004;560;1710;416;1415;74;279;120;421;194;700
520830;202004;1768;3760;1252;3182;43;108;1031;2592;1074;2700
520840;202004;2493;6715;2010;6085;846;2777;535;1734;1381;4511
520850;202004;619;1602;456;1362;157;546;109;342;266;888
520860;202004;6283;16908;4537;14067;1203;4029;1651;5054;2854;9083
520870;202004;101008;234188;66732;183195;14875;44341;23305;62939;38180;107280
520880;202004;6549;18810;5014;16045;1161;3894;1841;5936;3002;9830
520890;202004;3812;9206;2573;7246;518;1592;1099;3113;1617;4705
520910;202004;4523;11438;2835;8483;690;2232;634;1869;1324;4101
520915;202004;703;1968;411;1304;71;245;139;426;210;671
520920;202004;4250;9580;2953;7943;352;978;1674;4700;2026;5678
520929;202004;648;1519;472;1261;65;150;247;710;312;860
520940;202004;948;2514;734;2215;42;133;538;1593;580;1726
520945;202004;468;1067;377;938;17;39;271;665;288;704
520960;202004;979;2397;763;2061;151;365;448;1235;599;1600
520970;202004;2439;6723;1894;5854;471;1641;496;1642;967;3283
520980;202004;753;1830;547;1550;97;286;222;619;319;905
520990;202004;2894;7808;2310;7036;335;989;1510;4692;1845;5681
520993;202004;1095;2598;742;2051;107;337;421;1104;528;1441
520995;202004;2239;5679;1669;4876;259;763;665;2009;924;2772
521000;202004;8442;22046;5522;16775;1119;3521;1660;5040;2779;8561
521010;202004;3574;9310;2661;7734;259;759;1548;4453;1807;5212
521015;202004;767;1892;522;1464;38;120;330;878;368;998
521020;202004;3084;7887;1764;5337;527;1768;129;410;656;2178
521030;202004;458;1004;297;755;61;137;125;350;186;487
521040;202004;7474;18326;5463;15144;1173;3397;2309;6561;3482;9958
521056;202004;892;2352;693;2056;222;656;189;627;411;1283
521060;202004;929;2470;678;2010;67;209;331;978;398;1187
521080;202004;1098;2376;550;1514;72;217;227;542;299;759
521090;202004;3141;8394;2104;6358;580;1877;282;889;862;2766
521100;202004;1716;4000;1206;3273;191;517;713;1958;904;2475
521120;202004;4603;10765;3298;9155;201;511;1630;5272;1831;5783
521130;202004;991;2236;551;1472;20;61;295;837;315;898
521140;202004;1203;3098;862;2501;110;326;420;1238;530;1564
521150;202004;12206;26690;7493;19989;1260;3903;3551;9641;4811;13544
521160;202004;629;1308;438;1028;48;110;292;667;340;777
521170;202004;1001;2341;720;1925;54;150;492;1291;546;1441
521180;202004;6997;19442;5703;17178;911;2990;2960;8642;3871;11632
521190;202004;10236;25472;5784;17930;1455;4823;1124;3758;2579;8581
521200;202004;685;1676;470;1328;46;133;266;753;312;886
521205;202004;622;1537;466;1287;18;54;350;925;368;979
521210;202004;680;1742;387;1151;85;271;71;163;156;434
521220;202004;3577;8728;2289;6706;391;1292;865;2508;1256;3800
521225;202004;341;742;242;636;39;107;137;355;176;462
521230;202004;1287;3298;1130;3104;363;1013;574;1674;937;2687
521250;202004;29738;79861;22884;69761;8474;27195;6676;21689;15150;48884
521260;202004;551;1277;395;1029;54;143;223;571;277;714
521270;202004;1742;4430;1509;4155;86;206;1144;3196;1230;3402
521280;202004;1758;4710;1298;3938;306;1032;545;1669;851;2701
521290;202004;461;1088;322;908;42;139;202;551;244;690
521295;202004;1080;2336;815;2048;63;116;668;1740;731;1856
521300;202004;1817;4498;1422;3942;261;677;908;2594;1169;3271
521305;202004;692;1670;483;1354;68;177;278;783;346;960
521308;202004;4600;12308;3167;9572;284;870;1852;5510;2136;6380
521310;202004;8110;20678;5554;16382;1212;3900;2277;6445;3489;10345
521340;202004;405;947;293;783;21;55;207;540;228;595
521350;202004;2000;5096;1501;4339;127;452;1065;2936;1192;3388
521370;202004;1215;3078;713;2207;206;737;87;295;293;1032
521375;202004;1293;3146;868;2536;200;582;266;867;466;1449
521377;202004;1445;3078;1039;2580;77;139;848;2205;925;2344
521380;202004;6029;15975;3875;11993;394;1327;1049;3474;1443;4801
521385;202004;636;1548;486;1356;58;150;279;845;337;995
521390;202004;701;1715;485;1391;144;458;179;536;323;994
521400;202004;2560;5936;1961;5204;223;589;1353;3676;1576;4265
521405;202004;1273;3236;917;2628;178;520;446;1271;624;1791
521410;202004;783;2098;582;1747;103;287;295;946;398;1233
521440;202004;1148;2887;812;2376;272;874;229;677;501;1551
521450;202004;3818;11332;2780;9297;731;2468;716;2545;1447;5013
521460;202004;5569;14663;3875;11639;1329;4176;873;2702;2202;6878
521470;202004;606;1634;361;1120;49;146;119;363;168;509
521480;202004;357;900;208;612;42;125;67;192;109;317
521483;202004;2362;5652;1638;4541;358;1059;625;1724;983;2783
521486;202004;1715;4033;1264;3399;76;206;922;2460;998;2666
521487;202004;403;981;283;814;44;130;142;417;186;547
521490;202004;888;2376;657;1998;37;147;467;1382;504;1529
521500;202004;2193;5371;1597;4436;95;326;1144;3090;1239;3416
521520;202004;718;1663;505;1347;76;214;212;575;288;789
521523;202004;11194;34451;9143;31115;2485;9327;2482;8729;4967;18056
521525;202004;1005;2324;734;1943;72;195;523;1376;595;1571
521530;202004;2188;5663;1247;3742;272;851;299;926;571;1777
521540;202004;808;2041;537;1595;71;245;251;776;322;1021
521550;202004;1429;3655;794;2346;142;485;217;656;359;1141
521560;202004;4427;11642;3023;9743;446;1707;1548;5257;1994;6964
521565;202004;631;1516;483;1311;74;189;295;791;369;980
521570;202004;3381;9214;2221;6961;437;1606;204;677;641;2283
521580;202004;471;1147;267;801;40;131;79;211;119;342
521590;202004;624;1469;455;1228;83;245;258;685;341;930
521600;202004;368;993;236;737;34;86;98;310;132;396
521630;202004;1646;3604;998;2654;203;582;347;894;550;1476
521640;202004;1746;4062;1166;3230;254;735;400;1091;654;1826
521645;202004;545;1418;344;1056;84;232;113;357;197;589
521680;202004;1074;3249;818;2751;239;878;117;430;356;1308
521690;202004;514;1250;425;1131;59;165;269;710;328;875
521710;202004;3129;7792;1963;5877;355;1211;479;1343;834;2554
521720;202004;2161;4986;1382;3800;147;457;783;2155;930;2612
521730;202004;3456;9696;2611;8217;742;2722;695;1854;1437;4576
521740;202004;3800;9974;2832;8551;695;2266;1078;3391;1773;5657
521760;202004;14542;39870;11188;34682;2873;9890;4119;13309;6992;23199
521770;202004;2892;6953;1884;5317;572;1743;473;1347;1045;3090
521800;202004;6095;16430;4345;13480;987;3135;1683;5688;2670;8823
521805;202004;473;1157;350;979;106;273;145;415;251;688
521810;202004;601;1415;419;1169;62;176;242;687;304;863
521830;202004;5462;15104;4299;13298;290;1084;3092;9384;3382;10468
521839;202004;701;1664;484;1315;78;246;264;646;342;892
521850;202004;5335;12462;3305;9437;579;1854;509;1387;1088;3241
521860;202004;1498;3956;1023;3130;183;617;320;967;503;1584
521870;202004;677;1887;478;1489;101;356;121;329;222;685
521878;202004;653;1690;437;1266;55;185;231;609;286;794
521880;202004;17792;43229;11772;33958;2987;9157;4053;11931;7040;21088
521890;202004;2965;7665;1933;5855;552;1811;350;977;902;2788
521900;202004;1449;3402;833;2461;280;806;108;329;388;1135
521910;202004;1211;2572;789;2077;74;193;433;1248;507;1441
521920;202004;461;1271;336;1050;61;220;141;424;202;644
521925;202004;739;1919;531;1615;82;260;290;876;372;1136
521930;202004;5315;12728;3457;9883;879;2370;1314;4162;2193;6532
521935;202004;971;2343;659;1783;63;178;395;1019;458;1197
521940;202004;1301;2879;830;2232;193;572;331;872;524;1444
521945;202004;535;1469;432;1292;101;304;227;699;328;1003
521950;202004;730;1775;508;1428;121;354;219;581;340;935
521960;202004;709;1825;456;1353;56;178;240;663;296;841
521970;202004;2506;6125;1986;5505;158;429;1530;4297;1688;4726
521971;202004;723;1712;505;1399;145;395;143;411;288;806
521973;202004;1305;3401;1014;2951;40;133;760;2182;800;2315
521975;202004;11573;30521;9445;27569;1492;4589;5966;17453;7458;22042
521980;202004;2517;5876;1922;5085;146;369;1446;3928;1592;4297
521990;202004;1053;2972;830;2572;178;578;301;926;479;1504
522000;202004;2408;6453;1946;5875;250;730;1307;4103;1557;4833
522005;202004;329;788;246;665;50;133;125;347;175;480
522010;202004;3879;9440;2703;7546;618;1900;961;2612;1579;4512
522015;202004;961;2520;693;2109;208;623;252;803;460;1426
522020;202004;5425;12898;3524;9879;726;2142;1391;4020;2117;6162
522026;202004;744;1978;494;1525;91;308;170;488;261;796
522028;202004;415;1032;306;854;63;186;131;357;194;543
522040;202004;3043;6902;2148;5698;263;739;1443;3791;1706;4530
522045;202004;17045;47393;12473;39216;2956;10045;3395;10385;6351;20430
522050;202004;1006;2669;670;2087;175;616;226;621;401;1237
522060;202004;2838;7468;1948;5976;162;500;1124;3566;1286;4066
522068;202004;1781;4581;1387;4109;115;312;1081;3243;1196;3555
522070;202004;606;1481;487;1299;20;64;407;1069;427;1133
522100;202004;714;1831;478;1456;58;200;252;741;310;941
522108;202004;969;2498;747;2179;58;224;589;1653;647;1877
522119;202004;1468;3675;1121;3214;182;528;606;1815;788;2343
522130;202004;386;978;273;819;29;85;178;561;207;646
522140;202004;16987;45162;11697;35617;3060;10008;3094;9049;6154;19057
522145;202004;774;1918;516;1524;142;412;186;561;328;973
522150;202004;1044;2565;733;2044;200;552;216;638;416;1190
522155;202004;1049;2640;792;2231;145;379;439;1270;584;1649
522157;202004;548;1321;448;1192;25;83;351;938;376;1021
522160;202004;5942;15339;3803;11402;1027;3316;302;991;1329;4307
522170;202004;2599;6640;1936;5645;303;909;1084;3211;1387;4120
522180;202004;472;1085;309;809;58;160;65;186;123;346
522185;202004;18263;45134;12892;37733;5054;16104;2790;8860;7844;24964
522190;202004;756;1818;508;1385;95;270;191;508;286;778
522200;202004;1622;4581;1065;3510;220;793;186;552;406;1345
522205;202004;1643;3826;1243;3287;129;361;855;2266;984;2627
522220;202004;1241;3071;916;2581;116;345;526;1523;642;1868
522230;202004;1101;2806;879;2483;185;648;449;1198;634;1846
530010;202004;167759;450014;134330;400592;20904;68245;77987;229475;98891;297720
110001;202003;3921;11015;2609;8529;600;2107;1005;3344;1605;5451
110002;202003;11879;31193;8255;24878;2323;7434;2213;6758;4536;14192
110003;202003;617;1810;433;1424;102;361;105;328;207;689
110004;202003;10845;28505;7136;21818;1522;5075;2054;6456;3576;11531
110005;202003;2450;6394;1645;5041;356;1180;450;1497;806;2677
110006;202003;1754;4890;1086;3475;201;753;206;614;407;1367
110007;202003;1179;3026;730;2271;233;782;179;684;412;1466
110008;202003;3273;9113;2388;7748;262;838;1578;5451;1840;6289
110009;202003;4261;12005;2718;9157;605;2134;1081;3700;1686;5834
110010;202003;7376;24013;5370;20000;1098;4153;2608;10560;3706;14713
110011;202003;6685;17915;4498;13942;1613;5227;632;2060;2245;7287
110012;202003;14560;36481;8427;25578;2058;6726;779;2594;2837;9320
110013;202003;5147;15064;3720;12101;1512;5173;464;1674;1976;6847
110014;202003;3694;9926;2483;7620;586;1913;968;2918;1554;4831
110015;202003;5320;13876;3030;9317;704;2374;593;1694;1297;4068
110018;202003;3653;9223;2075;6429;403;1455;593;1801;996;3256
110020;202003;73201;176700;51814;147106;11385;33339;21394;66800;32779;100139
110025;202003;4908;11970;3176;8942;663;1996;1357;3880;2020;5876
110026;202003;490;1258;342;1043;84;276;147;479;231;755
110028;202003;6694;17128;3971;12141;1011;3363;591;1835;1602;5198
110029;202003;1460;3593;827;2476;191;589;302;947;493;1536
110030;202003;12595;29117;7751;21864;1681;5569;1537;4697;3218;10266
110032;202003;2943;8435;1853;6091;578;1902;388;1364;966;3266
110033;202003;3566;11249;2742;9722;975;3513;689;2716;1664;6229
110034;202003;3396;7983;2231;6364;671;2156;755;2328;1426;4484
110037;202003;1600;4739;1188;4016;253;856;579;2003;832;2859
110040;202003;2882;8085;2044;6510;583;1999;614;1910;1197;3909
110045;202003;4917;14313;3676;12035;977;3436;1296;4318;2273;7754
110050;202003;1754;4773;1222;3845;482;1652;222;724;704;2376
110060;202003;814;2483;546;1838;200;717;79;265;279;982
110070;202003;1563;4965;1167;4086;368;1373;238;754;606;2127
110080;202003;6172;14497;4531;12544;571;1498;3019;8901;3590;10399
110090;202003;547;1471;390;1195;88;295;173;518;261;813
110092;202003;1107;3247;805;2682;140;477;409;1469;549;1946
110094;202003;2718;8214;2033;6884;868;3135;288;976;1156;4111
110100;202003;1666;4953;1331;4295;371;1261;562;1831;933;3092
110110;202003;1683;4678;1160;3770;379;1267;268;949;647;2216
110120;202003;1243;3663;928;3043;231;816;302;963;533;1779
110130;202003;2572;6544;1641;4868;332;1126;616;1824;948;2950
110140;202003;2012;5965;1348;4591;335;1203;345;1211;680;2414
110143;202003;1293;3544;871;2698;282;873;143;451;425;1324
110145;202003;853;2261;523;1654;121;401;186;606;307;1007
110146;202003;443;1165;310;962;60;185;150;498;210;683
110147;202003;767;2009;476;1433;68;226;182;485;250;711
110148;202003;732;2014;404;1364;108;411;42;144;150;555
110149;202003;2955;8157;2036;6669;705;2444;447;1560;1152;4004
110150;202003;2670;6529;1776;5277;530;1732;450;1610;980;3342
110155;202003;717;2123;497;1583;109;370;165;504;274;874
110160;202003;1436;4514;1057;3656;310;1091;251;898;561;1989
110170;202003;2143;5505;1297;3886;240;764;667;1919;907;2683
110175;202003;1652;4685;1159;3820;180;654;517;1783;697;2437
110180;202003;1360;3774;921;2881;145;475;463;1445;608;1920
120001;202003;3174;9397;2601;8541;405;1381;1666;5643;2071;7024
120005;202003;1944;7454;1758;7188;151;681;1404;5830;1555;6511
120010;202003;5245;15891;4421;14650;415;1366;3205;10959;3620;12325
120013;202003;2160;7644;1907;7336;415;1533;1192;4901;1607;6434
120017;202003;2462;8370;2167;7917;345;1284;1400;5386;1745;6670
120020;202003;14890;58547;13661;56144;1078;5065;10770;44568;11848;49633
120025;202003;3119;8901;2492;8141;375;1210;1717;5806;2092;7016
120030;202003;6480;25594;6008;24702;426;2298;4670;19307;5096;21605
120032;202003;1684;7583;1593;7416;106;680;1318;6028;1424;6708
120033;202003;4070;15134;3823;14698;125;722;3340;12721;3465;13443
120034;202003;2629;9631;2237;8931;114;701;1845;7224;1959;7925
120035;202003;3714;14693;3522;14355;288;1409;2890;11767;3178;13176
120038;202003;2675;8631;2277;7977;529;1901;1220;4378;1749;6279
120039;202003;2033;8794;1898;8514;126;779;1527;6807;1653;7586
120040;202003;44410;139892;37645;128759;5341;19322;23426;81334;28767;100656
120042;202003;3299;12447;3031;11948;146;795;2530;9892;2676;10687
120043;202003;1382;5629;1258;5428;37;227;1153;4976;1190;5203
120045;202003;6211;15999;5388;15079;124;511;4912;13611;5036;14122
120050;202003;9312;33678;8506;32434;397;2100;7112;27159;7509;29259
120060;202003;9535;37009;8729;35803;384;2315;7611;31005;7995;33320
120070;202003;3133;10124;2708;9543;250;909;1949;7123;2199;8032
120080;202003;4170;13611;3703;12910;457;1718;2720;9651;3177;11369
130002;202003;3047;12098;2725;11620;190;833;2308;10017;2498;10850
130006;202003;2411;8995;1992;8235;182;797;1487;6201;1669;6998
130008;202003;2671;9347;2361;8892;69;376;2046;7697;2115;8073
130010;202003;3970;11585;3329;10852;78;234;3054;10100;3132;10334
130014;202003;3056;9144;2343;7952;411;1407;1431;5010;1842;6417
130020;202003;2797;10961;2507;10524;139;810;2016;8421;2155;9231
130030;202003;10071;32869;9145;31778;328;1127;8083;28576;8411;29703
130040;202003;3792;11414;3153;10557;182;618;2615;8865;2797;9483
130050;202003;7573;27807;6354;26225;162;846;5792;24118;5954;24964
130060;202003;7507;29917;6436;28510;436;2443;5339;23592;5775;26035
130063;202003;6361;20823;5658;20037;208;915;5125;18252;5333;19167
130068;202003;3750;13330;3171;12476;216;1230;2394;9313;2610;10543
130070;202003;7595;21411;6204;19879;288;890;5125;16944;5413;17834
130080;202003;7005;25570;6117;24532;254;1413;5210;21221;5464;22634
130083;202003;2746;9035;2431;8636;160;678;2082;7392;2242;8070
130090;202003;3492;10891;3095;10387;53;235;2736;9364;2789;9599
130100;202003;8017;24231;6819;22978;58;130;6426;22211;6484;22341
130110;202003;8592;24590;7060;22688;1011;2575;5144;17867;6155;20442
130115;202003;5287;16498;4560;15694;104;344;4059;14213;4163;14557
130120;202003;14215;50297;12521;48029;1081;4583;10166;39382;11247;43965
130130;202003;5287;16970;4077;15365;386;1587;3020;11432;3406;13019
130140;202003;7361;25604;6480;24592;191;1085;5704;21740;5895;22825
130150;202003;3628;13646;3407;13400;79;508;3126;12319;3205;12827
130160;202003;5072;18122;4330;17168;268;1160;3690;14880;3958;16040
130165;202003;3218;12263;3030;12023;119;542;2741;10946;2860;11488
130170;202003;11610;34332;9268;31587;695;2718;7458;25764;8153;28482
130180;202003;4474;14485;4238;14220;41;221;4089;13690;4130;13911
130185;202003;18447;45752;15059;42149;995;1812;12689;37616;13684;39428
130190;202003;18802;62363;15110;56843;1722;6745;10704;41537;12426;48282
130195;202003;2488;9058;2038;8491;67;373;1799;7527;1866;7900
130200;202003;2573;7279;2140;6713;98;395;1788;5590;1886;5985
130210;202003;1292;4894;1158;4737;101;591;926;3691;1027;4282
130220;202003;2305;8009;1966;7564;55;303;1727;6669;1782;6972
130230;202003;4599;19038;3998;18175;233;1462;3423;15550;3656;17012
130240;202003;12198;36683;9876;33596;189;1121;8865;30136;9054;31257
130250;202003;26286;79022;22519;74784;1628;5068;18138;62585;19766;67653
130255;202003;4373;14678;3808;13692;161;747;3095;11130;3256;11877
130260;202003;263980;736364;214429;664341;57973;190606;98738;316029;156711;506635
130270;202003;9385;33458;7729;30883;1162;4648;5151;21506;6313;26154
130280;202003;3534;14382;3247;14060;93;466;3018;13237;3111;13703
130290;202003;13172;44486;11374;42164;675;2671;9563;36252;10238;38923
130300;202003;4688;16488;4262;15901;146;817;3723;13850;3869;14667
130310;202003;6206;20978;5392;19919;297;1341;4565;16880;4862;18221
130320;202003;3459;11277;2884;10529;362;1288;2130;8032;2492;9320
130330;202003;4619;14832;3728;13734;206;915;3184;11731;3390;12646
130340;202003;23572;74154;20239;70353;1454;4416;16979;61081;18433;65497
130350;202003;3974;14436;3579;13937;147;779;3164;12266;3311;13045
130353;202003;7437;20202;5962;18339;754;2221;4289;13693;5043;15914
130356;202003;5211;16684;4310;15282;745;2588;2647;9954;3392;12542
130360;202003;2976;9827;2576;9280;93;413;2296;8208;2389;8621
130370;202003;5728;22579;4978;21507;297;1651;4050;17405;4347;19056
130380;202003;7320;30460;6776;29694;392;2235;5754;25024;6146;27259
130390;202003;5786;24507;5120;23394;537;2810;3853;17683;4390;20493
130395;202003;2328;7442;1992;6887;194;709;1522;5253;1716;5962
130400;202003;2724;8613;2329;8087;84;269;2094;7398;2178;7667
130406;202003;11081;38741;9322;36576;1748;6875;6260;25517;8008;32392
130410;202003;4121;14796;3510;13757;1051;4339;1600;6455;2651;10794
130420;202003;13638;48150;11400;45346;907;4644;8933;35773;9840;40417
130423;202003;4342;13701;3795;13080;188;843;3330;11375;3518;12218
130426;202003;2788;11113;2596;10880;70;398;2393;10081;2463;10479
130430;202003;4244;12060;3683;11316;239;900;3100;9379;3339;10279
130440;202003;4781;15178;4086;14344;92;414;3774;13339;3866;13753
140002;202003;2163;6429;1880;6079;89;343;1587;5182;1676;5525
140005;202003;3317;9190;2894;8705;132;350;2480;7667;2612;8017
140010;202003;55926;148372;44603;131506;11030;34216;19435;58520;30465;92736
140015;202003;3795;11373;3213;10659;217;697;2802;9457;3019;10154
140017;202003;4408;12322;3832;11595;262;753;3141;9781;3403;10534
140020;202003;5296;15486;4553;14504;234;990;3753;11852;3987;12842
140023;202003;2489;7400;2032;6738;196;663;1546;5245;1742;5908
140028;202003;2057;5302;1742;4898;89;280;1406;3951;1495;4231
140030;202003;5246;13463;4637;12761;332;661;4039;11502;4371;12163
140040;202003;2576;10185;2362;9901;95;580;2128;8805;2223;9385
140045;202003;2600;9461;2184;8890;351;1240;1483;6511;1834;7751
140047;202003;6257;17901;5262;16450;601;1917;3770;11984;4371;13901
140050;202003;1440;4218;1207;3884;116;373;923;3034;1039;3407
140060;202003;1667;4451;1427;4093;113;291;1147;3376;1260;3667
140070;202003;1887;9864;1831;9747;123;855;1520;8017;1643;8872
150010;202003;45466;113595;41077;107964;950;2251;36861;96826;37811;99077
150013;202003;1945;5000;1620;4652;149;302;1266;3879;1415;4181
150020;202003;14476;43606;13385;42179;1430;3777;10962;35636;12392;39413
150030;202003;8891;33353;8081;32350;467;2027;7011;28311;7478;30338
150034;202003;4150;10266;3415;9359;229;571;2841;7967;3070;8538
150040;202003;16383;42541;14397;40341;1242;1939;12062;36709;13304;38648
150050;202003;6954;24505;6333;23677;131;593;5819;21988;5950;22581
150060;202003;21974;59775;17587;53141;2788;8602;11152;34535;13940;43137
150070;202003;6739;25226;5906;24224;225;1119;5281;21861;5506;22980
150080;202003;94180;210474;78355;188855;18974;50008;22710;67051;41684;117059
150085;202003;7641;22249;6903;21368;119;390;6475;20192;6594;20582
150090;202003;9798;36601;9213;35449;677;2676;7418;28749;8095;31425
150095;202003;5636;16588;4900;15666;261;605;4164;13876;4425;14481
150100;202003;2841;10048;2521;9507;200;667;1973;7610;2173;8277
150110;202003;4418;18190;4097;17819;192;893;3763;16485;3955;17378
150120;202003;8082;25337;7661;24830;255;671;6826;22782;7081;23453
150125;202003;735;1985;548;1728;101;379;321;994;422;1373
150130;202003;22329;64816;19333;60288;3320;9259;12666;41872;15986;51131
150140;202003;248736;578368;209288;523647;31116;75538;122015;318160;153131;393698
150145;202003;4256;13168;3610;12163;915;2819;1976;7366;2891;10185
150150;202003;16168;41719;14105;39074;544;1665;11782;32635;12326;34300
150157;202003;3494;9596;2813;8706;289;911;1987;6426;2276;7337
150160;202003;3019;8958;2812;8653;541;1565;1754;5645;2295;7210
150170;202003;24539;80467;21438;75181;3903;12870;13176;49226;17079;62096
150172;202003;4813;13281;3862;11945;262;743;2934;9361;3196;10104
150175;202003;1614;5121;1346;4592;242;868;770;2655;1012;3523
150178;202003;10333;28098;8565;26029;212;551;7654;23610;7866;24161
150180;202003;22467;79547;20262;76995;1084;3615;17788;69232;18872;72847
150190;202003;6729;22734;6253;22132;257;1179;5536;19487;5793;20666
150195;202003;5126;16597;4870;16197;70;385;4521;14888;4591;15273
150200;202003;5863;17125;5361;16570;64;172;5070;15789;5134;15961
150210;202003;26242;90986;24456;88594;1699;6156;20222;75425;21921;81581
150215;202003;7622;21643;6557;20087;1178;3518;3905;12518;5083;16036
150220;202003;12274;34772;10704;32538;1060;3115;7428;23103;8488;26218
150230;202003;12189;34887;10732;32939;1130;3100;7453;23918;8583;27018
150240;202003;31775;88525;26316;79194;7226;22192;9094;27857;16320;50049
150250;202003;4215;16157;3922;15819;603;2349;3006;12483;3609;14832
150260;202003;2735;8970;2484;8585;155;518;1984;6954;2139;7472
150270;202003;8667;25012;6103;20471;1984;6946;1657;5936;3641;12882
150275;202003;6849;21898;6253;21069;235;902;5436;18257;5671;19159
150276;202003;2295;6115;1956;5712;247;637;1357;4370;1604;5007
150277;202003;5184;13596;4175;12424;311;816;3221;10245;3532;11061
150280;202003;6815;27614;6571;27217;471;1945;5578;23372;6049;25317
150285;202003;3287;11518;2882;10877;238;921;2120;8147;2358;9068
150290;202003;10478;28722;9458;27630;289;630;8558;25616;8847;26246
150293;202003;9261;22964;7046;20040;920;2648;4350;13017;5270;15665
150295;202003;7626;20641;5605;17913;1844;6290;1956;7146;3800;13436
150300;202003;2379;7142;2129;6825;36;129;1944;6262;1980;6391
150304;202003;4042;12094;3326;10985;600;1885;2012;6970;2612;8855
150307;202003;6160;19806;5675;18995;345;1153;4627;15660;4972;16813
150309;202003;6230;18844;5022;16748;869;2850;2822;9843;3691;12693
150310;202003;7295;29038;6948;28625;206;1175;6212;25804;6418;26979
150320;202003;9390;25700;8567;24498;404;1244;6661;19002;7065;20246
150330;202003;14031;45083;12931;43332;1233;3858;9755;33733;10988;37591
150340;202003;2523;7390;2233;6954;328;957;1530;4922;1858;5879
150345;202003;8137;23882;7298;22753;435;1426;6207;19432;6642;20858
150350;202003;8957;22502;8258;21598;695;1295;6829;18437;7524;19732
150360;202003;24043;66407;19201;60269;1961;5024;13641;45694;15602;50718
150370;202003;10700;32607;8789;30046;999;2908;6398;23529;7397;26437
150375;202003;3526;14293;3168;13769;228;1109;2685;11773;2913;12882
150380;202003;11080;28375;9085;25759;121;454;8028;22786;8149;23240
150390;202003;7927;31693;7117;30419;1072;4000;5074;22972;6146;26972
150400;202003;6438;23345;6175;22850;275;1059;5384;20014;5659;21073
150405;202003;9273;24409;8098;23000;482;1134;6554;19220;7036;20354
150410;202003;1924;6137;1631;5634;216;667;1042;3716;1258;4383
150420;202003;40577;112123;31182;98192;8676;28624;10687;39275;19363;67899
150430;202003;8458;24747;7703;23769;870;2000;6003;19426;6873;21426
150440;202003;5638;18155;5130;17426;759;2279;3605;12836;4364;15115
150442;202003;26104;62333;21448;56503;2262;5848;14849;39971;17111;45819
150445;202003;6302;19547;5531;18375;205;734;4737;15771;4942;16505
150450;202003;5092;21850;4711;21332;362;1792;4053;18354;4415;20146
150460;202003;8381;27641;7666;26732;251;1014;6557;23690;6808;24704
150470;202003;21870;56544;19485;53829;359;1011;18327;50665;18686;51676
150475;202003;4891;15427;4222;14411;157;606;3530;12189;3687;12795
150480;202003;13670;44401;12226;42235;2195;6876;8112;29923;10307;36799
150490;202003;8353;28963;7662;28108;270;1154;6811;25128;7081;26282
150495;202003;5270;18165;5034;17835;106;545;4577;16119;4683;16664
150497;202003;2874;9096;2310;8116;513;1831;1206;4561;1719;6392
150500;202003;3271;8421;2911;7918;237;563;2271;6193;2508;6756
150503;202003;4808;12353;3316;10404;991;3361;1060;3808;2051;7169
150506;202003;10307;30585;8633;28309;1841;5303;5360;19535;7201;24838
150510;202003;9848;35804;8514;33304;1236;4555;5624;23137;6860;27692
150520;202003;6986;27348;6680;26964;233;1406;5980;24051;6213;25457
150530;202003;12432;42395;10763;39990;1529;4598;7718;30639;9247;35237
150540;202003;4956;13554;4212;12444;235;631;3513;10451;3748;11082
150543;202003;7409;19823;6104;18183;496;1490;4677;14568;5173;16058
150548;202003;10102;31723;9097;30348;250;1028;8065;26957;8315;27985
150549;202003;1995;5971;1714;5586;44;188;1467;4795;1511;4983
150550;202003;19812;58415;16490;52952;3943;12876;7275;25005;11218;37881
150553;202003;27239;79267;21693;69455;6451;21054;7796;26852;14247;47906
150555;202003;1891;5061;1478;4423;131;307;1021;3212;1152;3519
150560;202003;1842;5619;1634;5206;263;811;977;3232;1240;4043
150563;202003;2424;7430;2034;6756;429;1513;1123;3758;1552;5271
150565;202003;4336;13925;3862;13181;104;456;3216;11078;3320;11534
150570;202003;6312;20118;5874;19506;272;1032;5079;16847;5351;17879
150580;202003;10547;41348;9081;39708;618;3186;7364;33330;7982;36516
150590;202003;8102;27918;6936;26531;179;1053;6288;23972;6467;25025
150600;202003;9632;32014;8927;31157;217;845;8259;29020;8476;29865
150610;202003;2839;8429;2536;7936;94;382;2132;6605;2226;6987
150611;202003;3214;9030;2844;8516;92;350;2513;7478;2605;7828
150613;202003;13376;36872;10083;31181;1866;6147;4982;15395;6848;21542
150616;202003;3364;9251;2443;7733;580;1911;1059;3332;1639;5243
150618;202003;6787;19668;5474;17640;481;1507;3532;12049;4013;13556
150619;202003;6356;17850;5256;16308;176;620;4454;13928;4630;14548
150620;202003;6775;22442;5829;20851;665;2265;3998;14736;4663;17001
150630;202003;6263;16929;5719;16254;424;1117;4756;13679;5180;14796
150635;202003;4657;12885;3910;11695;543;1526;2516;7806;3059;9332
150640;202003;2256;6648;2050;6393;35;104;1905;6023;1940;6127
150650;202003;11602;32282;10108;29868;2974;8290;4454;14403;7428;22693
150655;202003;5820;16622;5263;15811;201;621;4547;13657;4748;14278
150658;202003;4334;12354;3418;10965;525;1783;2066;6996;2591;8779
150660;202003;5740;16419;5105;15513;463;1336;3594;11208;4057;12544
150670;202003;8414;19473;6557;17373;641;1398;5149;14390;5790;15788
150680;202003;68075;199595;52243;174400;12482;40799;23510;88729;35992;129528
150690;202003;2885;7510;2492;7048;92;213;2222;6431;2314;6644
150700;202003;6167;18230;5496;17358;355;931;4370;14199;4725;15130
150710;202003;3789;12647;3439;12079;273;948;2617;9392;2890;10340
150715;202003;4981;14342;4076;12967;296;915;3203;10353;3499;11268
150720;202003;6844;24414;6342;23625;424;1731;5290;19879;5714;21610
150730;202003;12017;36533;10418;34266;1198;4078;7695;26025;8893;30103
150740;202003;3965;11122;3505;10406;309;766;2653;8061;2962;8827
150745;202003;5073;14442;4088;12983;818;2760;2589;8306;3407;11066
150746;202003;1624;4989;1482;4787;79;257;1213;3933;1292;4190
150747;202003;4858;15510;4274;14540;685;2081;2897;10322;3582;12403
150750;202003;3664;11486;3075;10584;213;801;2339;8291;2552;9092
150760;202003;11944;35117;10833;33578;1488;4226;7680;24572;9168;28798
150770;202003;6329;22782;5955;22353;187;577;5420;20995;5607;21572
150775;202003;926;2596;716;2309;135;483;388;1251;523;1734
150780;202003;4514;13620;3999;13020;150;435;3591;11990;3741;12425
150790;202003;5628;16031;4829;15174;219;515;3903;13542;4122;14057
150795;202003;13889;43025;12124;40266;2993;9374;6911;24490;9904;33864
150796;202003;3831;9415;3331;8838;179;430;2834;7634;3013;8064
150797;202003;3934;12229;3392;11453;134;352;2909;9985;3043;10337
150800;202003;13450;42095;12100;40306;1440;4510;9188;31598;10628;36108
150803;202003;7021;22675;6575;21980;357;1149;5598;18866;5955;20015
150805;202003;3461;10658;2926;9873;209;708;2291;7866;2500;8574
150808;202003;5971;16913;4363;14268;1688;6121;615;2272;2303;8393
150810;202003;20721;54364;15660;48271;3267;10324;7976;27109;11243;37433
150812;202003;5314;14985;4666;13924;411;1289;3457;10147;3868;11436
150815;202003;9445;27876;7876;26015;616;2044;6505;21821;7121;23865
150820;202003;11913;32790;10052;30452;1085;2805;7656;24290;8741;27095
150830;202003;11846;43439;10975;42372;415;1814;9556;37813;9971;39627
150835;202003;2363;7820;2010;7192;347;1220;1150;4169;1497;5389
150840;202003;7448;21100;5906;18592;983;3316;3255;10199;4238;13515
160005;202003;1192;3306;1055;3131;61;215;886;2639;947;2854
160010;202003;2449;6471;2284;6290;20;106;2217;6033;2237;6139
160015;202003;2790;8176;2474;7783;70;234;2276;7191;2346;7425
160020;202003;2088;6717;1825;6389;157;524;1435;5195;1592;5719
160021;202003;1068;4210;980;4102;65;376;802;3330;867;3706
160023;202003;1246;4414;1098;4167;113;393;771;3109;884;3502
160025;202003;1858;5637;1763;5528;12;38;1716;5402;1728;5440
160027;202003;9040;25080;8074;23845;624;1743;6511;19652;7135;21395
160030;202003;70464;200677;56793;182313;12011;36183;30973;109625;42984;145808
160040;202003;5704;19544;5182;18883;71;339;4848;17796;4919;18135
160050;202003;4742;14477;3702;13062;1391;4696;1305;5714;2696;10410
160053;202003;3710;11615;3367;11195;233;683;2795;9598;3028;10281
160055;202003;908;2646;873;2606;32;101;806;2408;838;2509
160060;202003;24670;65821;19925;60428;904;2940;15811;50299;16715;53239
160070;202003;2738;10383;2451;9939;199;799;1922;8056;2121;8855
160080;202003;3326;10628;2973;10231;32;170;2773;9615;2805;9785
170025;202003;600;1576;427;1320;68;221;221;701;289;922
170030;202003;1213;3697;929;3182;139;476;457;1608;596;2084
170035;202003;1443;3778;1058;3159;92;298;640;1933;732;2231
170040;202003;1875;5325;1474;4760;95;359;908;3050;1003;3409
170070;202003;1790;4236;1253;3549;72;238;757;2221;829;2459
170100;202003;2399;6925;1991;6246;190;558;1263;4086;1453;4644
170105;202003;715;2089;487;1600;126;371;162;550;288;921
170110;202003;910;2808;690;2385;121;434;305;1038;426;1472
170130;202003;1296;3898;923;3182;173;644;444;1571;617;2215
170190;202003;1320;3786;936;3163;327;1155;177;771;504;1926
170200;202003;1915;4674;1191;3462;203;625;442;1296;645;1921
170210;202003;24749;67282;18660;57091;6413;21387;2316;8174;8729;29561
170215;202003;1296;3471;1040;3127;40;171;831;2486;871;2657
170220;202003;5737;17907;4801;16210;1306;4233;1973;7291;3279;11524
170230;202003;1209;3634;902;3030;262;898;161;603;423;1501
170240;202003;2581;7282;1988;6315;143;544;1391;4313;1534;4857
170255;202003;3910;11377;2764;9264;485;1674;1261;4342;1746;6016
170270;202003;950;2296;626;1836;37;107;373;1093;410;1200
170290;202003;2821;8478;2410;7946;106;371;1902;6447;2008;6818
170300;202003;1957;5323;1576;4759;178;540;1058;3249;1236;3789
170305;202003;599;1647;494;1467;60;211;263;771;323;982
170307;202003;908;3135;726;2776;98;407;405;1570;503;1977
170310;202003;1555;3899;1062;3102;161;526;506;1486;667;2012
170320;202003;997;2605;749;2200;64;204;484;1453;548;1657
170330;202003;902;2789;816;2659;39;183;678;2149;717;2332
170360;202003;489;1317;334;1055;24;85;218;651;242;736
170370;202003;1252;3387;894;2775;280;826;222;821;502;1647
170380;202003;1730;5026;1278;4320;99;396;735;2558;834;2954
170382;202003;523;1579;427;1410;30;126;310;993;340;1119
170384;202003;1541;5512;1255;4951;250;1028;642;2575;892;3603
170386;202003;908;2482;555;1776;76;277;194;597;270;874
170388;202003;606;1737;422;1396;61;225;190;642;251;867
170389;202003;1021;3188;841;2890;45;171;618;2179;663;2350
170390;202003;1690;3927;1257;3390;46;114;1033;2878;1079;2992
170410;202003;553;1639;393;1337;32;143;237;782;269;925
170460;202003;351;927;280;811;34;91;181;546;215;637
170510;202003;880;2592;638;2146;46;195;401;1296;447;1491
170550;202003;6488;17347;4712;14450;1185;3901;1123;3738;2308;7639
170555;202003;1364;3727;1061;3252;71;230;515;1652;586;1882
170560;202003;1008;2864;750;2501;59;225;480;1693;539;1918
170600;202003;1288;3485;1042;3138;224;530;585;1923;809;2453
170610;202003;1636;4371;1176;3681;86;297;727;2251;813;2548
170625;202003;423;1175;260;829;42;136;82;249;124;385
170650;202003;1215;3631;943;3179;145;510;528;1853;673;2363
170700;202003;3310;9788;2463;8152;496;1661;1098;3744;1594;5405
170710;202003;1491;3953;1129;3372;155;497;702;2104;857;2601
170720;202003;1716;4358;1323;3744;158;433;787;2330;945;2763
170730;202003;1015;2783;744;2341;135;382;371;1246;506;1628
170740;202003;2032;6821;1739;6270;165;674;1259;4507;1424;5181
170755;202003;875;2435;598;1952;54;199;294;934;348;1133
170765;202003;1123;2929;781;2380;162;496;338;1077;500;1573
170770;202003;1802;5281;1464;4754;163;502;970;3253;1133;3755
170820;202003;3305;9974;2604;8674;515;1781;1209;4168;1724;5949
170825;202003;934;2230;745;1973;76;201;541;1439;617;1640
170830;202003;1389;3723;1138;3329;134;383;775;2306;909;2689
170900;202003;2619;8391;2187;7765;177;648;1731;6220;1908;6868
170930;202003;3646;10193;2774;8546;638;2075;916;2831;1554;4906
170950;202003;10993;30493;7506;24132;2130;7803;889;3094;3019;10897
170980;202003;437;1183;351;1051;14;63;261;744;275;807
171050;202003;1581;5026;1363;4651;44;225;1139;3859;1183;4084
171070;202003;1316;3803;1119;3511;299;953;481;1756;780;2709
171090;202003;1020;2543;812;2244;75;208;544;1494;619;1702
171110;202003;559;1510;390;1192;57;173;188;529;245;702
171150;202003;1093;2706;652;1949;65;222;386;1139;451;1361
171180;202003;781;2151;517;1640;90;262;216;689;306;951
171190;202003;1731;5851;1488;5424;236;933;887;3350;1123;4283
171195;202003;800;2570;637;2261;87;371;386;1348;473;1719
171200;202003;523;1485;391;1251;69;238;180;574;249;812
171215;202003;334;960;277;861;34;116;191;577;225;693
171240;202003;742;2486;603;2211;36;183;405;1455;441;1638
171245;202003;639;1935;491;1620;47;179;296;934;343;1113
171250;202003;1000;2647;722;2235;132;434;335;1056;467;1490
171270;202003;440;1596;336;1368;68;282;145;643;213;925
171280;202003;857;2604;665;2252;65;223;377;1340;442;1563
171320;202003;3920;11057;3001;9428;618;1931;1132;3755;1750;5686
171330;202003;2685;7421;2055;6325;393;1191;980;3141;1373;4332
171360;202003;1387;4044;1093;3610;83;306;786;2654;869;2960
171370;202003;675;1717;512;1485;52;144;343;1005;395;1149
171380;202003;1418;4103;1175;3755;98;301;850;2811;948;3112
171395;202003;945;2636;653;2080;58;229;395;1212;453;1441
171420;202003;1910;5682;1370;4579;223;820;616;2079;839;2899
171430;202003;1011;3012;834;2677;57;205;570;1761;627;1966
171488;202003;2270;6825;1778;5980;264;885;917;3203;1181;4088
171500;202003;981;2448;739;2079;38;110;572;1620;610;1730
171510;202003;777;2580;669;2375;46;207;466;1639;512;1846
171515;202003;444;1151;312;939;26;89;194;555;220;644
171525;202003;680;1976;521;1713;28;110;308;973;336;1083
171550;202003;335;972;247;827;31;122;139;449;170;571
171570;202003;1096;3383;911;3043;119;396;548;1879;667;2275
171575;202003;1810;4840;1151;3639;112;380;518;1641;630;2021
171610;202003;5701;15926;4248;13418;884;3145;1192;4031;2076;7176
171620;202003;2586;7332;2171;6729;101;388;1768;5498;1869;5886
171630;202003;940;2495;739;2218;109;320;496;1537;605;1857
171650;202003;2033;5815;1557;5001;388;1360;462;1627;850;2987
171660;202003;2307;5891;1558;4622;229;630;809;2460;1038;3090
171665;202003;1249;3506;963;3038;163;584;453;1454;616;2038
171670;202003;1862;4975;1417;4241;195;649;778;2333;973;2982
171700;202003;1197;3447;866;2842;109;352;465;1561;574;1913
171720;202003;784;2021;609;1748;52;178;438;1226;490;1404
171750;202003;1271;3580;862;2805;228;764;102;435;330;1199
171780;202003;1225;3126;872;2606;92;300;575;1684;667;1984
171790;202003;1373;4557;1123;4040;212;802;525;1928;737;2730
171800;202003;712;1977;529;1696;61;252;301;949;362;1201
171820;202003;10913;30809;7982;25701;2005;6681;2441;8470;4446;15151
171830;202003;1493;4862;1249;4419;108;482;803;2831;911;3313
171840;202003;754;2024;583;1744;24;73;387;1155;411;1228
171845;202003;573;1468;417;1238;50;176;256;752;306;928
171850;202003;842;2879;721;2594;68;330;514;1782;582;2112
171855;202003;1024;3149;865;2854;71;239;536;1737;607;1976
171865;202003;371;1166;300;1042;51;202;148;486;199;688
171870;202003;792;2245;555;1803;64;227;290;947;354;1174
171875;202003;1264;3730;993;3285;44;183;748;2476;792;2659
171880;202003;1144;3533;1000;3341;40;139;799;2727;839;2866
171884;202003;820;2340;600;1966;108;409;224;762;332;1171
171886;202003;1360;3770;963;3109;283;1036;192;628;475;1664
171888;202003;719;2015;488;1585;30;118;307;973;337;1091
171889;202003;374;1163;299;1015;66;245;121;408;187;653
171890;202003;1157;3239;845;2736;178;545;467;1561;645;2106
171900;202003;544;1883;390;1494;78;293;159;631;237;924
172000;202003;553;1665;462;1490;47;160;262;822;309;982
172010;202003;992;3436;841;3124;72;307;518;1893;590;2200
172015;202003;366;1289;270;1093;66;270;108;453;174;723
172020;202003;2614;7522;2290;7094;159;538;1708;5485;1867;6023
172025;202003;700;1948;514;1640;35;133;368;1172;403;1305
172030;202003;1216;3609;1033;3315;52;205;800;2559;852;2764
172049;202003;1276;3094;856;2513;171;481;442;1410;613;1891
172065;202003;1435;3576;1104;3163;102;219;870;2682;972;2901
172080;202003;2286;6782;1836;6000;104;383;1216;3958;1320;4341
172085;202003;465;1275;294;896;44;131;110;319;154;450
172090;202003;3908;9961;3005;8764;119;391;2289;6735;2408;7126
172093;202003;459;1375;327;1145;22;110;186;625;208;735
172097;202003;629;1682;446;1365;61;188;198;623;259;811
172100;202003;47919;119163;33180;95495;5929;18924;11706;34741;17635;53665
172110;202003;1569;5769;1347;5408;125;518;989;4178;1114;4696
172120;202003;4866;14437;3792;12692;498;1762;2159;7437;2657;9199
172125;202003;326;884;239;740;21;58;133;406;154;464
172130;202003;628;1537;485;1311;25;89;338;840;363;929
172208;202003;2492;6175;1993;5529;177;420;1437;4091;1614;4511
172210;202003;2638;6731;2013;5924;324;1038;1148;3516;1472;4554
210005;202003;18562;53502;14130;46086;4119;13965;5401;18494;9520;32459
210010;202003;1922;5939;1733;5710;72;314;1506;4975;1578;5289
210015;202003;3284;9860;2929;9398;107;305;2579;8365;2686;8670
210020;202003;7302;17307;6246;16088;72;215;5796;14996;5868;15211
210030;202003;4691;15520;4323;14967;194;873;3742;12933;3936;13806
210040;202003;1761;4251;1592;4044;25;44;1504;3861;1529;3905
210043;202003;6083;17544;5131;16234;438;1313;3923;12717;4361;14030
210047;202003;6545;20465;5315;18814;130;670;4622;16360;4752;17030
210050;202003;2187;7473;1711;6589;153;698;1199;4602;1352;5300
210055;202003;1844;5979;1665;5706;64;261;1412;4836;1476;5097
210060;202003;7209;26621;6387;25142;694;2870;4568;18460;5262;21330
210070;202003;7104;20307;6647;19716;39;179;6295;18628;6334;18807
210080;202003;4242;14557;4024;14318;42;261;3679;13180;3721;13441
210083;202003;5495;16111;4534;15096;41;206;4304;14385;4345;14591
210087;202003;3016;8231;2610;7706;99;233;2267;6865;2366;7098
210090;202003;9161;28859;8519;27722;501;1355;7238;23815;7739;25170
210095;202003;6291;20352;5742;19653;217;895;4939;17326;5156;18221
210100;202003;6770;20716;6060;19607;308;1085;4940;16064;5248;17149
210110;202003;2956;9865;2731;9598;50;308;2503;8759;2553;9067
210120;202003;22614;62575;18664;57356;1835;4657;12758;41637;14593;46294
210125;202003;4381;11746;3834;11105;741;1678;2750;8568;3491;10246
210130;202003;4355;11503;3608;10572;156;348;3074;9133;3230;9481
210135;202003;1445;4351;1240;4023;63;185;1006;3334;1069;3519
210140;202003;18397;48661;14023;43025;2675;7899;7868;25632;10543;33531
210150;202003;4311;10460;3831;9800;132;367;3348;8477;3480;8844
210160;202003;16425;48172;14170;45330;1256;4263;10075;33376;11331;37639
210170;202003;14944;46618;13894;45272;749;2171;12231;40249;12980;42420
210173;202003;2247;8641;2095;8365;66;419;1850;7381;1916;7800
210177;202003;3426;9408;2991;8884;114;219;2665;8203;2779;8422
210180;202003;1430;3873;1261;3671;24;64;1149;3359;1173;3423
210190;202003;5248;14353;4450;13273;75;363;3855;11349;3930;11712
210193;202003;1278;3751;1132;3526;31;141;888;2810;919;2951
210197;202003;2064;6497;1898;6267;137;464;1558;5219;1695;5683
210200;202003;7610;24560;6743;23112;405;1557;5412;18536;5817;20093
210203;202003;6930;20558;5937;19225;387;1309;4883;16110;5270;17419
210207;202003;3849;9557;2957;8607;131;301;2476;7400;2607;7701
210210;202003;8034;26218;7350;25287;133;813;6617;22621;6750;23434
210215;202003;2430;7740;2068;7195;51;273;1839;6413;1890;6686
210220;202003;6079;21110;5758;20623;177;1161;5096;17861;5273;19022
210230;202003;5057;15455;4572;14730;384;1003;3829;12650;4213;13653
210232;202003;11079;35044;9085;32012;1539;5421;5689;21373;7228;26794
210235;202003;3312;10004;2912;9454;65;282;2596;8456;2661;8738
210237;202003;2737;9104;2345;8644;31;192;2169;8001;2200;8193
210240;202003;2559;8160;2359;7804;79;309;2032;6660;2111;6969
210250;202003;5557;17072;5059;16459;74;436;4567;14817;4641;15253
210255;202003;2490;7653;2102;6958;280;951;1347;4463;1627;5414
210260;202003;5450;16343;4823;15429;211;781;4186;13384;4397;14165
210270;202003;4751;13296;4240;12656;107;478;3769;11183;3876;11661
210275;202003;3493;8904;3086;8416;57;124;2807;7760;2864;7884
210280;202003;5506;15797;4407;14088;259;1051;3200;10091;3459;11142
210290;202003;7205;19460;6436;18493;111;366;5975;17166;6086;17532
210300;202003;33265;89958;26981;80987;1857;5882;19362;60166;21219;66048
210310;202003;3041;7845;2684;7324;122;278;2339;6422;2461;6700
210312;202003;2612;6762;2308;6432;31;138;2163;5969;2194;6107
210315;202003;2895;8223;2469;7742;55;160;2260;7222;2315;7382
210317;202003;4014;12889;3637;12447;105;568;3271;11122;3376;11690
210320;202003;18633;57106;17037;54977;392;1940;15120;48500;15512;50440
210325;202003;3561;10200;3054;9532;91;282;2715;8640;2806;8922
210330;202003;24396;68999;19633;62850;5950;17161;9327;34639;15277;51800
210340;202003;9931;29341;8798;27804;694;2189;6759;21966;7453;24155
210350;202003;9157;26629;8007;25217;152;536;7155;22662;7307;23198
210355;202003;4247;14347;3730;13534;100;493;3181;11625;3281;12118
210360;202003;13375;42265;11935;40129;604;2748;9138;30268;9742;33016
210370;202003;10668;24213;8284;21689;227;401;7609;20386;7836;20787
210375;202003;3204;8545;2444;7519;649;2021;1107;3795;1756;5816
210380;202003;5397;13909;4659;13049;202;484;3995;11295;4197;11779
210390;202003;2529;9030;2335;8683;107;538;1985;7326;2092;7864
210400;202003;4379;13582;3893;12980;120;389;3494;11819;3614;12208
210405;202003;6814;18496;5483;16581;1043;2935;3088;9953;4131;12888
210407;202003;1944;6496;1622;5905;75;344;1308;4703;1383;5047
210408;202003;2490;9333;2334;9105;141;681;1914;7492;2055;8173
210409;202003;3757;13060;3432;12609;104;593;2851;10534;2955;11127
210410;202003;3388;10449;2876;9605;148;602;2197;7261;2345;7863
210420;202003;3813;12235;3453;11612;207;632;2897;9860;3104;10492
210430;202003;2233;6573;1993;6270;70;190;1764;5628;1834;5818
210440;202003;4351;11720;3782;11004;62;226;3491;10107;3553;10333
210450;202003;2407;7135;2065;6633;82;294;1708;5460;1790;5754
210455;202003;4192;11114;3173;9816;919;2868;1480;4845;2399;7713
210460;202003;3646;10433;3086;9724;63;272;2754;8624;2817;8896
210462;202003;1623;4956;1381;4560;35;142;1122;3738;1157;3880
210465;202003;2634;7749;2301;7301;50;206;2004;6343;2054;6549
210467;202003;5850;18815;5080;17794;296;1194;4211;14922;4507;16116
210470;202003;1998;5300;1409;4458;81;192;1083;3570;1164;3762
210480;202003;16285;47797;13449;44285;1137;3426;9893;35098;11030;38524
210490;202003;3654;9317;2956;8336;60;179;2572;7285;2632;7464
210500;202003;6203;24099;5699;23232;337;1725;4736;19174;5073;20899
210510;202003;5912;19661;5171;18857;127;560;4622;17150;4749;17710
210515;202003;3653;10851;3197;10333;102;387;2776;9107;2878;9494
210520;202003;2506;7198;2248;6873;68;243;1992;6052;2060;6295
210530;202003;51472;125562;39813;108346;6573;22199;10799;37370;17372;59569
210535;202003;3018;10399;2818;10083;116;463;2385;8603;2501;9066
210540;202003;14400;41808;11990;38434;1383;4133;8453;28353;9836;32486
210542;202003;6432;14996;5176;13625;316;513;4292;12084;4608;12597
210545;202003;2175;6824;2051;6619;40;178;1816;5789;1856;5967
210547;202003;3484;12642;3071;11821;294;1136;2274;8965;2568;10101
210550;202003;6108;18453;4827;16446;331;1293;3576;12494;3907;13787
210560;202003;3498;10739;3119;10128;115;378;2626;8468;2741;8846
210565;202003;1458;4821;1214;4458;56;302;966;3569;1022;3871
210570;202003;10303;28205;9160;26809;276;763;8167;24346;8443;25109
210580;202003;2941;7912;2434;7293;132;268;1959;6162;2091;6430
210590;202003;4245;12785;3665;12041;68;378;3267;10669;3335;11047
210592;202003;2629;7824;2423;7490;26;127;2146;6578;2172;6705
210594;202003;2480;6694;1897;5795;80;234;1402;4433;1482;4667
210596;202003;2475;8863;2219;8344;100;451;1813;6844;1913;7295
210598;202003;1792;5281;1652;5070;29;126;1495;4548;1524;4674
210600;202003;2999;8056;2428;7258;91;208;1977;6026;2068;6234
210610;202003;2652;7531;2277;7066;56;273;1930;5977;1986;6250
210620;202003;2715;7452;2266;6910;55;165;2088;6464;2143;6629
210630;202003;2974;10083;2718;9661;109;572;2266;7937;2375;8509
210632;202003;4381;14207;3877;13481;206;949;3097;10661;3303;11610
210635;202003;1725;6184;1624;6005;101;369;1351;5087;1452;5456
210637;202003;2391;7974;2088;7539;144;621;1579;5771;1723;6392
210640;202003;4538;16393;4256;16044;68;349;3858;14579;3926;14928
210650;202003;7331;21048;6677;20230;65;289;6207;18848;6272;19137
210660;202003;8021;23972;7112;22515;245;995;6198;19376;6443;20371
210663;202003;2538;7482;2331;7238;121;305;2006;6393;2127;6698
210667;202003;1925;6296;1736;6019;36;148;1576;5524;1612;5672
210670;202003;4387;15024;4006;14429;108;557;3504;12546;3612;13103
210675;202003;4980;13544;4247;12592;186;453;3581;10891;3767;11344
210680;202003;4408;10985;3707;10135;110;187;3339;9330;3449;9517
210690;202003;7617;23398;6402;22053;241;1068;5679;19684;5920;20752
210700;202003;2703;7619;2141;6814;143;452;1592;5281;1735;5733
210710;202003;4851;15308;4262;14474;107;594;3765;12632;3872;13226
210720;202003;2911;9637;2616;9271;53;316;2360;8312;2413;8628
210725;202003;1274;4360;1113;4118;41;176;816;3133;857;3309
210730;202003;1165;3105;977;2840;47;126;820;2391;867;2517
210735;202003;4594;13660;3914;12752;186;590;3372;11229;3558;11819
210740;202003;5195;14097;4524;13344;99;339;3830;11308;3929;11647
210745;202003;4343;11980;4032;11582;109;337;3700;10600;3809;10937
210750;202003;22852;58389;19786;54551;1601;4162;13935;40548;15536;44710
210760;202003;5872;15611;4967;14656;29;65;4720;14062;4749;14127
210770;202003;6051;15707;5213;14744;55;245;4917;13837;4972;14082
210780;202003;7226;22996;6333;21502;528;1602;5016;17371;5544;18973
210790;202003;4179;13307;3753;12750;179;451;3111;11080;3290;11531
210800;202003;4859;12944;4163;12023;53;223;3778;10798;3831;11021
210805;202003;3886;14273;3708;14014;104;574;3333;12514;3437;13088
210810;202003;4816;14094;4395;13550;283;615;3687;11747;3970;12362
210820;202003;6848;19495;5699;17658;667;2138;3412;10923;4079;13061
210825;202003;6666;20761;6018;19904;245;833;5219;17490;5464;18323
210830;202003;7596;21501;6917;20671;342;784;6011;18432;6353;19216
210840;202003;3165;8443;2832;7999;63;221;2522;7022;2585;7243
210845;202003;6393;17506;5757;16812;19;81;5555;16287;5574;16368
210850;202003;5887;20095;4908;18636;237;1200;3870;14746;4107;15946
210860;202003;20768;53899;17288;49514;731;1834;14006;42218;14737;44052
210870;202003;7264;19064;5744;17326;217;605;5019;15263;5236;15868
210880;202003;4217;13067;3817;12596;174;677;3196;10543;3370;11220
210890;202003;3823;11345;3434;10892;209;554;2818;9237;3027;9791
210900;202003;4429;13041;3358;10993;1311;4605;558;2065;1869;6670
210905;202003;1974;5493;1640;5064;44;79;1495;4731;1539;4810
210910;202003;7133;21619;5920;19646;800;2706;3872;13011;4672;15717
210920;202003;3196;10562;2769;9997;69;403;2499;8944;2568;9347
210923;202003;1475;4483;1272;4153;69;235;948;3134;1017;3369
210927;202003;5189;16513;4571;15785;206;746;3819;13454;4025;14200
210930;202003;2453;8532;2153;7943;170;688;1602;5916;1772;6604
210940;202003;4035;11476;3747;11138;108;446;3444;10122;3552;10568
210945;202003;6343;18450;5690;17673;222;654;4791;15261;5013;15915
210950;202003;5094;14288;3936;12686;598;1533;2603;9155;3201;10688
210955;202003;1539;4900;1323;4519;128;457;938;3274;1066;3731
210960;202003;8926;26665;7656;24761;1256;3794;4943;16753;6199;20547
210970;202003;1318;4063;1049;3608;64;237;805;2713;869;2950
210975;202003;1670;5306;1492;5022;64;237;1198;4052;1262;4289
210980;202003;9972;23154;8710;21850;75;180;8264;20808;8339;20988
210990;202003;15729;44745;12399;40355;682;2476;9361;31201;10043;33677
211000;202003;14329;42171;12078;39428;659;2307;9726;32981;10385;35288
211003;202003;5566;16742;4683;15689;128;516;4050;13873;4178;14389
211010;202003;6370;23129;5723;22343;87;444;5215;20700;5302;21144
211020;202003;8089;23566;7005;22327;197;843;5993;19534;6190;20377
211023;202003;1916;6316;1791;6153;80;305;1531;5248;1611;5553
211027;202003;3058;9799;2896;9542;195;537;2501;8323;2696;8860
211030;202003;3847;10641;3436;10140;229;511;2828;8608;3057;9119
211040;202003;4544;16491;4204;15884;112;688;3762;14075;3874;14763
211050;202003;9036;23615;8208;22546;86;298;7556;20760;7642;21058
211060;202003;6862;20923;6272;20126;119;502;5764;18499;5883;19001
211065;202003;2177;6074;1813;5617;82;215;1498;4814;1580;5029
211070;202003;7635;24328;6468;22560;490;1737;5033;17748;5523;19485
211080;202003;1271;3544;1020;3145;35;191;791;2304;826;2495
211085;202003;2002;5721;1697;5309;83;199;1475;4765;1558;4964
211090;202003;3104;8654;2805;8308;37;167;2594;7646;2631;7813
211100;202003;6657;17001;6149;16394;51;167;5677;15222;5728;15389
211102;202003;2993;10352;2741;9989;120;576;2410;8694;2530;9270
211105;202003;2334;7416;1931;6681;166;586;1401;4824;1567;5410
211107;202003;4598;14657;3927;13674;127;581;3209;11518;3336;12099
211110;202003;5791;15961;4479;13950;354;1035;3303;10503;3657;11538
211120;202003;43504;107097;35835;98158;4829;12158;23243;68023;28072;80181
211125;202003;2046;6103;1728;5619;36;154;1477;4809;1513;4963
211130;202003;185966;440965;161033;408674;23298;57413;74956;217697;98254;275110
211140;202003;4900;14617;4284;13814;211;604;3628;11807;3839;12411
211150;202003;9207;25526;7759;23640;340;1038;6560;20104;6900;21142
211153;202003;2415;7125;1966;6583;272;950;1309;4626;1581;5576
211157;202003;1079;3450;901;3129;33;173;670;2299;703;2472
211160;202003;3980;11272;3111;10019;142;532;2350;7486;2492;8018
211163;202003;1620;5205;1477;5008;20;103;1349;4602;1369;4705
211167;202003;1507;4848;1415;4701;29;130;1300;4294;1329;4424
211170;202003;6403;15836;5957;15328;53;164;5666;14536;5719;14700
211172;202003;2420;6674;2098;6201;104;317;1705;4932;1809;5249
211174;202003;2830;8211;2561;7912;41;211;2389;7343;2430;7554
211176;202003;4174;12015;3240;10644;150;657;2582;8441;2732;9098
211178;202003;4559;10785;3926;10094;33;155;3728;9505;3761;9660
211180;202003;3965;13139;3680;12724;201;757;3139;10902;3340;11659
211190;202003;3011;8940;2547;8255;35;205;2251;7221;2286;7426
211195;202003;1345;3856;1149;3554;48;112;984;3104;1032;3216
211200;202003;2075;5965;1661;5406;199;624;1170;3897;1369;4521
211210;202003;6193;19078;5613;18312;240;1001;4881;15784;5121;16785
211220;202003;36591;92474;29794;84084;2784;7377;22067;64075;24851;71452
211223;202003;5122;13547;4259;12408;352;1052;3234;9475;3586;10527
211227;202003;1736;5829;1576;5598;32;151;1396;5046;1428;5197
211230;202003;7357;21467;6423;20057;392;1056;5176;16538;5568;17594
211240;202003;8046;25694;7623;25150;135;744;7079;23102;7214;23846
211245;202003;6891;17623;6143;16847;86;211;5933;16311;6019;16522
211250;202003;12980;40933;11718;39230;613;2482;9684;32162;10297;34644
211260;202003;7886;25738;7039;24624;196;878;6331;22279;6527;23157
211270;202003;10405;33258;8916;31233;383;1756;7258;25606;7641;27362
211280;202003;12469;34611;11082;32856;915;2161;8890;27575;9805;29736
211285;202003;1693;5672;1486;5375;148;585;1037;3866;1185;4451
211290;202003;7395;22316;6658;21348;180;759;5736;18338;5916;19097
211300;202003;7769;22337;6895;21041;174;583;6011;18212;6185;18795
211400;202003;11202;32057;9102;29192;979;3161;6255;21062;7234;24223
220005;202003;1803;4779;1634;4550;37;145;1380;3770;1417;3915
220010;202003;1469;4216;1207;3744;28;113;942;2886;970;2999
220020;202003;3505;9872;3011;9158;139;498;2456;7422;2595;7920
220025;202003;2220;5051;1899;4574;24;64;1594;3723;1618;3787
220027;202003;1263;3205;1076;2959;19;64;914;2465;933;2529
220030;202003;3305;8349;3090;8061;74;228;2748;7076;2822;7304
220040;202003;7029;21330;6110;19549;1397;4109;3234;10907;4631;15016
220045;202003;1443;4448;1185;4012;31;172;964;3201;995;3373
220050;202003;4724;12801;3997;11843;59;287;3668;10731;3727;11018
220060;202003;2344;4951;1969;4520;24;58;1851;4234;1875;4292
220070;202003;2440;6163;2087;5654;73;154;1742;4744;1815;4898
220080;202003;707;2009;606;1858;24;92;523;1587;547;1679
220090;202003;1743;4223;1437;3791;21;75;1194;3261;1215;3336
220095;202003;641;1606;597;1559;25;42;539;1428;564;1470
220100;202003;1345;3716;1073;3279;48;172;860;2561;908;2733
220105;202003;1977;6189;1732;5698;113;429;1320;4321;1433;4750
220110;202003;3321;9218;3084;8803;39;202;2770;7794;2809;7996
220115;202003;2669;7800;2468;7532;67;234;2237;6775;2304;7009
220117;202003;1340;3247;1040;2831;10;50;879;2345;889;2395
220120;202003;12628;34231;11536;32875;76;271;10828;30853;10904;31124
220130;202003;1093;2960;928;2732;15;81;839;2443;854;2524
220140;202003;2093;4378;1763;3981;100;260;1548;3436;1648;3696
220150;202003;6313;18836;5775;17932;123;596;4889;14899;5012;15495
220155;202003;1141;3287;909;2856;32;115;649;2000;681;2115
220157;202003;1042;2560;883;2316;21;85;718;1821;739;1906
220160;202003;2739;7708;2367;7043;33;159;1976;5785;2009;5944
220170;202003;1510;3985;1288;3661;12;65;1155;3246;1167;3311
220173;202003;2102;5882;1687;5150;41;187;1349;4022;1390;4209
220177;202003;1972;5660;1866;5542;10;37;1842;5465;1852;5502
220180;202003;1109;2722;904;2376;4;21;702;1735;706;1756
220190;202003;6786;17153;5733;15703;356;1044;4292;11921;4648;12965
220191;202003;1447;4461;1310;4228;69;256;975;3055;1044;3311
220192;202003;2006;5314;1464;4338;28;102;1189;3472;1217;3574
220194;202003;1683;4843;1491;4538;53;206;1228;3688;1281;3894
220196;202003;1982;5143;1790;4851;27;113;1534;4082;1561;4195
220198;202003;1274;3545;1073;3287;8;37;989;3053;997;3090
220200;202003;5039;14572;4371;13703;107;433;3734;11710;3841;12143
220202;202003;2135;6019;1835;5530;28;150;1580;4690;1608;4840
220205;202003;2438;7051;2185;6592;48;196;1847;5486;1895;5682
220207;202003;782;2332;633;2075;62;213;399;1320;461;1533
220208;202003;1646;5067;1337;4465;152;552;810;2651;962;3203
220209;202003;1549;4421;1341;4056;22;102;1108;3313;1130;3415
220210;202003;1658;4139;1428;3784;10;48;1223;3173;1233;3221
220211;202003;1560;4051;1432;3874;17;65;1247;3398;1264;3463
220213;202003;1741;4662;1508;4259;30;107;1212;3329;1242;3436
220217;202003;2091;6426;1952;6265;33;89;1826;5953;1859;6042
220220;202003;10372;27131;8568;24332;552;1381;5838;17408;6390;18789
220225;202003;1012;2677;820;2429;6;37;763;2230;769;2267
220230;202003;5672;14108;4862;12992;160;384;4204;11279;4364;11663
220240;202003;2898;8490;2627;8016;112;361;2121;6491;2233;6852
220245;202003;1684;4065;1284;3560;10;53;1166;3263;1176;3316
220250;202003;2961;8321;2610;7877;18;96;2444;7347;2462;7443
220253;202003;1561;4278;1373;3965;62;225;1162;3254;1224;3479
220255;202003;1845;4455;1569;4065;35;156;1330;3314;1365;3470
220260;202003;4195;13042;3698;12122;156;599;2957;9690;3113;10289
220265;202003;1306;4172;1172;3990;34;175;965;3216;999;3391
220270;202003;6124;19458;5754;18783;205;1001;4821;15216;5026;16217
220271;202003;1471;3760;1272;3488;27;101;1125;3067;1152;3168
220272;202003;1756;5044;1559;4684;51;157;1183;3462;1234;3619
220273;202003;1205;3444;1009;3085;37;144;779;2337;816;2481
220275;202003;2232;5381;1762;4736;28;84;1547;4187;1575;4271
220277;202003;2090;5310;1796;4875;20;63;1540;4118;1560;4181
220280;202003;1615;3792;1330;3415;26;89;1133;2872;1159;2961
220285;202003;1409;3615;1201;3377;12;54;1097;3060;1109;3114
220290;202003;6229;17887;4884;15967;342;1263;3574;11932;3916;13195
220300;202003;1949;5649;1589;5171;30;186;1326;4286;1356;4472
220310;202003;3030;8170;2347;7371;41;203;1968;6144;2009;6347
220320;202003;2995;8848;2298;7507;85;411;1792;5666;1877;6077
220323;202003;1606;4709;1262;4146;55;214;1035;3351;1090;3565
220325;202003;1238;3671;1057;3371;23;116;887;2775;910;2891
220327;202003;1486;4237;1289;3911;45;189;1067;3155;1112;3344
220330;202003;4291;10425;3582;9562;57;181;3231;8561;3288;8742
220335;202003;1667;5069;1498;4856;32;107;1332;4336;1364;4443
220340;202003;1815;4799;1395;4100;58;196;954;2722;1012;2918
220342;202003;1123;3324;997;3135;42;202;798;2462;840;2664
220345;202003;3096;6971;2393;5952;13;42;2172;5379;2185;5421
220350;202003;3270;8365;2596;7361;136;412;1849;5243;1985;5655
220360;202003;1218;3131;952;2690;13;42;764;2141;777;2183
220370;202003;8636;25052;7836;23765;169;744;6842;20475;7011;21219
220375;202003;1591;4542;1403;4311;2;13;1332;4112;1334;4125
220380;202003;1474;3508;1193;3101;15;41;1044;2682;1059;2723
220385;202003;844;2030;670;1710;7;21;583;1468;590;1489
220390;202003;9939;25924;7568;22234;1952;5612;2840;9234;4792;14846
220400;202003;1457;3448;1110;2927;23;67;857;2209;880;2276
220410;202003;1149;3159;921;2775;48;141;747;2222;795;2363
220415;202003;798;2042;668;1832;19;56;538;1455;557;1511
220420;202003;1990;5521;1592;4748;53;160;1233;3630;1286;3790
220430;202003;2452;6617;2301;6397;76;250;1967;5403;2043;5653
220435;202003;1718;4438;1481;4094;38;127;1224;3323;1262;3450
220440;202003;2366;7421;2024;6888;96;406;1695;5676;1791;6082
220450;202003;2459;6379;2000;5807;60;206;1707;4978;1767;5184
220455;202003;1282;3970;1217;3878;11;59;1084;3449;1095;3508
220460;202003;962;2362;892;2273;36;89;763;1924;799;2013
220465;202003;2314;7189;2037;6753;177;607;1505;5087;1682;5694
220470;202003;3436;9517;3077;8955;81;218;2516;7236;2597;7454
220480;202003;2687;7013;2152;6150;160;397;1449;4159;1609;4556
220490;202003;2468;6216;2133;5788;27;131;1859;4968;1886;5099
220500;202003;2757;7102;2408;6545;52;177;1977;5228;2029;5405
220510;202003;2516;7142;1967;6150;79;233;1552;4892;1631;5125
220515;202003;1622;3938;1485;3746;32;52;1304;3279;1336;3331
220520;202003;4865;12713;4375;12014;98;288;3809;10379;3907;10667
220525;202003;1308;3311;1125;3080;9;42;1035;2799;1044;2841
220527;202003;1291;3620;1105;3351;11;51;951;2933;962;2984
220530;202003;1426;3563;1219;3300;31;102;1112;2982;1143;3084
220535;202003;790;2196;738;2127;30;100;605;1731;635;1831
220540;202003;3193;10211;2987;9821;116;406;2566;8408;2682;8814
220545;202003;1381;4201;1267;4018;65;257;1058;3310;1123;3567
220550;202003;8512;26152;7523;24439;491;1717;5680;18300;6171;20017
220551;202003;1372;3939;1197;3638;26;121;986;2932;1012;3053
220552;202003;1575;4581;1278;4057;29;144;1023;3132;1052;3276
220553;202003;1682;4400;1384;4006;56;125;1120;3365;1176;3490
220554;202003;877;2320;639;1919;45;104;414;1247;459;1351
220555;202003;2177;6656;1947;6338;42;186;1654;5386;1696;5572
220556;202003;1188;3452;1027;3146;57;232;736;2159;793;2391
220557;202003;1583;4860;1335;4360;67;264;977;3097;1044;3361
220558;202003;1381;3599;1080;3180;20;90;932;2718;952;2808
220559;202003;1692;4264;1430;3859;7;19;1148;3157;1155;3176
220560;202003;1737;3915;1396;3480;36;69;1269;3188;1305;3257
220570;202003;7109;21268;6457;20353;444;1412;5127;16262;5571;17674
220580;202003;6886;18942;6299;17990;81;300;5701;16163;5782;16463
220585;202003;1996;6297;1660;5681;40;143;1364;4717;1404;4860
220590;202003;1304;3554;1064;3189;72;214;771;2317;843;2531
220595;202003;2514;6891;2281;6578;21;101;2026;5796;2047;5897
220600;202003;1370;3082;1151;2808;85;106;961;2427;1046;2533
220605;202003;1607;4692;1367;4265;19;116;1105;3342;1124;3458
220610;202003;2710;7977;2538;7724;34;151;2366;7180;2400;7331
220620;202003;7755;24111;7132;23268;169;901;6497;20934;6666;21835
220630;202003;362;1073;275;908;22;73;183;608;205;681
220635;202003;1593;5077;1399;4651;54;267;1058;3412;1112;3679
220640;202003;2469;6822;2104;6292;80;322;1707;5037;1787;5359
220650;202003;2045;5655;1774;5237;37;137;1423;4203;1460;4340
220660;202003;2598;8119;2206;7453;81;424;1846;6085;1927;6509
220665;202003;1195;3645;1009;3335;32;175;839;2684;871;2859
220667;202003;1576;4920;1408;4602;61;247;1155;3745;1216;3992
220669;202003;1602;4889;1533;4782;51;241;1356;4133;1407;4374
220670;202003;2161;5666;1732;5061;16;83;1504;4381;1520;4464
220672;202003;3161;7778;2551;7041;106;340;2247;6150;2353;6490
220675;202003;1239;3410;1108;3169;31;103;925;2614;956;2717
220680;202003;2648;7265;2530;7096;95;232;2321;6532;2416;6764
220690;202003;1543;4095;1361;3817;60;171;1078;3041;1138;3212
220695;202003;880;2439;812;2320;22;68;710;2022;732;2090
220700;202003;9760;24125;7821;21437;342;979;5991;16306;6333;17285
220710;202003;883;2437;655;2005;30;98;487;1465;517;1563
220720;202003;2087;4966;1884;4692;15;61;1640;4030;1655;4091
220730;202003;1289;3621;1083;3271;16;91;919;2706;935;2797
220735;202003;947;2219;738;1900;17;62;623;1545;640;1607
220740;202003;1352;3543;1074;3192;32;86;886;2688;918;2774
220750;202003;3837;9749;3343;9037;191;466;2890;7850;3081;8316
220755;202003;1265;3165;1048;2838;24;90;848;2234;872;2324
220760;202003;3047;8560;2661;8037;77;259;2376;7241;2453;7500
220770;202003;21760;65313;18244;59211;5594;19148;6508;21887;12102;41035
220775;202003;1135;2917;1017;2770;11;46;974;2635;985;2681
220777;202003;1602;4052;1212;3452;29;72;932;2668;961;2740
220779;202003;1283;3242;1108;2988;20;62;967;2593;987;2655
220780;202003;5543;14012;4817;12909;203;662;3949;10342;4152;11004
220785;202003;1452;3239;1269;3007;7;19;1226;2890;1233;2909
220790;202003;9922;28437;8905;26982;212;1008;7503;22463;7715;23471
220793;202003;905;2382;716;2050;10;23;599;1737;609;1760
220795;202003;1372;3553;1205;3323;18;78;1067;2931;1085;3009
220800;202003;17665;39307;14911;35651;625;1457;11552;27578;12177;29035
220810;202003;2946;8178;2476;7344;52;163;2043;6011;2095;6174
220820;202003;4981;12997;4298;12003;274;673;3261;9098;3535;9771
220830;202003;7184;19110;6450;18090;235;770;5365;14838;5600;15608
220840;202003;12123;37175;10053;32911;2269;7120;4661;15923;6930;23043
220850;202003;3091;9598;2757;9187;60;322;2436;8122;2496;8444
220855;202003;679;1736;589;1607;13;48;536;1452;549;1500
220860;202003;1007;2550;865;2323;16;67;773;2049;789;2116
220865;202003;2418;6421;1898;5514;96;349;1386;3903;1482;4252
220870;202003;2896;8260;2417;7624;35;188;2222;6985;2257;7173
220880;202003;5246;12437;4505;11518;78;289;4111;10390;4189;10679
220885;202003;1372;4222;1132;3813;57;233;906;3085;963;3318
220887;202003;1532;3343;1272;3007;11;28;1179;2765;1190;2793
220890;202003;1381;4250;1207;3983;47;165;998;3349;1045;3514
220900;202003;2006;4772;1672;4337;30;74;1463;3782;1493;3856
220910;202003;1509;4127;1264;3769;55;168;1050;3143;1105;3311
220915;202003;925;2513;752;2195;5;20;576;1644;581;1664
220920;202003;1316;4303;1132;4058;60;272;930;3342;990;3614
220930;202003;1693;4627;1421;4231;23;72;1310;3895;1333;3967
220935;202003;1069;3072;872;2659;26;99;582;1684;608;1783
220937;202003;1389;3706;1199;3415;23;78;957;2697;980;2775
220940;202003;1483;4204;1178;3645;37;138;909;2772;946;2910
220945;202003;435;1518;375;1378;21;120;279;985;300;1105
220950;202003;1415;3253;916;2468;15;53;730;1903;745;1956
220955;202003;1579;4094;1316;3632;25;76;1115;3034;1140;3110
220960;202003;795;2032;591;1694;13;47;430;1174;443;1221
220965;202003;1761;4841;1533;4496;21;130;1329;3806;1350;3936
220970;202003;1904;4587;1392;3817;36;91;1152;3138;1188;3229
220975;202003;676;1972;577;1849;16;92;510;1574;526;1666
220980;202003;1140;3221;1012;3049;37;151;848;2522;885;2673
220985;202003;1197;3135;1039;2909;43;126;842;2289;885;2415
220987;202003;1419;4245;1233;3911;55;209;995;3131;1050;3340
220990;202003;1675;4616;1472;4318;18;101;1246;3594;1264;3695
220995;202003;1049;3195;847;2823;34;120;624;2069;658;2189
220997;202003;2368;7093;2187;6802;48;220;1960;6029;2008;6249
221000;202003;4433;12155;3914;11380;88;426;3332;9537;3420;9963
221005;202003;1454;3833;1327;3625;22;122;1154;3031;1176;3153
221010;202003;1173;2717;942;2434;20;56;820;2073;840;2129
221020;202003;1490;4563;1376;4346;22;88;1064;3318;1086;3406
221030;202003;1593;3989;1374;3721;24;77;1186;3257;1210;3334
221035;202003;1464;3896;1276;3640;21;28;1130;3314;1151;3342
221037;202003;653;1840;543;1645;8;27;380;1110;388;1137
221038;202003;516;1450;402;1242;13;43;284;874;297;917
221039;202003;846;2326;725;2119;19;83;595;1671;614;1754
221040;202003;3964;11893;3466;10999;148;528;2754;8736;2902;9264
221050;202003;3861;10181;3390;9578;65;241;3056;8609;3121;8850
221060;202003;8328;23184;6879;20896;247;713;5605;17152;5852;17865
221062;202003;1157;3754;981;3457;40;186;788;2738;828;2924
221063;202003;1024;2878;875;2659;57;197;675;2019;732;2216
221065;202003;2580;6683;2282;6145;22;89;2006;5304;2028;5393
221070;202003;3297;10300;2649;8944;280;948;1638;5649;1918;6597
221080;202003;3454;8499;2798;7531;57;221;2295;6080;2352;6301
221090;202003;1372;3553;1122;3140;9;35;964;2637;973;2672
221093;202003;1339;3766;1218;3519;121;339;845;2398;966;2737
221095;202003;884;2287;736;2057;10;33;615;1689;625;1722
221097;202003;830;2179;637;1831;22;70;469;1296;491;1366
221100;202003;112253;300384;93002;267359;10002;30861;60482;169234;70484;200095
221110;202003;9781;29199;8962;28134;147;750;8021;24926;8168;25676
221120;202003;4721;13023;4199;12178;161;491;3661;10597;3822;11088
221130;202003;5212;13677;3857;11015;761;2071;1852;5350;2613;7421
221135;202003;1593;4263;1428;4043;39;137;1267;3580;1306;3717
221140;202003;1310;3117;1102;2848;12;42;989;2506;1001;2548
221150;202003;1094;2702;852;2275;23;100;656;1636;679;1736
221160;202003;715;1787;629;1676;13;16;518;1387;531;1403
221170;202003;975;2807;883;2636;20;68;764;2256;784;2324
230010;202003;2981;7890;2450;6980;35;130;1986;5546;2021;5676
230015;202003;2958;9636;2581;8883;162;645;1818;6203;1980;6848
230020;202003;12809;40438;11958;39129;331;1378;10149;33012;10480;34390
230030;202003;12900;32330;10740;29527;176;541;9443;25951;9619;26492
230040;202003;4379;11418;3623;10198;44;222;3034;8420;3078;8642
230050;202003;2761;8565;2075;6922;335;1061;921;3003;1256;4064
230060;202003;2338;6405;1849;5539;37;165;1461;4290;1498;4455
230070;202003;3868;10308;3099;8818;140;438;2174;6114;2314;6552
230075;202003;8916;28913;8143;27545;465;1971;6490;21656;6955;23627
230080;202003;3059;6400;2314;5477;8;30;2112;5014;2120;5044
230090;202003;4234;10554;3564;9473;167;443;2842;7506;3009;7949
230100;202003;17687;46110;15521;43149;1154;3324;11168;31149;12322;34473
230110;202003;12674;37600;10636;33586;1716;5392;5630;17887;7346;23279
230120;202003;7258;19636;6378;18197;500;1267;4702;13629;5202;14896
230125;202003;3131;8265;2535;7296;88;298;1940;5513;2028;5811
230130;202003;5705;17546;4608;15092;309;1101;3121;10036;3430;11137
230140;202003;3387;10154;2875;9087;101;407;2191;6773;2292;7180
230150;202003;1559;4678;1290;4077;195;535;755;2477;950;3012
230160;202003;6450;16767;5510;15291;196;687;4458;12149;4654;12836
230170;202003;6230;17676;5063;15265;317;939;3631;10775;3948;11714
230180;202003;1634;4519;1380;4041;20;94;1117;3169;1137;3263
230185;202003;4297;12306;3607;11150;241;848;2697;8306;2938;9154
230190;202003;13012;37907;10914;33992;1459;4738;6181;19100;7640;23838
230195;202003;5249;15478;4751;14535;336;1022;3646;11123;3982;12145
230200;202003;4973;13697;4157;12151;146;473;3187;9120;3333;9593
230205;202003;4008;12069;3505;11293;179;663;2620;8377;2799;9040
230210;202003;10331;24861;8681;22621;336;1116;6854;17535;7190;18651
230220;202003;13902;34878;12125;32300;619;1674;9967;26283;10586;27957
230230;202003;6773;20472;6037;18922;386;1211;4462;13967;4848;15178
230240;202003;12968;34589;11175;31524;276;1151;9229;25438;9505;26589
230250;202003;8846;24855;8223;23881;221;797;6596;18583;6817;19380
230260;202003;14504;43476;12527;39896;1654;5158;7213;23483;8867;28641
230270;202003;7458;20288;5653;16842;457;1345;3758;11242;4215;12587
230280;202003;20297;54196;16483;47725;470;1996;12971;36201;13441;38197
230290;202003;4804;13326;3976;11739;265;698;2995;8865;3260;9563
230300;202003;4757;12740;4291;12096;94;291;3751;10500;3845;10791
230310;202003;4591;13087;3867;11798;134;581;2785;8259;2919;8840
230320;202003;7685;22206;6444;19912;245;1023;4923;14888;5168;15911
230330;202003;4678;12755;3674;10811;139;463;2754;7924;2893;8387
230340;202003;3552;11062;3013;9966;267;939;2019;6608;2286;7547
230350;202003;17698;48776;15462;45411;861;2909;10405;30772;11266;33681
230360;202003;2870;7686;2236;6565;139;411;1511;4387;1650;4798
230365;202003;2987;7509;2463;6719;48;231;2096;5642;2144;5873
230370;202003;58394;162253;49492;148914;7359;22400;29315;89687;36674;112087
230380;202003;6285;17453;4927;14934;128;522;3643;10804;3771;11326
230390;202003;3356;9981;2892;9226;96;427;2228;7020;2324;7447
230393;202003;3175;9529;2514;8161;84;442;1917;5987;2001;6429
230395;202003;5738;15631;4992;14378;325;876;3530;10199;3855;11075
230400;202003;5419;14966;4813;13952;96;512;3888;10948;3984;11460
230410;202003;14120;41573;11578;36844;884;3057;7932;25195;8816;28252
230420;202003;28382;78142;22900;68504;2784;8669;12776;38051;15560;46720
230423;202003;4633;13754;4020;12521;87;388;3295;10095;3382;10483
230425;202003;5512;17018;5001;15963;387;1301;3574;11358;3961;12659
230426;202003;2708;7157;1947;5664;29;108;1460;4172;1489;4280
230427;202003;1848;5210;1310;4062;60;211;866;2584;926;2795
230428;202003;9603;25602;8213;23497;1106;3152;4818;13734;5924;16886
230430;202003;4966;13920;3904;12096;154;548;2911;8887;3065;9435
230435;202003;5825;15305;4825;13508;573;1533;2948;8310;3521;9843
230440;202003;408148;1012445;337203;907408;34144;97370;215358;573555;249502;670925
230445;202003;4215;11191;3383;9749;164;462;2319;6559;2483;7021
230450;202003;3545;10266;3088;9591;233;917;2254;6789;2487;7706
230460;202003;2109;5896;1834;5460;57;230;1534;4543;1591;4773
230465;202003;3962;11176;3354;10009;100;407;2517;7219;2617;7626
230470;202003;11218;36966;10025;34753;864;3439;7121;24241;7985;27680
230480;202003;1398;4078;1180;3677;72;283;857;2574;929;2857
230490;202003;2505;7034;2092;6259;165;556;1310;3686;1475;4242
230495;202003;5706;16936;5012;15687;362;1382;3333;10295;3695;11677
230500;202003;9172;29606;8225;27857;269;1108;6695;22630;6964;23738
230510;202003;1587;4824;1220;4023;168;600;605;1960;773;2560
230520;202003;4474;12692;3858;11573;315;887;2707;8148;3022;9035
230523;202003;15300;45174;12164;38397;2748;8656;3163;10643;5911;19299
230526;202003;3660;10434;3118;9500;183;541;2283;7011;2466;7552
230530;202003;5348;16708;4481;14998;293;1112;3224;10670;3517;11782
230533;202003;4388;10575;3640;9376;83;250;3027;7671;3110;7921
230535;202003;5279;14665;4454;13262;228;688;3129;9424;3357;10112
230540;202003;16142;43770;13823;40329;272;1094;11399;32932;11671;34026
230550;202003;20460;54371;16344;47328;1481;4450;10398;29964;11879;34414
230560;202003;7999;19626;6427;17135;50;209;5513;14605;5563;14814
230565;202003;2979;8310;2485;7403;82;333;1882;5497;1964;5830
230570;202003;3442;8802;2928;8102;81;236;2411;6659;2492;6895
230580;202003;10871;28192;9271;25877;341;969;7643;21232;7984;22201
230590;202003;8787;25019;7244;22188;388;1419;5348;15843;5736;17262
230600;202003;3593;9397;2803;7985;79;245;1944;5578;2023;5823
230610;202003;6610;18285;5830;16964;440;1268;4593;13287;5033;14555
230620;202003;2047;5544;1546;4562;112;353;958;2739;1070;3092
230625;202003;7642;21770;6392;19459;1898;6011;1758;5758;3656;11769
230630;202003;10647;31646;9202;28732;1442;4300;5295;16919;6737;21219
230640;202003;27485;83130;24726;78714;1241;4971;19633;61580;20874;66551
230650;202003;5060;13835;4297;12494;131;555;3499;9935;3630;10490
230655;202003;9183;31176;8619;30183;596;2184;6874;24318;7470;26502
230660;202003;5950;17750;4859;15813;148;802;3969;12648;4117;13450
230670;202003;6126;14629;4459;11937;128;429;3598;9407;3726;9836
230680;202003;2601;7132;2201;6415;128;352;1590;4668;1718;5020
230690;202003;7103;21003;6105;19007;389;1365;3862;11808;4251;13173
230700;202003;10079;25879;8132;22260;311;844;6039;16213;6350;17057
230710;202003;6629;21070;5779;19239;581;1971;3935;12928;4516;14899
230720;202003;1890;5582;1529;4838;118;356;1028;3182;1146;3538
230725;202003;3822;11532;3425;10833;376;1327;1988;6195;2364;7522
230730;202003;56021;151774;43580;132586;9559;31493;14616;46766;24175;78259
230740;202003;5972;16552;5057;15087;127;458;4085;12145;4212;12603
230750;202003;8287;22109;6864;19735;160;580;5474;15341;5634;15921
230760;202003;11033;29059;9588;26890;503;1674;7242;19857;7745;21531
230763;202003;4722;13040;3940;11604;119;562;3159;9022;3278;9584
230765;202003;40299;109450;33311;98043;5198;15855;16692;48877;21890;64732
230770;202003;25310;62616;21081;56966;2144;5828;13980;37894;16124;43722
230780;202003;6158;21840;5605;20537;742;2735;3349;12569;4091;15304
230790;202003;2935;8569;2632;8069;107;463;1973;5898;2080;6361
230800;202003;7931;25259;6952;23271;793;2890;4206;13822;4999;16712
230810;202003;11340;33820;10116;31842;391;1444;7827;24183;8218;25627
230820;202003;3422;11183;2785;9678;251;1050;1696;5609;1947;6659
230830;202003;7453;20337;6320;18421;131;561;5223;14874;5354;15435
230835;202003;4231;10109;3235;8517;83;248;2622;6807;2705;7055
230837;202003;3082;9477;2682;8765;106;503;2139;6798;2245;7301
230840;202003;8894;26100;7631;23972;769;2302;5489;17400;6258;19702
230850;202003;9423;27396;7871;24301;353;1293;5677;17252;6030;18545
230860;202003;5121;13100;4231;11825;56;206;3744;10407;3800;10613
230870;202003;16379;40047;13999;36082;372;1078;11467;29051;11839;30129
230880;202003;2073;6316;1887;6007;39;221;1504;4676;1543;4897
230890;202003;4550;14522;4119;13645;327;1200;2988;9720;3315;10920
230900;202003;2953;8506;2513;7652;175;615;1702;5058;1877;5673
230910;202003;3047;8222;2442;7255;55;272;1988;5875;2043;6147
230920;202003;4538;12864;3826;11732;131;536;3007;9031;3138;9567
230930;202003;6410;17979;5358;16088;288;839;3743;11253;4031;12092
230940;202003;7906;20364;6791;18655;191;500;5679;15522;5870;16022
230945;202003;6440;18544;5516;16768;300;1077;3931;11753;4231;12830
230950;202003;6162;15553;5467;14603;88;210;4835;12975;4923;13185
230960;202003;12903;37607;11334;34659;1815;5526;5781;17901;7596;23427
230970;202003;13343;35354;11091;31844;1721;4890;6254;18246;7975;23136
230980;202003;2647;7771;2318;7190;342;1018;1441;4586;1783;5604
230990;202003;1600;4519;1326;3971;62;265;950;2710;1012;2975
231000;202003;2451;6548;1993;5641;72;189;1487;4129;1559;4318
231010;202003;3500;8247;2751;6938;40;148;2382;5836;2422;5984
231020;202003;7889;24942;7022;23194;1277;3906;3984;13727;5261;17633
231025;202003;7385;20432;6398;18806;716;2066;4439;13170;5155;15236
231030;202003;7218;21482;5622;18106;884;2759;2942;9519;3826;12278
231040;202003;2869;8360;2496;7660;118;378;1960;5917;2078;6295
231050;202003;11528;29781;9270;25759;637;1729;6890;18725;7527;20454
231060;202003;2778;7944;2420;7365;61;228;1994;6060;2055;6288
231070;202003;7716;22395;6570;20391;695;2227;4255;13127;4950;15354
231080;202003;3889;11140;3301;10181;127;549;2524;7635;2651;8184
231085;202003;6710;16340;5299;14645;193;512;4157;11495;4350;12007
231090;202003;4432;11569;3257;9296;97;391;2241;6173;2338;6564
231095;202003;2263;6728;1767;5645;139;445;1169;3733;1308;4178
231100;202003;3123;9040;2570;7999;117;427;1926;5931;2043;6358
231110;202003;3495;10309;3169;9704;115;430;2395;7226;2510;7656
231120;202003;2194;6443;1804;5766;74;293;1299;4103;1373;4396
231123;202003;1856;4837;1553;4316;67;159;1144;3191;1211;3350
231126;202003;5357;14878;4309;12874;234;715;3151;9301;3385;10016
231130;202003;20999;54012;17436;49485;1003;3712;12930;35971;13933;39683
231135;202003;4116;11591;3390;10161;148;504;2427;7140;2575;7644
231140;202003;16338;45971;12978;40016;580;2431;9135;27419;9715;29850
231150;202003;5680;15496;4362;12975;664;2000;1963;5998;2627;7998
231160;202003;6153;18756;5379;17312;764;2327;3108;10269;3872;12596
231170;202003;4321;12640;3551;11157;191;697;2466;7487;2657;8184
231180;202003;14124;40069;11401;34297;3136;9143;3893;12213;7029;21356
231190;202003;3844;10860;3159;9598;68;303;2429;7187;2497;7490
231195;202003;4868;14787;4019;13003;226;851;2910;9313;3136;10164
231200;202003;7713;24205;6714;22177;200;1023;5258;16843;5458;17866
231210;202003;4762;14039;4043;12830;178;684;3053;9499;3231;10183
231220;202003;11848;31000;9166;25895;375;1189;6724;18331;7099;19520
231230;202003;9104;29036;7993;27019;478;1904;5895;19910;6373;21814
231240;202003;11361;33214;9971;30562;1510;4500;6063;18808;7573;23308
231250;202003;2111;5445;1367;3790;98;276;834;2266;932;2542
231260;202003;3168;9013;2735;8330;251;754;1885;5867;2136;6621
231270;202003;6340;16614;5131;14632;144;569;3890;10857;4034;11426
231280;202003;1706;5320;1557;5043;90;302;1168;3754;1258;4056
231290;202003;37288;111114;30843;97910;5196;16325;14293;45158;19489;61483
231300;202003;4016;11163;3132;9374;208;679;2071;6068;2279;6747
231310;202003;7115;18562;5666;15860;463;1322;3909;10747;4372;12069
231320;202003;7662;21151;5951;18089;85;416;4674;14005;4759;14421
231325;202003;2411;6396;1968;5719;161;394;1330;3952;1491;4346
231330;202003;9367;28085;7667;24684;1373;4219;4098;13791;5471;18010
231335;202003;5662;14963;4780;13532;85;365;4213;11802;4298;12167
231340;202003;17101;53186;15305;49964;1269;4180;11143;36800;12412;40980
231350;202003;15677;42919;14205;40835;276;1006;12708;36199;12984;37205
231355;202003;4318;12950;3866;12100;230;777;2992;9264;3222;10041
231360;202003;7225;21948;6260;20255;251;940;4986;16050;5237;16990
231370;202003;2135;5891;1707;5132;33;111;1305;3920;1338;4031
231375;202003;4331;13484;3946;12846;130;599;3316;10651;3446;11250
231380;202003;5977;16264;5397;15460;180;482;4400;12793;4580;13275
231390;202003;3280;9583;2927;9000;124;489;2173;6498;2297;6987
231395;202003;3896;11552;3221;10476;401;1316;1908;6304;2309;7620
231400;202003;9604;27553;8022;24638;270;1141;6081;18275;6351;19416
231410;202003;14480;45256;13131;43007;588;2279;10593;34278;11181;36557
240010;202003;2485;6616;1927;5581;188;569;1163;3300;1351;3869
240020;202003;12255;34411;10246;30811;616;2312;6904;20435;7520;22747
240030;202003;2828;6919;2567;6516;89;260;2224;5595;2313;5855
240040;202003;785;2254;651;2001;32;120;459;1366;491;1486
240050;202003;3189;8566;2587;7452;47;142;2019;5735;2066;5877
240060;202003;1377;3708;1132;3261;23;86;927;2608;950;2694
240070;202003;2114;6146;1913;5735;179;582;1389;4044;1568;4626
240080;202003;2927;7912;2375;6880;53;206;1830;5196;1883;5402
240090;202003;2210;5461;1794;4758;18;51;1517;3977;1535;4028
240100;202003;9947;24623;7882;20834;206;638;6164;15741;6370;16379
240110;202003;4547;12826;3820;11495;185;678;2774;8182;2959;8860
240120;202003;3207;8932;2558;8142;179;620;1810;5900;1989;6520
240130;202003;3591;7523;2993;6748;26;82;2736;6085;2762;6167
240140;202003;1798;5375;1528;4847;156;544;1031;3238;1187;3782
240145;202003;6559;18219;5343;16127;815;2517;3025;9245;3840;11762
240150;202003;905;2652;800;2431;50;178;619;1822;669;2000
240160;202003;1424;4316;1188;3865;46;213;888;2899;934;3112
240165;202003;945;2587;784;2278;37;123;633;1807;670;1930
240170;202003;2455;6674;2057;5948;186;611;1396;3917;1582;4528
240180;202003;2944;8734;2349;7514;548;1658;1067;3633;1615;5291
240185;202003;1157;3700;1062;3538;52;215;882;2896;934;3111
240190;202003;1034;3080;887;2832;22;104;753;2411;775;2515
240200;202003;10637;27362;8449;23602;827;2540;4876;13288;5703;15828
240210;202003;3140;7845;2585;6969;26;134;2173;5683;2199;5817
240220;202003;7190;21575;6411;20341;323;1434;5044;15707;5367;17141
240230;202003;5749;14687;4597;12741;186;535;3675;10192;3861;10727
240240;202003;1836;5260;1139;3585;117;385;419;1175;536;1560
240250;202003;2884;7645;2537;7167;91;282;2135;6000;2226;6282
240260;202003;14025;41233;12075;37911;1702;4999;7495;24702;9197;29701
240270;202003;2225;6656;1940;6175;88;298;1430;4672;1518;4970
240280;202003;1665;4277;1411;3857;49;140;1134;3055;1183;3195
240290;202003;1170;3414;946;2909;27;127;671;1928;698;2055
240300;202003;2196;5640;1567;4475;71;218;1009;2810;1080;3028
240310;202003;8420;22243;6630;19025;884;2690;3460;9752;4344;12442
240320;202003;2008;5492;1480;4445;31;142;1108;3175;1139;3317
240325;202003;29785;80072;23365;68696;4153;12592;10243;30449;14396;43041
240330;202003;1707;4687;1299;3904;52;193;883;2533;935;2726
240340;202003;1948;4498;1586;3944;62;146;1299;3175;1361;3321
240350;202003;2104;5413;1887;5175;25;81;1721;4736;1746;4817
240360;202003;8561;23751;7617;22257;801;2375;5384;15918;6185;18293
240370;202003;1878;4993;1446;4095;62;189;1031;2840;1093;3029
240375;202003;891;2261;730;1954;27;98;595;1541;622;1639
240380;202003;2207;6274;1607;4914;137;399;949;2880;1086;3279
240390;202003;996;2470;685;1868;27;71;429;1087;456;1158
240400;202003;1402;3475;1090;2918;36;135;767;1945;803;2080
240410;202003;558;1686;469;1487;39;149;299;892;338;1041
240420;202003;4514;15850;3965;14620;452;1983;2364;8528;2816;10511
240430;202003;3323;8643;2765;7643;168;543;2061;5525;2229;6068
240440;202003;2500;5475;2105;4931;136;263;1708;4011;1844;4274
240450;202003;4430;12101;3470;10289;339;1068;2061;5886;2400;6954
240460;202003;2779;7966;2521;7549;241;769;1947;5810;2188;6579
240470;202003;3573;10725;2707;8910;455;1421;1416;4881;1871;6302
240480;202003;574;1591;388;1178;32;101;181;530;213;631
240485;202003;2099;5948;1717;5229;123;392;1197;3643;1320;4035
240490;202003;1608;4124;1261;3483;82;194;933;2597;1015;2791
240500;202003;2120;5741;1852;5294;100;275;1497;4283;1597;4558
240510;202003;1650;4295;1453;4009;64;229;1214;3272;1278;3501
240520;202003;1394;3488;1084;3050;42;142;827;2312;869;2454
240530;202003;2115;6084;1902;5745;91;276;1561;4704;1652;4980
240540;202003;2247;5662;1961;5211;59;122;1703;4522;1762;4644
240550;202003;674;1914;610;1787;19;76;510;1455;529;1531
240560;202003;3281;8486;2755;7777;271;700;1995;5737;2266;6437
240570;202003;2691;7088;1776;5038;272;780;710;1882;982;2662
240580;202003;8045;23412;7100;21655;553;1613;5663;17405;6216;19018
240590;202003;696;1843;612;1703;13;44;458;1253;471;1297
240600;202003;1763;4791;1293;3801;44;147;863;2455;907;2602
240610;202003;4159;11272;3501;10065;126;431;2676;7554;2802;7985
240615;202003;1199;3111;946;2647;85;233;652;1772;737;2005
240620;202003;1816;5134;1566;4693;92;257;1256;3751;1348;4008
240630;202003;2075;5879;1876;5536;148;313;1326;4088;1474;4401
240640;202003;932;2502;742;2181;27;108;556;1613;583;1721
240650;202003;4014;11139;3459;10011;208;619;2668;7615;2876;8234
240660;202003;3090;7912;2742;7460;50;155;2484;6764;2534;6919
240670;202003;2432;6854;1952;5870;141;457;1267;3712;1408;4169
240680;202003;1609;4288;1289;3740;48;150;982;2776;1030;2926
240690;202003;976;2456;771;2110;16;69;613;1612;629;1681
240700;202003;2381;6901;1936;6071;58;213;1530;4713;1588;4926
240710;202003;16051;41529;13394;36945;1732;4680;8288;22891;10020;27571
240720;202003;5070;12543;4373;11560;361;1024;3244;8457;3605;9481
240725;202003;1114;3170;855;2646;31;105;577;1726;608;1831
240730;202003;2195;6163;1776;5331;59;213;1361;4007;1420;4220
240740;202003;1788;4816;1431;4112;42;163;1063;2892;1105;3055
240750;202003;2111;6979;1778;6265;264;1016;952;3392;1216;4408
240760;202003;1562;3753;1091;3029;58;101;835;2403;893;2504
240770;202003;3178;8755;2662;8007;127;474;2148;6369;2275;6843
240780;202003;4790;13201;3883;11672;501;1489;2418;7437;2919;8926
240790;202003;842;2397;698;2115;13;56;531;1572;544;1628
240800;202003;44992;108805;34695;93142;4708;13044;18037;48544;22745;61588
240810;202003;87086;226904;73357;203901;9223;26264;46285;127004;55508;153268
240820;202003;5708;17035;4923;15610;658;2059;3060;9864;3718;11923
240830;202003;8663;24783;7691;23326;239;1052;6386;19095;6625;20147
240840;202003;1109;2746;880;2377;29;72;627;1632;656;1704
240850;202003;1329;3630;949;2827;41;129;534;1537;575;1666
240860;202003;1238;3371;926;2799;13;69;680;1961;693;2030
240870;202003;1102;2793;826;2306;130;368;450;1283;580;1651
240880;202003;1256;3969;1110;3681;85;362;855;2754;940;3116
240890;202003;4350;11870;3302;9857;439;1416;1700;4880;2139;6296
240895;202003;2651;8356;2430;8016;120;417;2134;7065;2254;7482
240910;202003;3271;8994;2788;8113;50;186;2295;6569;2345;6755
240920;202003;849;2351;702;2109;58;171;404;1268;462;1439
240930;202003;3653;8342;3022;7575;195;281;2277;6013;2472;6294
240933;202003;1748;4247;1427;3776;42;165;1235;3219;1277;3384
240940;202003;6020;14835;4651;12485;523;1417;2823;7369;3346;8786
240950;202003;994;2987;867;2750;27;116;707;2190;734;2306
240960;202003;669;2065;600;1925;27;101;470;1474;497;1575
240970;202003;1811;4684;1460;4078;55;208;1197;3251;1252;3459
240980;202003;3290;9799;2916;9123;116;498;2357;7245;2473;7743
240990;202003;2509;7087;2222;6522;259;849;1574;4453;1833;5302
241000;202003;920;2453;733;2105;26;70;545;1538;571;1608
241010;202003;2752;8824;2511;8307;167;681;1854;6034;2021;6715
241020;202003;2078;5566;1520;4437;139;404;971;2801;1110;3205
241025;202003;1730;4979;1371;4299;48;211;987;3053;1035;3264
241030;202003;2475;7730;1973;6648;218;757;1280;4313;1498;5070
241040;202003;2259;7173;2000;6738;100;431;1602;5364;1702;5795
241050;202003;1301;3628;1065;3200;31;121;803;2348;834;2469
241060;202003;730;2060;646;1883;26;86;459;1286;485;1372
241070;202003;653;1789;563;1632;12;39;443;1242;455;1281
241080;202003;1118;3164;844;2614;7;29;615;1878;622;1907
241090;202003;2003;5878;1633;5233;45;228;1293;4078;1338;4306
241100;202003;1161;3261;913;2741;62;196;599;1741;661;1937
241105;202003;972;2952;792;2610;252;806;257;887;509;1693
241110;202003;936;2647;697;2142;36;112;458;1368;494;1480
241120;202003;7550;21326;6396;19280;955;2814;3779;11705;4734;14519
241140;202003;3274;8618;2575;7216;150;433;1862;5091;2012;5524
241142;202003;757;2033;556;1640;27;92;333;928;360;1020
241150;202003;5893;15333;5191;14169;144;493;4268;11440;4412;11933
241160;202003;1125;3019;908;2617;128;375;587;1648;715;2023
241170;202003;1323;3369;1131;3041;28;110;943;2427;971;2537
241180;202003;1013;2617;732;2067;85;248;381;1056;466;1304
241190;202003;1091;2896;903;2518;17;71;671;1801;688;1872
241200;202003;18828;49539;16173;45219;2564;7172;9438;26476;12002;33648
241210;202003;1395;3749;997;2941;120;383;569;1631;689;2014
241220;202003;8579;25423;7431;23450;1719;5354;3530;11638;5249;16992
241230;202003;2895;7610;2554;7079;102;328;2125;5815;2227;6143
241240;202003;1161;3269;704;2232;57;193;322;1028;379;1221
241250;202003;5317;15487;4251;13463;164;764;3088;9402;3252;10166
241255;202003;2154;6799;1887;6228;106;442;1407;4543;1513;4985
241260;202003;4771;12535;3733;10791;77;333;2976;8411;3053;8744
241270;202003;1724;4972;1423;4389;106;368;1019;3125;1125;3493
241280;202003;2149;5414;1841;4851;60;163;1561;4045;1621;4208
241290;202003;3380;8288;2517;6873;72;245;1994;5295;2066;5540
241300;202003;1421;3809;1130;3277;33;114;784;2216;817;2330
241310;202003;2071;5233;1772;4807;15;63;1508;4128;1523;4191
241320;202003;936;3035;797;2767;86;363;519;1783;605;2146
241330;202003;1719;4519;1346;4024;15;78;1167;3472;1182;3550
241335;202003;3214;8965;2841;8279;103;347;2349;6764;2452;7111
241340;202003;1535;4347;1182;3601;253;805;490;1452;743;2257
241350;202003;2042;5886;1790;5431;90;311;1376;4114;1466;4425
241355;202003;1264;3440;1036;2997;14;43;820;2364;834;2407
241360;202003;2034;5268;1520;4212;44;136;1102;2941;1146;3077
241370;202003;1339;3703;1033;3061;48;168;720;2036;768;2204
241380;202003;611;1734;476;1464;76;202;246;777;322;979
241390;202003;2695;7930;2394;7482;185;522;1859;5901;2044;6423
241400;202003;3485;9733;3100;9129;154;499;2520;7373;2674;7872
241410;202003;2359;7028;1909;6093;336;1095;972;3109;1308;4204
241415;202003;1653;4873;1350;4279;61;228;948;2951;1009;3179
241420;202003;2165;6929;1850;6383;435;1665;919;3151;1354;4816
241430;202003;597;1652;408;1220;18;59;256;739;274;798
241440;202003;7335;22754;6545;21365;345;1299;5217;16896;5562;18195
241445;202003;1091;2805;963;2637;21;53;866;2426;887;2479
241450;202003;2560;6415;2203;5829;377;838;1453;3984;1830;4822
241460;202003;3696;10040;2987;8520;187;578;2117;5893;2304;6471
241470;202003;1396;3687;1132;3298;24;89;943;2755;967;2844
241475;202003;1178;3321;924;2825;22;110;664;1945;686;2055
241480;202003;2873;8991;2362;7870;711;2328;803;2968;1514;5296
241490;202003;616;1472;505;1322;22;59;362;929;384;988
241500;202003;788;2270;699;2156;3;10;645;2011;648;2021
250010;202003;2520;7542;2088;6652;59;239;1521;4737;1580;4976
250020;202003;1587;4291;1133;3393;30;71;819;2435;849;2506
250030;202003;6827;18739;6011;17446;500;1495;4500;12915;5000;14410
250040;202003;3990;12234;3441;11214;229;855;2492;7986;2721;8841
250050;202003;3595;9699;3243;9217;120;431;2645;7530;2765;7961
250053;202003;1143;3212;1033;3036;70;217;759;2230;829;2447
250057;202003;648;2335;604;2269;9;42;539;2065;548;2107
250060;202003;5456;14228;4898;13538;290;781;4038;11225;4328;12006
250070;202003;3949;11024;3347;9959;36;153;2698;7857;2734;8010
250073;202003;756;2015;615;1797;11;36;504;1432;515;1468
250077;202003;2194;5907;1643;4992;63;220;1241;3746;1304;3966
250080;202003;4840;12095;4100;11140;63;285;3581;9592;3644;9877
250090;202003;3315;8111;2890;7540;55;161;2492;6383;2547;6544
250100;202003;3615;11016;3253;10325;163;588;2556;7958;2719;8546
250110;202003;4878;13658;4383;12929;258;960;3420;9870;3678;10830
250115;202003;674;1773;486;1484;8;44;338;1027;346;1071
250120;202003;1819;5336;1524;4846;30;142;1204;3801;1234;3943
250130;202003;5444;14976;4585;13756;69;371;3885;11495;3954;11866
250135;202003;1140;3184;1009;2965;26;104;887;2579;913;2683
250140;202003;2235;6546;2071;6337;106;449;1775;5360;1881;5809
250150;202003;4796;14929;4299;14070;135;622;3466;11146;3601;11768
250153;202003;1400;3688;1173;3345;30;85;947;2679;977;2764
250157;202003;1689;5042;1531;4738;56;240;1220;3718;1276;3958
250160;202003;3904;9716;3115;8646;38;143;2749;7628;2787;7771
250170;202003;1836;4702;1638;4420;24;95;1433;3820;1457;3915
250180;202003;20061;48433;17069;44588;737;2320;13315;33899;14052;36219
250190;202003;4032;10782;3359;9765;319;972;2318;6570;2637;7542
250200;202003;1915;5121;1626;4711;57;185;1373;3973;1430;4158
250205;202003;857;2645;740;2456;15;68;622;2044;637;2112
250210;202003;1530;4655;1380;4411;71;317;1075;3377;1146;3694
250215;202003;1512;4178;1262;3818;75;252;763;2314;838;2566
250220;202003;661;1844;532;1648;28;106;354;1065;382;1171
250230;202003;1648;3703;1105;2872;17;61;913;2284;930;2345
250240;202003;2289;6962;2005;6435;40;196;1665;5261;1705;5457
250250;202003;4555;12635;3960;11756;83;294;3385;10053;3468;10347
250260;202003;1683;4706;1396;4212;44;126;1106;3309;1150;3435
250270;202003;1189;3591;1070;3443;64;223;799;2664;863;2887
250280;202003;3261;9121;2906;8586;104;310;2326;6861;2430;7171
250290;202003;1581;4180;1342;3836;23;71;1054;3022;1077;3093
250300;202003;5491;14613;4925;13955;181;815;4108;11224;4289;12039
250310;202003;1126;3096;927;2762;37;121;720;2116;757;2237
250320;202003;11641;26360;9959;24428;260;738;8858;21436;9118;22174
250330;202003;2338;6544;1951;6006;100;335;1570;4813;1670;5148
250340;202003;1069;2739;955;2590;10;27;878;2371;888;2398
250350;202003;4085;11398;3606;10593;189;469;2827;8553;3016;9022
250355;202003;1952;5899;1745;5612;27;147;1565;5000;1592;5147
250360;202003;1741;4825;1549;4565;38;150;1299;3798;1337;3948
250370;202003;13156;34221;10815;30664;236;902;9048;25298;9284;26200
250375;202003;1175;3079;941;2793;5;17;886;2657;891;2674
250380;202003;1602;4135;1467;3963;26;119;1290;3370;1316;3489
250390;202003;1829;4681;1524;4188;87;241;1207;3291;1294;3532
250400;202003;68404;168163;49801;138952;13748;40882;14633;43138;28381;84020
250403;202003;1717;4801;1531;4579;70;356;1183;3379;1253;3735
250407;202003;1176;2986;944;2634;61;134;692;1960;753;2094
250410;202003;629;1700;545;1555;5;10;451;1264;456;1274
250415;202003;1832;5172;1602;4799;34;153;1379;4108;1413;4261
250420;202003;1171;3330;1066;3187;24;95;951;2824;975;2919
250430;202003;6238;15277;5259;13960;134;427;4356;11315;4490;11742
250435;202003;1525;4248;1226;3724;11;54;945;2831;956;2885
250440;202003;4561;12053;3901;11221;68;192;3461;9956;3529;10148
250450;202003;1795;4784;1467;4332;27;99;1223;3624;1250;3723
250460;202003;7270;19692;6429;18443;319;984;5202;14836;5521;15820
250470;202003;1533;3955;1264;3536;50;156;985;2707;1035;2863
250480;202003;4032;10868;3418;10133;42;150;3022;9029;3064;9179
250485;202003;697;1601;507;1324;33;61;373;941;406;1002
250490;202003;5159;12246;4575;11575;171;517;4043;10042;4214;10559
250500;202003;1969;5456;1741;5057;71;236;1418;4109;1489;4345
250510;202003;5424;13648;4641;12604;73;197;4063;11139;4136;11336
250520;202003;1814;4916;1551;4539;124;398;1101;3198;1225;3596
250523;202003;2222;5471;1965;5146;67;293;1655;4171;1722;4464
250527;202003;1662;4299;1493;4107;23;74;1318;3654;1341;3728
250530;202003;620;1602;525;1472;5;11;463;1297;468;1308
250535;202003;1344;3939;1210;3679;26;112;993;2924;1019;3036
250540;202003;2930;6737;2437;6185;66;127;2142;5525;2208;5652
250550;202003;765;2455;667;2262;21;84;498;1661;519;1745
250560;202003;1697;4683;1492;4382;37;142;1256;3610;1293;3752
250570;202003;2620;7877;2245;7194;78;309;1771;5578;1849;5887
250580;202003;1045;2708;918;2528;45;174;771;2075;816;2249
250590;202003;813;2271;722;2139;19;69;592;1762;611;1831
250600;202003;8125;20784;6775;19035;237;764;5621;15660;5858;16424
250610;202003;2960;8282;2644;7819;117;440;2204;6436;2321;6876
250620;202003;764;2030;648;1830;10;35;482;1334;492;1369
250625;202003;2480;7158;2209;6706;41;221;1876;5529;1917;5750
250630;202003;10030;27802;8083;24364;854;2624;5158;15240;6012;17864
250640;202003;3346;9234;3016;8812;74;338;2610;7468;2684;7806
250650;202003;927;2231;781;2033;13;37;685;1768;698;1805
250660;202003;1608;3991;1300;3569;40;112;1071;2873;1111;2985
250670;202003;2300;7215;2091;6838;43;196;1817;5835;1860;6031
250680;202003;5780;13328;5152;12618;59;225;4772;11537;4831;11762
250690;202003;6769;15257;5740;13973;92;234;5102;12306;5194;12540
250700;202003;4256;11944;3703;11097;423;1253;2594;7745;3017;8998
250710;202003;4402;12579;3775;11718;275;950;2760;8561;3035;9511
250720;202003;2711;7251;2429;6851;35;175;2134;5948;2169;6123
250730;202003;4101;10884;3576;10192;100;412;2997;8304;3097;8716
250740;202003;1905;4786;1580;4353;88;216;1229;3397;1317;3613
250750;202003;103452;254217;87171;231360;6988;20169;63108;164337;70096;184506
250760;202003;2343;6063;2047;5584;85;258;1628;4313;1713;4571
250770;202003;3988;12027;3571;11469;377;1191;2579;8369;2956;9560
250780;202003;1719;4634;1430;4102;49;175;1113;3108;1162;3283
250790;202003;2443;7256;2105;6741;138;551;1422;4437;1560;4988
250800;202003;2441;6485;2120;5967;86;184;1717;4872;1803;5056
250810;202003;1223;3302;1000;2979;17;45;856;2572;873;2617
250820;202003;1961;5494;1807;5324;32;139;1651;4840;1683;4979
250830;202003;5784;17299;4757;15222;256;1000;3290;10213;3546;11213
250840;202003;759;2396;649;2177;14;56;490;1651;504;1707
250850;202003;1756;5274;1569;4940;32;161;1297;3977;1329;4138
250855;202003;939;2774;815;2555;58;198;612;1904;670;2102
250860;202003;3141;9286;2594;8351;443;1504;1512;4867;1955;6371
250870;202003;1021;2820;858;2544;31;118;706;2068;737;2186
250880;202003;1594;4078;1306;3664;77;220;1000;2805;1077;3025
250890;202003;9951;26119;8788;24536;399;1733;7003;18576;7402;20309
250900;202003;2768;7738;2390;7049;60;230;2022;5842;2082;6072
250905;202003;2378;6756;2182;6470;45;173;1983;5879;2028;6052
250910;202003;5882;14663;4835;13477;82;290;4210;11789;4292;12079
250915;202003;2156;5009;1500;4301;24;53;1307;3835;1331;3888
250920;202003;3497;8800;3064;8138;328;747;2249;6013;2577;6760
250930;202003;2229;5965;2012;5682;50;210;1751;4851;1801;5061
250933;202003;1148;3421;1012;3171;22;116;781;2370;803;2486
250937;202003;694;1866;567;1655;21;66;434;1289;455;1355
250939;202003;1743;4655;1513;4351;65;201;1181;3381;1246;3582
250940;202003;3929;10601;3443;9963;17;61;3055;8857;3072;8918
250950;202003;1685;4290;1355;3872;24;105;1123;3165;1147;3270
250960;202003;1126;3276;985;3052;27;142;798;2382;825;2524
250970;202003;8272;21184;7225;19502;223;688;5994;15875;6217;16563
250980;202003;2416;6396;2162;6016;34;142;1861;5046;1895;5188
250990;202003;2011;6113;1670;5511;52;259;1232;4012;1284;4271
251000;202003;2024;5728;1638;5056;37;161;1334;4091;1371;4252
251010;202003;2612;7380;2358;6993;19;88;2150;6372;2169;6460
251020;202003;1629;4430;1456;4155;31;143;1265;3534;1296;3677
251030;202003;993;2637;810;2299;32;91;573;1607;605;1698
251040;202003;1803;5117;1521;4640;38;189;1229;3718;1267;3907
251050;202003;1047;2851;879;2527;47;156;629;1744;676;1900
251060;202003;1057;2276;798;1950;6;21;640;1533;646;1554
251065;202003;476;1298;368;1097;11;33;251;729;262;762
251070;202003;726;1874;617;1713;11;44;530;1444;541;1488
251080;202003;18378;47080;14927;41853;1788;5223;9719;27319;11507;32542
251090;202003;2769;7960;2325;7163;54;197;1860;5687;1914;5884
251100;202003;789;2519;704;2356;25;99;541;1739;566;1838
251110;202003;1693;4530;1436;4084;46;124;1092;3089;1138;3213
251120;202003;7194;20227;6048;18818;255;993;4818;14938;5073;15931
251130;202003;3862;8662;3403;8151;59;166;3080;7340;3139;7506
251140;202003;4213;11749;3772;11127;72;302;3169;9230;3241;9532
251150;202003;2625;7647;2356;7213;99;414;1929;5778;2028;6192
251160;202003;2117;6201;1832;5785;39;183;1576;4888;1615;5071
251170;202003;1554;4234;1350;3965;34;120;1164;3403;1198;3523
251180;202003;2629;7020;2149;6338;169;501;1462;4294;1631;4795
251190;202003;4383;11391;3989;10946;42;240;3625;9744;3667;9984
251200;202003;4320;12662;3802;11991;75;319;3348;10592;3423;10911
251203;202003;934;3031;860;2870;23;106;654;2122;677;2228
251207;202003;1073;2940;829;2531;19;100;580;1727;599;1827
251210;202003;7386;18967;6003;17083;252;610;4592;13351;4844;13961
251220;202003;1160;2821;912;2491;48;115;710;1978;758;2093
251230;202003;4591;12734;3950;11626;117;438;3118;8942;3235;9380
251240;202003;3561;9791;2999;8848;135;396;2288;6620;2423;7016
251250;202003;10208;27482;8929;25324;720;2166;6609;18174;7329;20340
251260;202003;476;1364;433;1297;12;62;347;1005;359;1067
251270;202003;4235;13193;3807;12624;109;453;3114;10542;3223;10995
251272;202003;1335;3613;1203;3439;43;160;1010;2817;1053;2977
251274;202003;895;2479;714;2149;63;209;474;1359;537;1568
251275;202003;1204;3361;1029;3080;30;139;809;2345;839;2484
251276;202003;1304;3547;1136;3323;31;161;926;2608;957;2769
251278;202003;564;1565;502;1473;38;95;373;1124;411;1219
251280;202003;2217;6033;1977;5660;51;178;1658;4680;1709;4858
251290;202003;5887;13907;5312;13202;145;495;4648;11183;4793;11678
251300;202003;845;2499;762;2373;8;41;650;2021;658;2062
251310;202003;2688;7745;2339;7196;49;260;1877;5626;1926;5886
251315;202003;1681;5245;1536;4981;85;257;1160;3719;1245;3976
251320;202003;1584;4211;1125;3417;32;110;843;2520;875;2630
251330;202003;2082;4850;1703;4404;20;75;1542;4015;1562;4090
251335;202003;1036;3078;921;2896;22;96;802;2466;824;2562
251340;202003;3639;8827;2905;7843;111;343;2227;5970;2338;6313
251350;202003;1052;3051;943;2870;26;110;778;2319;804;2429
251360;202003;1793;5054;1445;4568;21;100;1231;3898;1252;3998
251365;202003;711;1937;561;1638;5;19;442;1276;447;1295
251370;202003;23020;61034;19658;56215;2370;6977;12459;36137;14829;43114
251380;202003;1199;3387;1047;3129;20;114;877;2542;897;2656
251385;202003;742;1912;568;1591;17;47;423;1146;440;1193
251390;202003;6370;18518;5608;17313;457;1477;3734;11558;4191;13035
251392;202003;947;2587;789;2352;23;103;617;1799;640;1902
251394;202003;600;1748;492;1556;18;80;370;1149;388;1229
251396;202003;660;1773;568;1618;14;41;402;1121;416;1162
251398;202003;922;2332;654;1878;13;54;488;1369;501;1423
251400;202003;1195;2945;960;2626;27;97;763;2019;790;2116
251410;202003;1444;3443;1185;3073;17;73;1016;2541;1033;2614
251420;202003;1885;4989;1525;4569;38;148;1207;3582;1245;3730
251430;202003;1515;4656;1359;4383;28;128;1174;3790;1202;3918
251440;202003;1097;3080;885;2682;36;101;701;2137;737;2238
251445;202003;1503;4239;1385;4077;27;114;1178;3404;1205;3518
251450;202003;4462;13062;3948;12295;83;333;3287;10143;3370;10476
251455;202003;842;2567;766;2434;22;100;606;1883;628;1983
251460;202003;872;2527;763;2356;16;59;637;1969;653;2028
251465;202003;430;1268;367;1153;5;20;279;861;284;881
251470;202003;1156;3205;864;2594;67;222;503;1439;570;1661
251480;202003;982;2594;800;2265;19;80;614;1653;633;1733
251490;202003;1874;4930;1483;4384;54;174;1103;3261;1157;3435
251500;202003;1925;5430;1765;5219;27;102;1606;4747;1633;4849
251510;202003;2643;7902;2181;6973;107;403;1483;4628;1590;5031
251520;202003;960;2529;728;2095;61;174;475;1331;536;1505
251530;202003;14626;35097;11727;31471;104;585;10377;27337;10481;27922
251540;202003;2888;8426;2602;7882;83;301;2146;6405;2229;6706
251550;202003;3696;8828;2946;7892;100;210;2460;6642;2560;6852
251560;202003;541;1641;473;1534;59;208;326;1021;385;1229
251570;202003;929;2621;752;2268;19;88;596;1739;615;1827
251580;202003;1874;4434;1669;4134;37;155;1459;3469;1496;3624
251590;202003;1554;3883;1305;3590;52;141;1085;2934;1137;3075
251593;202003;893;2604;797;2449;80;258;520;1567;600;1825
251597;202003;2095;5891;1887;5616;20;99;1674;4916;1694;5015
251600;202003;6378;17203;5577;15975;163;534;4621;13036;4784;13570
251610;202003;3209;9111;2747;8244;246;681;1906;5825;2152;6506
251615;202003;1222;3069;984;2706;22;59;794;2126;816;2185
251620;202003;18613;43301;14311;38014;112;377;12191;32914;12303;33291
251630;202003;4692;11060;3773;9794;197;521;2846;7334;3043;7855
251640;202003;2118;5793;1875;5411;28;136;1631;4592;1659;4728
251650;202003;3911;10551;3421;9895;117;379;2920;8428;3037;8807
251660;202003;3447;10351;3030;9613;75;352;2528;7883;2603;8235
251670;202003;3933;11211;3502;10594;49;248;3121;9351;3170;9599
251675;202003;641;1837;578;1759;75;229;383;1180;458;1409
251680;202003;2486;6603;2066;6059;44;146;1667;4934;1711;5080
251690;202003;3096;8676;2607;7822;89;270;1952;5802;2041;6072
251700;202003;2050;5872;1722;5457;41;194;1466;4563;1507;4757
251710;202003;779;2021;527;1505;40;140;311;856;351;996
251720;202003;1289;3650;1036;3207;21;95;795;2390;816;2485
251740;202003;610;1713;491;1487;43;154;327;951;370;1105
260005;202003;29515;62258;24231;55474;1588;3598;18763;42162;20351;45760
260010;202003;10129;26606;8340;23695;447;1357;4986;14209;5433;15566
260020;202003;6699;15820;5728;14425;107;491;4838;11968;4945;12459
260030;202003;6687;17198;5623;15660;140;436;4562;12648;4702;13084
260040;202003;7549;19650;6294;17808;438;1195;4425;12754;4863;13949
260050;202003;13795;35930;11414;33294;147;687;10495;30606;10642;31293
260060;202003;3970;9943;3405;9023;191;467;2692;7147;2883;7614
260070;202003;10430;26280;8896;24061;329;1151;7142;18810;7471;19961
260080;202003;6457;14749;5662;13687;115;376;4764;11295;4879;11671
260090;202003;4634;11952;4102;11218;456;1273;2905;7951;3361;9224
260100;202003;2990;8092;2492;7357;54;273;2047;5935;2101;6208
260105;202003;4948;13524;4421;12824;127;450;3725;10677;3852;11127
260110;202003;22138;61222;19657;57615;930;3185;16199;46825;17129;50010
260120;202003;14305;38133;11975;34628;1417;4046;7659;22495;9076;26541
260130;202003;3038;7846;2716;7375;228;625;2002;5360;2230;5985
260140;202003;12826;29145;11031;26998;538;1478;9257;22307;9795;23785
260150;202003;3583;8299;3068;7663;82;246;2701;6679;2783;6925
260160;202003;6415;16893;5422;15682;84;317;4874;14237;4958;14554
260170;202003;19407;46507;16392;42409;877;2300;13068;33421;13945;35721
260180;202003;3457;9246;2993;8614;72;264;2569;7282;2641;7546
260190;202003;18116;36391;15210;32968;158;427;13502;28709;13660;29136
260200;202003;11074;26531;9512;24537;435;995;7961;20817;8396;21812
260210;202003;11772;33256;9955;30278;317;1218;7927;23947;8244;25165
260220;202003;10214;24714;9432;23724;165;555;8323;20618;8488;21173
260230;202003;10638;26138;9266;24307;193;645;7824;20159;8017;20804
260240;202003;2643;7949;2310;7308;109;386;1789;5605;1898;5991
260250;202003;2153;5712;1874;5274;118;273;1431;4029;1549;4302
260260;202003;12837;33403;11400;31183;367;1244;9054;24253;9421;25497
260270;202003;4180;10159;3667;9536;135;500;3057;7794;3192;8294
260280;202003;12643;38135;11326;36268;449;1946;9644;30441;10093;32387
260290;202003;39932;101237;34275;93029;3665;10147;23291;63037;26956;73184
260300;202003;9549;25833;8271;24096;192;868;6958;20208;7150;21076
260310;202003;5040;13013;4427;12219;291;770;3444;9628;3735;10398
260320;202003;7617;21911;6428;19887;255;823;5237;16210;5492;17033
260330;202003;2529;7770;2216;7135;65;250;1764;5528;1829;5778
260340;202003;2025;5401;1745;4982;28;122;1495;4182;1523;4304
260345;202003;24776;64362;20637;58304;3033;9174;10982;30509;14015;39683
260350;202003;5434;12932;4711;12086;69;203;4174;10663;4243;10866
260360;202003;2500;6520;2255;6074;43;197;1584;4156;1627;4353
260370;202003;5508;15791;4737;14488;232;812;3654;11077;3886;11889
260380;202003;4887;14502;4167;13318;144;530;3137;9886;3281;10416
260390;202003;4451;13319;3693;11760;207;654;2498;7808;2705;8462
260392;202003;3297;10641;2963;10212;119;704;2385;8224;2504;8928
260400;202003;17511;40799;15062;37583;474;1354;11827;28455;12301;29809
260410;202003;71937;174783;55533;151755;9805;28141;25089;70664;34894;98805
260415;202003;4481;12109;3869;11088;64;267;3166;8929;3230;9196
260420;202003;12598;26235;10668;24092;105;302;9877;22094;9982;22396
260430;202003;2695;8433;2317;7678;101;411;1659;5446;1760;5857
260440;202003;3662;9562;3224;8875;65;240;2709;7326;2774;7566
260450;202003;5691;14362;5089;13597;288;598;4191;11408;4479;12006
260460;202003;5180;15408;4406;14038;480;1700;2634;8245;3114;9945
260470;202003;4886;12967;4126;12081;81;203;3776;11214;3857;11417
260480;202003;3952;10522;3310;9597;212;775;2301;6671;2513;7446
260490;202003;5313;12222;4697;11314;35;142;4273;10107;4308;10249
260500;202003;6066;15245;5193;14014;451;1147;3656;9993;4107;11140
260510;202003;9617;23838;8037;21635;111;447;7096;18934;7207;19381
260515;202003;4139;11341;3218;9584;142;429;2165;6278;2307;6707
260520;202003;17070;39442;14881;36630;763;1847;12118;29447;12881;31294
260530;202003;9693;27747;8250;25511;150;728;7069;21552;7219;22280
260540;202003;7160;15503;6302;14411;152;352;5651;12833;5803;13185
260545;202003;52;160;22;81;2;7;8;23;10;30
260550;202003;3019;8385;2473;7488;113;467;1665;4930;1778;5397
260560;202003;5870;15059;4959;13752;124;496;4180;11349;4304;11845
260570;202003;7701;20917;6762;19641;379;1207;5323;15507;5702;16714
260580;202003;4435;10567;3985;9971;19;72;3669;9158;3688;9230
260590;202003;6665;15512;5602;14323;219;530;4672;12084;4891;12614
260600;202003;30560;79145;24740;70164;1092;3470;18683;52097;19775;55567
260610;202003;7201;18578;6442;17589;391;1151;4840;13119;5231;14270
260620;202003;16148;41931;14050;38893;1257;3930;10173;27592;11430;31522
260630;202003;2370;6401;1932;5699;34;144;1561;4505;1595;4649
260640;202003;21233;48187;17736;44163;827;2040;14238;35292;15065;37332
260650;202003;5989;15740;4744;14217;147;594;4065;12088;4212;12682
260660;202003;7001;18530;6041;17245;146;659;5177;14444;5323;15103
260670;202003;2147;5642;1802;5116;72;176;1337;3753;1409;3929
260680;202003;27775;66240;23273;59814;1617;4431;16432;41434;18049;45865
260690;202003;3469;9060;2887;8154;91;358;2263;6343;2354;6701
260700;202003;6054;17560;5669;17114;23;86;5484;16671;5507;16757
260710;202003;1334;3530;1152;3271;35;133;902;2558;937;2691
260720;202003;22396;56697;19577;52809;1861;5165;14264;38110;16125;43275
260730;202003;7528;21775;6574;20433;261;1003;5469;16721;5730;17724
260740;202003;1312;3724;1107;3393;11;62;885;2780;896;2842
260750;202003;6977;19267;5827;17818;109;365;5212;16180;5321;16545
260760;202003;5619;13309;4818;12358;184;528;3958;10178;4142;10706
260765;202003;7932;22881;6883;21433;409;1733;4881;14850;5290;16583
260770;202003;3803;9709;3171;8661;108;352;2495;6718;2603;7070
260775;202003;5198;13821;4558;12847;188;694;3548;9657;3736;10351
260780;202003;3577;10615;3179;9972;278;1043;2052;6228;2330;7271
260790;202003;118594;264907;97846;237804;14797;34836;60554;147691;75351;182527
260795;202003;2971;7635;2542;7066;81;279;1985;5560;2066;5839
260800;202003;5359;12441;4775;11640;121;381;4185;9873;4306;10254
260805;202003;3590;10178;3017;9159;161;572;2258;6739;2419;7311
260810;202003;6450;17468;5656;15931;464;1245;4084;11278;4548;12523
260820;202003;4408;10306;3886;9687;100;358;3245;7953;3345;8311
260825;202003;2893;8628;2513;7967;106;380;1875;5869;1981;6249
260830;202003;4194;12173;3477;10859;446;1215;2219;7161;2665;8376
260840;202003;4143;10844;3694;10221;198;522;3069;8516;3267;9038
260845;202003;4259;11284;3789;10470;225;624;2841;7758;3066;8382
260850;202003;4949;13603;4112;11982;329;1033;2678;7545;3007;8578
260860;202003;3476;9809;2939;8874;99;355;2349;6910;2448;7265
260870;202003;4531;10888;3860;10062;70;266;3440;8839;3510;9105
260875;202003;6955;17187;5700;15334;566;1532;3871;10481;4437;12013
260880;202003;9707;27153;8400;24878;484;1461;6587;19471;7071;20932
260890;202003;12985;33305;11242;30641;596;1747;8212;21830;8808;23577
260900;202003;5368;14921;4400;13538;318;1043;2922;8961;3240;10004
260910;202003;3166;8622;2735;7961;86;283;2157;6232;2243;6515
260915;202003;5137;15076;4501;14336;50;268;4114;13096;4164;13364
260920;202003;3242;8085;2722;7522;84;237;2326;6478;2410;6715
260930;202003;3715;11662;3155;10656;176;715;2334;7697;2510;8412
260940;202003;14526;34694;12635;32059;956;2383;9524;23833;10480;26216
260950;202003;6794;18177;5471;15889;358;1218;3510;9756;3868;10974
260960;202003;69328;154763;55488;136913;6066;15445;35338;86072;41404;101517
260970;202003;5451;14446;4851;13634;225;519;3687;10478;3912;10997
260980;202003;4490;13146;3959;12474;53;199;3611;11478;3664;11677
260990;202003;17800;49252;15006;45444;841;2839;11647;34956;12488;37795
261000;202003;16111;37940;13497;34601;367;1331;10913;27292;11280;28623
261010;202003;2375;6207;2075;5810;73;192;1805;5079;1878;5271
261020;202003;6108;16569;5233;15056;186;697;4233;11694;4419;12391
261030;202003;4003;11541;3470;10628;127;530;2756;8191;2883;8721
261040;202003;5190;15159;4172;13204;149;602;3116;9629;3265;10231
261050;202003;7681;20071;6969;18948;440;892;5291;14495;5731;15387
261060;202003;14093;35211;12239;32956;268;879;10195;27186;10463;28065
261070;202003;63356;137905;52367;123406;2651;6257;40181;92635;42832;98892
261080;202003;6626;15971;6037;15228;130;329;5553;13982;5683;14311
261090;202003;18690;44657;16586;41931;283;1004;14485;36014;14768;37018
261100;202003;8258;22911;7148;21265;494;1592;5210;15502;5704;17094
261110;202003;63187;176695;52624;157665;7624;24002;30465;90590;38089;114592
261120;202003;3692;9222;3177;8521;87;225;2738;7360;2825;7585
261130;202003;7287;17794;6387;16572;117;356;5657;14567;5774;14923
261140;202003;3630;8373;3223;7829;167;428;2579;6161;2746;6589
261150;202003;5299;13806;4676;12869;71;268;4072;11082;4143;11350
261153;202003;1875;5659;1597;5113;56;202;1090;3504;1146;3706
261160;202003;207350;481598;167042;425482;40558;106490;69450;180044;110008;286534
261170;202003;5985;14924;5313;13916;317;759;4236;11034;4553;11793
261180;202003;9518;23684;8313;22091;436;1155;6055;16137;6491;17292
261190;202003;4483;13179;3995;12361;193;829;3107;9310;3300;10139
261200;202003;3336;7701;2974;7214;127;334;2500;5949;2627;6283
261210;202003;1892;4564;1600;4151;59;176;1347;3427;1406;3603
261220;202003;13713;38675;11345;34271;1422;4670;6472;19226;7894;23896
261230;202003;4023;11543;3362;10620;54;220;2797;8909;2851;9129
261240;202003;5274;13220;4620;12189;246;656;3814;9925;4060;10581
261245;202003;3545;10050;2982;9053;74;355;2371;6971;2445;7326
261247;202003;2854;8562;2363;7679;141;510;1631;5270;1772;5780
261250;202003;22069;50526;19069;47015;1673;3713;14505;36669;16178;40382
261255;202003;4058;11936;3284;10425;138;611;2407;7397;2545;8008
261260;202003;12617;34049;10885;31786;340;1413;9365;26953;9705;28366
261270;202003;4365;10858;3811;10145;184;537;3165;8286;3349;8823
261280;202003;2542;7060;2231;6532;69;255;1781;5077;1850;5332
261290;202003;2942;7586;2464;7036;68;281;1994;5738;2062;6019
261300;202003;12090;33977;10172;30662;573;2060;7365;21756;7938;23816
261310;202003;8741;22217;7436;20434;626;1938;5447;14594;6073;16532
261320;202003;5895;16721;5134;15462;82;364;4310;12784;4392;13148
261330;202003;5823;14257;5242;13496;123;448;4560;11511;4683;11959
261340;202003;4160;11725;3585;10976;137;506;2936;8910;3073;9416
261350;202003;8767;25521;7779;23869;119;559;6356;19217;6475;19776
261360;202003;8144;19617;6886;17836;235;690;5491;13834;5726;14524
261370;202003;23354;58360;19616;53162;2099;5624;12695;34631;14794;40255
261380;202003;4025;12177;3546;11329;442;1493;2326;7326;2768;8819
261390;202003;16295;46306;13688;42067;1148;3869;9108;27776;10256;31645
261400;202003;4592;14569;3978;13247;162;738;2990;9701;3152;10439
261410;202003;9421;23536;7721;20897;479;1356;6030;15987;6509;17343
261420;202003;7319;21899;6581;20989;777;2878;4619;14634;5396;17512
261430;202003;3410;9605;2860;8737;60;259;2373;7142;2433;7401
261440;202003;1463;4347;1220;3872;37;183;875;2644;912;2827
261450;202003;14899;40240;13155;37519;189;702;10898;31126;11087;31828
261460;202003;7452;20619;6594;19268;197;705;5385;15606;5582;16311
261470;202003;4166;10370;3630;9666;24;126;3131;8305;3155;8431
261480;202003;5020;15397;4317;14210;189;792;3343;10754;3532;11546
261485;202003;4936;14024;4245;12940;336;1107;3029;9089;3365;10196
261500;202003;5856;14992;5122;13993;375;907;3571;10138;3946;11045
261510;202003;1854;5547;1602;5128;60;228;1201;3894;1261;4122
261520;202003;2333;7165;2095;6670;69;251;1532;4860;1601;5111
261530;202003;11822;34648;9555;30442;921;3532;4808;14708;5729;18240
261540;202003;8130;23221;7298;22014;1056;3154;4163;13232;5219;16386
261550;202003;3622;9612;3126;8833;215;663;2243;6204;2458;6867
261560;202003;7785;23061;6725;21480;283;1080;5172;16525;5455;17605
261570;202003;3490;9349;2782;8211;196;688;1914;5534;2110;6222
261580;202003;6625;17485;5720;16261;110;536;5120;14341;5230;14877
261590;202003;2657;6803;2118;6035;69;225;1601;4525;1670;4750
261600;202003;5058;12830;4242;11591;308;747;2955;8316;3263;9063
261610;202003;2175;6126;1753;5368;89;335;1203;3645;1292;3980
261618;202003;2504;6260;2177;5781;54;166;1780;4682;1834;4848
261620;202003;4144;11624;3779;11093;844;2193;2337;7252;3181;9445
261630;202003;6302;17636;5331;15795;360;1278;3580;10182;3940;11460
261640;202003;37311;83517;31682;76531;1769;3440;23989;59648;25758;63088
261650;202003;4125;10203;3512;9386;151;483;2643;6998;2794;7481
270010;202003;4272;14342;3666;13297;166;940;2905;10236;3071;11176
270020;202003;3838;9642;3346;9004;130;445;2854;7507;2984;7952
270030;202003;32971;89335;27411;80406;3576;10225;18208;53597;21784;63822
270040;202003;10796;29034;9256;27218;365;1413;7679;22360;8044;23773
270050;202003;5510;12749;4690;11823;212;519;4110;10398;4322;10917
270060;202003;2075;5274;1716;4871;144;372;1359;3913;1503;4285
270070;202003;4627;13023;4029;12177;145;547;3370;9995;3515;10542
270080;202003;1424;3882;1186;3486;43;132;909;2562;952;2694
270090;202003;1746;5344;1563;4986;64;272;1277;3963;1341;4235
270100;202003;5466;14426;4703;13304;149;580;3910;10846;4059;11426
270110;202003;3206;7532;2578;6800;126;308;2060;5664;2186;5972
270120;202003;2766;7505;2387;6999;70;312;2016;5806;2086;6118
270130;202003;5090;13073;4397;12250;122;393;3794;10585;3916;10978
270135;202003;2004;4819;1695;4477;50;162;1527;4009;1577;4171
270140;202003;9653;22390;7706;19696;309;1075;6093;14825;6402;15900
270150;202003;2684;8077;2457;7749;4;28;2319;7293;2323;7321
270160;202003;6129;16727;5171;15646;55;316;4792;14461;4847;14777
270170;202003;3356;9816;2822;9070;180;860;2142;6592;2322;7452
270180;202003;2211;6844;2011;6585;41;203;1806;5869;1847;6072
270190;202003;1632;4860;1438;4618;38;192;1259;4002;1297;4194
270200;202003;2380;7203;2061;6770;112;427;1514;4932;1626;5359
270210;202003;5722;13474;4870;12521;79;326;4470;11308;4549;11634
270220;202003;1447;3806;1142;3371;195;595;656;1907;851;2502
270230;202003;9165;25521;7534;22980;625;2129;5368;16187;5993;18316
270235;202003;5644;17348;4857;16085;116;531;4004;13119;4120;13650
270240;202003;10468;28802;8411;25922;900;3015;5907;18207;6807;21222
270250;202003;2704;6862;2358;6362;184;485;1853;5002;2037;5487
270255;202003;4432;12673;3430;10833;109;447;2615;8131;2724;8578
270260;202003;5569;16366;5043;15500;100;510;4417;13252;4517;13762
270270;202003;1041;2692;858;2464;101;307;631;1792;732;2099
270280;202003;3938;9341;3106;8294;477;777;2177;6277;2654;7054
270290;202003;7388;23531;6607;22227;180;857;5723;19039;5903;19896
270300;202003;4136;10726;3212;9732;145;395;2509;7780;2654;8175
270310;202003;6908;19329;5925;17808;103;549;5041;14759;5144;15308
270320;202003;5510;16126;4783;14722;447;1428;3365;10107;3812;11535
270330;202003;3826;12531;3396;11868;261;1063;2597;9027;2858;10090
270340;202003;1595;4319;1377;4029;47;148;1167;3370;1214;3518
270350;202003;1817;4353;1488;3961;148;444;1044;2785;1192;3229
270360;202003;2571;6513;2288;6193;67;163;2106;5717;2173;5880
270370;202003;1328;4184;1211;3958;36;173;1006;3237;1042;3410
270375;202003;3080;7211;2551;6627;17;45;2394;6244;2411;6289
270380;202003;5411;15356;4549;14238;620;1901;2930;9533;3550;11434
270390;202003;1205;3027;981;2769;23;93;809;2282;832;2375
270400;202003;6165;16282;5158;14743;232;680;4028;11402;4260;12082
270410;202003;4568;13159;3938;12177;153;545;3266;10054;3419;10599
270420;202003;5474;16221;4911;15396;123;599;4252;13074;4375;13673
270430;202003;133022;315844;104391;279199;20760;57760;49726;135156;70486;192916
270440;202003;4704;12687;4046;11875;88;387;3517;10178;3605;10565
270450;202003;6888;18597;6038;17571;239;858;5091;14845;5330;15703
270460;202003;3791;8366;3257;7735;149;308;2920;6944;3069;7252
270470;202003;10984;30619;9507;28498;653;2172;7310;21877;7963;24049
270480;202003;2923;7773;2462;7109;99;397;2004;5642;2103;6039
270490;202003;939;2608;812;2453;48;161;652;1952;700;2113
270500;202003;4844;14888;4283;13951;290;1105;3324;10672;3614;11777
270510;202003;5564;14705;4681;13581;330;1312;3501;9674;3831;10986
270520;202003;3821;10962;2996;9536;637;2103;1227;4051;1864;6154
270530;202003;1234;3541;1053;3266;49;147;754;2374;803;2521
270540;202003;2183;6323;1876;5927;58;281;1620;5015;1678;5296
270550;202003;6645;17126;5285;15644;567;1372;3980;12238;4547;13610
270560;202003;2929;7646;2524;7102;134;437;2031;5656;2165;6093
270570;202003;4066;11389;3432;10447;110;369;2789;8436;2899;8805
270580;202003;2243;6356;2032;6046;92;278;1760;5192;1852;5470
270590;202003;1591;4801;1464;4637;16;81;1378;4337;1394;4418
270600;202003;2722;8410;2462;8021;48;250;2186;7029;2234;7279
270610;202003;3618;9489;3112;8821;67;258;2786;7818;2853;8076
270620;202003;1200;3699;1091;3481;33;150;933;2885;966;3035
270630;202003;17394;42417;14910;38990;554;1783;12570;32139;13124;33922
270640;202003;5333;15344;4601;14166;160;664;3748;11291;3908;11955
270642;202003;2482;7983;2192;7502;157;684;1687;5629;1844;6313
270644;202003;3584;8934;2935;8086;274;674;2200;6219;2474;6893
270650;202003;3092;9091;2705;8538;358;1224;1896;5919;2254;7143
270660;202003;2011;5104;1666;4608;81;306;1247;3390;1328;3696
270670;202003;16050;37067;13316;33699;391;1216;11331;28052;11722;29268
270680;202003;5388;13013;4782;12350;117;169;4467;11699;4584;11868
270690;202003;8793;21839;7293;19968;536;1411;5649;15502;6185;16913
270700;202003;510;1534;446;1427;31;126;321;1007;352;1133
270710;202003;5410;16323;4784;15359;221;953;3851;12129;4072;13082
270720;202003;3515;10409;3093;9696;64;347;2714;8350;2778;8697
270730;202003;8097;17952;7061;16839;215;437;5582;14719;5797;15156
270740;202003;2343;6128;2058;5789;93;323;1712;4731;1805;5054
270750;202003;5586;14867;4870;13950;88;406;4300;12245;4388;12651
270760;202003;3252;9192;2813;8602;52;269;2386;7206;2438;7475
270770;202003;20429;49771;16224;44649;2503;6234;10215;29647;12718;35881
270780;202003;1690;4907;1551;4705;99;372;1251;3726;1350;4098
270790;202003;1562;4360;1299;3989;98;317;940;2875;1038;3192
270800;202003;10633;29306;9516;27710;332;1226;8163;23380;8495;24606
270810;202003;3279;9376;2574;8170;171;670;1800;5602;1971;6272
270820;202003;1630;4885;1376;4471;52;252;1079;3412;1131;3664
270830;202003;5166;12271;4161;11041;166;551;3377;8813;3543;9364
270840;202003;8142;24286;7238;23000;175;995;6357;19650;6532;20645
270850;202003;8983;21314;7912;20024;627;1835;6542;16240;7169;18075
270860;202003;14063;31357;11098;27949;580;1396;8974;22552;9554;23948
270870;202003;2128;6014;1752;5398;235;707;1145;3611;1380;4318
270880;202003;8036;24030;7143;22681;222;945;5915;18449;6137;19394
270890;202003;2765;7503;2321;6866;177;544;1626;4802;1803;5346
270895;202003;3040;9454;2761;9086;73;400;2432;7836;2505;8236
270900;202003;1796;4626;1353;3907;39;117;1056;3038;1095;3155
270910;202003;3859;11155;3306;10277;93;323;2689;8268;2782;8591
270915;202003;9259;26595;7483;23654;636;2364;5113;15777;5749;18141
270920;202003;5027;15746;4537;14896;163;801;3722;11814;3885;12615
270930;202003;16990;39565;13121;35066;1839;4482;8873;24775;10712;29257
270940;202003;6443;17022;5490;15879;184;892;4467;12540;4651;13432
280010;202003;674;1870;530;1555;16;65;373;981;389;1046
280020;202003;4754;12077;4038;10947;471;1163;2715;7472;3186;8635
280030;202003;73420;172799;57588;150272;12159;32072;25734;69980;37893;102052
280040;202003;2897;8126;2525;7549;253;797;1693;5015;1946;5812
280050;202003;3808;10828;3266;9962;541;1730;1947;5914;2488;7644
280060;202003;5663;14954;4516;13178;847;2590;2148;6524;2995;9114
280067;202003;6785;16857;5759;15317;309;843;4237;11078;4546;11921
280070;202003;1922;5651;1785;5431;127;395;1470;4442;1597;4837
280100;202003;3931;10518;3300;9503;313;933;2272;6529;2585;7462
280110;202003;1379;3736;1202;3473;18;85;1055;2970;1073;3055
280120;202003;7515;21755;6699;20436;730;2085;4912;15325;5642;17410
280130;202003;9064;21237;7922;19605;425;1128;6384;15678;6809;16806
280140;202003;5399;12929;4742;12056;190;568;4039;10149;4229;10717
280150;202003;4148;10475;3586;9703;301;771;2781;7536;3082;8307
280160;202003;1207;3437;1006;3099;94;325;698;2092;792;2417
280170;202003;5179;13638;4623;12904;226;627;3733;10428;3959;11055
280190;202003;1251;2772;1084;2550;55;141;880;2026;935;2167
280200;202003;1254;3289;1026;2962;82;297;754;2128;836;2425
280210;202003;16227;40775;14087;37689;1501;4201;9111;24307;10612;28508
280220;202003;1742;4662;1491;4320;45;215;1228;3520;1273;3735
280230;202003;4202;10606;3536;9625;275;669;2543;6960;2818;7629
280240;202003;3291;8788;2947;8264;53;277;2536;6885;2589;7162
280250;202003;877;2159;709;1904;66;202;470;1218;536;1420
280260;202003;2145;5244;1905;4951;34;97;1731;4537;1765;4634
280270;202003;2315;6385;2043;5962;111;363;1694;4869;1805;5232
280280;202003;4167;12372;3690;11665;473;1288;2603;8618;3076;9906
280290;202003;17917;47396;15340;43743;1327;4059;10300;29580;11627;33639
280300;202003;11614;28520;10110;26897;282;814;7692;22316;7974;23130
280310;202003;1379;3528;1136;3117;34;118;857;2279;891;2397
280320;202003;8563;23093;7432;21392;892;2570;4973;14183;5865;16753
280330;202003;4603;11409;3895;10426;254;704;2875;7640;3129;8344
280340;202003;5406;11351;4508;10382;203;364;3937;9217;4140;9581
280350;202003;25595;60122;22388;55865;1097;2986;17608;43180;18705;46166
280360;202003;5649;15611;4921;14403;743;2218;2919;8639;3662;10857
280370;202003;2111;5244;1764;4666;57;162;1403;3642;1460;3804
280380;202003;963;2600;822;2406;71;206;562;1673;633;1879
280390;202003;3639;8966;3036;8009;132;351;2437;6368;2569;6719
280400;202003;3852;9780;3313;9026;504;1224;2029;5828;2533;7052
280410;202003;2217;6129;1787;5429;198;620;1038;3090;1236;3710
280420;202003;4278;11460;3920;11005;74;288;3598;10031;3672;10319
280430;202003;2045;4960;1781;4614;69;270;1445;3613;1514;3883
280440;202003;4176;11206;3652;10436;143;497;3078;8595;3221;9092
280445;202003;2272;5754;2020;5314;48;149;1533;3867;1581;4016
280450;202003;10218;23538;8933;21807;956;1965;6217;15749;7173;17714
280460;202003;6842;16254;6183;15332;335;811;5267;12913;5602;13724
280470;202003;1680;4759;1445;4337;61;217;1070;3129;1131;3346
280480;202003;42312;102887;36437;94515;2935;8253;25924;65788;28859;74041
280490;202003;3616;10274;3129;9447;89;392;2448;7155;2537;7547
280500;202003;985;2376;843;2185;32;119;709;1799;741;1918
280510;202003;2500;6408;2164;5928;72;282;1687;4499;1759;4781
280520;202003;1583;4056;1384;3782;59;168;1114;2998;1173;3166
280530;202003;2441;6101;2095;5621;289;647;1466;4066;1755;4713
280540;202003;8909;23916;8077;22676;264;919;7056;19527;7320;20446
280550;202003;6558;15295;5370;13613;191;679;4403;10770;4594;11449
280560;202003;7079;19800;6609;19093;134;533;5826;16629;5960;17162
280570;202003;6428;15594;5213;14053;211;668;3932;10510;4143;11178
280580;202003;5553;14870;4788;13719;570;1474;3352;9789;3922;11263
280590;202003;2909;6539;2477;6046;107;399;1970;4609;2077;5008
280600;202003;3565;9425;3135;8817;167;533;2251;6333;2418;6866
280610;202003;2423;5975;2183;5613;140;358;1792;4582;1932;4940
280620;202003;5327;13102;4555;12086;406;894;3202;8861;3608;9755
280630;202003;3769;10627;3443;10161;167;613;2830;8247;2997;8860
280640;202003;2350;6335;2071;6014;60;195;1835;5329;1895;5524
280650;202003;1166;3070;938;2726;85;294;691;1922;776;2216
280660;202003;3682;8085;3149;7449;202;391;2619;6303;2821;6694
280670;202003;19578;44043;16844;40560;900;2281;13475;32207;14375;34488
280680;202003;2764;6616;2360;6049;223;415;1706;4448;1929;4863
280690;202003;911;2280;767;2086;40;107;598;1602;638;1709
280700;202003;1162;2914;1005;2679;25;98;796;2080;821;2178
280710;202003;15176;34239;12804;31544;489;948;10905;27534;11394;28482
280720;202003;2597;5943;2157;5426;61;195;1553;4062;1614;4257
280730;202003;1035;2665;929;2487;39;126;717;1854;756;1980
280740;202003;13978;34115;11877;30900;719;2040;8583;21775;9302;23815
280750;202003;3563;9986;3100;9190;178;615;2227;6468;2405;7083
280760;202003;6301;16873;5478;15587;550;1414;3668;10788;4218;12202
290010;202003;3168;6644;2064;4920;5;20;1686;3840;1691;3860
290020;202003;5371;14266;4858;13603;338;656;4086;11849;4424;12505
290030;202003;4477;10328;3595;9357;155;380;3056;8031;3211;8411
290035;202003;5078;11133;4199;9989;374;576;3308;8244;3682;8820
290040;202003;4166;10225;3539;9462;111;299;2807;7863;2918;8162
290050;202003;2013;6489;1690;5786;116;478;1138;3793;1254;4271
290060;202003;1314;3167;960;2599;75;238;626;1673;701;1911
290070;202003;36794;80423;31521;73855;1729;4237;24575;56947;26304;61184
290080;202003;5299;15497;4531;14342;452;1559;3176;10127;3628;11686
290090;202003;2150;4135;1510;3452;17;60;1376;3114;1393;3174
290100;202003;9759;25459;7884;22633;1290;3472;4275;12880;5565;16352
290110;202003;5217;13730;4618;12789;323;921;3340;9148;3663;10069
290115;202003;3878;11267;3248;10134;207;717;2425;7507;2632;8224
290120;202003;6437;15947;5421;14552;138;476;4635;12225;4773;12701
290130;202003;4722;11416;3675;10054;162;465;2853;7783;3015;8248
290135;202003;4195;9866;3417;8587;193;494;2640;6455;2833;6949
290140;202003;4531;11863;3468;10436;100;375;2917;8721;3017;9096
290150;202003;2437;6306;2098;5882;131;366;1632;4608;1763;4974
290160;202003;3257;7574;2868;7037;293;606;2210;5491;2503;6097
290170;202003;3378;8506;2979;8068;112;307;2658;7263;2770;7570
290180;202003;2942;8067;2430;7228;82;294;1981;5848;2063;6142
290190;202003;4173;11849;3657;11155;142;617;3004;9015;3146;9632
290195;202003;2347;5804;1868;5173;27;136;1576;4324;1603;4460
290200;202003;4088;11352;3315;10064;185;624;2504;7530;2689;8154
290205;202003;3420;8837;3000;8198;123;440;2343;6179;2466;6619
290210;202003;12965;36048;11455;33749;869;2327;8824;26450;9693;28777
290220;202003;2844;7101;2492;6649;120;336;2045;5431;2165;5767
290225;202003;3241;6901;2491;6106;160;285;2069;5179;2229;5464
290230;202003;2437;6441;2215;6173;31;95;2000;5565;2031;5660
290240;202003;3703;9359;2937;8372;70;260;2474;7033;2544;7293
290250;202003;3901;11461;3264;10505;107;375;2695;8786;2802;9161
290260;202003;5245;13098;4339;11774;168;590;3571;9449;3739;10039
290265;202003;3411;10042;2765;8794;171;604;1994;6291;2165;6895
290270;202003;11046;37459;10304;36190;525;2309;8301;28860;8826;31169
290280;202003;5941;17855;5144;16285;281;1024;3734;11650;4015;12674
290290;202003;9852;28676;7941;25128;785;2696;5203;16238;5988;18934
290300;202003;4226;11460;3102;9328;157;518;2225;6658;2382;7176
290310;202003;1576;3887;1248;3485;54;228;966;2615;1020;2843
290320;202003;24110;62896;18947;54924;4170;11908;9019;27551;13189;39459
290323;202003;3781;10262;3277;9477;105;333;2592;7464;2697;7797
290327;202003;4085;11898;3469;10689;245;712;2478;7600;2723;8312
290330;202003;2199;4637;1708;4107;46;83;1510;3687;1556;3770
290340;202003;5691;14263;4373;12630;437;1308;3155;9248;3592;10556
290350;202003;4684;12974;3862;11579;267;817;2780;8380;3047;9197
290360;202003;4989;13176;4372;12364;130;376;3778;10759;3908;11135
290370;202003;5229;12749;3833;10899;156;407;2773;8062;2929;8469
290380;202003;5557;14828;4671;13613;114;284;4016;11930;4130;12214
290390;202003;14515;41084;12014;37147;1280;3889;7857;24717;9137;28606
290395;202003;2812;8173;2256;7193;67;316;1731;5423;1798;5739
290400;202003;3756;10073;2999;8825;80;345;2297;6573;2377;6918
290405;202003;4604;13463;3922;12275;289;947;2708;8649;2997;9596
290410;202003;5705;15594;4373;13425;105;504;3316;9892;3421;10396
290420;202003;2966;8294;2452;7479;71;256;1891;5721;1962;5977
290430;202003;3114;8561;2550;7688;223;711;1721;5125;1944;5836
290440;202003;2823;7085;1998;5784;41;120;1395;4134;1436;4254
290450;202003;3430;8801;2679;7673;142;409;1997;5761;2139;6170
290460;202003;11528;32411;9657;28846;1942;5899;4382;13040;6324;18939
290470;202003;4548;11171;3333;9485;387;1204;1892;5467;2279;6671
290475;202003;6375;18595;5365;16792;99;533;4394;13468;4493;14001
290480;202003;1790;4532;1463;4046;82;282;1009;2660;1091;2942
290485;202003;4499;13135;3970;12392;102;528;3394;10404;3496;10932
290490;202003;9236;21619;8244;20271;498;1116;6446;16101;6944;17217
290500;202003;3964;11895;3033;9869;540;1827;1338;4240;1878;6067
290510;202003;3455;8618;2868;7850;74;249;2470;6708;2544;6957
290515;202003;3638;10068;3143;9398;43;129;2823;8593;2866;8722
290520;202003;11518;32699;8851;27534;586;1977;5396;16544;5982;18521
290530;202003;4948;14116;4150;12808;133;506;3500;10760;3633;11266
290540;202003;3374;8870;3004;8442;50;166;2768;7754;2818;7920
290550;202003;4289;11251;3705;10561;10;54;3410;9838;3420;9892
290560;202003;6451;16635;4873;14284;417;1506;3190;9046;3607;10552
290570;202003;44674;109333;39474;102704;2431;6521;31730;82008;34161;88529
290580;202003;7770;22610;6671;21001;602;1867;4871;15702;5473;17569
290590;202003;7069;21730;5955;19730;142;586;4806;15997;4948;16583
290600;202003;18748;52151;16504;48469;674;2100;13298;38955;13972;41055
290610;202003;2548;7960;1976;6785;100;415;1377;4672;1477;5087
290620;202003;6379;17872;5497;16419;196;567;4623;13784;4819;14351
290630;202003;9222;22327;7297;19835;553;1496;5617;15398;6170;16894
290640;202003;2745;7115;2104;6178;81;248;1542;4579;1623;4827
290650;202003;12998;32250;11474;30526;2534;6456;7087;19744;9621;26200
290660;202003;3633;9327;3024;8439;49;135;2288;6600;2337;6735
290670;202003;6669;18474;5606;16710;378;1072;4279;12911;4657;13983
290680;202003;10776;29892;9032;27288;195;1052;7465;22054;7660;23106
290682;202003;4754;12352;4105;11488;127;303;3465;9805;3592;10108
290685;202003;3410;7722;2444;6329;199;483;1525;4211;1724;4694
290687;202003;6589;17744;5322;15648;703;1978;3394;10247;4097;12225
290689;202003;2806;7844;2151;6625;206;686;1469;4496;1675;5182
290690;202003;5553;14341;4487;12831;306;947;3247;9144;3553;10091
290700;202003;2618;7150;2300;6748;70;232;1927;5685;1997;5917
290710;202003;8263;23320;7065;21647;152;625;5964;18300;6116;18925
290720;202003;18381;50216;16685;47634;921;2932;13376;37723;14297;40655
290730;202003;7024;16709;5972;15485;290;599;4730;12445;5020;13044
290740;202003;1011;2749;776;2362;35;128;643;1956;678;2084
290750;202003;11098;27597;9578;25152;637;1801;7097;18092;7734;19893
290755;202003;2090;5888;1670;5114;90;286;1159;3577;1249;3863
290760;202003;3718;10817;2985;9421;190;573;2023;6560;2213;7133
290770;202003;2584;8380;2370;8111;51;258;1991;6889;2042;7147
290780;202003;8178;20234;7056;18749;269;604;5541;15056;5810;15660
290790;202003;4638;12803;4029;11948;150;447;3358;10087;3508;10534
290800;202003;7110;14741;5022;12278;291;691;3732;9193;4023;9884
290810;202003;5403;14139;4315;12534;111;357;3258;9665;3369;10022
290820;202003;4846;13110;4337;12372;180;520;3273;9470;3453;9990
290830;202003;4463;10148;3954;9511;28;80;3485;8282;3513;8362
290840;202003;16981;44885;14561;41138;1872;4341;9396;28210;11268;32551
290850;202003;6662;15986;5953;15222;205;513;5095;13160;5300;13673
290860;202003;6139;17579;5343;16653;227;728;4480;14288;4707;15016
290870;202003;4736;13061;3570;10833;137;445;2528;7617;2665;8062
290880;202003;1369;3438;1090;3070;70;179;763;2233;833;2412
290890;202003;9282;18685;8316;17599;154;335;7797;16431;7951;16766
290900;202003;2311;6095;1741;5092;99;263;1096;3179;1195;3442
290910;202003;5093;12277;3884;10435;47;156;3287;8755;3334;8911
290920;202003;4953;12748;4525;12246;40;93;4277;11683;4317;11776
290930;202003;7611;21220;6069;18512;192;829;4749;14115;4941;14944
290940;202003;3664;10285;3005;9323;152;577;2417;7491;2569;8068
290950;202003;1442;3634;1172;3231;62;180;831;2297;893;2477
290960;202003;5471;14340;4891;13609;175;443;4135;11561;4310;12004
290970;202003;3353;9841;2728;8706;106;391;2094;6680;2200;7071
290980;202003;12144;29077;10149;26003;797;2230;6328;15741;7125;17971
290990;202003;9484;25351;8354;23500;251;1040;7008;19049;7259;20089
291000;202003;3354;8778;2594;7816;115;363;2124;6462;2239;6825
291005;202003;15227;37439;13384;35020;1197;2894;10451;27524;11648;30418
291010;202003;2969;9039;2392;7808;107;412;1574;5002;1681;5414
291020;202003;1248;3083;996;2633;22;74;726;1813;748;1887
291030;202003;2489;6049;1719;4715;107;281;1068;2845;1175;3126
291040;202003;5368;14764;4471;13492;157;620;3510;10552;3667;11172
291050;202003;7654;19922;6525;18356;632;1998;4757;13112;5389;15110
291060;202003;5930;18137;5032;16930;313;1374;3827;12787;4140;14161
291070;202003;15758;42409;13094;38129;416;1472;10695;30950;11111;32422
291072;202003;24673;63216;17639;51026;3227;9652;7502;21978;10729;31630
291075;202003;5360;13265;4793;12384;108;300;3984;10099;4092;10399
291077;202003;1572;4107;1216;3487;49;119;853;2437;902;2556
291080;202003;97566;245431;76133;215288;23210;67214;20844;63377;44054;130591
291085;202003;5596;14142;4702;12777;190;575;3913;10594;4103;11169
291090;202003;2011;3789;1448;3162;44;99;1166;2502;1210;2601
291100;202003;3205;7001;2193;5790;97;270;1680;4395;1777;4665
291110;202003;5940;17622;5020;16043;314;1303;3802;11698;4116;13001
291120;202003;7576;18468;6372;16930;299;863;4906;13001;5205;13864
291125;202003;2165;3815;1621;3209;101;152;1299;2638;1400;2790
291130;202003;3228;9177;2386;7519;67;303;1757;5369;1824;5672
291140;202003;4798;12995;3483;10584;437;1163;2141;6564;2578;7727
291150;202003;2469;5364;1896;4717;6;22;1789;4438;1795;4460
291160;202003;5123;13931;4221;12632;373;1184;2822;8375;3195;9559
291165;202003;2100;5742;1589;4757;33;141;1162;3372;1195;3513
291170;202003;20819;52804;17318;46825;909;2707;11434;30409;12343;33116
291180;202003;6239;14493;4534;12187;263;688;3488;9386;3751;10074
291185;202003;3077;8272;2692;7642;90;276;2075;5901;2165;6177
291190;202003;7597;18652;6239;16904;301;946;4913;13256;5214;14202
291200;202003;2736;7538;2023;6192;94;301;1237;3654;1331;3955
291210;202003;6953;14978;5212;12975;133;437;3892;9724;4025;10161
291220;202003;4067;11537;3649;10907;184;678;2885;8501;3069;9179
291230;202003;4462;9577;3362;8373;36;94;3029;7619;3065;7713
291240;202003;4194;10726;3594;9728;63;221;3084;8219;3147;8440
291250;202003;3399;9999;2630;8588;156;509;1701;5567;1857;6076
291260;202003;1412;3316;1160;2991;30;94;952;2466;982;2560
291270;202003;5379;13885;4141;12059;633;1831;2564;7656;3197;9487
291280;202003;2517;6214;1865;5261;127;407;1232;3375;1359;3782
291290;202003;5848;15326;4505;13233;330;1047;3117;9077;3447;10124
291300;202003;3824;10281;2954;8857;113;416;2251;6639;2364;7055
291310;202003;5100;13551;4334;12158;115;372;3662;10123;3777;10495
291320;202003;6115;16934;4733;14356;1065;3015;2318;7477;3383;10492
291330;202003;1773;4475;1460;3962;84;229;1087;2913;1171;3142
291340;202003;4260;11025;3443;9595;80;259;2632;7193;2712;7452
291345;202003;2936;8794;2664;8370;111;392;2239;7038;2350;7430
291350;202003;6816;16896;5285;15031;61;200;4579;13271;4640;13471
291360;202003;37532;85426;29277;75457;2721;7185;19193;50501;21914;57686
291370;202003;7825;21555;6898;20130;493;1543;5121;14675;5614;16218
291380;202003;3386;9249;2968;8671;102;420;2458;7139;2560;7559
291390;202003;13162;28322;10180;25007;418;1028;8435;20701;8853;21729
291400;202003;13741;35183;11275;31441;1526;3728;6671;20083;8197;23811
291410;202003;2832;7511;2181;6393;34;148;1629;4699;1663;4847
291420;202003;1904;4707;1472;4169;32;131;1274;3599;1306;3730
291430;202003;2740;7783;2359;7152;86;386;1893;5553;1979;5939
291440;202003;6327;18192;5436;16724;314;1051;4252;13063;4566;14114
291450;202003;9139;22780;7529;20945;80;134;6588;18965;6668;19099
291460;202003;15449;40964;13508;38067;645;2064;10252;28667;10897;30731
291465;202003;9197;22780;7200;20492;141;648;6196;17514;6337;18162
291470;202003;16380;36841;13621;33727;707;1547;10132;25842;10839;27389
291480;202003;41471;91834;30336;76559;3526;9214;16057;40571;19583;49785
291490;202003;5623;13928;4834;13024;138;439;4357;11676;4495;12115
291500;202003;4974;12185;4119;11041;69;317;3743;9970;3812;10287
291510;202003;4271;10552;3165;9157;51;292;2636;7563;2687;7855
291520;202003;4553;10349;3423;8850;174;491;2627;6729;2801;7220
291530;202003;2250;5202;1576;4310;297;742;906;2712;1203;3454
291535;202003;3426;9982;3034;9286;170;469;2338;7316;2508;7785
291540;202003;2285;5100;1567;4237;62;215;1289;3426;1351;3641
291550;202003;5644;12906;4383;11304;389;841;2989;7873;3378;8714
291560;202003;18676;43948;13357;36905;1268;3405;8049;23099;9317;26504
291570;202003;2414;5742;1894;5101;58;158;1548;4338;1606;4496
291580;202003;6261;16176;4919;14362;207;676;3677;10644;3884;11320
291590;202003;2068;5099;1786;4768;74;276;1570;4097;1644;4373
291600;202003;5075;12221;3801;10247;337;993;2567;6695;2904;7688
291610;202003;5660;14823;5078;14175;78;294;4654;12974;4732;13268
291620;202003;3166;7020;2326;6099;105;272;1812;4841;1917;5113
291630;202003;3251;7382;2413;6273;281;815;1679;4270;1960;5085
291640;202003;15615;38677;11751;33057;1710;4675;5276;15470;6986;20145
291650;202003;9508;23601;8380;22260;568;1059;7046;19219;7614;20278
291660;202003;2055;5068;1491;4194;132;456;964;2534;1096;2990
291670;202003;2070;5435;1746;4969;100;247;1317;3809;1417;4056
291680;202003;4120;10135;3332;8988;290;802;2350;6315;2640;7117
291685;202003;4673;11141;3731;9936;226;470;2828;7826;3054;8296
291690;202003;4171;9218;2868;7319;216;452;2195;5630;2411;6082
291700;202003;8540;24722;7478;22841;314;1176;6092;18249;6406;19425
291710;202003;5326;12611;3906;10619;213;674;2848;7594;3061;8268
291720;202003;4446;13521;3691;12002;388;1347;2432;7737;2820;9084
291730;202003;6385;16255;5475;15064;268;817;4524;12381;4792;13198
291733;202003;2887;7325;2426;6715;58;166;1770;5139;1828;5305
291735;202003;2898;7616;2293;6538;78;199;1742;4930;1820;5129
291740;202003;3855;9958;2864;8132;91;248;2064;5752;2155;6000
291750;202003;19387;46213;15734;40863;1499;3807;10671;28020;12170;31827
291760;202003;10291;29619;8019;25948;2430;8908;2194;7084;4624;15992
291770;202003;6969;18765;5796;16742;361;1120;4331;12200;4692;13320
291780;202003;5112;13568;4600;12839;85;330;4041;11154;4126;11484
291790;202003;2685;7484;2430;7159;230;587;1826;5550;2056;6137
291800;202003;28991;72918;21465;61662;3356;9362;10532;31473;13888;40835
291810;202003;10543;25060;8772;22887;246;649;7509;19674;7755;20323
291820;202003;3791;9975;3273;9305;92;307;2626;7487;2718;7794
291830;202003;4420;10458;3608;9372;185;431;2875;7488;3060;7919
291835;202003;6465;19307;5056;16590;532;1869;3210;10670;3742;12539
291840;202003;47751;130517;41190;120315;4311;13440;28850;83782;33161;97222
291845;202003;2494;6453;1945;5773;108;343;1567;4702;1675;5045
291850;202003;3909;11153;3204;9973;259;766;2283;7295;2542;8061
291855;202003;2160;4303;1668;3756;41;100;1509;3407;1550;3507
291860;202003;2235;5812;1552;4497;45;130;1051;2935;1096;3065
291870;202003;1282;3212;855;2478;47;136;580;1652;627;1788
291875;202003;2871;8605;2469;7769;65;269;1821;5562;1886;5831
291880;202003;5629;15819;4801;14452;226;659;3621;10956;3847;11615
291890;202003;1644;3369;1055;2684;128;309;710;1803;838;2112
291900;202003;1183;2891;907;2460;24;92;718;1897;742;1989
291905;202003;2495;6304;2016;5543;77;278;1534;4066;1611;4344
291910;202003;2914;7395;2478;6873;50;180;2145;6051;2195;6231
291915;202003;7326;20740;5964;18425;226;788;4530;14163;4756;14951
291920;202003;26580;68779;22365;62890;2157;6592;15491;42764;17648;49356
291930;202003;2499;6760;2133;6244;237;709;1421;4201;1658;4910
291940;202003;3896;9905;2592;7683;197;585;1523;4494;1720;5079
291950;202003;9190;27571;7803;24896;288;1085;5437;17125;5725;18210
291955;202003;15580;39082;13840;36840;1177;3284;10792;28796;11969;32080
291960;202003;3043;8052;2517;7326;122;365;1967;5849;2089;6214
291970;202003;4522;11372;3773;10431;139;479;2856;7895;2995;8374
291980;202003;9643;27579;7580;23965;860;2558;4740;15314;5600;17872
291990;202003;2287;5914;1876;5420;30;131;1744;5029;1774;5160
291992;202003;3913;9450;3091;8378;222;522;2448;6762;2670;7284
291995;202003;2058;5702;1687;5104;50;227;1290;3806;1340;4033
292000;202003;2628;6185;2138;5596;98;370;1668;4306;1766;4676
292010;202003;5729;13407;4661;11880;169;529;3871;9654;4040;10183
292020;202003;4537;13163;3750;11756;200;743;2721;8280;2921;9023
292030;202003;1803;5525;1644;5230;74;267;1051;3276;1125;3543
292040;202003;4337;11207;3375;9779;219;580;2577;7622;2796;8202
292045;202003;4005;10541;2982;9037;35;86;2614;8125;2649;8211
292050;202003;6474;18121;5214;15875;240;843;3362;10054;3602;10897
292060;202003;11444;26296;10470;25084;486;1097;9158;21740;9644;22837
292070;202003;5780;14962;5035;14066;285;808;4332;12036;4617;12844
292080;202003;3091;7831;2553;7137;76;254;2265;6298;2341;6552
292090;202003;4626;9994;3279;8370;254;671;2461;6337;2715;7008
292100;202003;10807;26272;9193;24249;918;2543;6449;16909;7367;19452
292105;202003;3467;8664;3017;8053;99;243;2468;6618;2567;6861
292110;202003;5880;14382;4120;11560;970;2771;1890;5307;2860;8078
292120;202003;6829;17433;5648;15464;363;1055;4310;11602;4673;12657
292130;202003;3391;8102;2782;7347;97;285;2207;5761;2304;6046
292140;202003;5037;11890;4215;10643;313;784;3343;8412;3656;9196
292145;202003;2352;6778;1978;6139;60;163;1520;4773;1580;4936
292150;202003;14022;38229;12162;35189;311;1203;9942;28392;10253;29595
292160;202003;2960;7191;2229;6249;45;128;1817;5327;1862;5455
292170;202003;8397;22237;6980;19930;338;1135;5287;14800;5625;15935
292180;202003;2779;7613;2030;6228;160;486;1279;3860;1439;4346
292190;202003;2934;7701;2501;7030;93;319;1976;5486;2069;5805
292200;202003;8300;20699;6165;17669;1018;3022;3266;9623;4284;12645
292205;202003;3852;10651;3328;9867;60;285;2904;8559;2964;8844
292210;202003;6499;15128;5221;13513;85;377;4695;12008;4780;12385
292220;202003;2124;5111;1859;4703;48;139;1477;3606;1525;3745
292225;202003;3187;9333;2787;8721;73;340;2355;7242;2428;7582
292230;202003;8568;20402;7648;19236;148;501;6622;16374;6770;16875
292240;202003;4707;13586;4074;12438;305;910;2841;8705;3146;9615
292250;202003;5506;14531;4925;13652;395;1071;3633;10079;4028;11150
292260;202003;3418;8866;3019;8346;87;246;2631;7277;2718;7523
292265;202003;3367;9127;2819;8298;76;329;2236;6448;2312;6777
292270;202003;4421;10024;3508;8940;119;283;2910;7427;3029;7710
292273;202003;2664;5733;2117;5067;54;94;1584;4024;1638;4118
292275;202003;1643;4260;1287;3776;59;161;970;2904;1029;3065
292280;202003;2613;6196;2094;5596;80;174;1779;4889;1859;5063
292285;202003;2520;6111;2008;5424;79;181;1633;4452;1712;4633
292290;202003;7408;19654;5854;17466;162;625;4786;14249;4948;14874
292300;202003;10156;25598;7977;22668;750;2276;5526;15791;6276;18067
292303;202003;2936;8370;2546;7751;77;191;2127;6529;2204;6720
292305;202003;2312;6176;2133;5931;43;200;1934;5282;1977;5482
292310;202003;6664;16773;5741;15656;150;516;5001;13497;5151;14013
292320;202003;6079;16621;4812;14265;255;834;3521;10175;3776;11009
292330;202003;2726;5999;2188;5395;96;195;1704;4371;1800;4566
292335;202003;4712;12193;4188;11447;208;494;3544;9773;3752;10267
292340;202003;5615;15635;4620;13723;225;677;3414;10069;3639;10746
292350;202003;2457;6677;2039;6100;77;288;1641;4922;1718;5210
292360;202003;4856;12976;4022;11552;216;719;2866;8030;3082;8749
292370;202003;10506;24395;9009;22441;132;441;8362;20554;8494;20995
292380;202003;6782;18875;6059;17582;387;1128;4618;13283;5005;14411
292390;202003;4525;8704;3326;7305;105;192;2912;6409;3017;6601
292400;202003;22081;62762;19042;57934;1843;5705;13107;40089;14950;45794
292405;202003;4211;10528;3554;9492;97;261;2931;7740;3028;8001
292410;202003;2213;5251;1841;4779;64;143;1624;4240;1688;4383
292420;202003;3430;10430;3124;9937;112;574;2684;8299;2796;8873
292430;202003;4830;14414;3651;12233;285;996;2389;7997;2674;8993
292440;202003;8414;26755;7770;25784;129;659;6959;22998;7088;23657
292450;202003;3982;11377;3110;9672;86;331;2426;7498;2512;7829
292460;202003;4897;13390;3994;11853;347;988;2861;8507;3208;9495
292465;202003;2578;6748;2192;6240;85;189;1514;4672;1599;4861
292467;202003;1893;5303;1678;5009;239;638;1162;3603;1401;4241
292470;202003;2968;7534;2293;6485;52;115;1796;5086;1848;5201
292480;202003;6247;14955;5027;13476;72;280;4561;12135;4633;12415
292490;202003;2049;5313;1712;4816;117;266;1299;3750;1416;4016
292500;202003;6574;17925;5241;15550;497;1541;3414;9991;3911;11532
292510;202003;13170;35553;10252;30868;516;1850;7179;21540;7695;23390
292520;202003;6974;17322;6179;16188;451;1218;4803;12475;5254;13693
292525;202003;5844;14066;4747;12832;111;274;4117;11305;4228;11579
292530;202003;28005;74567;21337;63099;5152;15380;8175;24817;13327;40197
292540;202003;4336;8047;3393;7041;99;174;3064;6380;3163;6554
292550;202003;8379;21594;6401;19220;463;1396;4545;14515;5008;15911
292560;202003;4293;10805;3719;10047;70;216;3099;8417;3169;8633
292570;202003;3561;9425;2976;8331;69;268;2509;6850;2578;7118
292575;202003;6934;19704;6345;18921;363;1069;5118;15403;5481;16472
292580;202003;7539;18963;6242;17052;134;455;5265;14239;5399;14694
292590;202003;7329;19519;6278;17710;251;815;5251;14537;5502;15352
292593;202003;2787;6928;2313;6135;63;166;1954;5131;2017;5297
292595;202003;5381;14292;4601;13334;148;501;3882;11178;4030;11679
292600;202003;10878;29560;9341;27203;291;874;7448;21762;7739;22636
292610;202003;4080;10704;3449;9581;179;418;2615;7357;2794;7775
292620;202003;6426;17558;5322;16227;124;291;4867;15123;4991;15414
292630;202003;8470;20737;6813;18084;683;1824;4430;11800;5113;13624
292640;202003;8133;23925;7059;22146;196;788;5029;15886;5225;16674
292650;202003;4440;10939;4001;10364;106;288;3637;9318;3743;9606
292660;202003;11418;30585;9667;28003;441;1445;7425;21479;7866;22924
292665;202003;2157;6372;1869;5995;66;196;1581;5137;1647;5333
292670;202003;3567;9551;2728;7997;114;366;1860;5343;1974;5709
292680;202003;3960;10410;3113;8924;194;508;2274;6415;2468;6923
292690;202003;2611;6697;1795;5363;193;540;1065;3335;1258;3875
292700;202003;9779;26501;8492;24544;725;1868;5892;17612;6617;19480
292710;202003;2410;7579;2233;7334;45;164;2015;6667;2060;6831
292720;202003;8969;21328;7590;19737;207;575;6042;15983;6249;16558
292730;202003;4512;10289;4220;9942;255;424;3638;8762;3893;9186
292740;202003;324726;780658;279013;714609;38742;99381;173849;443411;212591;542792
292750;202003;6120;16453;5346;15327;221;645;4138;12044;4359;12689
292760;202003;3892;11163;3375;10239;223;755;2469;7431;2692;8186
292770;202003;6007;15855;4802;14167;765;2334;3000;9090;3765;11424
292780;202003;2053;4120;1519;3450;38;130;1228;2632;1266;2762
292790;202003;4073;8665;3113;7624;151;377;2601;6425;2752;6802
292800;202003;11217;28023;9576;25553;296;858;8008;21088;8304;21946
292805;202003;3574;8593;2782;7549;99;316;2196;5911;2295;6227
292810;202003;10614;27809;8373;24302;203;876;6315;17752;6518;18628
292820;202003;7415;20369;5384;16960;434;1460;3740;11591;4174;13051
292830;202003;2873;6781;2463;6271;89;269;2093;5339;2182;5608
292840;202003;8697;22639;7350;20809;147;569;6437;17914;6584;18483
292850;202003;2474;6564;2077;5973;141;428;1472;4205;1613;4633
292860;202003;17190;37552;15399;35427;408;993;13335;30303;13743;31296
292870;202003;17908;44174;15334;40552;938;2529;10490;27442;11428;29971
292880;202003;10984;29806;9350;27362;267;1111;7379;20887;7646;21998
292890;202003;6999;19427;6173;18224;183;750;5402;15820;5585;16570
292895;202003;2976;6373;2152;5153;98;233;1739;4122;1837;4355
292900;202003;2569;6908;2335;6546;61;238;1916;5215;1977;5453
292905;202003;4288;11060;3377;9720;141;468;2495;7103;2636;7571
292910;202003;4871;13189;4424;12553;214;602;3383;9540;3597;10142
292920;202003;9684;26491;8941;25435;247;939;7745;21644;7992;22583
292925;202003;5413;15271;4520;13664;219;671;3271;9773;3490;10444
292930;202003;6477;18951;5562;17261;466;1612;3565;10780;4031;12392
292935;202003;2416;6139;1866;5523;23;123;1676;4989;1699;5112
292937;202003;2907;7113;2535;6630;53;168;2241;5832;2294;6000
292940;202003;2834;7162;2264;6316;179;412;1643;4758;1822;5170
292950;202003;9554;24130;8341;22338;528;1229;6305;16860;6833;18089
292960;202003;5201;12569;4350;11355;127;339;3496;9028;3623;9367
292970;202003;3742;10847;3307;10176;80;387;2756;8515;2836;8902
292975;202003;4453;9494;3938;8917;129;220;3584;8216;3713;8436
292980;202003;3297;7923;2637;6951;87;276;2150;5560;2237;5836
292990;202003;11335;31002;9452;27660;645;1987;6918;19931;7563;21918
293000;202003;2566;6130;2193;5568;42;150;1753;4454;1795;4604
293010;202003;17955;45869;14430;40296;1919;5552;8829;24611;10748;30163
293015;202003;8126;24941;6341;21432;402;1469;4295;14717;4697;16186
293020;202003;9781;28320;8795;26908;134;588;7926;24305;8060;24893
293030;202003;5214;13852;3947;11876;98;337;2744;8489;2842;8826
293040;202003;4005;10989;3374;10098;66;260;2922;8760;2988;9020
293050;202003;21947;54265;19390;50502;965;2648;14756;37875;15721;40523
293060;202003;3446;9192;2801;7984;236;704;1944;5455;2180;6159
293070;202003;24995;60093;21280;55396;1945;5346;15322;39928;17267;45274
293075;202003;3449;10966;2991;10180;158;704;2373;8068;2531;8772
293076;202003;3507;8658;3191;8280;57;161;2841;7434;2898;7595
293077;202003;6030;16778;4890;14931;432;1450;3180;9948;3612;11398
293080;202003;4694;13855;4036;12729;91;431;3276;10137;3367;10568
293090;202003;3207;9288;2442;8025;204;669;1606;5335;1810;6004
293100;202003;5610;15032;4620;13245;219;657;3647;10362;3866;11019
293105;202003;3658;11611;3199;10678;229;795;2277;7538;2506;8333
293110;202003;2359;5903;1957;5309;67;246;1617;4274;1684;4520
293120;202003;4357;11847;3871;11081;112;301;3223;9236;3335;9537
293130;202003;3677;10113;3204;9489;74;284;2755;8091;2829;8375
293135;202003;30626;71421;22531;60668;3391;9954;10710;29124;14101;39078
293140;202003;2363;5247;2046;4853;61;144;1724;4081;1785;4225
293150;202003;5481;16201;4502;14333;335;1081;3087;9866;3422;10947
293160;202003;3849;9335;3259;8695;245;411;2714;7599;2959;8010
293170;202003;4794;10186;4161;9401;122;274;3623;8144;3745;8418
293180;202003;4264;12045;3500;10649;93;370;2772;8231;2865;8601
293190;202003;13832;37930;12140;35476;152;675;10757;31252;10909;31927
293200;202003;8322;20674;6637;18012;204;755;5293;14057;5497;14812
293210;202003;5122;13604;4389;12489;286;802;3369;9592;3655;10394
293220;202003;5019;12937;3659;10604;855;2475;1456;4323;2311;6798
293230;202003;3867;9915;2838;8431;209;700;1945;5828;2154;6528
293240;202003;4495;11876;3592;10403;70;174;2733;8225;2803;8399
293245;202003;3794;10248;3404;9691;140;475;2902;8118;3042;8593
293250;202003;5868;13597;4781;12213;135;344;4021;10268;4156;10612
293260;202003;4438;12040;3652;10798;140;466;2536;7527;2676;7993
293270;202003;7216;15915;5682;14274;387;590;4468;12049;4855;12639
293280;202003;4500;11850;3917;11024;234;581;3050;8678;3284;9259
293290;202003;14231;41560;12491;38838;1684;5333;8197;25834;9881;31167
293300;202003;5719;13849;4907;12670;268;698;3616;9342;3884;10040
293305;202003;3948;9548;3445;8920;45;121;3110;8048;3155;8169
293310;202003;2050;5265;1729;4768;44;136;1390;3773;1434;3909
293315;202003;4016;9589;3307;8510;190;439;2739;7039;2929;7478
293317;202003;2596;6111;2295;5697;140;267;1824;4552;1964;4819
293320;202003;11929;28902;10546;27355;261;726;9402;24285;9663;25011
293325;202003;1758;4369;1366;3840;191;529;840;2399;1031;2928
293330;202003;52538;151853;42316;133667;8110;26353;19461;62273;27571;88626
293340;202003;2205;6183;1817;5496;82;274;1296;3860;1378;4134
293345;202003;3461;9397;2765;8352;339;795;1821;5990;2160;6785
293350;202003;6601;18895;5691;17809;60;305;5190;16436;5250;16741
293360;202003;15436;38419;13079;35272;301;1249;11509;30461;11810;31710
310010;202003;925;2086;582;1607;46;165;217;543;263;708
310020;202003;2409;6596;1710;5333;372;1275;370;1072;742;2347
310030;202003;1871;5288;1432;4520;211;743;912;2767;1123;3510
310040;202003;896;2336;711;2023;29;129;488;1301;517;1430
310050;202003;1489;4465;1253;4087;132;539;818;2562;950;3101
310060;202003;3141;8895;2724;8343;83;358;2268;6849;2351;7207
310070;202003;337;775;237;631;7;15;179;473;186;488
310080;202003;677;1794;480;1436;70;233;220;621;290;854
310090;202003;4603;12338;3754;10941;284;898;2734;7844;3018;8742
310100;202003;3339;9453;2784;8506;78;375;2244;6681;2322;7056
310110;202003;4569;12045;3547;10236;762;2399;1537;4261;2299;6660
310120;202003;626;1533;395;1161;42;151;237;640;279;791
310130;202003;358;935;296;844;26;104;219;587;245;691
310140;202003;264;751;188;625;37;140;75;224;112;364
310150;202003;5273;13954;3872;11339;499;1683;1825;5052;2324;6735
310160;202003;7511;18756;5317;15145;1029;3228;1904;5480;2933;8708
310163;202003;1017;3014;808;2615;183;674;270;805;453;1479
310170;202003;8959;23031;7103;20114;600;1774;5026;14212;5626;15986
310180;202003;1734;4323;1269;3549;155;480;759;2047;914;2527
310190;202003;2441;7144;1947;6256;450;1623;316;949;766;2572
310200;202003;1827;5407;1312;4398;193;733;600;1973;793;2706
310205;202003;1099;3051;842;2645;149;530;378;1166;527;1696
310210;202003;2587;6951;2097;6075;116;362;1535;4352;1651;4714
310220;202003;1211;3340;920;2775;90;304;606;1758;696;2062
310230;202003;2148;5967;1717;5158;216;728;1073;3020;1289;3748
310240;202003;911;2834;762;2566;46;178;544;1805;590;1983
310250;202003;1013;2720;808;2384;19;76;579;1688;598;1764
310260;202003;2826;7270;1733;5358;493;1777;445;1046;938;2823
310270;202003;2643;6665;2074;5887;98;334;1683;4771;1781;5105
310280;202003;2325;5419;1780;4643;268;748;999;2505;1267;3253
310285;202003;1827;5840;1512;5271;167;671;934;3211;1101;3882
310290;202003;1117;2936;907;2559;207;676;474;1192;681;1868
310300;202003;1433;4196;1213;3821;136;540;723;2130;859;2670
310310;202003;286;706;186;534;31;94;99;283;130;377
310320;202003;500;1290;336;1025;26;98;183;530;209;628
310330;202003;479;1130;284;784;41;132;116;291;157;423
310340;202003;7653;20728;6103;18092;866;2493;3019;9277;3885;11770
310350;202003;12102;29144;8150;22764;1586;4750;3548;9613;5134;14363
310360;202003;489;1115;370;959;11;33;254;665;265;698
310370;202003;1244;3885;1046;3502;207;759;348;1183;555;1942
310375;202003;826;2054;571;1678;91;278;304;889;395;1167
310380;202003;392;880;215;599;34;103;98;253;132;356
310390;202003;427;1269;335;1091;77;274;96;265;173;539
310400;202003;9654;23403;6784;19102;702;2301;4027;11091;4729;13392
310410;202003;882;2534;574;1955;89;330;216;689;305;1019
310420;202003;4094;10487;2741;7903;378;1242;1109;2969;1487;4211
310430;202003;1476;4006;952;3028;215;756;327;917;542;1673
310440;202003;644;1680;438;1299;43;156;232;647;275;803
310445;202003;1339;3849;966;3097;57;197;683;2152;740;2349
310450;202003;4680;11696;3505;9847;136;522;2665;7256;2801;7778
310460;202003;1504;3961;1062;3159;183;592;358;1013;541;1605
310470;202003;3711;8136;2868;7038;279;663;2037;5117;2316;5780
310480;202003;870;2284;683;1971;77;240;445;1257;522;1497
310490;202003;2770;7574;2153;6537;233;882;1199;3421;1432;4303
310500;202003;1325;3752;980;3171;172;637;516;1621;688;2258
310510;202003;1974;5147;1242;3785;232;802;455;1393;687;2195
310520;202003;1179;3070;847;2474;141;405;445;1297;586;1702
310530;202003;678;1713;417;1234;59;220;139;330;198;550
310540;202003;2967;8449;2456;7569;550;1791;1115;3307;1665;5098
310550;202003;1221;3135;836;2472;70;256;477;1329;547;1585
310560;202003;14417;37501;10165;30046;1517;5152;4267;11403;5784;16555
310570;202003;1023;2668;806;2366;51;183;599;1731;650;1914
310590;202003;3963;10592;3157;9090;197;678;1849;5045;2046;5723
310600;202003;1294;3837;1057;3361;146;528;541;1605;687;2133
310610;202003;465;1216;289;925;52;187;142;427;194;614
310620;202003;171082;432649;123156;346155;17901;58398;59874;152662;77775;211060
310630;202003;4334;11864;3391;10047;297;983;2186;6266;2483;7249
310640;202003;995;2983;811;2612;167;593;345;1055;512;1648
310650;202003;2328;6711;1675;5448;163;574;976;3085;1139;3659
310660;202003;1273;3441;1036;3122;30;107;872;2610;902;2717
310665;202003;1385;3592;1107;3183;28;104;904;2618;932;2722
310670;202003;54404;140500;45568;125403;4282;13599;31355;82250;35637;95849
310680;202003;730;1760;592;1563;18;62;495;1263;513;1325
310690;202003;1879;4943;1338;4025;110;386;746;2137;856;2523
310700;202003;473;1052;374;934;22;75;296;711;318;786
310710;202003;5317;15212;3869;13100;882;3535;631;1977;1513;5512
310720;202003;966;2281;745;2001;34;113;558;1461;592;1574
310730;202003;9642;26024;8260;23849;327;1223;6229;17644;6556;18867
310740;202003;5790;15979;3910;12040;646;2202;1329;3770;1975;5972
310750;202003;1192;2842;862;2368;113;350;432;1115;545;1465
310760;202003;564;1465;402;1221;29;92;215;673;244;765
310770;202003;1057;2861;724;2351;78;305;370;1126;448;1431
310780;202003;4210;10242;3474;9248;65;199;2832;7576;2897;7775
310790;202003;1759;5589;1523;5084;353;1257;240;719;593;1976
310800;202003;2155;6386;1538;5108;349;1386;104;283;453;1669
310810;202003;1165;2931;934;2545;42;126;654;1726;696;1852
310820;202003;1092;2824;665;2100;149;513;164;518;313;1031
310825;202003;2469;7611;1964;6759;70;416;1575;5228;1645;5644
310830;202003;1678;4773;1148;3703;230;854;478;1439;708;2293
310840;202003;1866;5077;1329;4173;351;1247;319;879;670;2126
310850;202003;1467;4036;1223;3694;46;237;951;2735;997;2972
310855;202003;3024;8009;2341;6905;158;567;1680;4811;1838;5378
310860;202003;6879;19901;5483;17139;519;1726;3383;10646;3902;12372
310870;202003;926;2241;724;1952;46;125;548;1479;594;1604
310880;202003;973;2924;759;2483;103;347;442;1414;545;1761
310890;202003;2229;6354;1428;4728;264;947;219;619;483;1566
310900;202003;3744;10474;2504;7712;363;1187;1083;3135;1446;4322
310910;202003;1942;4810;1329;3824;102;365;266;703;368;1068
310920;202003;1887;4914;1424;4207;201;641;806;2328;1007;2969
310925;202003;921;2522;739;2225;69;244;499;1420;568;1664
310930;202003;5669;14905;4009;12186;759;2360;1869;5914;2628;8274
310940;202003;6406;15414;5100;13482;175;616;3885;9964;4060;10580
310945;202003;1313;3441;1028;2974;150;465;538;1526;688;1991
310950;202003;1853;5544;1199;4052;226;863;410;1218;636;2081
310960;202003;711;1896;391;1219;72;257;82;230;154;487
310970;202003;1108;3293;776;2572;203;742;144;438;347;1180
310980;202003;271;654;175;509;16;55;111;313;127;368
310990;202003;1277;3563;987;3053;162;527;505;1533;667;2060
311000;202003;3946;10989;2862;9166;700;2410;1177;3653;1877;6063
311010;202003;844;2495;673;2146;199;708;282;872;481;1580
311020;202003;1034;2650;652;1963;36;111;361;1077;397;1188
311030;202003;1588;3890;1080;3064;183;598;512;1364;695;1962
311040;202003;274;862;226;755;68;239;69;216;137;455
311050;202003;2753;6735;2015;5661;359;1156;1008;2710;1367;3866
311060;202003;2970;7619;2136;6044;314;1025;845;2187;1159;3212
311070;202003;2256;5639;1611;4625;177;656;855;2290;1032;2946
311080;202003;1090;2484;881;2154;50;168;688;1593;738;1761
311090;202003;1988;6325;1542;5477;352;1387;469;1608;821;2995
311100;202003;2305;6538;1339;4538;239;927;240;724;479;1651
311110;202003;3579;7325;1988;5120;352;980;743;1952;1095;2932
311115;202003;1319;3034;1097;2728;59;151;903;2228;962;2379
311120;202003;6171;16193;4616;13397;684;2277;1766;4513;2450;6790
311130;202003;1801;4694;1353;4075;110;422;764;2246;874;2668
311140;202003;1347;3334;1033;2908;77;254;692;1920;769;2174
311150;202003;1462;4638;1134;3995;183;717;605;2076;788;2793
311160;202003;3631;10435;2507;8304;625;2302;755;2400;1380;4702
311170;202003;873;2212;685;1958;37;106;436;1321;473;1427
311180;202003;1311;2953;803;2197;148;440;360;974;508;1414
311190;202003;854;2369;652;1974;116;403;262;694;378;1097
311200;202003;1905;5177;1352;4108;259;875;482;1312;741;2187
311205;202003;853;2581;692;2253;47;214;434;1339;481;1553
311210;202003;992;2906;861;2732;110;316;629;2049;739;2365
311220;202003;722;2010;602;1798;47;160;381;1078;428;1238
311230;202003;7532;22759;5666;18924;1004;3536;2126;7235;3130;10771
311240;202003;982;2575;743;2233;152;488;320;960;472;1448
311250;202003;970;2806;743;2372;161;494;297;915;458;1409
311260;202003;2529;6300;1579;4647;251;825;657;1775;908;2600
311265;202003;1292;3373;946;2782;40;161;657;1873;697;2034
311270;202003;2931;8763;2545;8116;157;694;1853;5638;2010;6332
311280;202003;1073;2738;490;1556;98;361;48;131;146;492
311290;202003;1824;5546;1656;5188;146;479;1124;3507;1270;3986
311300;202003;4613;12954;3769;11528;197;837;2975;8898;3172;9735
311310;202003;548;1517;462;1367;41;119;279;802;320;921
311320;202003;3058;9349;2588;8323;382;1456;1209;3530;1591;4986
311330;202003;4917;13001;3903;11352;420;1359;2186;6473;2606;7832
311340;202003;10087;28331;7910;24449;2100;7041;2142;6302;4242;13343
311350;202003;2263;5701;1572;4414;138;439;862;2174;1000;2613
311360;202003;1091;2677;684;2049;196;664;226;644;422;1308
311370;202003;4544;11041;3310;9087;137;545;2208;5719;2345;6264
311380;202003;344;1053;250;858;60;203;103;372;163;575
311390;202003;1656;5066;1295;4564;570;2261;315;982;885;3243
311400;202003;1364;3787;986;3066;149;481;390;1092;539;1573
311410;202003;1601;4704;1278;4232;193;736;742;2433;935;3169
311420;202003;1378;4006;940;3102;171;645;232;620;403;1265
311430;202003;3760;9996;2444;7369;480;1506;768;2313;1248;3819
311440;202003;2563;7312;1862;6103;430;1657;498;1555;928;3212
311450;202003;1658;4940;1176;4038;312;1217;324;963;636;2180
311455;202003;962;2139;629;1644;166;438;249;685;415;1123
311460;202003;469;1459;314;1130;64;301;84;253;148;554
311470;202003;480;1506;320;1125;72;298;48;153;120;451
311480;202003;1037;2686;856;2409;52;145;658;1855;710;2000
311490;202003;237;702;175;579;31;122;82;240;113;362
311500;202003;427;1066;327;923;24;77;214;581;238;658
311510;202003;3087;8088;2058;6297;300;1040;843;2426;1143;3466
311520;202003;615;1731;542;1591;70;263;303;864;373;1127
311530;202003;8535;19857;5289;14616;1277;3941;1399;3670;2676;7611
311535;202003;776;2118;497;1547;82;271;168;478;250;749
311540;202003;470;1497;416;1394;79;292;273;889;352;1181
311545;202003;2006;5754;1709;5291;96;347;1324;4042;1420;4389
311547;202003;1434;3692;1240;3390;43;120;866;2395;909;2515
311550;202003;2688;7536;2129;6502;302;1042;924;2696;1226;3738
311560;202003;276;612;174;463;22;73;96;222;118;295
311570;202003;1643;3817;1160;3153;34;102;927;2563;961;2665
311580;202003;2132;3969;1396;3103;134;288;944;2091;1078;2379
311590;202003;477;1269;379;1121;61;207;211;612;272;819
311600;202003;1736;3886;1452;3522;56;132;1252;2998;1308;3130
311610;202003;2163;7095;1781;6278;195;758;1004;3497;1199;4255
311615;202003;3049;8736;2453;7728;118;451;1927;5967;2045;6418
311620;202003;421;1095;363;1032;8;35;312;875;320;910
311630;202003;1293;3584;1040;3058;95;305;686;1939;781;2244
311640;202003;543;1487;420;1274;57;200;197;557;254;757
311650;202003;1823;4745;1501;4243;145;454;988;2720;1133;3174
311660;202003;2630;7491;1910;6102;348;1247;517;1421;865;2668
311670;202003;1457;3849;1060;3147;161;553;449;1330;610;1883
311680;202003;2074;6002;1529;4977;165;543;1009;3279;1174;3822
311690;202003;590;1260;460;1095;40;77;329;832;369;909
311700;202003;2204;5305;1712;4618;28;137;1440;3755;1468;3892
311710;202003;1454;4188;1037;3436;240;869;401;1299;641;2168
311720;202003;396;1184;314;1033;21;91;181;582;202;673
311730;202003;3743;9617;2378;6983;702;2214;458;1391;1160;3605
311740;202003;854;2262;720;2103;29;72;623;1878;652;1950
311750;202003;3798;11419;3016;9979;417;1499;1708;5459;2125;6958
311760;202003;594;1674;485;1480;71;271;241;636;312;907
311770;202003;2044;5870;1588;5043;245;826;745;2291;990;3117
311780;202003;1219;3496;819;2691;162;605;250;710;412;1315
311783;202003;2169;5947;1750;5216;45;212;1411;4039;1456;4251
311787;202003;696;1994;517;1585;68;231;223;584;291;815
311790;202003;1431;3859;928;2933;233;813;250;752;483;1565
311800;202003;4602;13848;3724;11931;799;2807;638;1760;1437;4567
311810;202003;919;2805;726;2463;57;221;465;1564;522;1785
311820;202003;759;1860;560;1554;69;220;346;908;415;1128
311830;202003;8229;23617;5555;17784;1547;5351;679;2122;2226;7473
311840;202003;3437;8830;2764;7860;251;759;2024;5721;2275;6480
311850;202003;354;938;286;809;14;38;189;522;203;560
311860;202003;56041;141464;42430;118415;6286;18974;23536;62862;29822;81836
311870;202003;1810;4810;1216;3729;205;718;477;1326;682;2044
311880;202003;6148;15949;5130;14534;280;716;3868;11177;4148;11893
311890;202003;1575;3838;1205;3308;82;276;864;2260;946;2536
311900;202003;710;1845;524;1588;52;185;352;1049;404;1234
311910;202003;4116;10570;3088;9219;548;1606;1560;4806;2108;6412
311920;202003;2003;5374;1577;4750;113;313;1005;3112;1118;3425
311930;202003;3581;8399;2499;6869;784;2333;743;1912;1527;4245
311940;202003;14244;37679;10405;30388;1503;4878;4748;12930;6251;17808
311950;202003;2206;6056;1631;5081;105;404;1039;3197;1144;3601
311960;202003;476;1166;381;1024;24;92;244;592;268;684
311970;202003;407;1316;292;1023;49;206;69;208;118;414
311980;202003;427;1174;218;755;25;89;67;235;92;324
311990;202003;530;1229;329;931;65;232;143;359;208;591
311995;202003;922;2543;446;1436;21;70;66;157;87;227
312000;202003;648;1711;532;1543;47;139;348;1016;395;1155
312010;202003;911;2548;697;2190;54;197;436;1313;490;1510
312015;202003;1325;3936;1165;3678;46;214;942;2905;988;3119
312020;202003;1445;4476;1082;3693;236;847;257;837;493;1684
312030;202003;1973;4954;1716;4670;21;80;1598;4339;1619;4419
312040;202003;824;2420;567;1910;63;223;257;846;320;1069
312050;202003;1148;3611;915;3158;216;871;277;854;493;1725
312060;202003;843;2091;553;1730;137;421;264;853;401;1274
312070;202003;868;2520;617;2024;47;168;333;1031;380;1199
312080;202003;2606;6422;1940;5433;104;344;1259;3379;1363;3723
312083;202003;824;2150;604;1807;53;195;403;1165;456;1360
312087;202003;2402;6315;1936;5576;45;152;1530;4407;1575;4559
312090;202003;9518;25070;7242;21435;1099;3590;3589;10357;4688;13947
312100;202003;1474;4396;1134;3763;102;431;644;2047;746;2478
312110;202003;994;3077;824;2732;186;718;290;863;476;1581
312120;202003;782;2140;527;1693;151;551;159;422;310;973
312125;202003;1696;4383;1413;3974;116;382;1050;2840;1166;3222
312130;202003;958;2329;707;1910;54;155;308;762;362;917
312140;202003;669;1930;543;1677;108;373;247;702;355;1075
312150;202003;446;1248;374;1097;13;58;267;727;280;785
312160;202003;7987;22074;5964;18461;732;2666;2888;8535;3620;11201
312170;202003;885;2419;668;1988;35;132;448;1294;483;1426
312180;202003;1306;3551;1028;3014;144;458;528;1500;672;1958
312190;202003;608;1704;421;1337;77;268;137;409;214;677
312200;202003;4492;12233;3541;10696;1072;3244;1254;3879;2326;7123
312210;202003;1314;2976;938;2426;35;106;707;1794;742;1900
312220;202003;1619;5019;1395;4597;101;360;885;2917;986;3277
312230;202003;12357;32079;8004;24062;1926;6542;1599;4148;3525;10690
312235;202003;1874;4842;1476;4234;82;294;1056;2947;1138;3241
312240;202003;686;2250;520;1898;120;473;143;510;263;983
312245;202003;2545;6740;2070;6010;59;196;1683;4851;1742;5047
312247;202003;917;2253;651;1863;117;359;339;978;456;1337
312250;202003;968;2573;618;1870;80;256;234;693;314;949
312260;202003;871;2389;688;2106;36;153;519;1533;555;1686
312270;202003;658;1796;496;1480;24;103;291;799;315;902
312280;202003;399;1178;308;1012;95;315;44;133;139;448
312290;202003;704;2086;559;1822;104;382;195;620;299;1002
312300;202003;956;2915;636;2117;156;563;123;342;279;905
312310;202003;829;2573;644;2171;98;363;299;976;397;1339
312320;202003;1881;4863;1352;3929;324;992;304;847;628;1839
312330;202003;839;2500;664;2131;63;226;408;1284;471;1510
312340;202003;256;670;180;542;44;156;72;192;116;348
312350;202003;240;485;168;407;14;44;115;264;129;308
312352;202003;1575;4731;1400;4416;85;278;865;2904;950;3182
312360;202003;2473;7208;1778;5845;356;1272;538;1701;894;2973
312370;202003;1760;4640;1427;4080;177;570;829;2263;1006;2833
312380;202003;2099;4801;1725;4330;6;25;1543;3834;1549;3859
312385;202003;1170;3238;912;2774;149;483;443;1332;592;1815
312390;202003;1840;5312;1367;4411;201;755;519;1526;720;2281
312400;202003;2772;8014;2280;7142;701;2364;739;2279;1440;4643
312410;202003;11371;31441;9207;27779;1584;4979;5066;15112;6650;20091
312420;202003;3534;9719;2919;8689;533;1759;1555;4504;2088;6263
312430;202003;7555;20293;6161;17765;385;1300;4354;12245;4739;13545
312440;202003;861;2794;675;2368;353;1308;84;256;437;1564
312450;202003;1121;3305;845;2816;242;856;287;991;529;1847
312460;202003;424;1111;287;901;40;139;149;483;189;622
312470;202003;458;1099;286;796;32;99;107;262;139;361
312480;202003;1033;2567;720;2107;100;318;352;970;452;1288
312490;202003;2018;4926;1525;4195;200;571;829;2231;1029;2802
312500;202003;941;2334;755;2074;50;176;516;1397;566;1573
312510;202003;3619;9589;2573;7612;656;1871;691;2086;1347;3957
312520;202003;150;420;114;358;29;93;49;155;78;248
312530;202003;576;1420;494;1320;16;58;435;1164;451;1222
312540;202003;1526;4307;1019;3252;145;510;555;1713;700;2223
312550;202003;730;1954;549;1593;45;147;349;930;394;1077
312560;202003;1911;4961;1527;4356;67;214;1163;3327;1230;3541
312570;202003;2105;5191;1572;4519;441;1333;626;1857;1067;3190
312580;202003;607;1687;428;1306;56;200;195;543;251;743
312590;202003;1567;4583;1245;3934;89;400;779;2281;868;2681
312595;202003;1850;5523;1535;4979;258;798;912;3103;1170;3901
312600;202003;1086;2631;604;1697;102;363;124;403;226;766
312610;202003;5938;15042;3762;10979;581;1844;1296;3530;1877;5374
312620;202003;2463;6433;1812;5510;54;261;1428;4427;1482;4688
312630;202003;278;818;196;672;38;158;76;250;114;408
312640;202003;487;1343;330;1068;41;137;126;429;167;566
312650;202003;1977;5110;1341;3906;65;216;952;2659;1017;2875
312660;202003;1284;3155;959;2599;84;259;655;1702;739;1961
312670;202003;4740;12673;3918;11362;170;768;2854;7897;3024;8665
312675;202003;1230;3272;996;2925;56;188;801;2327;857;2515
312680;202003;1338;3831;1153;3542;53;239;948;2821;1001;3060
312690;202003;2819;6037;2182;5269;52;151;1811;4382;1863;4533
312695;202003;928;2573;769;2298;38;100;602;1800;640;1900
312700;202003;2069;5465;1488;4396;148;511;834;2339;982;2850
312705;202003;1331;3276;1123;2960;18;61;1007;2636;1025;2697
312707;202003;1316;3892;1014;3336;59;295;657;2039;716;2334
312710;202003;6447;14776;3754;10533;959;2890;1062;3082;2021;5972
312720;202003;1036;2791;778;2383;97;318;476;1422;573;1740
312730;202003;1603;3816;1134;3159;90;300;669;1775;759;2075
312733;202003;1353;3595;1028;2974;36;143;703;1933;739;2076
312735;202003;639;1744;534;1537;67;223;327;841;394;1064
312737;202003;766;1769;526;1413;67;200;329;840;396;1040
312738;202003;604;1552;419;1236;44;152;234;651;278;803
312740;202003;410;1012;235;719;51;173;61;150;112;323
312750;202003;1540;4456;1147;3718;203;697;499;1535;702;2232
312760;202003;1752;5162;1236;4092;216;778;453;1430;669;2208
312770;202003;42891;102917;26510;74737;5498;16616;8683;24116;14181;40732
312780;202003;2366;7116;2001;6523;231;817;1296;4210;1527;5027
312790;202003;242;578;129;398;7;38;42;108;49;146
312800;202003;4764;13500;3589;11236;884;2922;1230;3762;2114;6684
312810;202003;1526;4053;990;3177;251;901;348;1015;599;1916
312820;202003;1705;4571;1346;3945;39;160;1020;2918;1059;3078
312825;202003;1277;3043;1103;2814;19;67;942;2359;961;2426
312830;202003;2748;7761;1586;5331;335;1275;379;1212;714;2487
312840;202003;1206;3387;940;2915;99;398;476;1384;575;1782
312850;202003;860;2103;605;1728;26;104;360;944;386;1048
312860;202003;1132;2924;762;2352;199;662;173;485;372;1147
312870;202003;5934;16046;3600;11516;622;2136;786;2382;1408;4518
312880;202003;1365;3452;1047;2905;34;126;621;1722;655;1848
312890;202003;2138;5458;1510;4384;96;285;777;2294;873;2579
312900;202003;1136;2897;918;2630;75;246;515;1611;590;1857
312910;202003;1574;2910;822;1924;144;282;319;753;463;1035
312920;202003;968;2614;656;2086;117;434;276;811;393;1245
312930;202003;2218;5503;1705;4745;371;1060;773;2163;1144;3223
312940;202003;925;2542;717;2234;75;284;358;1055;433;1339
312950;202003;3082;7654;1987;5860;520;1680;627;1789;1147;3469
312960;202003;1774;4751;1496;4311;67;177;1167;3458;1234;3635
312965;202003;1577;4462;1317;4040;112;365;914;2761;1026;3126
312970;202003;1261;3547;971;3070;147;566;551;1620;698;2186
312980;202003;21638;59831;17349;52176;3303;10958;8578;24285;11881;35243
312990;202003;462;1191;285;876;50;169;132;395;182;564
313000;202003;479;1365;360;1144;28;120;212;626;240;746
313005;202003;2442;7074;2046;6398;160;487;1447;4488;1607;4975
313010;202003;4805;13288;3805;11654;681;2285;2209;6627;2890;8912
313020;202003;934;2853;631;2148;109;397;123;360;232;757
313030;202003;1055;2476;707;1957;72;255;466;1225;538;1480
313040;202003;748;2293;613;2019;43;179;362;1135;405;1314
313050;202003;1697;4703;1173;3902;196;795;379;1113;575;1908
313055;202003;1851;5017;1633;4697;52;169;1406;4021;1458;4190
313060;202003;938;2252;675;1807;181;590;128;303;309;893
313065;202003;1586;4787;1384;4449;50;205;1068;3341;1118;3546
313070;202003;921;2455;691;2045;72;224;395;1144;467;1368
313080;202003;363;1008;256;793;51;183;92;237;143;420
313090;202003;4953;13285;4211;12084;319;1070;2826;8020;3145;9090
313100;202003;1304;3395;1000;2956;28;119;763;2195;791;2314
313110;202003;1413;3747;1016;3051;90;348;581;1621;671;1969
313115;202003;2451;7146;1978;6227;256;900;1040;3068;1296;3968
313120;202003;3679;8666;2670;7339;226;718;1728;4711;1954;5429
313130;202003;29481;76745;22350;63558;2446;7892;12599;33863;15045;41755
313140;202003;584;1287;344;935;26;68;232;638;258;706
313150;202003;1328;3737;978;3091;299;1033;221;625;520;1658
313160;202003;1066;2709;830;2340;28;100;629;1736;657;1836
313170;202003;10864;30930;7686;24965;1322;4688;3033;9293;4355;13981
313180;202003;2040;5414;1434;4212;179;550;816;2356;995;2906
313190;202003;3982;11387;2879;9176;541;1869;988;2937;1529;4806
313200;202003;1038;2922;901;2684;15;64;766;2210;781;2274
313210;202003;3677;10756;2987;9517;355;1297;1804;5520;2159;6817
313220;202003;1661;4377;1082;3237;165;558;435;1157;600;1715
313230;202003;2915;8251;2412;7652;47;181;2009;6512;2056;6693
313240;202003;9271;22698;5643;16838;961;3313;2362;6535;3323;9848
313250;202003;6131;17992;4582;14717;835;2711;1985;6253;2820;8964
313260;202003;577;1520;407;1212;52;206;201;555;253;761
313270;202003;5569;14220;4424;12589;561;1580;2941;8590;3502;10170
313280;202003;435;1234;279;912;36;129;116;363;152;492
313290;202003;925;2855;679;2422;215;833;221;768;436;1601
313300;202003;1516;4065;1077;3283;279;917;238;632;517;1549
313310;202003;1055;3110;800;2572;126;473;216;586;342;1059
313320;202003;2052;5472;1462;4508;258;908;619;1914;877;2822
313330;202003;3990;10526;2996;9016;165;658;1959;5854;2124;6512
313340;202003;1351;3052;949;2496;84;238;658;1727;742;1965
313350;202003;2453;6980;1554;4885;208;713;552;1533;760;2246
313360;202003;1308;3225;868;2522;141;501;432;1163;573;1664
313370;202003;1340;3803;1105;3334;132;473;626;1745;758;2218
313375;202003;1642;4267;975;3014;177;607;208;604;385;1211
313380;202003;5848;14697;4103;11489;759;2373;1883;4696;2642;7069
313390;202003;796;2566;689;2385;49;233;458;1517;507;1750
313400;202003;3668;9105;2823;7933;154;483;2169;5999;2323;6482
313410;202003;1260;3317;960;2776;55;195;703;1986;758;2181
313420;202003;14750;32734;7244;20058;1631;5050;1028;2815;2659;7865
313430;202003;895;2643;671;2182;122;492;277;793;399;1285
313440;202003;6100;13324;3975;10510;380;1056;2434;6439;2814;7495
313450;202003;693;1875;474;1418;75;239;162;418;237;657
313460;202003;2044;5897;1620;5225;322;1180;766;2341;1088;3521
313470;202003;2795;7208;2189;6312;253;725;1407;4113;1660;4838
313480;202003;971;2806;525;1779;68;263;148;454;216;717
313490;202003;2491;6036;1163;3640;304;1054;184;572;488;1626
313500;202003;446;1293;345;1068;44;128;125;375;169;503
313505;202003;9766;26086;8299;24083;325;1156;6692;19405;7017;20561
313507;202003;1424;3756;1159;3348;26;110;939;2653;965;2763
313510;202003;13175;36500;10277;30865;1216;3886;4914;14396;6130;18282
313520;202003;13915;39499;11035;34503;595;2261;8154;24927;8749;27188
313530;202003;513;1519;383;1238;44;152;153;451;197;603
313535;202003;2339;6492;1956;5747;260;692;1201;3527;1461;4219
313540;202003;743;2207;590;1838;110;354;249;727;359;1081
313545;202003;1132;3734;941;3335;153;567;508;1738;661;2305
313550;202003;1703;5211;1395;4485;316;1138;699;2138;1015;3276
313560;202003;2582;5157;1921;4348;59;111;1617;3689;1676;3800
313570;202003;912;2725;739;2400;178;606;308;956;486;1562
313580;202003;5418;14391;4135;12232;491;1546;2364;7097;2855;8643
313590;202003;958;2740;764;2465;197;668;345;1183;542;1851
313600;202003;3875;10502;3203;9451;92;386;2662;7708;2754;8094
313610;202003;981;2498;784;2164;89;274;488;1277;577;1551
313620;202003;5390;14276;4189;12073;542;1723;2367;6599;2909;8322
313630;202003;8280;20030;5739;16202;574;1889;3418;9474;3992;11363
313640;202003;1010;2347;624;1847;151;465;238;736;389;1201
313650;202003;1695;5069;1342;4467;91;362;890;2987;981;3349
313652;202003;723;2320;650;2164;107;390;404;1301;511;1691
313655;202003;1108;2836;876;2537;48;151;688;1985;736;2136
313657;202003;1169;3132;922;2742;40;155;683;1914;723;2069
313660;202003;847;2402;680;2097;81;296;409;1195;490;1491
313665;202003;4545;12243;3474;10292;405;1344;2129;6045;2534;7389
313670;202003;47502;116167;29680;85836;4432;14089;12852;35217;17284;49306
313680;202003;1007;2696;824;2400;60;205;552;1557;612;1762
313690;202003;750;2325;567;1986;143;555;146;496;289;1051
313695;202003;1757;4826;1338;4130;85;275;904;2796;989;3071
313700;202003;2857;9246;2460;8714;245;921;1846;6549;2091;7470
313710;202003;1351;3145;970;2635;75;212;641;1763;716;1975
313720;202003;5237;14471;3596;11035;581;1996;1460;4069;2041;6065
313730;202003;1273;2921;961;2492;77;175;634;1636;711;1811
313740;202003;1605;5741;1313;4979;315;1375;229;747;544;2122
313750;202003;1903;5096;1433;4253;261;856;674;1877;935;2733
313753;202003;2048;4935;1348;3814;129;391;768;2108;897;2499
313760;202003;4937;13628;3644;11134;775;2597;1549;4429;2324;7026
313770;202003;3876;10965;3047;9615;200;665;2239;7150;2439;7815
313780;202003;3921;10536;2813;8647;237;857;809;2558;1046;3415
313790;202003;459;1443;408;1348;46;167;232;750;278;917
313800;202003;1340;3090;969;2556;124;380;519;1303;643;1683
313810;202003;1541;3978;1216;3512;45;181;939;2643;984;2824
313820;202003;17227;43759;10682;29841;1687;4979;2947;7979;4634;12958
313830;202003;369;1060;251;774;49;160;78;221;127;381
313835;202003;896;2656;734;2356;59;243;409;1232;468;1475
313840;202003;6641;17337;4836;14316;1213;3814;1020;3096;2233;6910
313850;202003;934;2294;740;2031;132;445;357;861;489;1306
313860;202003;2486;6721;1844;5497;288;985;768;2110;1056;3095
313862;202003;1349;2846;644;1804;41;123;318;894;359;1017
313865;202003;2458;6611;2021;5896;80;257;1523;4363;1603;4620
313867;202003;1243;3754;1030;3357;142;460;666;2213;808;2673
313868;202003;1674;5170;1370;4550;44;224;1053;3389;1097;3613
313870;202003;726;1961;517;1576;94;301;193;536;287;837
313880;202003;1561;4107;1132;3382;157;514;528;1415;685;1929
313890;202003;2004;4371;1504;3718;47;154;1115;2689;1162;2843
313900;202003;3968;11579;2815;9204;738;2653;672;2022;1410;4675
313910;202003;616;1827;462;1536;95;350;102;328;197;678
313920;202003;2882;8936;2412;7948;502;1643;1191;3954;1693;5597
313925;202003;1524;3909;1215;3357;183;490;785;2159;968;2649
313930;202003;4533;13819;3666;12243;268;1022;2397;7914;2665;8936
313940;202003;8272;24028;5867;19838;779;3222;1457;5420;2236;8642
313950;202003;5031;11302;3628;9562;412;1345;2170;5685;2582;7030
313960;202003;5385;13256;3546;10144;740;2375;1143;3016;1883;5391
313970;202003;1434;3931;1192;3521;15;50;769;2230;784;2280
313980;202003;1329;3444;869;2719;135;490;340;1003;475;1493
313990;202003;1815;5861;1277;4589;341;1394;385;1217;726;2611
314000;202003;9218;23928;7728;21380;555;1980;5174;14176;5729;16156
314010;202003;1441;3499;1123;3060;45;155;846;2236;891;2391
314015;202003;1839;5104;1379;4315;188;699;727;2229;915;2928
314020;202003;448;1222;292;953;64;253;59;207;123;460
314030;202003;737;2124;580;1821;56;185;313;971;369;1156
314040;202003;609;1641;485;1412;71;239;261;725;332;964
314050;202003;1737;4633;1244;3720;151;529;647;1803;798;2332
314053;202003;1749;5249;1395;4538;265;859;734;2478;999;3337
314055;202003;2255;6095;1900;5537;43;167;1558;4538;1601;4705
314060;202003;1238;3324;924;2820;38;149;638;1921;676;2070
314070;202003;4484;12412;3482;10588;724;2202;1512;4543;2236;6745
314080;202003;2031;5324;1364;4167;181;660;569;1568;750;2228
314085;202003;2073;5904;1683;5291;226;749;954;3058;1180;3807
314090;202003;4399;12015;3748;11043;232;884;2392;7159;2624;8043
314100;202003;3075;7309;2372;6332;41;119;1799;4809;1840;4928
314110;202003;4379;12434;3540;10829;382;1373;2058;5909;2440;7282
314120;202003;756;1770;307;924;64;233;67;186;131;419
314130;202003;586;1512;356;1101;24;98;220;673;244;771
314140;202003;4435;12686;3483;10837;472;1570;1743;5310;2215;6880
314150;202003;1444;3623;1052;2946;88;257;702;1914;790;2171
314160;202003;2088;5571;1509;4509;204;678;650;1948;854;2626
314170;202003;897;2563;718;2208;44;169;466;1344;510;1513
314180;202003;5303;14798;4265;13117;354;1175;2583;7951;2937;9126
314190;202003;591;1480;409;1205;75;239;186;501;261;740
314200;202003;2855;8043;2320;7127;141;501;1647;4930;1788;5431
314210;202003;1926;5125;1514;4364;170;512;763;2169;933;2681
314220;202003;1291;3549;915;2895;196;709;339;984;535;1693
314225;202003;1068;3009;876;2703;75;194;629;2005;704;2199
314230;202003;738;1915;600;1746;68;227;395;1171;463;1398
314240;202003;977;2665;746;2303;186;600;289;904;475;1504
314250;202003;498;1401;315;1022;49;158;114;340;163;498
314260;202003;916;2511;716;2235;159;541;394;1192;553;1733
314270;202003;3257;9252;2665;8321;78;327;1954;6047;2032;6374
314280;202003;3324;7734;2183;5982;261;799;1169;3053;1430;3852
314290;202003;4411;11483;3595;10019;289;838;2449;6684;2738;7522
314300;202003;1891;5431;1222;3978;250;902;395;1217;645;2119
314310;202003;4028;10475;2662;8115;861;2873;430;1167;1291;4040
314315;202003;894;3106;762;2830;52;248;538;1923;590;2171
314320;202003;2814;7730;1793;5766;331;1160;658;2055;989;3215
314330;202003;48644;136401;36517;114680;9768;32108;7526;24919;17294;57027
314340;202003;2230;5522;1298;3831;265;915;328;822;593;1737
314345;202003;1366;4089;1107;3613;150;500;642;2074;792;2574
314350;202003;797;2176;503;1638;111;390;121;347;232;737
314360;202003;556;1612;338;1135;48;181;111;336;159;517
314370;202003;699;1897;556;1683;30;109;404;1181;434;1290
314380;202003;1108;3026;736;2351;163;599;161;502;324;1101
314390;202003;12180;31115;7626;22697;1557;4985;2352;6366;3909;11351
314400;202003;3871;11569;2899;9678;743;2564;1079;3747;1822;6311
314410;202003;2659;7397;1817;5816;248;910;620;2108;868;3018
314420;202003;803;2000;577;1633;42;161;386;1014;428;1175
314430;202003;7409;18322;5081;14372;763;2282;2325;6289;3088;8571
314435;202003;1685;4557;1323;3941;50;195;982;2865;1032;3060
314437;202003;893;2306;646;1884;68;221;315;908;383;1129
314440;202003;607;1737;424;1358;118;418;85;227;203;645
314450;202003;1367;3659;1135;3292;115;382;667;1854;782;2236
314460;202003;3182;9686;2291;7788;584;2106;536;1755;1120;3861
314465;202003;2150;6238;1824;5615;50;197;1396;4155;1446;4352
314467;202003;847;2260;715;2048;18;56;577;1607;595;1663
314470;202003;2058;5917;1641;5059;281;960;756;2177;1037;3137
314480;202003;6309;18045;4530;14273;766;2686;1639;4584;2405;7270
314490;202003;1026;2793;744;2198;61;201;463;1308;524;1509
314500;202003;1686;4041;1194;3347;299;823;423;1234;722;2057
314505;202003;2004;4938;1624;4394;101;290;1175;3100;1276;3390
314510;202003;1809;4777;1255;3918;243;853;550;1691;793;2544
314520;202003;4797;14758;3495;11979;717;2685;428;1304;1145;3989
314530;202003;5296;17178;4732;16078;316;1351;3464;11493;3780;12844
314535;202003;2490;6541;2003;5830;89;328;1531;4411;1620;4739
314537;202003;1072;3058;821;2649;46;179;589;1868;635;2047
314540;202003;378;943;249;717;17;60;139;380;156;440
314545;202003;1791;4416;1595;4188;33;99;1373;3707;1406;3806
314550;202003;626;1558;466;1329;35;133;255;661;290;794
314560;202003;3979;12113;2921;9714;471;1748;1003;3022;1474;4770
314570;202003;292;805;215;662;27;99;94;289;121;388
314580;202003;420;1260;324;1065;85;287;102;329;187;616
314585;202003;636;1993;477;1638;66;282;206;681;272;963
314587;202003;1964;5352;1483;4578;201;575;841;2685;1042;3260
314590;202003;3775;10401;2655;8249;370;1300;1121;3235;1491;4535
314600;202003;1854;5064;1059;3517;205;737;127;391;332;1128
314610;202003;8567;21489;5940;17557;1011;3559;2466;7467;3477;11026
314620;202003;2190;5173;1724;4579;38;131;1433;3789;1471;3920
314625;202003;1464;4133;1249;3833;32;201;1070;3208;1102;3409
314630;202003;5194;13438;4224;12140;108;461;3536;10168;3644;10629
314640;202003;643;1550;459;1263;60;192;250;648;310;840
314650;202003;780;1782;460;1285;41;136;250;612;291;748
314655;202003;1568;4339;1105;3496;162;509;543;1698;705;2207
314660;202003;317;726;203;520;13;29;130;320;143;349
314670;202003;1599;3666;1095;2943;16;49;731;1943;747;1992
314675;202003;1663;4452;1411;4026;75;253;1099;3050;1174;3303
314690;202003;2028;5682;1546;4958;414;1466;530;1674;944;3140
314700;202003;9709;27262;6287;20598;1217;4403;1870;5989;3087;10392
314710;202003;7460;20941;5329;16444;922;3132;1806;4885;2728;8017
314720;202003;1968;5808;1333;4493;284;1078;356;1124;640;2202
314730;202003;2088;5598;1490;4496;263;863;547;1562;810;2425
314740;202003;2790;7929;2154;6777;283;961;1079;3323;1362;4284
314750;202003;296;804;226;662;28;95;135;357;163;452
314760;202003;1815;5506;1136;3908;172;684;263;727;435;1411
314770;202003;1058;3107;552;1790;43;155;163;489;206;644
314780;202003;340;804;226;629;42;142;119;289;161;431
314790;202003;9947;26767;6717;20760;1444;5188;2241;6386;3685;11574
314795;202003;1431;3854;1199;3441;28;121;949;2622;977;2743
314800;202003;10370;26257;6088;18270;1119;3732;1422;3763;2541;7495
314810;202003;8432;22312;6064;18147;1502;4882;2074;5913;3576;10795
314820;202003;1161;2853;902;2466;50;194;575;1511;625;1705
314830;202003;1418;4347;1173;3877;217;797;571;1844;788;2641
314840;202003;837;2654;661;2368;48;238;469;1614;517;1852
314850;202003;1933;4655;1559;4174;38;123;1351;3646;1389;3769
314860;202003;3125;9257;2571;8238;205;822;1752;5465;1957;6287
314870;202003;6222;15912;4691;13850;268;881;3457;10309;3725;11190
314875;202003;1730;5182;1499;4878;105;283;1208;4009;1313;4292
314880;202003;812;1997;622;1705;25;73;381;1047;406;1120
314890;202003;410;1223;310;1011;49;183;133;407;182;590
314900;202003;675;1854;520;1577;86;297;216;618;302;915
314910;202003;1589;4528;1164;3828;215;821;547;1678;762;2499
314915;202003;2152;6437;1801;5822;114;381;1189;3803;1303;4184
314920;202003;454;1180;287;923;8;26;191;632;199;658
314930;202003;5164;14610;3836;12126;667;2307;1507;4457;2174;6764
314940;202003;385;982;316;861;29;76;204;528;233;604
314950;202003;484;1235;312;945;27;108;162;439;189;547
314960;202003;772;1857;593;1570;26;82;431;1089;457;1171
314970;202003;857;2475;642;2032;131;460;271;776;402;1236
314980;202003;1435;3681;1047;3108;188;646;490;1420;678;2066
314990;202003;2279;6558;1555;4917;318;1082;315;895;633;1977
314995;202003;1558;4366;1231;3772;39;174;821;2389;860;2563
315000;202003;1096;2791;777;2301;62;198;511;1493;573;1691
315010;202003;367;1029;278;869;44;160;134;393;178;553
315015;202003;2216;6273;1918;5769;186;632;1264;3733;1450;4365
315020;202003;784;2283;551;1753;73;289;235;677;308;966
315030;202003;539;1439;351;1086;82;253;80;225;162;478
315040;202003;810;2278;652;1999;85;282;398;1210;483;1492
315050;202003;1173;3040;828;2483;50;183;435;1276;485;1459
315053;202003;1061;2780;807;2332;48;151;472;1312;520;1463
315057;202003;1692;5157;1367;4577;139;468;913;3090;1052;3558
315060;202003;531;1618;389;1341;73;265;102;335;175;600
315070;202003;496;1315;335;1034;78;267;90;258;168;525
315080;202003;2794;7968;2106;6634;252;862;1265;3818;1517;4680
315090;202003;765;2333;552;1919;81;301;212;720;293;1021
315100;202003;1211;3657;755;2598;140;544;313;976;453;1520
315110;202003;1754;4312;1265;3550;134;361;630;1828;764;2189
315120;202003;11520;27188;8404;22437;1141;2846;4502;12499;5643;15345
315130;202003;1340;3805;1092;3378;126;453;449;1315;575;1768
315140;202003;2834;7887;2160;6670;389;1311;1066;3112;1455;4423
315150;202003;4223;10139;2922;8053;449;1449;1375;3674;1824;5123
315160;202003;1664;4120;1087;3191;239;741;483;1420;722;2161
315170;202003;1336;4245;913;3222;222;862;207;695;429;1557
315180;202003;15866;38307;8172;24120;1133;3783;2496;6496;3629;10279
315190;202003;2078;4612;1590;3970;183;441;1179;2974;1362;3415
315200;202003;3756;10782;2670;8820;770;2742;704;2231;1474;4973
315210;202003;7949;20872;5339;15271;632;1953;2610;6773;3242;8726
315213;202003;1083;2852;927;2639;19;65;773;2174;792;2239
315217;202003;2699;7949;2044;6837;85;443;1413;4509;1498;4952
315220;202003;8158;22244;6353;19015;1150;3650;2664;8003;3814;11653
315230;202003;3041;7189;2539;6536;194;300;1940;5328;2134;5628
315240;202003;2395;7060;2017;6391;459;1513;972;3081;1431;4594
315250;202003;11856;32271;8268;25364;1356;4534;3438;10114;4794;14648
315260;202003;897;2492;475;1573;79;264;37;102;116;366
315270;202003;803;2308;565;1849;78;269;192;542;270;811
315280;202003;2828;7057;1653;4926;412;1346;261;755;673;2101
315290;202003;1137;2791;663;2039;189;650;189;549;378;1199
315300;202003;584;1421;387;1136;90;303;185;539;275;842
315310;202003;1243;3508;915;2874;76;267;514;1529;590;1796
315320;202003;643;1885;447;1486;66;264;191;584;257;848
315330;202003;737;2533;400;1606;64;299;125;449;189;748
315340;202003;2924;7132;2104;5952;248;744;1152;3233;1400;3977
315350;202003;1523;4157;1176;3615;165;594;654;1984;819;2578
315360;202003;1622;4824;1206;3943;188;660;480;1486;668;2146
315370;202003;449;1326;353;1129;64;191;146;455;210;646
315380;202003;183;547;133;436;30;102;29;66;59;168
315390;202003;1021;2916;804;2509;146;526;362;1042;508;1568
315400;202003;3846;10671;3011;9145;435;1390;1602;4702;2037;6092
315410;202003;2200;5105;1645;4301;453;1251;231;673;684;1924
315415;202003;1319;3616;1058;3226;217;770;427;1327;644;2097
315420;202003;1277;3674;849;2831;175;614;154;490;329;1104
315430;202003;3548;8667;2480;7038;447;1490;1068;2822;1515;4312
315440;202003;983;2617;783;2289;65;220;466;1286;531;1506
315445;202003;1908;4643;1362;3864;82;276;990;2761;1072;3037
315450;202003;2174;6142;1772;5492;222;673;1104;3431;1326;4104
315460;202003;34691;97171;28440;85910;4493;15307;15221;43360;19714;58667
315470;202003;592;1706;411;1250;30;105;244;709;274;814
315480;202003;1140;3290;793;2543;154;521;256;794;410;1315
315490;202003;2805;7101;1911;5655;286;873;686;1978;972;2851
315500;202003;501;1352;301;911;41;146;142;375;183;521
315510;202003;1187;3126;1007;2870;23;105;875;2449;898;2554
315520;202003;969;2706;778;2374;53;200;586;1738;639;1938
315530;202003;553;1573;436;1370;128;456;215;630;343;1086
315540;202003;1345;3667;932;2881;98;362;416;1258;514;1620
315550;202003;1892;4932;1223;3686;258;889;296;885;554;1774
315560;202003;6169;18800;5199;17020;294;933;3468;11594;3762;12527
315570;202003;1946;5310;1556;4674;86;327;929;2704;1015;3031
315580;202003;2625;6232;1945;5173;276;868;752;1881;1028;2749
315590;202003;840;2168;641;1849;70;250;353;957;423;1207
315600;202003;2410;7653;1718;6271;254;882;900;3431;1154;4313
315610;202003;899;2308;661;1860;105;367;291;711;396;1078
315620;202003;473;1286;346;1087;43;160;203;645;246;805
315630;202003;959;2548;693;2063;129;401;298;813;427;1214
315640;202003;345;861;258;753;28;108;156;430;184;538
315645;202003;931;2405;625;1903;152;501;155;452;307;953
315650;202003;1677;4083;1335;3602;33;111;1095;2869;1128;2980
315660;202003;2399;5945;1792;4887;98;302;1275;3343;1373;3645
315670;202003;13061;35892;9877;30083;1956;6237;4422;12978;6378;19215
315680;202003;3000;8804;2176;7217;303;1157;1097;3458;1400;4615
315690;202003;3165;7725;1832;5399;397;1183;554;1764;951;2947
315700;202003;7615;21386;5692;17474;901;2954;2562;7507;3463;10461
315710;202003;1811;4532;1274;3711;41;190;905;2526;946;2716
315720;202003;4243;11845;3578;10662;170;691;2566;7338;2736;8029
315725;202003;2048;5456;1578;4627;138;388;1068;3208;1206;3596
315727;202003;534;1384;397;1161;53;178;158;452;211;630
315730;202003;553;1736;485;1588;79;295;187;577;266;872
315733;202003;1125;2867;797;2305;116;408;309;844;425;1252
315737;202003;1106;3205;870;2729;31;137;617;1866;648;2003
315740;202003;798;2233;628;1889;73;256;393;1106;466;1362
315750;202003;1256;3325;977;2866;89;273;594;1771;683;2044
315760;202003;1094;2632;965;2465;42;118;819;2055;861;2173
315765;202003;1845;4961;1504;4518;24;111;1323;3955;1347;4066
315770;202003;989;2758;751;2423;310;1095;150;408;460;1503
315780;202003;27243;74734;22718;66810;1322;4839;15800;44625;17122;49464
315790;202003;3509;10900;2970;9857;391;1360;1759;5928;2150;7288
315800;202003;1197;4241;858;3342;131;581;257;885;388;1466
315810;202003;1283;3212;1038;2784;55;187;804;2067;859;2254
315820;202003;2517;6881;2035;6175;169;623;1416;4252;1585;4875
315830;202003;1175;3488;801;2682;82;299;278;869;360;1168
315840;202003;800;1950;541;1490;44;140;261;663;305;803
315850;202003;1131;3375;889;2934;180;633;427;1334;607;1967
315860;202003;454;1309;311;1047;69;243;90;272;159;515
315870;202003;449;1176;357;1033;18;62;255;701;273;763
315880;202003;1017;2670;665;2040;89;342;160;464;249;806
315890;202003;1624;4676;1296;4214;326;1146;628;2021;954;3167
315895;202003;5833;15780;4347;12874;422;1410;2268;6261;2690;7671
315900;202003;791;2047;677;1882;57;174;508;1371;565;1545
315910;202003;500;1414;421;1289;56;190;293;876;349;1066
315920;202003;1420;3618;756;2351;123;450;233;674;356;1124
315930;202003;1059;2402;698;1882;130;336;302;829;432;1165
315935;202003;773;2328;606;2009;115;408;210;695;325;1103
315940;202003;579;1621;461;1437;50;171;245;728;295;899
315950;202003;1130;3134;925;2797;81;240;709;2146;790;2386
315960;202003;4267;12099;2559;8626;822;3174;205;440;1027;3614
315970;202003;612;1628;483;1459;61;209;317;961;378;1170
315980;202003;4139;9055;2219;5907;389;1105;792;1938;1181;3043
315990;202003;3571;9098;2775;7737;262;783;1589;4302;1851;5085
316000;202003;547;1400;406;1199;52;191;194;534;246;725
316010;202003;817;2178;599;1811;44;149;371;1049;415;1198
316020;202003;889;2746;716;2405;82;326;423;1330;505;1656
316030;202003;2690;7621;2025;6416;239;776;1274;4096;1513;4872
316040;202003;2263;6459;1638;5285;296;1084;383;1065;679;2149
316045;202003;2012;5288;1840;5079;70;153;1593;4510;1663;4663
316050;202003;352;986;268;845;33;117;154;464;187;581
316060;202003;652;1646;473;1378;19;84;333;933;352;1017
316070;202003;5151;14398;4175;12536;723;2239;1973;5777;2696;8016
316080;202003;719;2265;559;1938;139;500;80;259;219;759
316090;202003;384;1118;277;897;36;127;137;409;173;536
316095;202003;1247;3911;990;3250;267;915;320;1034;587;1949
316100;202003;2358;6962;1684;5510;312;1117;616;1845;928;2962
316105;202003;770;2136;631;1910;38;130;449;1374;487;1504
316110;202003;13273;38868;11046;35095;790;2949;7485;23489;8275;26438
316120;202003;1133;3259;704;2234;117;396;205;537;322;933
316130;202003;1250;2850;788;2084;61;191;451;1167;512;1358
316140;202003;1150;3102;731;2321;96;324;363;1133;459;1457
316150;202003;1785;3907;1458;3483;171;533;608;1395;779;1928
316160;202003;961;2648;788;2346;35;128;545;1572;580;1700
316165;202003;831;2086;635;1769;94;317;336;861;430;1178
316170;202003;1089;2737;804;2304;51;185;548;1513;599;1698
316180;202003;1292;3666;848;2731;139;534;156;456;295;990
316190;202003;2476;7036;1433;4555;217;724;530;1509;747;2233
316200;202003;3079;8893;2263;7450;564;1978;509;1648;1073;3626
316210;202003;4357;12845;3151;10097;1149;3970;194;512;1343;4482
316220;202003;577;1763;383;1318;96;380;44;167;140;547
316225;202003;1512;3461;1115;2812;46;178;837;1958;883;2136
316230;202003;391;1073;295;905;33;106;170;526;203;632
316240;202003;5450;15847;4763;14650;356;1190;3614;10936;3970;12126
316245;202003;2850;9412;2559;8912;123;713;1975;6558;2098;7271
316250;202003;9530;23140;6838;18872;1473;4486;2398;6573;3871;11059
316255;202003;2908;8087;2532;7476;118;367;1909;5698;2027;6065
316257;202003;1293;3217;906;2523;134;370;483;1307;617;1677
316260;202003;1970;5142;1495;4333;138;424;789;2351;927;2775
316265;202003;1119;3006;862;2572;21;73;632;1834;653;1907
316270;202003;3551;11061;3029;9897;489;1720;1441;4491;1930;6211
316280;202003;2727;7968;2310;7165;317;1064;1290;3895;1607;4959
316290;202003;3367;9261;2679;8001;295;1045;1148;3314;1443;4359
316292;202003;4828;12941;3835;11253;479;1533;2499;7060;2978;8593
316294;202003;781;2329;573;1961;98;381;153;499;251;880
316295;202003;2922;8238;2363;7276;138;521;1656;4865;1794;5386
316300;202003;962;2799;788;2528;48;173;565;1801;613;1974
316310;202003;747;1995;481;1532;103;391;80;220;183;611
316320;202003;608;1724;459;1473;53;205;219;688;272;893
316330;202003;1040;2761;775;2282;42;171;580;1637;622;1808
316340;202003;970;2669;721;2213;69;281;411;1185;480;1466
316350;202003;1258;3591;1042;3246;91;311;727;2238;818;2549
316360;202003;609;1622;490;1419;48;147;359;1016;407;1163
316370;202003;4733;12774;3462;10437;681;2370;1233;3288;1914;5658
316380;202003;1665;3994;1294;3476;45;108;934;2516;979;2624
316390;202003;782;2092;549;1680;223;777;95;261;318;1038
316400;202003;1103;3141;699;2324;112;412;232;695;344;1107
316410;202003;1050;3013;878;2758;64;208;689;2133;753;2341
316420;202003;1904;5228;1654;4904;48;187;1370;3980;1418;4167
316430;202003;817;2170;512;1622;95;332;155;461;250;793
316440;202003;685;2143;544;1900;113;456;129;430;242;886
316443;202003;520;1453;378;1178;99;356;78;219;177;575
316447;202003;1868;5105;1627;4706;31;119;1372;3904;1403;4023
316450;202003;2084;6393;1587;5355;207;759;953;3122;1160;3881
316460;202003;1039;2678;830;2345;128;404;517;1371;645;1775
316470;202003;6373;18342;4485;14344;729;2672;1729;5081;2458;7753
316480;202003;194;533;160;484;39;115;78;232;117;347
316490;202003;309;831;220;671;28;91;85;219;113;310
316500;202003;1109;3521;727;2592;153;602;161;550;314;1152
316510;202003;719;2369;576;2093;115;431;265;970;380;1401
316520;202003;1137;2806;861;2354;115;396;439;1101;554;1497
316530;202003;1065;2801;762;2259;86;340;386;1013;472;1353
316540;202003;799;2086;616;1802;108;364;292;780;400;1144
316550;202003;1342;3921;1143;3530;53;188;889;2726;942;2914
316553;202003;3824;11495;2631;8543;424;1540;895;2595;1319;4135
316555;202003;2403;7814;2184;7516;106;395;1792;6223;1898;6618
316556;202003;518;1289;371;1031;29;87;205;520;234;607
316557;202003;999;3136;854;2891;289;1052;269;894;558;1946
316560;202003;330;918;225;756;51;222;71;199;122;421
316570;202003;1167;3433;956;3041;233;750;357;1151;590;1901
316580;202003;377;803;217;540;36;105;108;252;144;357
316590;202003;1276;3328;893;2575;181;481;459;1286;640;1767
316600;202003;915;2837;783;2567;125;442;420;1350;545;1792
316610;202003;564;1801;460;1642;48;224;278;955;326;1179
316620;202003;1919;5272;1675;4931;86;271;1295;3829;1381;4100
316630;202003;1500;4534;1220;4005;321;1065;494;1746;815;2811
316640;202003;139;368;108;321;17;56;50;125;67;181
316650;202003;1008;3235;807;2921;74;299;500;1837;574;2136
316660;202003;179;453;77;240;7;24;12;35;19;59
316670;202003;1756;4479;1281;3696;297;938;478;1345;775;2283
316680;202003;2215;5663;1617;4524;92;277;1241;3387;1333;3664
316690;202003;1316;3779;979;3154;175;628;448;1398;623;2026
316695;202003;1001;2911;815;2571;35;147;556;1719;591;1866
316700;202003;384;901;315;819;14;46;244;592;258;638
316710;202003;2913;9620;2209;8133;461;1813;865;3173;1326;4986
316720;202003;19482;53503;14125;43161;2523;8201;5909;17213;8432;25414
316730;202003;400;1113;321;959;41;139;166;461;207;600
316740;202003;668;2005;571;1846;65;244;358;1156;423;1400
316750;202003;370;1119;284;957;57;225;131;405;188;630
316760;202003;3464;11064;2819;9763;1128;4229;614;2006;1742;6235
316770;202003;1589;3675;1215;3149;24;74;992;2643;1016;2717
316780;202003;529;1587;406;1343;164;609;59;164;223;773
316790;202003;673;1814;471;1410;97;314;143;385;240;699
316800;202003;5949;16929;4724;14677;473;1704;2479;7422;2952;9126
316805;202003;985;2191;790;1978;60;168;612;1545;672;1713
316810;202003;602;1694;403;1281;73;266;205;610;278;876
316820;202003;293;704;160;466;9;32;79;213;88;245
316830;202003;688;1872;543;1635;69;255;349;1005;418;1260
316840;202003;2672;7036;2126;6098;189;680;1442;3933;1631;4613
316850;202003;1846;4910;1304;3915;205;663;578;1694;783;2357
316860;202003;18666;48198;13667;40657;2198;7590;6216;18052;8414;25642
316870;202003;7448;20435;5479;16624;822;2777;2460;6965;3282;9742
316880;202003;809;2198;652;1979;134;459;303;870;437;1329
316890;202003;1101;2458;632;1819;93;336;367;964;460;1300
316900;202003;2132;5819;1626;4792;330;1077;531;1448;861;2525
316905;202003;505;1512;403;1310;101;359;161;535;262;894
316910;202003;870;2289;526;1668;134;466;45;131;179;597
316920;202003;1626;4085;1095;3261;204;655;466;1353;670;2008
316930;202003;7181;20894;5211;17265;1169;4159;1362;4303;2531;8462
316935;202003;3911;10681;2826;8633;505;1664;1136;3342;1641;5006
316940;202003;6242;18448;4740;15298;729;2613;1848;5547;2577;8160
316950;202003;1822;4320;1413;3759;43;137;1170;3064;1213;3201
316960;202003;4986;11295;3575;9339;346;998;2410;6146;2756;7144
316970;202003;3607;10349;3127;9434;486;1540;1335;3848;1821;5388
316980;202003;635;1914;476;1608;152;572;68;240;220;812
316990;202003;10316;28155;7178;21646;1956;6395;1029;2789;2985;9184
317000;202003;2503;7429;2207;6996;162;490;1635;5206;1797;5696
317005;202003;2517;7227;1981;6118;319;1041;1038;3154;1357;4195
317010;202003;23223;54503;14127;40582;2903;9177;5195;15446;8098;24623
317020;202003;61874;147111;34961;100092;6411;20179;10581;28016;16992;48195
317030;202003;656;1762;506;1558;18;83;389;1182;407;1265
317040;202003;10715;27254;7386;21471;1628;5117;2660;7923;4288;13040
317043;202003;837;1895;592;1554;55;153;425;1103;480;1256
317047;202003;1130;2748;775;2173;87;247;476;1301;563;1548
317050;202003;1149;3539;802;2732;110;392;331;996;441;1388
317052;202003;2290;6536;1838;5792;281;882;1102;3499;1383;4381
317057;202003;1795;4380;1311;3575;35;139;850;2293;885;2432
317060;202003;439;1168;258;796;30;106;113;310;143;416
317065;202003;1142;3385;931;2971;53;186;581;1746;634;1932
317070;202003;7339;20125;5081;15773;978;3427;1431;4192;2409;7619
317075;202003;878;2284;621;1830;100;335;265;705;365;1040
317080;202003;5967;14055;4385;11510;1183;3350;1420;3579;2603;6929
317090;202003;4372;13176;3883;12375;298;921;2869;9189;3167;10110
317100;202003;2614;6239;1647;4612;371;1088;604;1641;975;2729
317103;202003;1967;5642;1655;5144;91;463;1220;3618;1311;4081
317107;202003;1387;3706;1050;3054;72;262;647;1678;719;1940
317110;202003;703;1638;356;1094;53;194;120;381;173;575
317115;202003;1053;3025;892;2737;50;134;611;1887;661;2021
317120;202003;12276;33708;9529;29240;1100;3940;5364;16005;6464;19945
317130;202003;10789;25202;6686;18403;1092;3362;2180;5990;3272;9352
317140;202003;761;1913;571;1626;41;118;390;1148;431;1266
317150;202003;982;2363;730;2045;30;93;570;1574;600;1667
317160;202003;3518;8547;2285;6562;171;543;1275;3725;1446;4268
317170;202003;1750;4397;1233;3491;209;687;500;1230;709;1917
317180;202003;1879;5947;1369;4697;262;965;346;1112;608;2077
317190;202003;1198;3233;882;2741;101;327;515;1587;616;1914
317200;202003;4838;12730;3635;10643;989;3140;741;1989;1730;5129
317210;202003;1155;2837;895;2483;23;90;662;1883;685;1973
317220;202003;244;757;207;685;49;165;76;270;125;435
320010;202003;4391;12863;3527;11139;360;1265;2298;7087;2658;8352
320013;202003;1808;5093;1181;3807;180;589;523;1753;703;2342
320016;202003;2963;7625;2306;6620;153;421;1772;5100;1925;5521
320020;202003;3778;9875;2766;8123;616;1995;978;3003;1594;4998
320030;202003;1668;4673;1066;3450;199;708;381;1177;580;1885
320035;202003;1854;5161;1511;4554;380;1274;648;1886;1028;3160
320040;202003;3811;10933;3119;9637;442;1469;1747;5248;2189;6717
320050;202003;1716;3930;1473;3571;185;542;884;2055;1069;2597
320060;202003;11600;32332;8608;26449;1305;4439;4063;11894;5368;16333
320070;202003;1407;3986;969;3086;178;636;343;1055;521;1691
320080;202003;5495;14219;3841;10972;809;2454;1388;3767;2197;6221
320090;202003;8006;21589;5236;15788;1157;3754;1881;5315;3038;9069
320100;202003;2753;7747;2215;6792;364;1265;1185;3596;1549;4861
320110;202003;1753;4239;1196;3321;169;501;588;1563;757;2064
320115;202003;1782;5761;1518;5316;651;2404;424;1535;1075;3939
320120;202003;20535;52798;13951;41067;2011;6447;6342;17912;8353;24359
320130;202003;43283;121218;35325;106750;4716;15748;20495;60266;25211;76014
320140;202003;3347;9279;2267;7146;344;1240;916;2857;1260;4097
320150;202003;12695;33135;8834;25622;2333;7404;1566;4037;3899;11441
320160;202003;5392;15212;3923;12394;664;2288;1833;5690;2497;7978
320170;202003;1450;4221;1043;3411;278;908;415;1429;693;2337
320180;202003;678;2164;548;1905;209;772;148;484;357;1256
320190;202003;2651;8540;2036;7169;495;1850;534;1797;1029;3647
320200;202003;1175;3170;794;2467;184;620;291;921;475;1541
320210;202003;4287;11009;3280;9249;524;1614;1750;4729;2274;6343
320220;202003;2524;6808;1876;5722;342;1150;897;2620;1239;3770
320225;202003;1326;4149;927;3178;332;1220;191;651;523;1871
320230;202003;4638;13018;3485;11081;824;2852;1345;4174;2169;7026
320240;202003;14845;38189;10853;31739;2595;8251;3692;10558;6287;18809
320245;202003;2925;8771;2321;7535;886;3016;462;1470;1348;4486
320250;202003;2003;5762;1306;4088;307;1062;368;1030;675;2092
320255;202003;1745;5537;1505;5107;423;1470;728;2574;1151;4044
320260;202003;1301;3719;800;2581;172;625;197;530;369;1155
320265;202003;2379;7407;1943;6528;908;3220;346;1165;1254;4385
320270;202003;2136;6195;1610;5157;378;1304;646;2075;1024;3379
320280;202003;6460;17532;5167;15289;1141;3639;2245;6440;3386;10079
320290;202003;1301;3891;831;2742;219;795;208;642;427;1437
320300;202003;3438;10549;2742;9106;801;2872;624;1920;1425;4792
320305;202003;5019;14317;3873;12027;742;2501;1873;5625;2615;8126
320310;202003;1982;5580;1345;4216;250;817;574;1727;824;2544
320313;202003;2265;5750;1418;4119;305;999;363;978;668;1977
320316;202003;1417;4022;1144;3562;166;536;714;2227;880;2763
320320;202003;20845;55039;14581;44234;3401;10826;5358;16330;8759;27156
320330;202003;2911;7943;2247;6735;429;1284;1168;3588;1597;4872
320332;202003;6338;17483;4979;15079;1232;4003;2229;6718;3461;10721
320334;202003;1655;4756;1164;3753;257;987;265;677;522;1664
320335;202003;1327;3950;911;2979;235;849;227;678;462;1527
320340;202003;4655;11787;3853;10601;495;1496;2267;6272;2762;7768
320350;202003;5180;12970;3605;10095;460;1373;1885;5038;2345;6411
320360;202003;1379;3541;1023;2872;123;334;520;1408;643;1742
320370;202003;2512;7788;1848;6322;571;2048;587;1998;1158;4046
320380;202003;2424;6577;2005;5895;237;749;1266;3640;1503;4389
320390;202003;6894;18810;5061;15143;1069;3394;2033;5747;3102;9141
320400;202003;3157;9025;2410;7431;683;2243;872;2573;1555;4816
320405;202003;4395;11720;3284;9828;553;1768;1508;4450;2061;6218
320410;202003;4669;12199;3491;10294;624;1822;1749;5371;2373;7193
320420;202003;2875;7658;2169;6448;661;2222;397;1183;1058;3405
320425;202003;2040;4943;1551;4133;91;271;1025;2658;1116;2929
320430;202003;2896;7290;2265;6147;297;897;1455;3782;1752;4679
320435;202003;2140;6715;1683;5809;601;2185;511;1787;1112;3972
320440;202003;1360;3766;981;3040;148;493;448;1345;596;1838
320450;202003;1581;4601;1224;3918;276;1003;537;1600;813;2603
320455;202003;3960;12070;2617;8877;662;2416;635;1982;1297;4398
320460;202003;2013;5984;1401;4663;338;1204;346;1067;684;2271
320465;202003;1137;3277;870;2760;119;403;488;1555;607;1958
320470;202003;3624;10050;2519;7687;577;1873;601;1639;1178;3512
320480;202003;1612;4497;1309;3980;201;709;763;2236;964;2945
320490;202003;20455;53814;14907;43995;2537;8205;6191;18092;8728;26297
320495;202003;1254;3452;866;2698;189;675;328;973;517;1648
320500;202003;51673;137793;41009;119303;5762;18212;23638;65977;29400;84189
320501;202003;4229;12322;3107;10284;883;3260;1046;3402;1929;6662
320503;202003;2268;6580;1495;4975;407;1469;439;1376;846;2845
320506;202003;2329;7001;1642;5466;508;1841;177;586;685;2427
320510;202003;9669;26291;7781;23011;873;2996;4830;13819;5703;16815
320515;202003;1666;4587;1278;3792;356;1148;423;1216;779;2364
320517;202003;2046;6237;1623;5337;537;1916;461;1478;998;3394
320520;202003;34361;89388;25376;74236;4560;14693;10630;30167;15190;44860
320530;202003;30010;80134;23371;68354;2268;7859;14577;40409;16845;48268
330010;202003;20910;56388;16936;49667;2383;7505;10664;30642;13047;38147
330015;202003;1468;3634;1138;3124;201;625;615;1601;816;2226
330020;202003;19849;49565;16638;44903;2384;7246;11460;30176;13844;37422
330022;202003;1832;4962;1400;4206;241;746;815;2429;1056;3175
330023;202003;4854;11608;3410;9567;598;1851;1818;4985;2416;6836
330025;202003;4966;12158;3202;9168;878;2763;818;2235;1696;4998
330030;202003;10107;27126;7590;22942;830;2905;4623;13362;5453;16267
330040;202003;14332;37371;11276;32169;1093;3507;7512;20576;8605;24083
330045;202003;83233;197203;68039;177975;5101;13400;53976;140546;59077;153946
330050;202003;2442;6506;1772;5361;363;1189;839;2411;1202;3600
330060;202003;4827;12880;3911;11242;780;2486;1712;4525;2492;7011
330070;202003;22495;57083;17984;50450;2865;8554;10548;29408;13413;37962
330080;202003;8719;22156;7385;20243;926;2697;5105;13828;6031;16525
330090;202003;3283;6891;2204;5429;128;347;1521;3756;1649;4103
330093;202003;2371;5852;1734;4950;115;353;1301;3715;1416;4068
330095;202003;1215;3461;926;2909;76;290;557;1617;633;1907
330100;202003;69325;184960;58766;169189;3621;12466;44748;127002;48369;139468
330110;202003;2064;5794;1648;5082;273;925;918;2728;1191;3653
330115;202003;2164;5344;1609;4542;232;755;957;2586;1189;3341
330120;202003;3485;7832;2580;6657;225;653;1774;4404;1999;5057
330130;202003;4199;11517;3406;10300;479;1524;2108;6319;2587;7843
330140;202003;3600;9436;2814;8285;410;1334;1775;5102;2185;6436
330150;202003;2151;5750;1624;4906;295;944;781;2303;1076;3247
330160;202003;1348;3673;999;3046;173;573;532;1549;705;2122
330170;202003;103723;259835;82265;230565;11088;30903;54794;155598;65882;186501
330180;202003;1971;4769;1508;4116;98;304;1036;2751;1134;3055
330185;202003;9500;24020;7883;21751;489;1658;6269;16863;6758;18521
330187;202003;4210;10747;3244;9163;450;1390;1881;5276;2331;6666
330190;202003;32610;79358;27410;72186;1936;5524;21632;56330;23568;61854
330200;202003;15675;40054;12623;36262;2474;6788;7881;23314;10355;30102
330205;202003;2018;5021;1517;4207;85;289;1061;2818;1146;3107
330210;202003;3386;8565;2436;6885;352;1102;1177;3071;1529;4173
330220;202003;11308;28327;7905;22598;1723;5520;2726;7230;4449;12750
330225;202003;3700;9396;2753;7946;193;674;1975;5565;2168;6239
330227;202003;17249;41535;14375;38018;579;1725;12293;32131;12872;33856
330230;202003;1721;3988;1207;3332;102;296;796;2189;898;2485
330240;202003;23420;61073;19008;54102;2422;7543;12352;34341;14774;41884
330245;202003;1638;4086;971;2916;197;625;357;1075;554;1700
330250;202003;37412;96181;30815;86396;5462;15667;18588;52148;24050;67815
330260;202003;4370;10722;3235;9171;346;1100;2192;6032;2538;7132
330270;202003;28046;61624;17171;44612;2834;7917;7016;17659;9850;25576
330280;202003;2319;6136;1728;5117;186;607;1015;2898;1201;3505
330285;202003;22792;55102;17893;48047;1453;4555;13039;33860;14492;38415
330290;202003;3668;9006;2912;8002;321;987;2031;5425;2352;6412
330300;202003;5650;13420;4027;11050;308;956;2781;7505;3089;8461
330310;202003;2524;6288;1819;5109;122;312;1210;3395;1332;3707
330320;202003;16377;38946;12368;33923;1393;3811;8917;24574;10310;28385
330330;202003;35949;79411;27340;67868;2475;6748;19624;47880;22099;54628
330340;202003;14171;35124;10254;28964;1679;5255;5193;14062;6872;19317
330350;202003;129697;303436;105234;273552;6879;18715;85550;221527;92429;240242
330360;202003;7376;17950;6307;16641;207;555;5342;14033;5549;14588
330370;202003;4681;13476;3510;11456;809;2715;1477;5025;2286;7740
330380;202003;5326;14370;3972;11930;708;2451;1942;5559;2650;8010
330385;202003;3877;11214;3131;10114;755;2691;1489;4765;2244;7456
330390;202003;25756;69780;19358;58580;2766;9573;11012;31541;13778;41114
330395;202003;3141;7831;2572;7081;162;514;1852;4999;2014;5513
330400;202003;3169;8493;2667;7698;141;518;2006;5480;2147;5998
330410;202003;2954;8070;2201;6746;418;1406;1009;2938;1427;4344
330411;202003;2740;7427;2107;6214;146;508;1475;4190;1621;4698
330412;202003;1469;4179;1173;3685;133;486;716;2116;849;2602
330414;202003;22678;57400;18103;51156;1579;4604;13196;37063;14775;41667
330415;202003;4117;11207;3167;9555;322;1032;1894;5690;2216;6722
330420;202003;10604;26263;7176;20701;923;3019;3592;9719;4515;12738
330430;202003;9423;22713;7859;20548;329;1086;6170;15641;6499;16727
330440;202003;2366;6429;1740;5351;299;1084;960;2816;1259;3900
330450;202003;1260;3642;1005;3204;139;483;543;1706;682;2189
330452;202003;16212;41589;12807;36363;1686;5377;8040;22181;9726;27558
330455;202003;544882;1293084;413387;1103205;59273;168657;260066;683731;319339;852388
330460;202003;1176;3223;870;2768;155;522;469;1455;624;1977
330470;202003;4783;11974;3415;9843;1093;3250;1019;3032;2112;6282
330475;202003;9227;24082;7379;21652;1167;3922;4678;13451;5845;17373
330480;202003;5874;15238;4909;13822;395;1243;3411;9338;3806;10581
330490;202003;111699;256962;89916;227678;9949;26362;64365;161502;74314;187864
330500;202003;7263;17944;6022;16237;616;1861;4355;11586;4971;13447
330510;202003;39677;98394;29125;83374;4902;15009;17568;49648;22470;64657
330513;202003;1184;3084;924;2716;199;633;466;1379;665;2012
330515;202003;2445;6456;1930;5731;367;1179;1066;3090;1433;4269
330520;202003;10982;29069;8839;25662;1182;3792;5365;15209;6547;19001
330530;202003;1612;3958;1183;3316;244;740;548;1506;792;2246
330540;202003;2848;7572;2190;6437;511;1564;932;2656;1443;4220
330550;202003;8840;23107;6694;20256;1904;6264;2670;8010;4574;14274
330555;202003;17011;36513;14026;32990;855;2272;11210;26628;12065;28900
330560;202003;4128;11061;3303;9668;501;1511;1958;5604;2459;7115
330570;202003;2671;7384;2223;6689;354;1145;1424;4248;1778;5393
330575;202003;5412;13992;4635;12667;284;885;3695;9770;3979;10655
330580;202003;16698;44796;12711;37539;2362;7577;5944;16815;8306;24392
330590;202003;1437;3887;1181;3555;219;656;732;2245;951;2901
330600;202003;11486;30525;9249;26887;927;3127;5804;16445;6731;19572
330610;202003;9201;24553;7382;21679;581;2025;5157;14738;5738;16763
330615;202003;2043;5605;1571;4955;295;963;973;3128;1268;4091
330620;202003;3968;11352;3109;9851;700;2401;1313;3916;2013;6317
330630;202003;23870;59952;18579;51634;1385;4547;13206;35508;14591;40055
350010;202003;2039;5232;1014;3035;220;713;174;380;394;1093
350020;202003;683;1743;377;1154;47;151;152;423;199;574
350030;202003;3520;9885;2582;8230;647;2254;1042;3162;1689;5416
350040;202003;684;1969;382;1322;54;215;121;325;175;540
350050;202003;1180;2927;749;2159;173;585;252;582;425;1167
350055;202003;904;2395;694;2052;81;263;392;1102;473;1365
350060;202003;121;300;77;222;12;40;41;123;53;163
350070;202003;3352;8859;2080;6522;419;1469;624;1779;1043;3248
350075;202003;560;1666;415;1370;169;598;29;93;198;691
350080;202003;629;1627;392;1202;54;186;153;424;207;610
350090;202003;579;1373;340;946;69;207;146;383;215;590
350100;202003;2151;5782;1446;4516;115;447;868;2572;983;3019
350110;202003;472;1203;320;934;20;75;182;520;202;595
350115;202003;1250;3626;1016;3125;190;654;508;1401;698;2055
350120;202003;627;1459;327;886;37;119;163;383;200;502
350130;202003;2991;7932;2325;6711;413;1222;1134;3119;1547;4341
350140;202003;759;2155;494;1612;50;223;265;791;315;1014
350150;202003;492;1502;398;1318;90;284;108;332;198;616
350160;202003;10619;26537;6953;19867;906;2961;4165;11244;5071;14205
350170;202003;2014;5838;1570;4864;308;1011;643;1850;951;2861
350180;202003;1011;2511;504;1514;113;351;75;208;188;559
350190;202003;2776;7861;1885;5960;362;1314;778;2094;1140;3408
350200;202003;406;1157;317;995;18;63;208;621;226;684
350210;202003;5351;12285;3543;9570;488;1422;2143;5590;2631;7012
350220;202003;2822;7767;1877;5870;415;1371;611;1736;1026;3107
350230;202003;1015;2620;829;2344;155;469;459;1257;614;1726
350240;202003;627;1837;398;1298;82;265;111;343;193;608
350250;202003;2269;6576;1677;5577;600;2177;301;1056;901;3233
350260;202003;785;1882;488;1366;54;162;297;810;351;972
350270;202003;4364;11815;3433;10016;540;1716;1794;4891;2334;6607
350275;202003;2340;6309;1842;5495;303;1015;1072;3032;1375;4047
350280;202003;18126;40561;10418;28122;1809;5203;3913;10156;5722;15359
350290;202003;3085;8504;2042;6339;373;1272;814;2352;1187;3624
350300;202003;618;1694;451;1372;67;202;233;674;300;876
350310;202003;854;2475;614;1977;108;408;230;665;338;1073
350315;202003;551;1413;359;1079;24;90;178;499;202;589
350320;202003;14570;37456;10541;30304;2293;7245;3832;10273;6125;17518
350330;202003;13809;34040;9648;25958;1074;3207;5998;15145;7072;18352
350335;202003;348;997;266;844;33;118;132;395;165;513
350340;202003;1136;2942;672;2086;119;412;257;726;376;1138
350350;202003;729;1862;556;1668;68;248;329;964;397;1212
350360;202003;1086;3227;825;2674;221;729;248;816;469;1545
350370;202003;604;1522;410;1169;145;391;118;356;263;747
350380;202003;3984;10965;2719;8389;774;2379;649;2043;1423;4422
350390;202003;9790;26194;7533;22288;1743;5346;3166;9143;4909;14489
350395;202003;416;1066;211;668;22;64;74;210;96;274
350400;202003;7846;19379;5354;15244;1326;4072;1486;4149;2812;8221
350410;202003;9248;25871;6569;20632;1420;4972;2395;6959;3815;11931
350420;202003;651;1730;455;1337;73;241;114;292;187;533
350430;202003;642;1736;515;1524;68;237;310;838;378;1075
350440;202003;1940;4940;1555;4349;116;371;1023;2794;1139;3165
350450;202003;6586;18104;5068;15442;1120;3730;2098;5991;3218;9721
350460;202003;1672;4358;836;2609;148;490;169;466;317;956
350470;202003;246;627;190;532;10;31;131;354;141;385
350480;202003;931;2373;572;1726;123;432;102;255;225;687
350490;202003;1802;4784;1268;3907;301;968;384;1090;685;2058
350500;202003;684;1821;514;1504;70;218;255;701;325;919
350510;202003;1111;2899;811;2352;92;300;469;1303;561;1603
350520;202003;2073;6367;1585;5391;262;983;700;2163;962;3146
350530;202003;2682;6721;1952;5359;221;675;1152;2972;1373;3647
350535;202003;1351;3725;1152;3442;171;581;721;2077;892;2658
350540;202003;1781;4392;1287;3634;173;507;769;2123;942;2630
350550;202003;8237;20358;5655;16074;617;2075;3309;8760;3926;10835
350560;202003;3876;10945;3050;9443;298;994;1884;5649;2182;6643
350570;202003;23990;67003;19139;57516;3632;11960;9581;27575;13213;39535
350580;202003;1920;5255;1046;3367;278;963;184;481;462;1444
350590;202003;4728;12919;3402;9942;473;1562;1970;5327;2443;6889
350600;202003;35334;81680;21554;57551;3211;9639;10173;25024;13384;34663
350610;202003;6453;17799;4570;14002;829;2793;2078;6064;2907;8857
350620;202003;378;978;243;781;28;96;141;436;169;532
350630;202003;1409;3677;1024;2982;72;269;663;1806;735;2075
350635;202003;8159;20412;6063;17182;1030;3230;3408;9157;4438;12387
350640;202003;890;2442;472;1485;72;232;132;360;204;592
350650;202003;7795;20933;5185;15732;1039;3410;1836;5169;2875;8579
350660;202003;4505;11845;3443;10068;579;1715;1773;5190;2352;6905
350670;202003;1829;4858;1493;4368;155;473;1006;2940;1161;3413
350680;202003;1089;2952;715;2254;143;464;273;822;416;1286
350690;202003;1263;3263;877;2611;149;481;472;1356;621;1837
350700;202003;4614;11707;3178;9475;583;1993;1366;3837;1949;5830
350710;202003;2688;7483;2246;6691;390;1344;1200;3306;1590;4650
350715;202003;806;2308;654;2028;74;297;352;990;426;1287
350720;202003;151;397;111;325;19;56;33;76;52;132
350730;202003;587;1581;491;1413;27;105;373;1008;400;1113
350740;202003;1535;4157;1024;3101;200;636;316;894;516;1530
350745;202003;586;1477;313;952;41;151;121;337;162;488
350750;202003;9663;25133;7253;20935;1296;4333;3259;8411;4555;12744
350760;202003;13139;32973;9134;25986;2065;6482;3436;8849;5501;15331
350770;202003;959;2410;593;1760;39;125;377;1099;416;1224
350775;202003;642;1524;430;1200;42;126;210;579;252;705
350780;202003;1946;4827;1352;3963;244;799;494;1644;738;2443
350790;202003;1604;4302;981;3152;195;682;268;707;463;1389
350800;202003;3270;9573;2793;8726;254;910;1875;5694;2129;6604
350810;202003;2586;6447;2024;5625;290;776;1153;3272;1443;4048
350820;202003;904;2134;497;1397;51;172;242;611;293;783
350830;202003;836;2349;458;1499;71;225;139;400;210;625
350840;202003;2968;8779;2134;7155;514;1910;872;2671;1386;4581
350850;202003;6571;18375;4982;15491;1036;3501;2167;6487;3203;9988
350860;202003;3536;9491;3015;8777;124;459;2283;6560;2407;7019
350870;202003;2585;7305;1876;6148;263;960;1030;3301;1293;4261
350880;202003;1208;3482;932;2935;238;773;274;830;512;1603
350890;202003;526;1354;326;938;50;151;120;316;170;467
350900;202003;6738;18288;4173;12788;979;3312;1227;3404;2206;6716
350910;202003;850;2154;718;1949;85;246;515;1370;600;1616
350920;202003;11555;28841;9643;25696;444;1454;7757;19916;8201;21370
350925;202003;4306;11757;3041;9435;588;1978;1420;4061;2008;6039
350930;202003;1422;3748;966;2851;97;294;581;1682;678;1976
350940;202003;2193;5833;1674;4980;181;599;1052;3021;1233;3620
350945;202003;814;2287;598;1868;94;353;316;892;410;1245
350950;202003;83831;216640;63548;178279;8559;26457;38233;102322;46792;128779
350960;202003;6227;16974;4794;14261;581;1995;2846;8030;3427;10025
350970;202003;3459;9786;2468;7847;738;2623;467;1262;1205;3885
350980;202003;628;1736;505;1518;134;427;224;666;358;1093
350990;202003;1696;4788;1227;4008;300;1101;423;1299;723;2400
350995;202003;748;2340;669;2180;54;218;469;1454;523;1672
351000;202003;2732;7113;1912;5640;335;1049;725;2061;1060;3110
351010;202003;320;795;211;610;24;81;114;318;138;399
351015;202003;758;2310;607;1984;91;337;290;851;381;1188
351020;202003;8517;23384;6401;19707;1331;4231;3101;9303;4432;13534
351030;202003;2733;8172;2182;7031;329;1166;1155;3627;1484;4793
351040;202003;4900;12191;4074;10941;203;670;3333;8701;3536;9371
351050;202003;16805;41069;11784;33135;2403;7145;5014;13931;7417;21076
351060;202003;47859;120698;36106;100325;3811;11654;23984;64523;27795;76177
351070;202003;1425;3548;764;2376;187;633;130;393;317;1026
351080;202003;2738;6646;1921;5668;223;808;1268;3542;1491;4350
351090;202003;314;924;221;748;49;164;59;198;108;362
351100;202003;2465;6682;1566;4831;347;1120;448;1431;795;2551
351110;202003;5975;15255;3785;11152;646;2107;1596;4389;2242;6496
351120;202003;766;1954;504;1518;55;171;194;583;249;754
351130;202003;1116;2940;481;1556;92;298;102;320;194;618
351140;202003;1866;5422;1357;4409;303;1120;507;1479;810;2599
351150;202003;2213;6348;1421;4593;258;923;539;1539;797;2462
351160;202003;1110;3458;824;2781;182;652;214;628;396;1280
351170;202003;1358;3738;1169;3397;93;291;824;2325;917;2616
351190;202003;997;2771;643;2034;122;397;228;662;350;1059
351200;202003;1569;3768;1150;3148;92;284;805;2080;897;2364
351210;202003;1488;3675;894;2533;73;244;528;1391;601;1635
351220;202003;3170;9039;2684;8230;320;1010;1756;5352;2076;6362
351230;202003;1726;4715;1254;3874;228;809;557;1568;785;2377
351240;202003;2331;5980;1390;3981;294;891;536;1369;830;2260
351250;202003;1041;2793;597;1882;78;259;213;670;291;929
351260;202003;879;2234;625;1780;129;361;224;624;353;985
351270;202003;398;1087;324;959;33;114;192;494;225;608
351280;202003;3708;9766;2800;8062;531;1569;1292;3595;1823;5164
351290;202003;1180;2955;797;2284;119;367;449;1239;568;1606
351300;202003;16526;45204;11009;34439;2024;6868;4531;13659;6555;20527
351310;202003;3274;8088;2442;6782;185;642;1756;4612;1941;5254
351320;202003;870;2547;631;2033;125;432;216;627;341;1059
351330;202003;466;1092;381;936;26;80;276;610;302;690
351340;202003;6256;17875;4978;15622;1194;3914;2189;6840;3383;10754
351350;202003;11388;28522;9333;25272;999;2904;6786;17888;7785;20792
351360;202003;3711;10017;3042;8995;739;2335;1165;3198;1904;5533
351370;202003;2023;5669;1329;4209;322;1096;423;1219;745;2315
351380;202003;46117;112231;32039;87436;4291;12566;17841;46586;22132;59152
351385;202003;317;843;153;466;25;76;46;132;71;208
351390;202003;1346;3286;795;2468;120;437;446;1297;566;1734
351400;202003;908;2556;745;2216;123;367;449;1304;572;1671
351410;202003;2596;7246;1830;5736;326;1045;708;2175;1034;3220
351420;202003;376;896;199;585;25;66;110;307;135;373
351430;202003;910;2509;689;2138;63;195;456;1385;519;1580
351440;202003;3191;8427;2034;6020;372;1148;559;1424;931;2572
351450;202003;1636;4369;1035;3228;209;718;155;371;364;1089
351460;202003;794;2095;607;1786;148;428;328;961;476;1389
351470;202003;1162;2951;882;2478;82;276;571;1510;653;1786
351480;202003;2449;7224;1915;6271;367;1324;813;2491;1180;3815
351490;202003;1909;5456;1615;4927;75;303;1292;3799;1367;4102
351492;202003;334;913;275;789;8;24;204;574;212;598
351495;202003;178;463;129;365;17;43;67;188;84;231
351500;202003;35959;89217;26428;72947;4076;12131;15300;40408;19376;52539
351510;202003;12764;31870;9156;25531;1137;3622;5641;14986;6778;18608
351512;202003;461;1248;321;940;58;170;112;302;170;472
351515;202003;3109;6923;1876;4994;321;965;543;1553;864;2518
351518;202003;2379;6006;1505;4422;203;671;830;2210;1033;2881
351519;202003;712;1977;432;1414;90;289;63;195;153;484
351520;202003;1207;2993;476;1477;53;186;190;513;243;699
351530;202003;340;898;192;576;24;73;77;181;101;254
351535;202003;1849;4504;1309;3583;206;616;670;1739;876;2355
351540;202003;2243;5609;1443;4219;302;1014;479;1235;781;2249
351550;202003;6780;16850;4422;12518;452;1494;2492;6570;2944;8064
351560;202003;435;1248;335;1049;82;281;100;286;182;567
351565;202003;196;558;154;481;40;141;42;114;82;255
351570;202003;19564;53020;14586;42759;1630;5177;8879;24934;10509;30111
351580;202003;240;617;134;412;12;37;59;188;71;225
351590;202003;504;1149;266;734;23;80;147;369;170;449
351600;202003;1314;3463;1003;2895;90;284;615;1671;705;1955
351610;202003;725;1727;452;1248;28;87;258;672;286;759
351620;202003;22124;58880;15974;48087;2670;9091;7156;19513;9826;28604
351630;202003;25628;68105;20250;58702;3081;9402;12282;34588;15363;43990
351640;202003;16130;42959;12339;35921;1229;4101;8300;23242;9529;27343
351650;202003;367;971;164;534;20;70;45;128;65;198
351660;202003;733;2078;457;1446;88;295;65;162;153;457
351670;202003;5866;15777;3733;11105;802;2371;1610;4526;2412;6897
351680;202003;434;1248;273;883;44;138;63;168;107;306
351685;202003;421;1205;336;1066;92;292;105;315;197;607
351690;202003;1044;2667;598;1756;84;279;252;669;336;948
351700;202003;1354;3386;959;2687;160;458;524;1393;684;1851
351710;202003;716;1941;495;1519;45;157;264;737;309;894
351720;202003;1393;3627;905;2761;144;475;364;1055;508;1530
351730;202003;884;2313;733;2076;58;208;488;1320;546;1528
351740;202003;3466;8736;2686;7239;474;1381;1335;3336;1809;4717
351750;202003;1315;3474;810;2551;155;500;303;932;458;1432
351760;202003;3213;9098;2301;7233;468;1678;823;2322;1291;4000
351770;202003;1724;5144;1396;4494;272;927;716;2244;988;3171
351780;202003;1224;3151;710;2162;104;368;237;687;341;1055
351790;202003;1318;3145;1020;2752;163;454;598;1627;761;2081
351800;202003;500;1154;236;656;21;59;87;210;108;269
351810;202003;1011;2640;815;2340;36;113;599;1637;635;1750
351820;202003;2433;6848;1670;5360;440;1533;359;1066;799;2599
351830;202003;4394;11887;3332;10032;326;1200;2066;5894;2392;7094
351840;202003;8328;23153;6178;19111;908;3132;3179;9221;4087;12353
351850;202003;1575;4265;1018;3178;169;611;343;917;512;1528
351860;202003;2715;7885;2081;6694;370;1270;1120;3633;1490;4903
351870;202003;23019;58949;17069;49090;4623;13630;6711;19744;11334;33374
351880;202003;118421;308275;86305;252484;20710;66482;36588;102316;57298;168798
351885;202003;899;2426;705;2095;68;248;460;1297;528;1545
351890;202003;760;2006;485;1542;123;404;68;186;191;590
351900;202003;1073;2883;825;2507;118;360;464;1402;582;1762
351905;202003;387;1053;260;804;20;72;114;306;134;378
351907;202003;20552;54089;15679;45328;1864;5912;9953;27799;11817;33711
351910;202003;1427;3782;975;2788;71;228;552;1423;623;1651
351920;202003;811;2166;611;1787;91;309;286;767;377;1076
351925;202003;845;2284;650;1915;80;271;345;949;425;1220
351930;202003;3149;8876;2820;8273;591;1735;1861;5403;2452;7138
351940;202003;1045;2701;746;2174;117;377;367;1050;484;1427
351950;202003;1595;3727;1152;3054;63;185;790;2029;853;2214
351960;202003;5131;12988;3672;10377;818;2457;1639;4311;2457;6768
351970;202003;7001;20871;5499;18186;864;3182;2989;9612;3853;12794
351980;202003;990;2338;620;1732;89;283;353;909;442;1192
351990;202003;1384;3278;985;2692;56;208;472;1174;528;1382
352000;202003;2528;7243;2156;6476;265;913;1408;3955;1673;4868
352010;202003;2154;5822;1692;5036;438;1428;365;1110;803;2538
352020;202003;1432;3939;1090;3347;172;570;524;1526;696;2096
352030;202003;5311;14169;4111;12224;817;2671;2070;5989;2887;8660
352040;202003;2817;7605;1867;5646;279;934;670;1723;949;2657
352042;202003;2955;7241;1895;5526;378;1237;797;2239;1175;3476
352044;202003;2053;5494;1156;3748;185;687;251;742;436;1429
352050;202003;11504;30617;7143;21929;1788;6288;1230;3144;3018;9432
352060;202003;681;1836;490;1481;67;220;223;622;290;842
352070;202003;886;1797;562;1366;64;168;261;564;325;732
352080;202003;436;1101;262;753;27;89;99;255;126;344
352090;202003;1413;4162;1150;3628;129;489;552;1572;681;2061
352100;202003;2969;8446;2415;7404;538;1804;1112;3255;1650;5059
352110;202003;555;1638;426;1385;96;329;165;498;261;827
352115;202003;493;1351;402;1211;49;175;233;687;282;862
352120;202003;853;2572;688;2230;84;284;399;1214;483;1498
352130;202003;1867;5321;1234;3748;208;671;480;1335;688;2006
352140;202003;1119;3029;776;2356;142;461;366;1067;508;1528
352150;202003;806;2181;618;1853;83;266;407;1186;490;1452
352160;202003;955;2374;684;1951;78;270;374;1016;452;1286
352170;202003;2908;7860;2262;6559;341;1105;1320;3529;1661;4634
352180;202003;2491;6759;1901;5655;449;1502;561;1457;1010;2959
352190;202003;1179;3198;919;2796;167;485;441;1401;608;1886
352200;202003;332;1003;233;801;32;125;89;292;121;417
352210;202003;19025;45384;14790;39754;1058;3163;11297;29853;12355;33016
352215;202003;602;1604;518;1486;63;198;339;933;402;1131
352220;202003;18282;45888;11903;34297;2758;8371;4270;11644;7028;20015
352230;202003;12875;37758;9733;31758;2327;8464;3496;10508;5823;18972
352240;202003;10480;27016;7926;22698;1731;5590;3436;9080;5167;14670
352250;202003;23200;64851;18362;56365;3051;10005;10793;32589;13844;42594
352260;202003;4781;11999;3206;8927;472;1517;1816;4547;2288;6064
352265;202003;891;2482;780;2319;43;165;599;1725;642;1890
352270;202003;1416;4234;1039;3402;224;796;362;1099;586;1895
352280;202003;2394;6117;1801;5234;193;691;1053;2825;1246;3516
352290;202003;1129;3300;908;2858;124;438;483;1378;607;1816
352300;202003;892;2424;583;1763;80;272;306;866;386;1138
352310;202003;44255;117687;32475;96817;8054;24670;13727;41145;21781;65815
352320;202003;6324;16808;4780;13751;745;2426;2500;6496;3245;8922
352330;202003;2138;5690;1590;4922;290;1055;824;2382;1114;3437
352340;202003;5384;14189;3871;11426;629;2138;1936;5239;2565;7377
352350;202003;2118;6048;1646;4981;180;666;901;2447;1081;3113
352360;202003;1226;3293;1010;2910;81;285;759;2100;840;2385
352370;202003;1037;2968;896;2734;21;90;717;2140;738;2230
352380;202003;808;2224;600;1841;119;378;217;628;336;1006
352390;202003;14989;36696;10054;28083;1637;4984;5514;14542;7151;19526
352400;202003;3422;9448;2787;8257;608;2099;1440;3944;2048;6043
352410;202003;3134;8074;2338;6735;222;772;1441;3951;1663;4723
352420;202003;819;1993;574;1633;103;310;212;573;315;883
352430;202003;7529;18867;5301;14948;1171;3750;2389;6343;3560;10093
352440;202003;17213;46835;12694;38028;3124;9708;4686;13705;7810;23413
352450;202003;758;1874;375;1200;52;182;126;377;178;559
352460;202003;2885;8039;1956;6305;403;1435;739;2225;1142;3660
352470;202003;3104;7772;2245;6384;288;929;1285;3450;1573;4379
352480;202003;3626;8629;2307;6264;360;1118;1118;2761;1478;3879
352490;202003;683;1989;542;1725;101;343;256;768;357;1111
352500;202003;10200;26378;6847;20045;2897;9336;763;1272;3660;10608
352510;202003;3568;9631;2637;8010;561;1857;1208;3476;1769;5333
352520;202003;2584;6806;1977;5779;386;1279;1072;2824;1458;4103
352530;202003;9523;24835;6019;17969;1145;3917;1552;3828;2697;7745
352540;202003;528;1595;377;1244;62;227;116;344;178;571
352550;202003;978;2756;679;2173;139;482;209;599;348;1081
352560;202003;569;1599;431;1327;76;247;202;582;278;829
352570;202003;2129;6218;1290;4318;314;1139;129;357;443;1496
352580;202003;649;1674;534;1471;48;158;360;941;408;1099
352585;202003;295;784;216;651;16;62;133;358;149;420
352590;202003;12822;33674;8822;25981;2335;7474;3766;10304;6101;17778
352600;202003;1939;5210;1494;4375;163;524;930;2581;1093;3105
352610;202003;2911;8173;2179;6895;440;1584;889;2639;1329;4223
352620;202003;5558;14325;4229;12380;1246;3733;1593;4723;2839;8456
352630;202003;802;1999;592;1680;110;364;270;693;380;1057
352640;202003;2871;7424;2027;5936;214;662;1163;3283;1377;3945
352650;202003;575;1636;397;1235;59;214;146;430;205;644
352660;202003;1000;2957;796;2527;132;435;390;1195;522;1630
352670;202003;8771;23732;5501;17209;1482;4941;1056;3201;2538;8142
352680;202003;3201;9554;2207;7259;357;1419;1082;3201;1439;4620
352690;202003;25961;65383;19836;54875;1380;4555;13850;36807;15230;41362
352700;202003;550;1372;398;1163;148;488;86;238;234;726
352710;202003;4872;12609;3393;9902;792;2548;1397;3737;2189;6285
352720;202003;7596;20832;5851;17529;2484;7588;1177;3317;3661;10905
352725;202003;514;1304;291;862;20;61;142;396;162;457
352730;202003;2695;7722;2221;6634;313;1041;1344;3696;1657;4737
352740;202003;2211;5206;1608;4321;172;542;985;2501;1157;3043
352750;202003;384;967;220;672;35;114;90;245;125;359
352760;202003;1601;4472;1211;3688;139;447;634;1907;773;2354
352770;202003;862;2337;582;1779;122;386;229;670;351;1056
352780;202003;595;1700;419;1354;81;264;117;368;198;632
352790;202003;436;1169;295;879;30;100;112;295;142;395
352800;202003;1248;3875;873;2984;243;862;112;332;355;1194
352810;202003;1121;2675;696;1910;85;245;420;1088;505;1333
352820;202003;471;1291;320;1029;68;223;72;250;140;473
352830;202003;574;1465;257;791;25;79;54;135;79;214
352840;202003;3796;10879;3086;9614;1053;3559;988;2977;2041;6536
352850;202003;10420;25552;6987;19953;1913;5961;2172;5590;4085;11551
352860;202003;971;2685;702;2190;139;469;260;781;399;1250
352870;202003;856;2143;602;1620;39;129;402;1023;441;1152
352880;202003;1722;4052;1212;3172;180;492;712;1782;892;2274
352885;202003;293;826;216;686;24;84;128;386;152;470
352890;202003;676;1619;423;1101;46;127;239;563;285;690
352900;202003;17498;45688;11406;33614;1909;6004;5054;14024;6963;20028
352910;202003;420;1128;217;683;19;60;64;178;83;238
352920;202003;2636;6752;1897;5473;139;432;1292;3623;1431;4055
352930;202003;5482;14867;3971;11902;719;2351;1844;5137;2563;7488
352940;202003;21535;59045;15341;45890;3248;10667;6195;17471;9443;28138
352950;202003;490;1304;280;900;71;236;47;132;118;368
352960;202003;693;1864;367;1171;62;213;81;228;143;441
352965;202003;235;661;145;480;46;152;36;108;82;260
352970;202003;2929;7040;2209;5849;244;688;1435;3747;1679;4435
352980;202003;1367;3645;1079;3208;267;865;543;1569;810;2434
352990;202003;4046;11430;3149;9933;635;2212;1548;4675;2183;6887
353000;202003;452;1245;242;754;39;127;54;140;93;267
353010;202003;2450;6086;1591;4575;349;1142;634;1678;983;2820
353020;202003;3542;9209;2011;5973;291;986;680;1882;971;2868
353030;202003;4180;10693;2798;8212;654;2095;762;2146;1416;4241
353040;202003;625;1456;438;1181;66;184;251;645;317;829
353050;202003;5087;14596;3567;11469;705;2454;1592;4905;2297;7359
353060;202003;47377;121165;38724;107378;2756;9221;28901;77358;31657;86579
353070;202003;8854;25421;6250;19806;1242;4286;2439;7163;3681;11449
353080;202003;4043;11214;2696;8589;515;1862;1044;2916;1559;4778
353090;202003;531;1623;397;1340;29;103;238;788;267;891
353100;202003;303;821;135;438;27;89;38;101;65;190
353110;202003;7338;19911;5925;17842;1184;3643;3176;9850;4360;13493
353120;202003;383;961;273;782;40;137;114;284;154;421
353130;202003;2343;5519;1466;4086;386;1179;480;1232;866;2411
353140;202003;2685;6686;1920;5351;113;372;1336;3561;1449;3933
353150;202003;1468;3609;1022;2869;185;551;464;1227;649;1778
353160;202003;558;1480;395;1203;72;237;166;462;238;699
353170;202003;522;1406;385;1206;77;269;169;522;246;791
353180;202003;9566;23566;7422;20073;656;1983;5539;14564;6195;16547
353190;202003;3121;8461;2471;7170;295;915;1517;4161;1812;5076
353200;202003;1869;4956;933;3001;154;551;215;631;369;1182
353205;202003;349;1063;297;948;54;184;151;470;205;654
353210;202003;917;2141;573;1568;29;96;378;1015;407;1111
353215;202003;378;1055;293;897;45;148;145;403;190;551
353220;202003;708;1952;428;1339;95;287;52;161;147;448
353230;202003;805;2218;622;1927;173;599;241;679;414;1278
353240;202003;2210;6025;1769;5269;249;858;1026;2935;1275;3793
353250;202003;1247;2805;742;1958;97;286;408;1026;505;1312
353260;202003;1094;2547;591;1714;92;311;280;760;372;1071
353270;202003;666;1725;555;1527;45;145;387;998;432;1143
353280;202003;685;1866;472;1470;117;375;135;398;252;773
353282;202003;1742;4940;1458;4406;155;525;916;2616;1071;3141
353284;202003;349;810;175;478;22;81;78;186;100;267
353286;202003;162;401;93;287;12;38;33;93;45;131
353290;202003;1468;3911;901;2748;151;469;296;829;447;1298
353300;202003;1793;4864;1290;3850;204;681;578;1558;782;2239
353310;202003;383;942;270;730;22;78;181;457;203;535
353320;202003;648;1595;537;1436;9;39;467;1233;476;1272
353325;202003;638;1870;433;1419;94;294;156;496;250;790
353330;202003;511;1315;342;990;42;124;190;512;232;636
353340;202003;2808;7603;1936;5901;408;1379;851;2429;1259;3808
353350;202003;3359;8730;2288;6564;495;1553;660;1661;1155;3214
353360;202003;600;1698;453;1415;56;183;254;784;310;967
353370;202003;549;1607;452;1455;36;124;318;991;354;1115
353380;202003;262;781;214;685;28;99;115;332;143;431
353390;202003;5575;13864;4044;11297;495;1560;2274;6008;2769;7568
353400;202003;421;1161;313;952;52;188;116;291;168;479
353410;202003;516;1378;389;1154;72;222;218;646;290;868
353420;202003;419;1101;244;716;59;169;19;43;78;212
353430;202003;2103;5882;1567;4888;362;1231;649;1914;1011;3145
353440;202003;62296;169210;44358;134298;7444;24437;23150;66684;30594;91121
353450;202003;361;921;241;713;35;126;118;317;153;443
353460;202003;3188;8678;2269;6859;160;560;1056;3071;1216;3631
353470;202003;7592;19961;5341;15776;888;3007;2288;6161;3176;9168
353475;202003;1425;3709;970;2762;142;447;488;1289;630;1736
353480;202003;1585;4266;1254;3674;62;226;869;2461;931;2687
353490;202003;1061;2805;679;2064;100;327;293;851;393;1178
353500;202003;1014;2394;756;2004;168;449;409;1091;577;1540
353510;202003;769;2327;556;1799;139;499;143;385;282;884
353520;202003;1053;2765;659;2044;85;292;303;867;388;1159
353530;202003;2356;6248;1809;5260;248;816;964;2609;1212;3425
353540;202003;2007;5404;1629;4810;266;826;961;2780;1227;3606
353550;202003;5669;14651;4516;12801;741;2229;2574;7038;3315;9267
353560;202003;2005;5501;1445;4614;431;1502;381;1094;812;2596
353570;202003;578;1498;424;1252;46;143;254;713;300;856
353580;202003;2062;5471;1547;4448;339;981;728;2049;1067;3030
353590;202003;688;1817;440;1333;89;291;178;534;267;825
353600;202003;1695;4202;1264;3448;152;424;704;1875;856;2299
353610;202003;525;1550;372;1253;85;346;112;345;197;691
353620;202003;2616;7062;1819;5642;359;1244;585;1649;944;2893
353625;202003;469;1164;307;887;20;70;194;546;214;616
353630;202003;1247;3890;1028;3394;227;838;350;1054;577;1892
353640;202003;1322;3403;1055;3010;142;417;607;1731;749;2148
353650;202003;7727;20635;5707;16778;600;1993;3431;9479;4031;11472
353657;202003;378;989;265;794;29;94;116;319;145;413
353660;202003;1234;2635;833;2094;367;922;203;492;570;1414
353670;202003;3987;11118;3067;9297;611;2075;1510;4242;2121;6317
353680;202003;641;1685;464;1420;82;275;252;729;334;1004
353690;202003;419;1082;184;573;19;57;31;85;50;142
353700;202003;1970;5200;1611;4589;117;384;1183;3240;1300;3624
353710;202003;4450;9858;2518;6446;233;627;1563;3642;1796;4269
353715;202003;416;1092;241;757;11;46;74;215;85;261
353720;202003;1878;5092;1437;4434;186;653;869;2625;1055;3278
353730;202003;4252;11277;3146;9255;474;1607;1561;4198;2035;5805
353740;202003;2000;5286;1381;4178;340;1113;455;1231;795;2344
353750;202003;785;2364;539;1880;129;488;96;344;225;832
353760;202003;12372;29049;9322;24855;1783;4890;5108;13343;6891;18233
353770;202003;682;2052;384;1288;64;236;62;178;126;414
353780;202003;5061;14191;3942;12007;806;2736;1861;5225;2667;7961
353790;202003;2503;7649;1815;6181;523;2009;378;1096;901;3105
353800;202003;17180;45269;13167;38743;1911;6014;7324;21510;9235;27524
353810;202003;1094;2964;692;2103;111;377;287;823;398;1200
353820;202003;1636;4450;1120;3408;245;806;356;1011;601;1817
353830;202003;605;1539;440;1263;75;230;193;518;268;748
353850;202003;1566;4420;1193;3689;276;867;417;1263;693;2130
353860;202003;2470;6916;1889;5859;457;1626;820;2285;1277;3911
353870;202003;28500;75117;19835;58007;2623;8716;10344;27542;12967;36258
353880;202003;2929;8160;2295;6932;179;636;1431;4175;1610;4811
353890;202003;2413;5301;1588;4160;130;352;1083;2727;1213;3079
353900;202003;732;2052;518;1620;83;286;201;585;284;871
353910;202003;2094;5899;1705;5270;198;732;1132;3408;1330;4140
353920;202003;1755;4885;1224;3843;286;1015;319;815;605;1830
353930;202003;4055;10841;2708;8345;511;1791;1070;2904;1581;4695
353940;202003;1031;2964;703;2291;128;425;240;736;368;1161
353950;202003;3164;8629;2410;7232;431;1426;1355;3764;1786;5190
353960;202003;693;1821;458;1366;88;286;189;535;277;821
353970;202003;663;1596;491;1338;45;134;327;868;372;1002
353980;202003;14800;37846;11286;31600;830;2681;8007;21585;8837;24266
353990;202003;897;2193;530;1522;87;267;244;668;331;935
354000;202003;2380;5781;1304;3723;286;870;216;585;502;1455
354010;202003;344;900;247;746;40;134;139;404;179;538
354020;202003;3327;9285;2601;7732;661;2116;1038;2828;1699;4944
354025;202003;699;1946;450;1437;63;229;117;360;180;589
354030;202003;484;1068;250;677;51;149;121;306;172;455
354040;202003;792;1872;499;1377;22;75;363;966;385;1041
354050;202003;930;2609;632;2067;145;504;198;648;343;1152
354060;202003;3258;9268;2220;7069;505;1718;786;2327;1291;4045
354070;202003;3485;9306;2332;7034;418;1447;939;2416;1357;3863
354075;202003;2502;7336;1897;6173;233;877;1069;3369;1302;4246
354080;202003;1310;3592;860;2712;189;636;200;564;389;1200
354085;202003;398;848;309;732;0;0;228;501;228;501
354090;202003;1575;4474;1339;3969;89;284;1023;2961;1112;3245
354100;202003;18968;51954;12878;41183;2858;9840;4876;15495;7734;25335
354105;202003;1489;3760;1001;2857;132;383;465;1249;597;1632
354110;202003;472;1307;316;1013;48;167;112;356;160;523
354120;202003;1384;3734;914;2718;185;601;310;800;495;1401
354130;202003;5318;14128;3464;10535;881;2872;207;415;1088;3287
354140;202003;18140;44371;11948;33030;2086;6392;5056;12920;7142;19312
354150;202003;2937;6999;2169;5768;483;1336;875;2269;1358;3605
354160;202003;2911;8438;2129;6844;609;2109;593;1735;1202;3844
354165;202003;591;1801;456;1533;75;293;231;738;306;1031
354170;202003;1617;4542;1342;4000;69;240;876;2512;945;2752
354180;202003;383;1073;271;834;53;170;106;298;159;468
354190;202003;1396;3960;950;3027;63;232;416;1301;479;1533
354200;202003;828;2023;630;1715;72;211;406;1058;478;1269
354210;202003;750;1987;592;1722;38;137;435;1197;473;1334
354220;202003;3039;8250;2218;6591;384;1225;1093;3097;1477;4322
354230;202003;702;1757;550;1571;39;145;398;1092;437;1237
354240;202003;1576;4396;1050;3319;183;639;315;887;498;1526
354250;202003;508;1248;315;944;92;269;77;247;169;516
354260;202003;8107;21584;6078;17995;1266;3987;2496;7136;3762;11123
354270;202003;992;3008;800;2632;189;616;312;1001;501;1617
354280;202003;760;1937;643;1765;60;198;405;1036;465;1234
354290;202003;879;2792;733;2482;125;421;372;1299;497;1720
354300;202003;3487;10272;2934;9245;855;2703;1057;3318;1912;6021
354310;202003;669;2015;547;1752;128;430;201;605;329;1035
354320;202003;904;2228;574;1656;76;261;226;580;302;841
354323;202003;445;1083;295;814;32;71;127;338;159;409
354325;202003;1303;3898;910;3005;142;462;341;1093;483;1555
354330;202003;8970;22851;5790;16315;720;2386;3325;8676;4045;11062
354340;202003;30351;76640;19880;58149;3283;10729;9775;27278;13058;38007
354350;202003;1135;2936;896;2533;83;260;617;1669;700;1929
354360;202003;571;1480;319;1050;60;208;65;217;125;425
354370;202003;991;2870;782;2522;131;458;442;1401;573;1859
354380;202003;702;1853;497;1514;92;360;118;277;210;637
354390;202003;12673;30633;7847;22094;1488;4449;2986;8042;4474;12491
354400;202003;1537;4945;1148;4014;195;738;424;1460;619;2198
354410;202003;5405;14817;4012;11972;882;2842;1710;4854;2592;7696
354420;202003;1445;3806;1052;3081;136;426;647;1811;783;2237
354425;202003;2545;6245;1767;4886;419;1185;739;2046;1158;3231
354430;202003;1506;4010;1150;3432;124;436;684;1903;808;2339
354440;202003;539;1455;347;1054;53;186;155;432;208;618
354450;202003;405;1065;218;707;36;121;62;173;98;294
354460;202003;859;2169;555;1619;78;244;306;863;384;1107
354470;202003;461;1172;296;848;22;75;145;364;167;439
354480;202003;1174;2684;750;2000;67;187;499;1270;566;1457
354490;202003;754;2264;538;1780;114;399;227;699;341;1098
354500;202003;1949;5540;1586;4979;489;1668;364;1142;853;2810
354510;202003;704;1989;555;1684;53;172;300;831;353;1003
354515;202003;313;917;226;732;35;132;90;277;125;409
354520;202003;6325;17507;4291;13070;632;2206;2338;6633;2970;8839
354530;202003;4107;11784;3125;9824;746;2408;1210;3830;1956;6238
354540;202003;1282;3406;919;2761;215;680;346;1046;561;1726
354550;202003;526;1384;401;1140;56;174;232;625;288;799
354560;202003;2105;5131;1119;3209;141;416;557;1495;698;1911
354570;202003;1181;2971;472;1359;79;242;64;181;143;423
354580;202003;8757;22924;5580;16860;850;2813;2779;8050;3629;10863
354600;202003;1790;4875;1352;4036;150;524;867;2448;1017;2972
354610;202003;414;1077;226;682;26;79;100;292;126;371
354620;202003;406;1170;247;842;49;192;89;272;138;464
354625;202003;305;814;160;517;30;100;23;50;53;150
354630;202003;1882;5676;1493;4864;537;1839;253;756;790;2595
354640;202003;3109;8937;2238;7167;408;1440;794;2349;1202;3789
354650;202003;846;2215;667;1917;54;152;419;1190;473;1342
354660;202003;3678;8601;1881;5554;176;641;882;2362;1058;3003
354670;202003;1062;2986;721;2289;150;504;264;760;414;1264
354680;202003;4897;13019;3716;11039;876;2702;1830;5565;2706;8267
354690;202003;494;1581;348;1249;78;289;93;325;171;614
354700;202003;852;2258;600;1768;88;280;299;838;387;1118
354710;202003;459;1253;333;1004;45;155;147;382;192;537
354720;202003;281;677;122;361;38;120;27;78;65;198
354730;202003;9421;26512;6949;21713;997;3404;3863;11671;4860;15075
354740;202003;309;846;117;398;19;76;19;62;38;138
354750;202003;2370;6164;1466;4433;253;834;635;1722;888;2556
354760;202003;1910;5197;1296;4009;325;1092;400;1135;725;2227
354765;202003;375;1003;142;460;21;70;28;78;49;148
354770;202003;2225;5539;1614;4500;301;944;768;1983;1069;2927
354780;202003;52561;134295;39168;107515;4453;13734;24098;62118;28551;75852
354790;202003;949;2625;739;2276;83;280;449;1328;532;1608
354800;202003;2479;6404;1912;5527;486;1438;806;2211;1292;3649
354805;202003;1321;3031;883;2380;103;278;518;1296;621;1574
354810;202003;638;1856;349;1230;39;166;75;237;114;403
354820;202003;900;2604;622;2051;114;418;161;427;275;845
354830;202003;444;1092;280;792;55;168;96;253;151;421
354840;202003;853;2103;488;1385;39;125;291;781;330;906
354850;202003;21112;54787;14480;42728;1667;5719;8606;24005;10273;29724
354860;202003;1705;4835;1017;3323;181;651;301;888;482;1539
354870;202003;55741;141169;42531;116495;4771;14425;26203;67853;30974;82278
354880;202003;5603;13876;2577;7354;321;1061;937;2152;1258;3213
354890;202003;16387;40901;12588;34461;1713;5305;7490;19794;9203;25099
354900;202003;391;992;246;734;40;129;69;184;109;313
354910;202003;5176;13621;2996;9599;673;2278;473;1458;1146;3736
354920;202003;472;1267;216;738;29;112;44;157;73;269
354925;202003;283;814;168;545;19;70;39;109;58;179
354930;202003;390;921;222;637;14;49;108;284;122;333
354940;202003;2238;6793;1543;5217;522;1891;271;840;793;2731
354950;202003;1430;3729;1123;3299;57;234;828;2301;885;2535
354960;202003;888;2370;672;2048;55;198;391;1134;446;1332
354970;202003;4015;11298;3086;9671;372;1304;1931;5866;2303;7170
354980;202003;30875;73154;20008;54312;2248;7261;11877;29965;14125;37226
354990;202003;60630;154403;44560;124929;3913;12650;28548;75752;32461;88402
354995;202003;2740;6301;2051;5385;182;580;1458;3642;1640;4222
355000;202003;1547;3881;1153;3309;176;595;554;1465;730;2060
355010;202003;3699;10095;2144;6757;714;2336;221;726;935;3062
355020;202003;3512;9940;2530;8174;619;2185;883;2720;1502;4905
355030;202003;1301878;3203700;918483;2455122;143435;421399;449026;1106171;592461;1527570
355040;202003;2795;7077;2166;6243;322;921;1470;4284;1792;5205
355050;202003;947;2206;668;1789;173;512;259;632;432;1144
355060;202003;6008;16321;4324;13098;730;2560;2082;5724;2812;8284
355070;202003;8501;22108;6744;19269;792;2627;4289;11563;5081;14190
355080;202003;907;2599;551;1901;108;411;83;223;191;634
355090;202003;1081;3161;801;2663;215;707;234;810;449;1517
355100;202003;22283;58488;17014;50530;2786;8753;10077;29657;12863;38410
355110;202003;807;2276;579;1909;175;646;102;309;277;955
355120;202003;678;1787;478;1487;36;126;202;594;238;720
355130;202003;857;1933;394;1079;28;89;221;573;249;662
355140;202003;1795;4145;1500;3730;103;308;1222;2938;1325;3246
355150;202003;4201;11132;3305;9525;388;1255;2090;5770;2478;7025
355160;202003;1846;5106;1304;4113;327;1136;292;875;619;2011
355170;202003;9797;25010;7499;21087;1463;4456;3916;10649;5379;15105
355180;202003;2719;7386;1895;5962;420;1464;670;1915;1090;3379
355190;202003;1835;4825;1432;4195;339;995;760;2354;1099;3349
355200;202003;825;2542;689;2317;183;680;286;913;469;1593
355210;202003;2768;7627;2132;6308;423;1423;1067;2945;1490;4368
355220;202003;43382;115693;33740;96983;8060;24701;13660;36372;21720;61073
355230;202003;1107;2793;595;1768;103;299;208;579;311;878
355240;202003;23065;61179;15839;46617;2244;7187;8443;23481;10687;30668
355250;202003;36313;97684;26286;77975;6597;20663;9669;27289;16266;47952
355255;202003;690;1740;359;1109;59;204;134;396;193;600
355260;202003;1386;3504;1002;2837;137;463;570;1492;707;1955
355270;202003;1165;3489;897;2924;204;685;296;894;500;1579
355280;202003;28446;73577;19597;56479;2992;9346;9144;24871;12136;34217
355290;202003;851;2355;633;1944;137;401;259;777;396;1178
355300;202003;1204;3546;920;2944;178;640;311;930;489;1570
355310;202003;956;2657;718;2255;99;307;394;1253;493;1560
355320;202003;508;1337;370;1085;74;251;150;356;224;607
355330;202003;2579;6721;1926;5573;146;533;1405;3878;1551;4411
355340;202003;3919;8686;2990;7439;376;826;1879;4800;2255;5626
355350;202003;1262;3689;928;3040;201;680;324;1051;525;1731
355360;202003;1134;2926;865;2531;118;371;524;1511;642;1882
355365;202003;359;949;185;633;41;130;30;105;71;235
355370;202003;5291;13553;4053;11607;981;2618;1799;5663;2780;8281
355380;202003;2830;7592;2104;6213;388;1239;750;1936;1138;3175
355385;202003;1385;3682;1122;3282;106;377;711;1923;817;2300
355390;202003;784;2172;548;1641;123;398;222;596;345;994
355395;202003;1882;5200;1275;3973;225;747;440;1226;665;1973
355400;202003;8858;25582;6944;21721;1730;6159;2398;6695;4128;12854
355410;202003;21733;59549;13323;42417;2875;10106;3313;10393;6188;20499
355420;202003;614;1984;496;1746;143;555;121;409;264;964
355430;202003;3639;9330;2705;7627;658;1810;1219;3439;1877;5249
355440;202003;781;2133;466;1459;85;276;137;398;222;674
355450;202003;3037;7879;1928;5651;362;1132;780;2075;1142;3207
355460;202003;484;1197;306;898;43;164;142;373;185;537
355465;202003;374;1015;280;856;42;136;135;413;177;549
355470;202003;1052;2711;587;1792;165;563;174;462;339;1025
355475;202003;350;836;276;726;17;40;201;516;218;556
355480;202003;3694;10322;3007;9294;454;1627;1944;5812;2398;7439
355490;202003;921;2469;485;1507;34;120;248;697;282;817
355495;202003;749;2137;541;1761;71;260;190;573;261;833
355500;202003;6475;16870;3738;11359;597;1994;1239;3489;1836;5483
355510;202003;1269;3120;786;2287;105;353;346;899;451;1252
355520;202003;366;808;164;477;27;79;47;123;74;202
355530;202003;408;946;142;419;19;71;52;135;71;206
355535;202003;495;1370;369;1161;75;291;161;453;236;744
355540;202003;10236;26031;8265;23187;1329;4049;5179;14104;6508;18153
355550;202003;617;1835;503;1622;68;243;269;818;337;1061
355560;202003;1080;2804;567;1797;132;464;36;117;168;581
355570;202003;241;690;128;420;22;71;34;103;56;174
355580;202003;1186;2924;784;2236;141;445;321;863;462;1308
355590;202003;170;424;129;356;17;52;77;200;94;252
355600;202003;1394;3404;925;2630;184;564;392;1082;576;1646
355610;202003;1710;4251;1127;3230;132;420;595;1621;727;2041
355620;202003;4396;11823;3194;9468;366;1320;1739;4730;2105;6050
355630;202003;2257;6241;1558;4902;255;836;768;2386;1023;3222
355635;202003;862;2528;626;2062;120;446;181;533;301;979
355640;202003;2898;8158;1902;6129;369;1283;562;1741;931;3024
355645;202003;4116;11602;2969;9565;438;1525;1593;5046;2031;6571
355650;202003;6472;17471;5050;14856;1403;4285;1692;4499;3095;8784
355660;202003;1251;3289;853;2539;139;485;295;855;434;1340
355670;202003;3339;9028;2170;6398;282;1001;1094;2827;1376;3828
355680;202003;2676;7405;1135;3771;304;1063;122;425;426;1488
355690;202003;791;2351;492;1730;109;419;22;51;131;470
355695;202003;239;668;137;446;12;59;26;58;38;117
355700;202003;6995;20181;5627;17091;995;3173;2941;8498;3936;11671
355710;202003;8236;19528;5138;13811;804;2385;2279;5457;3083;7842
355715;202003;478;1276;243;750;50;168;47;128;97;296
355720;202003;1449;4095;1133;3530;187;619;604;1775;791;2394
355730;202003;888;2476;717;2145;135;443;319;866;454;1309
410010;202003;1198;3349;897;2701;189;617;181;530;370;1147
410020;202003;936;2959;718;2425;270;852;159;567;429;1419
410030;202003;1479;4135;1244;3759;174;588;675;2038;849;2626
410040;202003;11557;32174;8327;26083;1816;6094;2634;7658;4450;13752
410045;202003;832;2235;575;1756;80;282;208;584;288;866
410050;202003;2252;5646;1472;4265;291;923;470;1254;761;2177
410060;202003;1959;5653;1494;4690;361;1203;461;1397;822;2600
410070;202003;1796;4633;1286;3682;208;668;502;1323;710;1991
410080;202003;1327;3586;939;2857;213;669;309;956;522;1625
410090;202003;1070;2772;914;2522;85;225;570;1638;655;1863
410100;202003;1790;5215;1180;3704;171;608;160;479;331;1087
410105;202003;450;1154;241;745;33;108;71;210;104;318
410110;202003;2967;7608;2027;5771;282;858;848;2297;1130;3155
410115;202003;541;1406;377;1114;52;173;138;391;190;564
410120;202003;2423;7029;2090;6484;479;1650;1018;3039;1497;4689
410130;202003;1133;3107;979;2812;204;659;477;1265;681;1924
410140;202003;13737;33153;8298;23317;1599;4956;1896;4877;3495;9833
410150;202003;15701;37228;7535;21070;1268;3921;1694;4366;2962;8287
410160;202003;2804;7813;2235;6807;513;1715;778;2374;1291;4089
410165;202003;719;1935;590;1672;57;194;344;906;401;1100
410170;202003;2572;6740;1671;4780;386;1213;128;364;514;1577
410180;202003;14577;40711;11093;33509;1514;4987;5847;16534;7361;21521
410185;202003;426;1244;297;916;54;179;85;239;139;418
410190;202003;2179;5414;1547;4283;326;930;419;1109;745;2039
410200;202003;4860;11381;2580;7384;425;1413;449;1242;874;2655
410210;202003;2974;7509;1798;5330;286;967;611;1557;897;2524
410220;202003;500;1299;320;956;51;174;82;228;133;402
410230;202003;1618;4348;1219;3529;158;525;647;1757;805;2282
410240;202003;4673;12520;3183;9617;802;2702;258;725;1060;3427
410250;202003;2555;6113;1852;4945;134;460;924;2396;1058;2856
410260;202003;1833;4646;1132;3299;189;562;489;1410;678;1972
410270;202003;452;1205;323;978;47;161;116;334;163;495
410275;202003;589;1672;393;1265;48;172;192;569;240;741
410280;202003;2213;5957;1446;4407;229;777;569;1596;798;2373
410290;202003;3201;9048;2163;6798;589;1869;558;1734;1147;3603
410300;202003;626;1592;493;1370;37;115;252;658;289;773
410302;202003;380;943;200;604;25;83;97;282;122;365
410304;202003;1204;3140;999;2766;114;308;592;1600;706;1908
410305;202003;1697;4099;1136;3286;127;403;686;1926;813;2329
410310;202003;2479;7088;1953;6050;344;1153;880;2724;1224;3877
410315;202003;659;1576;343;1062;122;382;81;249;203;631
410320;202003;1050;2918;704;2197;108;383;130;381;238;764
410322;202003;537;1434;291;883;29;97;149;416;178;513
410330;202003;1469;3607;1000;2716;167;498;294;785;461;1283
410335;202003;813;2214;624;1856;96;309;281;781;377;1090
410337;202003;791;1911;543;1430;58;155;230;575;288;730
410340;202003;464;1305;306;902;27;87;141;347;168;434
410345;202003;2345;6042;1171;3443;243;755;329;863;572;1618
410347;202003;676;1731;486;1381;44;149;151;433;195;582
410350;202003;1245;3161;877;2539;117;357;359;984;476;1341
410360;202003;4249;10400;3257;8674;370;1097;1838;4698;2208;5795
410370;202003;12593;34333;7958;23212;991;3172;3274;8497;4265;11669
410380;202003;1420;3634;1031;2905;143;435;364;939;507;1374
410390;202003;2543;6546;1627;4842;382;1257;471;1285;853;2542
410395;202003;842;2453;682;2107;137;461;288;887;425;1348
410400;202003;5836;15622;4237;12468;664;2075;1950;5447;2614;7522
410405;202003;801;1933;589;1618;109;342;255;651;364;993
410410;202003;1200;3284;1117;3154;164;550;704;2053;868;2603
410420;202003;8964;25127;6629;20437;1156;3962;2331;6466;3487;10428
410425;202003;3049;8572;2058;6516;351;1217;750;2158;1101;3375
410430;202003;12435;31398;8474;24084;1391;4369;2856;7640;4247;12009
410440;202003;2260;6791;1921;6149;287;1034;1016;3188;1303;4222
410442;202003;2060;6404;1715;5633;496;1675;535;1696;1031;3371
410445;202003;2217;6477;1622;5297;323;1191;378;1305;701;2496
410450;202003;1378;3466;1000;2849;184;589;355;949;539;1538
410460;202003;1955;4826;1505;4116;165;471;756;2002;921;2473
410465;202003;2588;7575;2001;6431;376;1267;698;2102;1074;3369
410470;202003;1964;5467;1377;4363;367;1323;219;732;586;2055
410480;202003;36389;86396;18877;55064;3036;9936;3984;9931;7020;19867
410490;202003;10675;29860;7503;23190;1401;4729;2890;8409;4291;13138
410500;202003;1671;4545;1131;3474;250;902;329;876;579;1778
410510;202003;1825;4506;1185;3308;238;653;332;940;570;1593
410520;202003;2972;9419;2639;8721;904;3074;927;3152;1831;6226
410530;202003;1533;3808;724;2082;100;285;173;414;273;699
410540;202003;2640;7170;1804;5472;278;915;827;2426;1105;3341
410550;202003;6994;18817;4444;13091;780;2497;1207;3083;1987;5580
410560;202003;1414;3746;1037;2956;229;711;363;900;592;1611
410570;202003;2422;6765;1777;5592;489;1808;196;670;685;2478
410580;202003;24207;63295;17398;50711;3498;10916;7193;19612;10691;30528
410590;202003;1534;4391;1013;3122;151;485;289;785;440;1270
410600;202003;1730;4681;1308;3850;280;796;477;1449;757;2245
410610;202003;694;1848;506;1483;57;204;220;610;277;814
410620;202003;2213;6509;1405;4579;313;1121;268;805;581;1926
410630;202003;2295;6091;1470;4370;272;920;289;697;561;1617
410640;202003;4531;10646;3015;7994;669;2083;411;1077;1080;3160
410645;202003;1023;2949;830;2697;275;915;342;1136;617;2051
410650;202003;2097;5761;1395;4293;276;922;483;1371;759;2293
410655;202003;891;2147;627;1675;24;76;322;816;346;892
410657;202003;611;1658;371;1129;51;195;132;323;183;518
410660;202003;3240;8415;1790;5202;318;971;451;1240;769;2211
410670;202003;1035;2611;614;1787;128;384;222;594;350;978
410680;202003;2588;7874;1861;6020;459;1521;337;1115;796;2636
410685;202003;528;1356;398;1134;98;324;157;401;255;725
410690;202003;120519;297315;77072;215776;12627;40511;27864;68832;40491;109343
410700;202003;2381;6094;1992;5480;285;810;1057;2828;1342;3638
410710;202003;814;2081;518;1517;77;235;228;630;305;865
410712;202003;611;1791;502;1577;132;448;174;525;306;973
410715;202003;802;2333;486;1609;70;238;165;512;235;750
410720;202003;3079;7807;2391;6482;327;1038;511;1357;838;2395
410725;202003;1036;2554;586;1714;114;357;84;201;198;558
410730;202003;621;1660;473;1391;107;364;97;277;204;641
410740;202003;922;2582;673;2108;90;316;274;837;364;1153
410750;202003;1724;4379;1354;3690;206;630;615;1587;821;2217
410752;202003;355;911;169;522;22;76;71;205;93;281
410753;202003;273;819;185;619;30;118;43;133;73;251
410754;202003;1064;2766;880;2481;56;140;609;1817;665;1957
410755;202003;562;1463;380;1099;55;171;160;407;215;578
410760;202003;3366;8806;2362;6977;590;1978;518;1393;1108;3371
410765;202003;12283;34642;9419;28934;1594;5390;1873;5175;3467;10565
410770;202003;1019;2447;696;1899;67;187;354;966;421;1153
410773;202003;1240;3344;1079;3097;109;354;664;1849;773;2203
410775;202003;1428;3594;1235;3302;72;211;807;2130;879;2341
410780;202003;605;1501;391;1088;61;185;98;263;159;448
410785;202003;695;1839;529;1552;95;303;182;540;277;843
410790;202003;729;2064;587;1790;168;569;67;145;235;714
410800;202003;3277;7308;2635;6363;45;159;1717;4060;1762;4219
410810;202003;365;990;276;819;23;67;132;370;155;437
410820;202003;814;2317;410;1279;78;254;74;211;152;465
410830;202003;32587;79563;21253;60316;4440;14420;7106;19044;11546;33464
410832;202003;973;2537;763;2162;90;288;444;1190;534;1478
410840;202003;7875;20222;4602;13852;858;2818;1179;3247;2037;6065
410845;202003;1099;2781;852;2400;155;465;368;1014;523;1479
410850;202003;2166;6298;1884;5781;300;1017;943;2795;1243;3812
410855;202003;757;1912;490;1398;41;110;230;616;271;726
410860;202003;4257;10521;3316;8974;350;1100;1846;4728;2196;5828
410865;202003;1306;3909;1152;3603;127;452;694;2202;821;2654
410870;202003;1240;3348;1028;2989;79;247;697;2007;776;2254
410880;202003;4222;11566;2936;9149;506;1713;457;1567;963;3280
410890;202003;940;2682;689;2186;150;528;183;573;333;1101
410895;202003;950;3076;805;2756;250;928;163;522;413;1450
410900;202003;799;2109;534;1584;98;297;97;237;195;534
410910;202003;367;872;223;605;13;48;136;342;149;390
410920;202003;808;1946;552;1539;74;226;267;737;341;963
410930;202003;1616;4181;1102;3263;262;911;233;668;495;1579
410940;202003;21802;59945;15495;48357;3192;11015;4740;14536;7932;25551
410950;202003;1890;5550;1672;5211;47;181;1392;4287;1439;4468
410960;202003;6881;17514;4483;13312;1025;3397;1625;4741;2650;8138
410965;202003;985;2536;684;1967;82;265;387;1092;469;1357
410970;202003;3778;10206;2591;7891;597;2167;364;942;961;3109
410975;202003;1276;3205;958;2690;95;283;462;1300;557;1583
410980;202003;6770;17173;4197;12440;503;1689;1752;4814;2255;6503
410990;202003;1325;3252;858;2515;222;756;270;746;492;1502
411000;202003;590;1582;384;1178;51;186;115;303;166;489
411005;202003;394;1055;240;721;43;136;62;171;105;307
411007;202003;2222;6266;1814;5552;431;1387;629;1923;1060;3310
411010;202003;4082;12262;3200;10436;828;2927;367;1092;1195;4019
411020;202003;2184;6317;1784;5584;526;1722;500;1520;1026;3242
411030;202003;719;1795;496;1328;25;97;288;691;313;788
411040;202003;889;2249;443;1259;46;147;144;351;190;498
411050;202003;1839;5749;1485;4967;407;1469;229;656;636;2125
411060;202003;1807;4700;1126;3374;260;928;184;485;444;1413
411065;202003;370;970;245;723;34;115;104;287;138;402
411070;202003;6633;17195;5190;14751;732;2315;2500;6891;3232;9206
411080;202003;2063;5449;1612;4643;417;1372;324;903;741;2275
411090;202003;810;2139;521;1574;44;170;145;412;189;582
411095;202003;1532;3617;1034;2845;118;349;336;885;454;1234
411100;202003;1092;2852;733;2206;83;287;226;690;309;977
411110;202003;631;1621;279;863;35;107;17;37;52;144
411120;202003;1165;3296;951;2886;311;1073;216;589;527;1662
411125;202003;4972;14664;4378;13515;931;2875;2128;6842;3059;9717
411130;202003;688;1864;479;1464;90;254;180;583;270;837
411140;202003;2178;6756;1827;5990;540;1891;484;1554;1024;3445
411150;202003;3692;9547;2456;7015;499;1656;241;504;740;2160
411155;202003;951;2431;551;1674;79;235;226;651;305;886
411160;202003;355;817;234;655;31;94;52;150;83;244
411170;202003;672;2031;492;1602;111;352;157;501;268;853
411180;202003;5155;13717;3940;11545;590;1923;1841;5088;2431;7011
411190;202003;1559;4020;1150;3294;189;577;455;1197;644;1774
411200;202003;4857;13182;3330;10253;855;2920;635;1684;1490;4604
411210;202003;3025;6750;1937;4955;338;975;617;1488;955;2463
411220;202003;818;2130;586;1682;132;411;169;461;301;872
411230;202003;825;2216;582;1732;117;371;217;637;334;1008
411240;202003;1462;3568;932;2581;104;339;456;1161;560;1500
411250;202003;2164;5805;1582;4747;316;1097;498;1440;814;2537
411260;202003;317;852;199;607;24;68;78;221;102;289
411270;202003;1938;5232;1441;4227;209;639;712;1946;921;2585
411275;202003;1391;3227;941;2480;144;458;418;1028;562;1486
411280;202003;1294;3495;845;2622;230;728;114;342;344;1070
411290;202003;787;2087;497;1506;50;136;253;800;303;936
411295;202003;1210;3043;860;2354;104;301;379;974;483;1275
411300;202003;977;2451;606;1731;55;175;262;659;317;834
411310;202003;831;1945;627;1643;44;112;286;737;330;849
411320;202003;5239;13697;3751;10981;670;2102;1531;4034;2201;6136
411325;202003;1382;3955;1170;3590;191;580;661;2090;852;2670
411330;202003;3291;8893;2357;7174;533;1769;745;2273;1278;4042
411340;202003;800;2185;471;1449;63;212;164;481;227;693
411342;202003;993;2425;581;1613;97;292;246;653;343;945
411345;202003;1016;2653;761;2231;61;196;547;1623;608;1819
411350;202003;2548;6971;1629;5090;421;1432;225;644;646;2076
411360;202003;661;1604;471;1307;64;184;154;415;218;599
411370;202003;51476;126637;36117;100527;2613;8823;21674;56821;24287;65644
411373;202003;1355;3454;1094;3064;93;320;595;1685;688;2005
411375;202003;1060;2688;762;2121;127;368;302;808;429;1176
411380;202003;1088;2546;710;1820;36;104;430;1029;466;1133
411390;202003;1474;4067;1141;3342;180;590;465;1197;645;1787
411400;202003;2217;5568;1667;4522;172;551;836;2155;1008;2706
411410;202003;2330;6461;1681;5045;366;1210;387;1123;753;2333
411420;202003;3930;9707;2055;6066;287;979;371;852;658;1831
411430;202003;3315;9034;2486;7453;541;1758;856;2343;1397;4101
411435;202003;407;1145;252;805;51;154;80;210;131;364
411440;202003;2387;6775;1911;5864;391;1317;681;2034;1072;3351
411450;202003;2441;6533;1861;5576;240;727;1009;3068;1249;3795
411460;202003;3682;9613;2206;6720;390;1406;411;1152;801;2558
411470;202003;709;1855;507;1459;99;298;180;481;279;779
411480;202003;4482;12098;3196;9670;670;2378;1049;2889;1719;5267
411490;202003;1600;4143;1216;3503;155;518;514;1349;669;1867
411500;202003;1252;3381;822;2443;145;481;167;410;312;891
411510;202003;2228;5740;1757;4907;392;1276;409;1151;801;2427
411520;202003;29757;72428;16664;46853;1987;6508;6283;15841;8270;22349
411530;202003;879;2303;516;1590;92;321;79;218;171;539
411535;202003;448;1308;249;816;26;99;65;168;91;267
411540;202003;2674;6555;1794;4948;172;553;897;2378;1069;2931
411545;202003;903;2621;749;2351;69;212;489;1559;558;1771
411550;202003;684;1755;476;1363;70;220;82;244;152;464
411560;202003;1901;5107;1078;3338;155;537;82;227;237;764
411570;202003;6811;15930;4418;12200;968;2940;758;2052;1726;4992
411573;202003;746;2019;631;1843;94;291;329;942;423;1233
411575;202003;1840;5088;1362;4105;275;901;320;955;595;1856
411580;202003;4528;10375;2654;7480;377;1314;489;1272;866;2586
411585;202003;618;1846;283;943;70;242;52;153;122;395
411590;202003;374;1046;254;787;29;91;135;387;164;478
411600;202003;276;701;173;539;37;120;53;159;90;279
411605;202003;1470;3420;883;2463;110;386;471;1295;581;1681
411610;202003;2431;5889;1686;4513;81;277;1086;2691;1167;2968
411620;202003;2758;7399;2333;6728;400;1223;1279;3673;1679;4896
411630;202003;714;1873;469;1394;73;258;163;438;236;696
411640;202003;454;1194;318;902;47;148;117;303;164;451
411650;202003;197;588;125;426;25;91;20;56;45;147
411660;202003;876;2206;622;1746;48;149;295;804;343;953
411670;202003;1329;3300;884;2407;103;307;403;1033;506;1340
411680;202003;1431;3834;1052;3087;140;471;467;1320;607;1791
411690;202003;3521;9076;2630;7538;566;1651;811;2440;1377;4091
411695;202003;628;1933;390;1282;42;151;158;497;200;648
411700;202003;1568;4079;995;2990;220;720;148;410;368;1130
411705;202003;1773;5590;1499;5117;291;936;845;3123;1136;4059
411710;202003;1791;4586;1202;3467;277;822;213;600;490;1422
411720;202003;1044;2441;736;1900;143;389;298;720;441;1109
411721;202003;911;2315;670;1873;131;369;161;446;292;815
411722;202003;759;2051;403;1195;50;170;148;367;198;537
411725;202003;1117;3169;750;2440;178;617;168;559;346;1176
411727;202003;1436;4032;922;2907;210;692;165;486;375;1178
411729;202003;692;1680;431;1177;50;186;163;388;213;574
411730;202003;5015;13447;3847;11123;813;2527;1604;4551;2417;7078
411740;202003;531;1375;262;793;52;147;61;170;113;317
411745;202003;711;2020;473;1490;70;237;74;170;144;407
411750;202003;4920;13070;3517;10292;469;1489;1743;4824;2212;6313
411760;202003;6556;17652;5006;14924;1678;5212;981;3242;2659;8454
411770;202003;2863;8367;2062;6567;513;1745;288;846;801;2591
411780;202003;2743;7765;2323;6960;647;2030;780;2352;1427;4382
411790;202003;2756;6678;1446;4293;312;1059;218;560;530;1619
411800;202003;928;2634;658;2034;107;350;129;382;236;732
411810;202003;1493;3939;1094;3119;178;520;513;1389;691;1909
411820;202003;10803;31120;8644;27267;2167;7293;3609;11128;5776;18421
411830;202003;564;1390;417;1140;79;233;99;300;178;533
411840;202003;11383;30635;7471;22372;1287;4180;1920;5284;3207;9464
411845;202003;503;1465;259;854;30;125;52;161;82;286
411850;202003;7092;18198;4778;14093;1210;4021;788;2118;1998;6139
411860;202003;664;1885;476;1487;70;222;128;364;198;586
411870;202003;578;1693;399;1283;84;302;99;280;183;582
411880;202003;2195;5526;1591;4538;227;735;549;1520;776;2255
411885;202003;1011;2589;704;2039;96;323;238;636;334;959
411890;202003;1158;3070;752;2298;133;454;82;236;215;690
411900;202003;766;2128;455;1451;104;358;63;190;167;548
411910;202003;881;2614;625;2060;158;584;209;627;367;1211
411915;202003;14672;36101;9543;26782;1458;4615;3643;9182;5101;13797
411920;202003;1033;3117;852;2718;204;745;293;869;497;1614
411925;202003;459;1216;329;981;68;231;130;362;198;593
411930;202003;4840;15022;4069;13511;1751;6350;268;1029;2019;7379
411940;202003;3222;9637;2456;7921;601;2018;766;2233;1367;4251
411950;202003;13012;35425;10563;31394;1577;5277;6011;17179;7588;22456
411960;202003;5766;15604;4537;13078;838;2674;1728;4701;2566;7375
411965;202003;415;1171;290;919;44;155;114;325;158;480
411970;202003;1031;2451;795;2130;157;394;352;1067;509;1461
411980;202003;1450;3644;1036;2950;254;740;377;1035;631;1775
411990;202003;37477;98371;23410;72144;4387;14947;7964;23439;12351;38386
411995;202003;2957;7413;2181;6208;620;1977;603;1616;1223;3593
412000;202003;1916;4406;1345;3441;30;95;958;2304;988;2399
412010;202003;560;1748;401;1398;65;238;105;310;170;548
412015;202003;532;1506;435;1334;56;187;255;776;311;963
412020;202003;437;1223;268;852;37;147;116;344;153;491
412030;202003;580;1630;400;1290;65;214;118;378;183;592
412033;202003;830;2243;575;1701;64;187;200;528;264;715
412035;202003;756;2044;479;1526;53;208;260;781;313;989
412040;202003;560;1484;348;1052;49;143;67;203;116;346
412050;202003;1571;3936;1055;2987;212;679;263;740;475;1419
412060;202003;6888;20455;5679;17994;1502;5405;1640;4956;3142;10361
412065;202003;603;1663;433;1310;96;314;108;327;204;641
412070;202003;1055;2733;826;2272;106;312;345;893;451;1205
412080;202003;1964;5556;1232;3992;187;632;217;643;404;1275
412085;202003;268;642;87;279;9;23;14;39;23;62
412090;202003;5695;14929;4213;12113;1108;3325;1477;4333;2585;7658
412100;202003;1531;4259;1152;3546;326;1091;265;898;591;1989
412110;202003;806;2118;552;1605;82;241;185;514;267;755
412120;202003;1914;5581;1462;4669;284;1005;417;1143;701;2148
412125;202003;621;1776;434;1378;93;307;118;348;211;655
412130;202003;740;1903;501;1441;74;226;142;416;216;642
412135;202003;605;1609;267;810;42;128;92;250;134;378
412140;202003;1566;3797;1019;2834;188;643;202;535;390;1178
412150;202003;2690;7156;2267;6395;324;1059;1380;3662;1704;4721
412160;202003;932;2890;527;1790;94;341;93;278;187;619
412170;202003;4108;11465;3419;10360;706;2332;1390;3905;2096;6237
412175;202003;1260;3649;1042;3271;225;723;452;1441;677;2164
412180;202003;1572;4373;1123;3523;142;522;523;1506;665;2028
412190;202003;3287;8263;2418;6727;325;987;1061;2938;1386;3925
412200;202003;1680;5031;1198;3891;324;1156;192;570;516;1726
412210;202003;596;1434;347;977;47;148;128;323;175;471
412215;202003;3244;8833;2547;7475;628;1806;1092;3548;1720;5354
412217;202003;900;2386;761;2149;52;162;505;1387;557;1549
412220;202003;5708;15904;4521;13703;1118;3394;1465;4688;2583;8082
412230;202003;2490;7432;1984;6449;347;1278;537;1501;884;2779
412240;202003;6606;16951;4124;12151;729;2338;1223;3284;1952;5622
412250;202003;1986;5123;1473;4160;343;1018;341;906;684;1924
412260;202003;1154;3112;807;2356;146;447;237;666;383;1113
412265;202003;863;2372;674;2041;131;413;284;821;415;1234
412270;202003;921;2520;576;1793;74;260;224;631;298;891
412280;202003;386;1080;301;942;62;209;93;265;155;474
412290;202003;978;2502;649;1900;100;313;202;562;302;875
412300;202003;1632;4224;1118;3295;244;760;240;728;484;1488
412310;202003;725;2014;590;1756;84;308;240;665;324;973
412320;202003;824;2146;539;1561;67;237;188;549;255;786
412330;202003;1486;4022;981;3026;191;652;325;1026;516;1678
412340;202003;1120;3151;679;2158;101;377;116;334;217;711
412350;202003;2751;7128;1727;5094;354;1092;314;835;668;1927
412360;202003;251;696;166;504;6;28;94;267;100;295
412370;202003;817;2355;539;1740;106;391;45;153;151;544
412380;202003;1483;4040;1038;3141;288;903;135;478;423;1381
412382;202003;499;1240;323;951;45;160;133;335;178;495
412385;202003;2126;5868;1715;5058;542;1516;529;1741;1071;3257
412390;202003;2303;5660;1860;4998;322;873;738;2016;1060;2889
412395;202003;674;1928;463;1443;51;142;199;636;250;778
412400;202003;859;2305;607;1807;119;399;171;504;290;903
412402;202003;1936;4792;1292;3698;323;953;166;481;489;1434
412405;202003;2891;7626;1851;5636;493;1807;47;138;540;1945
412410;202003;5578;14600;4038;12037;738;2523;1323;3771;2061;6294
412420;202003;499;1286;322;936;22;78;152;390;174;468
412430;202003;574;1461;294;864;26;89;120;333;146;422
412440;202003;2602;7201;1731;5489;437;1495;283;927;720;2422
412450;202003;401;1180;264;824;43;129;22;51;65;180
412460;202003;991;2621;771;2240;144;457;362;1040;506;1497
412470;202003;1462;4805;1197;4186;314;1164;256;891;570;2055
412480;202003;975;2625;621;1844;110;355;183;484;293;839
412490;202003;1246;3179;985;2683;119;329;505;1303;624;1632
412500;202003;1867;4707;1380;3791;298;805;402;1069;700;1874
412510;202003;1836;5676;1253;4160;280;999;122;335;402;1334
412520;202003;1188;3107;625;1862;148;438;58;169;206;607
412530;202003;643;1697;466;1329;74;234;107;302;181;536
412535;202003;780;2031;521;1526;84;265;109;271;193;536
412540;202003;1149;2983;824;2357;86;316;273;809;359;1125
412545;202003;659;1703;448;1258;69;195;164;448;233;643
412550;202003;29687;79981;20325;60896;3461;11285;7894;21742;11355;33027
412555;202003;271;712;176;497;15;42;50;105;65;147
412560;202003;4600;13456;3351;10486;582;2001;987;3088;1569;5089
412570;202003;4203;10804;2320;7059;509;1727;287;972;796;2699
412575;202003;955;2432;756;2080;79;244;422;1097;501;1341
412580;202003;1386;3680;957;2827;89;317;498;1417;587;1734
412590;202003;410;1090;222;706;30;100;21;51;51;151
412600;202003;1454;4047;1056;3226;171;611;435;1243;606;1854
412610;202003;745;1961;520;1473;51;150;279;717;330;867
412620;202003;1173;3094;896;2683;168;585;293;818;461;1403
412625;202003;8398;22329;5054;15563;703;2488;325;896;1028;3384
412627;202003;1107;3108;687;2223;132;458;186;602;318;1060
412630;202003;2817;8230;1994;6410;390;1268;609;1786;999;3054
412635;202003;360;983;242;724;36;127;81;201;117;328
412640;202003;973;2578;528;1624;65;203;145;412;210;615
412650;202003;1545;4298;1219;3615;216;705;460;1198;676;1903
412660;202003;2292;5881;1582;4521;256;796;481;1232;737;2028
412665;202003;365;948;282;792;42;131;136;366;178;497
412667;202003;1674;4435;1237;3580;176;550;497;1379;673;1929
412670;202003;768;1840;502;1402;85;276;165;427;250;703
412680;202003;1738;4656;1155;3507;160;559;417;1134;577;1693
412690;202003;999;2662;722;2107;109;342;299;817;408;1159
412700;202003;1945;5178;1599;4622;189;643;883;2470;1072;3113
412710;202003;5595;16511;4123;13281;819;2968;1133;3263;1952;6231
412720;202003;1155;3392;878;2772;140;473;177;474;317;947
412730;202003;2240;6035;1431;4341;272;914;447;1284;719;2198
412740;202003;1759;4918;1184;3727;218;803;169;536;387;1339
412750;202003;3818;10080;3152;9127;306;1067;2079;5665;2385;6732
412760;202003;2819;7677;2323;6826;418;1391;1252;3464;1670;4855
412770;202003;9962;25086;5162;15550;734;2339;1162;2994;1896;5333
412780;202003;1165;3099;861;2540;188;606;342;989;530;1595
412785;202003;1956;4837;1355;3774;147;427;848;2318;995;2745
412788;202003;1263;3572;1034;3160;288;890;433;1303;721;2193
412790;202003;1266;3360;677;2108;106;377;215;598;321;975
412795;202003;1219;3175;641;1976;102;339;123;348;225;687
412796;202003;2160;6288;1771;5513;381;1265;575;1670;956;2935
412800;202003;3339;8110;2233;6059;265;813;1004;2433;1269;3246
412810;202003;10825;27651;6670;19140;825;2784;2531;6458;3356;9242
412820;202003;6269;17212;4357;13329;1047;3391;1264;3865;2311;7256
412830;202003;326;927;226;709;34;98;54;171;88;269
412840;202003;1763;4484;1239;3464;140;441;524;1359;664;1800
412850;202003;2754;7280;1974;5899;314;1003;830;2434;1144;3437
412853;202003;1512;3814;1252;3342;180;529;636;1516;816;2045
412855;202003;1203;3234;778;2308;140;495;226;634;366;1129
412860;202003;759;1866;516;1486;71;232;284;771;355;1003
412862;202003;661;1618;431;1233;77;230;183;503;260;733
412863;202003;1234;3766;1112;3539;195;629;671;2125;866;2754
412865;202003;682;1877;492;1488;125;386;144;451;269;837
412870;202003;846;2197;613;1817;169;572;124;384;293;956
412880;202003;774;2110;514;1574;93;325;85;225;178;550
420005;202003;394;1173;228;803;33;126;106;374;139;500
420010;202003;3205;7872;2097;5997;127;413;1533;4406;1660;4819
420020;202003;425;1339;275;955;42;168;62;174;104;342
420030;202003;74;258;54;215;17;73;17;67;34;140
420040;202003;509;1546;294;1058;59;235;17;44;76;279
420050;202003;697;1619;450;1170;67;201;277;653;344;854
420055;202003;158;490;88;319;21;100;31;91;52;191
420060;202003;96;263;53;156;11;37;14;32;25;69
420070;202003;646;1997;478;1637;105;377;190;632;295;1009
420075;202003;73;190;36;107;6;21;11;21;17;42
420080;202003;327;952;254;788;66;223;99;308;165;531
420090;202003;399;1242;231;826;51;193;42;134;93;327
420100;202003;1209;3221;997;2894;47;173;810;2314;857;2487
420110;202003;235;756;212;705;46;178;97;296;143;474
420120;202003;480;1307;313;950;59;210;137;348;196;558
420125;202003;325;1004;228;786;56;208;101;330;157;538
420127;202003;238;646;91;303;16;56;21;75;37;131
420130;202003;2899;8093;2168;6841;334;1284;1041;3025;1375;4309
420140;202003;3389;9173;2369;7374;662;2353;331;1028;993;3381
420150;202003;606;1567;410;1236;47;156;244;719;291;875
420160;202003;203;495;79;250;12;37;19;59;31;96
420165;202003;145;415;79;259;17;62;26;75;43;137
420170;202003;239;740;157;539;22;67;41;123;63;190
420180;202003;163;516;94;346;11;38;27;89;38;127
420190;202003;183;595;110;403;37;144;24;84;61;228
420195;202003;1323;3433;941;2805;291;1029;107;232;398;1261
420200;202003;4025;9835;2296;6593;302;1079;891;2189;1193;3268
420205;202003;1659;4504;1114;3415;165;532;605;1863;770;2395
420207;202003;1658;4372;1009;3128;197;700;398;1150;595;1850
420208;202003;302;868;173;623;55;215;47;155;102;370
420209;202003;145;492;83;298;23;94;23;84;46;178
420210;202003;2769;7157;1768;5522;337;1175;806;2475;1143;3650
420213;202003;740;2331;619;2078;135;492;304;1004;439;1496
420215;202003;172;529;116;403;30;114;18;59;48;173
420220;202003;233;684;136;466;25;102;63;192;88;294
420230;202003;4644;12769;3481;10579;529;1744;1835;5407;2364;7151
420240;202003;12109;33544;7295;22517;962;3392;3534;9654;4496;13046
420243;202003;367;1055;288;892;46;161;172;504;218;665
420245;202003;1193;3104;832;2479;64;234;501;1435;565;1669
420250;202003;419;1187;346;1062;55;195;191;541;246;736
420253;202003;471;1170;335;976;36;118;191;554;227;672
420257;202003;155;402;98;299;20;75;47;139;67;214
420260;202003;1058;2810;761;2387;123;438;474;1461;597;1899
420270;202003;474;1260;221;662;30;102;89;268;119;370
420280;202003;1058;3202;795;2665;157;590;270;884;427;1474
420285;202003;77;197;45;132;8;35;8;17;16;52
420287;202003;421;982;298;810;78;217;110;303;188;520
420290;202003;4186;11982;3146;9586;442;1579;1821;5102;2263;6681
420300;202003;6696;18992;3725;11979;717;2571;989;2817;1706;5388
420310;202003;781;1813;383;1074;42;129;200;523;242;652
420315;202003;739;2098;507;1678;111;393;198;660;309;1053
420320;202003;4672;12933;3343;10640;978;3463;783;2309;1761;5772
420325;202003;252;720;172;556;30;99;75;226;105;325
420330;202003;908;2668;563;1914;108;416;166;485;274;901
420340;202003;890;2480;655;2062;159;525;93;254;252;779
420350;202003;1138;3025;828;2458;70;240;578;1679;648;1919
420360;202003;2474;6950;1295;4341;241;877;130;430;371;1307
420370;202003;966;2637;766;2306;88;316;504;1456;592;1772
420380;202003;4172;11059;2741;8480;589;1950;1005;2998;1594;4948
420390;202003;1054;2538;721;1849;129;406;303;532;432;938
420395;202003;944;2713;631;2078;101;404;81;197;182;601
420400;202003;839;2467;563;1846;102;374;195;613;297;987
420410;202003;519;1432;397;1173;37;118;265;761;302;879
420415;202003;275;831;210;685;55;201;79;256;134;457
420417;202003;583;1743;460;1483;127;413;159;524;286;937
420419;202003;134;474;102;395;36;149;8;30;44;179
420420;202003;10170;26612;6575;20014;1911;6593;1754;4894;3665;11487
420425;202003;625;1650;405;1206;43;148;187;531;230;679
420430;202003;2962;8048;1693;5230;397;1285;532;1515;929;2800
420435;202003;240;610;113;368;16;53;54;172;70;225
420440;202003;720;1978;434;1351;111;388;172;491;283;879
420445;202003;251;629;159;454;32;96;70;187;102;283
420450;202003;633;1850;456;1463;87;339;163;448;250;787
420455;202003;1900;4730;1354;3885;190;678;672;1812;862;2490
420460;202003;8346;22350;6098;18214;933;3127;3090;8848;4023;11975
420470;202003;577;1528;304;981;58;214;69;194;127;408
420475;202003;70;179;26;83;7;23;2;6;9;29
420480;202003;5304;13092;3172;9507;649;2131;1044;3133;1693;5264
420490;202003;319;918;229;738;53;193;89;286;142;479
420500;202003;1368;3830;864;2859;153;566;368;1219;521;1785
420510;202003;156;437;85;269;10;45;27;77;37;122
420515;202003;51;119;31;76;1;1;14;30;15;31
420517;202003;728;2043;633;1873;49;145;476;1420;525;1565
420519;202003;267;643;187;528;26;81;102;299;128;380
420520;202003;286;765;140;470;24;86;12;40;36;126
420530;202003;753;2179;514;1678;88;337;189;533;277;870
420535;202003;223;665;85;299;11;44;37;119;48;163
420540;202003;34108;80697;21249;59004;3228;10182;7239;17227;10467;27409
420543;202003;204;625;156;509;21;75;81;250;102;325
420545;202003;1060;3175;793;2590;148;526;311;923;459;1449
420550;202003;3315;8908;2061;6763;337;1281;852;2855;1189;4136
420555;202003;285;827;190;624;26;98;108;336;134;434
420560;202003;378;945;248;748;54;176;137;407;191;583
420570;202003;1997;5611;1542;4749;277;947;659;1945;936;2892
420580;202003;1760;4513;1223;3675;290;950;410;1240;700;2190
420590;202003;2698;7170;1544;4677;282;1025;406;931;688;1956
420600;202003;912;2679;680;2221;106;400;365;1139;471;1539
420610;202003;344;998;187;632;42;149;62;217;104;366
420620;202003;656;1625;420;1234;94;292;173;498;267;790
420630;202003;800;2432;569;1863;83;293;318;988;401;1281
420640;202003;458;1254;209;729;66;227;15;50;81;277
420650;202003;3330;8820;1928;5869;283;947;702;1834;985;2781
420660;202003;323;843;207;603;43;130;58;156;101;286
420665;202003;557;1462;348;1097;63;230;154;431;217;661
420670;202003;1256;3456;814;2564;134;511;317;880;451;1391
420675;202003;149;427;81;284;16;73;35;106;51;179
420680;202003;311;729;153;510;27;105;75;236;102;341
420690;202003;767;2282;441;1497;62;248;102;287;164;535
420700;202003;2520;6660;1871;5547;239;779;1054;3017;1293;3796
420710;202003;795;2325;593;1886;63;263;352;1031;415;1294
420720;202003;1159;3243;823;2648;175;589;396;1226;571;1815
420730;202003;2899;7581;2116;6280;356;1158;1124;3228;1480;4386
420740;202003;492;1497;290;1041;89;339;27;111;116;450
420750;202003;1781;5194;1140;3691;199;757;452;1339;651;2096
420757;202003;72;181;35;114;4;8;16;51;20;59
420760;202003;332;979;153;478;39;136;37;93;76;229
420765;202003;447;1291;196;663;27;114;89;291;116;405
420768;202003;1244;3563;1073;3273;144;435;785;2390;929;2825
420770;202003;423;1140;198;686;32;127;81;263;113;390
420775;202003;246;745;173;573;41;152;48;130;89;282
420780;202003;824;2254;497;1563;116;398;97;273;213;671
420785;202003;181;486;123;361;15;50;59;142;74;192
420790;202003;955;2959;693;2416;119;488;368;1224;487;1712
420800;202003;623;1573;287;883;82;287;63;185;145;472
420810;202003;1326;4198;1066;3672;313;1234;325;945;638;2179
420820;202003;10936;27218;7672;21887;1487;4796;3541;9234;5028;14030
420830;202003;3292;8725;2380;7059;437;1435;1010;2920;1447;4355
420840;202003;462;1351;216;786;65;265;26;79;91;344
420845;202003;2192;5625;1277;3962;240;914;509;1487;749;2401
420850;202003;986;3211;594;2158;108;435;101;324;209;759
420860;202003;286;740;148;492;32;117;36;111;68;228
420870;202003;744;2069;556;1714;140;515;238;666;378;1181
420880;202003;921;2853;712;2417;152;623;266;828;418;1451
420890;202003;7478;20309;4467;14048;684;2395;1499;4149;2183;6544
420895;202003;160;464;97;299;23;74;31;98;54;172
420900;202003;1322;3266;768;2301;107;398;330;842;437;1240
420910;202003;26547;69746;16073;49374;2479;8695;6274;17263;8753;25958
420915;202003;515;1862;369;1437;54;211;195;782;249;993
420917;202003;320;795;163;455;27;81;79;221;106;302
420920;202003;67;177;21;77;0;0;3;9;3;9
420930;202003;15991;41820;11118;33191;2051;6802;4884;13828;6935;20630
420940;202003;2653;6485;1494;4474;380;1306;267;647;647;1953
420945;202003;128;366;100;304;22;75;40;110;62;185
420950;202003;301;878;162;539;23;86;38;116;61;202
420960;202003;941;2327;664;1847;119;405;290;705;409;1110
420970;202003;2149;6121;1472;4815;417;1421;316;1049;733;2470
420980;202003;255;845;223;780;110;388;64;237;174;625
420985;202003;296;851;144;511;35;133;45;139;80;272
420990;202003;292;907;154;552;29;104;30;95;59;199
421000;202003;480;1458;327;1114;77;285;85;264;162;549
421003;202003;436;1023;147;417;8;29;28;72;36;101
421005;202003;53;152;41;134;9;30;20;63;29;93
421010;202003;2936;8096;2082;6506;442;1581;551;1537;993;3118
421020;202003;350;1094;270;946;42;178;138;458;180;636
421030;202003;710;2177;547;1824;165;620;171;529;336;1149
421040;202003;636;1506;400;1150;28;93;247;703;275;796
421050;202003;900;2445;554;1660;110;366;198;520;308;886
421055;202003;161;431;81;252;11;42;44;121;55;163
421060;202003;530;1546;349;1123;70;260;149;422;219;682
421070;202003;605;1858;331;1166;72;279;92;316;164;595
421080;202003;469;1366;392;1217;44;157;246;753;290;910
421085;202003;357;1016;115;408;16;54;13;32;29;86
421090;202003;223;576;144;425;12;40;51;139;63;179
421100;202003;774;1715;304;928;90;317;72;179;162;496
421105;202003;1466;4088;993;3091;181;579;440;1303;621;1882
421110;202003;1032;2729;851;2495;21;60;632;1956;653;2016
421120;202003;816;2511;594;2005;88;331;199;626;287;957
421125;202003;272;721;191;571;71;230;67;164;138;394
421130;202003;4530;13327;3681;11641;901;3250;1792;5306;2693;8556
421140;202003;321;879;179;571;31;99;53;160;84;259
421145;202003;418;1173;270;859;62;221;99;284;161;505
421150;202003;550;1474;322;1020;61;231;147;431;208;662
421160;202003;484;1296;339;1021;49;162;216;634;265;796
421165;202003;189;553;117;384;25;86;48;154;73;240
421170;202003;1022;2702;799;2358;135;387;482;1470;617;1857
421175;202003;972;2441;584;1835;117;414;252;765;369;1179
421180;202003;371;962;198;610;36;142;74;208;110;350
421185;202003;305;821;206;615;28;97;120;356;148;453
421187;202003;265;811;162;539;28;96;52;160;80;256
421189;202003;343;999;260;834;44;152;99;297;143;449
421190;202003;9740;26420;6364;20001;1231;4251;2152;6258;3383;10509
421200;202003;615;1809;493;1575;53;193;318;990;371;1183
421205;202003;175;461;126;379;25;93;58;157;83;250
421210;202003;1033;2671;597;1919;128;410;224;738;352;1148
421220;202003;1243;3777;950;3145;226;816;291;875;517;1691
421223;202003;322;899;198;662;48;158;90;308;138;466
421225;202003;856;2547;720;2306;126;453;428;1365;554;1818
421227;202003;674;1897;415;1348;79;287;181;591;260;878
421230;202003;564;1501;350;1105;66;243;129;395;195;638
421240;202003;267;808;122;451;12;47;15;55;27;102
421250;202003;1726;4417;1182;3539;148;515;651;1878;799;2393
421260;202003;158;453;42;165;12;58;9;31;21;89
421265;202003;609;1593;542;1511;6;20;514;1436;520;1456
421270;202003;324;866;137;490;17;60;55;190;72;250
421280;202003;1648;4536;1213;3771;187;716;674;1961;861;2677
421290;202003;890;2418;435;1347;76;250;97;282;173;532
421300;202003;268;693;134;428;15;58;20;58;35;116
421310;202003;174;497;117;387;24;83;62;207;86;290
421315;202003;210;594;134;422;40;111;31;108;71;219
421320;202003;577;1763;281;966;31;98;36;85;67;183
421330;202003;559;1663;405;1340;80;310;113;358;193;668
421335;202003;323;977;265;876;66;248;112;358;178;606
421340;202003;1236;3502;869;2787;163;588;352;1050;515;1638
421350;202003;1313;3422;843;2590;179;646;339;969;518;1615
421360;202003;2139;5830;1233;3944;239;945;469;1293;708;2238
421370;202003;542;1810;330;1230;63;251;87;283;150;534
421380;202003;725;1960;623;1809;83;273;381;1079;464;1352
421390;202003;161;436;54;188;12;35;19;55;31;90
421400;202003;289;930;204;730;35;132;107;368;142;500
421410;202003;203;540;83;287;19;75;25;77;44;152
421415;202003;168;514;94;311;21;64;19;56;40;120
421420;202003;483;1320;391;1151;34;113;253;721;287;834
421430;202003;99;309;75;251;8;28;20;63;28;91
421440;202003;574;1553;340;1123;72;233;143;460;215;693
421450;202003;405;1200;236;806;32;136;37;130;69;266
421460;202003;338;978;176;627;21;83;33;94;54;177
421470;202003;235;689;132;460;27;95;50;182;77;277
421480;202003;2554;6923;1630;5070;357;1326;610;1710;967;3036
421490;202003;109;369;63;235;7;28;16;41;23;69
421500;202003;1975;5840;1368;4582;371;1454;320;927;691;2381
421505;202003;276;790;230;726;35;125;148;452;183;577
421507;202003;410;1170;217;735;54;192;73;233;127;425
421510;202003;259;750;148;480;22;78;75;224;97;302
421520;202003;451;1191;276;794;30;96;166;450;196;546
421530;202003;274;823;154;550;31;138;41;116;72;254
421535;202003;367;980;221;720;33;131;116;359;149;490
421540;202003;268;637;126;398;19;64;41;120;60;184
421545;202003;649;1937;485;1637;110;438;233;733;343;1171
421550;202003;1871;5107;1496;4543;264;847;869;2629;1133;3476
421555;202003;162;491;66;230;11;45;8;19;19;64
421560;202003;74;248;48;188;12;48;12;40;24;88
421565;202003;854;2214;560;1751;149;515;150;474;299;989
421567;202003;411;1382;265;957;100;375;60;201;160;576
421568;202003;321;963;241;777;34;127;112;348;146;475
421569;202003;149;437;71;239;17;61;33;108;50;169
421570;202003;977;2654;681;2089;169;584;208;579;377;1163
421575;202003;266;782;188;573;29;102;79;207;108;309
421580;202003;3201;8898;2051;6488;362;1362;772;2090;1134;3452
421590;202003;128;403;103;346;34;128;25;68;59;196
421600;202003;525;1433;350;1067;77;259;101;259;178;518
421605;202003;692;1802;481;1460;82;222;248;801;330;1023
421610;202003;956;2645;607;1975;113;395;189;600;302;995
421620;202003;3674;9753;2096;6827;460;1683;561;1745;1021;3428
421625;202003;129;360;58;187;14;46;14;45;28;91
421630;202003;2137;5627;1253;3880;222;810;399;1028;621;1838
421635;202003;238;656;167;505;20;66;98;273;118;339
421640;202003;689;1856;492;1548;96;344;208;639;304;983
421650;202003;2141;5869;1341;4342;324;1241;376;1010;700;2251
421660;202003;8984;25128;6114;19541;977;3521;2591;7569;3568;11090
421670;202003;711;2077;498;1567;87;307;246;747;333;1054
421680;202003;974;2698;728;2251;193;647;339;950;532;1597
421690;202003;1224;3552;825;2697;164;608;303;981;467;1589
421700;202003;439;1321;265;907;53;195;85;278;138;473
421710;202003;192;603;85;283;18;65;26;82;44;147
421715;202003;89;255;67;205;15;39;44;132;59;171
421720;202003;1757;4802;1015;3211;259;902;271;739;530;1641
421725;202003;219;538;107;337;22;76;42;98;64;174
421730;202003;399;1148;207;615;26;85;104;285;130;370
421740;202003;590;1658;389;1215;103;333;95;253;198;586
421750;202003;821;1942;367;1093;84;280;136;363;220;643
421755;202003;143;395;83;251;13;53;43;113;56;166
421760;202003;817;2172;527;1647;83;294;191;511;274;805
421770;202003;2297;6156;1647;5007;423;1276;594;1957;1017;3233
421775;202003;198;506;120;356;17;51;56;156;73;207
421780;202003;750;2232;474;1628;99;397;193;621;292;1018
421790;202003;734;1900;417;1341;92;303;199;624;291;927
421795;202003;171;475;120;358;23;84;41;111;64;195
421800;202003;2337;6370;1669;5129;212;770;952;2768;1164;3538
421810;202003;568;1578;381;1216;45;172;227;704;272;876
421820;202003;896;2610;504;1649;104;384;154;405;258;789
421825;202003;1243;3554;1101;3330;120;392;770;2282;890;2674
421830;202003;1894;5667;1534;4979;310;1072;658;2076;968;3148
421835;202003;182;462;104;329;21;77;32;102;53;179
421840;202003;209;673;138;499;28;106;35;117;63;223
421850;202003;353;987;185;629;37;138;57;151;94;289
421860;202003;301;849;163;564;23;88;55;173;78;261
421870;202003;3787;9611;2659;7497;479;1603;1266;3154;1745;4757
421875;202003;223;660;98;331;14;57;27;70;41;127
421880;202003;531;1527;346;1115;92;345;83;272;175;617
421885;202003;196;559;117;374;31;101;28;84;59;185
421890;202003;771;2378;562;1959;112;461;277;909;389;1370
421895;202003;387;995;322;909;38;121;220;646;258;767
421900;202003;894;2363;621;1794;94;315;275;723;369;1038
421910;202003;280;820;190;614;32;124;58;169;90;293
421915;202003;354;1007;190;616;37;119;27;76;64;195
421917;202003;529;1264;293;959;113;399;70;241;183;640
421920;202003;362;1115;263;919;107;393;70;234;177;627
421930;202003;2313;5894;1094;3514;276;992;276;803;552;1795
421935;202003;375;1203;294;1021;58;211;165;553;223;764
421940;202003;304;902;133;442;24;94;31;92;55;186
421950;202003;2746;6931;1475;4556;301;1042;358;987;659;2029
421960;202003;172;442;89;286;20;76;21;57;41;133
421970;202003;1762;4560;1024;3069;210;739;365;921;575;1660
421985;202003;270;717;148;475;16;53;56;168;72;221
422000;202003;1800;4738;1440;4140;156;530;973;2758;1129;3288
430003;202003;531;1479;346;1116;65;229;144;464;209;693
430005;202003;258;678;163;508;31;105;73;215;104;320
430010;202003;1667;4078;1323;3541;137;406;941;2438;1078;2844
430020;202003;558;1298;415;1102;47;152;272;690;319;842
430030;202003;952;2276;517;1498;138;446;161;428;299;874
430040;202003;9625;23370;5491;15951;1434;4508;617;1921;2051;6429
430045;202003;483;1221;324;934;21;74;217;611;238;685
430047;202003;233;508;82;237;21;66;20;55;41;121
430050;202003;850;2158;487;1419;107;329;119;322;226;651
430055;202003;229;569;102;306;10;45;62;166;72;211
430057;202003;77;167;27;76;7;26;7;12;14;38
430060;202003;15808;42560;12048;36661;2548;8227;5529;16807;8077;25034
430063;202003;821;2308;647;1938;123;363;359;1073;482;1436
430064;202003;967;2671;711;2137;211;652;270;789;481;1441
430066;202003;91;193;65;154;5;11;52;117;57;128
430070;202003;727;1854;86;295;6;23;17;51;23;74
430080;202003;747;1850;449;1264;79;259;231;573;310;832
430085;202003;824;1888;497;1363;100;287;209;560;309;847
430087;202003;490;1247;395;1120;58;153;254;735;312;888
430090;202003;514;1316;166;520;12;46;58;167;70;213
430100;202003;643;1542;353;988;62;212;160;386;222;598
430105;202003;1057;2848;672;2172;126;471;309;978;435;1449
430107;202003;158;468;90;288;17;66;23;56;40;122
430110;202003;2016;5090;1452;4252;220;693;791;2298;1011;2991
430120;202003;1131;3381;727;2362;128;442;330;1075;458;1517
430130;202003;3267;7654;2376;6393;918;2455;415;1367;1333;3822
430140;202003;839;2334;579;1834;132;411;273;838;405;1249
430150;202003;529;1355;282;856;62;205;98;281;160;486
430155;202003;237;605;104;316;17;48;22;62;39;110
430160;202003;18185;43569;13908;37430;1605;4748;8171;21882;9776;26630
430163;202003;2642;6520;1798;5145;86;283;1266;3606;1352;3889
430165;202003;296;721;77;251;15;35;12;34;27;69
430170;202003;870;2306;309;1079;47;177;48;151;95;328
430175;202003;629;1922;526;1698;133;438;244;770;377;1208
430180;202003;627;1534;497;1322;56;150;349;923;405;1073
430185;202003;531;1329;269;789;69;183;63;165;132;348
430187;202003;645;1492;454;1251;73;217;232;681;305;898
430190;202003;1297;3490;1031;3063;213;692;484;1368;697;2060
430192;202003;122;328;40;119;6;18;10;26;16;44
430195;202003;395;1186;48;176;6;17;7;26;13;43
430200;202003;1047;3150;837;2771;277;953;239;815;516;1768
430205;202003;449;1181;393;1084;13;43;338;909;351;952
430210;202003;4629;11996;3040;8564;572;1725;998;2303;1570;4028
430215;202003;296;764;182;532;40;124;68;198;108;322
430220;202003;613;1516;166;564;25;110;32;76;57;186
430222;202003;165;475;118;372;11;42;44;135;55;177
430223;202003;229;611;176;522;18;58;113;328;131;386
430225;202003;16;31;11;23;1;2;9;19;10;21
430230;202003;1703;4842;1439;4431;128;437;1057;3222;1185;3659
430235;202003;291;839;186;603;44;165;53;148;97;313
430237;202003;473;1162;338;929;22;62;237;634;259;696
430240;202003;1120;2576;605;1686;82;287;325;827;407;1114
430245;202003;664;1947;499;1618;149;496;227;757;376;1253
430250;202003;856;2172;609;1782;215;687;46;119;261;806
430258;202003;121;322;90;260;8;16;46;142;54;158
430260;202003;623;1655;427;1276;56;182;241;713;297;895
430265;202003;190;536;127;417;28;92;37;123;65;215
430270;202003;2711;6789;2128;5875;391;1185;1251;3340;1642;4525
430280;202003;4813;11463;3270;8772;677;1854;1396;3719;2073;5573
430290;202003;2165;5019;1757;4539;47;160;1506;3801;1553;3961
430300;202003;9091;23447;6816;19404;1114;3455;3578;9982;4692;13437
430310;202003;10736;26804;6983;19718;908;2879;3283;8641;4191;11520
430320;202003;963;2518;511;1592;66;191;276;881;342;1072
430330;202003;623;1538;376;1047;62;189;170;417;232;606
430340;202003;679;1478;364;1000;45;135;210;562;255;697
430350;202003;6924;17996;5042;14563;799;2444;2728;7602;3527;10046
430355;202003;316;831;106;342;19;64;13;35;32;99
430360;202003;834;1952;528;1428;104;317;211;529;315;846
430367;202003;298;695;159;447;28;90;88;235;116;325
430370;202003;452;1234;200;626;38;125;47;127;85;252
430380;202003;640;1592;315;987;76;287;87;255;163;542
430390;202003;2815;6784;1546;4425;284;930;227;442;511;1372
430400;202003;1029;2210;786;1866;61;177;551;1256;612;1433
430410;202003;515;1239;352;972;50;155;221;583;271;738
430420;202003;2533;7019;1927;5671;508;1555;821;2307;1329;3862
430430;202003;569;1454;262;800;66;190;61;199;127;389
430435;202003;1409;3609;1072;3061;194;594;549;1581;743;2175
430440;202003;3367;9413;2549;7930;275;978;1543;4751;1818;5729
430450;202003;6304;16070;4988;13742;733;2263;2703;7183;3436;9446
430460;202003;28090;72334;20042;58948;3681;11983;9641;27149;13322;39132
430461;202003;276;707;82;257;12;40;28;74;40;114
430462;202003;225;609;123;403;21;67;44;148;65;215
430463;202003;5031;13581;3650;11095;750;2506;1620;4743;2370;7249
430465;202003;401;1049;333;929;50;156;207;557;257;713
430466;202003;3895;9854;3002;8392;750;2193;1384;3670;2134;5863
430467;202003;468;1137;318;896;43;140;167;448;210;588
430468;202003;1198;2985;921;2566;83;249;592;1623;675;1872
430469;202003;553;1502;63;203;7;24;13;19;20;43
430470;202003;5164;13316;3382;10121;988;3251;909;2537;1897;5788
430471;202003;507;1451;408;1267;61;211;234;690;295;901
430480;202003;700;1856;369;1145;50;172;83;231;133;403
430485;202003;162;435;61;194;15;44;8;26;23;70
430490;202003;369;967;208;624;25;90;101;274;126;364
430495;202003;348;958;208;674;24;80;84;260;108;340
430500;202003;944;2452;641;1942;209;690;181;491;390;1181
430510;202003;23431;61663;16457;47803;2802;9235;7349;19578;10151;28813
430511;202003;303;890;122;405;13;51;19;53;32;104
430512;202003;913;2073;699;1756;169;435;259;662;428;1097
430513;202003;753;1885;344;1003;50;160;171;467;221;627
430515;202003;358;1011;254;800;35;104;130;406;165;510
430517;202003;1055;3282;774;2611;135;460;394;1355;529;1815
430520;202003;1202;3113;600;1795;112;360;130;353;242;713
430530;202003;926;2350;363;1137;73;223;92;277;165;500
430535;202003;2988;7850;2138;6281;303;925;1082;3078;1385;4003
430537;202003;313;1113;292;1048;20;64;235;844;255;908
430540;202003;555;1375;319;964;48;147;149;453;197;600
430543;202003;726;1299;397;927;54;107;187;485;241;592
430544;202003;641;1854;440;1402;102;317;177;567;279;884
430545;202003;2120;5597;1555;4715;308;971;768;2385;1076;3356
430550;202003;325;916;230;710;46;147;85;245;131;392
430558;202003;106;243;43;117;6;12;16;44;22;56
430560;202003;328;745;135;413;17;59;45;137;62;196
430570;202003;779;1911;533;1446;88;268;281;721;369;989
430580;202003;811;2035;578;1671;144;444;253;720;397;1164
430583;202003;196;487;34;108;4;13;7;19;11;32
430585;202003;216;524;105;286;13;38;50;125;63;163
430587;202003;190;539;139;432;17;52;58;186;75;238
430590;202003;1366;3277;1122;2913;54;164;939;2390;993;2554
430593;202003;15;52;10;34;1;3;5;16;6;19
430595;202003;407;999;104;336;12;51;24;57;36;108
430597;202003;406;1052;207;627;19;60;70;163;89;223
430600;202003;1819;4671;776;2253;139;430;216;579;355;1009
430605;202003;1093;2988;799;2426;112;404;363;1055;475;1459
430607;202003;500;1189;403;1032;24;68;294;739;318;807
430610;202003;5397;12764;3544;9909;1026;3200;771;2132;1797;5332
430613;202003;254;593;67;194;8;24;18;41;26;65
430620;202003;561;1381;405;1089;58;172;233;580;291;752
430630;202003;400;1108;109;356;18;59;22;66;40;125
430632;202003;467;1237;197;612;24;80;91;269;115;349
430635;202003;512;1229;376;1001;44;117;268;720;312;837
430637;202003;442;1096;342;950;37;121;215;565;252;686
430640;202003;959;2515;558;1696;80;263;192;538;272;801
430642;202003;344;943;259;746;41;111;139;377;180;488
430645;202003;147;344;53;142;8;22;15;41;23;63
430650;202003;1516;4438;1205;3913;323;1054;578;1949;901;3003
430655;202003;259;654;152;431;23;75;75;186;98;261
430660;202003;4849;12631;3617;10536;811;2518;1562;4469;2373;6987
430670;202003;638;1556;483;1278;34;96;292;776;326;872
430673;202003;517;1175;200;585;37;113;73;196;110;309
430675;202003;236;678;53;190;9;35;25;89;34;124
430676;202003;4448;11250;3483;9772;426;1339;2195;5984;2621;7323
430680;202003;857;2325;517;1626;143;456;128;394;271;850
430690;202003;2724;7465;2134;6383;734;2310;583;1657;1317;3967
430692;202003;210;642;160;555;9;36;119;419;128;455
430693;202003;917;2420;540;1657;103;375;142;387;245;762
430695;202003;428;1112;235;698;32;89;125;359;157;448
430697;202003;382;969;287;817;72;188;144;443;216;631
430700;202003;6300;15739;3530;10558;757;2487;609;1707;1366;4194
430705;202003;377;918;184;558;23;79;72;192;95;271
430710;202003;1604;3505;1116;2831;141;400;670;1670;811;2070
430720;202003;665;1613;337;1031;49;148;172;531;221;679
430730;202003;989;2717;669;2099;92;278;355;1103;447;1381
430740;202003;559;1537;282;943;52;183;74;267;126;450
430745;202003;347;968;215;674;39;142;68;181;107;323
430750;202003;1265;3255;880;2595;184;559;466;1345;650;1904
430755;202003;443;1070;271;720;16;48;160;393;176;441
430760;202003;1928;4770;1452;4021;342;1026;646;1705;988;2731
430770;202003;5891;14788;4479;12665;585;1893;2827;7723;3412;9616
430780;202003;1797;4391;1012;3021;204;684;390;1116;594;1800
430781;202003;441;1239;237;751;30;94;69;187;99;281
430783;202003;345;798;203;580;18;68;127;336;145;404
430786;202003;29;106;21;81;3;9;3;15;6;24
430790;202003;4122;10135;2827;7890;327;1095;1723;4488;2050;5583
430800;202003;725;1706;530;1405;34;92;356;942;390;1034
430805;202003;356;962;217;654;17;61;134;379;151;440
430807;202003;402;958;197;556;16;48;90;229;106;277
430810;202003;652;1536;245;735;27;104;103;293;130;397
430820;202003;1138;3041;645;2071;134;448;177;558;311;1006
430825;202003;224;562;77;201;12;30;23;55;35;85
430830;202003;1633;4715;1299;4064;58;214;940;2906;998;3120
430840;202003;953;2433;678;1959;92;292;460;1286;552;1578
430843;202003;116;277;46;132;5;21;20;50;25;71
430845;202003;404;978;266;747;55;170;105;277;160;447
430850;202003;2243;5850;1504;4402;231;750;605;1789;836;2539
430860;202003;863;2000;377;1071;44;157;182;443;226;600
430865;202003;490;1227;361;1010;56;169;195;521;251;690
430870;202003;591;1546;249;788;40;148;80;226;120;374
430880;202003;1348;3143;891;2444;146;425;473;1263;619;1688
430885;202003;170;453;82;277;6;20;48;163;54;183
430890;202003;962;2408;624;1817;56;242;131;351;187;593
430900;202003;2898;6384;1956;5013;160;490;1290;3114;1450;3604
430905;202003;724;1849;448;1323;81;273;166;452;247;725
430910;202003;1431;3790;972;2859;160;570;472;1232;632;1802
430912;202003;478;1335;317;1013;25;75;214;703;239;778
430915;202003;455;1410;343;1188;124;432;95;339;219;771
430920;202003;22318;56708;16823;47459;2313;7238;10061;27620;12374;34858
430925;202003;94;213;34;103;5;13;15;49;20;62
430930;202003;9932;23575;6204;17782;1194;3506;2550;7623;3744;11129
430940;202003;913;2389;535;1566;145;460;137;332;282;792
430950;202003;728;1724;457;1253;37;133;280;700;317;833
430955;202003;325;871;81;251;21;64;19;47;40;111
430957;202003;174;600;159;561;25;90;97;338;122;428
430960;202003;1304;3129;722;2049;158;481;310;854;468;1335
430965;202003;1554;3736;1192;3169;60;170;941;2540;1001;2710
430970;202003;343;835;169;488;24;73;83;217;107;290
430975;202003;471;1436;354;1158;76;258;172;551;248;809
430980;202003;357;823;202;558;30;97;92;226;122;323
430990;202003;524;1502;319;1002;42;134;160;503;202;637
430995;202003;534;1382;386;1141;45;142;212;616;257;758
431000;202003;1286;3041;505;1475;88;283;39;104;127;387
431010;202003;1923;4953;1149;3640;227;787;203;548;430;1335
431020;202003;7796;16926;4538;11999;1043;3126;1516;3484;2559;6610
431030;202003;319;875;156;525;30;105;21;66;51;171
431033;202003;3394;8082;2102;6031;467;1380;723;2099;1190;3479
431036;202003;327;705;68;193;5;15;20;48;25;63
431040;202003;862;2217;551;1652;83;280;239;660;322;940
431041;202003;440;1019;322;845;24;58;198;515;222;573
431043;202003;323;806;172;536;35;125;82;251;117;376
431046;202003;101;265;40;122;2;5;11;33;13;38
431050;202003;1277;3138;905;2539;167;512;468;1325;635;1837
431053;202003;598;1641;317;1011;72;261;88;240;160;501
431055;202003;556;1377;463;1236;51;125;329;878;380;1003
431057;202003;234;668;114;379;23;76;33;100;56;176
431060;202003;5059;13257;3340;10230;819;2717;867;2628;1686;5345
431065;202003;365;927;253;739;46;143;114;329;160;472
431070;202003;406;1150;225;734;52;185;50;159;102;344
431075;202003;208;615;125;418;24;87;38;128;62;215
431080;202003;526;1446;347;1068;65;235;116;336;181;571
431085;202003;700;1846;440;1237;64;178;213;590;277;768
431087;202003;400;1141;322;975;21;59;224;704;245;763
431090;202003;392;928;149;461;27;89;43;135;70;224
431100;202003;3232;7164;2194;5760;319;855;1109;2978;1428;3833
431110;202003;1303;3012;866;2267;266;707;320;786;586;1493
431112;202003;509;1449;422;1277;70;236;241;702;311;938
431113;202003;333;933;285;838;46;151;173;496;219;647
431115;202003;940;2692;724;2290;103;388;413;1227;516;1615
431120;202003;2227;6291;1498;4783;475;1710;346;986;821;2696
431123;202003;385;1070;241;761;42;118;132;437;174;555
431125;202003;931;2760;702;2290;259;825;232;815;491;1640
431127;202003;191;498;54;175;7;22;10;27;17;49
431130;202003;2834;7309;2051;5974;300;1000;1151;3252;1451;4252
431140;202003;4828;11444;2710;7438;351;1064;1190;2855;1541;3919
431142;202003;468;1266;344;1039;50;158;210;632;260;790
431150;202003;986;2650;684;2076;130;429;293;862;423;1291
431160;202003;625;1799;415;1329;66;230;132;421;198;651
431162;202003;474;1153;250;736;26;89;139;384;165;473
431164;202003;165;381;36;113;9;29;4;7;13;36
431170;202003;443;1249;307;953;97;297;85;250;182;547
431171;202003;608;1448;486;1283;99;233;289;787;388;1020
431173;202003;385;1029;284;874;78;269;113;326;191;595
431175;202003;1131;2677;666;1865;107;304;238;643;345;947
431177;202003;699;1982;511;1674;139;499;272;866;411;1365
431179;202003;329;712;89;260;15;48;21;54;36;102
431180;202003;2074;5255;1247;3628;323;931;339;986;662;1917
431190;202003;417;1105;196;616;26;82;58;149;84;231
431198;202003;325;962;265;856;98;334;72;252;170;586
431200;202003;350;884;67;194;14;41;6;15;20;56
431205;202003;191;530;93;304;24;81;34;114;58;195
431210;202003;577;1465;460;1302;112;316;223;671;335;987
431213;202003;228;615;166;503;14;43;84;263;98;306
431215;202003;545;1296;232;682;25;81;111;309;136;390
431217;202003;145;375;95;286;5;22;59;166;64;188
431220;202003;531;1383;309;940;32;120;174;488;206;608
431225;202003;1461;3488;1106;2891;108;296;778;2054;886;2350
431230;202003;626;1818;475;1469;60;208;286;853;346;1061
431235;202003;148;377;21;73;2;5;4;17;6;22
431237;202003;308;986;254;855;49;180;135;433;184;613
431238;202003;23;62;18;52;5;16;6;13;11;29
431240;202003;3980;9989;3029;8485;472;1476;1692;4562;2164;6038
431242;202003;234;643;197;582;42;132;104;299;146;431
431244;202003;302;726;152;428;22;75;53;130;75;205
431245;202003;1243;2918;769;2083;81;244;402;1028;483;1272
431247;202003;210;555;109;335;21;74;36;85;57;159
431250;202003;1560;3959;1133;3374;249;763;581;1801;830;2564
431260;202003;216;617;137;458;20;90;46;139;66;229
431261;202003;222;689;175;612;14;57;95;317;109;374
431262;202003;360;1010;177;578;10;30;119;394;129;424
431265;202003;1507;3564;573;1700;72;268;205;519;277;787
431267;202003;260;695;156;457;4;19;111;295;115;314
431270;202003;2670;6101;1391;3919;336;985;439;1257;775;2242
431275;202003;113;326;55;178;21;68;10;31;31;99
431280;202003;216;573;59;187;6;21;7;14;13;35
431290;202003;276;822;179;575;30;110;33;78;63;188
431295;202003;71;187;24;79;3;9;7;23;10;32
431300;202003;283;728;49;154;3;10;13;30;16;40
431301;202003;299;854;62;204;8;19;5;15;13;34
431303;202003;534;1419;310;923;23;80;143;398;166;478
431306;202003;2070;4830;1174;3329;171;544;493;1239;664;1783
431308;202003;24;73;21;67;9;31;10;31;19;62
431310;202003;503;1431;349;1080;40;131;159;455;199;586
431320;202003;561;1525;264;879;38;118;49;142;87;260
431330;202003;1536;3623;696;2050;146;498;246;640;392;1138
431333;202003;212;567;102;303;18;50;38;105;56;155
431335;202003;39;106;21;65;4;8;3;7;7;15
431337;202003;2494;6642;1790;5469;341;1178;897;2642;1238;3820
431339;202003;372;986;269;791;76;235;116;335;192;570
431340;202003;18169;43992;12271;34038;2155;6603;5402;14108;7557;20711
431342;202003;406;881;297;727;14;31;265;651;279;682
431344;202003;381;979;218;660;7;28;126;363;133;391
431346;202003;246;602;94;304;15;53;30;96;45;149
431349;202003;606;1590;314;936;79;225;116;348;195;573
431350;202003;3820;9962;2779;8144;410;1370;1458;4116;1868;5486
431360;202003;549;1313;269;766;80;239;76;213;156;452
431365;202003;1858;4471;1459;3919;114;350;1085;2883;1199;3233
431370;202003;4091;10177;2879;8114;651;1921;1349;3916;2000;5837
431380;202003;764;2072;614;1827;35;116;434;1286;469;1402
431390;202003;2446;5945;1423;4112;164;571;671;1693;835;2264
431395;202003;1206;3036;828;2450;189;585;359;1096;548;1681
431400;202003;309;870;163;519;28;88;35;105;63;193
431402;202003;831;1879;595;1519;78;214;394;983;472;1197
431403;202003;184;527;145;455;23;86;68;183;91;269
431405;202003;4235;11185;3205;9473;587;1923;1537;4333;2124;6256
431406;202003;505;1444;358;1133;77;236;187;606;264;842
431407;202003;416;1178;285;900;59;212;146;435;205;647
431410;202003;15602;39638;10002;29531;1523;5182;4900;13552;6423;18734
431413;202003;220;579;58;191;5;14;10;35;15;49
431415;202003;638;1567;386;1147;70;246;179;469;249;715
431417;202003;524;1171;358;918;54;156;200;505;254;661
431420;202003;1517;3452;1117;2890;164;426;616;1599;780;2025
431430;202003;523;1348;243;773;36;122;72;194;108;316
431440;202003;28947;68009;19903;53668;3454;10047;7707;19619;11161;29666
431442;202003;101;274;47;154;8;22;8;22;16;44
431445;202003;365;1035;114;381;17;53;9;27;26;80
431446;202003;258;770;191;633;37;139;96;302;133;441
431447;202003;648;1752;381;1176;76;260;134;411;210;671
431449;202003;720;1894;428;1273;76;215;176;528;252;743
431450;202003;2108;4414;1657;3786;88;221;1285;2859;1373;3080
431454;202003;30;96;26;87;6;19;10;35;16;54
431455;202003;585;1410;281;770;36;105;143;356;179;461
431460;202003;2667;6606;1898;5234;498;1453;536;1502;1034;2955
431470;202003;1368;3864;979;3027;189;593;429;1355;618;1948
431475;202003;241;653;38;145;3;11;4;11;7;22
431477;202003;381;990;223;664;41;122;88;224;129;346
431478;202003;252;658;49;154;12;34;7;18;19;52
431480;202003;2875;7256;2209;6206;534;1540;1093;3099;1627;4639
431490;202003;105850;250120;79783;209913;5920;18390;58022;146878;63942;165268
431500;202003;463;1173;333;925;60;166;182;488;242;654
431505;202003;268;644;182;515;11;35;128;360;139;395
431507;202003;333;786;128;381;42;136;36;97;78;233
431510;202003;1470;3826;976;2868;217;691;359;1037;576;1728
431513;202003;184;407;110;293;9;22;75;198;84;220
431514;202003;91;234;59;175;4;11;41;118;45;129
431515;202003;441;1109;310;877;62;170;158;453;220;623
431517;202003;60;180;50;156;9;27;22;65;31;92
431520;202003;406;994;151;479;23;84;63;171;86;255
431530;202003;3972;8490;2215;5875;506;1374;536;1430;1042;2804
431531;202003;201;505;121;348;12;38;55;143;67;181
431532;202003;533;1242;314;849;68;207;126;326;194;533
431535;202003;227;611;102;327;19;68;23;64;42;132
431540;202003;1746;5636;1624;5467;57;243;1324;4458;1381;4701
431545;202003;326;843;57;176;7;20;12;35;19;55
431550;202003;1908;4914;1425;3998;243;759;725;1941;968;2700
431555;202003;647;1471;401;1055;26;82;239;616;265;698
431560;202003;21064;51577;13972;40354;2841;8625;4718;14364;7559;22989
431570;202003;4284;10524;3389;9225;397;1222;2365;6181;2762;7403
431575;202003;218;548;160;443;41;99;44;128;85;227
431580;202003;567;1473;341;1012;40;146;184;515;224;661
431590;202003;570;1582;435;1303;94;296;170;526;264;822
431595;202003;338;930;213;651;46;143;85;236;131;379
431600;202003;1279;2924;861;2320;220;641;330;918;550;1559
431610;202003;1331;3448;893;2629;125;359;470;1415;595;1774
431620;202003;453;1166;194;578;30;89;74;209;104;298
431630;202003;1259;3163;571;1725;92;312;206;558;298;870
431640;202003;5972;14593;5042;13419;502;1391;3729;10016;4231;11407
431642;202003;530;1306;324;885;22;56;164;416;186;472
431643;202003;350;873;166;487;15;40;53;153;68;193
431645;202003;1781;4024;1377;3469;60;181;1102;2747;1162;2928
431647;202003;239;597;83;250;8;24;21;60;29;84
431650;202003;113;307;74;240;5;19;44;130;49;149
431660;202003;853;2285;423;1383;72;273;114;332;186;605
431670;202003;1081;2599;682;1874;100;288;358;933;458;1221
431673;202003;225;576;79;273;11;36;16;51;27;87
431675;202003;503;1230;98;306;11;43;19;50;30;93
431680;202003;7235;18625;5169;14726;1219;3634;2210;6138;3429;9772
431690;202003;21877;53812;14012;39593;2948;8924;5335;15104;8283;24028
431695;202003;144;338;86;251;17;67;46;106;63;173
431697;202003;431;1022;327;860;46;111;192;520;238;631
431700;202003;1301;3381;1093;3005;159;409;662;1811;821;2220
431710;202003;12108;29494;8275;23919;1501;4642;3981;11768;5482;16410
431720;202003;5825;14638;3289;9602;827;2579;579;1474;1406;4053
431725;202003;25;72;20;63;4;11;9;29;13;40
431730;202003;3736;9015;2268;6668;537;1682;695;2190;1232;3872
431740;202003;4868;11593;3104;8573;846;2706;786;1811;1632;4517
431750;202003;7126;18333;5367;15486;1210;3748;2282;6468;3492;10216
431755;202003;306;847;62;218;7;23;10;34;17;57
431760;202003;5018;11330;3289;8572;349;1054;1976;4880;2325;5934
431770;202003;1791;4276;1389;3737;80;262;1069;2802;1149;3064
431775;202003;193;511;101;316;21;67;15;38;36;105
431780;202003;1951;4951;1224;3564;203;662;508;1431;711;2093
431790;202003;769;2100;550;1670;100;298;250;734;350;1032
431795;202003;224;568;104;316;23;63;28;80;51;143
431800;202003;7715;18640;4657;13717;1240;4215;532;1624;1772;5839
431805;202003;282;664;80;263;5;17;29;94;34;111
431810;202003;3150;7527;1973;5356;373;1071;833;2177;1206;3248
431820;202003;2086;5646;1630;4908;457;1444;557;1777;1014;3221
431830;202003;8491;18464;6141;15323;1574;4559;1984;4936;3558;9495
431840;202003;2477;6566;1960;5710;318;928;1200;3530;1518;4458
431842;202003;571;1426;188;584;21;73;57;159;78;232
431843;202003;309;825;231;662;25;84;120;321;145;405
431844;202003;188;494;52;178;11;40;16;62;27;102
431845;202003;495;1318;341;1005;30;86;199;589;229;675
431846;202003;280;729;235;662;9;29;210;590;219;619
431848;202003;97;249;60;179;9;29;9;20;18;49
431849;202003;404;987;60;186;1;1;7;18;8;19
431850;202003;3865;10554;2931;8658;699;2232;930;2742;1629;4974
431860;202003;617;1498;344;973;57;171;189;512;246;683
431861;202003;92;252;51;157;10;37;17;45;27;82
431862;202003;424;1352;347;1217;66;255;177;599;243;854
431870;202003;18106;46627;14422;40764;1791;5684;8720;23840;10511;29524
431880;202003;3874;9957;2698;7829;439;1453;1225;3372;1664;4825
431890;202003;4278;10815;2580;7532;743;2380;455;1471;1198;3851
431900;202003;923;2347;582;1714;87;294;307;853;394;1147
431910;202003;720;1741;241;696;44;127;68;156;112;283
431912;202003;439;1228;343;1057;66;218;200;605;266;823
431915;202003;1011;2545;789;2185;26;88;607;1646;633;1734
431920;202003;1144;2770;945;2503;24;64;818;2165;842;2229
431930;202003;630;1699;423;1318;127;356;194;642;321;998
431935;202003;81;229;55;175;15;52;11;35;26;87
431936;202003;294;858;158;513;34;118;58;171;92;289
431937;202003;159;399;101;275;18;56;44;94;62;150
431940;202003;2889;6906;1633;4589;186;573;801;2146;987;2719
431950;202003;1719;4567;1375;4008;445;1320;508;1470;953;2790
431960;202003;2789;6912;1994;5455;550;1572;520;1409;1070;2981
431970;202003;393;1004;149;443;38;110;40;102;78;212
431971;202003;81;206;32;102;3;12;4;8;7;20
431973;202003;468;1499;386;1343;37;137;285;988;322;1125
431975;202003;105;218;18;64;2;10;2;6;4;16
431980;202003;975;2573;755;2199;153;470;352;992;505;1462
431990;202003;5374;12913;3540;10238;485;1667;1684;4657;2169;6324
432000;202003;10205;24497;7301;19962;1739;4858;3214;8904;4953;13762
432010;202003;1967;4969;1417;3983;217;692;836;2212;1053;2904
432020;202003;1712;4406;1045;3023;211;643;452;1229;663;1872
432023;202003;497;1201;257;735;35;113;120;303;155;416
432026;202003;929;2614;680;2125;169;532;240;747;409;1279
432030;202003;332;833;186;542;24;68;102;295;126;363
432032;202003;322;850;219;648;26;94;121;333;147;427
432035;202003;629;1808;544;1661;170;520;224;718;394;1238
432040;202003;1000;2304;347;1075;57;192;116;328;173;520
432045;202003;161;447;97;317;23;74;34;117;57;191
432050;202003;446;1148;331;942;73;212;137;416;210;628
432055;202003;574;1552;370;1160;128;412;77;222;205;634
432057;202003;220;588;164;450;25;61;70;178;95;239
432060;202003;446;1079;135;424;32;110;43;117;75;227
432065;202003;195;545;133;408;26;79;57;172;83;251
432067;202003;691;2028;580;1788;50;177;434;1285;484;1462
432070;202003;1600;4256;1023;3097;238;797;315;867;553;1664
432080;202003;4105;9981;3093;8325;561;1745;1428;3661;1989;5406
432085;202003;339;873;228;701;64;198;89;287;153;485
432090;202003;1318;3368;851;2463;172;537;425;1170;597;1707
432100;202003;887;2288;411;1294;79;265;75;186;154;451
432110;202003;1973;5292;1315;4080;320;1131;125;354;445;1485
432120;202003;2653;7258;2021;6154;389;1306;779;2273;1168;3579
432130;202003;2404;6253;1973;5620;582;1693;872;2536;1454;4229
432132;202003;164;465;96;316;18;61;44;124;62;185
432135;202003;966;2294;625;1708;34;106;448;1212;482;1318
432140;202003;1419;4263;1078;3587;158;567;672;2235;830;2802
432143;202003;1371;3597;1049;3094;71;230;695;2034;766;2264
432145;202003;1282;3408;735;2234;99;336;230;586;329;922
432146;202003;94;261;61;204;22;77;17;55;39;132
432147;202003;457;1304;264;883;86;312;68;195;154;507
432149;202003;407;1022;200;594;15;50;91;251;106;301
432150;202003;2863;7347;2038;5869;443;1440;771;2169;1214;3609
432160;202003;4916;13038;3558;10825;910;3034;1251;3632;2161;6666
432162;202003;255;563;36;106;5;10;6;20;11;30
432163;202003;118;290;24;65;0;0;3;5;3;5
432166;202003;577;1638;428;1321;82;279;139;393;221;672
432170;202003;1242;3299;774;2408;152;522;287;836;439;1358
432180;202003;2522;6109;1314;3781;252;776;457;1179;709;1955
432183;202003;347;1031;230;751;57;213;63;192;120;405
432185;202003;775;2011;441;1349;33;116;242;697;275;813
432190;202003;1670;4096;1053;3099;198;647;516;1436;714;2083
432195;202003;875;2197;566;1639;157;422;203;621;360;1043
432200;202003;3013;7825;2146;6412;376;1132;1177;3575;1553;4707
432210;202003;362;960;220;678;41;161;102;264;143;425
432215;202003;598;1759;539;1668;50;136;398;1252;448;1388
432218;202003;244;612;106;303;18;62;47;121;65;183
432220;202003;3405;8086;2512;6675;438;1243;1388;3615;1826;4858
432225;202003;79;229;58;185;11;41;31;99;42;140
432230;202003;666;1559;347;957;41;112;151;384;192;496
432232;202003;469;1150;292;839;59;185;104;273;163;458
432234;202003;262;656;116;340;20;50;15;41;35;91
432235;202003;46;131;16;50;4;12;4;13;8;25
432237;202003;323;833;281;763;10;21;231;615;241;636
432240;202003;14789;37121;10547;31370;768;2558;6703;20868;7471;23426
432250;202003;4624;13591;3584;11586;959;3208;1451;4706;2410;7914
432252;202003;428;1029;263;736;34;101;134;362;168;463
432253;202003;869;2708;537;1843;130;482;44;139;174;621
432254;202003;617;1446;132;402;22;69;17;46;39;115
432255;202003;105;267;55;168;5;15;26;70;31;85
432260;202003;4418;11525;3200;9182;951;2830;957;2691;1908;5521
432270;202003;1666;4702;1316;4009;398;1323;257;728;655;2051
432280;202003;1161;2897;553;1682;89;289;199;509;288;798
432285;202003;137;406;19;55;1;3;3;5;4;8
432290;202003;319;903;167;533;57;181;32;74;89;255
432300;202003;24682;62672;18243;52179;2697;8681;10515;29060;13212;37741
432310;202003;771;2119;549;1694;52;160;372;1155;424;1315
432320;202003;202;472;69;212;7;22;25;72;32;94
432330;202003;211;477;58;187;8;19;11;35;19;54
432335;202003;177;491;60;214;6;26;13;40;19;66
432340;202003;292;692;125;390;11;33;44;130;55;163
432345;202003;644;1504;565;1408;19;49;458;1128;477;1177
432350;202003;339;898;180;583;26;93;68;215;94;308
432360;202003;232;682;46;150;3;6;17;58;20;64
432370;202003;287;720;187;548;14;47;127;365;141;412
432375;202003;462;1163;339;920;60;156;168;462;228;618
432377;202003;176;548;33;110;8;30;4;10;12;40
432380;202003;1566;4171;989;3098;171;606;496;1483;667;2089
500020;202003;2396;6249;1715;5084;160;558;1052;3036;1212;3594
500025;202003;1175;2885;729;2044;66;200;393;1047;459;1247
500060;202003;7487;21314;5071;16230;620;2079;2937;9657;3557;11736
500070;202003;4124;10720;2830;8495;526;1615;1214;3729;1740;5344
500080;202003;1497;3746;915;2661;170;552;357;919;527;1471
500085;202003;1932;4881;1303;3825;295;916;621;1741;916;2657
500090;202003;1970;5344;1310;4165;235;784;470;1563;705;2347
500100;202003;3481;8901;2627;7500;448;1441;1271;3447;1719;4888
500110;202003;7570;19542;4778;15041;1033;3565;1450;5368;2483;8933
500124;202003;1963;5843;1557;5151;252;786;833;2890;1085;3676
500150;202003;1260;2875;774;2165;146;411;304;856;450;1267
500190;202003;4632;12016;2925;8707;635;1933;752;2151;1387;4084
500200;202003;2150;5177;1572;4206;174;495;957;2439;1131;2934
500210;202003;4479;10994;3164;9261;839;2451;1388;4168;2227;6619
500215;202003;1305;3686;914;2949;94;343;482;1547;576;1890
500220;202003;2369;6693;1472;4963;247;894;351;1131;598;2025
500230;202003;2010;4726;1505;4015;176;443;1014;2687;1190;3130
500240;202003;3446;10394;2378;8143;368;1393;930;3321;1298;4714
500260;202003;2993;6417;1821;4798;257;666;934;2401;1191;3067
500270;202003;130824;308835;76416;215539;12964;40109;27451;73348;40415;113457
500280;202003;1224;3137;829;2514;114;374;467;1386;581;1760
500290;202003;3369;8023;1865;5505;323;1103;578;1537;901;2640
500295;202003;3172;7759;1909;5493;309;976;697;1721;1006;2697
500310;202003;913;1915;608;1530;101;213;295;788;396;1001
500315;202003;3516;9944;2738;8764;238;780;1912;6287;2150;7067
500320;202003;17991;49450;12332;39977;3177;10783;4272;14674;7449;25457
500325;202003;4121;9227;2806;7489;224;632;1890;5118;2114;5750
500330;202003;6493;14854;4220;11516;313;947;2348;6564;2661;7511
500345;202003;1923;4747;1259;3711;315;960;412;1192;727;2152
500348;202003;2272;5918;1746;5044;235;692;997;2953;1232;3645
500350;202003;1241;3390;681;2167;75;243;284;860;359;1103
500370;202003;23838;61941;16356;49594;2227;7707;8428;25549;10655;33256
500375;202003;2397;6353;1577;4662;296;946;519;1439;815;2385
500380;202003;3333;8373;2259;6540;630;1969;545;1602;1175;3571
500390;202003;491;1060;311;841;51;159;186;495;237;654
500400;202003;1319;3399;856;2499;163;542;277;736;440;1278
500410;202003;2301;5741;1607;4685;170;487;943;2847;1113;3334
500430;202003;2489;6180;1667;4951;224;779;712;2218;936;2997
500440;202003;1041;2608;656;1990;98;330;253;823;351;1153
500450;202003;1391;3462;765;2302;134;424;185;527;319;951
500460;202003;3565;9653;2149;6809;358;1287;672;2103;1030;3390
500470;202003;2397;6482;1445;4500;411;1435;307;832;718;2267
500480;202003;2022;6237;1707;5735;148;550;1272;4329;1420;4879
500490;202003;927;2176;524;1576;120;440;146;429;266;869
500500;202003;4089;11006;2598;8548;922;3573;451;1523;1373;5096
500510;202003;666;1710;427;1254;25;90;262;751;287;841
500515;202003;1689;4328;1287;3690;134;424;814;2235;948;2659
500520;202003;2905;9317;2285;8132;614;2211;943;3551;1557;5762
500525;202003;830;2509;678;2275;60;206;419;1432;479;1638
500540;202003;4376;11419;2609;8258;683;2686;244;691;927;3377
500560;202003;5286;14550;4221;13198;254;842;3392;10767;3646;11609
500568;202003;4184;9172;2484;6633;574;1689;877;2351;1451;4040
500570;202003;7260;16989;4309;11931;793;2406;1525;3969;2318;6375
500580;202003;2968;7947;2144;6478;466;1473;1003;3046;1469;4519
500600;202003;3020;7597;2107;6172;465;1372;869;2635;1334;4007
500620;202003;7126;19068;4760;14508;1051;3354;1657;5007;2708;8361
500625;202003;471;1295;274;864;48;157;90;245;138;402
500627;202003;700;1835;421;1331;65;216;142;447;207;663
500630;202003;6265;14581;3528;9985;720;2247;1030;2948;1750;5195
500635;202003;2757;8818;2132;7996;166;689;1508;6117;1674;6806
500640;202003;1654;3646;1080;2879;37;119;742;1951;779;2070
500660;202003;16666;43425;11284;35518;3576;12769;2766;9030;6342;21799
500690;202003;2208;6176;1438;4843;519;2019;81;196;600;2215
500710;202003;2749;7448;2112;6347;603;1910;655;1866;1258;3776
500720;202003;4642;11837;2977;9051;685;2225;880;2744;1565;4969
500730;202003;932;2360;539;1643;85;245;156;503;241;748
500740;202003;4401;10599;2992;8348;383;1114;1583;4432;1966;5546
500750;202003;920;2370;598;1765;84;247;225;594;309;841
500755;202003;829;2193;448;1458;83;294;86;260;169;554
500769;202003;4727;11692;2515;7504;480;1640;357;830;837;2470
500770;202003;1428;3880;911;2944;165;612;308;982;473;1594
500780;202003;1174;2860;756;2151;156;499;204;555;360;1054
500790;202003;6970;18572;5404;15964;1092;3461;2683;7977;3775;11438
500793;202003;1946;5057;1356;4014;348;1100;428;1179;776;2279
500795;202003;2461;6351;2022;5784;86;237;1723;5057;1809;5294
500797;202003;666;1707;440;1285;124;375;140;411;264;786
500800;202003;2894;6658;1792;5044;564;1876;206;643;770;2519
500830;202003;16970;43193;11362;32769;2371;7385;4091;11136;6462;18521
500840;202003;1314;3225;781;2216;91;262;315;850;406;1112
510010;202003;1755;3978;1157;3202;103;271;824;2318;927;2589
510020;202003;3295;8380;1735;5316;368;1206;381;1058;749;2264
510025;202003;6461;15842;3919;11668;581;1966;1608;4645;2189;6611
510030;202003;2320;5272;1502;4052;321;881;555;1489;876;2370
510035;202003;1190;3112;746;2399;82;288;446;1532;528;1820
510040;202003;2183;4907;1580;4127;149;384;1015;2759;1164;3143
510050;202003;1967;4198;1271;3281;141;417;882;2221;1023;2638
510060;202003;1298;3292;939;2711;198;631;270;728;468;1359
510080;202003;1199;3171;764;2437;255;858;212;576;467;1434
510100;202003;638;1492;437;1175;55;149;226;592;281;741
510120;202003;255;473;137;335;4;13;103;256;107;269
510125;202003;1998;4954;1565;4335;167;606;823;2133;990;2739
510130;202003;1400;3548;974;2860;199;646;304;912;503;1558
510140;202003;2923;7619;1965;6407;703;2697;668;2039;1371;4736
510160;202003;1632;4259;1192;3684;158;470;863;2728;1021;3198
510170;202003;4355;11528;3151;9582;768;2461;1236;3858;2004;6319
510180;202003;13245;30158;8017;22390;1778;5428;2296;7438;4074;12866
510185;202003;1651;4291;1084;3480;440;1435;275;1148;715;2583
510190;202003;1970;5664;1265;4452;348;1360;225;859;573;2219
510250;202003;15880;40591;11829;34558;2271;6955;6049;18411;8320;25366
510260;202003;1873;7904;1548;7312;262;1334;939;4829;1201;6163
510263;202003;2932;8158;1768;5789;286;1053;224;640;510;1693
510267;202003;4581;13141;2565;8620;490;1747;303;945;793;2692
510268;202003;1221;3001;926;2553;110;295;609;1672;719;1967
510269;202003;981;2673;595;1940;144;514;181;542;325;1056
510270;202003;2810;8096;1920;6463;344;1290;778;2578;1122;3868
510279;202003;1700;4391;1047;3249;200;691;437;1313;637;2004
510285;202003;1070;2809;727;2221;231;791;150;418;381;1209
510300;202003;3590;9109;2611;7781;375;1167;1521;4730;1896;5897
510305;202003;1376;3827;828;2760;181;645;189;714;370;1359
510310;202003;883;2178;591;1690;165;494;161;485;326;979
510320;202003;3520;8842;2389;6870;543;1714;607;1736;1150;3450
510325;202003;4137;12293;3099;10390;889;3130;949;3308;1838;6438
510330;202003;2643;8003;1781;6473;351;1283;661;2765;1012;4048
510335;202003;4521;13092;3379;11266;516;1856;1909;6544;2425;8400
510336;202003;434;1232;310;1035;54;183;151;557;205;740
510337;202003;1453;4262;932;3305;358;1401;184;661;542;2062
510340;202003;85629;191127;53011;143500;12864;41616;15507;39185;28371;80801
510343;202003;978;2698;664;2112;119;429;280;845;399;1274
510345;202003;1198;3440;901;2861;156;493;409;1276;565;1769
510350;202003;2657;7006;1706;5384;371;1226;656;2064;1027;3290
510360;202003;1826;3818;1177;3053;71;136;806;2268;877;2404
510370;202003;1713;4886;1234;4058;165;607;729;2482;894;3089
510380;202003;523;1307;282;880;52;186;107;322;159;508
510385;202003;1190;3992;866;3375;86;390;550;2230;636;2620
510390;202003;1166;3183;769;2661;242;803;289;1125;531;1928
510395;202003;704;1601;470;1258;26;69;290;829;316;898
510410;202003;4601;12900;3333;10618;645;2150;1733;5710;2378;7860
510420;202003;2322;4949;1554;3920;115;319;1009;2548;1124;2867
510450;202003;418;1041;242;700;61;177;36;120;97;297
510452;202003;683;1919;467;1510;62;220;251;787;313;1007
510454;202003;868;2434;665;2093;70;203;417;1399;487;1602
510455;202003;862;2429;617;1936;99;351;241;697;340;1048
510460;202003;1733;4306;1223;3545;95;339;774;2145;869;2484
510480;202003;4335;10488;2811;7695;543;1649;1115;2966;1658;4615
510490;202003;1599;4189;1178;3657;164;524;762;2391;926;2915
510500;202003;1482;3753;907;2818;178;590;304;966;482;1556
510510;202003;3258;9598;2390;8019;600;2252;746;2649;1346;4901
510515;202003;5065;13075;3273;9835;794;2652;814;2190;1608;4842
510517;202003;995;2930;756;2525;231;861;136;397;367;1258
510520;202003;2001;4093;1126;3003;77;213;587;1678;664;1891
510523;202003;1006;2571;724;2106;152;424;414;1238;566;1662
510525;202003;6481;17916;4783;14597;781;2671;2236;6465;3017;9136
510530;202003;540;1395;395;1181;29;94;243;716;272;810
510550;202003;2263;6735;1619;5598;384;1395;714;2501;1098;3896
510558;202003;2180;5897;1568;4930;217;655;714;2438;931;3093
510560;202003;1582;4527;928;3220;189;745;234;875;423;1620
510562;202003;5234;13758;3668;10897;880;2824;1228;3859;2108;6683
510590;202003;3061;7591;2178;6473;172;534;1555;4729;1727;5263
510600;202003;1386;3133;891;2415;162;448;401;1098;563;1546
510610;202003;2571;6238;1754;5160;173;577;1096;3243;1269;3820
510615;202003;2450;6225;1653;4934;285;868;848;2638;1133;3506
510617;202003;952;2884;726;2515;103;409;449;1627;552;2036
510618;202003;1194;3205;812;2535;181;631;371;1109;552;1740
510619;202003;710;1799;449;1356;67;220;118;336;185;556
510620;202003;1366;3083;640;1925;172;636;36;75;208;711
510621;202003;1472;3951;877;2806;188;664;266;801;454;1465
510622;202003;4417;12512;2990;9434;1010;3397;427;1225;1437;4622
510623;202003;2485;6225;1720;5021;407;1431;529;1486;936;2917
510624;202003;1577;3972;722;2402;80;293;160;481;240;774
510625;202003;2752;6753;1463;4434;248;902;334;1019;582;1921
510626;202003;1447;3509;904;2651;249;834;204;607;453;1441
510627;202003;586;1525;331;1024;85;293;80;266;165;559
510628;202003;1419;3290;936;2644;196;592;352;985;548;1577
510629;202003;1531;4371;1127;3647;224;775;413;1340;637;2115
510630;202003;3163;8879;1820;6296;427;1589;315;1175;742;2764
510631;202003;567;1369;410;1136;14;38;313;897;327;935
510637;202003;3221;7796;2283;6429;569;1793;656;1873;1225;3666
510642;202003;5249;15097;3967;13132;986;3540;1680;5719;2666;9259
510645;202003;845;1716;505;1271;138;340;209;524;347;864
510650;202003;6821;17583;5400;16021;614;1639;3740;12213;4354;13852
510665;202003;1704;3791;1030;2703;149;410;445;1216;594;1626
510670;202003;423;914;243;651;24;65;139;383;163;448
510675;202003;5674;15750;3764;12141;1074;3856;586;1843;1660;5699
510677;202003;1997;5203;1367;4249;205;725;711;2162;916;2887
510680;202003;671;1734;370;1166;74;256;71;206;145;462
510682;202003;1471;4382;1068;3711;370;1423;242;810;612;2233
510685;202003;523;1524;374;1216;59;208;187;604;246;812
510700;202003;3918;9529;2701;7795;269;844;1951;5627;2220;6471
510704;202003;10297;24272;6689;18041;1445;4210;1772;4639;3217;8849
510706;202003;1891;5750;1358;4873;261;955;725;2823;986;3778
510710;202003;2518;6365;1626;4686;349;1055;555;1535;904;2590
510715;202003;564;1264;406;1042;33;100;198;500;231;600
510718;202003;2279;5142;1320;3858;393;1160;442;1583;835;2743
510719;202003;417;872;242;648;22;62;138;350;160;412
510720;202003;872;2040;560;1567;95;301;263;696;358;997
510724;202003;758;2068;518;1631;78;266;277;845;355;1111
510726;202003;1038;1898;556;1316;63;172;272;647;335;819
510729;202003;587;1384;257;760;36;122;59;189;95;311
510730;202003;2800;6812;1869;5361;251;815;924;2598;1175;3413
510735;202003;990;2865;749;2523;76;311;545;1830;621;2141
510740;202003;864;2134;537;1524;91;261;244;686;335;947
510757;202003;495;1531;385;1359;122;483;142;474;264;957
510760;202003;41415;91501;24275;65094;5042;15527;7454;18471;12496;33998
510770;202003;4127;9342;2796;7678;232;614;1906;5510;2138;6124
510774;202003;340;865;229;680;32;94;120;362;152;456
510775;202003;590;1586;377;1235;81;287;78;243;159;530
510776;202003;418;1049;296;821;70;195;99;293;169;488
510777;202003;1479;3960;1058;3417;143;541;676;2157;819;2698
510779;202003;635;1739;487;1506;56;165;282;940;338;1105
510780;202003;3418;8853;2477;7538;569;1731;1135;3863;1704;5594
510785;202003;1943;5164;1114;3637;289;1006;180;671;469;1677
510787;202003;2523;7180;1647;5326;539;1844;203;660;742;2504
510788;202003;566;1362;396;1096;63;184;190;604;253;788
510790;202003;16453;42686;9767;30169;2067;7220;1486;4097;3553;11317
510792;202003;8243;22477;4998;16262;1051;3868;830;2426;1881;6294
510794;202003;1165;3108;775;2432;236;822;154;425;390;1247
510795;202003;7702;20292;4906;15200;1133;3908;1272;3869;2405;7777
510800;202003;1646;4293;1058;3285;361;1144;115;355;476;1499
510805;202003;1442;4025;981;3151;225;770;317;924;542;1694
510810;202003;609;1248;382;940;106;263;150;390;256;653
510820;202003;734;1402;398;977;30;89;210;526;240;615
510830;202003;818;1978;581;1675;50;141;402;1239;452;1380
510835;202003;532;1290;340;1010;39;129;199;577;238;706
510840;202003;49771;106863;33940;87626;6556;15974;17366;49491;23922;65465
510850;202003;1778;4282;1003;3052;316;1100;123;342;439;1442
510860;202003;2259;6061;1402;4588;441;1673;114;367;555;2040
510880;202003;683;1951;514;1633;127;422;185;601;312;1023
510885;202003;531;1301;362;1063;69;224;121;352;190;576
510890;202003;616;1816;470;1569;105;380;212;701;317;1081
510895;202003;1215;3125;795;2439;163;592;332;945;495;1537
520005;202003;2473;6391;1890;5669;571;1719;798;2698;1369;4417
520010;202003;2139;6157;1522;4966;387;1426;458;1302;845;2728
520013;202003;2745;7067;1795;5318;399;1218;511;1656;910;2874
520015;202003;491;1239;345;1020;76;232;137;427;213;659
520017;202003;1078;2780;805;2366;98;321;534;1541;632;1862
520020;202003;371;846;282;735;25;88;215;533;240;621
520025;202003;32538;91318;27862;84758;2751;9157;20100;60867;22851;70024
520030;202003;5381;13867;4269;12317;290;937;3053;8738;3343;9675
520050;202003;396;940;248;682;11;32;156;439;167;471
520055;202003;1679;4095;1100;2992;89;230;629;1682;718;1912
520060;202003;1368;3794;987;3087;258;890;244;765;502;1655
520080;202003;1761;4565;1309;3953;237;716;637;2106;874;2822
520082;202003;885;2251;694;1938;73;192;365;1073;438;1265
520085;202003;795;2143;617;1849;108;341;302;878;410;1219
520090;202003;825;1625;564;1338;54;86;435;1086;489;1172
520110;202003;37181;100129;25578;80791;7864;28321;2212;6371;10076;34692
520120;202003;189;456;104;312;14;50;40;118;54;168
520130;202003;3494;8619;2719;7422;511;1412;1182;3301;1693;4713
520140;202003;39372;105287;27155;84331;9718;32761;3547;11463;13265;44224
520145;202003;567;1320;378;1054;58;191;214;555;272;746
520150;202003;584;1311;420;1113;73;193;230;626;303;819
520160;202003;724;1684;524;1375;98;242;244;683;342;925
520170;202003;4893;9884;3237;7990;181;513;2483;6074;2664;6587
520180;202003;2121;5770;1719;5196;311;1045;959;2883;1270;3928
520215;202003;1667;4034;1180;3278;283;849;396;1042;679;1891
520235;202003;588;1350;334;952;35;123;132;360;167;483
520250;202003;1462;3778;1006;3009;325;1056;243;776;568;1832
520260;202003;771;1799;480;1327;86;242;204;579;290;821
520280;202003;655;1635;502;1398;102;289;240;710;342;999
520310;202003;1007;2222;657;1699;154;457;251;680;405;1137
520320;202003;1593;4284;1197;3646;157;536;664;1991;821;2527
520330;202003;3778;10230;2704;8468;401;1498;1399;4285;1800;5783
520340;202003;2387;5284;1472;4016;163;412;871;2501;1034;2913
520350;202003;2783;6661;1961;5413;579;1677;748;2097;1327;3774
520355;202003;1762;4838;1242;3799;393;1307;302;810;695;2117
520357;202003;732;1759;520;1449;29;75;390;1116;419;1191
520360;202003;671;1761;504;1481;134;415;145;464;279;879
520380;202003;1394;3465;812;2383;89;277;414;1140;503;1417
520390;202003;985;2173;578;1673;161;503;195;612;356;1115
520393;202003;473;1136;313;886;35;118;147;384;182;502
520396;202003;803;2089;667;1872;38;126;496;1352;534;1478
520400;202003;1514;3769;1146;3261;147;455;770;2203;917;2658
520410;202003;1914;4320;1149;3148;190;558;448;1184;638;1742
520420;202003;357;830;275;701;22;61;213;522;235;583
520425;202003;1451;3523;816;2361;213;636;184;506;397;1142
520430;202003;2245;5143;1247;3596;237;809;59;151;296;960
520440;202003;2874;6982;1714;4926;418;1334;446;1216;864;2550
520450;202003;11487;27285;7472;21233;2354;7327;1387;4059;3741;11386
520455;202003;655;1785;475;1513;138;467;135;443;273;910
520460;202003;1004;2336;777;2048;74;169;622;1674;696;1843
520465;202003;749;1914;598;1709;80;266;414;1137;494;1403
520470;202003;2027;5268;1551;4636;458;1404;638;2057;1096;3461
520480;202003;881;2438;607;1979;194;646;132;459;326;1105
520485;202003;1516;4295;1267;3945;169;537;901;2806;1070;3343
520490;202003;3868;10686;2864;9088;973;3198;1049;3485;2022;6683
520495;202003;1539;3400;1156;2887;49;128;926;2322;975;2450
520500;202003;1197;3227;815;2478;189;617;331;1007;520;1624
520505;202003;712;1578;485;1290;61;167;298;794;359;961
520510;202003;7431;18475;4845;14456;1111;3726;1334;4297;2445;8023
520520;202003;1099;2794;802;2326;190;602;281;823;471;1425
520530;202003;1936;5650;1436;4813;422;1471;515;1847;937;3318
520540;202003;2768;7339;1677;5157;314;1059;382;1116;696;2175
520545;202003;931;2438;690;2039;145;423;278;835;423;1258
520547;202003;781;2126;620;1857;148;442;312;947;460;1389
520549;202003;12743;34401;10450;31031;1430;4490;6984;20721;8414;25211
520551;202003;4394;11938;3652;10851;387;1387;2602;7555;2989;8942
520552;202003;807;2092;665;1912;136;395;386;1167;522;1562
520570;202003;515;1150;342;908;85;202;136;410;221;612
520580;202003;2082;4838;1583;4245;108;353;1166;3082;1274;3435
520590;202003;1158;2955;795;2362;242;732;210;640;452;1372
520620;202003;7851;21291;6128;18777;1538;4849;2730;8649;4268;13498
520630;202003;690;1802;461;1400;79;245;117;346;196;591
520640;202003;2296;5722;1747;4769;413;1108;728;2060;1141;3168
520650;202003;792;1870;573;1566;95;258;312;905;407;1163
520660;202003;506;1212;261;783;53;189;68;195;121;384
520670;202003;886;2439;744;2235;68;211;476;1408;544;1619
520680;202003;656;1665;488;1403;77;214;254;737;331;951
520690;202003;323;751;221;604;65;163;70;217;135;380
520710;202003;397;962;275;752;10;23;199;536;209;559
520725;202003;1470;3461;1007;2716;117;367;633;1640;750;2007
520735;202003;741;1824;490;1404;106;287;182;566;288;853
520740;202003;2044;4626;1523;4012;265;640;861;2450;1126;3090
520750;202003;649;1575;450;1255;72;196;225;635;297;831
520753;202003;1226;3293;924;2722;180;563;372;1034;552;1597
520760;202003;1164;2622;1020;2449;31;59;933;2278;964;2337
520780;202003;1416;3328;999;2755;102;303;501;1347;603;1650
520790;202003;3254;7770;2293;6213;312;839;1256;3610;1568;4449
520800;202003;15770;40953;12163;35682;1901;5793;7071;21401;8972;27194
520810;202003;1245;2639;900;2242;150;401;566;1485;716;1886
520815;202003;560;1711;416;1415;74;279;120;420;194;699
520830;202003;1760;3762;1247;3186;39;106;1031;2602;1070;2708
520840;202003;2491;6726;2009;6095;840;2761;537;1745;1377;4506
520850;202003;614;1594;451;1354;156;542;108;344;264;886
520860;202003;6273;16901;4532;14068;1203;4024;1652;5071;2855;9095
520870;202003;100624;233397;66440;182541;14853;44318;23147;62619;38000;106937
520880;202003;6545;18798;5015;16042;1155;3878;1846;5948;3001;9826
520890;202003;3808;9209;2567;7247;519;1596;1092;3106;1611;4702
520910;202003;4519;11424;2833;8473;691;2234;632;1861;1323;4095
520915;202003;702;1972;411;1307;71;245;138;426;209;671
520920;202003;4252;9584;2956;7947;354;985;1684;4708;2038;5693
520929;202003;640;1501;465;1243;70;164;234;678;304;842
520940;202003;947;2515;734;2217;43;138;539;1596;582;1734
520945;202003;465;1057;375;931;18;41;266;652;284;693
520960;202003;976;2394;762;2059;150;368;449;1234;599;1602
520970;202003;2432;6707;1886;5836;474;1651;498;1639;972;3290
520980;202003;750;1824;544;1544;98;292;222;620;320;912
520990;202003;2888;7814;2311;7052;329;965;1513;4716;1842;5681
520993;202003;1077;2563;726;2017;105;334;411;1090;516;1424
520995;202003;2232;5671;1669;4886;258;765;677;2050;935;2815
521000;202003;8431;22044;5518;16779;1117;3518;1660;5047;2777;8565
521010;202003;3566;9289;2658;7723;258;755;1547;4449;1805;5204
521015;202003;769;1898;524;1470;37;116;334;889;371;1005
521020;202003;3079;7879;1760;5328;522;1749;129;409;651;2158
521030;202003;459;1008;297;756;61;135;126;356;187;491
521040;202003;7465;18311;5460;15139;1160;3365;2322;6590;3482;9955
521056;202003;890;2351;691;2055;224;664;189;625;413;1289
521060;202003;929;2469;679;2011;63;192;339;1008;402;1200
521080;202003;1093;2364;546;1502;71;212;227;542;298;754
521090;202003;3140;8394;2105;6370;583;1884;280;891;863;2775
521100;202003;1712;3990;1203;3264;189;514;710;1949;899;2463
521120;202003;4596;10767;3292;9158;202;514;1633;5284;1835;5798
521130;202003;978;2202;547;1464;21;65;290;822;311;887
521140;202003;1197;3078;853;2471;111;328;411;1209;522;1537
521150;202003;12187;26658;7483;19969;1258;3897;3549;9641;4807;13538
521160;202003;626;1300;435;1021;47;107;288;659;335;766
521170;202003;1001;2345;722;1931;54;150;493;1295;547;1445
521180;202003;6985;19420;5697;17167;914;3001;2954;8627;3868;11628
521190;202003;10231;25470;5787;17945;1449;4809;1129;3778;2578;8587
521200;202003;682;1670;470;1326;48;134;261;739;309;873
521205;202003;617;1532;462;1283;17;53;347;923;364;976
521210;202003;678;1739;387;1151;85;271;71;163;156;434
521220;202003;3581;8740;2292;6716;392;1295;863;2506;1255;3801
521225;202003;334;732;238;629;36;99;139;361;175;460
521230;202003;1288;3302;1131;3108;363;1013;575;1677;938;2690
521250;202003;29547;79508;22733;69471;8434;27149;6634;21591;15068;48740
521260;202003;551;1280;396;1035;55;147;223;574;278;721
521270;202003;1741;4443;1508;4168;85;205;1148;3217;1233;3422
521280;202003;1753;4700;1296;3935;306;1027;539;1665;845;2692
521290;202003;445;1066;308;888;41;137;189;531;230;668
521295;202003;1075;2324;809;2035;58;110;668;1735;726;1845
521300;202003;1817;4504;1425;3951;260;672;909;2602;1169;3274
521305;202003;687;1664;478;1348;64;167;278;786;342;953
521308;202003;4595;12309;3168;9584;283;866;1856;5532;2139;6398
521310;202003;8083;20621;5535;16333;1208;3879;2269;6438;3477;10317
521340;202003;404;944;293;782;21;59;208;540;229;599
521350;202003;1996;5091;1499;4339;127;452;1060;2923;1187;3375
521370;202003;1215;3079;713;2210;205;737;90;302;295;1039
521375;202003;1291;3143;867;2534;199;580;266;867;465;1447
521377;202003;1436;3075;1033;2581;77;139;842;2202;919;2341
521380;202003;6029;16006;3876;12024;399;1363;1048;3476;1447;4839
521385;202003;635;1546;485;1354;59;154;278;842;337;996
521390;202003;695;1705;480;1380;144;459;178;535;322;994
521400;202003;2560;5947;1962;5213;223;589;1354;3679;1577;4268
521405;202003;1272;3239;918;2633;178;518;448;1281;626;1799
521410;202003;783;2100;582;1749;102;286;296;949;398;1235
521440;202003;1144;2886;810;2377;272;874;230;680;502;1554
521450;202003;3805;11288;2771;9258;726;2468;719;2544;1445;5012
521460;202003;5562;14661;3871;11643;1334;4199;871;2693;2205;6892
521470;202003;608;1640;363;1126;48;145;121;368;169;513
521480;202003;355;893;206;605;40;115;65;186;105;301
521483;202003;2363;5653;1639;4542;359;1063;623;1708;982;2771
521486;202003;1708;4023;1259;3392;72;194;921;2463;993;2657
521487;202003;404;985;284;818;47;138;140;413;187;551
521490;202003;885;2371;653;1990;37;147;464;1375;501;1522
521500;202003;2146;5300;1556;4366;94;329;1103;3020;1197;3349
521520;202003;718;1667;507;1356;77;218;214;582;291;800
521523;202003;11145;34342;9121;31055;2486;9330;2465;8688;4951;18018
521525;202003;998;2313;730;1935;70;193;522;1373;592;1566
521530;202003;2186;5660;1247;3744;271;849;298;921;569;1770
521540;202003;802;2028;533;1585;70;244;245;759;315;1003
521550;202003;1421;3635;792;2340;140;478;218;659;358;1137
521560;202003;4396;11597;3003;9707;441;1701;1538;5223;1979;6924
521565;202003;629;1519;484;1320;74;189;297;801;371;990
521570;202003;3356;9138;2206;6909;431;1580;202;676;633;2256
521580;202003;472;1151;268;805;39;127;80;214;119;341
521590;202003;623;1474;455;1234;83;249;258;687;341;936
521600;202003;366;987;232;723;34;86;97;309;131;395
521630;202003;1646;3608;999;2659;205;586;347;896;552;1482
521640;202003;1743;4061;1164;3231;256;740;399;1091;655;1831
521645;202003;546;1420;343;1054;82;226;113;357;195;583
521680;202003;1072;3244;818;2746;239;880;117;427;356;1307
521690;202003;512;1247;423;1128;58;164;268;708;326;872
521710;202003;3120;7775;1955;5859;353;1203;477;1342;830;2545
521720;202003;2158;4986;1382;3803;149;461;784;2162;933;2623
521730;202003;3449;9682;2604;8205;741;2715;686;1837;1427;4552
521740;202003;3800;9985;2836;8571;694;2269;1079;3398;1773;5667
521760;202003;14539;39895;11196;34719;2877;9902;4132;13351;7009;23253
521770;202003;2888;6956;1884;5322;573;1754;471;1340;1044;3094
521800;202003;6085;16412;4345;13482;988;3136;1678;5677;2666;8813
521805;202003;469;1147;347;971;104;277;149;427;253;704
521810;202003;599;1408;417;1162;61;175;241;681;302;856
521830;202003;5454;15090;4293;13289;290;1080;3087;9381;3377;10461
521839;202003;688;1640;469;1285;76;237;252;629;328;866
521850;202003;5325;12454;3305;9439;579;1853;505;1374;1084;3227
521860;202003;1499;3958;1025;3133;185;621;321;968;506;1589
521870;202003;674;1885;476;1491;100;356;121;332;221;688
521878;202003;652;1692;436;1268;54;182;231;613;285;795
521880;202003;17704;43025;11727;33826;2979;9115;4057;11951;7036;21066
521890;202003;2957;7654;1927;5849;549;1804;346;965;895;2769
521900;202003;1450;3403;834;2464;280;801;111;342;391;1143
521910;202003;1211;2571;790;2077;75;196;433;1245;508;1441
521920;202003;459;1264;335;1046;58;210;139;416;197;626
521925;202003;738;1927;533;1626;81;256;295;895;376;1151
521930;202003;5297;12690;3444;9851;876;2364;1311;4152;2187;6516
521935;202003;966;2326;656;1772;62;177;393;1008;455;1185
521940;202003;1298;2873;829;2228;192;569;333;879;525;1448
521945;202003;521;1436;419;1259;99;302;221;682;320;984
521950;202003;728;1772;508;1430;122;360;219;581;341;941
521960;202003;706;1818;454;1346;56;177;237;656;293;833
521970;202003;2505;6144;1988;5527;155;424;1535;4320;1690;4744
521971;202003;707;1692;493;1384;134;370;144;419;278;789
521973;202003;1268;3319;976;2865;44;152;716;2065;760;2217
521975;202003;11525;30424;9399;27470;1478;4544;5941;17407;7419;21951
521980;202003;2510;5882;1918;5095;147;369;1441;3936;1588;4305
521990;202003;1048;2960;826;2562;176;571;301;926;477;1497
522000;202003;2382;6401;1924;5827;244;725;1295;4067;1539;4792
522005;202003;326;780;243;657;49;129;125;347;174;476
522010;202003;3819;9330;2660;7471;612;1889;939;2575;1551;4464
522015;202003;951;2491;683;2080;206;625;244;768;450;1393
522020;202003;5413;12891;3518;9879;726;2141;1388;4023;2114;6164
522026;202003;715;1898;488;1500;93;315;171;488;264;803
522028;202003;405;1020;298;843;57;178;130;356;187;534
522040;202003;3039;6902;2146;5700;262;742;1448;3799;1710;4541
522045;202003;16967;47187;12404;39022;2938;9984;3368;10311;6306;20295
522050;202003;960;2551;638;1999;170;589;206;592;376;1181
522060;202003;2838;7472;1948;5980;162;500;1124;3570;1286;4070
522068;202003;1781;4584;1387;4112;116;315;1080;3246;1196;3561
522070;202003;606;1482;487;1300;19;58;411;1082;430;1140
522100;202003;711;1821;475;1446;57;198;253;743;310;941
522108;202003;964;2491;742;2172;58;224;583;1645;641;1869
522119;202003;1460;3660;1113;3198;182;538;602;1803;784;2341
522130;202003;374;944;261;786;30;88;163;519;193;607
522140;202003;16992;45176;11704;35641;3059;10008;3101;9075;6160;19083
522145;202003;773;1917;516;1525;141;410;187;566;328;976
522150;202003;1031;2543;726;2031;197;546;213;631;410;1177
522155;202003;1045;2633;786;2222;141;373;437;1268;578;1641
522157;202003;546;1317;446;1188;25;83;349;934;374;1017
522160;202003;5938;15351;3805;11421;1032;3339;302;994;1334;4333
522170;202003;2598;6640;1934;5644;304;914;1083;3207;1387;4121
522180;202003;436;1019;280;754;59;168;37;119;96;287
522185;202003;18171;44906;12846;37562;5008;15950;2770;8802;7778;24752
522190;202003;756;1817;506;1381;95;269;188;504;283;773
522200;202003;1621;4582;1063;3505;219;788;185;549;404;1337
522205;202003;1635;3809;1239;3275;127;357;854;2258;981;2615
522220;202003;1233;3060;912;2576;119;348;519;1514;638;1862
522230;202003;1097;2797;877;2479;184;644;449;1200;633;1844
530010;202003;167523;449639;134210;400341;20893;68238;77928;229382;98821;297620
110001;202002;3875;10898;2588;8477;590;2074;1000;3333;1590;5407
110002;202002;11668;30780;8107;24641;2304;7404;2202;6771;4506;14175
110003;202002;602;1767;418;1387;100;357;104;327;204;684
110004;202002;10606;27974;6957;21405;1509;5035;1981;6257;3490;11292
110005;202002;2399;6277;1613;4956;347;1158;439;1471;786;2629
110006;202002;1724;4807;1068;3426;204;754;196;589;400;1343
110007;202002;1281;3257;810;2489;258;862;196;731;454;1593
110008;202002;3246;9076;2364;7722;269;858;1560;5418;1829;6276
110009;202002;4206;11892;2679;9109;609;2155;1065;3669;1674;5824
110010;202002;7228;23610;5314;19843;1096;4137;2579;10483;3675;14620
110011;202002;6541;17595;4439;13800;1593;5162;634;2072;2227;7234
110012;202002;14285;35790;8258;25166;2025;6597;769;2553;2794;9150
110013;202002;5054;14830;3659;11979;1511;5169;458;1650;1969;6819
110014;202002;3642;9815;2449;7538;598;1950;945;2849;1543;4799
110015;202002;5228;13667;2972;9165;705;2366;567;1619;1272;3985
110018;202002;3583;9051;2032;6312;407;1464;571;1729;978;3193
110020;202002;72106;174453;51011;145532;11232;33033;21191;66216;32423;99249
110025;202002;4811;11726;3127;8858;655;1991;1356;3870;2011;5861
110026;202002;479;1235;335;1024;85;271;138;458;223;729
110028;202002;6496;16671;3887;11968;1021;3404;574;1774;1595;5178
110029;202002;1438;3523;817;2432;184;559;305;958;489;1517
110030;202002;12418;28758;7660;21685;1668;5531;1556;4767;3224;10298
110032;202002;2891;8314;1820;6019;570;1883;390;1362;960;3245
110033;202002;3485;11027;2692;9566;962;3472;668;2637;1630;6109
110034;202002;3356;7916;2212;6325;660;2135;758;2335;1418;4470
110037;202002;1582;4710;1177;4001;264;896;563;1960;827;2856
110040;202002;2869;8092;2035;6525;584;2021;610;1913;1194;3934
110045;202002;4832;14077;3620;11866;967;3404;1288;4284;2255;7688
110050;202002;1740;4759;1218;3843;479;1648;230;754;709;2402
110060;202002;785;2408;531;1802;197;711;80;270;277;981
110070;202002;1541;4896;1157;4046;376;1404;230;723;606;2127
110080;202002;6081;14315;4466;12399;532;1386;3043;8975;3575;10361
110090;202002;545;1463;389;1190;89;299;173;516;262;815
110092;202002;1070;3161;780;2619;135;465;399;1431;534;1896
110094;202002;2696;8162;2021;6854;876;3182;295;994;1171;4176
110100;202002;1665;4961;1334;4314;377;1280;564;1837;941;3117
110110;202002;1663;4631;1147;3731;373;1250;264;933;637;2183
110120;202002;1226;3640;918;3037;228;808;300;968;528;1776
110130;202002;2518;6429;1612;4808;332;1123;604;1806;936;2929
110140;202002;1984;5913;1334;4577;334;1198;343;1212;677;2410
110143;202002;1284;3542;869;2713;284;884;143;454;427;1338
110145;202002;793;2133;513;1636;121;398;180;597;301;995
110146;202002;439;1166;307;965;56;175;148;500;204;675
110147;202002;753;1970;468;1407;72;240;175;461;247;701
110148;202002;728;2011;399;1367;108;414;42;144;150;558
110149;202002;2929;8098;2021;6629;708;2445;439;1550;1147;3995
110150;202002;2588;6337;1752;5203;522;1714;453;1612;975;3326
110155;202002;689;2043;484;1550;109;371;166;511;275;882
110160;202002;1431;4511;1052;3661;311;1092;249;898;560;1990
110170;202002;2116;5451;1276;3852;238;752;660;1905;898;2657
110175;202002;1612;4610;1136;3774;182;654;501;1752;683;2406
110180;202002;1345;3745;912;2870;149;485;458;1438;607;1923
120001;202002;3136;9322;2580;8492;406;1383;1648;5599;2054;6982
120005;202002;1928;7426;1746;7167;157;713;1385;5774;1542;6487
120010;202002;5217;15828;4408;14606;422;1394;3196;10923;3618;12317
120013;202002;2143;7611;1900;7314;423;1568;1177;4846;1600;6414
120017;202002;2451;8504;2170;8067;344;1307;1422;5573;1766;6880
120020;202002;14777;58249;13569;55924;1076;5103;10730;44448;11806;49551
120025;202002;3079;8828;2476;8092;380;1224;1708;5773;2088;6997
120030;202002;6450;25540;5985;24666;424;2299;4674;19331;5098;21630
120032;202002;1670;7548;1582;7383;106;683;1307;5988;1413;6671
120033;202002;4054;15055;3810;14631;123;704;3332;12683;3455;13387
120034;202002;2614;9602;2212;8910;114;706;1840;7206;1954;7912
120035;202002;3678;14611;3491;14286;291;1434;2853;11641;3144;13075
120038;202002;2660;8585;2257;7945;526;1896;1224;4392;1750;6288
120039;202002;2026;8768;1890;8487;131;803;1520;6768;1651;7571
120040;202002;43757;138371;37197;127654;5301;19187;23219;80847;28520;100034
120042;202002;3284;12400;3017;11917;145;787;2525;9872;2670;10659
120043;202002;1373;5588;1250;5388;37;227;1145;4935;1182;5162
120045;202002;6148;15895;5341;14993;127;527;4882;13558;5009;14085
120050;202002;9273;33549;8474;32316;396;2101;7083;27034;7479;29135
120060;202002;9513;36929;8709;35729;386;2330;7604;30950;7990;33280
120070;202002;3122;10106;2701;9538;254;928;1938;7098;2192;8026
120080;202002;4152;13577;3691;12888;451;1697;2714;9635;3165;11332
130002;202002;3039;12111;2715;11637;192;855;2307;10028;2499;10883
130006;202002;2382;8938;1972;8199;180;803;1473;6168;1653;6971
130008;202002;2645;9286;2344;8843;69;369;2028;7633;2097;8002
130010;202002;3947;11540;3315;10819;77;239;3043;10064;3120;10303
130014;202002;3020;9093;2324;7938;413;1426;1413;4973;1826;6399
130020;202002;2760;10863;2478;10432;141;833;1996;8342;2137;9175
130030;202002;10031;32760;9123;31693;321;1114;8089;28554;8410;29668
130040;202002;3746;11316;3108;10470;173;603;2591;8792;2764;9395
130050;202002;7551;27753;6347;26193;162;847;5786;24079;5948;24926
130060;202002;7452;29732;6393;28353;437;2467;5305;23416;5742;25883
130063;202002;6322;20724;5634;19957;210;936;5107;18172;5317;19108
130068;202002;3711;13285;3152;12451;230;1295;2371;9239;2601;10534
130070;202002;7501;21238;6135;19745;281;894;5113;16896;5394;17790
130080;202002;6949;25465;6067;24445;256;1433;5169;21114;5425;22547
130083;202002;2745;9055;2435;8661;166;700;2087;7410;2253;8110
130090;202002;3454;10810;3071;10324;58;260;2703;9261;2761;9521
130100;202002;7991;24155;6798;22908;55;130;6408;22135;6463;22265
130110;202002;8509;24414;7002;22549;1015;2611;5096;17732;6111;20343
130115;202002;5242;16394;4529;15608;105;352;4027;14123;4132;14475
130120;202002;14117;50087;12460;47875;1073;4584;10135;39287;11208;43871
130130;202002;5280;16960;4079;15366;386;1589;3020;11412;3406;13001
130140;202002;7229;25345;6364;24365;189;1071;5609;21520;5798;22591
130150;202002;3598;13558;3380;13316;78;508;3102;12238;3180;12746
130160;202002;5029;18027;4301;17093;263;1177;3670;14785;3933;15962
130165;202002;3213;12256;3026;12017;122;551;2736;10933;2858;11484
130170;202002;11565;34256;9243;31533;691;2716;7439;25689;8130;28405
130180;202002;4454;14402;4217;14136;41;220;4072;13620;4113;13840
130185;202002;18298;45474;14962;41937;963;1757;12661;37493;13624;39250
130190;202002;18692;62095;15016;56659;1717;6724;10691;41499;12408;48223
130195;202002;2481;9051;2038;8491;68;374;1803;7537;1871;7911
130200;202002;2539;7193;2120;6651;97;393;1776;5547;1873;5940
130210;202002;1283;4875;1152;4721;102;597;921;3675;1023;4272
130220;202002;2291;7995;1966;7564;57;311;1727;6667;1784;6978
130230;202002;4567;18950;3970;18097;236;1479;3402;15470;3638;16949
130240;202002;12113;36482;9816;33432;190;1123;8808;29956;8998;31079
130250;202002;26080;78540;22359;74365;1628;5074;18011;62247;19639;67321
130255;202002;4334;14592;3778;13630;162;750;3084;11098;3246;11848
130260;202002;260919;729401;212227;658918;57437;189218;98214;314361;155651;503579
130270;202002;9324;33296;7667;30733;1160;4638;5115;21413;6275;26051
130280;202002;3499;14245;3213;13924;96;490;2984;13084;3080;13574
130290;202002;13095;44397;11343;42145;678;2720;9544;36223;10222;38943
130300;202002;4666;16434;4250;15864;146;823;3717;13815;3863;14638
130310;202002;6139;20842;5344;19800;298;1349;4516;16763;4814;18112
130320;202002;3443;11200;2875;10469;355;1258;2137;8037;2492;9295
130330;202002;4604;14786;3720;13695;212;935;3174;11675;3386;12610
130340;202002;23379;73771;20067;70008;1453;4451;16834;60722;18287;65173
130350;202002;3943;14383;3549;13893;144;782;3138;12202;3282;12984
130353;202002;7356;20074;5906;18256;774;2320;4229;13524;5003;15844
130356;202002;5174;16584;4277;15191;728;2563;2646;9923;3374;12486
130360;202002;2967;9766;2574;9240;89;391;2300;8195;2389;8586
130370;202002;5705;22521;4975;21483;296;1652;4047;17379;4343;19031
130380;202002;7184;29981;6650;29237;383;2204;5660;24669;6043;26873
130390;202002;5757;24406;5097;23304;540;2828;3836;17595;4376;20423
130395;202002;2317;7425;1979;6867;200;727;1506;5215;1706;5942
130400;202002;2700;8597;2320;8091;86;289;2086;7390;2172;7679
130406;202002;10933;38407;9159;36273;1621;6382;6304;25814;7925;32196
130410;202002;4128;14761;3513;13717;1058;4339;1596;6418;2654;10757
130420;202002;13514;47801;11326;45081;921;4721;8877;35541;9798;40262
130423;202002;4300;13612;3766;13010;180;838;3313;11312;3493;12150
130426;202002;2784;11080;2596;10852;70;398;2394;10053;2464;10451
130430;202002;4208;11983;3654;11250;237;902;3074;9305;3311;10207
130440;202002;4776;15130;4086;14303;94;413;3779;13309;3873;13722
140002;202002;2150;6418;1871;6073;88;351;1580;5173;1668;5524
140005;202002;3273;9097;2868;8633;133;351;2462;7612;2595;7963
140010;202002;54672;144770;43529;128253;10868;33686;18770;56460;29638;90146
140015;202002;3750;11301;3183;10609;216;699;2777;9404;2993;10103
140017;202002;4381;12270;3818;11560;257;751;3138;9752;3395;10503
140020;202002;5217;15341;4493;14384;236;1001;3706;11762;3942;12763
140023;202002;2458;7346;2010;6707;200;673;1529;5200;1729;5873
140028;202002;2036;5248;1725;4851;90;280;1395;3926;1485;4206
140030;202002;5174;13306;4574;12615;334;656;3981;11374;4315;12030
140040;202002;2553;10124;2340;9841;97;598;2104;8732;2201;9330
140045;202002;2582;9411;2169;8856;348;1240;1483;6502;1831;7742
140047;202002;6173;17722;5201;16311;604;1927;3740;11918;4344;13845
140050;202002;1424;4179;1193;3848;116;374;909;2992;1025;3366
140060;202002;1647;4385;1411;4033;116;301;1131;3315;1247;3616
140070;202002;1893;9889;1836;9772;123;855;1526;8042;1649;8897
150010;202002;45273;113129;40934;107594;937;2244;36792;96568;37729;98812
150013;202002;1944;4994;1617;4648;145;305;1270;3877;1415;4182
150020;202002;14411;43460;13340;42067;1419;3760;10941;35562;12360;39322
150030;202002;8829;33190;8032;32212;462;2040;6984;28199;7446;30239
150034;202002;4124;10241;3403;9349;227;571;2835;7957;3062;8528
150040;202002;16302;42392;14331;40222;1234;1940;12030;36614;13264;38554
150050;202002;6927;24408;6326;23610;128;582;5811;21919;5939;22501
150060;202002;21600;58872;17302;52448;2770;8567;11015;34152;13785;42719
150070;202002;6684;25105;5872;24130;222;1114;5254;21778;5476;22892
150080;202002;93279;208471;77891;187601;18839;49653;22835;67360;41674;117013
150085;202002;7543;22042;6846;21206;118;382;6431;20063;6549;20445
150090;202002;9755;36504;9194;35401;673;2674;7420;28759;8093;31433
150095;202002;5576;16501;4865;15606;261;608;4128;13792;4389;14400
150100;202002;2826;10018;2512;9487;193;659;1971;7590;2164;8249
150110;202002;4400;18156;4093;17802;190;888;3761;16465;3951;17353
150120;202002;7982;25122;7585;24644;248;657;6775;22652;7023;23309
150125;202002;721;1961;539;1718;101;381;315;981;416;1362
150130;202002;22201;64484;19254;60075;3281;9148;12688;41906;15969;51054
150140;202002;246561;573665;207840;520258;31037;75502;121613;317104;152650;392606
150145;202002;4240;13103;3598;12111;907;2784;1987;7384;2894;10168
150150;202002;16042;41448;14015;38862;544;1654;11714;32488;12258;34142
150157;202002;3460;9535;2796;8671;288;909;1980;6406;2268;7315
150160;202002;2998;8919;2793;8619;543;1585;1740;5604;2283;7189
150170;202002;24383;80079;21303;74855;3899;12873;13119;49071;17018;61944
150172;202002;4774;13184;3821;11876;257;734;2923;9333;3180;10067
150175;202002;1602;5078;1343;4571;240;860;770;2644;1010;3504
150178;202002;10258;27981;8521;25949;208;547;7632;23572;7840;24119
150180;202002;22287;79191;20140;76717;1059;3602;17721;69010;18780;72612
150190;202002;6670;22638;6205;22045;260;1197;5482;19370;5742;20567
150195;202002;5110;16554;4864;16172;70;389;4522;14878;4592;15267
150200;202002;5846;17108;5349;16561;64;173;5060;15786;5124;15959
150210;202002;26100;90707;24351;88360;1748;6328;20073;74951;21821;81279
150215;202002;7503;21314;6455;19804;1175;3513;3832;12299;5007;15812
150220;202002;12157;34503;10604;32331;1064;3142;7395;22987;8459;26129
150230;202002;12115;34763;10653;32827;1126;3105;7421;23848;8547;26953
150240;202002;31532;87926;26106;78719;7246;22257;9007;27643;16253;49900
150250;202002;4183;16079;3911;15760;606;2363;2996;12418;3602;14781
150260;202002;2723;8947;2473;8562;161;545;1969;6912;2130;7457
150270;202002;8618;24895;6072;20437;1972;6941;1678;5993;3650;12934
150275;202002;6809;21830;6225;21026;230;897;5422;18238;5652;19135
150276;202002;2273;6054;1935;5652;248;642;1337;4312;1585;4954
150277;202002;5197;13658;4205;12503;319;856;3241;10282;3560;11138
150280;202002;6793;27539;6556;27158;476;1959;5564;23305;6040;25264
150285;202002;3269;11481;2869;10847;238;921;2104;8098;2342;9019
150290;202002;10449;28664;9459;27602;288;625;8566;25604;8854;26229
150293;202002;9156;22751;6964;19875;926;2670;4283;12875;5209;15545
150295;202002;7562;20535;5571;17868;1830;6282;1934;7074;3764;13356
150300;202002;2345;7054;2115;6760;36;129;1930;6199;1966;6328
150304;202002;4005;12005;3302;10916;592;1848;2004;6953;2596;8801
150307;202002;6148;19789;5664;18982;348;1151;4616;15640;4964;16791
150309;202002;6204;18794;4997;16708;897;2946;2792;9767;3689;12713
150310;202002;7295;29013;6950;28602;208;1189;6213;25772;6421;26961
150320;202002;9323;25544;8517;24385;400;1242;6642;18941;7042;20183
150330;202002;13945;44910;12825;43186;1256;3938;9716;33654;10972;37592
150340;202002;2515;7356;2225;6921;327;948;1527;4902;1854;5850
150345;202002;8078;23783;7257;22683;436;1426;6185;19409;6621;20835
150350;202002;8924;22482;8216;21581;688;1282;6821;18464;7509;19746
150360;202002;23802;65944;19029;59924;1952;5104;13534;45333;15486;50437
150370;202002;10595;32373;8710;29855;981;2866;6387;23501;7368;26367
150375;202002;3486;14186;3132;13673;226;1098;2655;11689;2881;12787
150380;202002;11019;28284;9037;25688;124;470;8000;22747;8124;23217
150390;202002;7895;31612;7093;30353;1066;3984;5068;22956;6134;26940
150400;202002;6419;23283;6160;22798;275;1057;5375;19967;5650;21024
150405;202002;9233;24361;8047;22975;485;1138;6538;19198;7023;20336
150410;202002;1912;6123;1626;5633;211;660;1049;3731;1260;4391
150420;202002;40092;111159;30823;97529;8647;28635;10587;39004;19234;67639
150430;202002;8408;24656;7656;23693;846;1963;5998;19410;6844;21373
150440;202002;5623;18151;5124;17435;753;2274;3616;12866;4369;15140
150442;202002;25772;61780;21218;56106;2249;5857;14697;39665;16946;45522
150445;202002;6280;19483;5524;18338;195;689;4746;15795;4941;16484
150450;202002;5067;21779;4693;21274;362;1800;4036;18287;4398;20087
150460;202002;8362;27603;7649;26708;247;995;6563;23703;6810;24698
150470;202002;21754;56283;19385;53595;359;1002;18247;50486;18606;51488
150475;202002;4854;15383;4197;14383;157;610;3512;12159;3669;12769
150480;202002;13583;44200;12175;42099;2212;6945;8072;29803;10284;36748
150490;202002;8319;28902;7642;28068;273;1165;6800;25106;7073;26271
150495;202002;5239;18099;5007;17775;105;542;4560;16075;4665;16617
150497;202002;2860;9068;2306;8100;511;1819;1204;4564;1715;6383
150500;202002;3256;8404;2894;7901;237;563;2270;6203;2507;6766
150503;202002;4710;12122;3243;10214;965;3268;1023;3719;1988;6987
150506;202002;10147;30266;8503;28036;1806;5218;5305;19409;7111;24627
150510;202002;9779;35613;8465;33185;1208;4476;5649;23230;6857;27706
150520;202002;6979;27278;6670;26897;228;1374;5990;24050;6218;25424
150530;202002;12396;42329;10730;39945;1539;4646;7703;30590;9242;35236
150540;202002;4926;13512;4187;12410;229;621;3500;10434;3729;11055
150543;202002;7310;19549;6017;17931;497;1512;4607;14336;5104;15848
150548;202002;10053;31625;9067;30295;254;1040;8044;26903;8298;27943
150549;202002;1980;5944;1704;5572;39;173;1468;4805;1507;4978
150550;202002;19659;58055;16397;52709;3922;12839;7277;25023;11199;37862
150553;202002;26541;77660;21164;68295;6336;20872;7553;26224;13889;47096
150555;202002;1858;4961;1452;4345;130;306;1008;3152;1138;3458
150560;202002;1827;5590;1618;5185;261;801;972;3238;1233;4039
150563;202002;2403;7384;2023;6726;432;1515;1116;3737;1548;5252
150565;202002;4280;13779;3802;13043;107;468;3177;10970;3284;11438
150570;202002;6269;20035;5846;19444;265;1003;5073;16851;5338;17854
150580;202002;10488;41258;9049;39657;613;3141;7367;33341;7980;36482
150590;202002;8039;27781;6902;26426;181;1062;6255;23861;6436;24923
150600;202002;9616;31968;8918;31129;213;829;8260;29008;8473;29837
150610;202002;2838;8448;2540;7963;94;382;2136;6631;2230;7013
150611;202002;3199;9035;2836;8524;91;349;2508;7487;2599;7836
150613;202002;13242;36593;9994;31031;1843;6092;4981;15436;6824;21528
150616;202002;3345;9198;2430;7695;590;1948;1037;3251;1627;5199
150618;202002;6741;19600;5428;17600;491;1539;3524;12038;4015;13577
150619;202002;6266;17719;5213;16222;170;608;4431;13879;4601;14487
150620;202002;6750;22361;5811;20787;671;2288;3989;14701;4660;16989
150630;202002;6200;16804;5668;16140;425;1116;4709;13580;5134;14696
150635;202002;4602;12728;3861;11565;534;1506;2504;7761;3038;9267
150640;202002;2247;6610;2045;6364;35;104;1900;5994;1935;6098
150650;202002;11520;32106;10040;29742;2984;8321;4436;14366;7420;22687
150655;202002;5792;16549;5242;15755;197;605;4545;13638;4742;14243
150658;202002;4260;12237;3397;10933;516;1758;2067;7004;2583;8762
150660;202002;5701;16342;5080;15461;459;1320;3585;11203;4044;12523
150670;202002;8317;19306;6503;17263;625;1378;5121;14314;5746;15692
150680;202002;67327;197908;51718;173191;12389;40628;23357;88305;35746;128933
150690;202002;2902;7602;2508;7139;93;212;2239;6522;2332;6734
150700;202002;6119;18123;5460;17276;355;944;4351;14143;4706;15087
150710;202002;3775;12597;3423;12036;268;939;2617;9380;2885;10319
150715;202002;4940;14257;4049;12905;300;924;3191;10319;3491;11243
150720;202002;6827;24404;6332;23630;426;1756;5283;19867;5709;21623
150730;202002;11897;36323;10343;34119;1183;4047;7657;25956;8840;30003
150740;202002;3947;11090;3494;10388;307;763;2649;8049;2956;8812
150745;202002;5043;14356;4068;12912;802;2704;2598;8331;3400;11035
150746;202002;1622;4992;1483;4793;78;254;1216;3947;1294;4201
150747;202002;4832;15478;4249;14520;683;2094;2885;10296;3568;12390
150750;202002;3647;11440;3068;10556;216;802;2333;8268;2549;9070
150760;202002;11902;35020;10802;33505;1484;4235;7674;24552;9158;28787
150770;202002;6288;22692;5924;22278;184;575;5414;20963;5598;21538
150775;202002;907;2555;702;2278;131;472;378;1229;509;1701
150780;202002;4487;13570;3991;12991;149;442;3588;11956;3737;12398
150790;202002;5593;15971;4813;15138;216;508;3910;13538;4126;14046
150795;202002;13729;42720;12030;40057;3005;9449;6837;24285;9842;33734
150796;202002;3788;9324;3299;8758;173;430;2806;7550;2979;7980
150797;202002;3925;12218;3388;11450;130;348;2910;9992;3040;10340
150800;202002;13298;41769;12014;40081;1422;4464;9156;31489;10578;35953
150803;202002;6978;22575;6549;21918;347;1135;5601;18871;5948;20006
150805;202002;3433;10605;2904;9832;201;695;2284;7853;2485;8548
150808;202002;5909;16781;4319;14166;1687;6112;611;2259;2298;8371
150810;202002;20542;54114;15542;48126;3284;10462;7908;26869;11192;37331
150812;202002;5283;14935;4640;13883;407;1276;3446;10143;3853;11419
150815;202002;9366;27756;7824;25927;609;2043;6478;21748;7087;23791
150820;202002;11863;32692;10013;30374;1070;2773;7646;24276;8716;27049
150830;202002;11691;43091;10864;42086;406;1814;9477;37572;9883;39386
150835;202002;2322;7704;1982;7107;344;1200;1145;4157;1489;5357
150840;202002;7348;20926;5824;18446;984;3316;3211;10101;4195;13417
160005;202002;1180;3279;1046;3109;60;214;880;2617;940;2831
160010;202002;2440;6453;2278;6275;21;114;2209;6008;2230;6122
160015;202002;2729;8025;2432;7653;71;236;2235;7063;2306;7299
160020;202002;2068;6682;1813;6364;156;531;1432;5177;1588;5708
160021;202002;1061;4195;974;4090;66;383;799;3321;865;3704
160023;202002;1244;4421;1094;4166;112;387;769;3108;881;3495
160025;202002;1857;5627;1763;5519;12;38;1717;5395;1729;5433
160027;202002;8995;24981;8046;23775;601;1675;6523;19677;7124;21352
160030;202002;69555;198407;56069;180449;11857;35850;30769;108955;42626;144805
160040;202002;5638;19412;5122;18757;72;339;4787;17668;4859;18007
160050;202002;4729;14458;3693;13053;1391;4693;1306;5725;2697;10418
160053;202002;3702;11601;3368;11194;232;683;2804;9617;3036;10300
160055;202002;910;2645;874;2604;31;93;808;2413;839;2506
160060;202002;24362;65299;19749;60052;900;2934;15742;50083;16642;53017
160070;202002;2734;10383;2448;9945;199;803;1919;8050;2118;8853
160080;202002;3302;10586;2961;10202;33;176;2761;9586;2794;9762
170025;202002;597;1570;427;1320;68;220;221;701;289;921
170030;202002;1210;3685;922;3168;144;483;456;1614;600;2097
170035;202002;1429;3747;1043;3125;91;294;634;1926;725;2220
170040;202002;1845;5272;1452;4719;90;345;896;3041;986;3386
170070;202002;1775;4203;1250;3533;70;233;754;2202;824;2435
170100;202002;2388;6908;1980;6237;189;551;1264;4090;1453;4641
170105;202002;708;2079;479;1587;122;363;165;559;287;922
170110;202002;897;2787;680;2367;126;455;293;1012;419;1467
170130;202002;1296;3907;923;3190;173;652;446;1570;619;2222
170190;202002;1295;3741;909;3123;315;1128;171;754;486;1882
170200;202002;1894;4645;1174;3449;206;635;426;1259;632;1894
170210;202002;24400;66436;18397;56475;6422;21436;2208;7866;8630;29302
170215;202002;1275;3429;1017;3091;37;153;829;2497;866;2650
170220;202002;5696;17792;4763;16118;1286;4176;1975;7281;3261;11457
170230;202002;1197;3596;890;3000;264;907;160;599;424;1506
170240;202002;2554;7234;1969;6291;145;556;1378;4275;1523;4831
170255;202002;3883;11313;2738;9204;492;1691;1239;4274;1731;5965
170270;202002;952;2304;629;1848;37;106;375;1098;412;1204
170290;202002;2808;8467;2402;7946;107;378;1903;6460;2010;6838
170300;202002;1943;5295;1561;4736;180;545;1044;3219;1224;3764
170305;202002;601;1656;495;1474;62;219;261;769;323;988
170307;202002;897;3110;716;2757;98;410;400;1558;498;1968
170310;202002;1544;3870;1045;3081;161;526;504;1476;665;2002
170320;202002;983;2578;736;2175;61;195;482;1452;543;1647
170330;202002;891;2747;805;2618;40;188;673;2128;713;2316
170360;202002;484;1311;331;1052;25;87;216;645;241;732
170370;202002;1250;3399;895;2800;285;859;219;805;504;1664
170380;202002;1723;4999;1271;4303;99;391;733;2558;832;2949
170382;202002;516;1553;422;1390;30;126;307;977;337;1103
170384;202002;1521;5442;1237;4887;248;1025;636;2557;884;3582
170386;202002;894;2464;557;1804;76;289;198;609;274;898
170388;202002;598;1704;416;1369;61;225;187;626;248;851
170389;202002;1014;3179;839;2888;44;164;621;2189;665;2353
170390;202002;1666;3878;1241;3357;47;109;1018;2846;1065;2955
170410;202002;551;1639;389;1337;32;148;237;786;269;934
170460;202002;350;926;278;807;40;115;174;522;214;637
170510;202002;876;2595;635;2150;48;201;401;1307;449;1508
170550;202002;6447;17276;4683;14407;1201;3973;1096;3651;2297;7624
170555;202002;1353;3698;1045;3228;74;240;514;1651;588;1891
170560;202002;1004;2846;745;2481;59;231;476;1679;535;1910
170600;202002;1275;3459;1030;3114;216;514;591;1939;807;2453
170610;202002;1633;4376;1175;3693;79;265;739;2312;818;2577
170625;202002;420;1163;252;800;40;123;80;249;120;372
170650;202002;1210;3625;940;3180;148;516;524;1845;672;2361
170700;202002;3279;9710;2438;8089;489;1645;1086;3707;1575;5352
170710;202002;1475;3926;1120;3359;154;494;694;2091;848;2585
170720;202002;1725;4391;1340;3815;99;235;886;2656;985;2891
170730;202002;1011;2795;745;2358;137;383;371;1263;508;1646
170740;202002;2008;6779;1726;6239;168;689;1246;4468;1414;5157
170755;202002;876;2442;597;1961;53;195;295;940;348;1135
170765;202002;1115;2911;778;2369;157;476;341;1096;498;1572
170770;202002;1792;5249;1454;4725;163;504;970;3246;1133;3750
170820;202002;3278;9900;2567;8626;500;1743;1224;4203;1724;5946
170825;202002;923;2227;734;1977;78;208;532;1431;610;1639
170830;202002;1383;3725;1140;3348;108;315;813;2410;921;2725
170900;202002;2605;8356;2179;7741;179;655;1730;6224;1909;6879
170930;202002;3599;10094;2737;8484;632;2061;916;2831;1548;4892
170950;202002;10853;30121;7389;23841;2106;7718;877;3062;2983;10780
170980;202002;427;1152;344;1024;14;63;255;721;269;784
171050;202002;1559;4976;1345;4611;43;222;1126;3829;1169;4051
171070;202002;1313;3802;1116;3512;298;951;477;1748;775;2699
171090;202002;1015;2540;808;2244;77;217;543;1491;620;1708
171110;202002;562;1516;391;1199;60;191;188;522;248;713
171150;202002;1088;2703;649;1946;66;229;384;1138;450;1367
171180;202002;772;2145;508;1636;89;266;210;674;299;940
171190;202002;1703;5758;1464;5342;237;940;861;3258;1098;4198
171195;202002;791;2550;626;2243;86;366;386;1356;472;1722
171200;202002;511;1455;384;1231;72;247;176;561;248;808
171215;202002;327;944;275;854;36;125;187;565;223;690
171240;202002;742;2489;604;2216;36;179;406;1459;442;1638
171245;202002;635;1930;488;1613;48;182;294;932;342;1114
171250;202002;991;2610;711;2199;133;437;332;1039;465;1476
171270;202002;439;1594;336;1376;66;278;142;630;208;908
171280;202002;854;2604;665;2256;63;214;381;1353;444;1567
171320;202002;3891;10998;2977;9422;626;1949;1118;3725;1744;5674
171330;202002;2663;7353;2037;6266;390;1175;975;3122;1365;4297
171360;202002;1379;4028;1085;3593;82;304;782;2640;864;2944
171370;202002;664;1702;509;1478;51;142;340;999;391;1141
171380;202002;1411;4092;1170;3747;99;303;847;2805;946;3108
171395;202002;936;2618;644;2069;61;235;384;1190;445;1425
171420;202002;1898;5663;1360;4579;220;817;620;2092;840;2909
171430;202002;1004;2995;829;2666;57;205;568;1758;625;1963
171488;202002;2232;6738;1746;5920;263;900;912;3191;1175;4091
171500;202002;979;2438;737;2069;37;106;565;1590;602;1696
171510;202002;768;2569;664;2366;44;198;467;1649;511;1847
171515;202002;442;1143;310;933;27;93;194;555;221;648
171525;202002;678;1974;521;1718;28;115;307;961;335;1076
171550;202002;330;961;244;821;30;116;140;456;170;572
171570;202002;1093;3384;909;3046;123;418;547;1877;670;2295
171575;202002;1797;4797;1138;3609;120;408;510;1610;630;2018
171610;202002;5660;15813;4202;13328;886;3153;1184;4007;2070;7160
171620;202002;2572;7321;2164;6730;108;412;1754;5463;1862;5875
171630;202002;934;2501;737;2232;107;320;498;1551;605;1871
171650;202002;2012;5766;1541;4965;396;1387;452;1584;848;2971
171660;202002;2294;5867;1552;4626;237;654;798;2426;1035;3080
171665;202002;1244;3506;961;3042;156;564;463;1488;619;2052
171670;202002;1853;4966;1411;4240;199;664;775;2326;974;2990
171700;202002;1202;3463;871;2860;103;338;476;1593;579;1931
171720;202002;781;2015;605;1740;51;171;438;1231;489;1402
171750;202002;1260;3551;859;2809;230;776;103;438;333;1214
171780;202002;1215;3107;869;2602;92;300;571;1675;663;1975
171790;202002;1364;4537;1111;4026;215;816;517;1917;732;2733
171800;202002;700;1948;519;1671;62;257;295;939;357;1196
171820;202002;10804;30522;7900;25499;1981;6610;2463;8537;4444;15147
171830;202002;1464;4799;1223;4364;109;490;783;2772;892;3262
171840;202002;750;2013;577;1734;23;71;390;1161;413;1232
171845;202002;574;1473;416;1240;50;176;256;754;306;930
171850;202002;836;2863;716;2580;65;320;513;1776;578;2096
171855;202002;1013;3126;857;2840;69;235;530;1720;599;1955
171865;202002;367;1153;296;1031;50;197;145;476;195;673
171870;202002;787;2230;557;1805;65;231;289;937;354;1168
171875;202002;1256;3717;999;3294;42;178;753;2476;795;2654
171880;202002;1128;3489;985;3297;36;123;795;2710;831;2833
171884;202002;804;2309;592;1946;112;423;221;758;333;1181
171886;202002;1353;3757;959;3104;281;1029;194;635;475;1664
171888;202002;717;2019;489;1596;31;121;309;981;340;1102
171889;202002;373;1162;299;1017;71;263;120;406;191;669
171890;202002;1143;3200;834;2701;177;549;464;1546;641;2095
171900;202002;537;1855;382;1463;77;289;156;619;233;908
172000;202002;550;1664;461;1493;45;155;264;831;309;986
172010;202002;981;3418;832;3109;73;312;510;1872;583;2184
172015;202002;367;1301;271;1107;68;285;109;458;177;743
172020;202002;2575;7452;2262;7041;155;538;1693;5442;1848;5980
172025;202002;694;1940;511;1636;34;125;365;1170;399;1295
172030;202002;1210;3600;1029;3314;50;194;802;2575;852;2769
172049;202002;1272;3092;836;2514;169;473;452;1443;621;1916
172065;202002;1426;3560;1100;3156;100;217;869;2678;969;2895
172080;202002;2284;6781;1835;5998;104;381;1218;3968;1322;4349
172085;202002;461;1262;294;892;48;143;112;318;160;461
172090;202002;3885;9926;2991;8747;124;413;2280;6708;2404;7121
172093;202002;453;1354;322;1128;22;110;185;620;207;730
172097;202002;624;1659;443;1348;59;181;200;625;259;806
172100;202002;47206;117622;32688;94466;5910;18908;11538;34312;17448;53220
172110;202002;1563;5749;1344;5396;126;521;987;4170;1113;4691
172120;202002;4834;14357;3771;12648;498;1761;2151;7421;2649;9182
172125;202002;317;861;234;726;20;56;130;402;150;458
172130;202002;613;1520;483;1311;25;89;337;845;362;934
172208;202002;2467;6157;1977;5530;179;442;1429;4079;1608;4521
172210;202002;2623;6743;1999;5945;330;1066;1139;3504;1469;4570
210005;202002;18383;53017;13981;45727;4101;13904;5349;18325;9450;32229
210010;202002;1915;5921;1728;5694;71;308;1504;4970;1575;5278
210015;202002;3278;9848;2929;9394;106;305;2583;8373;2689;8678
210020;202002;7294;17274;6244;16070;74;225;5800;14972;5874;15197
210030;202002;4679;15479;4322;14941;194;873;3745;12920;3939;13793
210040;202002;1757;4245;1591;4040;24;42;1504;3858;1528;3900
210043;202002;6049;17462;5108;16177;439;1314;3906;12667;4345;13981
210047;202002;6521;20417;5311;18792;128;656;4622;16343;4750;16999
210050;202002;2169;7443;1697;6569;154;705;1195;4589;1349;5294
210055;202002;1829;5944;1652;5673;64;263;1404;4819;1468;5082
210060;202002;7193;26658;6368;25181;703;2901;4545;18463;5248;21364
210070;202002;7073;20235;6628;19660;37;169;6288;18613;6325;18782
210080;202002;4220;14533;4015;14310;47;288;3645;13060;3692;13348
210083;202002;5485;16059;4536;15056;41;206;4305;14337;4346;14543
210087;202002;3013;8247;2607;7725;94;220;2271;6886;2365;7106
210090;202002;9129;28782;8498;27677;505;1366;7226;23771;7731;25137
210095;202002;6243;20279;5720;19630;209;894;4930;17306;5139;18200
210100;202002;6740;20636;6032;19547;310;1091;4931;16027;5241;17118
210110;202002;2952;9870;2727;9604;52;326;2502;8753;2554;9079
210120;202002;22440;62317;18544;57222;1857;4765;12716;41553;14573;46318
210125;202002;4376;11731;3829;11091;744;1687;2745;8549;3489;10236
210130;202002;4342;11464;3594;10536;159;355;3063;9092;3222;9447
210135;202002;1438;4335;1234;4014;62;184;1006;3335;1068;3519
210140;202002;18173;48255;13904;42755;2631;7814;7845;25569;10476;33383
210150;202002;4270;10373;3801;9727;127;353;3322;8409;3449;8762
210160;202002;16314;47961;14090;45165;1269;4316;10019;33220;11288;37536
210170;202002;14845;46449;13823;45137;728;2154;12188;40147;12916;42301
210173;202002;2246;8644;2094;8369;70;442;1846;7363;1916;7805
210177;202002;3415;9352;2987;8839;110;197;2667;8188;2777;8385
210180;202002;1419;3856;1256;3660;24;64;1147;3355;1171;3419
210190;202002;5206;14304;4443;13266;78;371;3844;11324;3922;11695
210193;202002;1269;3731;1125;3511;31;141;885;2799;916;2940
210197;202002;2048;6464;1882;6240;135;457;1549;5202;1684;5659
210200;202002;7572;24483;6720;23057;408;1573;5405;18516;5813;20089
210203;202002;6884;20466;5900;19153;389;1322;4852;16022;5241;17344
210207;202002;3779;9428;2927;8519;129;304;2456;7333;2585;7637
210210;202002;8027;26192;7346;25282;132;805;6646;22688;6778;23493
210215;202002;2414;7702;2059;7169;52;281;1829;6379;1881;6660
210220;202002;6060;21046;5744;20568;180;1175;5077;17781;5257;18956
210230;202002;5044;15443;4566;14729;383;1002;3826;12648;4209;13650
210232;202002;11036;34979;9062;31991;1529;5404;5706;21444;7235;26848
210235;202002;3312;9990;2913;9440;64;276;2602;8463;2666;8739
210237;202002;2708;9045;2336;8610;31;192;2166;7982;2197;8174
210240;202002;2550;8148;2351;7796;79;310;2031;6671;2110;6981
210250;202002;5558;17082;5060;16473;74;436;4568;14824;4642;15260
210255;202002;2464;7591;2086;6914;277;945;1336;4422;1613;5367
210260;202002;5434;16325;4814;15420;207;762;4182;13392;4389;14154
210270;202002;4719;13232;4208;12612;103;471;3763;11169;3866;11640
210275;202002;3487;8886;3086;8407;55;122;2810;7755;2865;7877
210280;202002;5478;15735;4388;14048;263;1069;3187;10042;3450;11111
210290;202002;7151;19352;6401;18414;115;372;5943;17089;6058;17461
210300;202002;32999;89374;26817;80603;1823;5778;19329;60090;21152;65868
210310;202002;3033;7832;2682;7318;124;281;2334;6414;2458;6695
210312;202002;2608;6768;2305;6439;32;141;2157;5966;2189;6107
210315;202002;2892;8205;2469;7727;52;151;2264;7218;2316;7369
210317;202002;4007;12862;3629;12419;109;586;3259;11072;3368;11658
210320;202002;18513;56856;16942;54789;402;2007;15050;48280;15452;50287
210325;202002;3550;10188;3049;9531;88;269;2714;8648;2802;8917
210330;202002;24148;68588;19519;62614;5934;17127;9289;34521;15223;51648
210340;202002;9870;29244;8760;27731;686;2168;6753;21956;7439;24124
210350;202002;9103;26528;7978;25156;147;524;7140;22620;7287;23144
210355;202002;4226;14308;3716;13517;97;477;3178;11628;3275;12105
210360;202002;13318;42124;11887;40025;601;2740;9138;30291;9739;33031
210370;202002;10614;24134;8266;21651;231;411;7594;20352;7825;20763
210375;202002;3169;8480;2423;7483;646;2013;1109;3802;1755;5815
210380;202002;5363;13847;4637;13009;198;479;3988;11279;4186;11758
210390;202002;2517;9016;2328;8682;110;556;1973;7299;2083;7855
210400;202002;4370;13564;3886;12966;121;393;3490;11806;3611;12199
210405;202002;6778;18421;5458;16553;1031;2899;3094;9968;4125;12867
210407;202002;1941;6482;1626;5907;76;350;1308;4693;1384;5043
210408;202002;2478;9311;2322;9080;141;688;1909;7474;2050;8162
210409;202002;3742;13029;3426;12588;105;604;2848;10516;2953;11120
210410;202002;3372;10406;2863;9567;145;589;2190;7247;2335;7836
210420;202002;3802;12216;3441;11595;203;618;2904;9898;3107;10516
210430;202002;2223;6540;1986;6241;71;199;1759;5596;1830;5795
210440;202002;4312;11682;3769;10996;61;225;3478;10095;3539;10320
210450;202002;2404;7117;2059;6612;83;296;1706;5449;1789;5745
210455;202002;4152;11037;3158;9772;928;2905;1476;4822;2404;7727
210460;202002;3622;10390;3069;9693;63;279;2743;8593;2806;8872
210462;202002;1616;4943;1376;4551;34;141;1120;3729;1154;3870
210465;202002;2626;7731;2296;7286;50;212;2006;6347;2056;6559
210467;202002;5784;18702;5055;17745;303;1212;4199;14898;4502;16110
210470;202002;1997;5298;1417;4470;83;194;1088;3578;1171;3772
210480;202002;16177;47602;13393;44171;1149;3447;9858;34993;11007;38440
210490;202002;3647;9298;2950;8325;62;185;2571;7273;2633;7458
210500;202002;6147;23965;5656;23124;339;1742;4698;19051;5037;20793
210510;202002;5896;19638;5163;18848;126;561;4628;17158;4754;17719
210515;202002;3639;10820;3189;10313;105;397;2777;9096;2882;9493
210520;202002;2493;7180;2240;6862;68;243;1990;6052;2058;6295
210530;202002;51006;124410;39426;107549;6514;22060;10795;37388;17309;59448
210535;202002;3018;10396;2819;10084;116;465;2384;8601;2500;9066
210540;202002;14354;41694;11971;38361;1385;4141;8445;28306;9830;32447
210542;202002;6376;14934;5138;13584;310;512;4272;12063;4582;12575
210545;202002;2168;6813;2046;6612;41;186;1813;5785;1854;5971
210547;202002;3464;12575;3050;11758;301;1158;2249;8882;2550;10040
210550;202002;6068;18370;4811;16401;330;1291;3567;12463;3897;13754
210560;202002;3477;10695;3104;10095;119;388;2610;8434;2729;8822
210565;202002;1454;4813;1208;4448;58;308;960;3555;1018;3863
210570;202002;10260;28122;9136;26758;276;768;8154;24298;8430;25066
210580;202002;2932;7902;2430;7291;134;272;1961;6167;2095;6439
210590;202002;4233;12757;3667;12033;70;383;3274;10679;3344;11062
210592;202002;2614;7774;2409;7444;26;127;2140;6549;2166;6676
210594;202002;2475;6685;1869;5788;78;223;1400;4441;1478;4664
210596;202002;2463;8837;2210;8322;102;456;1804;6823;1906;7279
210598;202002;1790;5280;1649;5069;28;124;1493;4544;1521;4668
210600;202002;2984;8026;2411;7225;89;208;1972;6019;2061;6227
210610;202002;2641;7521;2271;7061;53;265;1930;5985;1983;6250
210620;202002;2668;7333;2228;6807;52;154;2054;6363;2106;6517
210630;202002;2961;10047;2711;9638;111;576;2259;7917;2370;8493
210632;202002;4350;14156;3862;13449;203;950;3084;10620;3287;11570
210635;202002;1718;6151;1618;5971;109;393;1343;5053;1452;5446
210637;202002;2369;7931;2072;7505;146;641;1562;5711;1708;6352
210640;202002;4539;16392;4263;16047;73;380;3851;14515;3924;14895
210650;202002;7303;20976;6650;20164;59;272;6193;18811;6252;19083
210660;202002;7991;23920;7079;22469;242;986;6177;19354;6419;20340
210663;202002;2517;7458;2319;7225;126;316;1994;6377;2120;6693
210667;202002;1863;6188;1730;5996;39;160;1571;5503;1610;5663
210670;202002;4368;14968;3992;14384;110;568;3498;12520;3608;13088
210675;202002;4980;13574;4256;12632;191;464;3593;10927;3784;11391
210680;202002;4367;10928;3688;10104;113;193;3320;9301;3433;9494
210690;202002;7566;23292;6384;21984;238;1070;5676;19635;5914;20705
210700;202002;2704;7542;2151;6768;150;457;1598;5241;1748;5698
210710;202002;4834;15289;4251;14462;107;592;3761;12642;3868;13234
210720;202002;2880;9575;2599;9227;53;318;2350;8282;2403;8600
210725;202002;1272;4358;1109;4115;41;181;816;3131;857;3312
210730;202002;1163;3094;978;2832;50;130;819;2384;869;2514
210735;202002;4565;13598;3894;12700;185;586;3356;11180;3541;11766
210740;202002;5163;14032;4507;13296;103;350;3812;11248;3915;11598
210745;202002;4332;11939;4022;11543;107;332;3691;10561;3798;10893
210750;202002;22681;57996;19640;54238;1585;4132;13884;40417;15469;44549
210760;202002;5853;15553;4955;14612;29;65;4713;14020;4742;14085
210770;202002;6028;15672;5212;14735;54;242;4918;13833;4972;14075
210780;202002;7177;22912;6305;21455;520;1600;4990;17306;5510;18906
210790;202002;4149;13223;3733;12685;177;454;3115;11087;3292;11541
210800;202002;4830;12888;4146;11985;54;226;3764;10762;3818;10988
210805;202002;3859;14202;3686;13948;104;578;3318;12466;3422;13044
210810;202002;4786;14028;4379;13507;280;593;3689;11753;3969;12346
210820;202002;6819;19461;5651;17643;662;2124;3415;10939;4077;13063
210825;202002;6634;20693;6005;19865;241;817;5209;17455;5450;18272
210830;202002;7556;21442;6904;20651;349;802;5999;18404;6348;19206
210840;202002;3150;8425;2825;7994;58;211;2522;7033;2580;7244
210845;202002;6384;17504;5747;16814;18;80;5555;16303;5573;16383
210850;202002;5842;20015;4882;18589;242;1225;3857;14720;4099;15945
210860;202002;20580;53529;17155;49237;706;1803;13950;42066;14656;43869
210870;202002;7204;18928;5716;17233;209;591;5008;15204;5217;15795
210880;202002;4211;13042;3812;12582;176;686;3198;10532;3374;11218
210890;202002;3812;11324;3428;10876;208;552;2821;9244;3029;9796
210900;202002;4404;12980;3339;10956;1305;4594;553;2037;1858;6631
210905;202002;1968;5479;1640;5061;46;81;1494;4725;1540;4806
210910;202002;7072;21426;5876;19504;815;2739;3842;12903;4657;15642
210920;202002;3190;10549;2764;9987;71;410;2492;8926;2563;9336
210923;202002;1474;4482;1271;4150;68;231;947;3133;1015;3364
210927;202002;5181;16476;4570;15757;201;728;3834;13466;4035;14194
210930;202002;2448;8531;2147;7946;176;716;1592;5883;1768;6599
210940;202002;4028;11450;3745;11117;109;447;3439;10095;3548;10542
210945;202002;6293;18349;5640;17588;221;658;4776;15219;4997;15877
210950;202002;5056;14227;3912;12649;590;1511;2598;9140;3188;10651
210955;202002;1534;4893;1317;4519;125;447;940;3282;1065;3729
210960;202002;8882;26592;7632;24715;1265;3830;4917;16678;6182;20508
210970;202002;1298;4009;1039;3573;59;234;805;2698;864;2932
210975;202002;1659;5285;1481;5002;65;239;1192;4042;1257;4281
210980;202002;9933;23062;8679;21780;75;171;8251;20768;8326;20939
210990;202002;15614;44525;12344;40213;684;2486;9350;31157;10034;33643
211000;202002;14191;41999;11999;39334;645;2316;9702;32931;10347;35247
211003;202002;5484;16591;4644;15586;128;514;4021;13796;4149;14310
211010;202002;6355;23089;5704;22321;91;466;5218;20670;5309;21136
211020;202002;8029;23494;6977;22293;202;853;5971;19507;6173;20360
211023;202002;1912;6307;1791;6148;82;318;1533;5242;1615;5560
211027;202002;3050;9771;2888;9513;194;539;2495;8300;2689;8839
211030;202002;3829;10607;3424;10113;229;516;2817;8577;3046;9093
211040;202002;4521;16445;4184;15845;110;681;3750;14055;3860;14736
211050;202002;8997;23522;8186;22477;89;302;7545;20705;7634;21007
211060;202002;6825;20848;6250;20067;116;488;5754;18478;5870;18966
211065;202002;2150;6030;1789;5584;80;212;1488;4802;1568;5014
211070;202002;7595;24268;6442;22523;489;1740;5020;17728;5509;19468
211080;202002;1264;3528;1015;3131;37;194;786;2292;823;2486
211085;202002;1989;5710;1689;5307;81;196;1473;4767;1554;4963
211090;202002;3095;8631;2798;8288;36;163;2588;7624;2624;7787
211100;202002;6648;16987;6148;16388;52;168;5673;15210;5725;15378
211102;202002;2988;10340;2743;9986;121;582;2414;8695;2535;9277
211105;202002;2323;7393;1925;6670;166;591;1392;4790;1558;5381
211107;202002;4502;14456;3863;13517;130;596;3190;11435;3320;12031
211110;202002;5750;15899;4437;13907;357;1053;3289;10488;3646;11541
211120;202002;43102;106410;35663;97778;4765;12013;23235;68058;28000;80071
211125;202002;2024;6061;1712;5586;33;145;1465;4785;1498;4930
211130;202002;184630;438302;160280;406955;23187;57227;74721;217055;97908;274282
211140;202002;4877;14576;4264;13781;212;620;3616;11780;3828;12400
211150;202002;9137;25114;7711;23276;335;971;6524;19785;6859;20756
211153;202002;2399;7107;1961;6577;272;958;1304;4609;1576;5567
211157;202002;1076;3447;897;3123;33;173;670;2300;703;2473
211160;202002;3939;11211;3086;9977;144;536;2328;7440;2472;7976
211163;202002;1620;5200;1485;5011;21;110;1355;4595;1376;4705
211167;202002;1505;4838;1414;4695;29;129;1301;4293;1330;4422
211170;202002;6376;15783;5938;15289;52;168;5655;14510;5707;14678
211172;202002;2413;6659;2093;6192;102;312;1705;4929;1807;5241
211174;202002;2822;8205;2559;7913;42;215;2388;7343;2430;7558
211176;202002;4148;11959;3226;10610;149;646;2582;8447;2731;9093
211178;202002;4546;10742;3919;10059;33;155;3720;9467;3753;9622
211180;202002;3953;13123;3671;12714;204;768;3132;10890;3336;11658
211190;202002;3000;8907;2538;8235;35;204;2249;7205;2284;7409
211195;202002;1333;3835;1138;3535;47;116;974;3082;1021;3198
211200;202002;2055;5919;1647;5374;198;613;1162;3889;1360;4502
211210;202002;6168;19011;5593;18254;241;1016;4867;15729;5108;16745
211220;202002;36277;91924;29609;83730;2750;7308;22012;63975;24762;71283
211223;202002;5072;13449;4226;12337;358;1055;3207;9398;3565;10453
211227;202002;1726;5818;1569;5592;32;152;1393;5044;1425;5196
211230;202002;7275;21310;6363;19932;384;1047;5146;16459;5530;17506
211240;202002;8013;25628;7595;25092;138;753;7051;23041;7189;23794
211245;202002;6823;17414;6085;16651;81;207;5888;16139;5969;16346
211250;202002;12947;40735;11677;39050;607;2465;9699;32130;10306;34595
211260;202002;7819;25603;7013;24545;193;866;6324;22245;6517;23111
211270;202002;10366;33173;8897;31174;384;1760;7259;25594;7643;27354
211280;202002;12378;34463;11027;32765;910;2164;8863;27509;9773;29673
211285;202002;1697;5697;1491;5399;149;603;1032;3840;1181;4443
211290;202002;7332;22185;6627;21261;172;744;5725;18297;5897;19041
211300;202002;7751;22266;6890;21008;169;563;6034;18276;6203;18839
211400;202002;11086;31895;9022;29093;973;3149;6238;21035;7211;24184
220005;202002;1800;4783;1633;4560;37;145;1380;3781;1417;3926
220010;202002;1463;4205;1200;3733;29;117;937;2874;966;2991
220020;202002;3466;9786;2987;9089;140;507;2440;7362;2580;7869
220025;202002;2206;5028;1888;4556;23;60;1586;3709;1609;3769
220027;202002;1256;3189;1069;2944;18;60;912;2461;930;2521
220030;202002;3262;8279;3051;7995;72;226;2716;7026;2788;7252
220040;202002;6979;21217;6065;19467;1397;4115;3228;10894;4625;15009
220045;202002;1438;4438;1178;4006;32;174;962;3197;994;3371
220050;202002;4684;12744;3972;11804;57;282;3648;10701;3705;10983
220060;202002;2342;4962;1968;4536;24;58;1856;4252;1880;4310
220070;202002;2434;6150;2083;5647;70;146;1743;4744;1813;4890
220080;202002;708;2013;608;1862;24;92;525;1591;549;1683
220090;202002;1730;4213;1429;3786;20;69;1189;3262;1209;3331
220095;202002;633;1591;593;1548;26;43;537;1420;563;1463
220100;202002;1341;3711;1070;3276;47;171;859;2559;906;2730
220105;202002;1967;6171;1724;5682;116;437;1311;4300;1427;4737
220110;202002;3306;9194;3078;8795;39;202;2769;7797;2808;7999
220115;202002;2658;7777;2461;7523;67;240;2233;6760;2300;7000
220117;202002;1337;3239;1035;2819;10;50;878;2345;888;2395
220120;202002;12534;34043;11474;32743;77;277;10779;30744;10856;31021
220130;202002;1086;2946;922;2723;15;80;833;2431;848;2511
220140;202002;2065;4340;1749;3964;104;269;1528;3397;1632;3666
220150;202002;6280;18771;5752;17903;126;610;4882;14875;5008;15485
220155;202002;1129;3271;902;2853;30;108;643;1998;673;2106
220157;202002;1038;2546;878;2299;20;81;716;1813;736;1894
220160;202002;2730;7683;2356;7023;31;151;1972;5773;2003;5924
220170;202002;1505;3993;1287;3677;12;65;1153;3256;1165;3321
220173;202002;2096;5874;1679;5145;41;187;1344;4009;1385;4196
220177;202002;1959;5619;1858;5508;10;37;1836;5436;1846;5473
220180;202002;1099;2710;900;2380;4;21;697;1737;701;1758
220190;202002;6724;17051;5692;15630;355;1058;4266;11860;4621;12918
220191;202002;1440;4448;1304;4216;70;258;970;3038;1040;3296
220192;202002;1955;5222;1453;4327;30;108;1183;3458;1213;3566
220194;202002;1673;4824;1485;4527;50;191;1228;3691;1278;3882
220196;202002;1967;5120;1776;4830;26;110;1524;4067;1550;4177
220198;202002;1272;3537;1072;3283;7;30;990;3055;997;3085
220200;202002;5014;14522;4343;13660;119;480;3711;11647;3830;12127
220202;202002;2125;5991;1826;5506;29;151;1575;4676;1604;4827
220205;202002;2434;7024;2182;6571;49;205;1847;5471;1896;5676
220207;202002;776;2317;631;2067;64;216;398;1317;462;1533
220208;202002;1642;5063;1339;4472;153;561;810;2653;963;3214
220209;202002;1542;4393;1342;4049;21;101;1115;3322;1136;3423
220210;202002;1645;4117;1415;3769;11;53;1215;3161;1226;3214
220211;202002;1550;4034;1422;3858;18;71;1239;3384;1257;3455
220213;202002;1735;4652;1504;4251;29;104;1215;3341;1244;3445
220217;202002;2070;6374;1953;6242;32;86;1830;5933;1862;6019
220220;202002;10287;26944;8492;24188;541;1355;5830;17376;6371;18731
220225;202002;1011;2673;821;2429;6;37;764;2230;770;2267
220230;202002;5655;14069;4852;12969;160;392;4201;11258;4361;11650
220240;202002;2890;8477;2625;8009;115;373;2115;6469;2230;6842
220245;202002;1678;4048;1282;3551;9;47;1166;3255;1175;3302
220250;202002;2944;8271;2596;7831;18;96;2431;7303;2449;7399
220253;202002;1555;4270;1369;3960;59;216;1163;3259;1222;3475
220255;202002;1826;4431;1550;4042;35;156;1311;3286;1346;3442
220260;202002;4172;13010;3679;12118;156;610;2962;9714;3118;10324
220265;202002;1289;4140;1158;3962;34;171;952;3193;986;3364
220270;202002;6104;19384;5730;18727;205;997;4816;15192;5021;16189
220271;202002;1463;3746;1265;3475;28;107;1118;3052;1146;3159
220272;202002;1751;5036;1552;4675;56;174;1171;3432;1227;3606
220273;202002;1198;3436;1005;3084;39;152;773;2327;812;2479
220275;202002;2215;5370;1755;4740;28;89;1537;4172;1565;4261
220277;202002;2078;5284;1789;4855;22;67;1532;4095;1554;4162
220280;202002;1602;3781;1325;3413;27;95;1129;2864;1156;2959
220285;202002;1403;3598;1197;3362;12;54;1096;3052;1108;3106
220290;202002;6185;17788;4847;15897;344;1282;3557;11869;3901;13151
220300;202002;1934;5630;1577;5157;33;205;1316;4260;1349;4465
220310;202002;3004;8111;2331;7332;42;208;1960;6114;2002;6322
220320;202002;2976;8799;2284;7470;90;422;1780;5635;1870;6057
220323;202002;1592;4692;1254;4139;52;209;1034;3359;1086;3568
220325;202002;1227;3643;1049;3346;24;120;876;2744;900;2864
220327;202002;1483;4225;1288;3909;44;187;1068;3156;1112;3343
220330;202002;4272;10389;3568;9534;57;183;3220;8535;3277;8718
220335;202002;1663;5055;1499;4849;32;107;1335;4338;1367;4445
220340;202002;1801;4764;1384;4073;57;197;954;2717;1011;2914
220342;202002;1107;3285;984;3101;42;201;786;2430;828;2631
220345;202002;3079;6950;2385;5949;13;42;2164;5373;2177;5415
220350;202002;3252;8332;2581;7342;135;413;1851;5245;1986;5658
220360;202002;1210;3112;947;2677;13;42;763;2136;776;2178
220370;202002;8581;24918;7798;23671;169;737;6813;20399;6982;21136
220375;202002;1585;4519;1402;4298;2;13;1332;4102;1334;4115
220380;202002;1468;3498;1188;3098;16;47;1041;2674;1057;2721
220385;202002;840;2022;668;1705;7;21;582;1466;589;1487
220390;202002;9821;25684;7486;22080;1936;5579;2835;9228;4771;14807
220400;202002;1454;3451;1106;2931;24;68;859;2226;883;2294
220410;202002;1143;3141;918;2764;46;133;747;2219;793;2352
220415;202002;792;2034;661;1826;19;56;536;1454;555;1510
220420;202002;1975;5477;1579;4715;52;154;1226;3605;1278;3759
220430;202002;2442;6590;2287;6373;74;239;1966;5406;2040;5645
220435;202002;1707;4405;1470;4061;38;123;1217;3303;1255;3426
220440;202002;2356;7404;2019;6878;104;439;1687;5649;1791;6088
220450;202002;2437;6343;1982;5780;61;206;1697;4959;1758;5165
220455;202002;1279;3948;1216;3861;13;67;1082;3425;1095;3492
220460;202002;961;2353;891;2264;36;89;763;1916;799;2005
220465;202002;2293;7147;2022;6721;173;592;1503;5087;1676;5679
220470;202002;3405;9459;3053;8904;81;218;2499;7199;2580;7417
220480;202002;2676;6991;2144;6132;158;388;1452;4161;1610;4549
220490;202002;2462;6212;2127;5777;28;137;1857;4968;1885;5105
220500;202002;2684;6949;2375;6469;50;173;1969;5215;2019;5388
220510;202002;2499;7098;1949;6123;80;239;1545;4868;1625;5107
220515;202002;1610;3919;1478;3733;31;51;1300;3276;1331;3327
220520;202002;4811;12585;4333;11909;97;278;3790;10344;3887;10622
220525;202002;1302;3292;1121;3064;10;45;1034;2790;1044;2835
220527;202002;1288;3619;1109;3358;11;51;956;2946;967;2997
220530;202002;1422;3551;1217;3292;31;102;1113;2978;1144;3080
220535;202002;774;2164;724;2099;37;127;593;1696;630;1823
220540;202002;3177;10167;2978;9796;114;412;2556;8363;2670;8775
220545;202002;1371;4176;1264;4008;62;247;1058;3316;1120;3563
220550;202002;8453;25956;7476;24288;487;1712;5655;18196;6142;19908
220551;202002;1371;3933;1196;3634;26;121;990;2942;1016;3063
220552;202002;1560;4547;1266;4033;30;153;1014;3105;1044;3258
220553;202002;1675;4396;1377;4005;54;122;1117;3368;1171;3490
220554;202002;865;2294;629;1895;43;102;408;1225;451;1327
220555;202002;2161;6615;1934;6297;44;197;1643;5355;1687;5552
220556;202002;1180;3428;1021;3128;57;228;730;2145;787;2373
220557;202002;1577;4849;1329;4354;66;260;975;3099;1041;3359
220558;202002;1380;3597;1081;3181;20;90;935;2719;955;2809
220559;202002;1683;4253;1420;3849;7;19;1142;3151;1149;3170
220560;202002;1726;3896;1388;3463;36;72;1262;3168;1298;3240
220570;202002;7062;21148;6418;20242;439;1401;5108;16200;5547;17601
220580;202002;6868;18905;6295;17982;84;314;5702;16160;5786;16474
220585;202002;1990;6286;1666;5692;42;147;1366;4719;1408;4866
220590;202002;1293;3533;1056;3173;71;217;770;2306;841;2523
220595;202002;2503;6865;2271;6555;22;107;2018;5776;2040;5883
220600;202002;1366;3072;1148;2800;86;108;958;2417;1044;2525
220605;202002;1603;4682;1366;4260;20;122;1106;3345;1126;3467
220610;202002;2691;7934;2532;7706;32;144;2364;7176;2396;7320
220620;202002;7734;24057;7118;23221;168;898;6491;20902;6659;21800
220630;202002;360;1073;274;911;20;70;184;615;204;685
220635;202002;1584;5050;1389;4630;53;261;1052;3400;1105;3661
220640;202002;2456;6775;2097;6256;76;306;1702;5009;1778;5315
220650;202002;2030;5611;1765;5210;33;128;1422;4192;1455;4320
220660;202002;2574;8071;2196;7429;85;445;1838;6051;1923;6496
220665;202002;1192;3632;1006;3322;34;188;837;2672;871;2860
220667;202002;1572;4917;1404;4599;59;244;1153;3749;1212;3993
220669;202002;1598;4872;1532;4772;52;245;1356;4128;1408;4373
220670;202002;2148;5643;1717;5035;16;84;1496;4365;1512;4449
220672;202002;3143;7753;2541;7028;108;350;2236;6126;2344;6476
220675;202002;1227;3378;1096;3143;34;110;915;2589;949;2699
220680;202002;2638;7250;2526;7087;93;230;2320;6528;2413;6758
220690;202002;1533;4079;1352;3803;61;176;1072;3027;1133;3203
220695;202002;864;2409;806;2306;20;62;707;2016;727;2078
220700;202002;9667;23953;7743;21303;338;975;5956;16243;6294;17218
220710;202002;886;2440;658;2007;28;94;491;1468;519;1562
220720;202002;2082;4961;1880;4691;16;67;1638;4025;1654;4092
220730;202002;1277;3606;1074;3265;16;92;918;2718;934;2810
220735;202002;940;2202;734;1888;16;59;622;1542;638;1601
220740;202002;1345;3537;1071;3192;31;87;891;2707;922;2794
220750;202002;3813;9696;3324;8991;189;459;2881;7822;3070;8281
220755;202002;1253;3122;1039;2803;25;94;842;2208;867;2302
220760;202002;3021;8503;2645;7991;79;269;2354;7179;2433;7448
220770;202002;21487;64629;18027;58687;5567;19072;6467;21747;12034;40819
220775;202002;1120;2896;1015;2763;12;52;974;2632;986;2684
220777;202002;1598;4046;1214;3453;28;70;935;2670;963;2740
220779;202002;1284;3238;1111;2990;19;59;970;2595;989;2654
220780;202002;5499;13937;4782;12861;206;673;3929;10305;4135;10978
220785;202002;1445;3228;1266;3000;7;19;1224;2886;1231;2905
220790;202002;9868;28299;8850;26858;215;1026;7478;22376;7693;23402
220793;202002;904;2380;714;2050;10;22;599;1741;609;1763
220795;202002;1368;3555;1220;3361;17;66;1089;3003;1106;3069
220800;202002;17529;39163;14812;35567;623;1458;11492;27538;12115;28996
220810;202002;2925;8146;2464;7324;49;156;2036;6000;2085;6156
220820;202002;4962;12951;4283;11965;279;684;3251;9071;3530;9755
220830;202002;7131;19004;6404;17999;230;764;5338;14788;5568;15552
220840;202002;12056;37008;9987;32806;2279;7143;4652;15916;6931;23059
220850;202002;3081;9583;2748;9172;61;331;2431;8110;2492;8441
220855;202002;673;1728;587;1601;13;48;533;1446;546;1494
220860;202002;997;2513;856;2287;16;67;764;2015;780;2082
220865;202002;2412;6409;1891;5515;100;358;1382;3897;1482;4255
220870;202002;2862;8200;2393;7577;35;185;2202;6939;2237;7124
220880;202002;5237;12412;4497;11505;80;292;4116;10395;4196;10687
220885;202002;1372;4228;1136;3828;55;223;908;3093;963;3316
220887;202002;1525;3339;1268;3007;10;27;1177;2768;1187;2795
220890;202002;1372;4224;1198;3952;44;153;989;3323;1033;3476
220900;202002;2006;4772;1670;4338;29;73;1467;3788;1496;3861
220910;202002;1503;4117;1261;3762;55;168;1047;3133;1102;3301
220915;202002;918;2503;749;2191;5;20;573;1637;578;1657
220920;202002;1308;4286;1128;4046;59;270;927;3328;986;3598
220930;202002;1661;4576;1411;4211;24;75;1298;3867;1322;3942
220935;202002;1066;3061;865;2652;25;98;583;1686;608;1784
220937;202002;1373;3670;1187;3383;24;79;952;2686;976;2765
220940;202002;1470;4165;1169;3617;38;144;903;2751;941;2895
220945;202002;427;1496;368;1359;21;121;275;973;296;1094
220950;202002;1411;3257;917;2487;17;59;729;1912;746;1971
220955;202002;1573;4089;1312;3628;28;89;1113;3030;1141;3119
220960;202002;795;2033;592;1695;13;47;435;1183;448;1230
220965;202002;1754;4831;1532;4499;21;130;1329;3811;1350;3941
220970;202002;1894;4571;1381;3806;36;91;1145;3113;1181;3204
220975;202002;674;1964;578;1846;16;92;510;1567;526;1659
220980;202002;1132;3211;1007;3042;37;149;843;2518;880;2667
220985;202002;1187;3127;1032;2902;44;129;836;2285;880;2414
220987;202002;1407;4217;1222;3885;51;202;991;3117;1042;3319
220990;202002;1665;4598;1465;4305;18;104;1241;3588;1259;3692
220995;202002;1050;3200;848;2828;34;120;625;2074;659;2194
220997;202002;2363;7065;2182;6777;48;222;1960;6013;2008;6235
221000;202002;4399;12086;3882;11325;88;429;3317;9499;3405;9928
221005;202002;1455;3837;1328;3629;22;122;1156;3037;1178;3159
221010;202002;1166;2706;938;2429;21;57;819;2069;840;2126
221020;202002;1471;4504;1363;4302;21;85;1060;3303;1081;3388
221030;202002;1589;3981;1374;3718;24;77;1189;3262;1213;3339
221035;202002;1451;3865;1262;3613;18;25;1124;3295;1142;3320
221037;202002;653;1840;543;1645;8;27;381;1110;389;1137
221038;202002;510;1433;400;1231;13;43;282;865;295;908
221039;202002;844;2313;725;2112;17;75;600;1687;617;1762
221040;202002;3930;11831;3436;10947;144;520;2742;8731;2886;9251
221050;202002;3840;10142;3373;9545;66;257;3040;8564;3106;8821
221060;202002;8274;23060;6854;20837;242;708;5606;17151;5848;17859
221062;202002;1151;3741;976;3446;43;199;783;2721;826;2920
221063;202002;1013;2852;865;2636;60;210;668;1999;728;2209
221065;202002;2555;6650;2260;6120;21;87;1984;5274;2005;5361
221070;202002;3230;10150;2634;8933;286;961;1638;5646;1924;6607
221080;202002;3443;8481;2792;7528;58;228;2295;6076;2353;6304
221090;202002;1370;3546;1121;3135;9;35;965;2637;974;2672
221093;202002;1322;3733;1207;3497;113;320;841;2395;954;2715
221095;202002;880;2281;733;2052;9;31;614;1688;623;1719
221097;202002;823;2158;631;1813;22;67;468;1293;490;1360
221100;202002;110752;296796;91935;264825;10018;30888;59967;167995;69985;198883
221110;202002;9731;29111;8931;28075;148;749;8008;24906;8156;25655
221120;202002;4686;12931;4174;12105;158;479;3648;10547;3806;11026
221130;202002;5185;13615;3829;10977;753;2042;1856;5378;2609;7420
221135;202002;1579;4244;1415;4027;38;134;1260;3575;1298;3709
221140;202002;1301;3095;1096;2833;12;42;982;2486;994;2528
221150;202002;1081;2672;848;2261;23;100;652;1623;675;1723
221160;202002;710;1765;624;1653;13;16;518;1382;531;1398
221170;202002;968;2802;880;2640;19;67;761;2261;780;2328
230010;202002;2971;7868;2439;6974;36;131;1982;5531;2018;5662
230015;202002;2939;9590;2567;8848;164;661;1810;6175;1974;6836
230020;202002;12708;40187;11870;38915;332;1386;10084;32828;10416;34214
230030;202002;12805;32158;10687;29412;175;537;9421;25873;9596;26410
230040;202002;4368;11380;3597;10160;48;241;3028;8387;3076;8628
230050;202002;2753;8544;2061;6900;333;1060;917;2988;1250;4048
230060;202002;2315;6348;1841;5509;39;177;1462;4279;1501;4456
230070;202002;3824;10212;3072;8763;135;423;2164;6090;2299;6513
230075;202002;8908;28877;8143;27525;461;1971;6504;21671;6965;23642
230080;202002;3035;6361;2289;5446;7;26;2103;4995;2110;5021
230090;202002;4208;10498;3540;9432;157;410;2836;7483;2993;7893
230100;202002;17593;45978;15454;43076;1145;3313;11145;31118;12290;34431
230110;202002;12587;37377;10570;33426;1722;5401;5614;17826;7336;23227
230120;202002;7073;19246;6233;17872;478;1240;4648;13501;5126;14741
230125;202002;3106;8228;2514;7267;83;279;1931;5517;2014;5796
230130;202002;5661;17442;4572;15013;308;1086;3106;10030;3414;11116
230140;202002;3362;10087;2861;9045;98;391;2186;6760;2284;7151
230150;202002;1549;4646;1286;4059;197;536;752;2471;949;3007
230160;202002;6377;16638;5472;15219;195;685;4437;12124;4632;12809
230170;202002;6131;17463;5009;15180;309;921;3622;10781;3931;11702
230180;202002;1627;4506;1374;4031;20;94;1111;3155;1131;3249
230185;202002;4278;12250;3592;11106;241;838;2688;8284;2929;9122
230190;202002;12900;37656;10841;33843;1474;4800;6149;19013;7623;23813
230195;202002;5240;15455;4745;14532;332;1018;3659;11152;3991;12170
230200;202002;4940;13601;4129;12070;141;455;3174;9080;3315;9535
230205;202002;3984;12048;3493;11291;178;663;2618;8386;2796;9049
230210;202002;10263;24720;8631;22512;337;1108;6819;17449;7156;18557
230220;202002;13808;34675;12051;32138;604;1635;9931;26199;10535;27834
230230;202002;6730;20388;6003;18866;378;1203;4456;13964;4834;15167
230240;202002;12854;34303;11120;31382;272;1137;9205;25361;9477;26498
230250;202002;8766;24699;8160;23771;222;802;6564;18525;6786;19327
230260;202002;14383;43200;12406;39672;1618;5081;7201;23464;8819;28545
230270;202002;7446;20283;5629;16868;459;1361;3753;11244;4212;12605
230280;202002;20224;54035;16454;47693;469;1986;12971;36227;13440;38213
230290;202002;4765;13240;3957;11697;269;704;2984;8842;3253;9546
230300;202002;4722;12679;4272;12055;90;284;3738;10467;3828;10751
230310;202002;4550;12994;3823;11714;132;580;2774;8241;2906;8821
230320;202002;7642;22106;6417;19852;247;1030;4911;14841;5158;15871
230330;202002;4659;12712;3659;10775;139;457;2743;7903;2882;8360
230340;202002;3533;11000;2997;9921;263;907;2013;6606;2276;7513
230350;202002;17529;48442;15341;45178;851;2899;10347;30632;11198;33531
230360;202002;2838;7617;2217;6525;139;411;1503;4363;1642;4774
230365;202002;2981;7482;2460;6697;46;229;2102;5642;2148;5871
230370;202002;57735;160789;48951;147767;7349;22420;29042;88992;36391;111412
230380;202002;6273;17469;4933;15002;127;515;3656;10879;3783;11394
230390;202002;3340;9941;2874;9196;100;457;2223;6992;2323;7449
230393;202002;3155;9487;2495;8134;84;436;1915;5987;1999;6423
230395;202002;5683;15506;4947;14283;323;880;3500;10127;3823;11007
230400;202002;5391;14935;4794;13953;101;535;3868;10924;3969;11459
230410;202002;14038;41395;11512;36716;881;3065;7900;25107;8781;28172
230420;202002;28182;77743;22810;68313;2772;8640;12760;38031;15532;46671
230423;202002;4611;13696;4002;12479;83;366;3287;10074;3370;10440
230425;202002;5477;16918;4974;15897;390;1307;3566;11339;3956;12646
230426;202002;2707;7138;1953;5662;29;108;1473;4188;1502;4296
230427;202002;1840;5198;1307;4058;63;219;865;2583;928;2802
230428;202002;9521;25391;8150;23338;1088;3115;4821;13726;5909;16841
230430;202002;4937;13876;3881;12096;158;553;2911;8907;3069;9460
230435;202002;5744;15116;4772;13378;567;1531;2957;8319;3524;9850
230440;202002;404239;1003988;333805;900830;34121;97445;213589;569444;247710;666889
230445;202002;4197;11162;3372;9732;163;460;2315;6547;2478;7007
230450;202002;3510;10186;3058;9524;232;930;2238;6740;2470;7670
230460;202002;2088;5829;1817;5403;57;227;1524;4510;1581;4737
230465;202002;3945;11125;3329;9964;102;412;2507;7191;2609;7603
230470;202002;11153;36819;9986;34666;860;3415;7110;24246;7970;27661
230480;202002;1397;4076;1179;3678;75;293;852;2560;927;2853
230490;202002;2439;6839;2047;6129;161;539;1297;3660;1458;4199
230495;202002;5680;16882;4991;15644;361;1377;3320;10279;3681;11656
230500;202002;9126;29465;8184;27761;270;1116;6690;22602;6960;23718
230510;202002;1579;4824;1218;4041;171;615;607;1979;778;2594
230520;202002;4428;12587;3821;11486;317;892;2682;8083;2999;8975
230523;202002;15133;44734;12005;38125;2721;8582;3188;10721;5909;19303
230526;202002;3650;10425;3098;9497;178;536;2294;7050;2472;7586
230530;202002;5296;16564;4446;14898;295;1126;3209;10631;3504;11757
230533;202002;4322;10480;3608;9345;89;260;3011;7661;3100;7921
230535;202002;5238;14579;4423;13196;232;699;3117;9404;3349;10103
230540;202002;16027;43539;13766;40201;268;1082;11383;32898;11651;33980
230550;202002;20230;53872;16195;47001;1459;4392;10349;29843;11808;34235
230560;202002;7977;19575;6412;17097;51;208;5502;14577;5553;14785
230565;202002;2972;8306;2478;7402;82;344;1881;5490;1963;5834
230570;202002;3426;8762;2916;8081;75;222;2414;6664;2489;6886
230580;202002;10792;28020;9209;25749;339;965;7619;21170;7958;22135
230590;202002;8743;24931;7216;22148;387;1422;5345;15838;5732;17260
230600;202002;3598;9409;2790;7976;78;241;1932;5546;2010;5787
230610;202002;6564;18161;5797;16869;436;1259;4581;13249;5017;14508
230620;202002;2034;5516;1537;4540;107;344;960;2744;1067;3088
230625;202002;7578;21640;6336;19369;1897;6029;1753;5744;3650;11773
230630;202002;10594;31543;9151;28636;1473;4390;5254;16819;6727;21209
230640;202002;27319;82652;24570;78325;1252;5019;19563;61325;20815;66344
230650;202002;5047;13814;4281;12478;131;569;3494;9911;3625;10480
230655;202002;9133;31031;8576;30061;587;2163;6852;24230;7439;26393
230660;202002;5903;17636;4821;15712;146;800;3953;12602;4099;13402
230670;202002;6100;14589;4428;11924;126;423;3592;9404;3718;9827
230680;202002;2592;7114;2189;6417;128;356;1587;4665;1715;5021
230690;202002;7090;20980;6093;19010;388;1360;3867;11822;4255;13182
230700;202002;9939;25531;8040;22078;314;852;6024;16155;6338;17007
230710;202002;6530;20758;5713;19005;565;1940;3939;12904;4504;14844
230720;202002;1882;5556;1526;4824;114;345;1026;3166;1140;3511
230725;202002;3792;11439;3399;10747;371;1303;1967;6124;2338;7427
230730;202002;55318;150312;43078;131483;9564;31555;14440;46242;24004;77797
230740;202002;5937;16471;5034;15028;123;447;4076;12117;4199;12564
230750;202002;8239;22023;6821;19681;156;572;5458;15318;5614;15890
230760;202002;10942;28852;9515;26732;514;1703;7206;19753;7720;21456
230763;202002;4684;12972;3911;11553;116;552;3143;8989;3259;9541
230765;202002;39909;108608;33004;97439;5183;15843;16559;48590;21742;64433
230770;202002;25159;62307;20964;56748;2126;5772;13967;37888;16093;43660
230780;202002;6114;21735;5560;20455;737;2724;3345;12581;4082;15305
230790;202002;2922;8535;2620;8043;107;464;1966;5879;2073;6343
230800;202002;7874;25104;6904;23150;782;2862;4215;13860;4997;16722
230810;202002;11298;33709;10091;31766;390;1444;7828;24192;8218;25636
230820;202002;3378;11059;2745;9632;246;1047;1691;5588;1937;6635
230830;202002;7422;20260;6308;18376;136;584;5215;14836;5351;15420
230835;202002;4223;10100;3241;8534;82;252;2628;6821;2710;7073
230837;202002;3057;9413;2667;8729;104;499;2128;6767;2232;7266
230840;202002;8792;25881;7559;23811;753;2254;5463;17381;6216;19635
230850;202002;9357;27265;7834;24235;348;1283;5661;17234;6009;18517
230860;202002;5073;13002;4203;11749;56;209;3719;10334;3775;10543
230870;202002;16242;39797;13874;35895;364;1063;11411;29042;11775;30105
230880;202002;2071;6314;1885;6006;41;230;1505;4680;1546;4910
230890;202002;4519;14450;4092;13579;320;1173;2974;9694;3294;10867
230900;202002;2932;8454;2497;7618;177;622;1696;5048;1873;5670
230910;202002;3016;8143;2423;7202;56;271;1982;5858;2038;6129
230920;202002;4479;12750;3789;11654;130;533;2979;8973;3109;9506
230930;202002;6363;17867;5320;16004;283;838;3730;11206;4013;12044
230940;202002;7845;20266;6762;18614;202;525;5655;15482;5857;16007
230945;202002;6423;18518;5504;16765;302;1089;3923;11734;4225;12823
230950;202002;6124;15484;5444;14561;91;220;4815;12944;4906;13164
230960;202002;12806;37374;11264;34508;1793;5463;5784;17928;7577;23391
230970;202002;13158;34911;10917;31468;1706;4866;6146;17960;7852;22826
230980;202002;2631;7737;2306;7163;344;1030;1436;4576;1780;5606
230990;202002;1594;4509;1324;3970;62;265;949;2711;1011;2976
231000;202002;2415;6452;1974;5584;72;190;1479;4102;1551;4292
231010;202002;3478;8220;2740;6934;41;150;2370;5818;2411;5968
231020;202002;7830;24828;6973;23113;1274;3903;3970;13711;5244;17614
231025;202002;7336;20357;6365;18753;715;2081;4422;13134;5137;15215
231030;202002;7184;21400;5598;18054;896;2797;2928;9485;3824;12282
231040;202002;2868;8354;2501;7671;117;373;1970;5945;2087;6318
231050;202002;11450;29655;9218;25697;622;1703;6868;18698;7490;20401
231060;202002;2752;7875;2409;7320;59;224;1987;6021;2046;6245
231070;202002;7667;22276;6518;20287;703;2252;4223;13050;4926;15302
231080;202002;3858;11051;3284;10122;129;555;2512;7597;2641;8152
231085;202002;6657;16209;5249;14535;196;506;4127;11414;4323;11920
231090;202002;4427;11574;3264;9348;102;409;2253;6204;2355;6613
231095;202002;2250;6690;1764;5631;138;442;1171;3726;1309;4168
231100;202002;3104;9027;2552;7990;117;430;1927;5961;2044;6391
231110;202002;3472;10267;3141;9666;116;434;2392;7235;2508;7669
231120;202002;2177;6414;1788;5746;76;299;1289;4078;1365;4377
231123;202002;1850;4826;1550;4311;68;160;1140;3185;1208;3345
231126;202002;5327;14823;4303;12863;235;717;3141;9275;3376;9992
231130;202002;20831;53646;17288;49181;1000;3687;12840;35707;13840;39394
231135;202002;4098;11543;3373;10139;146;501;2435;7162;2581;7663
231140;202002;16232;45720;12865;39873;574;2419;9122;27402;9696;29821
231150;202002;5618;15392;4319;12925;670;2018;1958;6011;2628;8029
231160;202002;6092;18612;5338;17213;770;2361;3082;10185;3852;12546
231170;202002;4304;12618;3539;11162;191;707;2463;7490;2654;8197
231180;202002;13997;39754;11305;34078;3120;9110;3858;12130;6978;21240
231190;202002;3807;10760;3129;9517;66;293;2415;7155;2481;7448
231195;202002;4828;14680;3999;12951;220;830;2906;9311;3126;10141
231200;202002;7690;24169;6700;22170;206;1048;5249;16806;5455;17854
231210;202002;4745;14000;4041;12813;183;703;3043;9459;3226;10162
231220;202002;11781;30855;9119;25799;375;1189;6696;18277;7071;19466
231230;202002;9052;28918;7964;26952;467;1878;5903;19937;6370;21815
231240;202002;11274;33021;9905;30423;1512;4526;6014;18694;7526;23220
231250;202002;2106;5426;1359;3791;101;283;827;2246;928;2529
231260;202002;3143;8976;2721;8313;251;754;1880;5873;2131;6627
231270;202002;6303;16531;5111;14594;140;549;3894;10852;4034;11401
231280;202002;1691;5286;1547;5018;90;303;1163;3747;1253;4050
231290;202002;36950;110164;30542;97324;5138;16167;14294;45169;19432;61336
231300;202002;3984;11093;3107;9330;210;686;2063;6058;2273;6744
231310;202002;7085;18499;5625;15848;463;1312;3900;10727;4363;12039
231320;202002;7637;21081;5938;18062;83;409;4679;14021;4762;14430
231325;202002;2397;6389;1963;5723;156;389;1330;3961;1486;4350
231330;202002;9294;27908;7604;24540;1352;4172;4095;13772;5447;17944
231335;202002;5648;14933;4773;13523;87;373;4208;11785;4295;12158
231340;202002;16887;52770;15136;49619;1282;4228;11008;36498;12290;40726
231350;202002;15588;42702;14134;40652;280;1010;12657;36044;12937;37054
231355;202002;4295;12898;3852;12064;230;775;2982;9233;3212;10008
231360;202002;7184;21875;6235;20201;250;934;4973;16023;5223;16957
231370;202002;2133;5881;1705;5144;32;109;1311;3936;1343;4045
231375;202002;4306;13408;3922;12789;133;604;3300;10610;3433;11214
231380;202002;5955;16212;5369;15416;181;480;4386;12762;4567;13242
231390;202002;3264;9556;2922;8994;126;496;2168;6481;2294;6977
231395;202002;3865;11459;3191;10383;401;1315;1899;6264;2300;7579
231400;202002;9525;27346;7958;24499;271;1139;6053;18200;6324;19339
231410;202002;14388;45004;13055;42796;582;2264;10565;34184;11147;36448
240010;202002;2471;6590;1911;5570;187;576;1160;3292;1347;3868
240020;202002;12183;34221;10183;30693;618;2318;6873;20342;7491;22660
240030;202002;2801;6872;2545;6479;86;253;2210;5567;2296;5820
240040;202002;781;2242;648;1994;32;120;455;1354;487;1474
240050;202002;3166;8503;2577;7421;47;142;2019;5740;2066;5882
240060;202002;1367;3682;1124;3244;24;88;921;2594;945;2682
240070;202002;2095;6100;1903;5714;177;578;1385;4032;1562;4610
240080;202002;2905;7849;2364;6861;52;207;1829;5183;1881;5390
240090;202002;2194;5425;1786;4739;19;54;1510;3954;1529;4008
240100;202002;9859;24441;7826;20723;206;640;6133;15677;6339;16317
240110;202002;4508;12757;3794;11469;185;676;2760;8154;2945;8830
240120;202002;3200;8886;2547;8107;181;625;1803;5883;1984;6508
240130;202002;3586;7503;2994;6736;27;88;2741;6084;2768;6172
240140;202002;1793;5368;1527;4849;157;550;1033;3243;1190;3793
240145;202002;6506;18106;5289;16040;820;2541;3006;9187;3826;11728
240150;202002;889;2622;796;2429;52;188;617;1820;669;2008
240160;202002;1416;4297;1184;3861;47;223;889;2895;936;3118
240165;202002;943;2584;783;2279;39;130;631;1803;670;1933
240170;202002;2435;6624;2043;5909;187;618;1388;3886;1575;4504
240180;202002;2932;8703;2343;7513;547;1654;1072;3649;1619;5303
240185;202002;1151;3694;1060;3542;48;198;889;2929;937;3127
240190;202002;1022;3038;881;2800;21;98;747;2374;768;2472
240200;202002;10491;27055;8353;23384;829;2572;4847;13249;5676;15821
240210;202002;3057;7686;2549;6923;27;138;2161;5656;2188;5794
240220;202002;7160;21478;6387;20262;321;1427;5030;15643;5351;17070
240230;202002;5719;14624;4576;12698;187;531;3669;10188;3856;10719
240240;202002;1838;5260;1139;3589;115;382;423;1172;538;1554
240250;202002;2868;7627;2528;7160;92;286;2126;5984;2218;6270
240260;202002;13882;40884;11954;37640;1687;4995;7439;24516;9126;29511
240270;202002;2202;6600;1926;6151;91;300;1428;4666;1519;4966
240280;202002;1651;4245;1404;3844;52;149;1128;3040;1180;3189
240290;202002;1163;3396;941;2900;25;116;667;1928;692;2044
240300;202002;2177;5608;1553;4468;73;234;1009;2817;1082;3051
240310;202002;8366;22093;6585;18936;871;2647;3463;9751;4334;12398
240320;202002;1998;5487;1474;4456;31;145;1101;3168;1132;3313
240325;202002;29439;79179;23017;67964;4168;12680;10055;29933;14223;42613
240330;202002;1689;4638;1286;3862;51;187;871;2501;922;2688
240340;202002;1934;4474;1576;3924;64;150;1292;3164;1356;3314
240350;202002;2077;5381;1874;5157;23;72;1711;4731;1734;4803
240360;202002;8454;23553;7541;22113;810;2409;5303;15761;6113;18170
240370;202002;1864;4980;1440;4101;65;195;1024;2839;1089;3034
240375;202002;884;2235;725;1936;26;95;593;1534;619;1629
240380;202002;2195;6223;1599;4883;132;382;950;2873;1082;3255
240390;202002;995;2468;682;1864;30;76;429;1091;459;1167
240400;202002;1390;3460;1063;2913;35;138;766;1942;801;2080
240410;202002;554;1678;465;1479;40;156;296;888;336;1044
240420;202002;4484;15791;3937;14578;460;2048;2347;8469;2807;10517
240430;202002;3292;8583;2746;7602;171;553;2044;5481;2215;6034
240440;202002;2484;5427;2095;4893;135;266;1701;3981;1836;4247
240450;202002;4417;12051;3456;10259;332;1037;2065;5891;2397;6928
240460;202002;2744;7886;2502;7498;240;762;1943;5802;2183;6564
240470;202002;3560;10693;2705;8916;456;1421;1424;4908;1880;6329
240480;202002;563;1565;383;1173;28;92;182;536;210;628
240485;202002;2085;5907;1702;5189;123;391;1191;3622;1314;4013
240490;202002;1600;4101;1256;3473;80;187;934;2600;1014;2787
240500;202002;2120;5727;1849;5282;97;268;1503;4286;1600;4554
240510;202002;1639;4271;1448;3997;67;239;1210;3260;1277;3499
240520;202002;1390;3462;1084;3038;43;144;831;2309;874;2453
240530;202002;2093;6036;1889;5716;97;296;1550;4675;1647;4971
240540;202002;2238;5637;1956;5195;59;122;1700;4511;1759;4633
240550;202002;673;1920;609;1797;19;76;509;1450;528;1526
240560;202002;3261;8440;2734;7745;282;725;1976;5690;2258;6415
240570;202002;2671;7046;1774;5037;265;766;716;1899;981;2665
240580;202002;8006;23323;7080;21605;557;1637;5656;17371;6213;19008
240590;202002;694;1839;611;1700;14;50;457;1250;471;1300
240600;202002;1753;4759;1290;3789;44;149;868;2466;912;2615
240610;202002;4134;11209;3482;10028;123;415;2669;7535;2792;7950
240615;202002;1166;3064;920;2602;80;231;636;1731;716;1962
240620;202002;1790;5045;1543;4612;90;254;1243;3694;1333;3948
240630;202002;2063;5863;1862;5522;149;322;1317;4070;1466;4392
240640;202002;925;2492;734;2175;24;99;554;1609;578;1708
240650;202002;3980;11053;3433;9945;196;581;2666;7609;2862;8190
240660;202002;3063;7857;2717;7413;50;154;2470;6733;2520;6887
240670;202002;2423;6830;1948;5853;140;445;1267;3711;1407;4156
240680;202002;1605;4275;1289;3738;50;152;984;2781;1034;2933
240690;202002;961;2417;761;2083;15;66;608;1602;623;1668
240700;202002;2356;6846;1913;6021;60;224;1518;4689;1578;4913
240710;202002;15892;41172;13230;36676;1739;4690;8227;22754;9966;27444
240720;202002;5063;12536;4377;11567;362;1025;3245;8459;3607;9484
240725;202002;1105;3156;848;2633;31;107;572;1719;603;1826
240730;202002;2113;5989;1746;5291;58;214;1360;4010;1418;4224
240740;202002;1772;4769;1421;4085;43;174;1064;2892;1107;3066
240750;202002;2101;6961;1771;6251;267;1035;943;3365;1210;4400
240760;202002;1555;3739;1088;3023;56;99;836;2399;892;2498
240770;202002;3149;8700;2642;7961;117;448;2138;6347;2255;6795
240780;202002;4757;13113;3862;11619;481;1439;2425;7440;2906;8879
240790;202002;835;2381;692;2101;12;53;529;1568;541;1621
240800;202002;44593;108029;34394;92599;4678;13001;17948;48396;22626;61397
240810;202002;86181;224848;72606;202357;9276;26416;45859;125974;55135;152390
240820;202002;5658;16888;4887;15493;654;2063;3047;9802;3701;11865
240830;202002;8591;24670;7650;23276;242;1068;6369;19066;6611;20134
240840;202002;1104;2737;878;2374;30;75;623;1625;653;1700
240850;202002;1325;3625;944;2832;41;129;543;1567;584;1696
240860;202002;1235;3369;914;2805;13;66;682;1968;695;2034
240870;202002;1099;2786;821;2294;127;362;452;1290;579;1652
240880;202002;1254;3963;1106;3674;85;360;853;2753;938;3113
240890;202002;4301;11726;3263;9743;438;1413;1690;4842;2128;6255
240895;202002;2636;8312;2417;7981;122;422;2124;7037;2246;7459
240910;202002;3248;8934;2778;8084;50;185;2290;6557;2340;6742
240920;202002;839;2337;695;2098;58;170;399;1259;457;1429
240930;202002;3645;8329;3009;7568;192;280;2282;6021;2474;6301
240933;202002;1744;4248;1427;3781;42;165;1235;3219;1277;3384
240940;202002;5988;14775;4637;12477;491;1346;2883;7525;3374;8871
240950;202002;990;2975;863;2738;27;116;706;2193;733;2309
240960;202002;665;2059;595;1915;27;101;467;1467;494;1568
240970;202002;1801;4658;1452;4062;55;205;1191;3237;1246;3442
240980;202002;3235;9674;2883;9034;117;501;2333;7176;2450;7677
240990;202002;2495;7049;2213;6494;254;833;1578;4463;1832;5296
241000;202002;912;2432;729;2092;28;73;542;1531;570;1604
241010;202002;2741;8797;2501;8291;163;671;1855;6039;2018;6710
241020;202002;2071;5548;1520;4435;151;444;963;2771;1114;3215
241025;202002;1730;4979;1371;4298;46;204;988;3057;1034;3261
241030;202002;2454;7667;1958;6603;217;757;1274;4292;1491;5049
241040;202002;2252;7165;1994;6742;98;425;1606;5385;1704;5810
241050;202002;1289;3575;1055;3159;35;139;798;2323;833;2462
241060;202002;716;2032;635;1858;25;84;453;1273;478;1357
241070;202002;650;1774;564;1620;12;44;444;1226;456;1270
241080;202002;1110;3150;840;2616;7;29;620;1902;627;1931
241090;202002;1992;5842;1623;5215;46;234;1288;4053;1334;4287
241100;202002;1158;3255;907;2730;62;194;602;1753;664;1947
241105;202002;960;2918;783;2581;248;801;256;877;504;1678
241110;202002;936;2645;697;2140;37;121;460;1364;497;1485
241120;202002;7480;21151;6347;19163;943;2780;3765;11679;4708;14459
241140;202002;3244;8555;2553;7179;148;428;1863;5092;2011;5520
241142;202002;755;2023;554;1629;27;94;329;912;356;1006
241150;202002;5851;15266;5159;14133;143;484;4253;11439;4396;11923
241160;202002;1108;2982;898;2593;127;374;577;1619;704;1993
241170;202002;1315;3362;1126;3042;28;110;940;2429;968;2539
241180;202002;1017;2621;734;2074;88;252;383;1057;471;1309
241190;202002;1076;2863;892;2492;17;71;666;1794;683;1865
241200;202002;18581;49008;15975;44853;2547;7132;9392;26386;11939;33518
241210;202002;1384;3720;989;2923;120;384;568;1628;688;2012
241220;202002;8491;25217;7369;23311;1732;5384;3506;11582;5238;16966
241230;202002;2869;7564;2539;7050;101;329;2121;5816;2222;6145
241240;202002;1151;3239;698;2212;57;195;318;1012;375;1207
241250;202002;5289;15409;4234;13425;167;775;3076;9358;3243;10133
241255;202002;2139;6759;1876;6197;107;449;1400;4523;1507;4972
241260;202002;4748;12486;3702;10752;79;345;2969;8385;3048;8730
241270;202002;1718;4957;1422;4382;107;377;1019;3120;1126;3497
241280;202002;2140;5391;1835;4835;59;162;1560;4039;1619;4201
241290;202002;3374;8275;2519;6880;71;252;2002;5307;2073;5559
241300;202002;1420;3814;1128;3286;32;111;787;2226;819;2337
241310;202002;2062;5218;1763;4790;15;63;1501;4113;1516;4176
241320;202002;929;3008;792;2743;89;375;521;1788;610;2163
241330;202002;1716;4513;1342;4019;16;79;1164;3467;1180;3546
241335;202002;3191;8913;2820;8240;104;348;2333;6727;2437;7075
241340;202002;1524;4319;1172;3578;252;803;487;1440;739;2243
241350;202002;2029;5856;1783;5411;92;317;1373;4104;1465;4421
241355;202002;1249;3408;1027;2986;15;49;817;2352;832;2401
241360;202002;2033;5269;1517;4210;45;138;1103;2946;1148;3084
241370;202002;1339;3705;1032;3065;50;177;721;2034;771;2211
241380;202002;606;1731;473;1464;74;201;244;772;318;973
241390;202002;2674;7896;2381;7462;182;521;1858;5903;2040;6424
241400;202002;3464;9696;3088;9111;152;495;2515;7361;2667;7856
241410;202002;2353;7013;1907;6087;331;1073;975;3117;1306;4190
241415;202002;1641;4852;1341;4261;62;234;945;2943;1007;3177
241420;202002;2141;6877;1828;6342;439;1687;903;3101;1342;4788
241430;202002;592;1640;405;1215;21;69;256;741;277;810
241440;202002;7280;22643;6499;21281;335;1288;5204;16862;5539;18150
241445;202002;1083;2786;955;2620;20;46;865;2425;885;2471
241450;202002;2544;6388;2199;5831;377;835;1448;3982;1825;4817
241460;202002;3665;9984;2960;8475;183;580;2114;5884;2297;6464
241470;202002;1386;3662;1126;3280;26;95;936;2734;962;2829
241475;202002;1173;3308;922;2824;22;115;664;1942;686;2057
241480;202002;2841;8906;2341;7807;715;2340;798;2957;1513;5297
241490;202002;613;1467;502;1317;21;56;360;927;381;983
241500;202002;783;2260;695;2147;4;19;642;1997;646;2016
250010;202002;2509;7502;2072;6620;60;244;1514;4708;1574;4952
250020;202002;1586;4293;1135;3399;31;75;817;2432;848;2507
250030;202002;6783;18652;5978;17389;493;1491;4503;12923;4996;14414
250040;202002;3977;12211;3430;11194;225;853;2492;7989;2717;8842
250050;202002;3566;9640;3223;9168;111;418;2648;7513;2759;7931
250053;202002;1134;3201;1028;3031;70;220;754;2222;824;2442
250057;202002;650;2363;607;2298;9;42;542;2094;551;2136
250060;202002;5377;14095;4853;13445;287;768;4013;11175;4300;11943
250070;202002;3934;10985;3330;9932;36;152;2692;7835;2728;7987
250073;202002;756;2016;614;1795;8;26;505;1434;513;1460
250077;202002;2183;5884;1634;4972;62;218;1229;3711;1291;3929
250080;202002;4811;12045;4082;11118;65;299;3567;9555;3632;9854
250090;202002;3288;8074;2872;7511;54;165;2478;6355;2532;6520
250100;202002;3592;10988;3234;10320;162;592;2551;7969;2713;8561
250110;202002;4853;13598;4354;12871;263;978;3405;9839;3668;10817
250115;202002;673;1767;484;1476;8;44;338;1023;346;1067
250120;202002;1807;5311;1512;4828;30;147;1200;3790;1230;3937
250130;202002;5413;14918;4565;13715;69;369;3868;11460;3937;11829
250135;202002;1141;3175;1010;2955;27;106;891;2582;918;2688
250140;202002;2223;6531;2063;6327;107;461;1771;5354;1878;5815
250150;202002;4761;14860;4275;14020;135;611;3446;11102;3581;11713
250153;202002;1395;3665;1172;3333;29;84;946;2658;975;2742
250157;202002;1680;5031;1522;4723;56;238;1215;3714;1271;3952
250160;202002;3895;9704;3109;8642;39;144;2745;7622;2784;7766
250170;202002;1825;4673;1629;4395;25;101;1420;3781;1445;3882
250180;202002;19841;48037;16898;44289;730;2320;13228;33742;13958;36062
250190;202002;4003;10726;3336;9723;324;967;2296;6537;2620;7504
250200;202002;1906;5111;1622;4708;54;177;1373;3981;1427;4158
250205;202002;844;2606;726;2414;17;79;610;2004;627;2083
250210;202002;1530;4656;1378;4413;64;296;1085;3410;1149;3706
250215;202002;1491;4146;1247;3792;70;237;764;2320;834;2557
250220;202002;661;1852;531;1656;29;109;355;1070;384;1179
250230;202002;1547;3504;1095;2831;19;64;897;2250;916;2314
250240;202002;2276;6917;1993;6390;39;190;1660;5233;1699;5423
250250;202002;4528;12591;3940;11723;81;287;3367;10022;3448;10309
250260;202002;1681;4696;1392;4203;41;116;1109;3310;1150;3426
250270;202002;1182;3577;1061;3430;65;227;798;2663;863;2890
250280;202002;3225;9036;2876;8508;102;299;2307;6816;2409;7115
250290;202002;1584;4188;1348;3847;24;73;1060;3038;1084;3111
250300;202002;5460;14559;4914;13934;193;872;4086;11137;4279;12009
250310;202002;1118;3072;923;2747;36;119;718;2105;754;2224
250320;202002;11531;26183;9877;24291;261;737;8785;21298;9046;22035
250330;202002;2312;6472;1933;5961;103;342;1568;4808;1671;5150
250340;202002;1063;2729;948;2579;8;20;873;2364;881;2384
250350;202002;4062;11364;3574;10588;179;459;2816;8526;2995;8985
250355;202002;1946;5900;1739;5615;28;150;1563;5010;1591;5160
250360;202002;1724;4801;1540;4546;37;142;1292;3794;1329;3936
250370;202002;13045;33976;10758;30518;240;925;9004;25158;9244;26083
250375;202002;1170;3061;937;2776;5;17;882;2640;887;2657
250380;202002;1590;4111;1456;3943;27;128;1282;3352;1309;3480
250390;202002;1816;4656;1515;4165;86;237;1201;3278;1287;3515
250400;202002;67692;166555;49199;137769;13591;40431;14678;43248;28269;83679
250403;202002;1697;4766;1512;4551;71;366;1173;3357;1244;3723
250407;202002;1174;2985;948;2646;61;137;700;1985;761;2122
250410;202002;624;1689;541;1547;6;14;446;1252;452;1266
250415;202002;1801;5112;1592;4776;34;147;1376;4106;1410;4253
250420;202002;1162;3315;1063;3180;24;95;954;2828;978;2923
250430;202002;6178;15172;5208;13879;131;429;4333;11278;4464;11707
250435;202002;1513;4217;1222;3714;12;57;943;2825;955;2882
250440;202002;4550;12049;3887;11223;64;173;3463;9986;3527;10159
250450;202002;1770;4733;1457;4309;26;103;1221;3609;1247;3712
250460;202002;7221;19576;6383;18342;314;968;5174;14774;5488;15742
250470;202002;1524;3948;1251;3529;48;150;979;2709;1027;2859
250480;202002;4011;10805;3409;10093;39;135;3032;9051;3071;9186
250485;202002;692;1583;499;1307;33;61;369;925;402;986
250490;202002;5126;12175;4555;11519;173;527;4024;9987;4197;10514
250500;202002;1963;5439;1734;5042;71;230;1416;4112;1487;4342
250510;202002;5389;13576;4612;12572;70;198;4061;11120;4131;11318
250520;202002;1793;4863;1530;4493;129;423;1087;3150;1216;3573
250523;202002;2216;5447;1960;5124;69;301;1651;4154;1720;4455
250527;202002;1647;4267;1484;4082;22;74;1309;3628;1331;3702
250530;202002;616;1600;523;1472;6;17;461;1296;467;1313
250535;202002;1337;3918;1206;3663;28;120;990;2905;1018;3025
250540;202002;2918;6714;2431;6172;64;110;2143;5533;2207;5643
250550;202002;762;2445;665;2264;20;83;500;1667;520;1750
250560;202002;1684;4640;1477;4342;38;145;1247;3570;1285;3715
250570;202002;2603;7830;2232;7164;78;308;1761;5541;1839;5849
250580;202002;1039;2692;915;2518;45;173;771;2076;816;2249
250590;202002;816;2279;725;2147;19;74;600;1783;619;1857
250600;202002;8086;20684;6727;18969;241;773;5614;15624;5855;16397
250610;202002;2949;8253;2638;7799;115;438;2201;6417;2316;6855
250620;202002;759;2023;641;1821;9;34;483;1339;492;1373
250625;202002;2473;7139;2203;6694;42;225;1870;5513;1912;5738
250630;202002;9933;27580;8009;24199;850;2619;5139;15209;5989;17828
250640;202002;3305;9151;2988;8748;70;335;2603;7452;2673;7787
250650;202002;924;2227;777;2028;12;36;685;1771;697;1807
250660;202002;1540;3852;1287;3524;38;105;1071;2857;1109;2962
250670;202002;2295;7206;2087;6832;44;197;1813;5827;1857;6024
250680;202002;5761;13272;5136;12567;59;225;4758;11486;4817;11711
250690;202002;6734;15209;5726;13958;93;238;5089;12279;5182;12517
250700;202002;4229;11883;3682;11049;417;1247;2593;7731;3010;8978
250710;202002;4368;12493;3746;11645;279;974;2744;8502;3023;9476
250720;202002;2702;7219;2422;6829;34;172;2132;5925;2166;6097
250730;202002;4086;10846;3573;10174;99;409;3004;8321;3103;8730
250740;202002;1895;4764;1571;4332;90;231;1222;3370;1312;3601
250750;202002;101792;250796;85868;228755;6948;20092;62365;162809;69313;182901
250760;202002;2327;6028;2034;5551;86;262;1615;4281;1701;4543
250770;202002;3971;12005;3555;11455;369;1190;2579;8352;2948;9542
250780;202002;1710;4625;1432;4111;55;194;1109;3102;1164;3296
250790;202002;2432;7241;2099;6739;138;562;1421;4435;1559;4997
250800;202002;2436;6472;2117;5958;85;181;1718;4873;1803;5054
250810;202002;1217;3289;996;2968;16;42;854;2563;870;2605
250820;202002;1937;5445;1788;5281;33;140;1638;4803;1671;4943
250830;202002;5742;17178;4711;15126;251;994;3281;10180;3532;11174
250840;202002;756;2386;646;2169;14;56;489;1646;503;1702
250850;202002;1758;5296;1573;4968;31;158;1301;4007;1332;4165
250855;202002;921;2735;803;2536;58;196;610;1905;668;2101
250860;202002;3113;9221;2579;8304;446;1510;1502;4834;1948;6344
250870;202002;1013;2798;852;2528;30;112;702;2060;732;2172
250880;202002;1584;4060;1302;3660;80;235;1001;2803;1081;3038
250890;202002;9915;26098;8751;24537;415;1799;6977;18523;7392;20322
250900;202002;2751;7703;2374;7020;59;232;2012;5817;2071;6049
250905;202002;2365;6740;2167;6462;45;172;1972;5861;2017;6033
250910;202002;5861;14607;4821;13433;82;288;4200;11749;4282;12037
250915;202002;2145;4984;1491;4278;24;53;1302;3825;1326;3878
250920;202002;3473;8770;3043;8114;321;740;2242;6000;2563;6740
250930;202002;2196;5902;1982;5629;57;238;1723;4781;1780;5019
250933;202002;1148;3426;1013;3183;22;116;783;2380;805;2496
250937;202002;692;1862;567;1654;21;66;433;1288;454;1354
250939;202002;1745;4658;1519;4359;65;202;1182;3379;1247;3581
250940;202002;3903;10540;3425;9912;19;73;3033;8788;3052;8861
250950;202002;1670;4279;1356;3883;25;108;1124;3177;1149;3285
250960;202002;1126;3274;985;3049;27;149;800;2373;827;2522
250970;202002;8203;21069;7175;19424;230;724;5951;15793;6181;16517
250980;202002;2402;6365;2151;5988;34;142;1854;5035;1888;5177
250990;202002;2004;6096;1664;5504;56;273;1230;4004;1286;4277
251000;202002;2014;5693;1631;5036;38;165;1330;4073;1368;4238
251010;202002;2594;7333;2342;6950;18;81;2136;6336;2154;6417
251020;202002;1616;4396;1447;4134;30;141;1262;3521;1292;3662
251030;202002;989;2625;805;2284;31;89;569;1593;600;1682
251040;202002;1794;5106;1512;4628;40;192;1220;3706;1260;3898
251050;202002;1028;2806;871;2506;43;148;634;1763;677;1911
251060;202002;1044;2257;798;1948;5;16;641;1533;646;1549
251065;202002;475;1297;366;1096;11;33;254;741;265;774
251070;202002;718;1862;609;1704;11;44;522;1431;533;1475
251080;202002;18224;46757;14811;41633;1740;5109;9741;27367;11481;32476
251090;202002;2764;7941;2318;7148;54;197;1860;5676;1914;5873
251100;202002;778;2489;697;2334;26;105;534;1718;560;1823
251110;202002;1682;4509;1427;4065;45;122;1084;3070;1129;3192
251120;202002;7156;20168;6016;18788;252;986;4805;14905;5057;15891
251130;202002;3852;8652;3399;8149;59;171;3079;7333;3138;7504
251140;202002;4204;11750;3768;11142;72;300;3165;9240;3237;9540
251150;202002;2605;7591;2338;7161;104;426;1915;5736;2019;6162
251160;202002;2092;6153;1813;5751;42;196;1557;4842;1599;5038
251170;202002;1545;4221;1346;3960;33;116;1166;3410;1199;3526
251180;202002;2608;6992;2130;6322;166;500;1450;4273;1616;4773
251190;202002;4346;11312;3967;10886;45;250;3608;9689;3653;9939
251200;202002;4293;12596;3786;11943;74;322;3337;10546;3411;10868
251203;202002;931;3032;855;2871;22;105;654;2128;676;2233
251207;202002;1067;2933;828;2532;18;95;579;1729;597;1824
251210;202002;7330;18836;5952;16987;252;613;4562;13276;4814;13889
251220;202002;1152;2804;907;2477;50;122;706;1965;756;2087
251230;202002;4566;12670;3928;11581;120;452;3119;8958;3239;9410
251240;202002;3530;9705;2969;8774;135;397;2262;6549;2397;6946
251250;202002;10120;27300;8844;25192;720;2183;6559;18055;7279;20238
251260;202002;472;1350;429;1283;12;62;344;993;356;1055
251270;202002;4206;13103;3775;12541;105;426;3105;10517;3210;10943
251272;202002;1331;3601;1201;3430;41;158;1005;2800;1046;2958
251274;202002;892;2470;710;2143;61;202;476;1365;537;1567
251275;202002;1190;3323;1015;3050;31;144;798;2316;829;2460
251276;202002;1298;3523;1129;3300;31;161;926;2602;957;2763
251278;202002;565;1568;503;1476;38;95;374;1126;412;1221
251280;202002;2206;6013;1967;5647;49;175;1653;4668;1702;4843
251290;202002;5779;13761;5221;13078;132;488;4578;11057;4710;11545
251300;202002;836;2480;753;2356;8;41;644;2006;652;2047
251310;202002;2672;7705;2326;7167;48;253;1870;5616;1918;5869
251315;202002;1667;5225;1525;4970;83;253;1155;3717;1238;3970
251320;202002;1573;4193;1115;3401;31;103;834;2508;865;2611
251330;202002;2063;4814;1693;4380;20;75;1535;3995;1555;4070
251335;202002;1033;3078;920;2901;23;97;801;2472;824;2569
251340;202002;3612;8769;2888;7806;109;337;2215;5936;2324;6273
251350;202002;1039;3020;932;2843;27;120;770;2298;797;2418
251360;202002;1782;5036;1429;4554;20;93;1229;3900;1249;3993
251365;202002;703;1925;555;1629;7;23;434;1263;441;1286
251370;202002;22824;60641;19509;55959;2318;6833;12498;36292;14816;43125
251380;202002;1193;3390;1043;3134;16;93;879;2568;895;2661
251385;202002;727;1879;559;1576;15;46;418;1132;433;1178
251390;202002;6327;18413;5550;17222;451;1466;3715;11489;4166;12955
251392;202002;940;2575;786;2350;22;102;617;1800;639;1902
251394;202002;596;1750;490;1561;18;80;367;1150;385;1230
251396;202002;655;1760;566;1610;15;42;400;1115;415;1157
251398;202002;911;2310;646;1860;11;50;489;1374;500;1424
251400;202002;1184;2927;957;2617;27;97;763;2017;790;2114
251410;202002;1441;3441;1182;3071;18;77;1013;2534;1031;2611
251420;202002;1873;4961;1512;4545;38;148;1198;3551;1236;3699
251430;202002;1496;4621;1344;4358;27;130;1164;3775;1191;3905
251440;202002;1095;3075;883;2678;37;102;700;2135;737;2237
251445;202002;1497;4225;1379;4068;28;117;1176;3394;1204;3511
251450;202002;4427;12990;3934;12262;84;342;3283;10134;3367;10476
251455;202002;834;2544;759;2415;22;100;601;1873;623;1973
251460;202002;869;2513;760;2342;16;59;636;1962;652;2021
251465;202002;427;1257;364;1142;5;20;276;850;281;870
251470;202002;1150;3195;859;2595;67;220;503;1441;570;1661
251480;202002;964;2557;788;2245;18;78;614;1667;632;1745
251490;202002;1860;4897;1476;4367;54;170;1098;3242;1152;3412
251500;202002;1916;5411;1758;5202;26;94;1602;4739;1628;4833
251510;202002;2622;7865;2161;6949;112;422;1466;4584;1578;5006
251520;202002;948;2500;717;2075;61;175;475;1337;536;1512
251530;202002;14520;34908;11657;31341;105;590;10331;27224;10436;27814
251540;202002;2865;8384;2582;7846;78;286;2131;6380;2209;6666
251550;202002;3667;8785;2932;7864;98;207;2449;6619;2547;6826
251560;202002;542;1637;473;1529;59;203;327;1023;386;1226
251570;202002;927;2608;751;2259;19;88;600;1745;619;1833
251580;202002;1869;4424;1665;4128;38;150;1460;3479;1498;3629
251590;202002;1543;3867;1290;3581;51;145;1082;2922;1133;3067
251593;202002;866;2556;785;2422;80;258;516;1561;596;1819
251597;202002;2088;5868;1881;5594;20;99;1668;4897;1688;4996
251600;202002;6312;17085;5517;15887;154;515;4594;12993;4748;13508
251610;202002;3188;9062;2729;8203;250;695;1896;5803;2146;6498
251615;202002;1218;3057;977;2694;21;57;792;2119;813;2176
251620;202002;18482;43087;14221;37884;112;380;12142;32797;12254;33177
251630;202002;4654;10963;3754;9731;198;535;2850;7318;3048;7853
251640;202002;2103;5759;1864;5383;26;128;1621;4570;1647;4698
251650;202002;3904;10523;3426;9889;116;375;2928;8427;3044;8802
251660;202002;3432;10304;3015;9581;75;354;2518;7843;2593;8197
251670;202002;3933;11229;3503;10612;44;232;3132;9400;3176;9632
251675;202002;640;1837;577;1759;75;229;383;1181;458;1410
251680;202002;2469;6585;2059;6053;42;143;1669;4943;1711;5086
251690;202002;3074;8640;2586;7793;88;276;1943;5783;2031;6059
251700;202002;2031;5829;1710;5428;38;185;1460;4551;1498;4736
251710;202002;772;2001;518;1482;40;140;307;844;347;984
251720;202002;1285;3633;1037;3203;22;98;797;2391;819;2489
251740;202002;609;1712;490;1484;40;134;334;983;374;1117
260005;202002;29287;61783;24007;55079;1576;3582;18647;41888;20223;45470
260010;202002;10079;26532;8281;23646;444;1359;4981;14224;5425;15583
260020;202002;6661;15751;5690;14366;109;500;4815;11919;4924;12419
260030;202002;6642;17113;5574;15589;140;440;4535;12569;4675;13009
260040;202002;7505;19638;6259;17809;459;1236;4383;12718;4842;13954
260050;202002;13731;35831;11361;33215;150;702;10461;30543;10611;31245
260060;202002;3931;9881;3380;8987;183;456;2686;7140;2869;7596
260070;202002;10349;26142;8836;23951;331;1159;7091;18729;7422;19888
260080;202002;6428;14687;5639;13649;115;372;4748;11247;4863;11619
260090;202002;4612;11919;4086;11207;467;1316;2886;7895;3353;9211
260100;202002;2989;8089;2492;7358;52;255;2047;5937;2099;6192
260105;202002;4911;13405;4381;12728;125;442;3708;10609;3833;11051
260110;202002;22037;61001;19595;57451;940;3235;16157;46687;17097;49922
260120;202002;14236;38042;11920;34594;1460;4176;7595;22385;9055;26561
260130;202002;3016;7811;2699;7353;222;613;2005;5367;2227;5980
260140;202002;12739;29019;10957;26888;533;1483;9200;22225;9733;23708
260150;202002;3558;8258;3046;7627;84;256;2683;6642;2767;6898
260160;202002;6409;16856;5419;15652;86;330;4872;14193;4958;14523
260170;202002;19234;46222;16244;42195;901;2377;12937;33163;13838;35540
260180;202002;3436;9201;2978;8577;72;274;2559;7252;2631;7526
260190;202002;17996;36198;15059;32832;155;427;13445;28614;13600;29041
260200;202002;11026;26463;9475;24492;436;1009;7947;20793;8383;21802
260210;202002;11722;33168;9893;30215;311;1209;7906;23909;8217;25118
260220;202002;10163;24605;9385;23637;158;541;8309;20582;8467;21123
260230;202002;10565;26034;9194;24226;190;643;7785;20101;7975;20744
260240;202002;2634;7939;2301;7309;112;396;1786;5601;1898;5997
260250;202002;2147;5690;1869;5257;120;280;1424;3998;1544;4278
260260;202002;12755;33237;11319;31046;371;1257;8996;24120;9367;25377
260270;202002;4125;10101;3628;9495;139;527;3020;7740;3159;8267
260280;202002;12568;37998;11264;36163;452;1960;9593;30335;10045;32295
260290;202002;39453;100336;33854;92266;3630;10085;23070;62584;26700;72669
260300;202002;9521;25759;8250;24057;194;880;6948;20155;7142;21035
260310;202002;4985;12915;4375;12146;294;779;3410;9550;3704;10329
260320;202002;7571;21806;6395;19816;253;818;5225;16178;5478;16996
260330;202002;2517;7751;2200;7126;65;248;1769;5559;1834;5807
260340;202002;2020;5399;1741;4981;27;122;1492;4178;1519;4300
260345;202002;24587;63961;20469;57983;3017;9140;10918;30367;13935;39507
260350;202002;5400;12846;4692;12026;74;221;4165;10607;4239;10828
260360;202002;2487;6499;2211;6057;44;207;1581;4164;1625;4371
260370;202002;5461;15696;4701;14412;229;819;3639;11045;3868;11864
260380;202002;4841;14415;4125;13244;145;543;3110;9824;3255;10367
260390;202002;4430;13279;3682;11745;208;668;2495;7816;2703;8484
260392;202002;3282;10596;2953;10178;117;695;2378;8200;2495;8895
260400;202002;17366;40510;14926;37337;465;1346;11750;28277;12215;29623
260410;202002;71279;173435;54874;150769;9710;27957;24967;70309;34677;98266
260415;202002;4456;12076;3850;11063;64;267;3145;8896;3209;9163
260420;202002;12533;26158;10642;24056;109;319;9844;22030;9953;22349
260430;202002;2688;8397;2313;7663;97;395;1654;5426;1751;5821
260440;202002;3645;9547;3213;8868;67;251;2701;7319;2768;7570
260450;202002;5650;14293;5054;13536;283;599;4164;11352;4447;11951
260460;202002;5126;15296;4370;13952;475;1698;2618;8199;3093;9897
260470;202002;4878;12919;4122;12041;84;211;3774;11172;3858;11383
260480;202002;3946;10515;3296;9593;205;760;2307;6683;2512;7443
260490;202002;5288;12174;4685;11284;36;143;4264;10082;4300;10225
260500;202002;6028;15170;5168;13956;445;1133;3649;9967;4094;11100
260510;202002;9535;23660;7978;21505;115;464;7046;18802;7161;19266
260515;202002;4112;11283;3183;9528;138;425;2154;6251;2292;6676
260520;202002;16986;39311;14803;36538;777;1882;12062;29355;12839;31237
260530;202002;9606;27540;8178;25333;151;737;7024;21419;7175;22156
260540;202002;7129;15445;6286;14376;154;352;5642;12806;5796;13158
260545;202002;51;157;22;81;2;7;8;23;10;30
260550;202002;3000;8345;2458;7465;116;470;1660;4916;1776;5386
260560;202002;5863;15037;4958;13742;124;494;4177;11340;4301;11834
260570;202002;7643;20794;6717;19539;377;1213;5296;15438;5673;16651
260580;202002;4421;10518;3969;9926;19;72;3660;9119;3679;9191
260590;202002;6634;15435;5578;14258;211;524;4666;12037;4877;12561
260600;202002;30339;78623;24529;69771;1071;3448;18590;51859;19661;55307
260610;202002;7128;18428;6389;17463;382;1140;4825;13069;5207;14209
260620;202002;15987;41604;13940;38658;1262;3967;10107;27449;11369;31416
260630;202002;2362;6383;1926;5685;33;143;1558;4487;1591;4630
260640;202002;21118;47992;17662;44035;819;2033;14211;35226;15030;37259
260650;202002;5958;15663;4706;14141;149;608;4031;12012;4180;12620
260660;202002;6976;18483;6022;17205;144;657;5164;14415;5308;15072
260670;202002;2141;5645;1797;5121;70;168;1335;3765;1405;3933
260680;202002;27472;65679;23006;59350;1601;4417;16242;41039;17843;45456
260690;202002;3453;9029;2868;8132;92;357;2254;6330;2346;6687
260700;202002;6029;17459;5653;17025;21;72;5467;16588;5488;16660
260710;202002;1323;3512;1146;3263;36;139;896;2550;932;2689
260720;202002;22132;56122;19343;52309;1887;5268;14061;37615;15948;42883
260730;202002;7477;21677;6543;20361;266;1026;5443;16652;5709;17678
260740;202002;1304;3701;1102;3374;11;62;885;2776;896;2838
260750;202002;6917;19192;5799;17784;108;368;5193;16151;5301;16519
260760;202002;5595;13259;4799;12317;182;511;3942;10146;4124;10657
260765;202002;7886;22800;6836;21362;408;1745;4861;14785;5269;16530
260770;202002;3791;9689;3176;8675;103;347;2507;6742;2610;7089
260775;202002;5173;13762;4529;12794;190;709;3530;9606;3720;10315
260780;202002;3551;10550;3159;9923;281;1057;2041;6204;2322;7261
260790;202002;117415;262624;96787;236029;14657;34582;60143;146881;74800;181463
260795;202002;2962;7623;2532;7057;81;276;1981;5548;2062;5824
260800;202002;5339;12431;4763;11646;130;410;4169;9864;4299;10274
260805;202002;3570;10136;3000;9128;157;560;2254;6730;2411;7290
260810;202002;6432;17439;5639;15917;470;1261;4073;11263;4543;12524
260820;202002;4375;10265;3845;9648;101;359;3215;7911;3316;8270
260825;202002;2882;8618;2505;7963;106;388;1867;5849;1973;6237
260830;202002;4163;12083;3453;10789;438;1196;2215;7144;2653;8340
260840;202002;4110;10799;3680;10198;202;529;3055;8492;3257;9021
260845;202002;4227;11217;3769;10424;226;625;2827;7731;3053;8356
260850;202002;4910;13533;4087;11941;326;1022;2665;7535;2991;8557
260860;202002;3453;9752;2921;8825;96;348;2336;6867;2432;7215
260870;202002;4502;10829;3843;10018;70;271;3427;8797;3497;9068
260875;202002;6916;17079;5664;15256;570;1526;3857;10445;4427;11971
260880;202002;9653;27025;8364;24789;479;1429;6575;19455;7054;20884
260890;202002;12928;33198;11184;30555;600;1765;8182;21791;8782;23556
260900;202002;5223;14643;4292;13325;311;1047;2882;8859;3193;9906
260910;202002;3158;8610;2728;7953;90;286;2155;6239;2245;6525
260915;202002;5120;15059;4492;14332;50;264;4109;13094;4159;13358
260920;202002;3226;8070;2710;7514;80;226;2324;6495;2404;6721
260930;202002;3692;11619;3145;10636;175;719;2328;7684;2503;8403
260940;202002;14436;34510;12549;31902;950;2378;9482;23741;10432;26119
260950;202002;6710;17995;5418;15770;356;1215;3481;9707;3837;10922
260960;202002;68694;153578;55001;136001;6044;15431;35055;85458;41099;100889
260970;202002;5421;14378;4826;13573;225;533;3681;10445;3906;10978
260980;202002;4459;13059;3941;12405;54;204;3597;11415;3651;11619
260990;202002;17730;49131;14934;45348;854;2890;11596;34851;12450;37741
261000;202002;16029;37803;13442;34497;368;1338;10872;27198;11240;28536
261010;202002;2369;6195;2072;5801;73;192;1808;5081;1881;5273
261020;202002;6053;16474;5198;15002;186;700;4206;11650;4392;12350
261030;202002;3979;11485;3450;10587;127;533;2745;8159;2872;8692
261040;202002;5154;15064;4136;13126;155;623;3091;9550;3246;10173
261050;202002;7643;20004;6940;18896;437;898;5271;14438;5708;15336
261060;202002;14014;35077;12181;32858;270;894;10148;27088;10418;27982
261070;202002;62583;136401;51795;122218;2632;6198;39771;91855;42403;98053
261080;202002;6572;15857;5991;15128;134;349;5513;13883;5647;14232
261090;202002;18556;44413;16477;41749;283;1009;14405;35859;14688;36868
261100;202002;8208;22817;7101;21200;486;1581;5202;15490;5688;17071
261110;202002;62443;174940;52074;156377;7622;24012;30164;89901;37786;113913
261120;202002;3674;9193;3165;8503;88;223;2725;7339;2813;7562
261130;202002;7223;17688;6335;16490;120;371;5618;14501;5738;14872
261140;202002;3611;8339;3206;7803;169;439;2571;6150;2740;6589
261150;202002;5304;13843;4684;12908;73;279;4075;11103;4148;11382
261153;202002;1866;5623;1593;5090;57;207;1092;3507;1149;3714
261160;202002;205425;477773;165558;422662;40324;106053;69082;179212;109406;285265
261170;202002;5960;14868;5294;13869;324;775;4217;10982;4541;11757
261180;202002;9467;23611;8270;22047;429;1143;6038;16107;6467;17250
261190;202002;4451;13122;3977;12337;200;854;3092;9284;3292;10138
261200;202002;3307;7648;2961;7185;125;330;2493;5935;2618;6265
261210;202002;1883;4548;1593;4142;60;179;1345;3425;1405;3604
261220;202002;13607;38465;11243;34115;1405;4620;6465;19213;7870;23833
261230;202002;3993;11487;3345;10578;54;223;2785;8871;2839;9094
261240;202002;5248;13162;4605;12157;248;654;3806;9916;4054;10570
261245;202002;3523;9990;2969;9015;74;355;2365;6956;2439;7311
261247;202002;2839;8532;2354;7660;143;519;1628;5256;1771;5775
261250;202002;21869;50142;18906;46698;1653;3672;14399;36434;16052;40106
261255;202002;4044;11901;3281;10412;137;601;2402;7379;2539;7980
261260;202002;12573;33962;10856;31749;332;1396;9356;26930;9688;28326
261270;202002;4325;10810;3789;10117;181;542;3150;8257;3331;8799
261280;202002;2533;7048;2220;6518;69;253;1775;5071;1844;5324
261290;202002;2928;7544;2452;7002;66;274;1987;5707;2053;5981
261300;202002;11997;33760;10082;30505;581;2099;7325;21630;7906;23729
261310;202002;8667;22068;7377;20307;638;1985;5403;14482;6041;16467
261320;202002;5862;16670;5105;15422;85;378;4292;12754;4377;13132
261330;202002;5811;14236;5242;13496;126;456;4565;11522;4691;11978
261340;202002;4139;11686;3563;10939;142;523;2922;8881;3064;9404
261350;202002;8732;25399;7748;23766;121;565;6332;19108;6453;19673
261360;202002;8102;19570;6848;17815;232;696;5477;13820;5709;14516
261370;202002;23067;57816;19347;52732;2080;5629;12564;34343;14644;39972
261380;202002;4008;12146;3532;11314;440;1504;2320;7307;2760;8811
261390;202002;16172;46069;13593;41887;1139;3869;9080;27730;10219;31599
261400;202002;4582;14549;3969;13239;159;726;2986;9694;3145;10420
261410;202002;9381;23473;7686;20855;490;1388;5991;15916;6481;17304
261420;202002;7260;21784;6525;20884;778;2897;4598;14588;5376;17485
261430;202002;3409;9612;2864;8749;59;253;2380;7163;2439;7416
261440;202002;1459;4334;1219;3868;37;183;878;2647;915;2830
261450;202002;14840;40121;13121;37426;199;744;10868;31012;11067;31756
261460;202002;7397;20466;6547;19147;182;669;5396;15614;5578;16283
261470;202002;4149;10355;3619;9665;23;123;3130;8320;3153;8443
261480;202002;5005;15371;4307;14199;191;798;3347;10768;3538;11566
261485;202002;4906;13951;4217;12874;337;1105;3004;9028;3341;10133
261500;202002;5821;14950;5087;13970;373;912;3556;10107;3929;11019
261510;202002;1842;5532;1594;5118;62;232;1195;3892;1257;4124
261520;202002;2332;7153;2098;6669;71;257;1532;4856;1603;5113
261530;202002;11786;34572;9443;30381;951;3658;4765;14542;5716;18200
261540;202002;8042;22973;7216;21805;1051;3152;4129;13099;5180;16251
261550;202002;3596;9567;3108;8798;214;668;2241;6209;2455;6877
261560;202002;7752;22969;6681;21401;287;1087;5154;16466;5441;17553
261570;202002;3465;9300;2760;8171;197;695;1901;5504;2098;6199
261580;202002;6542;17339;5702;16214;111;544;5108;14295;5219;14839
261590;202002;2643;6768;2101;6013;70;225;1592;4497;1662;4722
261600;202002;5037;12818;4222;11597;316;771;2940;8296;3256;9067
261610;202002;2167;6114;1750;5373;85;327;1204;3651;1289;3978
261618;202002;2485;6242;2158;5771;53;165;1769;4671;1822;4836
261620;202002;4121;11586;3760;11071;847;2225;2325;7219;3172;9444
261630;202002;6277;17581;5317;15769;366;1296;3564;10137;3930;11433
261640;202002;36952;82810;31437;76026;1745;3434;23921;59418;25666;62852
261650;202002;4108;10185;3506;9385;153;489;2639;6997;2792;7486
270010;202002;4243;14272;3643;13238;161;919;2897;10218;3058;11137
270020;202002;3810;9587;3323;8967;135;462;2839;7478;2974;7940
270030;202002;32429;88146;27045;79532;3547;10191;18030;53203;21577;63394
270040;202002;10738;28910;9209;27108;359;1410;7649;22278;8008;23688
270050;202002;5475;12657;4665;11753;214;519;4096;10342;4310;10861
270060;202002;2049;5239;1697;4844;116;298;1382;3995;1498;4293
270070;202002;4605;12972;4009;12135;147;554;3361;9965;3508;10519
270080;202002;1413;3857;1179;3467;43;133;909;2564;952;2697
270090;202002;1748;5356;1568;5004;66;285;1280;3979;1346;4264
270100;202002;5428;14376;4672;13283;154;599;3885;10799;4039;11398
270110;202002;3171;7499;2551;6776;120;307;2043;5642;2163;5949
270120;202002;2761;7494;2389;6999;69;308;2022;5826;2091;6134
270130;202002;5070;13055;4388;12244;124;404;3786;10578;3910;10982
270135;202002;1997;4803;1692;4466;49;156;1522;3993;1571;4149
270140;202002;9612;22322;7668;19640;309;1077;6068;14786;6377;15863
270150;202002;2674;8047;2452;7729;4;28;2318;7284;2322;7312
270160;202002;6097;16618;5158;15559;55;316;4779;14370;4834;14686
270170;202002;3343;9801;2807;9069;181;868;2135;6581;2316;7449
270180;202002;2210;6834;2011;6578;40;196;1806;5864;1846;6060
270190;202002;1625;4858;1439;4626;38;193;1259;4004;1297;4197
270200;202002;2351;7137;2038;6715;114;443;1500;4888;1614;5331
270210;202002;5680;13391;4838;12452;78;326;4445;11257;4523;11583
270220;202002;1420;3752;1121;3331;194;598;638;1874;832;2472
270230;202002;9077;25309;7483;22841;624;2119;5338;16096;5962;18215
270235;202002;5601;17249;4828;16013;121;545;3982;13054;4103;13599
270240;202002;10375;28558;8364;25782;846;2917;5987;18331;6833;21248
270250;202002;2691;6843;2353;6353;189;499;1846;4994;2035;5493
270255;202002;4392;12601;3406;10796;107;445;2598;8086;2705;8531
270260;202002;5537;16287;5018;15436;96;494;4405;13222;4501;13716
270270;202002;1030;2665;853;2444;103;307;626;1773;729;2080
270280;202002;3925;9317;3097;8279;473;763;2174;6271;2647;7034
270290;202002;7351;23436;6580;22152;179;847;5705;18989;5884;19836
270300;202002;4130;10721;3188;9727;143;393;2515;7798;2658;8191
270310;202002;6872;19248;5905;17764;106;558;5036;14751;5142;15309
270320;202002;5486;16079;4771;14702;453;1444;3353;10092;3806;11536
270330;202002;3806;12470;3380;11813;264;1067;2585;8989;2849;10056
270340;202002;1589;4308;1372;4026;49;153;1164;3368;1213;3521
270350;202002;1806;4328;1480;3943;147;446;1034;2759;1181;3205
270360;202002;2544;6469;2263;6154;70;182;2079;5660;2149;5842
270370;202002;1324;4161;1209;3938;38;187;1003;3206;1041;3393
270375;202002;3067;7168;2533;6586;18;51;2386;6202;2404;6253
270380;202002;5384;15339;4526;14240;609;1879;2919;9528;3528;11407
270390;202002;1191;3001;973;2751;23;100;801;2253;824;2353
270400;202002;6132;16236;5127;14719;226;675;4023;11388;4249;12063
270410;202002;4544;13093;3916;12120;158;562;3253;10011;3411;10573
270420;202002;5434;16135;4881;15329;123;599;4230;13022;4353;13621
270430;202002;131711;313335;103465;277372;20628;57443;49538;134841;70166;192284
270440;202002;4690;12666;4039;11861;88;387;3511;10162;3599;10549
270450;202002;6834;18484;6002;17486;237;854;5070;14783;5307;15637
270460;202002;3764;8310;3234;7692;140;302;2917;6912;3057;7214
270470;202002;10878;30387;9410;28288;652;2192;7242;21709;7894;23901
270480;202002;2896;7704;2445;7069;101;398;1988;5592;2089;5990
270490;202002;938;2606;815;2456;49;162;652;1949;701;2111
270500;202002;4825;14852;4274;13940;286;1092;3325;10682;3611;11774
270510;202002;5503;14615;4646;13521;332;1342;3466;9601;3798;10943
270520;202002;3786;10866;2957;9457;634;2090;1216;4023;1850;6113
270530;202002;1207;3483;1038;3234;53;157;748;2357;801;2514
270540;202002;2167;6284;1864;5898;61;297;1611;4978;1672;5275
270550;202002;6607;17071;5263;15609;556;1347;3982;12251;4538;13598
270560;202002;2917;7621;2516;7089;136;442;2031;5653;2167;6095
270570;202002;4044;11354;3422;10427;104;357;2789;8451;2893;8808
270580;202002;2233;6339;2027;6037;92;286;1758;5186;1850;5472
270590;202002;1592;4793;1466;4632;16;84;1384;4343;1400;4427
270600;202002;2703;8373;2451;7996;51;269;2179;7008;2230;7277
270610;202002;3613;9471;3100;8800;70;265;2778;7797;2848;8062
270620;202002;1188;3673;1079;3463;33;150;926;2878;959;3028
270630;202002;17251;42117;14809;38763;553;1778;12506;31998;13059;33776
270640;202002;5303;15258;4581;14098;158;659;3733;11230;3891;11889
270642;202002;2460;7932;2177;7470;154;679;1680;5608;1834;6287
270644;202002;3562;8867;2916;8027;266;654;2197;6204;2463;6858
270650;202002;3069;9037;2683;8490;361;1228;1877;5872;2238;7100
270660;202002;2009;5096;1665;4601;81;304;1248;3389;1329;3693
270670;202002;15915;36863;13198;33562;387;1222;11262;27963;11649;29185
270680;202002;5359;12977;4767;12329;116;165;4459;11696;4575;11861
270690;202002;8728;21721;7238;19878;536;1422;5603;15399;6139;16821
270700;202002;508;1526;445;1422;29;122;328;1027;357;1149
270710;202002;5371;16239;4755;15299;218;943;3848;12125;4066;13068
270720;202002;3482;10356;3071;9657;64;345;2697;8321;2761;8666
270730;202002;8055;17931;7045;16844;214;431;5590;14756;5804;15187
270740;202002;2329;6100;2052;5771;93;323;1713;4731;1806;5054
270750;202002;5556;14820;4847;13915;91;421;4282;12200;4373;12621
270760;202002;3245;9171;2808;8585;52;269;2385;7204;2437;7473
270770;202002;20225;49355;16090;44375;2473;6163;10192;29564;12665;35727
270780;202002;1680;4883;1543;4684;99;372;1246;3716;1345;4088
270790;202002;1542;4331;1280;3966;92;299;927;2853;1019;3152
270800;202002;10584;29176;9483;27609;334;1235;8142;23301;8476;24536
270810;202002;3266;9348;2563;8149;174;679;1794;5585;1968;6264
270820;202002;1623;4875;1370;4464;52;246;1073;3406;1125;3652
270830;202002;5127;12216;4133;11001;166;560;3350;8763;3516;9323
270840;202002;8110;24213;7224;22967;177;1013;6362;19647;6539;20660
270850;202002;8938;21244;7889;19995;617;1816;6552;16253;7169;18069
270860;202002;13958;31154;11006;27779;590;1414;8891;22373;9481;23787
270870;202002;2098;5949;1733;5345;225;685;1147;3604;1372;4289
270880;202002;7996;23925;7116;22603;219;944;5918;18458;6137;19402
270890;202002;2741;7458;2305;6836;177;549;1619;4793;1796;5342
270895;202002;3026;9442;2760;9086;72;390;2434;7856;2506;8246
270900;202002;1798;4629;1352;3908;40;114;1055;3043;1095;3157
270910;202002;3824;11098;3273;10237;97;338;2664;8210;2761;8548
270915;202002;9185;26433;7429;23530;638;2385;5077;15667;5715;18052
270920;202002;5013;15711;4529;14871;161;795;3718;11802;3879;12597
270930;202002;16879;39340;13057;34897;1817;4423;8862;24715;10679;29138
270940;202002;6399;16952;5462;15835;184;904;4444;12485;4628;13389
280010;202002;676;1870;529;1553;15;61;376;987;391;1048
280020;202002;4706;11991;4010;10901;477;1178;2698;7446;3175;8624
280030;202002;72758;171399;57058;149304;12165;32134;25509;69467;37674;101601
280040;202002;2882;8092;2512;7533;250;795;1697;5011;1947;5806
280050;202002;3774;10764;3251;9930;537;1728;1946;5912;2483;7640
280060;202002;5574;14741;4446;13016;822;2539;2140;6506;2962;9045
280067;202002;6736;16769;5713;15253;304;834;4221;11049;4525;11883
280070;202002;1915;5645;1782;5436;126;391;1471;4459;1597;4850
280100;202002;3906;10470;3280;9468;313;944;2267;6506;2580;7450
280110;202002;1368;3720;1195;3465;18;85;1048;2960;1066;3045
280120;202002;7396;21570;6607;20314;708;2047;4890;15283;5598;17330
280130;202002;8996;21133;7872;19538;432;1137;6360;15667;6792;16804
280140;202002;5386;12921;4734;12060;190;577;4041;10154;4231;10731
280150;202002;4109;10387;3554;9636;283;721;2783;7549;3066;8270
280160;202002;1205;3431;1004;3095;93;323;693;2075;786;2398
280170;202002;5142;13543;4589;12817;222;618;3707;10356;3929;10974
280190;202002;1234;2745;1068;2524;53;136;865;2002;918;2138
280200;202002;1235;3248;1007;2921;78;282;744;2112;822;2394
280210;202002;16097;40510;13981;37490;1523;4268;9048;24159;10571;28427
280220;202002;1734;4650;1484;4312;44;214;1222;3510;1266;3724
280230;202002;4191;10589;3525;9619;271;660;2543;6964;2814;7624
280240;202002;3285;8786;2946;8276;54;281;2532;6882;2586;7163
280250;202002;876;2165;710;1913;65;198;471;1226;536;1424
280260;202002;2122;5199;1893;4924;33;93;1725;4518;1758;4611
280270;202002;2275;6306;2022;5922;112;375;1688;4852;1800;5227
280280;202002;4155;12358;3695;11688;466;1270;2613;8648;3079;9918
280290;202002;17720;46886;15167;43298;1316;4042;10241;29399;11557;33441
280300;202002;11552;28389;10045;26792;285;836;7669;22144;7954;22980
280310;202002;1373;3512;1131;3105;33;115;855;2273;888;2388
280320;202002;8475;22900;7363;21242;859;2497;4968;14172;5827;16669
280330;202002;4571;11349;3858;10382;257;713;2861;7618;3118;8331
280340;202002;5358;11243;4471;10291;196;358;3914;9139;4110;9497
280350;202002;25421;59783;22253;55593;1093;2986;17555;43084;18648;46070
280360;202002;5611;15559;4896;14378;741;2206;2907;8639;3648;10845
280370;202002;2113;5240;1766;4663;56;159;1406;3639;1462;3798
280380;202002;955;2586;812;2392;68;200;559;1666;627;1866
280390;202002;3608;8929;3013;7980;124;335;2428;6367;2552;6702
280400;202002;3827;9718;3287;8968;491;1193;2021;5806;2512;6999
280410;202002;2192;6069;1768;5381;195;610;1040;3102;1235;3712
280420;202002;4266;11438;3911;10987;74;288;3589;10014;3663;10302
280430;202002;2024;4910;1762;4568;65;260;1435;3589;1500;3849
280440;202002;4162;11195;3650;10443;145;504;3076;8596;3221;9100
280445;202002;2264;5736;2011;5294;48;148;1529;3860;1577;4008
280450;202002;10180;23455;8893;21746;935;1916;6238;15784;7173;17700
280460;202002;6804;16176;6153;15267;343;833;5235;12840;5578;13673
280470;202002;1667;4746;1438;4336;59;210;1064;3128;1123;3338
280480;202002;41939;102069;36107;93863;2899;8179;25791;65502;28690;73681
280490;202002;3605;10260;3119;9437;98;429;2432;7103;2530;7532
280500;202002;980;2357;839;2168;32;117;707;1788;739;1905
280510;202002;2484;6388;2156;5918;74;286;1678;4483;1752;4769
280520;202002;1579;4054;1387;3791;57;165;1115;2999;1172;3164
280530;202002;2441;6107;2098;5636;288;652;1471;4075;1759;4727
280540;202002;8870;23850;8050;22648;258;904;7044;19526;7302;20430
280550;202002;6513;15231;5330;13564;195;698;4367;10704;4562;11402
280560;202002;7048;19745;6579;19049;132;527;5808;16594;5940;17121
280570;202002;6387;15523;5175;13997;209;672;3908;10462;4117;11134
280580;202002;5520;14835;4762;13692;562;1468;3336;9753;3898;11221
280590;202002;2888;6495;2455;6003;105;393;1963;4587;2068;4980
280600;202002;3541;9393;3121;8800;164;524;2253;6352;2417;6876
280610;202002;2415;5956;2176;5593;136;344;1794;4588;1930;4932
280620;202002;5301;13073;4535;12072;398;883;3208;8891;3606;9774
280630;202002;3748;10615;3429;10159;165;596;2817;8249;2982;8845
280640;202002;2343;6323;2067;6008;59;191;1836;5329;1895;5520
280650;202002;1151;3029;927;2697;86;291;680;1897;766;2188
280660;202002;3592;7949;3085;7344;191;383;2586;6235;2777;6618
280670;202002;19394;43714;16704;40317;870;2229;13415;32090;14285;34319
280680;202002;2742;6571;2349;6018;222;413;1698;4427;1920;4840
280690;202002;895;2256;755;2067;31;100;585;1575;616;1675
280700;202002;1158;2907;1000;2672;26;99;790;2070;816;2169
280710;202002;15115;34107;12733;31428;489;967;10886;27460;11375;28427
280720;202002;2585;5921;2155;5415;63;207;1543;4024;1606;4231
280730;202002;1027;2648;922;2472;40;127;715;1859;755;1986
280740;202002;13873;33922;11807;30776;728;2054;8535;21718;9263;23772
280750;202002;3544;9931;3086;9150;180;607;2222;6457;2402;7064
280760;202002;6260;16814;5445;15541;546;1420;3655;10756;4201;12176
290010;202002;3154;6624;2054;4916;7;25;1680;3836;1687;3861
290020;202002;5361;14242;4853;13587;340;661;4080;11825;4420;12486
290030;202002;4430;10289;3580;9354;157;388;3047;8029;3204;8417
290035;202002;5041;11052;4164;9912;377;580;3280;8182;3657;8762
290040;202002;4143;10187;3519;9437;113;301;2807;7856;2920;8157
290050;202002;2006;6449;1683;5749;114;466;1136;3780;1250;4246
290060;202002;1305;3154;949;2588;73;234;626;1673;699;1907
290070;202002;36475;79932;31275;73518;1714;4216;24435;56710;26149;60926
290080;202002;5268;15442;4497;14296;451;1572;3168;10117;3619;11689
290090;202002;2140;4115;1501;3438;15;51;1374;3114;1389;3165
290100;202002;9702;25366;7844;22580;1280;3463;4265;12860;5545;16323
290110;202002;5171;13657;4588;12743;329;945;3321;9123;3650;10068
290115;202002;3853;11206;3235;10103;210;725;2427;7515;2637;8240
290120;202002;6405;15911;5403;14541;136;468;4634;12242;4770;12710
290130;202002;4712;11401;3667;10044;164;472;2849;7778;3013;8250
290135;202002;4173;9801;3406;8551;194;505;2633;6414;2827;6919
290140;202002;4494;11792;3454;10401;98;380;2911;8703;3009;9083
290150;202002;2426;6295;2093;5877;132;368;1631;4604;1763;4972
290160;202002;3213;7514;2823;6978;305;636;2164;5418;2469;6054
290170;202002;3345;8461;2961;8038;111;306;2641;7232;2752;7538
290180;202002;2925;8030;2424;7205;83;295;1973;5816;2056;6111
290190;202002;4153;11828;3638;11142;142;623;2994;9006;3136;9629
290195;202002;2333;5777;1862;5154;28;146;1574;4310;1602;4456
290200;202002;4058;11280;3298;10013;200;683;2497;7512;2697;8195
290205;202002;3388;8780;2973;8164;121;439;2322;6143;2443;6582
290210;202002;12902;35959;11401;33695;871;2347;8816;26461;9687;28808
290220;202002;2829;7066;2482;6624;118;327;2040;5419;2158;5746
290225;202002;3231;6895;2493;6117;161;280;2075;5199;2236;5479
290230;202002;2424;6419;2206;6157;31;95;1995;5556;2026;5651
290240;202002;3675;9292;2916;8325;70;260;2469;7004;2539;7264
290250;202002;3879;11409;3257;10481;107;375;2691;8761;2798;9136
290260;202002;5216;13065;4323;11771;164;578;3565;9453;3729;10031
290265;202002;3392;10000;2750;8771;162;591;1999;6295;2161;6886
290270;202002;10989;37321;10256;36074;521;2298;8282;28809;8803;31107
290280;202002;5906;17734;5126;16207;287;1031;3720;11607;4007;12638
290290;202002;9771;28495;7891;25023;778;2680;5184;16211;5962;18891
290300;202002;4214;11419;3088;9290;156;518;2216;6625;2372;7143
290310;202002;1563;3874;1244;3483;55;230;960;2606;1015;2836
290320;202002;23838;62301;18774;54513;4153;11841;8960;27379;13113;39220
290323;202002;3758;10200;3262;9435;102;326;2585;7442;2687;7768
290327;202002;4065;11850;3452;10660;247;715;2465;7559;2712;8274
290330;202002;2188;4612;1703;4088;46;83;1506;3667;1552;3750
290340;202002;5638;14173;4315;12556;439;1319;3120;9179;3559;10498
290350;202002;4656;12910;3846;11538;260;791;2778;8379;3038;9170
290360;202002;4980;13138;4370;12337;129;375;3789;10764;3918;11139
290370;202002;5237;12754;3827;10909;164;418;2779;8078;2943;8496
290380;202002;5523;14767;4645;13566;115;291;4011;11916;4126;12207
290390;202002;14425;40844;11964;36994;1256;3800;7874;24761;9130;28561
290395;202002;2795;8160;2237;7194;69;323;1728;5439;1797;5762
290400;202002;3737;10035;2987;8805;78;347;2291;6547;2369;6894
290405;202002;4551;13377;3871;12218;287;957;2696;8649;2983;9606
290410;202002;5674;15542;4349;13402;105;511;3320;9912;3425;10423
290420;202002;2955;8277;2438;7465;72;263;1884;5713;1956;5976
290430;202002;3087;8531;2535;7675;227;738;1706;5092;1933;5830
290440;202002;2800;7049;1986;5766;41;128;1398;4148;1439;4276
290450;202002;3401;8754;2667;7653;143;411;1992;5747;2135;6158
290460;202002;11421;32122;9602;28694;1940;5899;4378;13012;6318;18911
290470;202002;4508;11107;3296;9438;369;1172;1900;5475;2269;6647
290475;202002;6342;18494;5350;16719;100;538;4387;13408;4487;13946
290480;202002;1771;4498;1450;4026;83;281;997;2632;1080;2913
290485;202002;4472;13088;3949;12358;105;543;3381;10380;3486;10923
290490;202002;9171;21484;8170;20151;502;1129;6409;16012;6911;17141
290500;202002;3931;11820;3006;9821;533;1810;1339;4254;1872;6064
290510;202002;3435;8570;2856;7814;74;250;2464;6686;2538;6936
290515;202002;3621;10024;3129;9370;43;129;2821;8582;2864;8711
290520;202002;11451;32525;8761;27416;564;1913;5406;16578;5970;18491
290530;202002;4909;14046;4125;12772;131;496;3491;10745;3622;11241
290540;202002;3357;8833;2991;8409;50;166;2759;7732;2809;7898
290550;202002;4264;11206;3694;10533;11;60;3401;9807;3412;9867
290560;202002;6414;16571;4828;14248;423;1526;3179;9023;3602;10549
290570;202002;44133;108146;39061;101729;2400;6417;31523;81533;33923;87950
290580;202002;7825;22764;6717;21167;622;1943;4893;15758;5515;17701
290590;202002;7041;21692;5938;19731;136;568;4813;16040;4949;16608
290600;202002;18575;51727;16376;48138;676;2129;13205;38702;13881;40831
290610;202002;2532;7929;1963;6759;95;389;1379;4687;1474;5076
290620;202002;6369;17846;5490;16403;196;568;4618;13771;4814;14339
290630;202002;9175;22214;7265;19744;562;1515;5588;15319;6150;16834
290640;202002;2732;7085;2098;6154;85;262;1535;4550;1620;4812
290650;202002;12803;31916;11320;30240;2536;6484;6973;19504;9509;25988
290660;202002;3609;9293;3009;8426;48;129;2282;6615;2330;6744
290670;202002;6601;18361;5568;16648;370;1051;4273;12913;4643;13964
290680;202002;10702;29794;8984;27235;194;1052;7440;22018;7634;23070
290682;202002;4710;12268;4077;11424;128;308;3446;9760;3574;10068
290685;202002;3350;7635;2424;6317;189;469;1527;4224;1716;4693
290687;202002;6490;17543;5253;15512;693;1959;3357;10171;4050;12130
290689;202002;2776;7780;2140;6607;196;647;1474;4531;1670;5178
290690;202002;5513;14262;4457;12781;315;979;3237;9136;3552;10115
290700;202002;2597;7106;2286;6713;70;245;1910;5631;1980;5876
290710;202002;8196;23187;7012;21541;150;645;5933;18236;6083;18881
290720;202002;18252;49998;16561;47445;898;2914;13309;37581;14207;40495
290730;202002;6980;16632;5938;15436;288;596;4715;12413;5003;13009
290740;202002;1002;2727;766;2347;36;131;633;1929;669;2060
290750;202002;11000;27377;9498;24971;641;1823;7041;17947;7682;19770
290755;202002;2077;5846;1660;5079;89;279;1153;3554;1242;3833
290760;202002;3700;10779;2962;9387;188;568;2015;6531;2203;7099
290770;202002;2572;8368;2360;8103;51;267;1992;6914;2043;7181
290780;202002;8119;20104;7016;18647;267;600;5526;15007;5793;15607
290790;202002;4623;12734;4018;11890;154;457;3359;10067;3513;10524
290800;202002;7092;14722;5001;12268;289;695;3728;9187;4017;9882
290810;202002;5376;14095;4292;12511;113;369;3257;9653;3370;10022
290820;202002;4819;13061;4321;12337;180;521;3272;9461;3452;9982
290830;202002;4449;10126;3951;9501;29;83;3486;8282;3515;8365
290840;202002;16853;44673;14464;41000;1855;4339;9371;28155;11226;32494
290850;202002;6607;15909;5904;15158;218;553;5051;13077;5269;13630
290860;202002;6079;17459;5296;16548;221;719;4466;14246;4687;14965
290870;202002;4691;12940;3546;10762;133;447;2532;7617;2665;8064
290880;202002;1362;3430;1083;3063;69;179;760;2225;829;2404
290890;202002;9228;18622;8267;17541;158;349;7751;16366;7909;16715
290900;202002;2274;6030;1715;5051;95;258;1084;3160;1179;3418
290910;202002;5041;12199;3861;10401;49;163;3266;8712;3315;8875
290920;202002;4956;12694;4534;12201;41;94;4287;11641;4328;11735
290930;202002;7578;21152;6061;18503;186;823;4762;14135;4948;14958
290940;202002;3655;10279;3005;9337;151;591;2419;7501;2570;8092
290950;202002;1439;3631;1172;3234;62;180;831;2299;893;2479
290960;202002;5442;14296;4869;13573;171;435;4125;11542;4296;11977
290970;202002;3349;9832;2728;8708;107;397;2093;6667;2200;7064
290980;202002;12086;28951;10106;25929;787;2205;6345;15782;7132;17987
290990;202002;9419;25215;8306;23396;253;1046;6972;18969;7225;20015
291000;202002;3342;8749;2593;7802;113;349;2123;6460;2236;6809
291005;202002;15121;37228;13315;34878;1174;2848;10452;27515;11626;30363
291010;202002;2952;9003;2383;7792;109;418;1579;5027;1688;5445
291020;202002;1234;3055;990;2618;23;78;724;1805;747;1883
291030;202002;2475;6015;1713;4705;111;289;1064;2836;1175;3125
291040;202002;5331;14703;4446;13456;163;635;3501;10544;3664;11179
291050;202002;7553;19744;6471;18255;634;2006;4714;13042;5348;15048
291060;202002;5895;18094;5008;16916;309;1352;3820;12792;4129;14144
291070;202002;15640;42201;13002;37998;422;1500;10637;30841;11059;32341
291072;202002;24405;62688;17446;50725;3222;9644;7459;21890;10681;31534
291075;202002;5325;13217;4765;12345;108;298;3959;10067;4067;10365
291077;202002;1570;4108;1213;3496;45;109;857;2448;902;2557
291080;202002;95797;241849;74850;212655;23084;67153;20341;61966;43425;129119
291085;202002;5566;14085;4683;12754;191;578;3907;10586;4098;11164
291090;202002;1997;3762;1426;3141;39;86;1168;2508;1207;2594
291100;202002;3188;6992;2189;5795;98;275;1678;4398;1776;4673
291110;202002;5921;17574;5003;16012;314;1297;3791;11665;4105;12962
291120;202002;7514;18370;6322;16851;300;872;4871;12948;5171;13820
291125;202002;2135;3771;1602;3177;102;153;1279;2605;1381;2758
291130;202002;3207;9141;2373;7495;68;309;1736;5307;1804;5616
291140;202002;4760;12915;3460;10557;428;1145;2149;6575;2577;7720
291150;202002;2446;5333;1884;4698;6;22;1778;4418;1784;4440
291160;202002;5080;13852;4193;12569;369;1177;2806;8342;3175;9519
291165;202002;2085;5706;1582;4738;33;145;1160;3355;1193;3500
291170;202002;20665;52491;17205;46632;919;2740;11404;30348;12323;33088
291180;202002;6172;14384;4494;12117;264;691;3458;9332;3722;10023
291185;202002;3072;8276;2686;7653;90;276;2079;5924;2169;6200
291190;202002;7543;18556;6203;16847;310;964;4896;13215;5206;14179
291200;202002;2727;7519;2009;6181;94;310;1235;3651;1329;3961
291210;202002;6890;14921;5183;12977;137;456;3891;9746;4028;10202
291220;202002;4018;11437;3609;10821;186;683;2849;8425;3035;9108
291230;202002;4421;9515;3339;8330;35;87;3013;7593;3048;7680
291240;202002;4179;10697;3581;9708;63;219;3078;8215;3141;8434
291250;202002;3376;9945;2618;8558;155;507;1703;5579;1858;6086
291260;202002;1406;3308;1157;2987;30;94;949;2459;979;2553
291270;202002;5334;13854;4096;12053;624;1831;2560;7667;3184;9498
291280;202002;2478;6135;1839;5201;125;410;1209;3313;1334;3723
291290;202002;5799;15218;4464;13156;326;1030;3103;9045;3429;10075
291300;202002;3811;10269;2953;8867;115;421;2249;6643;2364;7064
291310;202002;5077;13513;4320;12138;113;373;3651;10096;3764;10469
291320;202002;6088;16902;4724;14353;1073;3050;2307;7454;3380;10504
291330;202002;1768;4468;1458;3961;85;233;1085;2902;1170;3135
291340;202002;4231;10956;3419;9546;82;263;2620;7166;2702;7429
291345;202002;2920;8776;2653;8362;113;401;2231;7031;2344;7432
291350;202002;6781;16843;5247;14989;60;195;4568;13267;4628;13462
291360;202002;37078;84725;28981;74985;2718;7187;19057;50244;21775;57431
291370;202002;7778;21432;6873;20050;485;1515;5115;14655;5600;16170
291380;202002;3375;9227;2964;8660;101;416;2453;7126;2554;7542
291390;202002;13096;28219;10150;24955;407;1002;8428;20690;8835;21692
291400;202002;13603;34957;11200;31311;1510;3724;6642;20036;8152;23760
291410;202002;2810;7449;2172;6358;35;153;1622;4671;1657;4824
291420;202002;1898;4701;1475;4173;31;127;1275;3600;1306;3727
291430;202002;2730;7761;2354;7137;87;393;1890;5547;1977;5940
291440;202002;6295;18127;5413;16678;307;1038;4258;13077;4565;14115
291450;202002;9054;22683;7474;20883;78;134;6557;18922;6635;19056
291460;202002;15322;40713;13411;37888;628;2031;10225;28616;10853;30647
291465;202002;9098;22587;7124;20338;140;647;6149;17407;6289;18054
291470;202002;16158;36469;13465;33442;689;1534;10049;25671;10738;27205
291480;202002;41024;90954;29946;75976;3521;9209;15994;40438;19515;49647
291490;202002;5577;13859;4804;12973;136;436;4343;11664;4479;12100
291500;202002;4956;12150;4099;11017;71;326;3729;9929;3800;10255
291510;202002;4234;10511;3140;9143;54;306;2618;7543;2672;7849
291520;202002;4535;10320;3416;8836;170;478;2633;6752;2803;7230
291530;202002;2224;5150;1555;4266;296;743;903;2696;1199;3439
291535;202002;3385;9895;3006;9231;173;477;2315;7259;2488;7736
291540;202002;2274;5092;1553;4234;62;221;1287;3431;1349;3652
291550;202002;5603;12843;4359;11274;392;843;2983;7872;3375;8715
291560;202002;18567;43634;13227;36732;1233;3320;8129;23316;9362;26636
291570;202002;2410;5732;1892;5093;57;152;1546;4333;1603;4485
291580;202002;6206;16064;4870;14299;210;679;3652;10590;3862;11269
291590;202002;2059;5101;1779;4772;75;278;1560;4094;1635;4372
291600;202002;5046;12182;3777;10217;341;1006;2556;6701;2897;7707
291610;202002;5630;14799;5058;14171;78;293;4651;12994;4729;13287
291620;202002;3147;6998;2300;6084;100;262;1803;4831;1903;5093
291630;202002;3218;7311;2373;6218;265;786;1680;4274;1945;5060
291640;202002;15493;38430;11644;32887;1731;4714;5208;15324;6939;20038
291650;202002;9426;23490;8315;22180;549;1045;7018;19180;7567;20225
291660;202002;2046;5057;1482;4197;130;453;961;2527;1091;2980
291670;202002;2058;5425;1746;4976;101;257;1321;3818;1422;4075
291680;202002;4064;10019;3294;8902;282;774;2332;6279;2614;7053
291685;202002;4642;11085;3709;9894;232;478;2810;7783;3042;8261
291690;202002;4167;9222;2866;7328;211;444;2199;5648;2410;6092
291700;202002;8502;24628;7447;22784;312;1183;6083;18231;6395;19414
291710;202002;5273;12550;3886;10596;208;661;2837;7581;3045;8242
291720;202002;4408;13426;3663;11939;383;1339;2431;7733;2814;9072
291730;202002;6343;16185;5447;15013;270;819;4502;12345;4772;13164
291733;202002;2872;7316;2426;6730;56;164;1778;5156;1834;5320
291735;202002;2878;7568;2289;6530;82;221;1732;4901;1814;5122
291740;202002;3834;9917;2851;8110;89;242;2068;5776;2157;6018
291750;202002;19216;45864;15623;40612;1476;3761;10641;27925;12117;31686
291760;202002;10186;29396;7941;25785;2414;8854;2173;7064;4587;15918
291770;202002;6918;18657;5755;16669;360;1117;4315;12166;4675;13283
291780;202002;5077;13502;4582;12791;87;333;4016;11086;4103;11419
291790;202002;2670;7476;2421;7159;233;603;1822;5553;2055;6156
291800;202002;28736;72411;21303;61370;3342;9318;10535;31512;13877;40830
291810;202002;10496;25004;8747;22868;245;662;7509;19672;7754;20334
291820;202002;3764;9913;3257;9258;91;297;2617;7461;2708;7758
291830;202002;4388;10393;3588;9331;183;428;2871;7471;3054;7899
291835;202002;6424;19214;5013;16509;543;1911;3177;10575;3720;12486
291840;202002;47279;129378;40809;119422;4328;13542;28573;83042;32901;96584
291845;202002;2470;6422;1939;5765;107;342;1559;4685;1666;5027
291850;202002;3890;11103;3194;9942;259;761;2279;7281;2538;8042
291855;202002;2146;4281;1658;3739;36;93;1504;3397;1540;3490
291860;202002;2227;5801;1549;4493;45;130;1050;2939;1095;3069
291870;202002;1281;3203;854;2471;48;142;580;1647;628;1789
291875;202002;2849;8558;2453;7736;66;274;1813;5552;1879;5826
291880;202002;5601;15753;4787;14435;230;659;3610;10925;3840;11584
291890;202002;1632;3357;1045;2680;127;309;706;1803;833;2112
291900;202002;1158;2852;884;2437;22;93;705;1876;727;1969
291905;202002;2485;6284;2011;5530;77;280;1532;4064;1609;4344
291910;202002;2913;7377;2475;6857;51;182;2145;6035;2196;6217
291915;202002;7271;20606;5930;18326;230;806;4503;14058;4733;14864
291920;202002;26285;68192;22127;62440;2159;6614;15381;42550;17540;49164
291930;202002;2474;6712;2116;6210;235;706;1406;4163;1641;4869
291940;202002;3879;9883;2580;7668;198;591;1515;4477;1713;5068
291950;202002;9113;27383;7744;24757;283;1061;5424;17096;5707;18157
291955;202002;15352;38603;13665;36442;1185;3299;10643;28435;11828;31734
291960;202002;3023;7990;2510;7282;121;365;1967;5825;2088;6190
291970;202002;4480;11298;3748;10382;134;452;2853;7907;2987;8359
291980;202002;9602;27509;7563;23963;791;2388;4836;15591;5627;17979
291990;202002;2233;5826;1868;5394;33;147;1733;4986;1766;5133
291992;202002;3884;9400;3075;8342;227;540;2434;6734;2661;7274
291995;202002;2038;5646;1671;5064;49;224;1287;3796;1336;4020
292000;202002;2625;6182;2133;5596;95;370;1668;4303;1763;4673
292010;202002;5725;13373;4661;11857;178;561;3877;9626;4055;10187
292020;202002;4519;13103;3728;11699;197;736;2712;8248;2909;8984
292030;202002;1798;5515;1640;5222;78;284;1055;3292;1133;3576
292040;202002;4323;11186;3377;9786;221;587;2579;7634;2800;8221
292045;202002;3993;10507;2969;9004;34;85;2606;8098;2640;8183
292050;202002;6432;18038;5144;15794;239;835;3337;9998;3576;10833
292060;202002;11409;26243;10442;25057;487;1097;9160;21768;9647;22865
292070;202002;5753;14902;5023;14037;283;819;4326;12004;4609;12823
292080;202002;3083;7819;2547;7128;75;247;2260;6297;2335;6544
292090;202002;4590;9927;3248;8324;252;678;2460;6315;2712;6993
292100;202002;10677;25991;9089;24008;930;2596;6344;16639;7274;19235
292105;202002;3437;8601;3004;8015;95;231;2463;6604;2558;6835
292110;202002;5852;14337;4092;11534;981;2809;1866;5239;2847;8048
292120;202002;6780;17331;5613;15391;357;1047;4296;11565;4653;12612
292130;202002;3368;8072;2765;7319;99;293;2200;5759;2299;6052
292140;202002;5022;11862;4203;10624;313;784;3336;8400;3649;9184
292145;202002;2338;6740;1969;6110;58;165;1516;4751;1574;4916
292150;202002;13914;38060;12080;35093;309;1195;9904;28348;10213;29543
292160;202002;2941;7160;2229;6237;45;129;1822;5330;1867;5459
292170;202002;8339;22141;6936;19860;345;1157;5256;14742;5601;15899
292180;202002;2756;7556;2013;6185;162;494;1273;3846;1435;4340
292190;202002;2901;7640;2481;6995;94;323;1963;5459;2057;5782
292200;202002;8190;20497;6093;17538;1020;3044;3225;9550;4245;12594
292205;202002;3847;10625;3330;9855;64;308;2910;8556;2974;8864
292210;202002;6469;15071;5202;13470;84;375;4671;11949;4755;12324
292220;202002;2119;5105;1857;4703;47;136;1475;3599;1522;3735
292225;202002;3174;9318;2781;8718;72;333;2351;7244;2423;7577
292230;202002;8548;20330;7634;19169;152;515;6605;16287;6757;16802
292240;202002;4685;13550;4061;12431;307;927;2832;8695;3139;9622
292250;202002;5436;14407;4870;13559;401;1088;3591;10000;3992;11088
292260;202002;3407;8851;3013;8337;88;248;2630;7280;2718;7528
292265;202002;3341;9077;2795;8254;73;320;2220;6409;2293;6729
292270;202002;4401;9993;3498;8920;123;289;2893;7396;3016;7685
292273;202002;2637;5713;2106;5066;53;93;1577;4025;1630;4118
292275;202002;1635;4241;1281;3760;59;160;968;2893;1027;3053
292280;202002;2604;6187;2087;5595;81;176;1774;4886;1855;5062
292285;202002;2518;6111;2010;5431;79;181;1634;4460;1713;4641
292290;202002;7377;19610;5823;17444;163;627;4765;14219;4928;14846
292300;202002;10081;25478;7893;22599;733;2227;5511;15791;6244;18018
292303;202002;2918;8332;2531;7731;80;203;2117;6500;2197;6703
292305;202002;2306;6165;2130;5924;42;199;1931;5273;1973;5472
292310;202002;6630;16724;5710;15617;152;524;4986;13474;5138;13998
292320;202002;6069;16581;4805;14228;244;793;3545;10252;3789;11045
292330;202002;2710;5979;2178;5382;95;199;1700;4359;1795;4558
292335;202002;4678;12132;4168;11414;207;489;3539;9761;3746;10250
292340;202002;5578;15533;4596;13651;220;666;3411;10049;3631;10715
292350;202002;2445;6649;2026;6074;76;285;1633;4894;1709;5179
292360;202002;4829;12938;4010;11539;223;745;2859;8010;3082;8755
292370;202002;10451;24236;8967;22299;130;431;8335;20455;8465;20886
292380;202002;6755;18810;6037;17530;397;1172;4608;13260;5005;14432
292390;202002;4496;8661;3297;7269;107;192;2885;6373;2992;6565
292400;202002;21871;62314;18904;57607;1806;5611;13069;40023;14875;45634
292405;202002;4166;10449;3530;9448;97;263;2913;7711;3010;7974
292410;202002;2191;5211;1832;4757;66;157;1614;4213;1680;4370
292420;202002;3428;10421;3122;9936;112;575;2690;8309;2802;8884
292430;202002;4797;14352;3640;12217;291;1017;2379;7977;2670;8994
292440;202002;8368;26633;7734;25675;130;664;6930;22902;7060;23566
292450;202002;3959;11343;3090;9650;88;344;2417;7480;2505;7824
292460;202002;4851;13290;3963;11786;350;992;2837;8464;3187;9456
292465;202002;2564;6729;2178;6222;84;188;1513;4668;1597;4856
292467;202002;1873;5267;1659;4979;241;646;1145;3563;1386;4209
292470;202002;2939;7459;2277;6437;52;115;1792;5072;1844;5187
292480;202002;6223;14873;5013;13402;71;276;4554;12078;4625;12354
292490;202002;2035;5297;1702;4806;116;270;1290;3733;1406;4003
292500;202002;6529;17829;5211;15489;501;1547;3412;10000;3913;11547
292510;202002;13024;35200;10135;30604;516;1855;7142;21446;7658;23301
292520;202002;6901;17167;6110;16053;457;1247;4757;12379;5214;13626
292525;202002;5837;13979;4757;12780;111;272;4145;11278;4256;11550
292530;202002;27591;73636;21039;62454;5185;15495;8014;24386;13199;39881
292540;202002;4304;8021;3381;7035;99;174;3055;6374;3154;6548
292550;202002;8302;21502;6333;19172;446;1365;4546;14524;4992;15889
292560;202002;4269;10754;3700;10003;72;222;3082;8371;3154;8593
292570;202002;3547;9395;2968;8317;67;259;2506;6842;2573;7101
292575;202002;6910;19685;6330;18915;351;1047;5125;15439;5476;16486
292580;202002;7492;18879;6211;17012;133;451;5248;14208;5381;14659
292590;202002;7302;19476;6259;17691;245;790;5249;14566;5494;15356
292593;202002;2764;6883;2304;6108;64;166;1947;5116;2011;5282
292595;202002;5352;14222;4583;13277;146;494;3869;11137;4015;11631
292600;202002;10783;29366;9265;27061;287;863;7420;21697;7707;22560
292610;202002;4063;10665;3437;9560;182;435;2610;7348;2792;7783
292620;202002;6400;17511;5314;16202;121;279;4868;15120;4989;15399
292630;202002;8399;20594;6756;17989;667;1781;4439;11826;5106;13607
292640;202002;8090;23852;7026;22128;189;772;5027;15901;5216;16673
292650;202002;4426;10904;3992;10340;106;296;3631;9288;3737;9584
292660;202002;11340;30444;9599;27926;435;1421;7406;21446;7841;22867
292665;202002;2156;6379;1870;6004;66;197;1583;5147;1649;5344
292670;202002;3549;9504;2716;7962;111;357;1858;5342;1969;5699
292680;202002;3937;10370;3096;8895;199;524;2266;6394;2465;6918
292690;202002;2569;6617;1773;5319;187;525;1067;3349;1254;3874
292700;202002;9714;26353;8447;24424;729;1914;5850;17449;6579;19363
292710;202002;2407;7551;2230;7308;45;164;2013;6642;2058;6806
292720;202002;8926;21300;7551;19726;210;578;6024;15998;6234;16576
292730;202002;4478;10233;4182;9899;242;391;3637;8779;3879;9170
292740;202002;320995;773438;276284;709373;38585;99054;172612;441053;211197;540107
292750;202002;6088;16394;5316;15278;224;653;4121;12017;4345;12670
292760;202002;3861;11098;3354;10200;222;746;2471;7432;2693;8178
292770;202002;5905;15693;4725;14042;746;2292;2968;9048;3714;11340
292780;202002;2047;4123;1519;3459;40;138;1224;2631;1264;2769
292790;202002;4073;8660;3111;7620;147;379;2603;6420;2750;6799
292800;202002;11139;27867;9506;25414;291;850;7957;20964;8248;21814
292805;202002;3523;8498;2740;7466;102;319;2162;5841;2264;6160
292810;202002;10530;27639;8306;24193;199;879;6281;17668;6480;18547
292820;202002;7398;20325;5371;16943;433;1453;3734;11570;4167;13023
292830;202002;2854;6732;2448;6228;88;275;2084;5294;2172;5569
292840;202002;8663;22588;7328;20774;147;576;6423;17884;6570;18460
292850;202002;2455;6498;2063;5926;139;422;1465;4179;1604;4601
292860;202002;17061;37355;15301;35271;420;1014;13239;30144;13659;31158
292870;202002;17676;43724;15168;40214;925;2531;10399;27238;11324;29769
292880;202002;10883;29595;9292;27224;267;1114;7341;20809;7608;21923
292890;202002;6930;19278;6121;18097;188;772;5353;15679;5541;16451
292895;202002;2941;6332;2133;5138;87;216;1734;4125;1821;4341
292900;202002;2545;6872;2321;6522;60;239;1912;5214;1972;5453
292905;202002;4250;10993;3357;9677;130;443;2497;7125;2627;7568
292910;202002;4828;13101;4395;12487;209;590;3376;9522;3585;10112
292920;202002;9641;26379;8906;25345;241;925;7727;21584;7968;22509
292925;202002;5396;15237;4512;13662;220;682;3269;9763;3489;10445
292930;202002;6410;18792;5505;17109;465;1621;3526;10674;3991;12295
292935;202002;2416;6136;1873;5529;23;123;1681;4992;1704;5115
292937;202002;2893;7091;2525;6617;54;169;2235;5819;2289;5988
292940;202002;2826;7153;2258;6319;178;411;1646;4770;1824;5181
292950;202002;9501;24008;8297;22247;517;1212;6299;16846;6816;18058
292960;202002;5178;12523;4338;11323;128;345;3490;9004;3618;9349
292970;202002;3725;10805;3287;10139;81;390;2753;8507;2834;8897
292975;202002;4435;9464;3925;8890;127;217;3574;8195;3701;8412
292980;202002;3281;7881;2626;6916;86;270;2141;5532;2227;5802
292990;202002;11271;30846;9379;27529;649;2000;6875;19825;7524;21825
293000;202002;2555;6104;2183;5547;42;152;1741;4425;1783;4577
293010;202002;17851;45670;14351;40157;1901;5505;8830;24630;10731;30135
293015;202002;8074;24815;6309;21371;411;1487;4274;14670;4685;16157
293020;202002;9735;28265;8761;26871;137;596;7901;24288;8038;24884
293030;202002;5194;13820;3943;11869;99;344;2749;8492;2848;8836
293040;202002;3984;10938;3360;10070;66;256;2916;8737;2982;8993
293050;202002;21792;53997;19257;50305;951;2647;14698;37757;15649;40404
293060;202002;3426;9118;2781;7933;240;718;1937;5427;2177;6145
293070;202002;24789;59739;21128;55114;1949;5376;15222;39729;17171;45105
293075;202002;3439;10941;2982;10159;165;715;2363;8054;2528;8769
293076;202002;3490;8623;3179;8252;59;168;2829;7399;2888;7567
293077;202002;5987;16701;4859;14878;419;1410;3188;9995;3607;11405
293080;202002;4661;13782;4012;12687;96;449;3257;10095;3353;10544
293090;202002;3183;9240;2423;7991;199;654;1610;5354;1809;6008
293100;202002;5579;14956;4596;13200;215;655;3641;10345;3856;11000
293105;202002;3630;11529;3180;10615;224;779;2278;7532;2502;8311
293110;202002;2350;5879;1952;5292;66;240;1616;4273;1682;4513
293120;202002;4329;11811;3847;11050;110;296;3206;9213;3316;9509
293130;202002;3670;10105;3203;9489;79;305;2756;8084;2835;8389
293135;202002;30205;70567;22239;60011;3346;9824;10637;28933;13983;38757
293140;202002;2351;5229;2036;4839;57;137;1720;4076;1777;4213
293150;202002;5443;16128;4466;14290;336;1107;3084;9859;3420;10966
293160;202002;3829;9294;3249;8664;243;408;2710;7580;2953;7988
293170;202002;4765;10146;4138;9363;125;286;3604;8114;3729;8400
293180;202002;4220;11967;3470;10615;97;385;2746;8160;2843;8545
293190;202002;13781;37823;12114;35405;153;680;10750;31233;10903;31913
293200;202002;8263;20557;6599;17968;198;734;5295;14076;5493;14810
293210;202002;5100;13542;4376;12442;290;812;3359;9554;3649;10366
293220;202002;4985;12872;3624;10553;851;2461;1449;4315;2300;6776
293230;202002;3856;9883;2833;8426;205;679;1952;5845;2157;6524
293240;202002;4474;11834;3581;10374;71;181;2727;8204;2798;8385
293245;202002;3772;10218;3390;9671;139;471;2891;8104;3030;8575
293250;202002;5832;13518;4756;12158;134;338;4011;10231;4145;10569
293260;202002;4410;11988;3635;10770;139;462;2535;7518;2674;7980
293270;202002;7144;15808;5643;14212;388;593;4434;11976;4822;12569
293280;202002;4470;11777;3899;10966;235;588;3046;8649;3281;9237
293290;202002;14091;41274;12400;38653;1702;5396;8125;25672;9827;31068
293300;202002;5684;13775;4882;12615;265;689;3611;9330;3876;10019
293305;202002;3901;9495;3418;8890;42;113;3094;8033;3136;8146
293310;202002;2038;5230;1717;4733;46;144;1383;3756;1429;3900
293315;202002;3993;9574;3297;8514;188;433;2729;7040;2917;7473
293317;202002;2578;6078;2279;5669;143;275;1814;4534;1957;4809
293320;202002;11789;28703;10464;27221;264;737;9339;24182;9603;24919
293325;202002;1748;4355;1358;3829;189;531;844;2410;1033;2941
293330;202002;51672;149965;41735;132439;8103;26402;19200;61652;27303;88054
293340;202002;2185;6142;1804;5478;80;270;1292;3847;1372;4117
293345;202002;3432;9341;2745;8325;337;792;1821;5993;2158;6785
293350;202002;6582;18853;5686;17794;60;302;5192;16433;5252;16735
293360;202002;15336;38216;13008;35123;305;1270;11451;30323;11756;31593
310010;202002;916;2060;573;1587;44;155;214;533;258;688
310020;202002;2382;6532;1688;5277;373;1283;356;1033;729;2316
310030;202002;1850;5243;1415;4487;214;756;893;2712;1107;3468
310040;202002;892;2334;706;2019;27;119;489;1312;516;1431
310050;202002;1473;4437;1246;4071;134;548;808;2537;942;3085
310060;202002;3120;8846;2704;8295;86;373;2247;6798;2333;7171
310070;202002;331;758;233;616;6;14;178;466;184;480
310080;202002;670;1774;471;1415;72;246;213;591;285;837
310090;202002;4565;12256;3720;10870;289;922;2709;7772;2998;8694
310100;202002;3300;9365;2760;8445;77;361;2225;6633;2302;6994
310110;202002;4541;11973;3521;10181;759;2390;1523;4223;2282;6613
310120;202002;619;1509;395;1156;44;154;235;631;279;785
310130;202002;357;929;293;838;26;103;219;587;245;690
310140;202002;258;736;184;614;38;146;71;210;109;356
310150;202002;5216;13829;3833;11260;505;1728;1807;4999;2312;6727
310160;202002;7362;18411;5212;14898;1020;3188;1872;5417;2892;8605
310163;202002;1011;3008;804;2614;185;681;271;808;456;1489
310170;202002;8872;22874;7057;20033;590;1762;5009;14189;5599;15951
310180;202002;1708;4270;1256;3519;158;487;749;2019;907;2506
310190;202002;2417;7075;1912;6190;449;1635;306;918;755;2553
310200;202002;1801;5358;1288;4347;200;773;586;1927;786;2700
310205;202002;1098;3047;841;2642;149;533;378;1163;527;1696
310210;202002;2576;6904;2077;6032;116;358;1531;4328;1647;4686
310220;202002;1204;3307;916;2756;97;326;600;1731;697;2057
310230;202002;2135;5935;1709;5141;215;728;1067;3009;1282;3737
310240;202002;905;2827;758;2562;48;186;543;1808;591;1994
310250;202002;1010;2709;805;2372;19;76;578;1681;597;1757
310260;202002;2794;7222;1705;5326;482;1756;445;1060;927;2816
310270;202002;2638;6654;2075;5885;98;338;1694;4798;1792;5136
310280;202002;2303;5391;1763;4624;272;750;985;2482;1257;3232
310285;202002;1815;5819;1507;5266;167;662;938;3235;1105;3897
310290;202002;1108;2913;896;2535;205;671;471;1191;676;1862
310300;202002;1416;4162;1198;3797;138;549;714;2105;852;2654
310310;202002;287;710;188;541;31;94;101;285;132;379
310320;202002;499;1295;335;1029;24;91;182;542;206;633
310330;202002;475;1116;275;774;42;137;112;273;154;410
310340;202002;7573;20565;6053;17991;859;2479;3008;9251;3867;11730
310350;202002;11968;28823;8044;22506;1568;4677;3497;9498;5065;14175
310360;202002;485;1110;366;951;11;33;251;661;262;694
310370;202002;1238;3876;1040;3491;212;778;340;1156;552;1934
310375;202002;820;2037;567;1664;93;283;298;867;391;1150
310380;202002;387;868;211;591;32;98;96;246;128;344
310390;202002;422;1256;331;1082;77;273;95;262;172;535
310400;202002;9412;22796;6610;18640;691;2275;3967;10902;4658;13177
310410;202002;865;2485;561;1913;93;342;207;661;300;1003
310420;202002;4030;10320;2692;7778;372;1220;1091;2913;1463;4133
310430;202002;1467;3975;944;3006;209;745;326;908;535;1653
310440;202002;639;1668;435;1288;43;156;231;647;274;803
310445;202002;1325;3819;961;3089;51;180;686;2170;737;2350
310450;202002;4608;11555;3460;9748;137;515;2622;7154;2759;7669
310460;202002;1500;3939;1058;3145;184;591;357;1010;541;1601
310470;202002;3697;8103;2857;7016;275;658;2038;5110;2313;5768
310480;202002;871;2285;683;1972;77;240;446;1258;523;1498
310490;202002;2743;7491;2131;6461;234;881;1179;3350;1413;4231
310500;202002;1317;3733;971;3149;172;635;508;1604;680;2239
310510;202002;1957;5115;1229;3754;236;822;451;1385;687;2207
310520;202002;1167;3049;840;2465;133;373;447;1313;580;1686
310530;202002;663;1671;401;1189;56;210;138;331;194;541
310540;202002;2947;8380;2443;7533;551;1804;1110;3291;1661;5095
310550;202002;1202;3101;825;2458;63;235;475;1328;538;1563
310560;202002;14203;36979;10018;29728;1531;5196;4200;11215;5731;16411
310570;202002;1018;2664;804;2369;51;183;596;1730;647;1913
310590;202002;3932;10521;3133;9039;197;676;1840;5023;2037;5699
310600;202002;1286;3802;1048;3328;147;528;540;1600;687;2128
310610;202002;461;1211;286;919;46;166;148;448;194;614
310620;202002;168722;426954;121337;342146;17893;58346;58983;150580;76876;208926
310630;202002;4274;11738;3367;9994;284;946;2184;6265;2468;7211
310640;202002;971;2928;796;2581;176;613;333;1022;509;1635
310650;202002;2318;6704;1670;5452;164;576;970;3076;1134;3652
310660;202002;1250;3389;1022;3086;30;106;864;2592;894;2698
310665;202002;1371;3577;1099;3174;29;110;900;2611;929;2721
310670;202002;53648;138754;44938;124019;4268;13554;30954;81339;35222;94893
310680;202002;722;1752;584;1555;19;68;487;1251;506;1319
310690;202002;1863;4915;1317;4005;110;380;740;2132;850;2512
310700;202002;472;1044;373;926;24;81;292;691;316;772
310710;202002;5247;15060;3773;12990;878;3521;607;1924;1485;5445
310720;202002;953;2257;738;1984;35;117;554;1450;589;1567
310730;202002;9542;25832;8177;23691;333;1240;6147;17443;6480;18683
310740;202002;5678;15696;3834;11869;635;2152;1317;3767;1952;5919
310750;202002;1181;2818;854;2347;110;343;427;1101;537;1444
310760;202002;562;1465;401;1222;29;92;217;680;246;772
310770;202002;1044;2842;712;2333;80;312;356;1094;436;1406
310780;202002;4199;10200;3470;9212;64;202;2830;7533;2894;7735
310790;202002;1757;5580;1520;5080;355;1267;242;725;597;1992
310800;202002;2126;6304;1509;5034;352;1385;102;282;454;1667
310810;202002;1137;2895;911;2493;41;125;645;1707;686;1832
310820;202002;1093;2825;666;2102;150;514;165;520;315;1034
310825;202002;2441;7559;1950;6727;70;417;1567;5209;1637;5626
310830;202002;1638;4678;1114;3632;230;861;464;1399;694;2260
310840;202002;1838;5016;1312;4133;354;1263;319;871;673;2134
310850;202002;1462;4026;1219;3687;47;245;948;2720;995;2965
310855;202002;3001;7951;2319;6861;161;568;1668;4783;1829;5351
310860;202002;6815;19747;5431;17014;518;1730;3357;10582;3875;12312
310870;202002;921;2213;718;1924;48;127;544;1460;592;1587
310880;202002;975;2926;758;2480;98;330;446;1423;544;1753
310890;202002;2207;6302;1404;4690;262;935;217;621;479;1556
310900;202002;3710;10364;2481;7622;357;1147;1086;3138;1443;4285
310910;202002;1933;4786;1309;3813;103;369;262;694;365;1063
310920;202002;1866;4865;1408;4169;201;641;793;2295;994;2936
310925;202002;927;2541;739;2241;73;254;498;1422;571;1676
310930;202002;5634;14864;3982;12171;757;2365;1875;5945;2632;8310
310940;202002;6368;15378;5074;13455;172;618;3869;9955;4041;10573
310945;202002;1295;3409;1014;2954;120;389;561;1599;681;1988
310950;202002;1837;5492;1190;4032;222;843;412;1231;634;2074
310960;202002;708;1890;391;1224;71;255;83;232;154;487
310970;202002;1106;3288;771;2562;203;743;142;433;345;1176
310980;202002;266;650;173;507;17;61;109;306;126;367
310990;202002;1256;3507;967;3006;162;530;493;1499;655;2029
311000;202002;3907;10898;2831;9094;696;2400;1175;3650;1871;6050
311010;202002;844;2502;674;2154;202;722;280;864;482;1586
311020;202002;1010;2599;634;1919;35;108;353;1057;388;1165
311030;202002;1547;3799;1061;3010;179;592;511;1354;690;1946
311040;202002;271;854;224;748;70;248;67;207;137;455
311050;202002;2706;6635;1986;5591;357;1148;998;2690;1355;3838
311060;202002;2922;7520;2105;5997;310;1010;843;2192;1153;3202
311070;202002;2222;5566;1584;4562;177;650;838;2251;1015;2901
311080;202002;1074;2455;870;2132;47;162;681;1577;728;1739
311090;202002;1976;6290;1529;5440;348;1377;463;1597;811;2974
311100;202002;2263;6451;1312;4484;245;952;230;699;475;1651
311110;202002;3559;7292;1969;5107;346;959;746;1964;1092;2923
311115;202002;1307;3032;1088;2729;61;162;895;2226;956;2388
311120;202002;6098;16008;4554;13257;683;2276;1744;4456;2427;6732
311130;202002;1801;4695;1352;4077;109;416;766;2251;875;2667
311140;202002;1329;3295;1017;2871;75;250;677;1878;752;2128
311150;202002;1454;4609;1138;4000;183;715;611;2093;794;2808
311160;202002;3564;10252;2456;8164;618;2290;745;2377;1363;4667
311170;202002;864;2194;680;1945;35;101;434;1314;469;1415
311180;202002;1294;2913;794;2175;145;431;359;967;504;1398
311190;202002;846;2350;647;1964;115;399;261;693;376;1092
311200;202002;1887;5118;1329;4056;260;874;477;1294;737;2168
311205;202002;847;2565;688;2243;46;209;433;1340;479;1549
311210;202002;990;2904;862;2734;114;326;629;2048;743;2374
311220;202002;719;2006;599;1794;48;164;378;1074;426;1238
311230;202002;7470;22636;5608;18849;995;3507;2114;7208;3109;10715
311240;202002;980;2571;745;2235;155;497;323;961;478;1458
311250;202002;951;2740;725;2312;162;498;285;880;447;1378
311260;202002;2502;6221;1560;4589;246;799;657;1780;903;2579
311265;202002;1274;3336;937;2763;41;164;652;1864;693;2028
311270;202002;2915;8720;2532;8087;158;697;1851;5633;2009;6330
311280;202002;1063;2719;481;1548;100;366;45;124;145;490
311290;202002;1813;5528;1646;5172;144;472;1118;3502;1262;3974
311300;202002;4568;12871;3726;11455;195;829;2951;8859;3146;9688
311310;202002;534;1484;448;1331;37;109;266;767;303;876
311320;202002;3049;9341;2569;8301;380;1445;1205;3534;1585;4979
311330;202002;4846;12878;3855;11257;409;1335;2169;6445;2578;7780
311340;202002;9954;28012;7796;24181;2103;7074;2089;6166;4192;13240
311350;202002;2250;5664;1549;4389;140;446;855;2158;995;2604
311360;202002;1069;2638;676;2026;197;674;216;603;413;1277
311370;202002;4502;10979;3281;9040;144;583;2173;5653;2317;6236
311380;202002;343;1056;250;862;62;210;101;366;163;576
311390;202002;1638;5035;1277;4536;564;2259;309;962;873;3221
311400;202002;1349;3741;977;3034;147;471;391;1094;538;1565
311410;202002;1567;4642;1268;4200;193;745;738;2413;931;3158
311420;202002;1363;3976;928;3083;169;631;227;609;396;1240
311430;202002;3705;9869;2409;7294;474;1470;754;2284;1228;3754
311440;202002;2528;7206;1836;6017;424;1647;495;1538;919;3185
311450;202002;1650;4921;1174;4038;307;1193;325;962;632;2155
311455;202002;945;2115;624;1643;165;435;241;671;406;1106
311460;202002;461;1441;306;1117;64;303;84;259;148;562
311470;202002;478;1506;317;1127;73;299;53;170;126;469
311480;202002;1033;2682;851;2409;52;146;655;1854;707;2000
311490;202002;234;690;172;567;31;122;82;240;113;362
311500;202002;419;1042;319;899;25;81;207;559;232;640
311510;202002;3045;7995;2036;6246;302;1050;832;2403;1134;3453
311520;202002;610;1719;536;1577;67;253;302;864;369;1117
311530;202002;8499;19752;5255;14525;1274;3918;1396;3649;2670;7567
311535;202002;767;2106;492;1547;79;263;167;485;246;748
311540;202002;474;1501;420;1398;83;302;271;879;354;1181
311545;202002;1984;5710;1696;5263;93;344;1321;4023;1414;4367
311547;202002;1419;3665;1232;3370;45;125;866;2408;911;2533
311550;202002;2662;7486;2106;6475;308;1070;914;2667;1222;3737
311560;202002;275;607;173;458;20;66;97;224;117;290
311570;202002;1635;3806;1159;3155;35;107;927;2562;962;2669
311580;202002;2102;3901;1372;3049;129;268;936;2088;1065;2356
311590;202002;478;1278;382;1134;61;207;214;625;275;832
311600;202002;1728;3867;1450;3512;55;128;1256;3003;1311;3131
311610;202002;2146;7072;1778;6282;201;776;995;3478;1196;4254
311615;202002;3025;8695;2436;7690;115;441;1921;5961;2036;6402
311620;202002;418;1094;361;1032;8;35;310;875;318;910
311630;202002;1291;3584;1042;3069;96;307;684;1933;780;2240
311640;202002;533;1467;412;1255;57;200;194;552;251;752
311650;202002;1811;4714;1491;4217;131;413;1010;2783;1141;3196
311660;202002;2599;7408;1882;6035;348;1243;512;1408;860;2651
311670;202002;1452;3844;1053;3142;159;550;448;1332;607;1882
311680;202002;2066;5986;1524;4966;166;546;1001;3255;1167;3801
311690;202002;580;1245;452;1086;38;74;326;832;364;906
311700;202002;2198;5301;1712;4622;27;137;1447;3775;1474;3912
311710;202002;1439;4155;1027;3416;240;870;397;1287;637;2157
311720;202002;393;1173;312;1026;20;87;182;583;202;670
311730;202002;3714;9553;2355;6937;697;2196;451;1372;1148;3568
311740;202002;843;2246;716;2094;29;72;619;1869;648;1941
311750;202002;3763;11322;3003;9938;414;1495;1711;5455;2125;6950
311760;202002;582;1644;475;1452;67;263;238;633;305;896
311770;202002;2026;5828;1575;5010;250;856;741;2272;991;3128
311780;202002;1217;3493;811;2686;166;626;245;703;411;1329
311783;202002;2150;5921;1738;5204;44;207;1406;4036;1450;4243
311787;202002;692;1989;509;1568;69;236;218;570;287;806
311790;202002;1420;3834;921;2924;237;828;253;766;490;1594
311800;202002;4558;13747;3679;11877;795;2788;618;1726;1413;4514
311810;202002;917;2795;724;2456;57;221;464;1555;521;1776
311820;202002;754;1853;554;1545;73;238;340;894;413;1132
311830;202002;8115;23325;5479;17622;1528;5319;677;2117;2205;7436
311840;202002;3393;8744;2747;7820;247;745;2019;5709;2266;6454
311850;202002;350;931;283;804;15;40;187;519;202;559
311860;202002;55338;139950;41869;117325;6245;18865;23277;62327;29522;81192
311870;202002;1801;4807;1209;3727;209;723;469;1318;678;2041
311880;202002;6133;15936;5117;14530;274;709;3874;11205;4148;11914
311890;202002;1569;3831;1201;3303;84;283;859;2251;943;2534
311900;202002;705;1844;525;1594;50;177;361;1080;411;1257
311910;202002;4087;10511;3064;9175;544;1596;1556;4793;2100;6389
311920;202002;1983;5348;1565;4735;112;310;1001;3107;1113;3417
311930;202002;3514;8279;2450;6798;780;2320;735;1900;1515;4220
311940;202002;14075;37270;10298;30145;1491;4828;4723;12900;6214;17728
311950;202002;2185;6017;1614;5065;101;398;1042;3207;1143;3605
311960;202002;477;1168;384;1030;23;90;250;606;273;696
311970;202002;404;1311;286;1016;49;202;66;203;115;405
311980;202002;426;1168;214;749;25;89;66;229;91;318
311990;202002;524;1221;327;929;64;227;144;364;208;591
311995;202002;912;2524;447;1433;20;64;67;163;87;227
312000;202002;632;1670;514;1506;48;145;342;992;390;1137
312010;202002;899;2520;689;2169;50;183;431;1303;481;1486
312015;202002;1324;3932;1164;3673;46;216;944;2904;990;3120
312020;202002;1426;4414;1075;3663;242;866;256;822;498;1688
312030;202002;1972;4955;1718;4674;22;87;1599;4336;1621;4423
312040;202002;823;2413;566;1903;63;222;256;838;319;1060
312050;202002;1147;3619;912;3161;217;880;276;852;493;1732
312060;202002;839;2082;552;1726;136;420;265;849;401;1269
312070;202002;857;2495;608;1996;48;171;327;1020;375;1191
312080;202002;2610;6435;1943;5446;104;344;1263;3390;1367;3734
312083;202002;814;2125;603;1800;52;188;398;1148;450;1336
312087;202002;2383;6278;1919;5551;46;155;1518;4375;1564;4530
312090;202002;9403;24820;7096;21224;1097;3611;3539;10226;4636;13837
312100;202002;1455;4353;1113;3717;100;431;632;2017;732;2448
312110;202002;990;3080;820;2738;191;746;286;852;477;1598
312120;202002;771;2109;519;1668;152;560;156;415;308;975
312125;202002;1667;4350;1385;3942;115;381;1027;2821;1142;3202
312130;202002;946;2315;699;1902;56;160;298;746;354;906
312140;202002;672;1940;546;1686;108;373;249;710;357;1083
312150;202002;445;1251;374;1101;13;64;268;726;281;790
312160;202002;7880;21814;5885;18271;738;2684;2851;8426;3589;11110
312170;202002;880;2408;663;1978;35;132;445;1287;480;1419
312180;202002;1293;3519;1014;2982;143;458;521;1483;664;1941
312190;202002;590;1672;406;1302;77;274;124;377;201;651
312200;202002;4471;12169;3529;10654;1072;3238;1258;3886;2330;7124
312210;202002;1292;2936;921;2397;36;103;694;1778;730;1881
312220;202002;1619;5024;1396;4603;104;366;884;2917;988;3283
312230;202002;12174;31695;7886;23831;1914;6513;1572;4110;3486;10623
312235;202002;1862;4816;1474;4222;85;301;1058;2945;1143;3246
312240;202002;668;2196;505;1852;115;463;142;503;257;966
312245;202002;2521;6687;2052;5972;59;199;1671;4824;1730;5023
312247;202002;905;2235;645;1850;119;365;332;963;451;1328
312250;202002;954;2540;608;1849;80;257;231;685;311;942
312260;202002;852;2362;674;2088;37;155;503;1510;540;1665
312270;202002;651;1773;489;1465;24;103;287;785;311;888
312280;202002;394;1162;300;990;93;311;44;136;137;447
312290;202002;689;2048;544;1787;110;410;179;560;289;970
312300;202002;945;2873;630;2095;157;570;121;331;278;901
312310;202002;811;2534;630;2147;96;363;292;959;388;1322
312320;202002;1857;4806;1332;3896;318;967;305;858;623;1825
312330;202002;830;2479;657;2115;63;225;406;1280;469;1505
312340;202002;251;656;176;529;43;153;70;186;113;339
312350;202002;237;479;167;403;13;41;115;264;128;305
312352;202002;1571;4710;1393;4391;87;281;864;2893;951;3174
312360;202002;2435;7108;1753;5766;349;1252;527;1665;876;2917
312370;202002;1744;4617;1407;4057;181;585;818;2243;999;2828
312380;202002;2085;4775;1713;4314;7;31;1538;3812;1545;3843
312385;202002;1156;3199;898;2735;155;502;431;1300;586;1802
312390;202002;1826;5269;1350;4374;202;766;508;1497;710;2263
312400;202002;2727;7926;2244;7071;698;2359;726;2258;1424;4617
312410;202002;11238;31090;9101;27494;1575;4947;5024;14982;6599;19929
312420;202002;3534;9727;2926;8703;537;1767;1557;4502;2094;6269
312430;202002;7488;20144;6117;17669;385;1297;4330;12191;4715;13488
312440;202002;847;2747;664;2331;351;1296;78;232;429;1528
312450;202002;1103;3262;833;2787;236;839;288;993;524;1832
312460;202002;424;1109;286;899;40;140;149;480;189;620
312470;202002;456;1094;283;791;33;104;114;280;147;384
312480;202002;1030;2565;716;2105;99;317;347;968;446;1285
312490;202002;2000;4884;1508;4150;200;574;820;2206;1020;2780
312500;202002;932;2316;745;2056;49;174;510;1382;559;1556
312510;202002;3543;9429;2533;7533;657;1881;688;2081;1345;3962
312520;202002;145;412;113;354;31;100;49;154;80;254
312530;202002;570;1413;490;1315;15;51;433;1168;448;1219
312540;202002;1505;4272;1006;3236;146;524;541;1678;687;2202
312550;202002;721;1942;546;1589;45;147;346;927;391;1074
312560;202002;1910;4954;1527;4355;67;211;1164;3321;1231;3532
312570;202002;2070;5124;1542;4462;438;1325;613;1811;1051;3136
312580;202002;606;1698;429;1323;58;207;197;551;255;758
312590;202002;1562;4583;1240;3939;89;400;776;2278;865;2678
312595;202002;1820;5457;1516;4932;259;797;901;3071;1160;3868
312600;202002;1066;2585;595;1684;102;367;126;407;228;774
312610;202002;5860;14860;3692;10818;562;1777;1285;3518;1847;5295
312620;202002;2443;6375;1802;5468;52;243;1424;4414;1476;4657
312630;202002;272;803;193;664;37;154;77;254;114;408
312640;202002;483;1330;326;1055;41;137;125;425;166;562
312650;202002;1971;5100;1332;3913;67;219;946;2648;1013;2867
312660;202002;1276;3143;953;2592;83;258;653;1699;736;1957
312670;202002;4714;12613;3904;11322;168;761;2849;7878;3017;8639
312675;202002;1215;3247;983;2902;55;186;789;2304;844;2490
312680;202002;1333;3822;1148;3534;54;246;945;2811;999;3057
312690;202002;2775;5937;2152;5186;53;157;1789;4316;1842;4473
312695;202002;922;2573;767;2307;36;96;601;1811;637;1907
312700;202002;2056;5435;1481;4387;147;508;837;2350;984;2858
312705;202002;1308;3242;1105;2932;18;61;989;2607;1007;2668
312707;202002;1312;3877;1011;3329;58;295;655;2028;713;2323
312710;202002;6351;14583;3698;10441;947;2869;1059;3079;2006;5948
312720;202002;1031;2791;774;2385;98;324;474;1419;572;1743
312730;202002;1591;3780;1127;3141;84;275;674;1800;758;2075
312733;202002;1347;3575;1021;2956;35;139;700;1923;735;2062
312735;202002;626;1703;526;1510;65;217;328;842;393;1059
312737;202002;763;1760;524;1406;67;200;328;838;395;1038
312738;202002;596;1530;413;1216;43;150;230;637;273;787
312740;202002;406;1004;233;716;53;179;60;149;113;328
312750;202002;1493;4371;1129;3706;199;694;501;1525;700;2219
312760;202002;1730;5125;1215;4069;214;777;448;1424;662;2201
312770;202002;42466;102027;26173;74223;5454;16542;8609;23956;14063;40498
312780;202002;2355;7094;1993;6513;224;801;1295;4211;1519;5012
312790;202002;238;566;128;390;7;36;43;106;50;142
312800;202002;4714;13395;3543;11174;878;2913;1218;3735;2096;6648
312810;202002;1513;4024;979;3150;249;903;345;1002;594;1905
312820;202002;1682;4536;1337;3937;40;163;1010;2900;1050;3063
312825;202002;1274;3033;1099;2805;20;71;940;2348;960;2419
312830;202002;2719;7702;1556;5290;330;1268;368;1185;698;2453
312840;202002;1200;3366;933;2901;98;392;472;1369;570;1761
312850;202002;848;2075;588;1703;26;103;352;921;378;1024
312860;202002;1119;2889;753;2332;200;657;176;512;376;1169
312870;202002;5877;15907;3549;11405;618;2137;777;2372;1395;4509
312880;202002;1359;3420;1037;2873;34;129;620;1716;654;1845
312890;202002;2130;5454;1480;4371;95;279;780;2318;875;2597
312900;202002;1125;2880;910;2617;71;232;517;1619;588;1851
312910;202002;1562;2889;812;1905;142;281;322;750;464;1031
312920;202002;959;2582;646;2055;122;463;264;755;386;1218
312930;202002;2197;5465;1689;4716;368;1061;767;2150;1135;3211
312940;202002;922;2533;713;2224;82;309;359;1056;441;1365
312950;202002;3042;7567;1964;5805;507;1641;623;1779;1130;3420
312960;202002;1761;4722;1486;4288;69;183;1158;3435;1227;3618
312965;202002;1572;4463;1313;4045;113;370;911;2760;1024;3130
312970;202002;1237;3504;954;3043;151;583;539;1592;690;2175
312980;202002;21356;59094;17123;51597;3247;10760;8540;24189;11787;34949
312990;202002;455;1173;283;866;48;165;132;388;180;553
313000;202002;469;1342;352;1128;30;129;204;606;234;735
313005;202002;2425;7051;2042;6394;160;488;1445;4488;1605;4976
313010;202002;4705;13070;3744;11503;678;2273;2174;6534;2852;8807
313020;202002;911;2784;615;2102;108;401;114;333;222;734
313030;202002;1050;2473;701;1954;70;249;462;1216;532;1465
313040;202002;735;2265;605;1998;41;171;361;1135;402;1306
313050;202002;1679;4680;1164;3896;193;784;376;1112;569;1896
313055;202002;1851;5018;1636;4702;52;169;1408;4021;1460;4190
313060;202002;936;2244;672;1794;180;580;147;327;327;907
313065;202002;1574;4761;1378;4431;50;205;1066;3335;1116;3540
313070;202002;916;2441;685;2036;69;212;395;1146;464;1358
313080;202002;361;1007;255;796;52;187;92;239;144;426
313090;202002;4869;13115;4143;11963;325;1088;2798;7948;3123;9036
313100;202002;1299;3376;991;2932;27;113;763;2194;790;2307
313110;202002;1406;3737;1012;3047;92;356;587;1640;679;1996
313115;202002;2421;7083;1957;6193;263;924;1031;3064;1294;3988
313120;202002;3627;8566;2642;7282;229;733;1703;4644;1932;5377
313130;202002;29107;75976;22089;63036;2429;7846;12477;33633;14906;41479
313140;202002;573;1270;340;928;23;60;229;633;252;693
313150;202002;1318;3703;967;3056;295;1015;228;653;523;1668
313160;202002;1044;2659;810;2295;28;100;612;1690;640;1790
313170;202002;10766;30685;7607;24786;1309;4651;2998;9190;4307;13841
313180;202002;1998;5311;1404;4157;178;547;805;2340;983;2887
313190;202002;3948;11319;2850;9126;535;1866;986;2933;1521;4799
313200;202002;1034;2919;903;2696;16;65;769;2230;785;2295
313210;202002;3633;10686;2960;9477;350;1289;1791;5517;2141;6806
313220;202002;1641;4314;1065;3193;164;549;436;1164;600;1713
313230;202002;2895;8175;2399;7602;50;199;1996;6423;2046;6622
313240;202002;9115;22387;5552;16645;953;3293;2315;6419;3268;9712
313250;202002;6056;17835;4539;14644;812;2665;1985;6283;2797;8948
313260;202002;575;1519;405;1211;52;205;198;552;250;757
313270;202002;5494;14070;4367;12472;564;1628;2897;8450;3461;10078
313280;202002;433;1224;275;901;36;127;114;357;150;484
313290;202002;921;2853;676;2423;217;842;221;773;438;1615
313300;202002;1497;4009;1060;3245;280;917;236;627;516;1544
313310;202002;1043;3088;784;2548;125;471;211;573;336;1044
313320;202002;2029;5430;1454;4496;260;918;618;1907;878;2825
313330;202002;3956;10457;2974;8971;162;645;1944;5825;2106;6470
313340;202002;1345;3043;944;2489;85;239;653;1716;738;1955
313350;202002;2429;6915;1534;4861;203;694;551;1553;754;2247
313360;202002;1288;3179;856;2505;140;496;424;1146;564;1642
313370;202002;1326;3766;1096;3311;131;468;622;1737;753;2205
313375;202002;1623;4225;961;2988;181;622;204;588;385;1210
313380;202002;5783;14541;4053;11370;750;2334;1863;4662;2613;6996
313390;202002;793;2546;686;2368;48;227;457;1506;505;1733
313400;202002;3653;9067;2813;7900;158;504;2160;5961;2318;6465
313410;202002;1254;3296;953;2751;55;194;700;1973;755;2167
313420;202002;14593;32440;7141;19894;1614;5033;1016;2781;2630;7814
313430;202002;886;2623;661;2162;116;472;277;807;393;1279
313440;202002;6027;13188;3929;10414;348;975;2450;6493;2798;7468
313450;202002;688;1866;469;1410;75;241;157;400;232;641
313460;202002;2030;5870;1611;5209;325;1196;768;2339;1093;3535
313470;202002;2776;7160;2178;6277;259;734;1381;4040;1640;4774
313480;202002;957;2763;517;1752;70;272;144;439;214;711
313490;202002;2416;5828;1113;3518;302;1061;168;522;470;1583
313500;202002;442;1286;340;1056;43;125;125;373;168;498
313505;202002;9684;25962;8254;24012;333;1188;6657;19333;6990;20521
313507;202002;1415;3747;1152;3341;27;113;930;2637;957;2750
313510;202002;12991;36053;10156;30582;1217;3912;4892;14334;6109;18246
313520;202002;13771;39231;10950;34356;600;2291;8098;24812;8698;27103
313530;202002;506;1504;379;1228;42;148;153;453;195;601
313535;202002;2306;6413;1931;5692;257;679;1209;3552;1466;4231
313540;202002;737;2193;583;1828;111;354;246;727;357;1081
313545;202002;1129;3736;939;3342;148;556;514;1757;662;2313
313550;202002;1689;5169;1384;4456;318;1146;689;2102;1007;3248
313560;202002;2560;5117;1903;4316;58;109;1610;3675;1668;3784
313570;202002;907;2711;736;2389;179;607;307;950;486;1557
313580;202002;5368;14280;4090;12158;496;1576;2340;7026;2836;8602
313590;202002;948;2723;758;2454;197;673;338;1164;535;1837
313600;202002;3858;10475;3193;9432;94;395;2648;7668;2742;8063
313610;202002;963;2463;771;2142;92;275;484;1269;576;1544
313620;202002;5327;14148;4145;11994;543;1738;2345;6561;2888;8299
313630;202002;8163;19801;5650;16021;587;1937;3362;9317;3949;11254
313640;202002;1005;2346;621;1848;157;480;232;724;389;1204
313650;202002;1673;5032;1339;4464;87;344;898;3019;985;3363
313652;202002;720;2311;651;2162;108;397;408;1309;516;1706
313655;202002;1105;2832;875;2535;47;145;688;1991;735;2136
313657;202002;1167;3135;921;2746;40;161;682;1917;722;2078
313660;202002;846;2396;675;2078;83;309;410;1186;493;1495
313665;202002;4485;12102;3416;10176;404;1339;2099;5994;2503;7333
313670;202002;46961;115039;29364;85188;4405;14018;12747;34941;17152;48959
313680;202002;1000;2676;818;2393;61;207;549;1550;610;1757
313690;202002;747;2327;566;1990;143;556;147;497;290;1053
313695;202002;1745;4799;1327;4102;86;276;901;2783;987;3059
313700;202002;2842;9212;2451;8693;244;920;1842;6542;2086;7462
313710;202002;1341;3120;961;2621;77;218;639;1756;716;1974
313720;202002;5167;14286;3552;10927;566;1961;1458;4050;2024;6011
313730;202002;1268;2913;958;2485;76;174;635;1639;711;1813
313740;202002;1587;5692;1296;4946;314;1367;222;731;536;2098
313750;202002;1884;5055;1420;4222;262;861;660;1839;922;2700
313753;202002;2030;4886;1335;3776;128;386;769;2115;897;2501
313760;202002;4881;13498;3585;11025;772;2581;1515;4359;2287;6940
313770;202002;3836;10868;3022;9538;203;691;2226;7077;2429;7768
313780;202002;3877;10421;2730;8568;246;884;807;2548;1053;3432
313790;202002;455;1433;405;1340;47;173;231;746;278;919
313800;202002;1327;3069;958;2536;123;380;517;1303;640;1683
313810;202002;1510;3910;1190;3464;46;190;918;2581;964;2771
313820;202002;17006;43153;10556;29505;1654;4881;2975;8043;4629;12924
313830;202002;372;1077;255;797;50;165;82;240;132;405
313835;202002;896;2653;730;2359;63;252;404;1217;467;1469
313840;202002;6570;17199;4771;14189;1216;3828;1000;3047;2216;6875
313850;202002;927;2286;736;2027;131;443;357;864;488;1307
313860;202002;2472;6686;1825;5464;289;986;760;2092;1049;3078
313862;202002;1339;2818;642;1792;41;124;319;888;360;1012
313865;202002;2431;6559;2009;5876;86;274;1511;4341;1597;4615
313867;202002;1229;3719;1022;3333;141;457;668;2222;809;2679
313868;202002;1671;5163;1375;4566;46;232;1054;3381;1100;3613
313870;202002;723;1958;515;1574;94;299;196;551;290;850
313880;202002;1533;4058;1111;3350;160;528;513;1385;673;1913
313890;202002;1984;4352;1474;3705;48;158;1102;2673;1150;2831
313900;202002;3891;11391;2761;9078;727;2627;668;2017;1395;4644
313910;202002;605;1801;452;1514;94;347;100;322;194;669
313920;202002;2857;8906;2392;7926;493;1622;1192;3971;1685;5593
313925;202002;1514;3890;1207;3341;181;480;780;2155;961;2635
313930;202002;4515;13785;3654;12232;269;1044;2392;7889;2661;8933
313940;202002;8164;23748;5797;19642;782;3229;1447;5378;2229;8607
313950;202002;4992;11257;3604;9527;411;1353;2150;5640;2561;6993
313960;202002;5299;13081;3460;10020;752;2419;1113;2936;1865;5355
313970;202002;1422;3901;1181;3497;15;50;768;2225;783;2275
313980;202002;1298;3380;852;2677;132;480;338;1004;470;1484
313990;202002;1795;5802;1263;4548;340;1383;382;1209;722;2592
314000;202002;9113;23726;7659;21255;547;1952;5175;14206;5722;16158
314010;202002;1435;3491;1121;3056;46;158;843;2231;889;2389
314015;202002;1821;5047;1355;4256;182;682;718;2187;900;2869
314020;202002;448;1223;293;959;64;253;60;210;124;463
314030;202002;723;2086;575;1801;55;186;313;970;368;1156
314040;202002;603;1626;479;1395;69;229;261;727;330;956
314050;202002;1708;4579;1223;3691;151;532;638;1793;789;2325
314053;202002;1719;5181;1382;4497;263;851;722;2436;985;3287
314055;202002;2235;6056;1889;5514;43;173;1553;4529;1596;4702
314060;202002;1232;3317;919;2813;35;145;638;1921;673;2066
314070;202002;4438;12281;3439;10468;723;2187;1497;4498;2220;6685
314080;202002;2033;5332;1365;4176;182;662;570;1569;752;2231
314085;202002;2045;5847;1656;5234;226;754;939;3030;1165;3784
314090;202002;4362;11936;3717;10981;232;888;2371;7089;2603;7977
314100;202002;3056;7279;2366;6325;50;149;1792;4784;1842;4933
314110;202002;4324;12287;3493;10707;371;1328;2049;5895;2420;7223
314120;202002;746;1752;305;922;64;236;64;177;128;413
314130;202002;575;1493;353;1093;25;104;215;657;240;761
314140;202002;4399;12600;3449;10766;474;1582;1724;5267;2198;6849
314150;202002;1432;3595;1043;2925;83;242;697;1901;780;2143
314160;202002;2073;5534;1490;4479;204;682;645;1932;849;2614
314170;202002;893;2555;717;2205;45;171;465;1339;510;1510
314180;202002;5267;14724;4237;13056;351;1171;2568;7922;2919;9093
314190;202002;587;1472;406;1198;75;239;184;497;259;736
314200;202002;2831;7977;2303;7074;140;493;1649;4935;1789;5428
314210;202002;1912;5087;1498;4329;168;510;765;2169;933;2679
314220;202002;1280;3526;903;2876;196;724;331;963;527;1687
314225;202002;1066;3009;875;2705;74;190;633;2019;707;2209
314230;202002;732;1900;596;1734;67;222;394;1170;461;1392
314240;202002;973;2656;745;2298;183;588;293;915;476;1503
314250;202002;498;1398;312;1018;50;166;113;336;163;502
314260;202002;911;2509;715;2235;158;543;399;1204;557;1747
314270;202002;3227;9214;2638;8298;83;358;1940;6023;2023;6381
314280;202002;3288;7620;2152;5891;258;786;1145;2975;1403;3761
314290;202002;4376;11406;3574;9962;288;836;2449;6686;2737;7522
314300;202002;1853;5326;1203;3916;254;916;388;1192;642;2108
314310;202002;3974;10372;2631;8087;857;2862;430;1170;1287;4032
314315;202002;889;3092;759;2820;54;256;534;1913;588;2169
314320;202002;2771;7643;1772;5725;327;1159;646;2041;973;3200
314330;202002;47922;134580;35904;113334;9702;31877;7451;24741;17153;56618
314340;202002;2205;5464;1276;3792;261;909;328;824;589;1733
314345;202002;1352;4063;1096;3594;150;503;640;2075;790;2578
314350;202002;791;2158;504;1643;108;376;121;343;229;719
314360;202002;551;1601;335;1129;46;170;108;331;154;501
314370;202002;693;1884;549;1667;30;112;399;1169;429;1281
314380;202002;1095;2990;730;2333;161;603;170;521;331;1124
314390;202002;12050;30823;7505;22556;1565;5020;2343;6349;3908;11369
314400;202002;3841;11495;2877;9636;745;2578;1071;3719;1816;6297
314410;202002;2633;7335;1803;5802;247;905;626;2124;873;3029
314420;202002;794;1968;575;1635;40;158;392;1038;432;1196
314430;202002;7340;18197;5037;14279;757;2284;2299;6221;3056;8505
314435;202002;1641;4459;1296;3874;48;184;968;2840;1016;3024
314437;202002;888;2296;641;1875;67;216;316;913;383;1129
314440;202002;607;1741;428;1370;119;418;86;232;205;650
314450;202002;1356;3628;1128;3271;114;382;662;1840;776;2222
314460;202002;3148;9622;2258;7738;582;2101;522;1733;1104;3834
314465;202002;2135;6196;1813;5590;51;195;1392;4145;1443;4340
314467;202002;843;2253;710;2037;18;56;576;1604;594;1660
314470;202002;2029;5839;1616;5003;276;940;746;2150;1022;3090
314480;202002;6214;17796;4460;14108;758;2683;1609;4495;2367;7178
314490;202002;985;2703;729;2174;62;208;457;1291;519;1499
314500;202002;1673;4021;1187;3336;291;797;429;1250;720;2047
314505;202002;1989;4911;1611;4373;104;298;1163;3075;1267;3373
314510;202002;1785;4727;1246;3894;244;842;552;1708;796;2550
314520;202002;4670;14355;3385;11629;682;2572;413;1238;1095;3810
314530;202002;5270;17127;4706;16041;321;1374;3444;11434;3765;12808
314535;202002;2485;6528;2006;5827;90;327;1536;4417;1626;4744
314537;202002;1053;3023;806;2618;47;189;578;1843;625;2032
314540;202002;375;937;246;710;17;60;138;378;155;438
314545;202002;1774;4399;1581;4174;33;94;1363;3704;1396;3798
314550;202002;625;1554;463;1329;36;136;254;663;290;799
314560;202002;3937;12000;2883;9645;472;1761;998;3015;1470;4776
314570;202002;289;795;213;653;27;99;92;283;119;382
314580;202002;416;1250;319;1055;86;291;97;316;183;607
314585;202002;626;1968;470;1618;63;269;207;688;270;957
314587;202002;1956;5329;1471;4560;198;569;839;2668;1037;3237
314590;202002;3728;10290;2621;8170;365;1281;1110;3215;1475;4496
314600;202002;1841;5040;1041;3495;203;737;127;389;330;1126
314610;202002;8468;21269;5888;17433;1009;3554;2440;7402;3449;10956
314620;202002;2167;5119;1701;4524;37;129;1424;3758;1461;3887
314625;202002;1457;4127;1243;3830;32;201;1066;3208;1098;3409
314630;202002;5151;13367;4194;12091;108;464;3516;10131;3624;10595
314640;202002;634;1535;453;1250;59;191;247;641;306;832
314650;202002;772;1760;453;1265;43;142;246;603;289;745
314655;202002;1558;4314;1096;3475;163;510;540;1693;703;2203
314660;202002;315;724;203;524;13;29;126;312;139;341
314670;202002;1588;3638;1090;2921;16;49;725;1922;741;1971
314675;202002;1659;4452;1410;4033;75;254;1098;3048;1173;3302
314690;202002;2017;5655;1534;4940;413;1465;525;1668;938;3133
314700;202002;9561;26899;6185;20361;1191;4364;1825;5840;3016;10204
314710;202002;7317;20583;5222;16200;916;3109;1751;4784;2667;7893
314720;202002;1948;5751;1318;4451;282;1067;355;1126;637;2193
314730;202002;2052;5526;1458;4437;269;883;522;1505;791;2388
314740;202002;2768;7852;2141;6729;273;923;1103;3380;1376;4303
314750;202002;295;803;225;661;26;92;136;358;162;450
314760;202002;1801;5477;1130;3923;174;687;267;756;441;1443
314770;202002;1048;3075;538;1755;41;150;166;501;207;651
314780;202002;340;806;223;627;43;144;117;288;160;432
314790;202002;9804;26421;6613;20536;1433;5138;2200;6307;3633;11445
314795;202002;1416;3814;1189;3406;27;119;945;2601;972;2720
314800;202002;10240;25944;6017;18134;1122;3748;1397;3711;2519;7459
314810;202002;8287;21945;5968;17895;1485;4820;2059;5890;3544;10710
314820;202002;1138;2823;891;2452;50;190;568;1508;618;1698
314830;202002;1402;4300;1157;3827;221;811;559;1811;780;2622
314840;202002;824;2622;653;2350;48;238;465;1606;513;1844
314850;202002;1916;4634;1546;4161;36;116;1338;3629;1374;3745
314860;202002;3100;9209;2554;8202;211;841;1739;5427;1950;6268
314870;202002;6187;15872;4674;13830;269;887;3447;10278;3716;11165
314875;202002;1714;5155;1492;4870;104;287;1211;4016;1315;4303
314880;202002;810;1991;621;1703;23;68;386;1060;409;1128
314890;202002;402;1191;302;981;49;183;125;374;174;557
314900;202002;665;1834;513;1561;86;295;208;603;294;898
314910;202002;1582;4522;1160;3828;214;825;543;1660;757;2485
314915;202002;2142;6412;1797;5810;114;380;1192;3808;1306;4188
314920;202002;450;1169;285;917;7;24;192;633;199;657
314930;202002;5111;14490;3794;12049;661;2292;1501;4466;2162;6758
314940;202002;382;974;313;853;29;74;200;519;229;593
314950;202002;477;1212;307;928;29;112;159;431;188;543
314960;202002;760;1838;581;1549;26;84;423;1077;449;1161
314970;202002;841;2428;630;1996;130;462;261;743;391;1205
314980;202002;1382;3547;1001;2987;183;633;453;1326;636;1959
314990;202002;2250;6479;1535;4873;315;1083;315;890;630;1973
314995;202002;1537;4319;1217;3752;41;185;813;2375;854;2560
315000;202002;1091;2790;777;2310;62;198;511;1492;573;1690
315010;202002;362;1019;273;862;43;158;131;388;174;546
315015;202002;2187;6233;1898;5743;183;631;1246;3707;1429;4338
315020;202002;759;2230;544;1735;77;309;227;644;304;953
315030;202002;540;1441;350;1086;82;253;80;225;162;478
315040;202002;781;2243;648;1987;83;275;400;1215;483;1490
315050;202002;1170;3033;821;2474;53;194;434;1272;487;1466
315053;202002;1062;2783;809;2340;50;156;474;1319;524;1475
315057;202002;1661;5101;1358;4563;140;474;905;3071;1045;3545
315060;202002;533;1621;390;1343;75;271;101;330;176;601
315070;202002;484;1284;326;1008;74;257;88;250;162;507
315080;202002;2771;7936;2084;6607;266;906;1234;3755;1500;4661
315090;202002;761;2326;552;1933;83;317;208;694;291;1011
315100;202002;1204;3637;747;2584;138;539;307;956;445;1495
315110;202002;1735;4288;1256;3545;138;374;623;1808;761;2182
315120;202002;11384;26923;8307;22231;1146;2880;4422;12282;5568;15162
315130;202002;1327;3772;1082;3349;125;451;447;1307;572;1758
315140;202002;2820;7844;2149;6639;390;1321;1058;3085;1448;4406
315150;202002;4180;10046;2891;7976;443;1431;1366;3640;1809;5071
315160;202002;1635;4055;1062;3139;233;722;472;1389;705;2111
315170;202002;1322;4205;902;3192;220;861;206;694;426;1555
315180;202002;15701;38006;8078;23993;1125;3757;2468;6450;3593;10207
315190;202002;2056;4577;1580;3949;181;435;1173;2961;1354;3396
315200;202002;3706;10660;2635;8731;765;2727;690;2196;1455;4923
315210;202002;7870;20694;5296;15216;633;1959;2576;6702;3209;8661
315213;202002;1074;2828;920;2621;19;62;767;2164;786;2226
315217;202002;2676;7917;2023;6816;85;442;1401;4494;1486;4936
315220;202002;8020;21932;6232;18780;1159;3694;2621;7888;3780;11582
315230;202002;3027;7157;2524;6506;158;266;1970;5347;2128;5613
315240;202002;2357;6972;1983;6313;444;1477;974;3094;1418;4571
315250;202002;11609;31628;8089;24926;1328;4435;3401;10024;4729;14459
315260;202002;892;2474;469;1561;79;260;35;106;114;366
315270;202002;794;2282;557;1823;76;263;189;534;265;797
315280;202002;2789;6960;1628;4853;406;1334;259;754;665;2088
315290;202002;1127;2776;660;2035;190;656;184;539;374;1195
315300;202002;584;1423;389;1146;96;322;181;530;277;852
315310;202002;1236;3496;911;2865;72;259;512;1521;584;1780
315320;202002;643;1891;446;1493;67;269;194;596;261;865
315330;202002;730;2520;393;1592;65;303;119;432;184;735
315340;202002;2893;7092;2092;5942;233;713;1170;3289;1403;4002
315350;202002;1508;4133;1166;3600;167;605;645;1962;812;2567
315360;202002;1610;4798;1191;3917;181;641;481;1492;662;2133
315370;202002;442;1300;349;1111;65;193;144;447;209;640
315380;202002;178;530;132;425;30;98;26;56;56;154
315390;202002;1003;2875;785;2469;144;516;352;1019;496;1535
315400;202002;3813;10605;2986;9094;436;1391;1590;4668;2026;6059
315410;202002;2170;5057;1626;4265;461;1275;221;649;682;1924
315415;202002;1304;3578;1051;3207;211;754;431;1339;642;2093
315420;202002;1260;3641;837;2810;177;629;146;469;323;1098
315430;202002;3516;8610;2444;7003;445;1484;1062;2820;1507;4304
315440;202002;974;2600;777;2281;67;226;461;1279;528;1505
315445;202002;1875;4572;1341;3811;81;269;977;2732;1058;3001
315450;202002;2152;6101;1756;5465;233;705;1088;3395;1321;4100
315460;202002;34222;96049;28031;85012;4481;15296;15021;42889;19502;58185
315470;202002;586;1692;406;1240;29;104;243;709;272;813
315480;202002;1126;3256;783;2516;156;527;249;778;405;1305
315490;202002;2765;6985;1887;5591;288;872;679;1965;967;2837
315500;202002;496;1343;297;910;40;144;139;369;179;513
315510;202002;1159;3076;984;2826;23;106;856;2409;879;2515
315520;202002;966;2698;779;2370;54;201;586;1733;640;1934
315530;202002;549;1567;436;1372;128;454;213;631;341;1085
315540;202002;1332;3641;918;2860;99;362;410;1252;509;1614
315550;202002;1854;4831;1199;3621;249;856;298;887;547;1743
315560;202002;6130;18725;5175;16982;289;917;3456;11572;3745;12489
315570;202002;1933;5285;1552;4668;84;329;929;2701;1013;3030
315580;202002;2568;6108;1893;5058;268;845;742;1871;1010;2716
315590;202002;837;2165;645;1861;71;255;355;960;426;1215
315600;202002;2399;7645;1714;6284;255;886;895;3424;1150;4310
315610;202002;898;2311;663;1870;105;368;289;707;394;1075
315620;202002;468;1272;342;1074;42;154;204;647;246;801
315630;202002;935;2486;681;2027;133;418;292;797;425;1215
315640;202002;339;848;253;742;28;108;153;421;181;529
315645;202002;931;2417;628;1922;149;495;162;479;311;974
315650;202002;1665;4082;1329;3614;34;120;1093;2874;1127;2994
315660;202002;2403;5944;1795;4888;98;302;1279;3355;1377;3657
315670;202002;12881;35436;9742;29774;1937;6167;4371;12886;6308;19053
315680;202002;2978;8768;2165;7200;308;1180;1073;3392;1381;4572
315690;202002;3112;7607;1797;5319;387;1154;551;1759;938;2913
315700;202002;7551;21242;5623;17404;895;2945;2547;7475;3442;10420
315710;202002;1810;4545;1276;3726;42;192;908;2542;950;2734
315720;202002;4227;11815;3547;10631;166;681;2567;7356;2733;8037
315725;202002;2021;5413;1556;4592;139;392;1052;3175;1191;3567
315727;202002;529;1378;392;1155;55;187;156;449;211;636
315730;202002;549;1727;482;1585;78;294;188;581;266;875
315733;202002;1114;2840;789;2289;113;403;311;846;424;1249
315737;202002;1105;3212;872;2740;32;137;620;1886;652;2023
315740;202002;790;2210;620;1868;77;274;384;1079;461;1353
315750;202002;1243;3308;970;2853;89;273;592;1769;681;2042
315760;202002;1087;2621;958;2456;42;122;818;2053;860;2175
315765;202002;1840;4954;1505;4520;24;113;1326;3957;1350;4070
315770;202002;937;2625;708;2302;285;1024;140;378;425;1402
315780;202002;26855;73854;22394;66124;1322;4850;15611;44199;16933;49049
315790;202002;3485;10836;2953;9811;384;1341;1748;5893;2132;7234
315800;202002;1191;4246;850;3340;134;597;251;868;385;1465
315810;202002;1273;3188;1034;2771;55;187;801;2055;856;2242
315820;202002;2498;6829;2017;6140;166;614;1407;4236;1573;4850
315830;202002;1168;3479;799;2696;82;299;283;901;365;1200
315840;202002;797;1944;539;1487;41;129;265;675;306;804
315850;202002;1110;3330;876;2903;174;618;424;1326;598;1944
315860;202002;447;1285;308;1034;70;246;93;282;163;528
315870;202002;448;1176;356;1033;19;66;253;694;272;760
315880;202002;1012;2655;655;2038;90;346;158;450;248;796
315890;202002;1606;4636;1283;4181;321;1133;626;2013;947;3146
315895;202002;5764;15611;4283;12743;415;1393;2239;6191;2654;7584
315900;202002;786;2034;672;1869;55;168;504;1362;559;1530
315910;202002;502;1418;422;1292;55;189;295;880;350;1069
315920;202002;1409;3578;756;2353;127;453;240;702;367;1155
315930;202002;1045;2385;685;1870;125;324;304;835;429;1159
315935;202002;760;2299;597;1990;119;426;207;688;326;1114
315940;202002;570;1598;453;1416;50;171;243;724;293;895
315950;202002;1120;3111;922;2785;80;238;708;2139;788;2377
315960;202002;4188;11899;2499;8476;808;3134;191;407;999;3541
315970;202002;606;1612;475;1439;57;198;317;961;374;1159
315980;202002;4094;8920;2174;5810;379;1070;793;1941;1172;3011
315990;202002;3547;9048;2761;7715;261;783;1596;4333;1857;5116
316000;202002;537;1379;399;1181;51;187;188;518;239;705
316010;202002;809;2156;591;1795;42;144;371;1044;413;1188
316020;202002;887;2736;715;2403;81;327;423;1331;504;1658
316030;202002;2668;7567;2001;6371;233;757;1266;4081;1499;4838
316040;202002;2245;6433;1626;5274;302;1091;393;1112;695;2203
316045;202002;1995;5267;1824;5059;67;153;1581;4489;1648;4642
316050;202002;354;992;269;850;35;128;153;458;188;586
316060;202002;647;1635;471;1371;18;80;331;927;349;1007
316070;202002;5104;14290;4142;12466;720;2239;1960;5735;2680;7974
316080;202002;705;2223;546;1894;139;502;76;253;215;755
316090;202002;380;1107;273;889;35;125;137;411;172;536
316095;202002;1239;3891;986;3242;263;904;322;1045;585;1949
316100;202002;2339;6926;1665;5491;306;1093;609;1828;915;2921
316105;202002;761;2126;623;1902;37;122;453;1407;490;1529
316110;202002;13147;38671;10966;34997;811;3010;7404;23331;8215;26341
316120;202002;1127;3242;698;2216;116;390;204;538;320;928
316130;202002;1231;2805;774;2053;60;185;448;1166;508;1351
316140;202002;1144;3085;724;2304;96;327;358;1113;454;1440
316150;202002;1756;3861;1441;3453;171;533;601;1381;772;1914
316160;202002;945;2615;777;2324;36;132;533;1543;569;1675
316165;202002;824;2074;631;1762;94;317;330;849;424;1166
316170;202002;1091;2763;811;2338;51;185;553;1537;604;1722
316180;202002;1262;3604;826;2691;141;549;147;431;288;980
316190;202002;2453;6970;1408;4509;217;723;521;1489;738;2212
316200;202002;3006;8733;2202;7303;555;1962;468;1537;1023;3499
316210;202002;4291;12687;3090;9980;1144;3969;200;539;1344;4508
316220;202002;572;1751;380;1313;99;387;43;163;142;550
316225;202002;1509;3456;1115;2809;42;163;846;1977;888;2140
316230;202002;385;1061;289;894;32;103;170;534;202;637
316240;202002;5416;15783;4737;14602;361;1204;3596;10904;3957;12108
316245;202002;2816;9328;2533;8843;120;698;1961;6519;2081;7217
316250;202002;9364;22772;6717;18601;1440;4402;2375;6513;3815;10915
316255;202002;2887;8055;2520;7464;121;374;1896;5689;2017;6063
316257;202002;1271;3179;891;2497;132;371;469;1280;601;1651
316260;202002;1950;5106;1488;4327;133;411;784;2348;917;2759
316265;202002;1108;2997;864;2584;20;72;635;1848;655;1920
316270;202002;3520;10988;2992;9822;491;1732;1419;4421;1910;6153
316280;202002;2715;7950;2307;7162;318;1073;1290;3882;1608;4955
316290;202002;3354;9237;2666;7982;297;1048;1142;3305;1439;4353
316292;202002;4821;12914;3824;11236;470;1499;2518;7124;2988;8623
316294;202002;769;2300;562;1933;98;377;146;485;244;862
316295;202002;2880;8129;2335;7202;139;526;1647;4832;1786;5358
316300;202002;957;2804;790;2540;47;168;566;1811;613;1979
316310;202002;745;1995;476;1523;104;398;80;218;184;616
316320;202002;599;1689;451;1439;52;203;217;673;269;876
316330;202002;1024;2732;762;2262;44;178;563;1597;607;1775
316340;202002;965;2662;719;2211;69;281;408;1180;477;1461
316350;202002;1245;3577;1035;3238;90;308;724;2236;814;2544
316360;202002;606;1615;487;1412;47;150;355;1000;402;1150
316370;202002;4668;12604;3419;10334;673;2342;1227;3265;1900;5607
316380;202002;1663;3990;1295;3476;46;109;939;2530;985;2639
316390;202002;777;2084;544;1674;223;779;96;264;319;1043
316400;202002;1093;3118;688;2303;111;410;234;701;345;1111
316410;202002;1038;2998;869;2746;63;202;683;2133;746;2335
316420;202002;1885;5195;1637;4876;48;188;1367;3982;1415;4170
316430;202002;814;2169;510;1622;95;333;155;464;250;797
316440;202002;676;2132;535;1890;117;477;119;405;236;882
316443;202002;513;1446;377;1180;97;349;78;225;175;574
316447;202002;1843;5049;1609;4663;32;124;1354;3852;1386;3976
316450;202002;2078;6390;1585;5369;205;744;958;3163;1163;3907
316460;202002;1026;2652;821;2325;128;402;513;1362;641;1764
316470;202002;6281;18075;4411;14173;733;2705;1711;5028;2444;7733
316480;202002;191;528;159;481;37;109;79;235;116;344
316490;202002;305;820;215;661;27;89;84;217;111;306
316500;202002;1092;3483;713;2569;148;583;158;538;306;1121
316510;202002;707;2332;564;2056;113;431;256;939;369;1370
316520;202002;1111;2758;850;2337;118;407;437;1100;555;1507
316530;202002;1047;2773;759;2252;87;344;384;1007;471;1351
316540;202002;790;2072;613;1798;107;362;293;788;400;1150
316550;202002;1329;3893;1132;3508;53;187;878;2704;931;2891
316553;202002;3772;11376;2599;8485;428;1556;878;2574;1306;4130
316555;202002;2354;7740;2145;7460;105;399;1755;6148;1860;6547
316556;202002;516;1275;369;1017;30;87;206;528;236;615
316557;202002;981;3093;838;2845;305;1106;239;797;544;1903
316560;202002;328;916;222;754;53;227;67;189;120;416
316570;202002;1156;3403;951;3022;235;751;360;1153;595;1904
316580;202002;346;746;207;521;34;98;107;251;141;349
316590;202002;1263;3320;890;2581;171;451;468;1319;639;1770
316600;202002;908;2831;778;2567;125;444;414;1340;539;1784
316610;202002;562;1802;461;1648;48;224;279;959;327;1183
316620;202002;1900;5242;1658;4902;85;270;1285;3819;1370;4089
316630;202002;1491;4513;1212;3984;324;1076;489;1727;813;2803
316640;202002;137;361;106;314;17;57;48;120;65;177
316650;202002;1001;3231;788;2919;73;294;498;1847;571;2141
316660;202002;179;452;77;239;7;24;13;37;20;61
316670;202002;1746;4452;1267;3669;305;956;473;1337;778;2293
316680;202002;2189;5608;1607;4509;90;268;1245;3407;1335;3675
316690;202002;1295;3707;962;3095;173;613;439;1363;612;1976
316695;202002;995;2899;811;2567;37;153;550;1706;587;1859
316700;202002;382;895;314;814;14;46;241;582;255;628
316710;202002;2889;9560;2192;8100;458;1798;866;3182;1324;4980
316720;202002;19357;53237;14020;42987;2537;8256;5863;17106;8400;25362
316730;202002;398;1106;320;955;40;133;166;462;206;595
316740;202002;665;2005;568;1846;65;246;354;1152;419;1398
316750;202002;366;1099;282;942;57;231;130;391;187;622
316760;202002;3453;11026;2811;9732;1125;4216;615;2007;1740;6223
316770;202002;1565;3626;1207;3119;23;77;989;2623;1012;2700
316780;202002;519;1562;399;1321;155;575;62;179;217;754
316790;202002;663;1786;465;1398;99;319;139;376;238;695
316800;202002;5905;16851;4697;14628;464;1687;2475;7423;2939;9110
316805;202002;977;2171;784;1960;63;177;605;1524;668;1701
316810;202002;592;1674;401;1272;73;266;203;602;276;868
316820;202002;289;697;154;456;9;33;75;204;84;237
316830;202002;678;1855;538;1631;68;249;345;1006;413;1255
316840;202002;2645;6997;2110;6073;194;706;1424;3888;1618;4594
316850;202002;1834;4882;1292;3888;203;664;574;1681;777;2345
316860;202002;18432;47717;13484;40360;2188;7573;6190;18009;8378;25582
316870;202002;7355;20198;5410;16468;826;2786;2415;6844;3241;9630
316880;202002;777;2121;627;1920;132;455;289;836;421;1291
316890;202002;1084;2429;621;1802;92;334;358;948;450;1282
316900;202002;2104;5756;1608;4759;327;1075;529;1449;856;2524
316905;202002;499;1503;399;1306;101;363;158;528;259;891
316910;202002;844;2235;522;1662;135;470;48;143;183;613
316920;202002;1599;4035;1070;3214;201;644;449;1321;650;1965
316930;202002;7069;20631;5113;17065;1145;4104;1333;4245;2478;8349
316935;202002;3877;10603;2796;8575;501;1645;1134;3349;1635;4994
316940;202002;6216;18396;4702;15249;740;2660;1825;5489;2565;8149
316950;202002;1810;4302;1405;3745;44;139;1166;3061;1210;3200
316960;202002;4954;11236;3560;9309;350;1010;2389;6097;2739;7107
316970;202002;3564;10249;3080;9338;490;1568;1310;3781;1800;5349
316980;202002;614;1878;461;1581;151;580;65;228;216;808
316990;202002;10169;27788;7032;21379;1929;6337;1007;2724;2936;9061
317000;202002;2482;7396;2197;6978;160;477;1631;5197;1791;5674
317005;202002;2492;7169;1965;6084;317;1033;1035;3143;1352;4176
317010;202002;22802;53515;13856;39920;2876;9108;5103;15206;7979;24314
317020;202002;60669;144148;34220;98315;6316;19894;10417;27599;16733;47493
317030;202002;650;1751;502;1549;18;83;390;1188;408;1271
317040;202002;10503;26776;7243;21163;1605;5047;2631;7853;4236;12900
317043;202002;833;1889;592;1556;55;152;424;1104;479;1256
317047;202002;1131;2742;778;2171;87;250;479;1303;566;1553
317050;202002;1134;3499;789;2699;109;387;326;989;435;1376
317052;202002;2267;6509;1821;5770;280;893;1091;3486;1371;4379
317057;202002;1783;4366;1305;3579;36;145;848;2287;884;2432
317060;202002;442;1176;257;799;33;112;113;311;146;423
317065;202002;1132;3356;923;2953;53;186;580;1741;633;1927
317070;202002;7234;19858;4997;15565;960;3372;1404;4126;2364;7498
317075;202002;842;2199;598;1779;98;330;249;662;347;992
317080;202002;5877;13858;4304;11350;1172;3316;1391;3496;2563;6812
317090;202002;4315;13013;3841;12241;297;911;2843;9113;3140;10024
317100;202002;2572;6133;1621;4547;371;1093;592;1608;963;2701
317103;202002;1938;5575;1632;5083;89;449;1206;3577;1295;4026
317107;202002;1374;3680;1047;3046;71;266;648;1672;719;1938
317110;202002;695;1618;348;1080;51;187;118;376;169;563
317115;202002;1045;3004;885;2720;48;129;613;1903;661;2032
317120;202002;12053;33199;9347;28831;1092;3914;5271;15777;6363;19691
317130;202002;10635;24866;6584;18212;1090;3365;2149;5928;3239;9293
317140;202002;732;1854;558;1590;38;106;383;1133;421;1239
317150;202002;973;2345;723;2027;31;100;561;1550;592;1650
317160;202002;3510;8530;2272;6551;176;561;1274;3716;1450;4277
317170;202002;1737;4377;1225;3479;206;682;495;1220;701;1902
317180;202002;1856;5896;1347;4656;257;955;347;1136;604;2091
317190;202002;1191;3216;874;2727;100;325;512;1580;612;1905
317200;202002;4789;12617;3585;10543;991;3161;728;1947;1719;5108
317210;202002;1147;2811;892;2467;23;89;660;1870;683;1959
317220;202002;243;752;205;680;49;165;74;260;123;425
320010;202002;4344;12761;3483;11063;362;1275;2271;7040;2633;8315
320013;202002;1782;5025;1163;3757;176;577;521;1745;697;2322
320016;202002;2948;7610;2296;6622;154;424;1773;5120;1927;5544
320020;202002;3706;9712;2737;8064;616;1995;983;3021;1599;5016
320030;202002;1635;4592;1047;3396;198;707;374;1160;572;1867
320035;202002;1845;5138;1506;4541;383;1281;645;1886;1028;3167
320040;202002;3759;10779;3074;9508;424;1419;1733;5205;2157;6624
320050;202002;1665;3819;1443;3504;190;554;862;2008;1052;2562
320060;202002;11453;31974;8478;26180;1298;4422;4003;11726;5301;16148
320070;202002;1367;3893;936;3008;177;638;333;1028;510;1666
320080;202002;5448;14134;3817;10964;811;2473;1385;3786;2196;6259
320090;202002;7914;21341;5174;15652;1149;3753;1877;5271;3026;9024
320100;202002;2716;7675;2188;6736;361;1259;1169;3553;1530;4812
320110;202002;1613;3955;1141;3184;170;509;573;1537;743;2046
320115;202002;1775;5758;1507;5315;652;2417;422;1533;1074;3950
320120;202002;20075;51773;13680;40442;2001;6412;6208;17610;8209;24022
320130;202002;42722;119840;34885;105732;4727;15795;20254;59641;24981;75436
320140;202002;3059;8673;2172;6916;344;1242;900;2814;1244;4056
320150;202002;12562;32840;8742;25439;2316;7345;1551;4050;3867;11395
320160;202002;5333;15072;3892;12338;662;2266;1829;5697;2491;7963
320170;202002;1387;4053;1013;3318;266;864;415;1429;681;2293
320180;202002;672;2153;546;1901;207;766;146;476;353;1242
320190;202002;2596;8370;2003;7061;484;1808;533;1783;1017;3591
320200;202002;1051;2908;763;2385;190;648;276;871;466;1519
320210;202002;4264;10953;3270;9213;525;1628;1754;4724;2279;6352
320220;202002;2494;6730;1856;5669;342;1145;887;2593;1229;3738
320225;202002;1318;4129;917;3162;331;1220;186;635;517;1855
320230;202002;4546;12806;3431;10943;821;2836;1331;4142;2152;6978
320240;202002;14619;37736;10688;31435;2580;8207;3673;10538;6253;18745
320245;202002;2891;8674;2303;7486;896;3057;461;1460;1357;4517
320250;202002;1971;5677;1288;4039;306;1052;363;1028;669;2080
320255;202002;1716;5472;1490;5072;439;1526;721;2549;1160;4075
320260;202002;1192;3476;770;2503;173;638;200;542;373;1180
320265;202002;2351;7339;1928;6487;908;3221;350;1182;1258;4403
320270;202002;2122;6155;1604;5141;376;1296;649;2075;1025;3371
320280;202002;6401;17411;5118;15194;1134;3622;2221;6387;3355;10009
320290;202002;1295;3895;827;2748;221;801;203;636;424;1437
320300;202002;3337;10315;2686;8982;789;2849;605;1875;1394;4724
320305;202002;4969;14171;3838;11929;731;2462;1870;5619;2601;8081
320310;202002;1952;5501;1331;4182;246;809;566;1712;812;2521
320313;202002;2234;5658;1380;4045;301;988;353;936;654;1924
320316;202002;1407;3998;1136;3543;170;550;705;2200;875;2750
320320;202002;20631;54503;14415;43852;3365;10714;5330;16256;8695;26970
320330;202002;2885;7871;2232;6689;429;1287;1158;3548;1587;4835
320332;202002;6165;17130;4856;14828;1209;3960;2196;6675;3405;10635
320334;202002;1619;4670;1141;3693;258;998;248;634;506;1632
320335;202002;1312;3908;903;2963;233;841;224;671;457;1512
320340;202002;4603;11700;3826;10562;489;1474;2259;6263;2748;7737
320350;202002;5134;12886;3575;10041;458;1364;1872;5019;2330;6383
320360;202002;1363;3508;1012;2847;119;323;517;1402;636;1725
320370;202002;2424;7596;1830;6290;565;2022;596;2042;1161;4064
320380;202002;2403;6526;1996;5869;236;744;1265;3639;1501;4383
320390;202002;6830;18685;5017;15070;1053;3338;2034;5778;3087;9116
320400;202002;3108;8918;2396;7412;681;2235;873;2580;1554;4815
320405;202002;4347;11579;3249;9719;553;1762;1481;4362;2034;6124
320410;202002;4613;12080;3465;10229;610;1789;1741;5351;2351;7140
320420;202002;2844;7558;2143;6377;665;2234;402;1179;1067;3413
320425;202002;2023;4897;1538;4097;87;259;1026;2656;1113;2915
320430;202002;2858;7187;2243;6067;291;891;1447;3734;1738;4625
320435;202002;2130;6704;1683;5823;597;2165;520;1824;1117;3989
320440;202002;1342;3714;966;3004;147;492;441;1322;588;1814
320450;202002;1561;4564;1214;3911;280;1019;535;1606;815;2625
320455;202002;3938;12009;2607;8863;675;2456;649;2037;1324;4493
320460;202002;2000;5949;1392;4648;337;1201;350;1086;687;2287
320465;202002;1130;3261;864;2751;122;417;484;1541;606;1958
320470;202002;3579;9927;2497;7627;571;1857;596;1634;1167;3491
320480;202002;1591;4456;1302;3964;202;712;757;2223;959;2935
320490;202002;20133;53071;14675;43487;2515;8181;6114;17892;8629;26073
320495;202002;1248;3441;864;2696;186;671;332;984;518;1655
320500;202002;50935;135973;40491;117992;5750;18184;23377;65334;29127;83518
320501;202002;4161;12163;3059;10166;865;3210;1040;3401;1905;6611
320503;202002;2201;6457;1472;4940;405;1476;441;1386;846;2862
320506;202002;2315;6965;1638;5471;509;1846;182;604;691;2450
320510;202002;9585;26084;7716;22864;871;2976;4793;13729;5664;16705
320515;202002;1649;4540;1266;3757;352;1135;420;1201;772;2336
320517;202002;2034;6217;1617;5331;543;1950;447;1431;990;3381
320520;202002;33981;88520;25115;73656;4530;14579;10552;29981;15082;44560
320530;202002;29566;78972;23028;67483;2247;7807;14406;39978;16653;47785
330010;202002;20637;55789;16750;49242;2382;7497;10547;30370;12929;37867
330015;202002;1454;3615;1127;3111;199;624;608;1591;807;2215
330020;202002;19624;49128;16513;44631;2369;7213;11448;30154;13817;37367
330022;202002;1814;4916;1389;4177;237;738;811;2410;1048;3148
330023;202002;4784;11417;3365;9425;593;1830;1797;4924;2390;6754
330025;202002;4857;11911;3162;9062;880;2764;829;2273;1709;5037
330030;202002;10039;26998;7533;22847;824;2908;4595;13304;5419;16212
330040;202002;14182;37046;11173;31929;1092;3498;7443;20445;8535;23943
330045;202002;82316;195453;67487;176782;5020;13182;53688;139861;58708;153043
330050;202002;2392;6393;1732;5279;368;1200;811;2345;1179;3545
330060;202002;4700;12579;3858;11110;782;2501;1715;4539;2497;7040
330070;202002;22151;56373;17715;49939;2840;8507;10416;29110;13256;37617
330080;202002;8627;21961;7328;20106;922;2690;5074;13744;5996;16434
330090;202002;3263;6853;2177;5390;126;344;1510;3744;1636;4088
330093;202002;2352;5816;1723;4929;116;359;1287;3680;1403;4039
330095;202002;1198;3419;916;2888;75;287;552;1604;627;1891
330100;202002;68761;183684;58299;168182;3618;12451;44457;126326;48075;138777
330110;202002;2036;5735;1638;5063;269;911;909;2705;1178;3616
330115;202002;2093;5206;1578;4466;231;754;949;2571;1180;3325
330120;202002;3452;7774;2547;6595;236;684;1736;4325;1972;5009
330130;202002;4140;11386;3372;10214;487;1555;2084;6247;2571;7802
330140;202002;3543;9327;2774;8201;406;1317;1749;5053;2155;6370
330150;202002;2120;5665;1600;4845;305;972;767;2268;1072;3240
330160;202002;1336;3648;995;3034;172;569;530;1542;702;2111
330170;202002;102281;257102;81355;228759;10984;30662;54399;154719;65383;185381
330180;202002;1966;4754;1498;4102;98;301;1034;2745;1132;3046
330185;202002;9402;23835;7820;21609;492;1662;6215;16751;6707;18413
330187;202002;4144;10614;3201;9068;440;1365;1866;5254;2306;6619
330190;202002;32107;78409;27066;71521;1932;5517;21413;55888;23345;61405
330200;202002;15498;39786;12546;36109;2467;6801;7853;23237;10320;30038
330205;202002;1953;4887;1493;4145;82;275;1054;2809;1136;3084
330210;202002;3370;8524;2425;6868;356;1112;1168;3042;1524;4154
330220;202002;10872;27382;7685;22076;1736;5570;2660;7078;4396;12648
330225;202002;3625;9223;2710;7829;196;685;1940;5466;2136;6151
330227;202002;17111;41310;14298;37856;577;1729;12239;32025;12816;33754
330230;202002;1666;3892;1184;3278;102;299;780;2145;882;2444
330240;202002;23115;60421;18824;53657;2424;7568;12243;34017;14667;41585
330245;202002;1628;4079;972;2944;196;631;361;1092;557;1723
330250;202002;36909;95156;30477;85660;5452;15646;18360;51688;23812;67334
330260;202002;4282;10532;3180;9032;342;1084;2157;5942;2499;7026
330270;202002;27845;61178;17062;44378;2833;7909;7000;17632;9833;25541
330280;202002;2310;6120;1717;5104;186;611;1012;2891;1198;3502
330285;202002;22549;54568;17730;47669;1455;4563;12925;33600;14380;38163
330290;202002;3636;8939;2888;7947;316;988;2020;5395;2336;6383
330300;202002;5585;13281;3980;10946;308;952;2751;7428;3059;8380
330310;202002;2359;5929;1751;4942;114;299;1194;3360;1308;3659
330320;202002;16189;38644;12271;33744;1385;3812;8875;24482;10260;28294
330330;202002;35389;78386;27054;67215;2478;6761;19435;47430;21913;54191
330340;202002;13917;34612;10091;28619;1655;5224;5122;13924;6777;19148
330350;202002;127239;299026;103587;270191;6811;18567;84258;218838;91069;237405
330360;202002;7353;17905;6287;16600;208;559;5327;14002;5535;14561
330370;202002;4628;13360;3458;11352;811;2731;1463;4999;2274;7730
330380;202002;5231;14168;3917;11804;700;2421;1921;5527;2621;7948
330385;202002;3855;11174;3119;10093;748;2672;1485;4763;2233;7435
330390;202002;25324;68836;19099;57979;2753;9541;10883;31232;13636;40773
330395;202002;3124;7804;2550;7069;163;514;1838;4975;2001;5489
330400;202002;3130;8405;2649;7642;141;516;1994;5440;2135;5956
330410;202002;2876;7905;2163;6649;402;1374;1017;2968;1419;4342
330411;202002;2705;7342;2086;6159;147;509;1455;4137;1602;4646
330412;202002;1454;4153;1161;3667;131;478;715;2125;846;2603
330414;202002;22456;56930;17959;50817;1589;4635;13108;36829;14697;41464
330415;202002;4045;11020;3115;9416;313;1002;1870;5651;2183;6653
330420;202002;10455;25920;7052;20456;926;3019;3512;9543;4438;12562
330430;202002;9324;22516;7776;20409;333;1102;6115;15497;6448;16599
330440;202002;2311;6298;1713;5276;298;1087;951;2787;1249;3874
330450;202002;1246;3608;996;3180;137;477;542;1703;679;2180
330452;202002;15971;41039;12632;35968;1688;5362;7932;21926;9620;27288
330455;202002;538308;1279892;408524;1093495;59021;168204;257125;677356;316146;845560
330460;202002;1171;3211;867;2758;155;523;467;1447;622;1970
330470;202002;4710;11824;3368;9756;1090;3247;1025;3049;2115;6296
330475;202002;9113;23875;7304;21508;1170;3943;4630;13339;5800;17282
330480;202002;5831;15138;4877;13746;388;1216;3396;9316;3784;10532
330490;202002;110418;254227;89160;225744;9875;26170;63992;160370;73867;186540
330500;202002;7182;17801;5981;16151;618;1869;4332;11535;4950;13404
330510;202002;39123;97328;28763;82714;4910;15001;17382;49256;22292;64257
330513;202002;1184;3084;924;2716;200;635;466;1379;666;2014
330515;202002;2412;6384;1903;5672;370;1189;1050;3049;1420;4238
330520;202002;10872;28832;8764;25497;1185;3808;5338;15142;6523;18950
330530;202002;1608;3964;1178;3321;245;746;545;1505;790;2251
330540;202002;2816;7482;2171;6378;521;1602;913;2599;1434;4201
330550;202002;8709;22879;6609;20107;1895;6245;2650;7951;4545;14196
330555;202002;16778;36155;13859;32713;850;2268;11072;26377;11922;28645
330560;202002;4117;11040;3293;9662;502;1515;1958;5607;2460;7122
330570;202002;2650;7330;2211;6656;351;1139;1427;4253;1778;5392
330575;202002;5354;13871;4593;12580;285;888;3660;9691;3945;10579
330580;202002;16313;43892;12395;36786;2335;7503;5796;16471;8131;23974
330590;202002;1431;3874;1178;3546;216;650;731;2237;947;2887
330600;202002;11365;30266;9150;26670;935;3138;5734;16308;6669;19446
330610;202002;9112;24324;7328;21531;581;2030;5133;14664;5714;16694
330615;202002;2020;5560;1551;4918;292;957;969;3126;1261;4083
330620;202002;3930;11255;3082;9776;710;2445;1291;3859;2001;6304
330630;202002;23564;59320;18381;51194;1389;4561;13082;35235;14471;39796
350010;202002;2025;5191;1003;3014;222;722;169;366;391;1088
350020;202002;672;1715;370;1130;46;145;153;426;199;571
350030;202002;3495;9820;2569;8182;647;2240;1030;3135;1677;5375
350040;202002;674;1943;376;1307;53;211;118;315;171;526
350050;202002;1164;2899;739;2143;176;585;243;559;419;1144
350055;202002;894;2372;688;2045;80;265;384;1082;464;1347
350060;202002;114;284;75;219;11;38;40;122;51;160
350070;202002;3322;8778;2057;6459;419;1471;610;1727;1029;3198
350075;202002;554;1657;412;1369;167;589;29;97;196;686
350080;202002;625;1618;385;1188;55;190;150;423;205;613
350090;202002;570;1356;333;931;70;216;139;356;209;572
350100;202002;2108;5671;1417;4436;112;434;853;2533;965;2967
350110;202002;469;1192;316;921;19;70;180;511;199;581
350115;202002;1241;3609;1008;3116;190;661;511;1416;701;2077
350120;202002;629;1458;326;882;36;111;163;391;199;502
350130;202002;2945;7829;2299;6672;414;1235;1124;3094;1538;4329
350140;202002;748;2142;486;1604;52;235;259;775;311;1010
350150;202002;487;1489;394;1307;93;293;106;326;199;619
350160;202002;10476;26164;6865;19616;889;2902;4138;11177;5027;14079
350170;202002;1981;5758;1542;4794;302;988;637;1850;939;2838
350180;202002;996;2481;496;1498;108;335;79;224;187;559
350190;202002;2740;7745;1862;5887;359;1304;782;2093;1141;3397
350200;202002;403;1140;313;977;18;63;208;616;226;679
350210;202002;5302;12164;3513;9490;487;1420;2125;5544;2612;6964
350220;202002;2805;7709;1867;5843;424;1405;610;1723;1034;3128
350230;202002;996;2595;813;2322;155;476;442;1222;597;1698
350240;202002;631;1847;398;1296;82;267;111;339;193;606
350250;202002;2234;6508;1644;5521;603;2200;288;1018;891;3218
350260;202002;772;1864;484;1365;55;164;296;813;351;977
350270;202002;4321;11706;3407;9964;542;1726;1786;4892;2328;6618
350275;202002;2304;6209;1811;5414;300;1002;1055;2990;1355;3992
350280;202002;17984;40274;10329;27929;1810;5230;3897;10132;5707;15362
350290;202002;3047;8406;2038;6327;371;1262;819;2358;1190;3620
350300;202002;614;1672;448;1353;68;205;230;659;298;864
350310;202002;844;2448;608;1952;106;403;232;662;338;1065
350315;202002;547;1414;355;1078;26;98;171;479;197;577
350320;202002;14287;36793;10367;29898;2275;7187;3760;10086;6035;17273
350330;202002;13592;33523;9519;25665;1080;3221;5930;15032;7010;18253
350335;202002;344;985;264;836;34;122;130;387;164;509
350340;202002;1122;2910;663;2069;119;411;252;718;371;1129
350350;202002;729;1861;557;1668;69;252;328;959;397;1211
350360;202002;1075;3200;818;2662;221;728;240;796;461;1524
350370;202002;595;1502;403;1154;147;402;116;348;263;750
350380;202002;3903;10759;2665;8267;777;2400;633;2010;1410;4410
350390;202002;9609;25775;7390;22001;1744;5375;3102;8998;4846;14373
350395;202002;416;1067;208;661;23;67;74;213;97;280
350400;202002;7756;19184;5297;15120;1303;4023;1488;4155;2791;8178
350410;202002;9103;25505;6465;20379;1408;4938;2358;6862;3766;11800
350420;202002;653;1738;457;1345;75;246;114;294;189;540
350430;202002;635;1718;507;1507;67;234;309;835;376;1069
350440;202002;1893;4839;1524;4273;114;366;1004;2746;1118;3112
350450;202002;6493;17844;4996;15273;1117;3720;2082;5932;3199;9652
350460;202002;1652;4310;823;2575;140;454;165;458;305;912
350470;202002;242;622;186;527;11;36;126;344;137;380
350480;202002;919;2353;563;1711;118;417;100;256;218;673
350490;202002;1791;4750;1261;3882;300;965;381;1081;681;2046
350500;202002;679;1805;507;1491;73;229;252;693;325;922
350510;202002;1104;2881;801;2327;93;303;464;1293;557;1596
350520;202002;2045;6282;1568;5334;261;988;702;2169;963;3157
350530;202002;2617;6576;1909;5264;216;656;1117;2889;1333;3545
350535;202002;1332;3660;1136;3380;169;572;716;2048;885;2620
350540;202002;1760;4349;1267;3595;169;496;766;2120;935;2616
350550;202002;8160;20154;5610;15942;607;2048;3293;8720;3900;10768
350560;202002;3842;10861;3023;9378;291;960;1876;5645;2167;6605
350570;202002;23505;65771;18764;56582;3580;11820;9370;27017;12950;38837
350580;202002;1908;5224;1030;3338;274;956;181;473;455;1429
350590;202002;4656;12726;3356;9830;471;1561;1950;5277;2421;6838
350600;202002;34988;80952;21328;57150;3182;9544;10141;24998;13323;34542
350610;202002;6373;17604;4514;13881;824;2775;2049;5992;2873;8767
350620;202002;373;959;239;763;26;92;139;421;165;513
350630;202002;1398;3664;1017;2978;74;276;663;1813;737;2089
350635;202002;8009;20092;5977;16974;1021;3209;3370;9058;4391;12267
350640;202002;888;2444;468;1482;73;237;133;361;206;598
350650;202002;7708;20734;5116;15584;1049;3443;1805;5087;2854;8530
350660;202002;4448;11720;3399;9995;576;1713;1762;5159;2338;6872
350670;202002;1810;4814;1479;4333;157;487;989;2882;1146;3369
350680;202002;1084;2938;707;2243;143;467;271;822;414;1289
350690;202002;1249;3239;867;2608;149;476;474;1375;623;1851
350700;202002;4576;11617;3145;9426;578;1958;1370;3875;1948;5833
350710;202002;2656;7384;2227;6628;376;1300;1199;3314;1575;4614
350715;202002;803;2300;650;2024;74;297;350;984;424;1281
350720;202002;150;396;110;324;19;56;32;75;51;131
350730;202002;577;1561;479;1392;27;108;365;994;392;1102
350740;202002;1525;4128;1019;3087;199;627;311;878;510;1505
350745;202002;562;1432;304;926;36;133;128;357;164;490
350750;202002;9553;24851;7177;20734;1284;4290;3229;8331;4513;12621
350760;202002;12960;32518;8998;25664;2058;6456;3369;8676;5427;15132
350770;202002;936;2342;578;1719;39;126;363;1053;402;1179
350775;202002;632;1500;423;1181;42;126;211;578;253;704
350780;202002;1922;4767;1330;3909;236;777;483;1610;719;2387
350790;202002;1586;4254;969;3121;193;675;258;682;451;1357
350800;202002;3238;9492;2763;8668;279;1010;1841;5586;2120;6596
350810;202002;2552;6371;1998;5561;281;746;1145;3259;1426;4005
350820;202002;892;2102;490;1387;50;170;239;607;289;777
350830;202002;823;2318;455;1495;72;233;135;389;207;622
350840;202002;2921;8639;2100;7067;514;1909;861;2638;1375;4547
350850;202002;6502;18236;4924;15384;1029;3476;2135;6416;3164;9892
350860;202002;3500;9422;2994;8731;126;460;2270;6534;2396;6994
350870;202002;2556;7251;1863;6117;264;971;1016;3256;1280;4227
350880;202002;1185;3426;922;2902;232;758;275;833;507;1591
350890;202002;526;1353;326;937;49;148;121;318;170;466
350900;202002;6575;17847;4071;12514;984;3322;1180;3282;2164;6604
350910;202002;840;2134;712;1934;85;248;512;1363;597;1611
350920;202002;11417;28523;9543;25461;448;1485;7681;19712;8129;21197
350925;202002;4263;11681;3012;9381;571;1929;1412;4043;1983;5972
350930;202002;1407;3696;957;2819;100;310;583;1683;683;1993
350940;202002;2171;5782;1658;4947;186;618;1044;3000;1230;3618
350945;202002;801;2257;591;1847;93;350;314;879;407;1229
350950;202002;82501;213396;62586;176062;8470;26250;37790;101298;46260;127548
350960;202002;6152;16808;4716;14125;576;1978;2810;7964;3386;9942
350970;202002;3388;9661;2429;7773;733;2611;458;1241;1191;3852
350980;202002;623;1723;500;1505;137;434;220;657;357;1091
350990;202002;1688;4768;1222;3998;297;1090;424;1308;721;2398
350995;202002;733;2284;656;2131;51;199;463;1439;514;1638
351000;202002;2720;7093;1903;5628;339;1068;718;2038;1057;3106
351010;202002;315;787;208;608;24;81;114;321;138;402
351015;202002;737;2245;590;1929;89;331;287;847;376;1178
351020;202002;8467;23234;6358;19596;1307;4140;3116;9352;4423;13492
351030;202002;2666;7998;2135;6907;326;1165;1129;3549;1455;4714
351040;202002;4837;12077;4025;10852;202;671;3294;8620;3496;9291
351050;202002;16569;40505;11622;32720;2378;7072;4942;13736;7320;20808
351060;202002;47120;118932;35624;99161;3795;11610;23746;63967;27541;75577
351070;202002;1411;3513;755;2355;185;625;130;392;315;1017
351080;202002;2690;6558;1896;5609;219;791;1250;3497;1469;4288
351090;202002;311;913;216;732;48;161;58;194;106;355
351100;202002;2433;6588;1538;4754;337;1089;440;1416;777;2505
351110;202002;5907;15118;3748;11077;644;2094;1581;4362;2225;6456
351120;202002;751;1916;494;1483;57;176;194;583;251;759
351130;202002;1098;2903;470;1547;95;319;94;293;189;612
351140;202002;1865;5404;1352;4385;300;1096;499;1446;799;2542
351150;202002;2129;6131;1379;4480;256;920;531;1527;787;2447
351160;202002;1086;3382;811;2734;178;629;214;634;392;1263
351170;202002;1352;3723;1163;3380;94;296;821;2318;915;2614
351190;202002;989;2750;635;2016;122;409;222;642;344;1051
351200;202002;1554;3738;1139;3123;93;286;796;2057;889;2343
351210;202002;1481;3659;897;2538;71;235;532;1402;603;1637
351220;202002;3126;8936;2649;8140;318;1009;1734;5294;2052;6303
351230;202002;1706;4685;1239;3857;233;827;547;1553;780;2380
351240;202002;2307;5891;1368;3907;279;833;543;1391;822;2224
351250;202002;1022;2743;586;1868;78;258;218;687;296;945
351260;202002;874;2223;621;1782;134;367;217;611;351;978
351270;202002;381;1040;312;926;32;109;187;490;219;599
351280;202002;3657;9648;2767;7980;527;1568;1280;3559;1807;5127
351290;202002;1157;2917;776;2254;127;400;425;1173;552;1573
351300;202002;16090;44096;10747;33781;2000;6795;4429;13403;6429;20198
351310;202002;3219;7973;2396;6681;180;622;1722;4547;1902;5169
351320;202002;863;2532;627;2026;124;428;218;637;342;1065
351330;202002;463;1087;380;937;26;80;275;607;301;687
351340;202002;6200;17717;4939;15516;1194;3921;2166;6780;3360;10701
351350;202002;11257;28214;9242;25042;1000;2901;6725;17721;7725;20622
351360;202002;3676;9939;3012;8944;743;2350;1147;3149;1890;5499
351370;202002;2004;5633;1317;4193;323;1108;421;1217;744;2325
351380;202002;45476;110910;31654;86719;4297;12598;17647;46164;21944;58762
351385;202002;305;807;150;459;25;76;44;129;69;205
351390;202002;1337;3261;789;2448;121;444;445;1288;566;1732
351400;202002;902;2547;741;2211;122;363;445;1297;567;1660
351410;202002;2566;7198;1803;5699;322;1041;689;2136;1011;3177
351420;202002;375;899;199;589;26;69;111;313;137;382
351430;202002;897;2479;679;2110;66;213;444;1342;510;1555
351440;202002;3150;8309;2007;5940;371;1148;556;1413;927;2561
351450;202002;1633;4357;1027;3220;206;699;158;384;364;1083
351460;202002;781;2062;599;1759;147;427;323;939;470;1366
351470;202002;1154;2933;877;2466;82;276;561;1483;643;1759
351480;202002;2419;7141;1892;6218;356;1283;807;2484;1163;3767
351490;202002;1890;5400;1598;4875;75;303;1278;3757;1353;4060
351492;202002;330;907;271;783;8;24;198;562;206;586
351495;202002;179;469;131;374;17;43;69;195;86;238
351500;202002;35466;88111;26112;72242;4026;12017;15179;40076;19205;52093
351510;202002;12598;31493;9056;25298;1124;3568;5589;14873;6713;18441
351512;202002;454;1225;314;916;55;160;109;292;164;452
351515;202002;3033;6738;1839;4897;320;954;533;1519;853;2473
351518;202002;2356;5950;1484;4379;201;661;820;2194;1021;2855
351519;202002;705;1956;423;1396;89;292;64;197;153;489
351520;202002;1175;2908;465;1449;53;187;186;504;239;691
351530;202002;340;902;190;576;24;73;76;181;100;254
351535;202002;1843;4494;1314;3591;206;618;673;1743;879;2361
351540;202002;2223;5577;1425;4196;304;1023;470;1213;774;2236
351550;202002;6678;16597;4329;12330;447;1485;2451;6455;2898;7940
351560;202002;426;1225;331;1034;82;284;97;276;179;560
351565;202002;197;568;155;491;40;141;41;116;81;257
351570;202002;19238;52196;14390;42312;1644;5248;8759;24624;10403;29872
351580;202002;242;626;137;422;13;42;61;191;74;233
351590;202002;490;1107;257;701;22;78;140;342;162;420
351600;202002;1294;3398;986;2853;93;295;613;1671;706;1966
351610;202002;718;1701;444;1223;28;87;256;664;284;751
351620;202002;21721;57998;15710;47446;2639;8990;7046;19221;9685;28211
351630;202002;25244;67189;19974;58060;3049;9302;12168;34352;15217;43654
351640;202002;15883;42382;12145;35488;1216;4068;8188;22977;9404;27045
351650;202002;359;947;158;517;18;69;43;118;61;187
351660;202002;731;2080;453;1448;87;290;63;160;150;450
351670;202002;5753;15493;3666;10979;779;2314;1605;4524;2384;6838
351680;202002;432;1238;270;877;45;145;61;156;106;301
351685;202002;417;1198;334;1063;94;296;106;311;200;607
351690;202002;1027;2623;591;1741;90;295;239;635;329;930
351700;202002;1342;3367;946;2666;155;441;524;1407;679;1848
351710;202002;714;1931;491;1507;45;156;263;736;308;892
351720;202002;1371;3574;890;2726;141;466;352;1029;493;1495
351730;202002;876;2302;728;2067;57;202;489;1326;546;1528
351740;202002;3439;8699;2674;7233;467;1372;1338;3356;1805;4728
351750;202002;1279;3388;785;2486;147;488;296;913;443;1401
351760;202002;3203;9068;2285;7208;467;1666;821;2322;1288;3988
351770;202002;1709;5110;1387;4478;271;919;718;2261;989;3180
351780;202002;1223;3164;700;2156;103;365;232;684;335;1049
351790;202002;1311;3123;1014;2732;165;460;597;1621;762;2081
351800;202002;492;1136;228;640;18;49;86;210;104;259
351810;202002;1001;2617;806;2318;34;107;594;1623;628;1730
351820;202002;2395;6754;1642;5295;443;1557;350;1030;793;2587
351830;202002;4337;11793;3300;9985;322;1188;2047;5868;2369;7056
351840;202002;8176;22774;6080;18831;906;3131;3129;9077;4035;12208
351850;202002;1561;4224;1008;3147;170;621;336;901;506;1522
351860;202002;2688;7819;2061;6634;368;1261;1112;3618;1480;4879
351870;202002;22599;58029;16819;48493;4602;13587;6608;19531;11210;33118
351880;202002;115842;302487;84647;248584;20545;66026;35711;100235;56256;166261
351885;202002;887;2395;697;2072;70;247;453;1285;523;1532
351890;202002;757;1995;483;1533;124;403;72;197;196;600
351900;202002;1064;2866;817;2491;118;365;459;1389;577;1754
351905;202002;382;1041;255;791;18;64;109;294;127;358
351907;202002;20368;53668;15557;45078;1849;5858;9909;27724;11758;33582
351910;202002;1386;3664;952;2728;73;232;537;1385;610;1617
351920;202002;796;2131;600;1761;87;302;288;768;375;1070
351925;202002;832;2253;643;1896;86;282;335;923;421;1205
351930;202002;3110;8793;2789;8197;587;1724;1841;5361;2428;7085
351940;202002;1043;2722;748;2203;116;377;367;1060;483;1437
351950;202002;1554;3648;1119;3013;64;190;767;1983;831;2173
351960;202002;5069;12853;3640;10311;815;2467;1621;4264;2436;6731
351970;202002;6862;20507;5374;17928;853;3148;2955;9534;3808;12682
351980;202002;984;2325;616;1729;81;259;357;928;438;1187
351990;202002;1369;3234;972;2655;54;200;466;1154;520;1354
352000;202002;2514;7216;2145;6466;264;915;1404;3949;1668;4864
352010;202002;2132;5762;1676;4997;437;1427;355;1081;792;2508
352020;202002;1408;3883;1074;3314;175;587;514;1500;689;2087
352030;202002;5238;14004;4076;12136;804;2640;2079;6005;2883;8645
352040;202002;2762;7466;1830;5547;277;920;661;1703;938;2623
352042;202002;2928;7172;1867;5460;371;1221;782;2198;1153;3419
352044;202002;2031;5441;1140;3705;182;677;242;721;424;1398
352050;202002;11330;30154;7013;21630;1781;6244;1204;3096;2985;9340
352060;202002;679;1832;489;1483;67;222;222;615;289;837
352070;202002;878;1780;556;1352;64;171;256;543;320;714
352080;202002;421;1057;255;741;26;84;99;259;125;343
352090;202002;1396;4119;1132;3590;133;500;537;1527;670;2027
352100;202002;2926;8322;2385;7309;545;1840;1104;3215;1649;5055
352110;202002;551;1617;420;1358;96;323;163;489;259;812
352115;202002;486;1339;395;1199;46;169;230;683;276;852
352120;202002;847;2562;681;2222;84;291;395;1210;479;1501
352130;202002;1864;5312;1230;3749;201;645;490;1373;691;2018
352140;202002;1109;2982;770;2319;137;442;368;1070;505;1512
352150;202002;796;2167;610;1843;87;281;392;1150;479;1431
352160;202002;954;2376;685;1964;79;275;376;1021;455;1296
352170;202002;2885;7814;2245;6524;343;1132;1304;3473;1647;4605
352180;202002;2454;6655;1872;5585;444;1491;561;1447;1005;2938
352190;202002;1157;3149;894;2748;162;480;429;1365;591;1845
352200;202002;328;994;232;797;33;127;89;295;122;422
352210;202002;18863;45079;14668;39529;1065;3183;11210;29660;12275;32843
352215;202002;588;1559;507;1460;62;199;344;943;406;1142
352220;202002;17769;44603;11594;33509;2702;8192;4163;11422;6865;19614
352230;202002;12706;37248;9589;31389;2288;8323;3465;10436;5753;18759
352240;202002;10354;26743;7826;22495;1722;5569;3381;8944;5103;14513
352250;202002;22888;64030;18135;55738;3025;9929;10695;32296;13720;42225
352260;202002;4734;11889;3168;8898;473;1532;1813;4556;2286;6088
352265;202002;882;2471;771;2311;45;178;591;1710;636;1888
352270;202002;1395;4191;1025;3378;222;800;356;1100;578;1900
352280;202002;2386;6112;1778;5227;196;715;1042;2798;1238;3513
352290;202002;1113;3255;892;2817;124;440;470;1337;594;1777
352300;202002;892;2425;582;1765;79;270;307;869;386;1139
352310;202002;43718;116348;32070;95925;8006;24524;13625;40886;21631;65410
352320;202002;6248;16609;4723;13605;736;2369;2467;6432;3203;8801
352330;202002;2108;5621;1573;4876;294;1071;810;2345;1104;3416
352340;202002;5309;14027;3809;11318;632;2143;1907;5199;2539;7342
352350;202002;2088;5982;1612;4926;182;685;881;2399;1063;3084
352360;202002;1212;3256;1005;2887;79;277;758;2097;837;2374
352370;202002;1028;2939;888;2708;21;90;709;2113;730;2203
352380;202002;802;2209;595;1830;118;373;214;622;332;995
352390;202002;14819;36294;9935;27840;1610;4914;5470;14475;7080;19389
352400;202002;3358;9274;2732;8113;593;2054;1429;3921;2022;5975
352410;202002;3112;8018;2310;6698;217;754;1428;3918;1645;4672
352420;202002;810;1980;569;1627;103;312;208;565;311;877
352430;202002;7458;18696;5260;14855;1164;3723;2372;6308;3536;10031
352440;202002;17002;46294;12550;37674;3085;9615;4707;13768;7792;23383
352450;202002;749;1847;367;1179;54;188;121;366;175;554
352460;202002;2840;7945;1923;6251;411;1472;731;2209;1142;3681
352470;202002;3073;7696;2214;6323;287;931;1273;3421;1560;4352
352480;202002;3598;8566;2285;6217;357;1111;1106;2732;1463;3843
352490;202002;677;1987;538;1729;101;342;252;768;353;1110
352500;202002;10023;25916;6731;19738;2864;9251;752;1260;3616;10511
352510;202002;3513;9497;2598;7906;556;1836;1191;3435;1747;5271
352520;202002;2552;6745;1946;5724;381;1261;1061;2815;1442;4076
352530;202002;9405;24585;5909;17799;1141;3906;1490;3687;2631;7593
352540;202002;531;1607;377;1254;63;234;115;341;178;575
352550;202002;972;2742;677;2174;136;471;208;595;344;1066
352560;202002;562;1579;424;1307;73;241;201;578;274;819
352570;202002;2120;6180;1281;4297;311;1112;137;388;448;1500
352580;202002;635;1637;520;1438;53;176;343;897;396;1073
352585;202002;254;715;192;604;15;59;113;321;128;380
352590;202002;12652;33245;8697;25716;2319;7431;3724;10226;6043;17657
352600;202002;1913;5158;1475;4347;167;545;916;2539;1083;3084
352610;202002;2882;8079;2156;6818;441;1581;875;2589;1316;4170
352620;202002;5491;14216;4183;12306;1250;3742;1577;4694;2827;8436
352630;202002;794;1977;586;1663;104;345;272;693;376;1038
352640;202002;2830;7342;2009;5900;209;644;1153;3259;1362;3903
352650;202002;563;1596;390;1201;59;214;142;407;201;621
352660;202002;987;2919;785;2491;143;469;369;1129;512;1598
352670;202002;8556;23223;5396;16948;1472;4904;1011;3076;2483;7980
352680;202002;3200;9565;2213;7318;348;1380;1092;3260;1440;4640
352690;202002;25677;64691;19605;54294;1396;4603;13654;36310;15050;40913
352700;202002;542;1352;394;1152;146;482;87;240;233;722
352710;202002;4831;12500;3357;9834;790;2551;1389;3718;2179;6269
352720;202002;7494;20589;5780;17354;2500;7649;1119;3135;3619;10784
352725;202002;510;1288;286;843;19;55;143;397;162;452
352730;202002;2649;7570;2195;6542;312;1035;1330;3640;1642;4675
352740;202002;2188;5166;1582;4280;170;529;968;2481;1138;3010
352750;202002;381;960;219;671;36;116;88;240;124;356
352760;202002;1588;4435;1197;3649;138;447;628;1890;766;2337
352770;202002;855;2320;576;1764;126;395;222;653;348;1048
352780;202002;596;1707;419;1357;80;262;118;372;198;634
352790;202002;434;1168;292;881;32;110;109;286;141;396
352800;202002;1224;3791;851;2928;237;854;116;338;353;1192
352810;202002;1123;2679;695;1912;87;250;420;1092;507;1342
352820;202002;466;1278;317;1017;67;220;72;251;139;471
352830;202002;559;1418;247;760;23;74;51;128;74;202
352840;202002;3764;10816;3061;9567;1057;3578;968;2929;2025;6507
352850;202002;10233;25163;6853;19700;1894;5911;2131;5533;4025;11444
352860;202002;957;2645;694;2167;132;438;256;770;388;1208
352870;202002;853;2134;602;1618;40;132;401;1016;441;1148
352880;202002;1682;3949;1183;3099;167;461;720;1788;887;2249
352885;202002;288;815;212;676;24;84;127;385;151;469
352890;202002;670;1609;421;1095;46;127;238;560;284;687
352900;202002;17318;45234;11290;33400;1902;5999;5028;13945;6930;19944
352910;202002;419;1123;213;683;18;56;65;183;83;239
352920;202002;2609;6699;1880;5444;140;436;1280;3591;1420;4027
352930;202002;5424;14722;3935;11811;717;2342;1836;5125;2553;7467
352940;202002;21132;58031;15025;45232;3237;10679;6020;16997;9257;27676
352950;202002;487;1294;282;897;75;248;44;124;119;372
352960;202002;693;1865;368;1180;63;217;81;228;144;445
352965;202002;235;654;144;475;46;149;35;105;81;254
352970;202002;2903;6959;2184;5777;246;686;1417;3706;1663;4392
352980;202002;1362;3633;1070;3194;266;856;540;1562;806;2418
352990;202002;3995;11290;3103;9834;641;2244;1537;4630;2178;6874
353000;202002;445;1229;241;754;38;124;54;140;92;264
353010;202002;2418;6017;1574;4534;353;1155;625;1658;978;2813
353020;202002;3529;9209;2001;5997;294;1016;678;1865;972;2881
353030;202002;4121;10553;2747;8105;648;2072;747;2109;1395;4181
353040;202002;625;1465;442;1196;63;185;261;660;324;845
353050;202002;5043;14487;3541;11415;703;2445;1576;4872;2279;7317
353060;202002;46924;120134;38424;106682;2713;9110;28780;77109;31493;86219
353070;202002;8722;25017;6147;19513;1236;4282;2391;7011;3627;11293
353080;202002;3985;11062;2645;8490;508;1840;1035;2896;1543;4736
353090;202002;523;1605;390;1323;31;112;232;767;263;879
353100;202002;292;798;129;423;28;91;35;90;63;181
353110;202002;7260;19740;5867;17698;1173;3605;3180;9871;4353;13476
353120;202002;379;955;270;775;39;133;112;284;151;417
353130;202002;2291;5396;1428;3982;381;1170;467;1206;848;2376
353140;202002;2625;6535;1870;5219;113;372;1291;3439;1404;3811
353150;202002;1445;3565;1015;2857;187;557;453;1202;640;1759
353160;202002;543;1439;386;1176;74;249;163;456;237;705
353170;202002;507;1366;374;1171;76;266;167;514;243;780
353180;202002;9402;23162;7311;19814;664;2017;5447;14348;6111;16365
353190;202002;3079;8364;2438;7108;290;911;1499;4117;1789;5028
353200;202002;1862;4948;932;3005;156;555;217;640;373;1195
353205;202002;343;1047;290;929;54;185;144;452;198;637
353210;202002;916;2139;573;1567;30;98;378;1012;408;1110
353215;202002;368;1030;283;870;45;148;138;385;183;533
353220;202002;698;1914;423;1318;94;281;52;156;146;437
353230;202002;794;2197;613;1907;171;583;240;686;411;1269
353240;202002;2185;5948;1747;5208;247;852;1016;2889;1263;3741
353250;202002;1234;2775;732;1946;97;281;403;1016;500;1297
353260;202002;1092;2551;590;1724;95;320;278;765;373;1085
353270;202002;661;1707;550;1509;42;134;385;991;427;1125
353280;202002;675;1834;462;1443;105;341;139;403;244;744
353282;202002;1726;4901;1452;4391;158;542;910;2608;1068;3150
353284;202002;346;804;175;479;22;81;77;184;99;265
353286;202002;162;401;90;287;12;38;33;93;45;131
353290;202002;1459;3884;898;2743;147;464;296;834;443;1298
353300;202002;1778;4825;1281;3826;207;692;577;1551;784;2243
353310;202002;379;942;267;731;22;78;179;461;201;539
353320;202002;644;1595;536;1439;9;39;466;1236;475;1275
353325;202002;622;1828;420;1383;94;296;155;496;249;792
353330;202002;507;1297;337;972;43;126;183;486;226;612
353340;202002;2756;7451;1896;5790;402;1358;832;2383;1234;3741
353350;202002;3301;8593;2252;6475;483;1530;637;1587;1120;3117
353360;202002;593;1681;447;1407;55;180;251;779;306;959
353370;202002;550;1608;452;1455;37;125;316;986;353;1111
353380;202002;256;760;208;665;28;99;110;312;138;411
353390;202002;5513;13735;4001;11203;489;1547;2251;5959;2740;7506
353400;202002;418;1152;310;945;51;182;115;290;166;472
353410;202002;503;1351;381;1135;71;223;213;631;284;854
353420;202002;419;1101;244;716;59;169;19;43;78;212
353430;202002;2079;5827;1548;4854;361;1236;640;1884;1001;3120
353440;202002;61469;167154;43760;132907;7369;24221;22885;66015;30254;90236
353450;202002;359;920;240;713;35;126;117;317;152;443
353460;202002;3168;8609;2256;6828;160;563;1060;3069;1220;3632
353470;202002;7550;19796;5294;15654;894;3021;2261;6081;3155;9102
353475;202002;1391;3619;953;2709;142;448;475;1250;617;1698
353480;202002;1574;4236;1246;3651;62;224;862;2433;924;2657
353490;202002;1055;2794;671;2055;101;331;288;839;389;1170
353500;202002;1000;2360;749;1980;168;449;401;1066;569;1515
353510;202002;765;2321;550;1792;137;488;143;392;280;880
353520;202002;1038;2728;648;2009;85;297;298;849;383;1146
353530;202002;2338;6195;1792;5219;248;818;960;2595;1208;3413
353540;202002;1988;5373;1620;4799;261;805;962;2792;1223;3597
353550;202002;5552;14419;4450;12671;735;2222;2537;6947;3272;9169
353560;202002;1976;5419;1416;4540;429;1489;363;1058;792;2547
353570;202002;573;1487;420;1240;46;143;257;720;303;863
353580;202002;2044;5425;1527;4406;331;953;727;2048;1058;3001
353590;202002;680;1806;435;1329;92;301;172;526;264;827
353600;202002;1693;4199;1262;3451;151;415;705;1882;856;2297
353610;202002;515;1523;365;1232;84;341;108;334;192;675
353620;202002;2572;6932;1784;5541;360;1254;584;1643;944;2897
353625;202002;454;1129;300;871;20;70;193;543;213;613
353630;202002;1233;3849;1013;3359;225;828;346;1046;571;1874
353640;202002;1318;3399;1054;3013;146;437;606;1725;752;2162
353650;202002;7673;20524;5655;16691;585;1940;3409;9453;3994;11393
353657;202002;372;970;258;772;26;82;115;320;141;402
353660;202002;1230;2627;830;2088;358;898;207;505;565;1403
353670;202002;3948;11041;3043;9259;610;2060;1497;4239;2107;6299
353680;202002;630;1665;454;1404;83;277;249;727;332;1004
353690;202002;418;1080;184;575;18;55;30;79;48;134
353700;202002;1938;5124;1593;4541;119;388;1163;3187;1282;3575
353710;202002;4397;9732;2493;6398;229;621;1545;3582;1774;4203
353715;202002;412;1080;241;757;11;46;74;215;85;261
353720;202002;1850;5043;1416;4399;183;644;857;2613;1040;3257
353730;202002;4212;11185;3121;9186;476;1613;1551;4180;2027;5793
353740;202002;1977;5242;1358;4134;329;1085;453;1234;782;2319
353750;202002;770;2332;531;1867;131;501;95;349;226;850
353760;202002;12258;28898;9259;24790;1768;4891;5090;13292;6858;18183
353770;202002;681;2053;376;1276;61;224;62;177;123;401
353780;202002;4995;14041;3893;11890;803;2742;1830;5149;2633;7891
353790;202002;2454;7509;1781;6095;515;2001;371;1096;886;3097
353800;202002;16889;44602;12935;38217;1902;5997;7204;21210;9106;27207
353810;202002;1075;2906;687;2091;109;371;287;819;396;1190
353820;202002;1622;4425;1109;3396;250;822;355;1019;605;1841
353830;202002;600;1535;434;1258;73;222;190;517;263;739
353850;202002;1555;4385;1187;3667;269;851;422;1269;691;2120
353860;202002;2443;6832;1869;5797;454;1620;816;2261;1270;3881
353870;202002;28076;74073;19508;57330;2625;8739;10173;27155;12798;35894
353880;202002;2898;8099;2274;6896;186;675;1409;4102;1595;4777
353890;202002;2367;5221;1556;4100;132;360;1059;2682;1191;3042
353900;202002;711;1988;495;1562;82;282;191;554;273;836
353910;202002;2052;5800;1677;5192;203;741;1100;3316;1303;4057
353920;202002;1756;4891;1216;3832;280;994;319;821;599;1815
353930;202002;3992;10659;2666;8218;511;1794;1059;2881;1570;4675
353940;202002;1022;2949;703;2294;134;447;235;716;369;1163
353950;202002;3113;8488;2366;7108;429;1420;1334;3712;1763;5132
353960;202002;685;1798;452;1346;90;297;182;507;272;804
353970;202002;659;1584;489;1333;45;134;323;852;368;986
353980;202002;14566;37259;11118;31184;834;2679;7883;21290;8717;23969
353990;202002;884;2171;526;1522;88;271;241;664;329;935
354000;202002;2366;5740;1288;3700;286;870;210;567;496;1437
354010;202002;341;899;245;746;39;132;138;406;177;538
354020;202002;3270;9128;2553;7618;661;2115;1017;2770;1678;4885
354025;202002;693;1933;442;1428;67;244;106;330;173;574
354030;202002;480;1064;250;681;49;145;121;309;170;454
354040;202002;786;1865;497;1374;22;81;359;952;381;1033
354050;202002;916;2570;624;2042;144;504;195;637;339;1141
354060;202002;3234;9184;2201;7008;511;1724;776;2301;1287;4025
354070;202002;3422;9145;2294;6942;413;1439;917;2360;1330;3799
354075;202002;2473;7231;1869;6079;233;872;1061;3342;1294;4214
354080;202002;1305;3570;851;2689;190;642;195;544;385;1186
354085;202002;394;841;307;729;0;0;225;497;225;497
354090;202002;1553;4367;1320;3875;89;285;1017;2958;1106;3243
354100;202002;18689;51335;12680;40798;2833;9765;4803;15314;7636;25079
354105;202002;1478;3736;995;2841;135;388;454;1218;589;1606
354110;202002;462;1280;306;990;50;177;105;332;155;509
354120;202002;1369;3688;907;2704;183;591;315;819;498;1410
354130;202002;5248;13954;3419;10426;877;2872;210;415;1087;3287
354140;202002;17876;43673;11763;32661;2078;6373;4991;12777;7069;19150
354150;202002;2906;6936;2151;5723;481;1322;872;2269;1353;3591
354160;202002;2877;8339;2104;6767;606;2098;591;1729;1197;3827
354165;202002;581;1777;451;1517;78;313;225;710;303;1023
354170;202002;1596;4485;1315;3934;73;258;868;2486;941;2744
354180;202002;374;1040;266;811;52;167;106;294;158;461
354190;202002;1394;3953;946;3022;64;235;415;1298;479;1533
354200;202002;820;2007;626;1709;73;215;405;1056;478;1271
354210;202002;735;1948;579;1688;38;137;425;1167;463;1304
354220;202002;2997;8144;2177;6493;376;1198;1073;3050;1449;4248
354230;202002;697;1740;544;1554;36;132;394;1086;430;1218
354240;202002;1560;4343;1026;3258;179;635;311;867;490;1502
354250;202002;494;1221;301;917;87;270;71;228;158;498
354260;202002;7998;21316;5992;17795;1275;4009;2461;7067;3736;11076
354270;202002;987;3001;793;2627;192;626;309;1011;501;1637
354280;202002;745;1887;630;1720;58;196;404;1031;462;1227
354290;202002;870;2765;722;2458;124;420;365;1275;489;1695
354300;202002;3454;10187;2908;9178;866;2735;1032;3238;1898;5973
354310;202002;644;1930;524;1672;126;421;187;558;313;979
354320;202002;891;2199;564;1632;74;254;226;584;300;838
354323;202002;441;1079;294;813;31;71;127;337;158;408
354325;202002;1255;3742;883;2922;140;464;343;1098;483;1562
354330;202002;8814;22475;5697;16088;714;2380;3279;8561;3993;10941
354340;202002;29801;75410;19522;57411;3267;10685;9608;26839;12875;37524
354350;202002;1127;2910;888;2512;82;254;615;1660;697;1914
354360;202002;570;1484;314;1046;60;211;62;209;122;420
354370;202002;982;2849;776;2504;128;450;439;1390;567;1840
354380;202002;699;1855;490;1514;90;351;118;282;208;633
354390;202002;12649;30572;7843;22103;1496;4482;2978;8000;4474;12482
354400;202002;1508;4832;1121;3925;193;732;415;1416;608;2148
354410;202002;5299;14530;3934;11761;873;2806;1684;4796;2557;7602
354420;202002;1435;3784;1045;3071;132;411;646;1810;778;2221
354425;202002;2520;6183;1755;4853;410;1149;734;2045;1144;3194
354430;202002;1493;3980;1142;3413;124;432;679;1896;803;2328
354440;202002;531;1430;342;1039;53;186;151;418;204;604
354450;202002;400;1052;211;694;35;119;59;173;94;292
354460;202002;863;2179;558;1629;79;246;308;867;387;1113
354470;202002;458;1170;294;848;22;75;142;357;164;432
354480;202002;1151;2624;740;1972;66;185;493;1253;559;1438
354490;202002;753;2270;536;1789;116;407;228;710;344;1117
354500;202002;1936;5507;1578;4955;487;1660;366;1159;853;2819
354510;202002;699;1976;553;1678;52;170;299;826;351;996
354515;202002;310;913;224;732;35;133;89;280;124;413
354520;202002;6222;17247;4227;12912;625;2180;2304;6567;2929;8747
354530;202002;4053;11658;3075;9737;737;2381;1196;3790;1933;6171
354540;202002;1265;3353;910;2731;213;674;343;1033;556;1707
354550;202002;512;1347;391;1113;53;161;228;610;281;771
354560;202002;2076;5064;1091;3159;146;428;545;1461;691;1889
354570;202002;1161;2938;462;1355;85;270;63;176;148;446
354580;202002;8679;22671;5524;16692;856;2832;2756;7975;3612;10807
354600;202002;1768;4829;1335;4001;148;517;856;2423;1004;2940
354610;202002;404;1051;219;666;28;89;97;286;125;375
354620;202002;404;1163;247;839;48;186;90;274;138;460
354625;202002;307;824;162;525;30;104;25;54;55;158
354630;202002;1863;5622;1472;4813;535;1832;251;751;786;2583
354640;202002;3059;8813;2196;7086;395;1405;775;2294;1170;3699
354650;202002;843;2211;665;1913;54;152;416;1184;470;1336
354660;202002;3630;8478;1844;5479;172;627;870;2343;1042;2970
354670;202002;1046;2927;707;2247;145;489;256;732;401;1221
354680;202002;4809;12814;3664;10902;868;2678;1815;5531;2683;8209
354690;202002;492;1575;347;1246;75;276;96;337;171;613
354700;202002;843;2243;592;1757;87;276;293;827;380;1103
354710;202002;456;1237;330;996;43;149;152;398;195;547
354720;202002;280;673;121;357;40;123;27;78;67;201
354730;202002;9302;26209;6875;21528;986;3367;3819;11550;4805;14917
354740;202002;303;827;114;386;19;77;17;54;36;131
354750;202002;2375;6178;1460;4437;254;832;627;1711;881;2543
354760;202002;1889;5148;1283;3984;323;1088;398;1127;721;2215
354765;202002;354;932;135;443;21;70;25;70;46;140
354770;202002;2204;5492;1598;4469;298;936;764;1977;1062;2913
354780;202002;51720;132294;38657;106328;4446;13752;23765;61301;28211;75053
354790;202002;936;2601;734;2266;82;284;454;1347;536;1631
354800;202002;2455;6355;1901;5496;483;1426;802;2200;1285;3626
354805;202002;1294;2985;870;2353;103;275;503;1259;606;1534
354810;202002;635;1844;346;1220;39;161;74;235;113;396
354820;202002;889;2582;615;2038;115;423;159;430;274;853
354830;202002;441;1086;277;786;53;161;94;251;147;412
354840;202002;850;2104;485;1387;39;125;289;776;328;901
354850;202002;20871;54314;14324;42439;1662;5696;8540;23893;10202;29589
354860;202002;1692;4798;1004;3299;179;644;307;899;486;1543
354870;202002;54789;138921;41833;114882;4722;14281;25812;66955;30534;81236
354880;202002;5546;13720;2561;7330;324;1070;919;2116;1243;3186
354890;202002;16180;40451;12436;34131;1690;5231;7423;19634;9113;24865
354900;202002;385;980;243;727;38;121;68;184;106;305
354910;202002;5119;13490;2959;9535;669;2278;464;1424;1133;3702
354920;202002;457;1227;209;714;27;107;42;143;69;250
354925;202002;285;821;170;552;21;74;40;114;61;188
354930;202002;385;916;216;632;13;47;105;281;118;328
354940;202002;2195;6671;1508;5109;517;1873;265;812;782;2685
354950;202002;1407;3689;1106;3266;58;237;818;2281;876;2518
354960;202002;877;2341;664;2027;57;205;387;1118;444;1323
354970;202002;3964;11160;3046;9566;374;1308;1893;5761;2267;7069
354980;202002;30430;72165;19693;53636;2224;7193;11693;29576;13917;36769
354990;202002;59708;152241;43897;123360;3875;12535;28176;74876;32051;87411
354995;202002;2712;6245;2031;5346;179;574;1448;3632;1627;4206
355000;202002;1525;3836;1137;3274;176;594;541;1429;717;2023
355010;202002;3647;9955;2107;6692;706;2314;215;708;921;3022
355020;202002;3489;9896;2503;8135;619;2192;858;2659;1477;4851
355030;202002;1282617;3156149;906637;2428613;142428;418640;444973;1096990;587401;1515630
355040;202002;2771;7029;2154;6215;326;928;1457;4255;1783;5183
355050;202002;940;2188;662;1774;170;498;263;645;433;1143
355060;202002;5912;16135;4257;12978;722;2532;2048;5674;2770;8206
355070;202002;8370;21791;6641;19006;773;2583;4227;11420;5000;14003
355080;202002;889;2555;536;1860;108;413;77;205;185;618
355090;202002;1066;3117;787;2624;218;709;227;794;445;1503
355100;202002;21958;57651;16797;49922;2781;8729;9970;29337;12751;38066
355110;202002;802;2270;576;1906;177;657;101;304;278;961
355120;202002;671;1771;474;1476;37;130;199;582;236;712
355130;202002;825;1839;381;1041;28;85;214;556;242;641
355140;202002;1769;4111;1483;3705;102;305;1209;2930;1311;3235
355150;202002;4171;11051;3282;9459;383;1241;2088;5755;2471;6996
355160;202002;1830;5066;1290;4083;321;1127;296;892;617;2019
355170;202002;9652;24686;7385;20838;1462;4445;3843;10502;5305;14947
355180;202002;2695;7333;1880;5929;415;1448;671;1919;1086;3367
355190;202002;1813;4760;1419;4150;340;1003;746;2305;1086;3308
355200;202002;814;2508;682;2295;187;696;278;873;465;1569
355210;202002;2708;7471;2096;6195;408;1372;1060;2932;1468;4304
355220;202002;42640;113854;33169;95581;7993;24544;13425;35819;21418;60363
355230;202002;1092;2753;590;1756;100;290;205;577;305;867
355240;202002;22852;60646;15672;46285;2228;7141;8361;23258;10589;30399
355250;202002;35839;96465;25908;77175;6519;20454;9587;27086;16106;47540
355255;202002;683;1719;352;1098;60;201;132;387;192;588
355260;202002;1379;3496;996;2832;135;465;572;1500;707;1965
355270;202002;1155;3455;883;2888;202;678;287;873;489;1551
355280;202002;28133;72833;19411;56076;2966;9262;9102;24781;12068;34043
355290;202002;842;2333;623;1931;137;404;258;772;395;1176
355300;202002;1194;3520;913;2924;178;637;304;910;482;1547
355310;202002;951;2638;715;2241;97;304;396;1253;493;1557
355320;202002;502;1312;362;1058;72;245;150;355;222;600
355330;202002;2524;6606;1887;5489;143;526;1382;3834;1525;4360
355340;202002;3889;8616;2969;7389;374;829;1863;4743;2237;5572
355350;202002;1243;3629;915;3002;196;668;323;1049;519;1717
355360;202002;1120;2903;857;2516;117;370;520;1501;637;1871
355365;202002;357;944;184;627;42;132;28;99;70;231
355370;202002;5226;13397;3988;11490;969;2593;1797;5648;2766;8241
355380;202002;2808;7568;2089;6230;391;1256;746;1939;1137;3195
355385;202002;1371;3666;1114;3279;107;383;705;1921;812;2304
355390;202002;785;2171;548;1644;123;394;225;606;348;1000
355395;202002;1865;5159;1258;3946;218;731;447;1236;665;1967
355400;202002;8714;25221;6845;21488;1732;6170;2363;6612;4095;12782
355410;202002;21129;57896;13178;42137;2883;10144;3251;10235;6134;20379
355420;202002;604;1959;488;1730;138;542;119;409;257;951
355430;202002;3608;9253;2681;7582;660;1819;1211;3415;1871;5234
355440;202002;775;2110;460;1437;81;258;139;402;220;660
355450;202002;2986;7757;1900;5596;360;1129;763;2032;1123;3161
355460;202002;482;1185;302;886;40;142;152;410;192;552
355465;202002;368;991;274;834;43;138;131;396;174;534
355470;202002;1043;2683;583;1778;164;561;178;471;342;1032
355475;202002;350;836;275;725;17;40;201;517;218;557
355480;202002;3650;10212;2979;9209;451;1621;1925;5747;2376;7368
355490;202002;914;2460;485;1522;35;124;250;709;285;833
355495;202002;743;2113;532;1743;63;228;191;578;254;806
355500;202002;6411;16718;3697;11261;593;1978;1225;3447;1818;5425
355510;202002;1249;3081;775;2272;106;361;340;895;446;1256
355520;202002;365;807;164;478;26;78;47;124;73;202
355530;202002;405;931;141;413;18;65;54;142;72;207
355535;202002;492;1359;367;1152;75;291;161;451;236;742
355540;202002;10090;25723;8153;22929;1327;4051;5093;13911;6420;17962
355550;202002;610;1822;499;1620;71;254;265;812;336;1066
355560;202002;1075;2783;566;1799;130;458;36;117;166;575
355570;202002;237;675;127;416;22;72;34;100;56;172
355580;202002;1175;2903;773;2226;139;439;329;889;468;1328
355590;202002;170;425;128;355;17;52;76;199;93;251
355600;202002;1381;3383;916;2620;180;547;394;1101;574;1648
355610;202002;1687;4189;1110;3183;133;418;582;1582;715;2000
355620;202002;4332;11670;3142;9354;363;1315;1716;4688;2079;6003
355630;202002;2215;6121;1524;4807;250;823;751;2331;1001;3154
355635;202002;851;2501;616;2042;122;452;179;533;301;985
355640;202002;2814;7933;1860;5999;361;1258;544;1681;905;2939
355645;202002;4087;11534;2960;9543;419;1457;1606;5089;2025;6546
355650;202002;6317;17071;4937;14570;1392;4252;1699;4526;3091;8778
355660;202002;1232;3232;839;2496;137;478;294;857;431;1335
355670;202002;3279;8865;2138;6307;274;986;1095;2832;1369;3818
355680;202002;2651;7338;1119;3732;302;1052;121;425;423;1477
355690;202002;777;2315;486;1724;113;423;19;44;132;467
355695;202002;236;659;134;438;13;63;24;53;37;116
355700;202002;6917;19973;5556;16916;989;3142;2905;8404;3894;11546
355710;202002;8122;19223;5047;13614;807;2378;2235;5374;3042;7752
355715;202002;472;1253;240;739;50;168;48;133;98;301
355720;202002;1423;4021;1112;3469;182;608;599;1756;781;2364
355730;202002;875;2448;705;2118;137;449;317;862;454;1311
410010;202002;1186;3314;881;2680;188;612;183;537;371;1149
410020;202002;929;2951;717;2431;263;828;168;602;431;1430
410030;202002;1459;4104;1229;3735;177;607;659;1997;836;2604
410040;202002;11367;31710;8196;25777;1789;5994;2619;7646;4408;13640
410045;202002;827;2227;571;1754;77;274;207;588;284;862
410050;202002;2241;5616;1464;4244;293;936;466;1239;759;2175
410060;202002;1958;5660;1493;4693;364;1203;461;1401;825;2604
410070;202002;1779;4590;1272;3662;204;668;500;1316;704;1984
410080;202002;1325;3568;933;2837;204;644;318;969;522;1613
410090;202002;1066;2773;914;2531;84;224;570;1645;654;1869
410100;202002;1750;5118;1152;3647;162;587;160;478;322;1065
410105;202002;440;1123;236;723;33;111;67;190;100;301
410110;202002;2939;7555;2010;5744;283;875;830;2245;1113;3120
410115;202002;533;1380;371;1091;52;171;136;382;188;553
410120;202002;2379;6939;2054;6409;486;1679;984;2952;1470;4631
410130;202002;1122;3077;969;2788;209;668;468;1243;677;1911
410140;202002;13491;32606;8171;23040;1576;4895;1886;4861;3462;9756
410150;202002;15541;36833;7414;20795;1236;3815;1679;4313;2915;8128
410160;202002;2776;7748;2220;6770;505;1698;781;2371;1286;4069
410165;202002;718;1941;597;1696;55;190;356;943;411;1133
410170;202002;2516;6603;1649;4717;383;1195;134;384;517;1579
410180;202002;14293;39979;10894;32996;1507;4956;5738;16228;7245;21184
410185;202002;420;1226;292;904;51;166;84;238;135;404
410190;202002;2161;5376;1540;4276;324;920;416;1116;740;2036
410200;202002;4808;11274;2533;7322;418;1386;461;1289;879;2675
410210;202002;2950;7454;1789;5306;292;994;616;1583;908;2577
410220;202002;475;1233;306;916;48;158;72;203;120;361
410230;202002;1600;4312;1219;3533;155;527;657;1783;812;2310
410240;202002;4639;12466;3168;9603;809;2736;255;730;1064;3466
410250;202002;2536;6093;1834;4936;128;448;918;2396;1046;2844
410260;202002;1778;4499;1104;3236;188;557;482;1395;670;1952
410270;202002;446;1187;320;965;48;164;112;319;160;483
410275;202002;581;1652;386;1247;46;165;190;565;236;730
410280;202002;2202;5931;1438;4406;229;785;569;1590;798;2375
410290;202002;3157;8948;2121;6707;573;1826;552;1723;1125;3549
410300;202002;608;1557;482;1348;37;116;246;644;283;760
410302;202002;376;931;195;590;26;84;95;278;121;362
410304;202002;1191;3108;990;2743;115;312;579;1566;694;1878
410305;202002;1671;4062;1120;3263;129;411;679;1914;808;2325
410310;202002;2464;7055;1943;6023;352;1180;865;2673;1217;3853
410315;202002;653;1555;339;1047;121;373;78;240;199;613
410320;202002;1047;2912;695;2199;108;386;125;378;233;764
410322;202002;526;1404;283;859;30;102;140;389;170;491
410330;202002;1458;3597;994;2716;167;502;296;802;463;1304
410335;202002;807;2201;620;1848;92;295;279;782;371;1077
410337;202002;784;1893;538;1412;57;152;230;577;287;729
410340;202002;462;1309;304;911;29;94;142;358;171;452
410345;202002;2315;5955;1155;3400;237;733;330;873;567;1606
410347;202002;670;1708;484;1364;45;153;148;412;193;565
410350;202002;1227;3112;864;2504;115;350;355;976;470;1326
410360;202002;4194;10287;3235;8615;355;1069;1852;4731;2207;5800
410370;202002;12355;33678;7813;22849;978;3137;3227;8358;4205;11495
410380;202002;1384;3532;1000;2831;148;454;353;906;501;1360
410390;202002;2503;6469;1594;4785;380;1267;455;1242;835;2509
410395;202002;833;2443;675;2102;133;456;290;897;423;1353
410400;202002;5599;15011;4116;12144;659;2064;1899;5359;2558;7423
410405;202002;776;1879;581;1599;108;345;254;652;362;997
410410;202002;1180;3229;1104;3112;164;553;693;2015;857;2568
410420;202002;8790;24660;6497;20090;1135;3895;2290;6335;3425;10230
410425;202002;2955;8342;2010;6390;345;1207;741;2138;1086;3345
410430;202002;12308;31152;8391;23956;1386;4344;2844;7626;4230;11970
410440;202002;2241;6767;1899;6128;290;1046;1003;3170;1293;4216
410442;202002;2037;6325;1684;5561;482;1616;535;1710;1017;3326
410445;202002;2180;6378;1608;5259;321;1175;381;1309;702;2484
410450;202002;1364;3423;984;2808;182;582;346;915;528;1497
410460;202002;1934;4768;1499;4103;161;468;757;2004;918;2472
410465;202002;2547;7458;1965;6338;370;1234;683;2067;1053;3301
410470;202002;1932;5408;1366;4348;379;1365;213;717;592;2082
410480;202002;35786;84893;18513;54282;3003;9805;3959;9935;6962;19740
410490;202002;10519;29420;7387;22944;1394;4695;2847;8310;4241;13005
410500;202002;1657;4511;1119;3448;249;893;323;857;572;1750
410510;202002;1813;4492;1178;3305;237;651;328;931;565;1582
410520;202002;2943;9351;2619;8680;887;3019;937;3181;1824;6200
410530;202002;1508;3743;718;2065;106;304;171;416;277;720
410540;202002;2571;6985;1765;5359;277;912;814;2385;1091;3297
410550;202002;6889;18512;4359;12925;769;2464;1192;3046;1961;5510
410560;202002;1391;3699;1024;2934;224;697;360;898;584;1595
410570;202002;2393;6674;1751;5523;493;1822;196;660;689;2482
410580;202002;23896;62513;17211;50245;3491;10885;7169;19546;10660;30431
410590;202002;1527;4383;1000;3099;145;466;300;826;445;1292
410600;202002;1715;4646;1299;3842;274;781;475;1450;749;2231
410610;202002;694;1850;509;1486;55;197;223;617;278;814
410620;202002;2175;6414;1380;4510;305;1094;259;789;564;1883
410630;202002;2277;6057;1459;4367;277;942;284;692;561;1634
410640;202002;4466;10531;2965;7925;671;2096;404;1070;1075;3166
410645;202002;1010;2913;820;2666;268;890;343;1139;611;2029
410650;202002;2081;5729;1377;4276;273;911;485;1382;758;2293
410655;202002;878;2121;615;1655;23;77;313;795;336;872
410657;202002;586;1577;362;1104;49;185;133;335;182;520
410660;202002;3190;8277;1754;5115;321;976;442;1221;763;2197
410670;202002;1028;2594;608;1776;136;419;214;564;350;983
410680;202002;2566;7811;1842;5980;471;1555;338;1119;809;2674
410685;202002;524;1348;395;1127;98;321;157;402;255;723
410690;202002;118493;292448;75709;212864;12526;40227;27527;68105;40053;108332
410700;202002;2359;6035;1971;5429;276;789;1060;2835;1336;3624
410710;202002;793;2034;511;1509;71;218;232;649;303;867
410712;202002;606;1786;503;1584;130;444;179;539;309;983
410715;202002;793;2306;481;1598;73;248;162;509;235;757
410720;202002;3050;7734;2349;6398;328;1053;505;1318;833;2371
410725;202002;1023;2524;576;1706;114;353;89;212;203;565
410730;202002;612;1629;465;1363;103;348;97;276;200;624
410740;202002;923;2596;669;2112;93;325;270;837;363;1162
410750;202002;1673;4257;1318;3617;208;639;598;1549;806;2188
410752;202002;352;891;165;502;21;70;69;193;90;263
410753;202002;265;801;181;607;30;115;39;124;69;239
410754;202002;1054;2739;871;2459;60;155;599;1792;659;1947
410755;202002;549;1419;378;1084;57;175;159;401;216;576
410760;202002;3316;8671;2319;6898;586;1973;511;1368;1097;3341
410765;202002;12023;33910;9201;28364;1561;5281;1823;5058;3384;10339
410770;202002;1007;2427;688;1887;65;188;355;972;420;1160
410773;202002;1232;3335;1072;3086;109;352;662;1854;771;2206
410775;202002;1411;3565;1223;3282;72;208;799;2122;871;2330
410780;202002;600;1492;392;1091;62;188;104;278;166;466
410785;202002;685;1825;525;1546;90;291;190;561;280;852
410790;202002;694;1955;559;1710;157;534;67;145;224;679
410800;202002;3238;7239;2600;6302;46;162;1697;4007;1743;4169
410810;202002;362;983;274;813;23;67;132;371;155;438
410820;202002;794;2271;399;1263;79;259;73;207;152;466
410830;202002;32125;78565;20931;59675;4423;14379;7015;18842;11438;33221
410832;202002;963;2507;755;2141;86;276;444;1176;530;1452
410840;202002;7752;19937;4518;13700;859;2822;1161;3182;2020;6004
410845;202002;1087;2769;841;2402;152;452;370;1038;522;1490
410850;202002;2158;6303;1870;5792;306;1039;939;2791;1245;3830
410855;202002;756;1913;488;1404;42;122;233;624;275;746
410860;202002;4212;10462;3286;8963;361;1130;1826;4698;2187;5828
410865;202002;1292;3892;1142;3598;130;468;687;2184;817;2652
410870;202002;1230;3334;1026;2990;74;234;705;2028;779;2262
410880;202002;4174;11463;2917;9095;511;1728;446;1527;957;3255
410890;202002;929;2656;681;2167;153;541;183;568;336;1109
410895;202002;938;3038;792;2720;254;936;155;500;409;1436
410900;202002;786;2079;525;1565;99;299;99;239;198;538
410910;202002;358;847;215;584;11;36;133;337;144;373
410920;202002;800;1922;543;1519;75;228;260;719;335;947
410930;202002;1582;4130;1087;3243;264;929;230;664;494;1593
410940;202002;21456;59172;15248;47895;3177;10971;4680;14392;7857;25363
410950;202002;1882;5530;1668;5197;49;189;1387;4264;1436;4453
410960;202002;6764;17240;4402;13113;1015;3372;1603;4670;2618;8042
410965;202002;971;2509;677;1952;81;259;383;1090;464;1349
410970;202002;3720;10051;2553;7795;594;2164;358;932;952;3096
410975;202002;1272;3209;943;2690;97;289;463;1310;560;1599
410980;202002;6765;17176;4214;12534;510;1702;1779;4903;2289;6605
410990;202002;1303;3206;827;2473;224;770;260;710;484;1480
411000;202002;587;1576;380;1181;53;191;113;298;166;489
411005;202002;384;1025;233;697;44;136;57;159;101;295
411007;202002;2173;6134;1774;5445;425;1363;626;1927;1051;3290
411010;202002;4042;12179;3162;10372;825;2926;367;1089;1192;4015
411020;202002;2162;6273;1771;5560;517;1707;500;1518;1017;3225
411030;202002;705;1764;479;1288;27;109;278;666;305;775
411040;202002;879;2238;436;1249;47;145;139;345;186;490
411050;202002;1779;5608;1452;4889;401;1450;229;658;630;2108
411060;202002;1784;4634;1096;3334;262;930;175;458;437;1388
411065;202002;365;959;242;719;31;106;103;289;134;395
411070;202002;6548;16978;5136;14609;728;2304;2489;6861;3217;9165
411080;202002;2038;5411;1599;4629;414;1362;327;917;741;2279
411090;202002;800;2111;511;1552;38;145;145;415;183;560
411095;202002;1502;3535;1003;2779;115;353;340;886;455;1239
411100;202002;1079;2821;718;2174;84;289;224;687;308;976
411110;202002;623;1602;274;856;35;107;17;37;52;144
411120;202002;1135;3218;928;2817;307;1068;210;558;517;1626
411125;202002;4909;14502;4326;13377;920;2849;2117;6816;3037;9665
411130;202002;676;1851;476;1462;88;249;178;580;266;829
411140;202002;2168;6724;1821;5971;542;1901;488;1563;1030;3464
411150;202002;3638;9422;2426;6968;503;1669;242;514;745;2183
411155;202002;942;2414;541;1651;75;218;227;661;302;879
411160;202002;350;808;228;644;30;88;49;143;79;231
411170;202002;665;2014;487;1590;103;321;158;515;261;836
411180;202002;5077;13532;3882;11396;591;1914;1813;5021;2404;6935
411190;202002;1531;3962;1133;3255;186;573;450;1186;636;1759
411200;202002;4798;13028;3284;10150;839;2880;618;1640;1457;4520
411210;202002;2971;6613;1906;4896;341;983;593;1438;934;2421
411220;202002;814;2114;584;1669;133;411;168;456;301;867
411230;202002;818;2190;576;1712;114;359;215;635;329;994
411240;202002;1456;3551;924;2571;99;323;459;1173;558;1496
411250;202002;2140;5729;1565;4696;314;1084;490;1416;804;2500
411260;202002;314;846;196;598;24;62;77;226;101;288
411270;202002;1915;5198;1422;4209;210;647;697;1914;907;2561
411275;202002;1364;3176;920;2440;142;451;411;1016;553;1467
411280;202002;1274;3459;829;2599;226;727;112;334;338;1061
411290;202002;773;2047;488;1479;51;143;246;771;297;914
411295;202002;1201;3021;858;2353;105;302;377;969;482;1271
411300;202002;962;2401;585;1679;56;179;256;639;312;818
411310;202002;826;1937;624;1639;46;118;283;736;329;854
411320;202002;5206;13603;3716;10911;664;2074;1529;4043;2193;6117
411325;202002;1364;3904;1154;3539;185;561;658;2072;843;2633
411330;202002;3234;8761;2308;7074;530;1762;727;2227;1257;3989
411340;202002;794;2175;472;1460;65;218;167;491;232;709
411342;202002;979;2394;576;1601;96;288;243;644;339;932
411345;202002;1011;2643;757;2225;60;192;545;1618;605;1810
411350;202002;2497;6862;1592;5018;420;1432;211;613;631;2045
411360;202002;657;1587;467;1295;67;190;153;413;220;603
411370;202002;50729;124829;35606;99282;2595;8793;21460;56278;24055;65071
411373;202002;1333;3392;1075;3007;88;305;587;1657;675;1962
411375;202002;1051;2658;753;2097;126;365;298;798;424;1163
411380;202002;1079;2521;700;1793;37;106;418;997;455;1103
411390;202002;1456;4007;1125;3302;179;590;464;1189;643;1779
411400;202002;2175;5472;1644;4479;172;553;837;2164;1009;2717
411410;202002;2278;6301;1635;4910;358;1172;381;1111;739;2283
411420;202002;3888;9585;2032;6013;289;978;364;836;653;1814
411430;202002;3285;8963;2468;7424;558;1814;863;2358;1421;4172
411435;202002;403;1133;249;802;50;149;80;213;130;362
411440;202002;2361;6699;1882;5789;382;1291;684;2045;1066;3336
411450;202002;2420;6469;1846;5536;242;726;1009;3064;1251;3790
411460;202002;3624;9482;2169;6646;385;1392;408;1151;793;2543
411470;202002;701;1845;503;1453;95;286;182;487;277;773
411480;202002;4388;11892;3130;9522;662;2364;1022;2816;1684;5180
411490;202002;1577;4098;1200;3466;154;517;503;1320;657;1837
411500;202002;1237;3354;815;2436;146;487;165;414;311;901
411510;202002;2200;5711;1734;4907;391;1274;404;1154;795;2428
411520;202002;29340;71395;16361;46231;1977;6434;6205;15692;8182;22126
411530;202002;867;2278;508;1575;96;334;79;225;175;559
411535;202002;463;1355;257;845;30;108;60;159;90;267
411540;202002;2667;6520;1788;4929;177;571;891;2350;1068;2921
411545;202002;888;2577;733;2303;68;208;482;1537;550;1745
411550;202002;673;1729;465;1345;73;235;88;256;161;491
411560;202002;1871;5020;1048;3263;157;545;81;229;238;774
411570;202002;6607;15500;4285;11906;954;2899;771;2108;1725;5007
411573;202002;738;2007;624;1833;92;287;327;939;419;1226
411575;202002;1816;5007;1344;4059;270;871;319;949;589;1820
411580;202002;4464;10243;2612;7402;376;1311;481;1249;857;2560
411585;202002;605;1806;273;924;69;236;49;146;118;382
411590;202002;365;1026;249;781;29;93;129;365;158;458
411600;202002;274;693;171;532;38;123;51;151;89;274
411605;202002;1450;3373;874;2438;112;390;466;1274;578;1664
411610;202002;2369;5763;1649;4448;81;275;1070;2658;1151;2933
411620;202002;2732;7334;2323;6694;401;1218;1291;3695;1692;4913
411630;202002;702;1844;461;1378;72;252;156;419;228;671
411640;202002;449;1173;312;879;44;139;117;300;161;439
411650;202002;196;583;123;417;25;91;20;56;45;147
411660;202002;862;2168;619;1738;47;145;303;831;350;976
411670;202002;1291;3219;860;2354;103;307;398;1015;501;1322
411680;202002;1421;3829;1054;3108;136;460;478;1362;614;1822
411690;202002;3468;8953;2572;7444;540;1595;811;2443;1351;4038
411695;202002;628;1930;394;1297;43;154;161;505;204;659
411700;202002;1547;4054;990;2992;218;718;147;409;365;1127
411705;202002;1751;5518;1485;5060;296;948;835;3080;1131;4028
411710;202002;1759;4520;1181;3424;286;839;200;569;486;1408
411720;202002;1017;2378;715;1850;134;368;296;712;430;1080
411721;202002;903;2289;667;1859;132;368;161;448;293;816
411722;202002;737;1994;390;1164;48;162;144;352;192;514
411725;202002;1103;3142;745;2430;172;593;169;569;341;1162
411727;202002;1417;3987;909;2880;213;704;159;468;372;1172
411729;202002;687;1667;423;1165;51;187;160;382;211;569
411730;202002;4980;13377;3819;11107;824;2569;1571;4466;2395;7035
411740;202002;528;1368;261;790;51;144;61;170;112;314
411745;202002;695;1983;468;1475;69;233;76;178;145;411
411750;202002;4849;12889;3461;10150;450;1428;1732;4795;2182;6223
411760;202002;6470;17432;4933;14748;1675;5179;970;3223;2645;8402
411770;202002;2840;8309;2052;6547;512;1740;286;843;798;2583
411780;202002;2727;7727;2313;6934;643;2018;780;2350;1423;4368
411790;202002;2712;6564;1424;4219;304;1029;213;539;517;1568
411800;202002;927;2633;655;2032;108;350;128;387;236;737
411810;202002;1482;3925;1086;3106;182;531;506;1381;688;1912
411820;202002;10617;30688;8508;26939;2168;7303;3545;10974;5713;18277
411830;202002;557;1379;411;1130;74;212;95;293;169;505
411840;202002;11265;30289;7404;22193;1287;4170;1915;5254;3202;9424
411845;202002;487;1412;245;814;29;121;50;150;79;271
411850;202002;6918;17788;4667;13819;1199;3983;769;2074;1968;6057
411860;202002;661;1880;470;1483;72;228;126;363;198;591
411870;202002;569;1667;391;1264;85;305;96;272;181;577
411880;202002;2147;5441;1543;4459;230;744;527;1476;757;2220
411885;202002;999;2567;695;2024;94;314;236;638;330;952
411890;202002;1144;3038;732;2268;135;463;78;213;213;676
411900;202002;761;2123;450;1454;104;361;61;189;165;550
411910;202002;868;2583;613;2034;156;578;203;610;359;1188
411915;202002;14483;35614;9385;26413;1450;4595;3548;8951;4998;13546
411920;202002;1023;3082;839;2689;203;730;290;869;493;1599
411925;202002;456;1210;323;971;67;229;132;366;199;595
411930;202002;4782;14896;4003;13424;1748;6371;254;968;2002;7339
411940;202002;3190;9561;2432;7874;600;2020;755;2199;1355;4219
411950;202002;12892;35127;10469;31158;1572;5240;5954;17036;7526;22276
411960;202002;5705;15477;4506;13017;838;2690;1715;4670;2553;7360
411965;202002;406;1152;288;918;45;157;110;316;155;473
411970;202002;1015;2418;781;2099;158;393;338;1038;496;1431
411980;202002;1426;3602;1023;2926;251;735;369;1019;620;1754
411990;202002;36727;96561;23020;71172;4345;14851;7864;23187;12209;38038
411995;202002;2880;7234;2109;6055;607;1938;579;1562;1186;3500
412000;202002;1901;4381;1338;3434;31;97;954;2297;985;2394
412010;202002;555;1734;397;1389;60;226;105;306;165;532
412015;202002;526;1497;434;1335;55;188;256;781;311;969
412020;202002;430;1205;265;843;36;145;119;359;155;504
412030;202002;569;1602;389;1270;65;214;117;378;182;592
412033;202002;824;2230;573;1697;61;183;202;537;263;720
412035;202002;752;2028;472;1509;56;222;257;767;313;989
412040;202002;556;1481;346;1055;51;151;69;208;120;359
412050;202002;1561;3933;1051;3002;211;678;265;758;476;1436
412060;202002;6838;20360;5644;17936;1504;5418;1616;4904;3120;10322
412065;202002;604;1665;436;1315;96;310;113;344;209;654
412070;202002;1040;2688;814;2241;106;313;341;882;447;1195
412080;202002;1928;5470;1209;3939;185;629;211;619;396;1248
412085;202002;263;633;89;283;8;19;18;49;26;68
412090;202002;5637;14777;4167;12039;1111;3332;1476;4318;2587;7650
412100;202002;1515;4235;1145;3531;327;1100;262;885;589;1985
412110;202002;800;2096;545;1592;75;219;190;521;265;740
412120;202002;1889;5535;1444;4631;277;983;414;1150;691;2133
412125;202002;614;1769;434;1386;96;319;114;339;210;658
412130;202002;730;1878;493;1419;77;234;133;392;210;626
412135;202002;602;1594;269;808;38;110;92;253;130;363
412140;202002;1537;3725;996;2785;185;638;200;521;385;1159
412150;202002;2668;7120;2249;6368;318;1049;1373;3647;1691;4696
412160;202002;927;2879;532;1806;94;350;93;280;187;630
412170;202002;4073;11367;3389;10276;698;2296;1396;3929;2094;6225
412175;202002;1242;3599;1028;3231;220;703;449;1445;669;2148
412180;202002;1555;4329;1112;3497;140;517;515;1480;655;1997
412190;202002;3263;8215;2385;6699;321;976;1065;2949;1386;3925
412200;202002;1654;4979;1189;3884;321;1153;193;570;514;1723
412210;202002;595;1433;349;982;48;152;125;316;173;468
412215;202002;3216;8786;2542;7489;636;1826;1095;3566;1731;5392
412217;202002;893;2367;750;2129;54;167;497;1369;551;1536
412220;202002;5612;15698;4460;13560;1097;3355;1441;4615;2538;7970
412230;202002;2463;7355;1964;6415;345;1275;539;1516;884;2791
412240;202002;6531;16741;4079;12015;719;2301;1232;3318;1951;5619
412250;202002;1965;5068;1450;4123;345;1020;334;893;679;1913
412260;202002;1138;3071;796;2337;145;453;235;652;380;1105
412265;202002;849;2351;670;2045;129;414;288;837;417;1251
412270;202002;905;2477;560;1757;76;270;213;596;289;866
412280;202002;382;1069;294;931;65;217;90;256;155;473
412290;202002;965;2479;642;1888;99;316;197;556;296;872
412300;202002;1623;4200;1109;3277;245;762;235;709;480;1471
412310;202002;720;2006;586;1755;82;304;244;681;326;985
412320;202002;799;2068;525;1523;67;236;186;538;253;774
412330;202002;1467;3965;970;2998;193;649;325;1019;518;1668
412340;202002;1100;3110;661;2136;100;370;111;325;211;695
412350;202002;2733;7084;1717;5082;347;1076;315;837;662;1913
412360;202002;247;687;164;502;6;28;91;258;97;286
412370;202002;795;2293;531;1707;106;376;41;137;147;513
412380;202002;1473;4009;1019;3110;290;913;137;474;427;1387
412382;202002;496;1247;324;965;47;162;131;343;178;505
412385;202002;2091;5792;1689;5019;541;1521;518;1716;1059;3237
412390;202002;2282;5624;1848;4976;315;860;746;2046;1061;2906
412395;202002;671;1923;463;1455;53;150;201;646;254;796
412400;202002;851;2287;604;1793;120;397;167;496;287;893
412402;202002;1886;4683;1261;3634;317;937;157;466;474;1403
412405;202002;2858;7546;1842;5610;493;1810;45;129;538;1939
412410;202002;5507;14471;3967;11939;742;2549;1304;3719;2046;6268
412420;202002;489;1262;319;926;22;77;150;385;172;462
412430;202002;571;1457;294;868;25;83;122;338;147;421
412440;202002;2567;7123;1715;5459;437;1492;280;922;717;2414
412450;202002;387;1144;256;813;45;134;21;45;66;179
412460;202002;973;2578;764;2212;140;444;362;1035;502;1479
412470;202002;1467;4812;1200;4207;312;1144;270;936;582;2080
412480;202002;952;2569;602;1803;110;352;172;459;282;811
412490;202002;1236;3153;977;2665;123;339;501;1292;624;1631
412500;202002;1846;4672;1362;3767;298;811;404;1073;702;1884
412510;202002;1817;5631;1245;4155;278;995;121;330;399;1325
412520;202002;1177;3072;626;1856;150;441;55;154;205;595
412530;202002;636;1681;458;1317;72;229;111;312;183;541
412535;202002;760;1977;513;1502;83;266;114;287;197;553
412540;202002;1146;2999;809;2370;84;307;277;840;361;1147
412545;202002;651;1679;440;1235;66;189;161;438;227;627
412550;202002;29161;78520;19950;59982;3427;11223;7784;21458;11211;32681
412555;202002;269;706;173;491;16;45;48;98;64;143
412560;202002;4557;13364;3317;10442;568;1952;996;3128;1564;5080
412570;202002;4116;10605;2251;6947;503;1717;281;955;784;2672
412575;202002;946;2412;742;2061;75;227;424;1111;499;1338
412580;202002;1377;3662;950;2811;89;315;491;1401;580;1716
412590;202002;407;1075;219;695;33;112;21;51;54;163
412600;202002;1438;4012;1046;3210;169;608;428;1226;597;1834
412610;202002;734;1942;513;1466;53;157;272;708;325;865
412620;202002;1170;3080;889;2666;162;575;297;823;459;1398
412625;202002;8277;22002;4966;15354;703;2482;311;870;1014;3352
412627;202002;1096;3088;680;2231;133;459;186;610;319;1069
412630;202002;2798;8180;1979;6390;392;1281;614;1793;1006;3074
412635;202002;363;993;244;735;36;127;81;204;117;331
412640;202002;963;2541;521;1593;59;179;145;409;204;588
412650;202002;1539;4281;1216;3610;216;707;460;1196;676;1903
412660;202002;2282;5867;1570;4512;254;790;483;1246;737;2036
412665;202002;362;949;281;795;41;126;133;361;174;487
412667;202002;1671;4421;1232;3575;172;532;506;1404;678;1936
412670;202002;761;1826;498;1399;85;276;166;427;251;703
412680;202002;1703;4574;1134;3460;154;541;426;1168;580;1709
412690;202002;973;2597;708;2070;103;321;294;806;397;1127
412700;202002;1932;5141;1582;4589;188;641;876;2448;1064;3089
412710;202002;5555;16400;4096;13219;828;2995;1143;3306;1971;6301
412720;202002;1149;3381;865;2759;136;462;175;470;311;932
412730;202002;2209;5961;1405;4273;266;894;435;1247;701;2141
412740;202002;1758;4916;1183;3726;217;798;171;545;388;1343
412750;202002;3800;10048;3143;9112;311;1080;2074;5653;2385;6733
412760;202002;2788;7623;2288;6769;404;1351;1243;3463;1647;4814
412770;202002;9860;24892;5111;15506;731;2354;1158;3011;1889;5365
412780;202002;1151;3059;847;2509;183;592;336;971;519;1563
412785;202002;1933;4809;1337;3760;154;447;822;2273;976;2720
412788;202002;1236;3502;1016;3109;281;878;430;1296;711;2174
412790;202002;1247;3319;669;2097;101;368;212;591;313;959
412795;202002;1199;3132;626;1948;95;322;124;351;219;673
412796;202002;2137;6212;1752;5444;377;1248;573;1676;950;2924
412800;202002;3290;7997;2190;5975;253;790;998;2423;1251;3213
412810;202002;10692;27288;6588;18931;818;2762;2493;6357;3311;9119
412820;202002;6192;17016;4303;13214;1039;3368;1252;3829;2291;7197
412830;202002;319;910;217;687;31;93;54;170;85;263
412840;202002;1745;4429;1218;3439;141;437;515;1351;656;1788
412850;202002;2725;7213;1946;5835;306;982;823;2412;1129;3394
412853;202002;1490;3749;1233;3288;178;525;628;1498;806;2023
412855;202002;1187;3187;767;2278;140;486;228;637;368;1123
412860;202002;730;1803;502;1452;68;224;281;768;349;992
412862;202002;658;1612;431;1235;80;241;182;503;262;744
412863;202002;1226;3752;1111;3541;184;602;691;2184;875;2786
412865;202002;678;1869;490;1493;121;372;147;461;268;833
412870;202002;841;2183;605;1806;168;576;124;384;292;960
412880;202002;770;2099;511;1562;89;310;87;235;176;545
420005;202002;388;1159;225;794;33;124;105;372;138;496
420010;202002;3182;7848;2081;5986;127;417;1526;4400;1653;4817
420020;202002;421;1334;273;953;43;177;61;174;104;351
420030;202002;75;262;55;219;17;73;17;67;34;140
420040;202002;496;1517;293;1063;57;229;19;49;76;278
420050;202002;689;1598;441;1150;61;184;275;644;336;828
420055;202002;153;460;84;294;18;79;31;88;49;167
420060;202002;93;257;50;150;11;37;13;32;24;69
420070;202002;641;1985;475;1630;107;384;188;622;295;1006
420075;202002;72;189;35;106;6;21;10;20;16;41
420080;202002;325;942;252;780;68;228;95;294;163;522
420090;202002;392;1230;227;819;54;213;45;151;99;364
420100;202002;1195;3197;992;2880;48;177;804;2295;852;2472
420110;202002;234;754;211;703;48;185;95;290;143;475
420120;202002;457;1262;299;921;59;214;125;325;184;539
420125;202002;313;966;223;763;55;203;100;320;155;523
420127;202002;231;624;86;286;15;52;21;72;36;124
420130;202002;2831;7931;2112;6707;321;1244;1038;3046;1359;4290
420140;202002;3331;9023;2331;7273;644;2302;331;1027;975;3329
420150;202002;588;1512;394;1185;43;147;242;703;285;850
420160;202002;202;490;78;246;10;29;22;69;32;98
420165;202002;142;412;78;259;18;65;26;77;44;142
420170;202002;241;738;154;535;22;66;40;122;62;188
420180;202002;159;507;92;344;11;37;26;92;37;129
420190;202002;182;594;109;402;37;147;22;76;59;223
420195;202002;1304;3382;927;2769;292;1020;109;253;401;1273
420200;202002;3917;9581;2224;6428;300;1074;865;2128;1165;3202
420205;202002;1626;4427;1094;3366;165;528;593;1834;758;2362
420207;202002;1639;4334;1005;3118;194;686;405;1181;599;1867
420208;202002;276;808;170;610;50;193;51;168;101;361
420209;202002;126;424;80;286;21;83;25;90;46;173
420210;202002;2716;7036;1718;5425;332;1161;790;2433;1122;3594
420213;202002;729;2295;609;2048;135;492;298;990;433;1482
420215;202002;170;519;115;394;29;111;18;57;47;168
420220;202002;230;673;134;461;24;98;61;186;85;284
420230;202002;4563;12611;3425;10468;530;1764;1812;5364;2342;7128
420240;202002;11841;32796;7137;22139;934;3305;3495;9602;4429;12907
420243;202002;363;1048;288;891;45;155;172;506;217;661
420245;202002;1184;3096;828;2480;63;232;498;1437;561;1669
420250;202002;415;1179;345;1059;55;195;191;539;246;734
420253;202002;464;1156;325;963;36;118;194;563;230;681
420257;202002;153;398;96;295;20;75;47;139;67;214
420260;202002;1027;2746;744;2348;122;435;467;1454;589;1889
420270;202002;460;1219;217;652;31;104;86;260;117;364
420280;202002;1046;3148;782;2611;155;585;268;873;423;1458
420285;202002;76;198;43;131;8;36;9;22;17;58
420287;202002;413;961;294;796;76;205;108;301;184;506
420290;202002;4080;11666;3059;9332;440;1572;1769;4950;2209;6522
420300;202002;6628;18801;3692;11894;713;2564;979;2779;1692;5343
420310;202002;775;1811;382;1079;42;130;197;517;239;647
420315;202002;714;2025;486;1620;109;385;191;647;300;1032
420320;202002;4528;12588;3265;10408;961;3399;757;2221;1718;5620
420325;202002;246;706;169;555;31;106;73;225;104;331
420330;202002;872;2594;554;1905;107;417;166;489;273;906
420340;202002;877;2450;643;2037;157;521;89;245;246;766
420350;202002;1125;3008;824;2460;71;244;576;1682;647;1926
420360;202002;2403;6750;1254;4237;239;877;127;416;366;1293
420370;202002;942;2588;745;2261;89;320;482;1398;571;1718
420380;202002;4031;10815;2690;8372;579;1929;985;2962;1564;4891
420390;202002;1020;2462;696;1796;124;394;303;539;427;933
420395;202002;927;2668;615;2044;101;409;78;191;179;600
420400;202002;820;2421;555;1827;103;380;192;604;295;984
420410;202002;502;1382;391;1151;37;121;256;730;293;851
420415;202002;265;808;200;662;52;191;76;254;128;445
420417;202002;576;1732;458;1489;127;412;161;538;288;950
420419;202002;131;467;100;389;37;153;6;23;43;176
420420;202002;9998;26159;6480;19768;1884;6471;1734;4833;3618;11304
420425;202002;613;1618;400;1200;42;145;189;539;231;684
420430;202002;2916;7951;1679;5221;383;1255;537;1527;920;2782
420435;202002;233;595;110;360;14;47;54;175;68;222
420440;202002;706;1953;429;1351;111;392;175;504;286;896
420445;202002;249;624;155;449;32;96;67;178;99;274
420450;202002;618;1805;446;1441;86;340;160;441;246;781
420455;202002;1832;4603;1325;3836;192;691;661;1783;853;2474
420460;202002;8198;22006;6003;18000;931;3124;3039;8710;3970;11834
420470;202002;564;1486;299;964;60;220;67;184;127;404
420475;202002;64;165;26;82;7;23;3;10;10;33
420480;202002;5244;12996;3119;9426;655;2151;1011;3044;1666;5195
420490;202002;320;937;229;757;54;202;89;296;143;498
420500;202002;1344;3783;854;2840;152;557;363;1208;515;1765
420510;202002;156;437;84;269;12;51;25;71;37;122
420515;202002;45;100;29;68;1;1;14;30;15;31
420517;202002;724;2033;631;1871;49;142;475;1421;524;1563
420519;202002;267;640;186;522;26;81;101;292;127;373
420520;202002;285;771;141;479;24;86;11;39;35;125
420530;202002;740;2149;506;1671;89;341;179;511;268;852
420535;202002;217;641;87;305;11;44;37;119;48;163
420540;202002;33025;77959;20531;57017;3160;9981;7037;16687;10197;26668
420543;202002;198;609;151;495;21;73;80;251;101;324
420545;202002;1025;3064;768;2505;145;506;304;903;449;1409
420550;202002;3244;8760;2013;6668;337;1287;844;2838;1181;4125
420555;202002;271;788;185;606;27;101;104;323;131;424
420560;202002;370;935;246;747;55;176;136;405;191;581
420570;202002;1965;5531;1512;4678;275;943;649;1914;924;2857
420580;202002;1722;4457;1193;3631;288;949;403;1218;691;2167
420590;202002;2651;7034;1511;4579;275;998;405;931;680;1929
420600;202002;897;2643;672;2199;103;390;362;1130;465;1520
420610;202002;337;978;183;619;41;148;60;209;101;357
420620;202002;642;1599;409;1213;92;287;167;484;259;771
420630;202002;792;2412;564;1854;74;270;331;1024;405;1294
420640;202002;443;1214;200;703;62;214;14;46;76;260
420650;202002;3290;8694;1910;5800;283;949;706;1845;989;2794
420660;202002;307;805;194;571;42;131;54;147;96;278
420665;202002;544;1430;336;1069;60;217;150;429;210;646
420670;202002;1247;3423;803;2533;134;510;315;878;449;1388
420675;202002;145;411;79;274;17;77;35;104;52;181
420680;202002;306;714;150;497;25;98;72;224;97;322
420690;202002;756;2263;438;1498;62;256;106;301;168;557
420700;202002;2485;6573;1849;5483;237;775;1048;3007;1285;3782
420710;202002;775;2255;575;1816;60;247;343;1000;403;1247
420720;202002;1145;3211;810;2622;176;586;389;1216;565;1802
420730;202002;2828;7397;2076;6158;349;1130;1115;3214;1464;4344
420740;202002;493;1496;292;1047;92;352;28;114;120;466
420750;202002;1716;5004;1085;3537;189;718;437;1304;626;2022
420757;202002;70;175;35;111;4;8;16;51;20;59
420760;202002;320;937;147;459;39;136;34;83;73;219
420765;202002;397;1165;190;645;24;109;88;287;112;396
420768;202002;1221;3517;1052;3232;145;436;770;2358;915;2794
420770;202002;420;1135;197;686;29;113;84;281;113;394
420775;202002;237;722;168;560;40;154;45;122;85;276
420780;202002;818;2230;491;1545;116;399;96;263;212;662
420785;202002;181;483;124;362;15;50;60;143;75;193
420790;202002;943;2932;685;2402;120;491;361;1206;481;1697
420800;202002;610;1518;290;891;81;281;64;190;145;471
420810;202002;1342;4239;1078;3710;315;1241;337;983;652;2224
420820;202002;10717;26725;7540;21557;1463;4760;3496;9110;4959;13870
420830;202002;3207;8510;2316;6912;425;1389;983;2859;1408;4248
420840;202002;459;1349;214;787;64;261;25;75;89;336
420845;202002;2144;5538;1253;3920;233;889;501;1491;734;2380
420850;202002;976;3202;588;2160;112;450;98;322;210;772
420860;202002;273;704;140;468;32;116;34;101;66;217
420870;202002;736;2049;550;1699;141;518;239;668;380;1186
420880;202002;904;2797;697;2369;151;602;264;831;415;1433
420890;202002;7374;20020;4386;13855;680;2388;1477;4080;2157;6468
420895;202002;159;463;97;304;23;75;31;100;54;175
420900;202002;1290;3201;749;2261;107;394;315;814;422;1208
420910;202002;26163;68796;15814;48757;2454;8628;6172;16994;8626;25622
420915;202002;506;1838;361;1417;56;223;189;756;245;979
420917;202002;312;770;159;446;26;78;77;217;103;295
420920;202002;67;177;21;77;0;0;3;9;3;9
420930;202002;15797;41355;10974;32879;2010;6687;4871;13839;6881;20526
420940;202002;2583;6318;1456;4370;370;1266;259;628;629;1894
420945;202002;128;366;102;309;22;75;41;113;63;188
420950;202002;296;865;160;540;24;93;40;129;64;222
420960;202002;922;2290;650;1820;119;404;282;690;401;1094
420970;202002;2124;6050;1455;4762;420;1438;292;971;712;2409
420980;202002;250;834;219;771;109;382;63;239;172;621
420985;202002;289;827;144;505;35;134;46;136;81;270
420990;202002;288;890;152;539;28;100;31;96;59;196
421000;202002;473;1442;323;1105;73;279;86;272;159;551
421003;202002;424;984;142;396;8;29;26;63;34;92
421005;202002;52;154;40;136;8;30;19;61;27;91
421010;202002;2899;8014;2051;6438;434;1556;550;1545;984;3101
421020;202002;348;1086;268;939;41;170;138;460;179;630
421030;202002;707;2172;545;1820;164;618;171;526;335;1144
421040;202002;621;1451;384;1099;27;91;239;671;266;762
421050;202002;886;2393;549;1640;113;381;193;492;306;873
421055;202002;155;418;77;242;12;45;38;102;50;147
421060;202002;512;1503;340;1103;67;243;143;414;210;657
421070;202002;590;1814;318;1130;74;282;80;286;154;568
421080;202002;452;1326;380;1187;42;151;239;739;281;890
421085;202002;356;1033;121;443;18;64;12;29;30;93
421090;202002;220;569;142;422;12;40;53;144;65;184
421100;202002;765;1705;306;932;94;330;73;180;167;510
421105;202002;1435;4007;972;3041;178;568;432;1290;610;1858
421110;202002;984;2651;817;2433;19;58;605;1904;624;1962
421120;202002;805;2484;587;1995;91;344;202;638;293;982
421125;202002;262;701;189;565;69;222;66;160;135;382
421130;202002;4418;13029;3591;11399;883;3198;1750;5205;2633;8403
421140;202002;326;886;179;565;28;92;53;156;81;248
421145;202002;420;1181;271;869;62;219;105;303;167;522
421150;202002;542;1452;315;1000;61;230;140;409;201;639
421160;202002;478;1292;338;1027;48;160;218;648;266;808
421165;202002;184;535;113;369;22;72;49;158;71;230
421170;202002;995;2636;776;2300;131;377;469;1439;600;1816
421175;202002;964;2426;579;1836;115;413;256;772;371;1185
421180;202002;353;914;188;589;35;141;72;205;107;346
421185;202002;304;818;205;612;28;97;120;355;148;452
421187;202002;259;790;158;532;28;96;52;159;80;255
421189;202002;337;982;254;819;43;144;98;297;141;441
421190;202002;9546;25963;6242;19730;1230;4273;2092;6109;3322;10382
421200;202002;608;1790;489;1562;52;189;318;990;370;1179
421205;202002;166;435;122;364;26;91;59;165;85;256
421210;202002;1002;2599;582;1886;126;400;216;719;342;1119
421220;202002;1220;3719;932;3098;216;775;291;885;507;1660
421223;202002;317;886;196;657;46;152;91;311;137;463
421225;202002;836;2500;705;2268;120;433;421;1351;541;1784
421227;202002;816;2181;454;1456;81;292;194;630;275;922
421230;202002;557;1496;348;1105;65;236;123;385;188;621
421240;202002;263;796;117;439;17;74;15;54;32;128
421250;202002;1675;4300;1146;3438;149;522;616;1784;765;2306
421260;202002;154;439;40;165;12;58;8;30;20;88
421265;202002;592;1559;533;1486;6;20;504;1409;510;1429
421270;202002;322;867;134;490;18;64;53;188;71;252
421280;202002;1592;4410;1174;3681;194;736;639;1866;833;2602
421290;202002;816;2225;427;1322;73;240;97;278;170;518
421300;202002;259;674;130;422;13;53;23;74;36;127
421310;202002;173;496;118;390;24;83;62;207;86;290
421315;202002;204;578;127;403;39;115;32;106;71;221
421320;202002;569;1723;274;929;32;98;37;88;69;186
421330;202002;554;1651;402;1331;75;297;118;369;193;666
421335;202002;315;960;258;862;63;240;109;354;172;594
421340;202002;1202;3431;850;2736;165;593;337;1007;502;1600
421350;202002;1271;3318;819;2518;176;642;330;937;506;1579
421360;202002;2139;5851;1225;3986;241;955;464;1286;705;2241
421370;202002;518;1735;311;1174;60;244;83;271;143;515
421380;202002;719;1942;618;1793;81;264;384;1090;465;1354
421390;202002;159;434;54;188;13;39;18;51;31;90
421400;202002;274;885;194;697;34;129;100;342;134;471
421410;202002;207;550;85;294;18;67;27;85;45;152
421415;202002;169;519;95;316;22;66;19;56;41;122
421420;202002;470;1290;379;1123;34;117;242;690;276;807
421430;202002;101;315;79;265;8;28;24;74;32;102
421440;202002;555;1504;329;1090;70;228;141;455;211;683
421450;202002;399;1190;237;823;31;132;39;143;70;275
421460;202002;334;965;174;617;21;83;34;97;55;180
421470;202002;231;674;129;450;27;95;48;174;75;269
421480;202002;2516;6842;1604;5041;350;1301;598;1694;948;2995
421490;202002;108;361;62;227;7;28;17;43;24;71
421500;202002;1951;5769;1347;4531;364;1431;315;927;679;2358
421505;202002;274;786;228;722;36;128;148;451;184;579
421507;202002;401;1145;215;727;56;198;71;227;127;425
421510;202002;252;731;147;475;23;81;75;223;98;304
421520;202002;444;1185;274;801;32;106;162;440;194;546
421530;202002;268;803;151;538;29;123;44;131;73;254
421535;202002;364;972;220;716;33;131;115;356;148;487
421540;202002;253;603;120;383;15;49;40;123;55;172
421545;202002;646;1923;481;1625;112;446;229;718;341;1164
421550;202002;1839;5027;1468;4472;254;820;856;2597;1110;3417
421555;202002;162;495;66;235;12;50;8;19;20;69
421560;202002;74;249;48;189;14;56;11;37;25;93
421565;202002;844;2190;557;1749;148;511;153;486;301;997
421567;202002;411;1384;265;959;100;377;60;201;160;578
421568;202002;312;934;239;772;34;127;112;348;146;475
421569;202002;150;439;73;244;17;61;34;110;51;171
421570;202002;952;2586;664;2039;165;576;201;560;366;1136
421575;202002;255;748;189;580;30;110;80;208;110;318
421580;202002;3109;8663;1995;6365;353;1331;762;2080;1115;3411
421590;202002;127;405;102;346;34;128;25;71;59;199
421600;202002;515;1410;341;1045;76;260;99;259;175;519
421605;202002;679;1777;472;1440;82;224;239;771;321;995
421610;202002;945;2624;598;1959;109;379;188;602;297;981
421620;202002;3625;9623;2060;6737;458;1670;546;1697;1004;3367
421625;202002;129;360;58;187;14;46;14;45;28;91
421630;202002;2095;5523;1227;3828;218;802;400;1038;618;1840
421635;202002;232;640;160;489;19;58;93;267;112;325
421640;202002;678;1830;481;1522;95;346;202;620;297;966
421650;202002;2108;5792;1318;4291;314;1202;370;1002;684;2204
421660;202002;8749;24521;5976;19164;949;3426;2548;7453;3497;10879
421670;202002;704;2049;494;1555;86;302;246;752;332;1054
421680;202002;951;2667;713;2232;194;653;327;928;521;1581
421690;202002;1210;3525;820;2692;162;605;303;985;465;1590
421700;202002;429;1295;258;888;52;190;84;274;136;464
421710;202002;190;595;83;275;18;65;26;83;44;148
421715;202002;88;253;67;204;14;35;45;135;59;170
421720;202002;1747;4787;1006;3219;259;924;274;741;533;1665
421725;202002;211;513;101;319;20;69;41;94;61;163
421730;202002;396;1138;204;608;26;84;103;283;129;367
421740;202002;575;1607;381;1200;107;343;91;245;198;588
421750;202002;799;1890;354;1061;81;271;131;351;212;622
421755;202002;138;385;83;250;15;63;42;107;57;170
421760;202002;809;2160;521;1646;89;324;189;507;278;831
421770;202002;2247;6026;1619;4912;409;1241;594;1941;1003;3182
421775;202002;181;468;114;337;18;53;54;148;72;201
421780;202002;738;2191;469;1602;96;384;195;616;291;1000
421790;202002;709;1836;403;1291;92;304;192;596;284;900
421795;202002;170;472;118;355;22;78;42;117;64;195
421800;202002;2296;6281;1638;5056;212;774;927;2712;1139;3486
421810;202002;551;1543;380;1216;45;169;227;708;272;877
421820;202002;876;2550;493;1623;104;390;148;396;252;786
421825;202002;1244;3558;1101;3335;122;400;770;2282;892;2682
421830;202002;1869;5626;1517;4956;299;1042;695;2220;994;3262
421835;202002;177;439;103;314;20;73;30;82;50;155
421840;202002;200;640;131;471;25;90;32;107;57;197
421850;202002;346;970;188;638;44;166;63;169;107;335
421860;202002;297;840;167;581;23;90;57;179;80;269
421870;202002;3706;9411;2595;7333;473;1587;1234;3080;1707;4667
421875;202002;203;590;95;320;13;52;26;69;39;121
421880;202002;515;1480;336;1088;94;348;75;251;169;599
421885;202002;185;519;112;352;30;104;31;91;61;195
421890;202002;756;2324;552;1916;111;452;267;875;378;1327
421895;202002;372;975;312;895;37;119;214;640;251;759
421900;202002;889;2336;615;1766;95;317;267;693;362;1010
421910;202002;277;817;190;621;33;130;57;167;90;297
421915;202002;357;1014;192;621;37;119;27;76;64;195
421917;202002;521;1254;290;953;113;399;70;241;183;640
421920;202002;359;1112;261;917;108;400;68;230;176;630
421930;202002;2281;5800;1077;3456;273;983;268;770;541;1753
421935;202002;372;1190;290;1005;58;211;161;537;219;748
421940;202002;294;872;127;418;22;85;29;84;51;169
421950;202002;2684;6727;1424;4384;296;1025;346;939;642;1964
421960;202002;173;445;89;289;21;79;22;60;43;139
421970;202002;1732;4479;1009;3026;211;740;363;909;574;1649
421985;202002;272;726;150;478;14;46;59;173;73;219
422000;202002;1764;4687;1408;4098;153;523;942;2706;1095;3229
430003;202002;518;1443;338;1093;65;235;137;432;202;667
430005;202002;251;667;160;506;30;104;72;215;102;319
430010;202002;1647;4039;1313;3514;133;396;938;2425;1071;2821
430020;202002;556;1289;413;1095;48;156;270;682;318;838
430030;202002;937;2233;510;1474;138;446;157;415;295;861
430040;202002;9513;23162;5417;15836;1407;4443;606;1898;2013;6341
430045;202002;475;1209;320;931;20;71;213;603;233;674
430047;202002;231;494;80;226;21;66;22;60;43;126
430050;202002;847;2155;482;1415;106;328;119;328;225;656
430055;202002;221;555;102;309;10;45;60;163;70;208
430057;202002;75;161;25;70;7;26;6;11;13;37
430060;202002;15592;42083;11887;36277;2521;8149;5476;16698;7997;24847
430063;202002;817;2300;643;1930;123;362;357;1070;480;1432
430064;202002;954;2654;702;2127;208;651;266;780;474;1431
430066;202002;91;193;65;154;5;11;52;117;57;128
430070;202002;713;1810;85;289;7;24;16;45;23;69
430080;202002;742;1834;446;1256;79;257;229;570;308;827
430085;202002;814;1877;493;1362;101;296;205;546;306;842
430087;202002;490;1248;394;1121;58;153;254;736;312;889
430090;202002;505;1285;161;505;13;50;57;161;70;211
430100;202002;628;1510;346;967;60;204;155;369;215;573
430105;202002;1032;2787;655;2125;123;459;301;959;424;1418
430107;202002;157;465;89;285;17;66;24;60;41;126
430110;202002;2001;5061;1443;4233;214;673;792;2299;1006;2972
430120;202002;1126;3368;722;2349;128;441;325;1062;453;1503
430130;202002;3233;7596;2336;6359;925;2483;419;1390;1344;3873
430140;202002;834;2323;574;1823;127;402;275;844;402;1246
430150;202002;520;1339;275;848;64;207;93;275;157;482
430155;202002;236;601;103;312;18;51;22;61;40;112
430160;202002;17861;43008;13738;37073;1592;4717;8078;21669;9670;26386
430163;202002;2579;6357;1743;4999;87;286;1231;3508;1318;3794
430165;202002;299;724;80;263;16;38;13;36;29;74
430170;202002;866;2297;307;1073;51;188;47;148;98;336
430175;202002;619;1904;516;1677;132;436;239;763;371;1199
430180;202002;615;1510;489;1303;57;153;341;904;398;1057
430185;202002;493;1205;260;753;65;177;62;160;127;337
430187;202002;639;1488;449;1246;71;215;231;681;302;896
430190;202002;1273;3426;1011;3010;215;702;474;1340;689;2042
430192;202002;122;328;40;119;6;18;10;26;16;44
430195;202002;393;1172;47;171;6;17;7;22;13;39
430200;202002;1040;3139;831;2762;272;944;241;823;513;1767
430205;202002;438;1160;385;1067;13;43;332;897;345;940
430210;202002;4524;11718;2995;8457;586;1778;969;2244;1555;4022
430215;202002;292;759;179;530;38;123;71;207;109;330
430220;202002;614;1516;164;560;28;122;31;73;59;195
430222;202002;161;468;117;370;10;36;46;142;56;178
430223;202002;224;597;175;516;19;62;112;323;131;385
430225;202002;16;31;11;23;1;2;9;19;10;21
430230;202002;1699;4832;1437;4431;130;443;1059;3230;1189;3673
430235;202002;287;826;185;596;42;156;52;146;94;302
430237;202002;471;1161;338;932;22;62;238;641;260;703
430240;202002;1089;2499;597;1658;75;257;324;835;399;1092
430245;202002;656;1923;498;1613;151;499;223;746;374;1245
430250;202002;845;2153;600;1765;217;690;44;114;261;804
430258;202002;112;301;88;256;9;21;46;142;55;163
430260;202002;609;1623;419;1270;58;187;238;701;296;888
430265;202002;189;536;129;423;29;98;39;126;68;224
430270;202002;2666;6718;2106;5838;394;1194;1239;3325;1633;4519
430280;202002;4781;11409;3252;8746;681;1870;1398;3725;2079;5595
430290;202002;2144;4984;1744;4516;48;164;1494;3775;1542;3939
430300;202002;8953;23185;6746;19283;1109;3445;3542;9918;4651;13363
430310;202002;10441;26010;6802;19238;903;2867;3228;8475;4131;11342
430320;202002;951;2493;509;1587;65;189;276;878;341;1067
430330;202002;597;1470;369;1022;63;189;167;405;230;594
430340;202002;673;1471;363;998;48;145;208;557;256;702
430350;202002;6795;17732;4958;14424;814;2476;2662;7459;3476;9935
430355;202002;309;808;103;335;18;61;12;32;30;93
430360;202002;790;1856;510;1384;104;320;207;516;311;836
430367;202002;288;670;153;427;27;87;84;223;111;310
430370;202002;442;1203;195;614;38;124;46;126;84;250
430380;202002;636;1579;310;973;74;280;84;242;158;522
430390;202002;2766;6676;1514;4366;278;907;216;432;494;1339
430400;202002;1021;2193;782;1853;57;168;558;1265;615;1433
430410;202002;506;1217;348;961;48;152;221;580;269;732
430420;202002;2527;7014;1916;5668;508;1555;812;2285;1320;3840
430430;202002;563;1428;263;803;66;193;61;192;127;385
430435;202002;1380;3556;1050;3017;192;593;541;1559;733;2152
430440;202002;3327;9326;2521;7875;289;1037;1526;4693;1815;5730
430450;202002;6237;15930;4937;13640;712;2210;2705;7191;3417;9401
430460;202002;27664;71342;19778;58297;3676;12003;9497;26763;13173;38766
430461;202002;274;700;81;253;12;40;27;70;39;110
430462;202002;221;594;122;394;18;54;43;146;61;200
430463;202002;4955;13395;3602;10966;733;2454;1623;4765;2356;7219
430465;202002;395;1033;328;914;49;155;207;555;256;710
430466;202002;3839;9745;2964;8331;749;2177;1378;3676;2127;5853
430467;202002;468;1138;319;898;43;139;167;449;210;588
430468;202002;1187;2954;913;2543;85;256;584;1593;669;1849
430469;202002;542;1464;61;200;7;24;13;19;20;43
430470;202002;5089;13169;3342;10068;983;3244;910;2564;1893;5808
430471;202002;493;1422;400;1245;62;218;228;675;290;893
430480;202002;696;1849;366;1145;50;172;83;234;133;406
430485;202002;161;433;60;191;15;44;8;26;23;70
430490;202002;366;959;205;613;25;90;101;274;126;364
430495;202002;345;945;203;661;24;81;78;242;102;323
430500;202002;936;2442;635;1935;206;676;181;495;387;1171
430510;202002;23050;60700;16164;47126;2771;9178;7232;19279;10003;28457
430511;202002;298;879;117;394;14;55;15;42;29;97
430512;202002;893;2026;684;1722;167;428;250;646;417;1074
430513;202002;751;1876;340;998;50;162;174;479;224;641
430515;202002;353;995;249;783;34;98;129;407;163;505
430517;202002;1034;3220;768;2595;134;449;390;1346;524;1795
430520;202002;1194;3090;591;1774;108;350;128;343;236;693
430530;202002;924;2351;362;1136;70;213;94;286;164;499
430535;202002;2960;7785;2115;6234;304;933;1076;3082;1380;4015
430537;202002;313;1113;291;1045;20;64;234;839;254;903
430540;202002;549;1364;325;981;47;143;151;456;198;599
430543;202002;715;1283;390;915;54;107;185;481;239;588
430544;202002;636;1847;440;1405;101;313;183;584;284;897
430545;202002;2093;5529;1537;4663;307;953;757;2359;1064;3312
430550;202002;322;908;229;711;45;140;84;246;129;386
430558;202002;104;236;43;118;5;10;16;43;21;53
430560;202002;326;740;134;410;16;52;44;136;60;188
430570;202002;760;1855;515;1392;87;262;271;694;358;956
430580;202002;804;2015;574;1657;142;440;257;729;399;1169
430583;202002;195;482;34;110;3;11;7;19;10;30
430585;202002;212;516;103;280;11;30;51;130;62;160
430587;202002;187;529;136;422;17;52;58;185;75;237
430590;202002;1351;3233;1111;2875;50;149;934;2370;984;2519
430593;202002;15;52;10;34;1;3;5;16;6;19
430595;202002;397;971;97;318;10;47;23;55;33;102
430597;202002;393;1029;205;623;19;60;70;162;89;222
430600;202002;1779;4568;768;2235;136;427;215;576;351;1003
430605;202002;1080;2956;788;2397;106;387;360;1052;466;1439
430607;202002;498;1193;401;1036;24;68;292;740;316;808
430610;202002;5294;12567;3460;9758;1014;3157;752;2121;1766;5278
430613;202002;254;595;68;197;8;24;19;44;27;68
430620;202002;551;1359;397;1071;54;161;230;569;284;730
430630;202002;398;1104;108;355;18;60;22;66;40;126
430632;202002;465;1228;194;602;23;77;92;270;115;347
430635;202002;508;1218;371;989;42;114;267;719;309;833
430637;202002;434;1075;333;930;36;118;212;559;248;677
430640;202002;938;2437;541;1630;76;241;191;533;267;774
430642;202002;336;920;254;737;42;111;137;375;179;486
430645;202002;148;349;52;143;9;27;15;42;24;69
430650;202002;1501;4414;1200;3907;322;1055;576;1947;898;3002
430655;202002;254;639;149;421;24;77;71;174;95;251
430660;202002;4806;12544;3596;10509;809;2509;1549;4442;2358;6951
430670;202002;629;1539;476;1270;31;87;290;775;321;862
430673;202002;517;1178;200;591;37;113;74;198;111;311
430675;202002;231;661;52;184;9;35;24;82;33;117
430676;202002;4345;10995;3406;9566;416;1309;2163;5905;2579;7214
430680;202002;851;2309;513;1613;142;454;128;396;270;850
430690;202002;2687;7372;2106;6307;727;2284;578;1649;1305;3933
430692;202002;204;630;154;542;8;35;113;400;121;435
430693;202002;918;2433;540;1670;107;393;143;396;250;789
430695;202002;425;1102;235;695;32;89;126;361;158;450
430697;202002;377;955;283;805;72;187;142;437;214;624
430700;202002;6198;15498;3461;10400;744;2434;591;1675;1335;4109
430705;202002;378;923;187;567;22;77;76;205;98;282
430710;202002;1589;3472;1107;2806;143;406;667;1660;810;2066
430720;202002;661;1602;334;1023;48;144;174;535;222;679
430730;202002;979;2685;659;2075;94;283;350;1093;444;1376
430740;202002;556;1527;285;949;49;173;79;281;128;454
430745;202002;342;949;212;659;36;129;73;190;109;319
430750;202002;1255;3240;875;2590;184;562;466;1347;650;1909
430755;202002;433;1045;267;716;15;47;162;402;177;449
430760;202002;1895;4708;1433;3982;341;1024;642;1712;983;2736
430770;202002;5819;14643;4437;12571;587;1907;2797;7647;3384;9554
430780;202002;1782;4353;1004;3005;199;665;388;1117;587;1782
430781;202002;437;1222;235;743;31;96;70;189;101;285
430783;202002;344;788;206;577;18;68;133;348;151;416
430786;202002;28;100;21;81;4;16;3;15;7;31
430790;202002;4083;10027;2786;7788;329;1098;1702;4427;2031;5525
430800;202002;714;1689;523;1392;33;89;352;936;385;1025
430805;202002;354;956;221;664;17;61;140;394;157;455
430807;202002;396;938;195;547;13;41;91;235;104;276
430810;202002;651;1543;242;736;26;100;103;297;129;397
430820;202002;1123;2982;629;2025;134;449;164;523;298;972
430825;202002;225;563;78;202;13;33;24;56;37;89
430830;202002;1604;4651;1282;4027;57;205;926;2881;983;3086
430840;202002;933;2393;664;1931;90;287;453;1274;543;1561
430843;202002;116;277;46;132;5;21;20;50;25;71
430845;202002;397;951;259;721;57;170;100;258;157;428
430850;202002;2209;5770;1487;4360;232;755;605;1783;837;2538
430860;202002;846;1952;370;1062;46;163;180;437;226;600
430865;202002;486;1220;357;1006;54;164;201;542;255;706
430870;202002;589;1537;247;785;40;149;80;224;120;373
430880;202002;1318;3082;877;2409;146;430;460;1223;606;1653
430885;202002;170;454;81;275;6;20;48;164;54;184
430890;202002;954;2391;621;1810;57;243;129;348;186;591
430900;202002;2878;6346;1947;4985;162;495;1277;3082;1439;3577
430905;202002;714;1827;438;1306;80;267;162;446;242;713
430910;202002;1400;3697;954;2802;158;550;465;1214;623;1764
430912;202002;470;1307;310;996;26;77;210;692;236;769
430915;202002;453;1410;343;1193;124;435;96;344;220;779
430920;202002;22130;56287;16702;47210;2317;7236;10002;27477;12319;34713
430925;202002;93;211;34;103;5;13;15;49;20;62
430930;202002;9847;23370;6140;17653;1183;3481;2536;7607;3719;11088
430940;202002;898;2357;518;1543;143;452;127;314;270;766
430950;202002;720;1708;448;1235;37;133;273;678;310;811
430955;202002;318;848;78;242;18;55;19;47;37;102
430957;202002;174;599;160;561;26;92;97;336;123;428
430960;202002;1281;3071;712;2027;156;476;307;846;463;1322
430965;202002;1543;3708;1185;3150;60;172;938;2527;998;2699
430970;202002;342;837;169;489;24;73;84;221;108;294
430975;202002;470;1436;353;1160;77;261;167;537;244;798
430980;202002;357;822;201;555;28;91;94;235;122;326
430990;202002;517;1485;317;1008;38;125;158;495;196;620
430995;202002;530;1376;382;1135;45;142;211;615;256;757
431000;202002;1259;2961;491;1439;87;283;36;92;123;375
431010;202002;1888;4854;1118;3562;220;768;195;520;415;1288
431020;202002;7709;16776;4491;11916;1032;3093;1508;3468;2540;6561
431030;202002;318;869;153;520;29;103;22;67;51;170
431033;202002;3339;7983;2061;5959;477;1438;710;2072;1187;3510
431036;202002;327;703;68;192;5;15;20;48;25;63
431040;202002;847;2187;543;1634;83;285;231;639;314;924
431041;202002;432;997;315;827;23;57;194;506;217;563
431043;202002;322;805;170;536;35;125;82;253;117;378
431046;202002;99;259;40;123;2;5;11;33;13;38
431050;202002;1262;3102;895;2513;162;489;468;1325;630;1814
431053;202002;583;1598;307;989;68;244;94;266;162;510
431055;202002;555;1377;462;1239;51;125;332;885;383;1010
431057;202002;233;668;112;377;23;76;32;99;55;175
431060;202002;4989;13125;3308;10159;812;2703;853;2581;1665;5284
431065;202002;366;941;256;757;47;149;114;331;161;480
431070;202002;406;1156;224;737;53;190;49;155;102;345
431075;202002;207;614;124;417;24;87;38;128;62;215
431080;202002;519;1423;342;1050;65;233;112;326;177;559
431085;202002;689;1824;438;1238;63;178;214;594;277;772
431087;202002;402;1141;325;978;23;62;225;704;248;766
431090;202002;390;921;148;460;26;83;41;129;67;212
431100;202002;3194;7085;2177;5716;325;883;1095;2922;1420;3805
431110;202002;1298;3000;866;2263;260;699;323;791;583;1490
431112;202002;505;1456;419;1282;76;259;232;682;308;941
431113;202002;326;920;278;825;45;147;169;489;214;636
431115;202002;938;2687;723;2288;101;384;417;1238;518;1622
431120;202002;2201;6247;1493;4783;476;1726;345;972;821;2698
431123;202002;383;1068;241;763;42;119;132;438;174;557
431125;202002;923;2749;697;2286;256;819;237;834;493;1653
431127;202002;189;493;51;170;7;22;10;27;17;49
431130;202002;2793;7238;2026;5926;306;1018;1124;3185;1430;4203
431140;202002;4792;11355;2680;7390;336;1009;1190;2881;1526;3890
431142;202002;460;1242;337;1017;47;149;210;631;257;780
431150;202002;983;2647;681;2071;133;436;285;841;418;1277
431160;202002;634;1824;423;1353;68;243;133;424;201;667
431162;202002;473;1146;251;735;26;89;140;385;166;474
431164;202002;164;378;35;110;8;24;4;7;12;31
431170;202002;437;1238;303;947;95;290;80;239;175;529
431171;202002;600;1433;479;1270;98;235;286;780;384;1015
431173;202002;379;1023;280;869;81;281;111;322;192;603
431175;202002;1111;2642;653;1841;106;301;236;641;342;942
431177;202002;690;1961;504;1655;135;488;271;861;406;1349
431179;202002;324;703;85;253;14;44;18;49;32;93
431180;202002;2033;5155;1224;3573;320;918;332;970;652;1888
431190;202002;414;1103;195;622;25;82;58;148;83;230
431198;202002;329;977;269;871;99;337;75;264;174;601
431200;202002;350;884;67;194;14;41;6;15;20;56
431205;202002;185;514;90;298;24;82;35;117;59;199
431210;202002;568;1454;454;1292;111;316;222;670;333;986
431213;202002;227;614;166;503;14;43;83;262;97;305
431215;202002;545;1296;230;682;26;84;110;306;136;390
431217;202002;146;378;96;289;5;22;60;169;65;191
431220;202002;521;1359;299;918;32;121;170;478;202;599
431225;202002;1448;3464;1095;2875;105;292;773;2046;878;2338
431230;202002;616;1793;468;1453;58;205;282;841;340;1046
431235;202002;144;366;21;73;2;5;4;17;6;22
431237;202002;303;977;249;846;49;178;129;420;178;598
431238;202002;23;62;18;52;5;16;6;13;11;29
431240;202002;3923;9872;2976;8395;471;1466;1658;4501;2129;5967
431242;202002;233;644;197;584;41;129;105;303;146;432
431244;202002;301;724;153;428;22;78;56;133;78;211
431245;202002;1213;2846;757;2051;80;239;399;1018;479;1257
431247;202002;209;555;109;335;22;76;35;83;57;159
431250;202002;1549;3945;1123;3362;248;762;574;1791;822;2553
431260;202002;214;616;137;460;17;74;47;145;64;219
431261;202002;221;687;175;611;15;60;98;326;113;386
431262;202002;356;999;175;571;12;38;115;379;127;417
431265;202002;1494;3543;568;1699;74;275;201;509;275;784
431267;202002;255;684;153;449;4;19;109;288;113;307
431270;202002;2662;6095;1384;3924;337;990;435;1252;772;2242
431275;202002;114;327;56;179;22;69;10;31;32;100
431280;202002;217;580;60;193;6;21;8;15;14;36
431290;202002;276;823;179;576;31;113;32;75;63;188
431295;202002;70;185;23;77;2;7;7;23;9;30
431300;202002;275;704;48;152;3;10;12;29;15;39
431301;202002;299;854;62;204;8;19;5;15;13;34
431303;202002;532;1409;308;914;20;65;146;410;166;475
431306;202002;2028;4758;1140;3295;170;541;473;1208;643;1749
431308;202002;24;73;21;67;9;31;10;31;19;62
431310;202002;497;1423;344;1076;40;134;160;466;200;600
431320;202002;558;1515;264;887;40;125;47;138;87;263
431330;202002;1518;3581;680;2009;150;519;239;618;389;1137
431333;202002;210;561;99;297;18;50;39;110;57;160
431335;202002;38;103;21;65;4;8;3;7;7;15
431337;202002;2451;6524;1758;5371;343;1183;874;2571;1217;3754
431339;202002;360;957;263;771;77;237;114;323;191;560
431340;202002;17915;43469;12114;33667;2152;6592;5330;13948;7482;20540
431342;202002;407;882;302;735;12;29;272;661;284;690
431344;202002;383;979;221;661;8;30;131;371;139;401
431346;202002;243;592;90;290;15;53;27;88;42;141
431349;202002;607;1592;318;946;81;234;120;359;201;593
431350;202002;3761;9803;2742;8049;417;1386;1431;4055;1848;5441
431360;202002;539;1296;267;766;78;232;78;223;156;455
431365;202002;1834;4423;1450;3901;114;346;1081;2873;1195;3219
431370;202002;4041;10107;2847;8077;662;1967;1321;3849;1983;5816
431380;202002;756;2054;611;1820;36;123;432;1275;468;1398
431390;202002;2415;5867;1402;4058;163;570;658;1662;821;2232
431395;202002;1190;3008;821;2439;189;583;354;1084;543;1667
431400;202002;301;848;160;513;27;83;36;108;63;191
431402;202002;823;1869;592;1519;78;215;389;975;467;1190
431403;202002;183;523;144;450;23;86;69;185;92;271
431405;202002;4184;11082;3174;9409;602;1984;1507;4235;2109;6219
431406;202002;501;1433;354;1120;76;233;183;593;259;826
431407;202002;413;1166;282;888;59;209;143;425;202;634
431410;202002;15384;39135;9842;29192;1513;5162;4850;13423;6363;18585
431413;202002;213;559;57;191;4;11;11;41;15;52
431415;202002;634;1542;384;1127;71;248;180;473;251;721
431417;202002;515;1152;352;906;53;155;197;501;250;656
431420;202002;1490;3414;1103;2864;169;448;598;1555;767;2003
431430;202002;517;1325;240;765;32;112;75;204;107;316
431440;202002;28423;66942;19587;52956;3442;10013;7591;19378;11033;29391
431442;202002;97;262;44;144;8;22;9;26;17;48
431445;202002;365;1036;114;381;17;53;9;27;26;80
431446;202002;256;764;188;625;36;136;95;298;131;434
431447;202002;637;1731;376;1170;73;247;135;426;208;673
431449;202002;714;1873;418;1243;76;215;169;508;245;723
431450;202002;2083;4375;1642;3761;90;227;1273;2837;1363;3064
431454;202002;30;96;26;87;6;19;10;35;16;54
431455;202002;581;1395;277;755;36;104;139;343;175;447
431460;202002;2648;6577;1889;5231;497;1451;529;1492;1026;2943
431470;202002;1357;3837;969;3016;181;565;434;1373;615;1938
431475;202002;241;654;37;150;3;11;3;10;6;21
431477;202002;373;971;220;658;39;115;89;231;128;346
431478;202002;251;656;47;149;13;38;6;16;19;54
431480;202002;2851;7201;2192;6173;535;1542;1084;3073;1619;4615
431490;202002;103989;246214;78794;207552;5861;18223;57478;145712;63339;163935
431500;202002;462;1173;334;931;60;169;183;492;243;661
431505;202002;261;631;178;505;11;35;125;353;136;388
431507;202002;334;788;129;383;41;132;37;100;78;232
431510;202002;1453;3784;967;2850;214;675;362;1049;576;1724
431513;202002;184;406;110;292;9;22;75;197;84;219
431514;202002;91;232;59;174;4;11;41;117;45;128
431515;202002;441;1110;311;879;60;166;162;461;222;627
431517;202002;60;180;50;156;9;27;22;65;31;92
431520;202002;401;980;150;478;24;87;63;170;87;257
431530;202002;3901;8325;2176;5775;495;1349;529;1407;1024;2756
431531;202002;200;507;121;351;12;40;55;144;67;184
431532;202002;531;1233;314;844;66;200;129;334;195;534
431535;202002;225;608;99;320;20;71;22;61;42;132
431540;202002;1750;5652;1628;5486;58;253;1327;4466;1385;4719
431545;202002;316;819;54;170;8;23;11;33;19;56
431550;202002;1899;4890;1428;3999;243;747;730;1963;973;2710
431555;202002;634;1430;392;1033;26;85;240;616;266;701
431560;202002;20730;50803;13737;39821;2798;8559;4657;14191;7455;22750
431570;202002;4255;10477;3366;9191;391;1209;2354;6170;2745;7379
431575;202002;213;539;157;439;37;91;45;130;82;221
431580;202002;555;1436;329;980;40;146;177;491;217;637
431590;202002;561;1558;433;1296;94;295;171;527;265;822
431595;202002;333;926;208;649;46;143;83;242;129;385
431600;202002;1251;2886;852;2310;220;645;327;918;547;1563
431610;202002;1310;3410;886;2608;125;356;465;1393;590;1749
431620;202002;448;1158;194;581;30;94;75;208;105;302
431630;202002;1245;3134;563;1715;89;302;204;559;293;861
431640;202002;5905;14504;5007;13362;509;1417;3674;9895;4183;11312
431642;202002;524;1294;319;877;21;53;167;423;188;476
431643;202002;341;848;160;471;16;43;53;151;69;194
431645;202002;1759;3986;1364;3444;62;196;1085;2704;1147;2900
431647;202002;232;580;81;242;8;24;19;54;27;78
431650;202002;113;313;76;248;7;26;43;129;50;155
431660;202002;841;2253;419;1372;72;274;112;325;184;599
431670;202002;1066;2562;674;1855;95;269;361;949;456;1218
431673;202002;229;579;79;276;12;42;18;56;30;98
431675;202002;491;1193;92;293;11;47;18;48;29;95
431680;202002;7112;18328;5076;14520;1215;3627;2179;6068;3394;9695
431690;202002;21454;52874;13764;39058;2928;8888;5244;14902;8172;23790
431695;202002;142;337;84;250;17;67;42;97;59;164
431697;202002;428;1019;325;858;46;112;191;520;237;632
431700;202002;1285;3361;1081;2994;147;385;665;1821;812;2206
431710;202002;11897;29111;8150;23696;1494;4633;3916;11631;5410;16264
431720;202002;5674;14348;3246;9545;819;2556;574;1452;1393;4008
431725;202002;25;72;20;63;4;11;9;29;13;40
431730;202002;3682;8907;2236;6598;539;1699;691;2182;1230;3881
431740;202002;4808;11478;3061;8494;857;2741;757;1745;1614;4486
431750;202002;7008;18077;5317;15360;1183;3677;2305;6527;3488;10204
431755;202002;295;802;59;209;7;23;9;31;16;54
431760;202002;4962;11205;3266;8520;334;1008;1979;4898;2313;5906
431770;202002;1778;4258;1379;3726;84;282;1058;2773;1142;3055
431775;202002;193;509;101;315;21;63;15;42;36;105
431780;202002;1933;4912;1212;3541;203;669;510;1437;713;2106
431790;202002;752;2053;539;1637;99;297;249;735;348;1032
431795;202002;223;574;102;320;22;63;29;88;51;151
431800;202002;7598;18413;4607;13633;1235;4187;529;1621;1764;5808
431805;202002;278;650;81;271;5;18;31;100;36;118
431810;202002;3142;7525;1963;5372;371;1061;837;2200;1208;3261
431820;202002;2065;5613;1622;4900;459;1452;559;1791;1018;3243
431830;202002;8375;18287;6063;15199;1569;4548;1970;4916;3539;9464
431840;202002;2448;6523;1945;5685;322;948;1181;3487;1503;4435
431842;202002;583;1460;191;603;22;78;60;168;82;246
431843;202002;307;822;230;662;26;86;119;318;145;404
431844;202002;187;490;51;174;11;40;15;58;26;98
431845;202002;492;1310;340;1002;26;77;199;585;225;662
431846;202002;272;715;229;651;9;29;205;580;214;609
431848;202002;93;239;57;170;7;23;9;20;16;43
431849;202002;397;968;62;190;1;1;6;17;7;18
431850;202002;3813;10420;2896;8563;695;2218;925;2726;1620;4944
431860;202002;602;1463;339;957;56;166;186;507;242;673
431861;202002;92;254;49;159;11;39;16;43;27;82
431862;202002;419;1335;343;1201;67;261;175;592;242;853
431870;202002;17701;45687;14145;40064;1760;5610;8576;23450;10336;29060
431880;202002;3832;9870;2669;7773;434;1451;1212;3358;1646;4809
431890;202002;4166;10552;2506;7367;731;2344;443;1443;1174;3787
431900;202002;908;2312;574;1694;85;288;303;837;388;1125
431910;202002;713;1727;238;690;45;129;65;147;110;276
431912;202002;432;1219;338;1054;63;210;199;609;262;819
431915;202002;999;2512;783;2166;25;83;600;1618;625;1701
431920;202002;1130;2742;938;2485;22;61;820;2165;842;2226
431930;202002;617;1671;416;1301;124;352;193;637;317;989
431935;202002;80;228;55;175;15;52;11;35;26;87
431936;202002;290;850;158;514;34;118;56;167;90;285
431937;202002;156;391;99;268;16;51;43;90;59;141
431940;202002;2874;6882;1626;4586;186;583;800;2143;986;2726
431950;202002;1692;4533;1357;3998;451;1337;507;1494;958;2831
431960;202002;2740;6807;1966;5394;547;1566;521;1415;1068;2981
431970;202002;381;981;143;431;37;109;37;99;74;208
431971;202002;77;194;32;101;3;12;5;10;8;22
431973;202002;465;1489;383;1336;37;137;284;983;321;1120
431975;202002;104;216;18;64;3;14;2;6;5;20
431980;202002;964;2553;744;2180;154;477;347;979;501;1456
431990;202002;5312;12793;3491;10160;476;1621;1669;4629;2145;6250
432000;202002;10068;24209;7203;19738;1725;4817;3175;8802;4900;13619
432010;202002;1934;4880;1398;3922;211;677;832;2195;1043;2872
432020;202002;1690;4345;1050;3041;210;639;465;1273;675;1912
432023;202002;488;1179;248;706;38;122;117;296;155;418
432026;202002;927;2617;679;2130;169;533;242;757;411;1290
432030;202002;321;804;180;530;24;67;97;286;121;353
432032;202002;315;825;214;627;25;87;118;320;143;407
432035;202002;615;1767;532;1622;169;516;217;697;386;1213
432040;202002;979;2243;341;1060;57;192;115;327;172;519
432045;202002;160;443;97;317;23;76;34;115;57;191
432050;202002;443;1142;326;935;74;215;137;416;211;631
432055;202002;563;1526;364;1142;127;411;77;220;204;631
432057;202002;222;591;164;451;25;61;70;177;95;238
432060;202002;433;1032;135;424;32;110;43;117;75;227
432065;202002;190;531;131;402;25;76;58;173;83;249
432067;202002;684;2011;577;1778;50;180;432;1276;482;1456
432070;202002;1602;4242;1019;3080;234;779;310;849;544;1628
432080;202002;4051;9880;3066;8271;555;1737;1428;3659;1983;5396
432085;202002;330;857;223;690;64;198;87;283;151;481
432090;202002;1226;3101;813;2325;162;500;419;1147;581;1647
432100;202002;877;2268;402;1287;78;268;73;185;151;453
432110;202002;1934;5215;1290;4031;319;1140;121;342;440;1482
432120;202002;2601;7144;1988;6072;392;1320;761;2231;1153;3551
432130;202002;2372;6202;1951;5585;586;1709;857;2504;1443;4213
432132;202002;161;462;97;319;18;61;45;127;63;188
432135;202002;947;2272;616;1699;34;111;445;1213;479;1324
432140;202002;1418;4268;1078;3594;157;564;671;2235;828;2799
432143;202002;1332;3502;1029;3032;69;222;689;2013;758;2235
432145;202002;1279;3403;736;2240;102;339;227;581;329;920
432146;202002;90;250;57;193;21;74;17;55;38;129
432147;202002;459;1315;266;895;87;317;69;197;156;514
432149;202002;403;1008;194;582;15;50;89;246;104;296
432150;202002;2804;7213;2005;5795;440;1435;757;2124;1197;3559
432160;202002;4859;12913;3531;10761;904;3014;1245;3621;2149;6635
432162;202002;253;557;34;99;6;16;5;14;11;30
432163;202002;117;289;24;65;0;0;3;5;3;5
432166;202002;563;1603;419;1295;79;267;139;394;218;661
432170;202002;1210;3230;749;2362;148;520;280;811;428;1331
432180;202002;2502;6068;1305;3784;254;781;452;1173;706;1954
432183;202002;338;997;226;733;60;224;63;191;123;415
432185;202002;766;1978;439;1337;35;126;238;679;273;805
432190;202002;1654;4051;1045;3065;203;665;511;1414;714;2079
432195;202002;869;2184;562;1630;156;420;201;617;357;1037
432200;202002;2986;7787;2136;6394;376;1139;1171;3569;1547;4708
432210;202002;356;951;213;669;40;155;98;259;138;414
432215;202002;596;1757;537;1666;48;132;397;1250;445;1382
432218;202002;244;614;108;312;17;58;48;123;65;181
432220;202002;3380;8029;2499;6651;434;1229;1398;3640;1832;4869
432225;202002;76;221;55;177;11;41;29;94;40;135
432230;202002;655;1540;347;967;45;125;147;375;192;500
432232;202002;460;1130;286;827;59;189;104;274;163;463
432234;202002;259;653;116;342;21;52;14;38;35;90
432235;202002;48;142;18;61;4;12;6;24;10;36
432237;202002;319;823;279;758;10;21;229;610;239;631
432240;202002;14562;36763;10430;31172;748;2531;6665;20773;7413;23304
432250;202002;4495;13304;3518;11426;951;3177;1427;4653;2378;7830
432252;202002;413;988;256;723;32;95;129;351;161;446
432253;202002;871;2715;536;1851;133;494;45;148;178;642
432254;202002;608;1439;135;421;24;78;14;36;38;114
432255;202002;102;258;54;165;4;12;29;79;33;91
432260;202002;4376;11445;3168;9130;941;2817;944;2651;1885;5468
432270;202002;1647;4668;1301;3981;398;1335;250;711;648;2046
432280;202002;1142;2857;546;1672;87;287;199;518;286;805
432285;202002;139;412;19;55;1;3;3;5;4;8
432290;202002;318;899;166;529;58;185;31;69;89;254
432300;202002;24273;61676;17995;51544;2678;8633;10408;28771;13086;37404
432310;202002;769;2118;547;1693;50;157;371;1152;421;1309
432320;202002;200;468;67;209;7;22;24;69;31;91
432330;202002;202;464;60;195;8;19;12;39;20;58
432335;202002;177;492;61;219;7;30;12;37;19;67
432340;202002;287;674;120;376;11;33;43;127;54;160
432345;202002;636;1485;556;1391;19;49;453;1113;472;1162
432350;202002;335;889;181;585;28;103;70;217;98;320
432360;202002;232;683;46;151;4;11;16;54;20;65
432370;202002;287;716;187;544;15;49;125;358;140;407
432375;202002;453;1136;334;903;61;155;167;464;228;619
432377;202002;173;535;33;110;8;30;3;7;11;37
432380;202002;1549;4125;978;3067;170;603;488;1453;658;2056
500020;202002;2360;6156;1675;5001;173;589;1018;2937;1191;3526
500025;202002;1172;2885;731;2056;61;187;402;1085;463;1272
500060;202002;7406;21118;5018;16138;617;2066;2921;9646;3538;11712
500070;202002;4017;10485;2754;8331;507;1562;1187;3684;1694;5246
500080;202002;1471;3673;897;2613;171;562;353;912;524;1474
500085;202002;1917;4856;1295;3813;293;918;626;1755;919;2673
500090;202002;1893;5165;1280;4090;235;783;469;1561;704;2344
500100;202002;3446;8824;2585;7429;450;1446;1259;3428;1709;4874
500110;202002;7411;19152;4642;14789;1021;3542;1409;5223;2430;8765
500124;202002;1909;5734;1525;5084;242;757;833;2912;1075;3669
500150;202002;1240;2829;763;2139;149;429;286;797;435;1226
500190;202002;4561;11837;2909;8671;647;1958;752;2168;1399;4126
500200;202002;2141;5153;1558;4183;172;490;955;2430;1127;2920
500210;202002;4428;10912;3134;9215;825;2419;1388;4173;2213;6592
500215;202002;1290;3670;904;2940;91;338;475;1536;566;1874
500220;202002;2339;6615;1458;4933;258;929;357;1161;615;2090
500230;202002;1978;4680;1491;3993;175;448;998;2658;1173;3106
500240;202002;3390;10234;2337;8039;377;1440;913;3256;1290;4696
500260;202002;2961;6337;1802;4755;260;669;928;2382;1188;3051
500270;202002;128750;303821;75033;212350;12871;39849;27014;72224;39885;112073
500280;202002;1211;3093;819;2478;106;346;477;1417;583;1763
500290;202002;3344;7952;1838;5460;329;1128;573;1528;902;2656
500295;202002;3129;7643;1885;5426;303;968;720;1788;1023;2756
500310;202002;909;1912;607;1533;98;203;307;821;405;1024
500315;202002;3470;9866;2699;8712;235;765;1889;6252;2124;7017
500320;202002;17761;48933;12165;39667;3149;10704;4238;14653;7387;25357
500325;202002;4056;9105;2767;7406;228;643;1852;5023;2080;5666
500330;202002;6415;14706;4123;11430;316;958;2334;6563;2650;7521
500345;202002;1886;4676;1234;3654;304;931;412;1194;716;2125
500348;202002;2264;5899;1737;5026;239;709;987;2927;1226;3636
500350;202002;1230;3353;661;2117;73;240;284;879;357;1119
500370;202002;23457;61036;16101;48978;2211;7662;8315;25281;10526;32943
500375;202002;2370;6304;1561;4647;300;958;504;1405;804;2363
500380;202002;3282;8260;2224;6469;624;1946;545;1613;1169;3559
500390;202002;478;1038;297;816;50;159;177;482;227;641
500400;202002;1294;3332;839;2457;159;524;277;748;436;1272
500410;202002;2283;5717;1594;4663;161;461;947;2874;1108;3335
500430;202002;2444;6093;1635;4897;223;788;700;2181;923;2969
500440;202002;1027;2562;650;1963;90;302;254;826;344;1128
500450;202002;1352;3379;736;2242;138;446;170;488;308;934
500460;202002;3514;9534;2124;6767;355;1278;664;2098;1019;3376
500470;202002;2356;6383;1421;4450;416;1460;288;779;704;2239
500480;202002;2001;6198;1700;5718;145;536;1265;4307;1410;4843
500490;202002;919;2160;521;1567;118;432;147;433;265;865
500500;202002;4055;10948;2574;8522;926;3584;456;1547;1382;5131
500510;202002;661;1689;421;1232;26;95;255;723;281;818
500515;202002;1672;4273;1272;3641;137;432;798;2181;935;2613
500520;202002;2865;9212;2259;8057;616;2209;926;3502;1542;5711
500525;202002;813;2460;663;2229;59;204;410;1413;469;1617
500540;202002;4293;11186;2545;8089;667;2620;242;686;909;3306
500560;202002;5213;14436;4176;13122;258;858;3348;10685;3606;11543
500568;202002;4113;9044;2435;6569;558;1641;864;2333;1422;3974
500570;202002;7142;16764;4229;11781;791;2416;1468;3854;2259;6270
500580;202002;2917;7837;2125;6435;461;1461;1000;3047;1461;4508
500600;202002;2957;7467;2070;6087;441;1309;883;2690;1324;3999
500620;202002;6970;18734;4653;14313;1039;3360;1624;4930;2663;8290
500625;202002;474;1304;274;863;50;163;90;248;140;411
500627;202002;686;1794;415;1303;64;212;143;449;207;661
500630;202002;6172;14372;3481;9925;712;2239;1035;2967;1747;5206
500635;202002;2732;8801;2126;8012;164;692;1519;6152;1683;6844
500640;202002;1636;3613;1067;2858;38;123;734;1937;772;2060
500660;202002;16394;42939;11143;35212;3552;12724;2727;8934;6279;21658
500690;202002;2151;6031;1410;4796;523;2038;80;191;603;2229
500710;202002;2722;7397;2093;6318;601;1908;653;1873;1254;3781
500720;202002;4597;11739;2952;9000;691;2239;877;2740;1568;4979
500730;202002;916;2317;531;1632;70;194;173;551;243;745
500740;202002;4371;10546;2973;8310;382;1116;1595;4465;1977;5581
500750;202002;910;2362;590;1764;87;260;224;603;311;863
500755;202002;791;2075;423;1375;80;281;82;241;162;522
500769;202002;4628;11463;2470;7402;474;1606;356;831;830;2437
500770;202002;1406;3827;901;2921;167;617;302;968;469;1585
500780;202002;1144;2789;739;2108;151;480;201;554;352;1034
500790;202002;6919;18445;5376;15901;1081;3436;2710;8062;3791;11498
500793;202002;1909;4951;1314;3915;348;1101;405;1115;753;2216
500795;202002;2412;6249;1989;5705;82;226;1711;5021;1793;5247
500797;202002;643;1657;427;1255;120;362;143;427;263;789
500800;202002;2810;6478;1736;4913;547;1820;201;634;748;2454
500830;202002;16689;42484;11212;32427;2339;7274;4092;11165;6431;18439
500840;202002;1302;3190;768;2193;86;260;313;845;399;1105
510010;202002;1740;3951;1144;3179;96;260;818;2307;914;2567
510020;202002;3249;8278;1720;5276;355;1165;382;1057;737;2222
510025;202002;6377;15685;3857;11567;580;1962;1577;4580;2157;6542
510030;202002;2274;5160;1472;3973;319;875;538;1451;857;2326
510035;202002;1177;3080;734;2380;80;286;449;1537;529;1823
510040;202002;2166;4871;1567;4100;145;373;1009;2741;1154;3114
510050;202002;1953;4183;1263;3273;140;418;876;2218;1016;2636
510060;202002;1283;3256;927;2690;197;632;276;746;473;1378
510080;202002;1187;3132;756;2412;253;839;211;574;464;1413
510100;202002;636;1497;436;1181;52;142;226;598;278;740
510120;202002;254;478;139;343;4;14;106;265;110;279
510125;202002;1985;4936;1556;4329;167;610;818;2128;985;2738
510130;202002;1389;3506;948;2812;197;639;297;891;494;1530
510140;202002;2902;7598;1962;6412;708;2724;666;2019;1374;4743
510160;202002;1624;4243;1184;3669;157;468;860;2720;1017;3188
510170;202002;4291;11376;3112;9478;755;2405;1230;3852;1985;6257
510180;202002;13057;29826;7915;22199;1780;5446;2254;7354;4034;12800
510185;202002;1628;4265;1067;3465;432;1411;281;1177;713;2588
510190;202002;1881;5510;1236;4380;344;1352;220;836;564;2188
510250;202002;15560;39899;11692;34242;2206;6734;6121;18696;8327;25430
510260;202002;1861;7869;1533;7273;264;1344;927;4777;1191;6121
510263;202002;2895;8067;1736;5729;286;1059;206;593;492;1652
510267;202002;4506;12953;2523;8538;492;1749;300;943;792;2692
510268;202002;1189;2903;899;2464;104;278;595;1617;699;1895
510269;202002;973;2668;600;1963;154;551;179;543;333;1094
510270;202002;2782;8037;1903;6416;342;1279;773;2552;1115;3831
510279;202002;1686;4366;1036;3241;204;711;434;1297;638;2008
510285;202002;1044;2745;715;2192;228;783;148;409;376;1192
510300;202002;3551;9028;2576;7714;372;1159;1508;4707;1880;5866
510305;202002;1361;3787;815;2730;178;630;190;724;368;1354
510310;202002;869;2146;576;1661;163;492;163;490;326;982
510320;202002;3480;8787;2358;6846;541;1729;603;1730;1144;3459
510325;202002;4107;12241;3089;10380;891;3136;956;3335;1847;6471
510330;202002;2620;7969;1771;6462;351;1284;662;2772;1013;4056
510335;202002;4431;12902;3323;11133;512;1840;1874;6456;2386;8296
510336;202002;429;1217;308;1025;58;192;148;541;206;733
510337;202002;1425;4203;920;3287;363;1428;176;639;539;2067
510340;202002;84430;188786;52173;142030;12746;41342;15236;38653;27982;79995
510343;202002;960;2663;659;2098;120;430;280;844;400;1274
510345;202002;1189;3415;897;2849;157;497;409;1273;566;1770
510350;202002;2598;6853;1669;5288;369;1220;645;2031;1014;3251
510360;202002;1787;3751;1160;3016;70;133;806;2273;876;2406
510370;202002;1677;4873;1218;4065;170;634;713;2460;883;3094
510380;202002;520;1304;280;878;52;190;107;328;159;518
510385;202002;1179;3968;859;3360;86;396;547;2222;633;2618
510390;202002;1141;3132;752;2613;233;787;289;1123;522;1910
510395;202002;694;1579;460;1236;27;72;281;811;308;883
510410;202002;4531;12696;3290;10506;631;2082;1747;5754;2378;7836
510420;202002;2285;4898;1523;3890;119;337;998;2530;1117;2867
510450;202002;418;1042;244;707;63;182;36;120;99;302
510452;202002;686;1926;468;1516;62;220;252;790;314;1010
510454;202002;858;2414;659;2084;71;210;414;1385;485;1595
510455;202002;861;2436;614;1946;103;373;243;696;346;1069
510460;202002;1709;4229;1201;3484;91;326;769;2129;860;2455
510480;202002;4313;10465;2776;7691;537;1636;1117;2982;1654;4618
510490;202002;1589;4172;1162;3641;168;536;753;2369;921;2905
510500;202002;1469;3701;894;2774;167;541;305;966;472;1507
510510;202002;3217;9493;2356;7951;609;2281;725;2595;1334;4876
510515;202002;4993;12929;3204;9743;792;2652;783;2116;1575;4768
510517;202002;977;2880;738;2488;229;855;136;389;365;1244
510520;202002;1992;4085;1122;3004;78;222;590;1691;668;1913
510523;202002;991;2550;718;2098;153;431;409;1220;562;1651
510525;202002;6346;17565;4677;14320;775;2656;2180;6310;2955;8966
510530;202002;533;1374;390;1168;31;96;236;697;267;793
510550;202002;2240;6687;1612;5586;386;1402;707;2480;1093;3882
510558;202002;2155;5820;1527;4873;223;677;693;2374;916;3051
510560;202002;1556;4461;914;3184;186;737;238;891;424;1628
510562;202002;5009;13346;3542;10672;868;2841;1215;3810;2083;6651
510590;202002;3037;7528;2166;6430;176;562;1549;4688;1725;5250
510600;202002;1372;3117;886;2412;168;471;390;1069;558;1540
510610;202002;2553;6210;1736;5131;174;583;1086;3231;1260;3814
510615;202002;2397;6101;1621;4855;287;870;834;2597;1121;3467
510617;202002;939;2846;714;2479;102;405;439;1589;541;1994
510618;202002;1156;3103;787;2453;175;612;371;1115;546;1727
510619;202002;699;1778;443;1341;65;214;111;316;176;530
510620;202002;1355;3055;635;1918;166;615;39;84;205;699
510621;202002;1449;3903;864;2778;185;661;264;797;449;1458
510622;202002;4304;12199;2913;9219;1005;3379;412;1170;1417;4549
510623;202002;2444;6129;1683;4939;400;1414;508;1426;908;2840
510624;202002;1567;3947;712;2381;87;323;156;467;243;790
510625;202002;2694;6593;1433;4348;248;894;330;1009;578;1903
510626;202002;1404;3414;873;2583;243;822;197;589;440;1411
510627;202002;579;1508;324;1008;81;280;80;268;161;548
510628;202002;1397;3252;927;2626;196;591;352;980;548;1571
510629;202002;1507;4326;1117;3631;225;785;407;1321;632;2106
510630;202002;3136;8782;1805;6232;423;1567;315;1173;738;2740
510631;202002;567;1369;411;1138;14;39;316;904;330;943
510637;202002;3182;7718;2249;6368;574;1810;637;1821;1211;3631
510642;202002;5189;14997;3934;13075;989;3554;1659;5681;2648;9235
510645;202002;758;1587;447;1184;98;278;206;516;304;794
510650;202002;6742;17463;5345;15947;597;1610;3733;12193;4330;13803
510665;202002;1684;3759;1025;2704;143;401;445;1206;588;1607
510670;202002;418;903;237;638;24;65;134;373;158;438
510675;202002;5583;15530;3721;12023;1076;3867;573;1809;1649;5676
510677;202002;1980;5160;1359;4226;209;736;706;2140;915;2876
510680;202002;662;1713;362;1153;72;248;75;219;147;467
510682;202002;1443;4302;1046;3636;356;1375;238;801;594;2176
510685;202002;521;1512;372;1206;56;201;188;603;244;804
510700;202002;3860;9434;2669;7745;273;878;1923;5551;2196;6429
510704;202002;10133;23900;6565;17797;1425;4169;1758;4602;3183;8771
510706;202002;1855;5647;1336;4805;254;931;715;2786;969;3717
510710;202002;2485;6290;1594;4638;345;1050;547;1520;892;2570
510715;202002;518;1190;384;1006;33;101;197;514;230;615
510718;202002;2247;5073;1306;3822;401;1184;427;1545;828;2729
510719;202002;412;862;239;647;25;68;139;352;164;420
510720;202002;866;2037;555;1561;98;315;257;676;355;991
510724;202002;745;2034;511;1609;75;254;268;818;343;1072
510726;202002;1037;1897;557;1318;62;169;273;650;335;819
510729;202002;579;1361;248;748;36;125;58;185;94;310
510730;202002;2781;6775;1860;5342;253;825;918;2574;1171;3399
510735;202002;977;2833;746;2505;73;294;544;1823;617;2117
510740;202002;834;2046;525;1475;86;242;249;697;335;939
510757;202002;490;1521;381;1350;124;493;139;465;263;958
510760;202002;40596;89713;23693;63999;5019;15475;7299;18092;12318;33567
510770;202002;4103;9300;2777;7658;230;604;1903;5510;2133;6114
510774;202002;338;865;229;684;34;100;115;353;149;453
510775;202002;580;1548;367;1199;80;283;77;239;157;522
510776;202002;415;1049;295;823;71;205;97;288;168;493
510777;202002;1475;3952;1052;3411;142;532;679;2173;821;2705
510779;202002;628;1704;480;1481;52;150;284;932;336;1082
510780;202002;3381;8779;2461;7492;565;1716;1134;3861;1699;5577
510785;202002;1909;5083;1095;3582;283;988;177;664;460;1652
510787;202002;2472;7040;1611;5217;520;1790;208;675;728;2465
510788;202002;563;1348;392;1082;62;179;185;588;247;767
510790;202002;16148;41962;9568;29699;2040;7149;1456;3987;3496;11136
510792;202002;8067;21999;4892;15953;1022;3747;827;2413;1849;6160
510794;202002;1144;3057;760;2390;237;827;149;413;386;1240
510795;202002;7638;20137;4868;15114;1135;3922;1263;3824;2398;7746
510800;202002;1635;4271;1059;3287;370;1168;116;362;486;1530
510805;202002;1429;3988;967;3107;219;755;312;901;531;1656
510810;202002;610;1254;386;952;109;275;153;388;262;663
510820;202002;725;1384;393;965;28;84;208;521;236;605
510830;202002;809;1962;574;1665;47;134;398;1233;445;1367
510835;202002;529;1289;339;1011;39;129;197;572;236;701
510840;202002;48896;105474;33344;86761;6445;15762;17202;49138;23647;64900
510850;202002;1748;4204;966;2997;323;1125;114;305;437;1430
510860;202002;2207;5933;1375;4513;435;1647;119;383;554;2030
510880;202002;663;1898;504;1596;128;427;184;593;312;1020
510885;202002;528;1293;359;1057;67;223;121;354;188;577
510890;202002;608;1789;460;1539;106;384;209;690;315;1074
510895;202002;1201;3101;782;2423;166;610;322;923;488;1533
520005;202002;2412;6225;1837;5536;550;1668;789;2654;1339;4322
520010;202002;2102;6073;1504;4920;377;1396;453;1294;830;2690
520013;202002;2717;7019;1778;5320;391;1189;507;1657;898;2846
520015;202002;485;1225;342;1010;77;234;133;415;210;649
520017;202002;1059;2755;790;2347;99;326;523;1524;622;1850
520020;202002;370;848;282;738;25;88;215;536;240;624
520025;202002;32193;90434;27629;84106;2708;9000;20042;60721;22750;69721
520030;202002;5304;13722;4232;12236;298;962;3018;8653;3316;9615
520050;202002;394;932;248;679;11;32;154;432;165;464
520055;202002;1614;3943;1074;2921;81;217;622;1653;703;1870
520060;202002;1369;3801;988;3095;258;891;245;769;503;1660
520080;202002;1739;4509;1290;3906;235;715;629;2088;864;2803
520082;202002;884;2253;691;1937;74;199;366;1076;440;1275
520085;202002;780;2103;605;1818;105;334;294;845;399;1179
520090;202002;817;1608;560;1324;53;87;432;1071;485;1158
520110;202002;36635;98730;25201;79856;7837;28271;2171;6285;10008;34556
520120;202002;187;451;103;310;14;50;40;120;54;170
520130;202002;3460;8559;2681;7365;513;1433;1177;3281;1690;4714
520140;202002;38721;103695;26741;83220;9626;32489;3524;11375;13150;43864
520145;202002;543;1288;372;1043;60;198;214;555;274;753
520150;202002;577;1301;415;1104;75;200;224;609;299;809
520160;202002;720;1680;522;1379;94;230;250;695;344;925
520170;202002;4834;9781;3206;7933;172;485;2470;6043;2642;6528
520180;202002;2077;5686;1689;5130;307;1039;941;2836;1248;3875
520215;202002;1660;4024;1176;3274;282;842;407;1080;689;1922
520235;202002;581;1335;329;939;35;125;129;348;164;473
520250;202002;1434;3716;996;2980;323;1050;240;761;563;1811
520260;202002;769;1798;479;1330;90;249;200;568;290;817
520280;202002;653;1635;501;1401;99;274;243;727;342;1001
520310;202002;1002;2208;652;1685;151;448;251;678;402;1126
520320;202002;1568;4226;1179;3604;153;531;654;1965;807;2496
520330;202002;3725;10154;2676;8422;406;1537;1375;4220;1781;5757
520340;202002;2375;5272;1472;4020;168;422;870;2498;1038;2920
520350;202002;2755;6624;1951;5405;577;1683;749;2098;1326;3781
520355;202002;1736;4788;1225;3779;375;1252;319;874;694;2126
520357;202002;720;1725;511;1420;27;69;384;1093;411;1162
520360;202002;670;1758;499;1473;137;424;141;452;278;876
520380;202002;1379;3437;799;2364;90;283;406;1126;496;1409
520390;202002;968;2154;569;1660;164;519;185;578;349;1097
520393;202002;472;1133;313;884;34;114;148;387;182;501
520396;202002;791;2069;657;1860;40;132;487;1336;527;1468
520400;202002;1499;3744;1138;3246;147;454;763;2197;910;2651
520410;202002;1872;4212;1126;3081;183;528;462;1226;645;1754
520420;202002;350;814;270;688;22;60;207;505;229;565
520425;202002;1408;3430;800;2331;207;616;192;533;399;1149
520430;202002;2220;5083;1235;3558;233;794;59;153;292;947
520440;202002;2844;6891;1702;4881;414;1316;443;1210;857;2526
520450;202002;11330;26975;7345;21029;2331;7276;1348;3946;3679;11222
520455;202002;645;1766;465;1493;133;460;136;442;269;902
520460;202002;982;2305;759;2021;77;176;603;1642;680;1818
520465;202002;744;1904;593;1702;82;275;407;1114;489;1389
520470;202002;2006;5235;1541;4620;415;1264;678;2198;1093;3462
520480;202002;873;2425;602;1973;195;649;130;468;325;1117
520485;202002;1506;4255;1262;3916;167;530;898;2783;1065;3313
520490;202002;3835;10593;2847;9035;969;3197;1048;3466;2017;6663
520495;202002;1532;3372;1150;2865;50;133;921;2294;971;2427
520500;202002;1175;3162;794;2420;188;617;332;1012;520;1629
520505;202002;701;1566;482;1287;59;161;298;798;357;959
520510;202002;7313;18206;4781;14266;1106;3700;1312;4239;2418;7939
520520;202002;1093;2795;799;2333;192;604;279;826;471;1430
520530;202002;1893;5540;1409;4736;432;1515;486;1749;918;3264
520540;202002;2733;7248;1659;5108;316;1061;378;1115;694;2176
520545;202002;911;2392;675;2003;139;404;272;820;411;1224
520547;202002;772;2107;612;1841;148;446;306;928;454;1374
520549;202002;12525;33865;10283;30578;1433;4506;6854;20312;8287;24818
520551;202002;4345;11831;3611;10769;388;1374;2582;7501;2970;8875
520552;202002;795;2065;653;1884;135;387;376;1147;511;1534
520570;202002;513;1141;340;899;85;202;133;399;218;601
520580;202002;2043;4776;1557;4202;110;368;1146;3028;1256;3396
520590;202002;1122;2875;772;2305;235;716;202;615;437;1331
520620;202002;7760;21037;6052;18553;1517;4790;2734;8639;4251;13429
520630;202002;681;1787;452;1383;82;253;102;314;184;567
520640;202002;2270;5642;1726;4704;418;1120;711;2010;1129;3130
520650;202002;773;1829;563;1536;93;253;310;895;403;1148
520660;202002;504;1205;261;782;53;189;67;189;120;378
520670;202002;871;2408;736;2218;71;222;479;1422;550;1644
520680;202002;653;1658;483;1395;77;214;252;731;329;945
520690;202002;322;749;221;605;63;161;70;218;133;379
520710;202002;388;939;268;732;10;23;192;516;202;539
520725;202002;1459;3435;1004;2709;118;374;630;1630;748;2004
520735;202002;728;1803;482;1391;105;288;179;561;284;849
520740;202002;2025;4588;1504;3983;264;640;850;2420;1114;3060
520750;202002;643;1566;447;1249;73;198;223;632;296;830
520753;202002;1225;3287;920;2712;179;557;375;1046;554;1603
520760;202002;1145;2589;1009;2424;31;60;922;2252;953;2312
520780;202002;1400;3285;992;2728;101;298;495;1323;596;1621
520790;202002;3228;7719;2270;6171;299;806;1258;3636;1557;4442
520800;202002;15532;40445;12007;35321;1898;5791;7011;21235;8909;27026
520810;202002;1233;2623;895;2233;145;389;564;1480;709;1869
520815;202002;548;1668;407;1385;72;267;114;400;186;667
520830;202002;1748;3750;1237;3178;41;115;1025;2602;1066;2717
520840;202002;2456;6640;1985;6030;834;2740;531;1730;1365;4470
520850;202002;610;1589;448;1352;158;547;107;345;265;892
520860;202002;6186;16714;4484;13978;1185;3955;1656;5103;2841;9058
520870;202002;98254;228201;64856;178966;14675;43840;22605;61275;37280;105115
520880;202002;6404;18366;4924;15730;1148;3826;1819;5850;2967;9676
520890;202002;3740;9079;2533;7188;526;1628;1067;3053;1593;4681
520910;202002;4478;11324;2820;8437;694;2260;633;1861;1327;4121
520915;202002;692;1931;404;1274;68;230;134;405;202;635
520920;202002;4215;9515;2927;7888;351;970;1680;4687;2031;5657
520929;202002;633;1482;460;1229;72;171;230;664;302;835
520940;202002;942;2511;732;2217;43;138;539;1599;582;1737
520945;202002;460;1050;373;927;20;43;265;652;285;695
520960;202002;955;2363;754;2044;148;365;449;1229;597;1594
520970;202002;2405;6646;1857;5782;476;1664;496;1628;972;3292
520980;202002;748;1828;543;1549;106;322;217;605;323;927
520990;202002;2875;7787;2305;7052;330;987;1502;4683;1832;5670
520993;202002;1061;2510;714;1971;98;309;404;1065;502;1374
520995;202002;2220;5635;1667;4888;267;788;676;2051;943;2839
521000;202002;8311;21770;5447;16628;1121;3531;1649;5008;2770;8539
521010;202002;3531;9194;2636;7661;260;762;1537;4420;1797;5182
521015;202002;763;1887;519;1463;38;119;329;879;367;998
521020;202002;3036;7785;1741;5288;519;1729;135;435;654;2164
521030;202002;455;990;303;762;64;137;131;365;195;502
521040;202002;7371;18052;5398;14969;1156;3358;2294;6491;3450;9849
521056;202002;869;2320;685;2046;221;652;193;644;414;1296
521060;202002;923;2453;680;2010;50;148;356;1067;406;1215
521080;202002;1086;2361;543;1507;72;219;227;545;299;764
521090;202002;3112;8319;2080;6334;588;1910;275;876;863;2786
521100;202002;1703;3976;1199;3262;192;518;702;1937;894;2455
521120;202002;4549;10681;3259;9092;198;505;1626;5253;1824;5758
521130;202002;934;2100;540;1449;23;69;287;821;310;890
521140;202002;1186;3053;847;2457;111;334;413;1208;524;1542
521150;202002;11998;26290;7326;19760;1246;3880;3518;9585;4764;13465
521160;202002;620;1288;429;1013;45;105;286;653;331;758
521170;202002;994;2338;718;1931;55;156;492;1296;547;1452
521180;202002;6885;19162;5627;16978;917;3012;2938;8605;3855;11617
521190;202002;10070;25132;5681;17728;1439;4812;1108;3745;2547;8557
521200;202002;684;1684;474;1342;48;134;265;756;313;890
521205;202002;610;1513;455;1265;16;50;343;911;359;961
521210;202002;673;1731;386;1151;88;279;69;160;157;439
521220;202002;3545;8680;2271;6673;418;1407;815;2330;1233;3737
521225;202002;327;718;235;619;33;88;140;366;173;454
521230;202002;1266;3268;1117;3084;362;1013;565;1655;927;2668
521250;202002;29117;78615;22458;68884;8341;26909;6622;21618;14963;48527
521260;202002;549;1278;395;1039;56;151;224;576;280;727
521270;202002;1722;4404;1493;4135;81;198;1143;3203;1224;3401
521280;202002;1747;4693;1297;3945;316;1062;532;1645;848;2707
521290;202002;441;1066;307;891;39;132;189;538;228;670
521295;202002;1051;2294;801;2023;53;107;663;1722;716;1829
521300;202002;1802;4465;1420;3932;263;677;896;2565;1159;3242
521305;202002;673;1635;470;1329;59;157;275;778;334;935
521308;202002;4546;12196;3134;9537;286;881;1841;5499;2127;6380
521310;202002;7980;20391;5459;16178;1191;3833;2249;6395;3440;10228
521340;202002;400;936;290;776;22;60;203;526;225;586
521350;202002;1994;5095;1497;4350;135;474;1056;2933;1191;3407
521370;202002;1196;3042;706;2204;203;731;87;294;290;1025
521375;202002;1279;3130;859;2525;198;575;268;879;466;1454
521377;202002;1431;3072;1027;2575;75;135;843;2210;918;2345
521380;202002;5960;15849;3827;11961;403;1390;1033;3414;1436;4804
521385;202002;636;1548;486;1356;58;150;281;847;339;997
521390;202002;694;1698;478;1373;142;451;178;531;320;982
521400;202002;2502;5833;1923;5133;214;570;1344;3648;1558;4218
521405;202002;1261;3214;911;2622;179;521;443;1263;622;1784
521410;202002;777;2082;578;1740;104;292;298;958;402;1250
521440;202002;1140;2877;809;2372;272;872;232;684;504;1556
521450;202002;3739;11121;2701;9129;716;2442;712;2514;1428;4956
521460;202002;5503;14563;3843;11637;1331;4213;877;2719;2208;6932
521470;202002;611;1654;366;1141;48;145;124;382;172;527
521480;202002;351;883;205;602;40;115;62;176;102;291
521483;202002;2344;5623;1627;4523;348;1029;625;1710;973;2739
521486;202002;1696;4019;1256;3401;72;198;920;2467;992;2665
521487;202002;402;974;283;810;47;138;139;409;186;547
521490;202002;884;2374;654;1997;38;149;464;1379;502;1528
521500;202002;2121;5269;1547;4363;96;339;1099;3015;1195;3354
521520;202002;714;1654;505;1346;76;216;213;575;289;791
521523;202002;11036;34169;9032;30966;2460;9256;2452;8689;4912;17945
521525;202002;987;2290;727;1925;70;193;519;1360;589;1553
521530;202002;2179;5655;1243;3757;271;856;295;914;566;1770
521540;202002;790;1997;522;1555;72;252;237;736;309;988
521550;202002;1410;3605;783;2315;138;471;217;654;355;1125
521560;202002;4327;11438;2945;9593;446;1717;1517;5159;1963;6876
521565;202002;632;1526;486;1326;76;192;297;803;373;995
521570;202002;3306;9001;2162;6803;426;1551;208;706;634;2257
521580;202002;466;1137;264;795;39;128;79;210;118;338
521590;202002;614;1452;448;1215;84;250;249;664;333;914
521600;202002;356;960;222;700;33;82;95;307;128;389
521630;202002;1636;3594;997;2656;205;588;347;895;552;1483
521640;202002;1719;4022;1150;3204;253;738;391;1076;644;1814
521645;202002;549;1427;342;1062;81;225;114;358;195;583
521680;202002;1058;3210;816;2741;235;870;119;426;354;1296
521690;202002;501;1234;417;1120;58;166;263;698;321;864
521710;202002;3088;7702;1937;5820;348;1197;472;1320;820;2517
521720;202002;2137;4955;1373;3797;157;492;779;2148;936;2640
521730;202002;3387;9531;2569;8105;737;2696;676;1811;1413;4507
521740;202002;3769;9912;2823;8532;687;2265;1080;3382;1767;5647
521760;202002;14367;39526;11083;34509;2887;9916;4113;13354;7000;23270
521770;202002;2853;6889;1859;5267;571;1744;469;1340;1040;3084
521800;202002;6028;16312;4300;13442;994;3163;1657;5624;2651;8787
521805;202002;463;1133;343;961;108;293;146;418;254;711
521810;202002;595;1417;415;1175;60;173;242;693;302;866
521830;202002;5358;14864;4231;13151;298;1126;3053;9291;3351;10417
521839;202002;681;1630;463;1276;76;237;245;613;321;850
521850;202002;5202;12238;3227;9271;554;1792;427;1144;981;2936
521860;202002;1482;3925;1012;3114;181;615;322;971;503;1586
521870;202002;666;1858;468;1464;97;344;118;325;215;669
521878;202002;624;1618;430;1253;54;180;228;602;282;782
521880;202002;17441;42413;11562;33439;2945;9038;4041;11908;6986;20946
521890;202002;2917;7564;1898;5781;537;1772;338;930;875;2702
521900;202002;1442;3390;831;2463;277;793;114;356;391;1149
521910;202002;1193;2533;786;2058;71;187;436;1244;507;1431
521920;202002;452;1259;331;1044;60;217;143;433;203;650
521925;202002;731;1908;533;1617;87;276;287;858;374;1134
521930;202002;5245;12604;3421;9817;879;2385;1303;4130;2182;6515
521935;202002;955;2291;649;1748;62;177;384;977;446;1154
521940;202002;1266;2825;813;2213;191;570;326;865;517;1435
521945;202002;511;1412;410;1237;97;296;215;666;312;962
521950;202002;725;1768;506;1429;124;370;219;576;343;946
521960;202002;695;1802;451;1345;55;175;237;661;292;836
521970;202002;2483;6100;1979;5502;154;427;1527;4295;1681;4722
521971;202002;699;1671;482;1360;132;363;142;411;274;774
521973;202002;1238;3228;950;2785;42;150;696;1997;738;2147
521975;202002;11393;30136;9299;27269;1446;4462;5934;17391;7380;21853
521980;202002;2485;5844;1906;5078;146;371;1433;3913;1579;4284
521990;202002;1044;2949;828;2566;175;569;305;939;480;1508
522000;202002;2366;6381;1916;5812;243;722;1293;4066;1536;4788
522005;202002;324;777;241;654;47;126;123;343;170;469
522010;202002;3794;9271;2644;7429;615;1897;935;2565;1550;4462
522015;202002;942;2462;673;2044;182;552;259;810;441;1362
522020;202002;5369;12807;3473;9847;719;2126;1380;3990;2099;6116
522026;202002;672;1836;472;1472;92;313;167;484;259;797
522028;202002;393;1001;292;831;53;162;130;361;183;523
522040;202002;3004;6821;2116;5628;257;731;1427;3748;1684;4479
522045;202002;16679;46438;12159;38461;2900;9869;3344;10249;6244;20118
522050;202002;926;2479;623;1968;168;583;209;605;377;1188
522060;202002;2812;7415;1930;5937;164;514;1110;3532;1274;4046
522068;202002;1765;4558;1378;4093;123;333;1065;3214;1188;3547
522070;202002;598;1462;480;1284;19;56;407;1077;426;1133
522100;202002;693;1781;464;1414;55;195;248;725;303;920
522108;202002;944;2474;728;2160;56;231;573;1628;629;1859
522119;202002;1449;3653;1099;3195;177;529;602;1812;779;2341
522130;202002;371;931;259;776;33;96;159;509;192;605
522140;202002;16614;44204;11461;35060;2991;9796;3077;9011;6068;18807
522145;202002;768;1902;516;1519;143;408;195;589;338;997
522150;202002;1007;2503;711;2009;195;537;211;630;406;1167
522155;202002;1035;2612;776;2202;136;363;434;1258;570;1621
522157;202002;543;1309;445;1182;25;83;347;927;372;1010
522160;202002;5868;15202;3767;11357;1036;3362;292;957;1328;4319
522170;202002;2578;6607;1917;5633;299;904;1080;3204;1379;4108
522180;202002;425;1003;278;755;60;174;37;119;97;293
522185;202002;17941;44468;12673;37289;4967;15826;2786;8859;7753;24685
522190;202002;747;1804;500;1374;94;264;189;505;283;769
522200;202002;1596;4527;1042;3458;218;786;173;524;391;1310
522205;202002;1620;3772;1227;3253;124;353;853;2251;977;2604
522220;202002;1227;3058;907;2577;126;366;508;1491;634;1857
522230;202002;1078;2758;864;2460;183;638;450;1200;633;1838
530010;202002;164970;444029;132439;396150;20764;67950;77060;227191;97824;295141
110001;202001;3938;11102;2630;8615;603;2125;1003;3330;1606;5455
110002;202001;12024;31798;8376;25403;2341;7549;2251;6892;4592;14441
110003;202001;623;1843;444;1466;104;377;109;342;213;719
110004;202001;10908;28934;7179;22098;1566;5205;1948;6180;3514;11385
110005;202001;2559;6660;1664;5108;360;1203;434;1455;794;2658
110006;202001;1762;4938;1090;3516;216;802;188;562;404;1364
110007;202001;1327;3389;848;2602;268;893;205;756;473;1649
110008;202001;3272;9184;2388;7814;274;868;1559;5440;1833;6308
110009;202001;4277;12118;2728;9246;632;2244;1033;3559;1665;5803
110010;202001;7325;23929;5407;20130;1166;4366;2551;10364;3717;14730
110011;202001;6652;17938;4542;14087;1638;5302;635;2068;2273;7370
110012;202001;14729;37259;8612;26291;2106;6831;793;2660;2899;9491
110013;202001;5293;15447;3864;12503;1567;5349;477;1699;2044;7048
110014;202001;3736;10036;2475;7616;628;2032;907;2762;1535;4794
110015;202001;5323;13955;3016;9304;716;2399;557;1581;1273;3980
110018;202001;3704;9409;2128;6606;421;1501;582;1770;1003;3271
110020;202001;74981;181649;52962;151048;11563;34115;21501;67095;33064;101210
110025;202001;4943;12107;3192;9046;670;2057;1362;3873;2032;5930
110026;202001;501;1307;353;1091;89;293;142;465;231;758
110028;202001;6623;17089;4018;12315;1052;3500;588;1787;1640;5287
110029;202001;1437;3524;820;2453;184;563;303;955;487;1518
110030;202001;12947;30011;8042;22725;1709;5667;1666;5047;3375;10714
110032;202001;2999;8638;1900;6271;589;1951;403;1406;992;3357
110033;202001;3663;11606;2848;10087;1016;3678;682;2697;1698;6375
110034;202001;3444;8169;2270;6532;677;2187;777;2399;1454;4586
110037;202001;1631;4870;1219;4138;279;947;567;1971;846;2918
110040;202001;2993;8438;2128;6815;610;2102;617;1918;1227;4020
110045;202001;5095;14778;3831;12474;1017;3572;1340;4419;2357;7991
110050;202001;1800;4929;1258;3968;488;1677;238;777;726;2454
110060;202001;783;2353;539;1793;200;712;83;278;283;990
110070;202001;1668;5272;1255;4355;404;1508;241;746;645;2254
110080;202001;6228;14555;4558;12577;537;1395;3090;9088;3627;10483
110090;202001;564;1510;398;1219;90;309;170;502;260;811
110092;202001;1155;3397;833;2783;140;483;422;1505;562;1988
110094;202001;2818;8448;2104;7087;886;3207;317;1081;1203;4288
110100;202001;1710;5098;1380;4455;387;1308;575;1871;962;3179
110110;202001;1709;4787;1175;3834;380;1282;265;923;645;2205
110120;202001;1265;3754;939;3108;237;837;297;969;534;1806
110130;202001;2694;6869;1704;5084;345;1163;595;1774;940;2937
110140;202001;2055;6164;1404;4812;352;1253;349;1238;701;2491
110143;202001;1322;3639;902;2795;292;897;153;486;445;1383
110145;202001;835;2246;537;1706;126;418;178;588;304;1006
110146;202001;453;1204;320;1005;59;184;147;500;206;684
110147;202001;773;2010;475;1417;69;229;178;459;247;688
110148;202001;820;2288;459;1556;112;419;48;162;160;581
110149;202001;3041;8379;2104;6872;738;2526;444;1571;1182;4097
110150;202001;2669;6543;1798;5347;535;1753;463;1643;998;3396
110155;202001;699;2094;503;1621;113;385;171;523;284;908
110160;202001;1458;4582;1067;3701;314;1103;246;896;560;1999
110170;202001;2211;5734;1338;4030;253;802;676;1965;929;2767
110175;202001;1679;4777;1182;3910;193;693;502;1764;695;2457
110180;202001;1357;3782;915;2890;155;504;454;1424;609;1928
120001;202001;3214;9506;2647;8662;420;1428;1667;5635;2087;7063
120005;202001;1970;7559;1778;7277;166;743;1382;5764;1548;6507
120010;202001;5338;16154;4491;14834;451;1461;3191;10901;3642;12362
120013;202001;2224;7907;1981;7605;447;1659;1196;4922;1643;6581
120017;202001;2510;8831;2229;8386;350;1342;1448;5776;1798;7118
120020;202001;15150;59668;13888;57174;1155;5429;10753;44620;11908;50049
120025;202001;3115;8960;2498;8190;399;1290;1698;5751;2097;7041
120030;202001;6605;26030;6129;25144;436;2371;4738;19508;5174;21879
120032;202001;1676;7576;1587;7405;110;718;1295;5935;1405;6653
120033;202001;4099;15189;3840;14731;132;749;3326;12647;3458;13396
120034;202001;2648;9672;2251;8959;118;731;1848;7191;1966;7922
120035;202001;3683;14790;3477;14419;288;1422;2798;11610;3086;13032
120038;202001;2742;8835;2350;8196;550;1990;1241;4421;1791;6411
120039;202001;2014;8751;1880;8468;142;866;1486;6641;1628;7507
120040;202001;44762;142017;38318;131323;5593;20269;23490;81704;29083;101973
120042;202001;3369;12698;3074;12128;149;812;2524;9878;2673;10690
120043;202001;1396;5659;1273;5463;42;252;1148;4942;1190;5194
120045;202001;6196;16059;5366;15128;125;512;4881;13613;5006;14125
120050;202001;9423;33959;8577;32638;420;2203;7077;26988;7497;29191
120060;202001;9694;37308;8867;36043;412;2442;7651;30911;8063;33353
120070;202001;3167;10237;2742;9650;264;949;1939;7108;2203;8057
120080;202001;4308;14079;3842;13366;487;1822;2727;9672;3214;11494
130002;202001;3094;12273;2759;11775;196;890;2324;10065;2520;10955
130006;202001;2411;9064;1982;8279;190;862;1465;6151;1655;7013
130008;202001;2655;9284;2344;8818;71;381;2009;7541;2080;7922
130010;202001;3996;11608;3338;10856;79;252;3054;10068;3133;10320
130014;202001;3138;9423;2422;8242;433;1500;1447;5077;1880;6577
130020;202001;2753;10874;2491;10477;149;869;1991;8329;2140;9198
130030;202001;10074;32781;9147;31695;320;1087;8097;28541;8417;29628
130040;202001;3819;11498;3179;10633;181;634;2612;8826;2793;9460
130050;202001;7719;28073;6458;26440;178;901;5834;24139;6012;25040
130060;202001;7613;30255;6526;28820;463;2610;5331;23467;5794;26077
130063;202001;6351;20751;5667;19993;217;972;5117;18138;5334;19110
130068;202001;3768;13498;3201;12626;242;1341;2361;9183;2603;10524
130070;202001;7630;21559;6238;20021;304;975;5168;17045;5472;18020
130080;202001;6983;25712;6107;24669;270;1513;5106;20984;5376;22497
130083;202001;2772;9108;2458;8709;175;739;2094;7398;2269;8137
130090;202001;3507;10908;3115;10408;60;266;2707;9249;2767;9515
130100;202001;8048;24192;6850;22939;62;147;6429;22106;6491;22253
130110;202001;8654;24714;7104;22793;1041;2688;5140;17798;6181;20486
130115;202001;5401;16813;4647;15968;108;374;4061;14231;4169;14605
130120;202001;14465;51018;12727;48728;1125;4785;10291;39789;11416;44574
130130;202001;5305;17052;4087;15441;395;1651;2991;11307;3386;12958
130140;202001;7258;25450;6430;24499;208;1169;5611;21472;5819;22641
130150;202001;3702;13802;3472;13543;83;528;3160;12360;3243;12888
130160;202001;5095;18220;4376;17301;288;1287;3690;14797;3978;16084
130165;202001;3270;12395;3071;12143;131;590;2742;10939;2873;11529
130170;202001;11965;35197;9517;32320;741;2915;7542;25914;8283;28829
130180;202001;4518;14497;4274;14220;40;225;4117;13667;4157;13892
130185;202001;18698;46087;15248;42403;1001;1801;12829;37765;13830;39566
130190;202001;19236;63622;15472;57964;1838;7161;10776;41709;12614;48870
130195;202001;2481;9044;2033;8475;72;393;1795;7509;1867;7902
130200;202001;2617;7400;2169;6806;106;421;1785;5574;1891;5995
130210;202001;1288;4911;1154;4754;105;622;916;3668;1021;4290
130220;202001;2316;8112;2003;7695;62;331;1750;6748;1812;7079
130230;202001;4582;19025;3983;18160;254;1560;3382;15414;3636;16974
130240;202001;12179;36566;9855;33471;199;1163;8795;29820;8994;30983
130250;202001;26553;79603;22794;75375;1701;5264;18196;62640;19897;67904
130255;202001;4387;14755;3810;13740;168;769;3073;11090;3241;11859
130260;202001;268327;752340;218730;679667;59092;195346;99460;317706;158552;513052
130270;202001;9361;33543;7762;31050;1198;4794;5109;21373;6307;26167
130280;202001;3543;14304;3240;13966;100;511;2991;13062;3091;13573
130290;202001;13381;45130;11572;42804;697;2781;9664;36555;10361;39336
130300;202001;4770;16695;4321;16073;155;863;3733;13838;3888;14701
130310;202001;6181;21033;5393;19983;314;1419;4510;16733;4824;18152
130320;202001;3513;11353;2939;10621;358;1275;2166;8094;2524;9369
130330;202001;4664;14944;3762;13828;221;982;3187;11713;3408;12695
130340;202001;23766;74838;20401;70970;1533;4747;16921;60979;18454;65726
130350;202001;3966;14512;3573;14012;145;822;3131;12195;3276;13017
130353;202001;7465;20348;5992;18471;855;2567;4159;13317;5014;15884
130356;202001;5266;16889;4375;15491;753;2636;2672;9996;3425;12632
130360;202001;3057;9804;2621;9251;93;387;2354;8286;2447;8673
130370;202001;5817;22736;5044;21651;303;1682;4092;17481;4395;19163
130380;202001;7179;29944;6652;29196;396;2286;5595;24326;5991;26612
130390;202001;5995;25231;5279;24012;576;3047;3817;17412;4393;20459
130395;202001;2345;7481;2002;6911;201;728;1511;5199;1712;5927
130400;202001;2747;8686;2355;8169;92;321;2095;7388;2187;7709
130406;202001;11131;39280;9414;37141;1686;6676;6384;26137;8070;32813
130410;202001;4174;14924;3549;13857;1073;4387;1588;6412;2661;10799
130420;202001;13755;48440;11513;45658;960;4867;8925;35648;9885;40515
130423;202001;4291;13667;3764;13069;185;880;3283;11246;3468;12126
130426;202001;2835;11164;2648;10933;74;422;2426;10071;2500;10493
130430;202001;4234;12058;3674;11315;259;961;3032;9194;3291;10155
130440;202001;4864;15261;4161;14420;106;450;3820;13339;3926;13789
140002;202001;2222;6572;1925;6197;96;373;1598;5181;1694;5554
140005;202001;3328;9191;2936;8748;139;359;2517;7692;2656;8051
140010;202001;56206;148450;44421;130944;11252;34836;18178;55120;29430;89956
140015;202001;3807;11456;3244;10767;220;726;2819;9507;3039;10233
140017;202001;4460;12506;3894;11797;275;810;3155;9822;3430;10632
140020;202001;5376;15783;4612;14760;256;1083;3721;11830;3977;12913
140023;202001;2473;7371;2023;6746;210;709;1500;5108;1710;5817
140028;202001;2097;5396;1778;4993;102;326;1417;3970;1519;4296
140030;202001;5306;13637;4679;12914;358;732;4010;11477;4368;12209
140040;202001;2541;10058;2322;9746;102;632;2065;8546;2167;9178
140045;202001;2619;9519;2207;8946;354;1243;1494;6539;1848;7782
140047;202001;6402;18318;5386;16839;640;2033;3785;12049;4425;14082
140050;202001;1452;4218;1206;3866;124;404;891;2918;1015;3322
140060;202001;1689;4469;1425;4082;123;329;1122;3290;1245;3619
140070;202001;1931;10072;1865;9924;127;868;1539;8119;1666;8987
150010;202001;46045;114832;41600;109119;968;2386;37085;97068;38053;99454
150013;202001;2005;5084;1638;4685;152;323;1258;3837;1410;4160
150020;202001;14502;43669;13429;42266;1370;3601;11027;35792;12397;39393
150030;202001;8954;33610;8147;32612;466;2076;7033;28377;7499;30453
150034;202001;4269;10553;3505;9592;243;614;2885;8064;3128;8678
150040;202001;16698;43009;14581;40663;1283;2038;12034;36571;13317;38609
150050;202001;7033;24674;6418;23844;139;628;5845;21970;5984;22598
150060;202001;22218;60632;17883;54092;2887;8955;11156;34552;14043;43507
150070;202001;6765;25374;5920;24357;227;1148;5254;21849;5481;22997
150080;202001;96349;215709;80587;194275;19298;50846;23716;69803;43014;120649
150085;202001;7648;22264;6923;21395;136;469;6463;20096;6599;20565
150090;202001;9910;36976;9319;35808;683;2728;7464;28899;8147;31627
150095;202001;5669;16743;4934;15808;273;640;4129;13801;4402;14441
150100;202001;2907;10237;2570;9667;205;697;1990;7637;2195;8334
150110;202001;4449;18376;4146;18022;206;974;3772;16489;3978;17463
150120;202001;8056;25335;7652;24852;281;753;6789;22757;7070;23510
150125;202001;755;2047;558;1782;103;395;319;994;422;1389
150130;202001;22875;66441;19807;61843;3338;9437;12948;42579;16286;52016
150140;202001;251064;584861;212027;530644;31982;77949;122554;319633;154536;397582
150145;202001;4383;13390;3705;12356;919;2793;2041;7518;2960;10311
150150;202001;16174;41782;14148;39197;589;1770;11721;32492;12310;34262
150157;202001;3515;9660;2835;8785;294;941;1990;6433;2284;7374
150160;202001;3048;9046;2836;8733;555;1626;1735;5579;2290;7205
150170;202001;24871;81509;21685;76062;4013;13284;13106;49054;17119;62338
150172;202001;4838;13312;3872;11957;264;758;2928;9350;3192;10108
150175;202001;1613;5118;1356;4612;240;860;779;2677;1019;3537
150178;202001;10585;28678;8721;26492;231;621;7713;23790;7944;24411
150180;202001;22403;79661;20310;77227;1076;3741;17755;69040;18831;72781
150190;202001;6775;22901;6286;22269;283;1275;5478;19305;5761;20580
150195;202001;5246;16894;4971;16474;77;417;4603;15106;4680;15523
150200;202001;5890;17219;5383;16661;66;185;5079;15846;5145;16031
150210;202001;26391;92023;24634;89633;1787;6560;20221;75612;22008;82172
150215;202001;7691;21834;6585;20213;1210;3632;3807;12263;5017;15895
150220;202001;12435;35326;10869;33087;1116;3320;7416;23038;8532;26358
150230;202001;12540;35646;10927;33513;1180;3273;7477;24011;8657;27284
150240;202001;32699;91073;27039;81306;7544;23113;9078;27868;16622;50981
150250;202001;4274;16428;4006;16105;635;2480;3027;12517;3662;14997
150260;202001;2782;9120;2515;8706;174;581;1957;6883;2131;7464
150270;202001;8884;25532;6259;20945;2022;7104;1717;6109;3739;13213
150275;202001;6867;22044;6286;21232;238;930;5437;18293;5675;19223
150276;202001;2337;6275;1999;5871;264;707;1363;4413;1627;5120
150277;202001;5315;13906;4291;12712;333;894;3268;10350;3601;11244
150280;202001;6828;27605;6584;27197;497;2024;5511;23069;6008;25093
150285;202001;3329;11671;2920;11024;246;974;2104;8070;2350;9044
150290;202001;10648;28986;9610;27867;299;662;8658;25723;8957;26385
150293;202001;9611;23766;7240;20627;1033;2955;4278;12888;5311;15843
150295;202001;8036;21510;5850;18578;1890;6467;1956;7126;3846;13593
150300;202001;2403;7174;2147;6841;44;163;1941;6209;1985;6372
150304;202001;4160;12407;3417;11236;626;1959;2036;7031;2662;8990
150307;202001;6210;19987;5714;19164;360;1187;4635;15736;4995;16923
150309;202001;6280;19059;5065;16931;924;3048;2790;9764;3714;12812
150310;202001;7362;29057;6998;28609;220;1233;6206;25601;6426;26834
150320;202001;9549;26064;8700;24845;415;1280;6707;19085;7122;20365
150330;202001;14148;45564;13047;43807;1309;4115;9803;33949;11112;38064
150340;202001;2569;7491;2271;7040;343;1001;1550;4944;1893;5945
150345;202001;8155;23941;7323;22828;434;1414;6217;19479;6651;20893
150350;202001;9196;23167;8428;22173;744;1427;6897;18731;7641;20158
150360;202001;24532;68020;19587;61706;2043;5473;13603;45554;15646;51027
150370;202001;10811;33022;8887;30427;1005;2958;6425;23630;7430;26588
150375;202001;3511;14287;3161;13758;248;1189;2632;11580;2880;12769
150380;202001;11261;28778;9218;26082;138;499;8090;22949;8228;23448
150390;202001;8134;32423;7288;31080;1114;4176;5088;23045;6202;27221
150400;202001;6471;23453;6201;22939;286;1122;5367;19948;5653;21070
150405;202001;9333;24589;8155;23163;494;1149;6537;19210;7031;20359
150410;202001;1942;6201;1648;5692;211;657;1059;3765;1270;4422
150420;202001;41861;116578;32234;102115;8983;29905;10710;39467;19693;69372
150430;202001;8522;24931;7762;23938;869;2043;6042;19500;6911;21543
150440;202001;5677;18343;5176;17618;757;2309;3631;12911;4388;15220
150442;202001;26365;63287;21705;57392;2354;6151;14778;39960;17132;46111
150445;202001;6375;19670;5605;18485;214;752;4772;15782;4986;16534
150450;202001;5094;21929;4724;21417;365;1843;4033;18266;4398;20109
150460;202001;8506;27878;7789;26961;253;1031;6614;23763;6867;24794
150470;202001;21847;56473;19443;53739;390;1050;18214;50434;18604;51484
150475;202001;4946;15637;4276;14621;176;657;3527;12219;3703;12876
150480;202001;13841;44849;12365;42640;2242;7055;8131;29965;10373;37020
150490;202001;8399;29118;7719;28271;274;1184;6832;25173;7106;26357
150495;202001;5281;18188;5051;17856;116;602;4580;16079;4696;16681
150497;202001;2963;9368;2382;8344;539;1937;1203;4548;1742;6485
150500;202001;3318;8547;2941;8008;254;615;2277;6221;2531;6836
150503;202001;4865;12663;3384;10705;1002;3398;1050;3843;2052;7241
150506;202001;10408;31169;8757;28915;1869;5439;5385;19765;7254;25204
150510;202001;9954;36281;8615;33748;1181;4403;5719;23505;6900;27908
150520;202001;7126;27599;6796;27185;237;1393;6087;24270;6324;25663
150530;202001;12574;42791;10885;40341;1598;4781;7722;30629;9320;35410
150540;202001;5040;13803;4276;12655;229;626;3550;10567;3779;11193
150543;202001;7432;19896;6063;18167;511;1565;4589;14372;5100;15937
150548;202001;10353;32194;9310;30781;310;1164;8153;27054;8463;28218
150549;202001;2013;6029;1726;5638;41;184;1481;4839;1522;5023
150550;202001;20192;59430;16870;53996;3995;13008;7395;25372;11390;38380
150553;202001;27091;79587;21585;69818;6506;21580;7391;25845;13897;47425
150555;202001;1918;5104;1483;4430;137;337;1014;3167;1151;3504
150560;202001;1851;5673;1634;5238;267;831;967;3221;1234;4052
150563;202001;2466;7562;2088;6898;452;1565;1124;3738;1576;5303
150565;202001;4365;14004;3859;13203;115;513;3147;10865;3262;11378
150570;202001;6298;20180;5880;19583;263;1020;5095;16919;5358;17939
150580;202001;10600;41698;9191;40110;642;3244;7427;33531;8069;36775
150590;202001;8108;27981;6971;26607;191;1111;6279;23882;6470;24993
150600;202001;9748;32280;9045;31417;226;877;8316;29103;8542;29980
150610;202001;2904;8616;2591;8102;100;394;2154;6680;2254;7074
150611;202001;3230;9110;2856;8581;91;352;2506;7463;2597;7815
150613;202001;13850;38193;10426;32263;1915;6313;5061;15653;6976;21966
150616;202001;3418;9399;2474;7822;607;2001;1017;3194;1624;5195
150618;202001;6952;20203;5606;18094;533;1654;3568;12168;4101;13822
150619;202001;6395;18065;5301;16497;172;630;4434;13876;4606;14506
150620;202001;6735;22257;5803;20692;677;2320;3988;14660;4665;16980
150630;202001;6273;16987;5705;16275;445;1186;4693;13573;5138;14759
150635;202001;4775;13194;3997;11944;557;1589;2550;7873;3107;9462
150640;202001;2260;6617;2057;6372;36;109;1906;5993;1942;6102
150650;202001;11786;32842;10297;30405;3084;8597;4472;14448;7556;23045
150655;202001;5922;16835;5329;15962;212;653;4578;13699;4790;14352
150658;202001;4474;12669;3543;11267;547;1848;2104;7077;2651;8925
150660;202001;5811;16619;5161;15693;464;1331;3599;11235;4063;12566
150670;202001;8509;19740;6636;17619;664;1462;5162;14448;5826;15910
150680;202001;69284;203172;53112;177459;12674;41794;23692;89173;36366;130967
150690;202001;3017;7901;2602;7409;109;239;2295;6710;2404;6949
150700;202001;6230;18438;5561;17573;358;965;4400;14298;4758;15263
150710;202001;3837;12753;3475;12164;267;930;2636;9426;2903;10356
150715;202001;5072;14606;4151;13182;319;984;3232;10416;3551;11400
150720;202001;6943;24754;6428;23932;450;1828;5297;19893;5747;21721
150730;202001;12172;37043;10570;34748;1230;4205;7787;26316;9017;30521
150740;202001;4002;11220;3527;10478;309;782;2648;8019;2957;8801
150745;202001;5190;14696;4162;13160;820;2761;2641;8441;3461;11202
150746;202001;1647;5054;1501;4837;84;275;1222;3949;1306;4224
150747;202001;4887;15629;4302;14659;716;2197;2860;10216;3576;12413
150750;202001;3715;11619;3118;10704;226;836;2344;8289;2570;9125
150760;202001;12182;35714;11038;34166;1561;4448;7728;24664;9289;29112
150770;202001;6388;22965;6023;22542;198;632;5466;21100;5664;21732
150775;202001;921;2616;717;2325;130;467;379;1243;509;1710
150780;202001;4612;13771;4090;13154;149;437;3662;12070;3811;12507
150790;202001;5710;16261;4937;15426;225;543;3970;13713;4195;14256
150795;202001;13967;43537;12276;40873;3082;9723;6914;24561;9996;34284
150796;202001;3827;9393;3315;8791;180;449;2814;7559;2994;8008
150797;202001;4056;12597;3485;11761;140;383;2945;10106;3085;10489
150800;202001;13508;42281;12222;40598;1481;4635;9230;31663;10711;36298
150803;202001;7141;22980;6688;22277;366;1198;5651;18995;6017;20193
150805;202001;3537;10862;2978;10042;230;779;2281;7837;2511;8616
150808;202001;6138;17453;4505;14733;1725;6229;606;2243;2331;8472
150810;202001;21135;55566;15949;49260;3379;10787;7947;26990;11326;37777
150812;202001;5478;15464;4790;14313;435;1356;3480;10215;3915;11571
150815;202001;9572;28309;8016;26422;636;2107;6532;21880;7168;23987
150820;202001;12188;33376;10251;30950;1119;2920;7765;24527;8884;27447
150830;202001;11763;43444;11012;42521;434;1962;9512;37602;9946;39564
150835;202001;2393;7947;2042;7315;368;1297;1142;4155;1510;5452
150840;202001;7646;21721;6027;19030;1010;3415;3256;10218;4266;13633
160005;202001;1178;3276;1053;3112;59;213;884;2616;943;2829
160010;202001;2460;6494;2304;6323;21;114;2234;6054;2255;6168
160015;202001;2724;8063;2444;7705;74;253;2234;7062;2308;7315
160020;202001;2078;6733;1824;6412;169;578;1428;5162;1597;5740
160021;202001;1087;4246;993;4127;66;377;804;3296;870;3673
160023;202001;1254;4470;1105;4219;109;381;776;3132;885;3513
160025;202001;1879;5638;1791;5536;13;44;1746;5416;1759;5460
160027;202001;9111;25221;8145;24000;622;1732;6545;19719;7167;21451
160030;202001;70616;201525;57048;183344;12181;36993;30752;108941;42933;145934
160040;202001;5710;19571;5166;18875;81;385;4793;17653;4874;18038
160050;202001;4887;15010;3842;13555;1453;4906;1328;5814;2781;10720
160053;202001;3735;11696;3409;11299;242;705;2820;9641;3062;10346
160055;202001;918;2672;884;2633;31;93;819;2442;850;2535
160060;202001;24569;66022;20021;60817;954;3099;15865;50431;16819;53530
160070;202001;2779;10508;2495;10062;209;833;1937;8089;2146;8922
160080;202001;3356;10739;3010;10346;36;190;2793;9678;2829;9868
170025;202001;623;1645;451;1387;79;247;228;724;307;971
170030;202001;1213;3695;923;3163;149;501;449;1576;598;2077
170035;202001;1479;3847;1068;3184;99;332;629;1890;728;2222
170040;202001;1885;5389;1474;4803;94;383;897;3042;991;3425
170070;202001;1822;4285;1284;3599;73;249;754;2178;827;2427
170100;202001;2463;7064;2026;6341;194;573;1276;4104;1470;4677
170105;202001;716;2103;483;1592;117;346;170;574;287;920
170110;202001;923;2840;697;2401;124;452;295;1013;419;1465
170130;202001;1337;3991;945;3232;175;653;447;1561;622;2214
170190;202001;1357;3890;935;3193;322;1150;165;736;487;1886
170200;202001;1898;4640;1171;3415;211;646;402;1184;613;1830
170210;202001;25295;68832;19102;58461;6603;22060;2143;7641;8746;29701
170215;202001;1326;3543;1072;3203;45;181;839;2503;884;2684
170220;202001;5929;18481;4946;16669;1319;4259;2033;7491;3352;11750
170230;202001;1245;3733;923;3093;267;915;173;635;440;1550
170240;202001;2657;7470;2024;6443;147;568;1390;4304;1537;4872
170255;202001;4025;11713;2832;9476;510;1743;1243;4291;1753;6034
170270;202001;980;2357;642;1881;31;88;384;1125;415;1213
170290;202001;2908;8618;2464;8050;112;373;1935;6515;2047;6888
170300;202001;1987;5401;1595;4821;188;569;1046;3224;1234;3793
170305;202001;657;1806;532;1590;62;218;264;782;326;1000
170307;202001;938;3236;744;2844;102;426;408;1572;510;1998
170310;202001;1593;4002;1087;3169;172;550;497;1449;669;1999
170320;202001;1043;2701;775;2269;68;211;488;1456;556;1667
170330;202001;920;2827;828;2681;43;192;681;2165;724;2357
170360;202001;488;1331;334;1066;27;90;213;638;240;728
170370;202001;1287;3473;919;2842;290;871;225;820;515;1691
170380;202001;1779;5150;1310;4410;111;431;733;2558;844;2989
170382;202001;545;1635;442;1452;35;152;315;996;350;1148
170384;202001;1597;5713;1291;5098;249;1041;648;2596;897;3637
170386;202001;885;2449;545;1777;75;294;188;582;263;876
170388;202001;609;1738;427;1409;63;241;184;612;247;853
170389;202001;1023;3204;849;2911;43;163;632;2221;675;2384
170390;202001;1711;3960;1258;3404;57;135;1013;2837;1070;2972
170410;202001;559;1660;395;1346;30;138;241;799;271;937
170460;202001;377;982;292;841;44;123;175;523;219;646
170510;202001;900;2653;644;2179;44;189;405;1320;449;1509
170550;202001;6737;18031;4876;14961;1226;4074;1102;3680;2328;7754
170555;202001;1357;3736;1048;3250;75;239;526;1687;601;1926
170560;202001;1045;2927;768;2532;66;250;475;1671;541;1921
170600;202001;1327;3564;1069;3181;220;520;602;1949;822;2469
170610;202001;1686;4514;1210;3787;76;259;750;2344;826;2603
170625;202001;419;1157;257;811;39;122;82;252;121;374
170650;202001;1271;3801;985;3319;147;511;531;1867;678;2378
170700;202001;3406;10029;2515;8322;507;1727;1095;3722;1602;5449
170710;202001;1555;4111;1170;3479;158;511;703;2100;861;2611
170720;202001;1773;4469;1383;3889;80;177;969;2852;1049;3029
170730;202001;1031;2838;758;2388;144;411;364;1231;508;1642
170740;202001;2090;6954;1779;6362;177;695;1254;4462;1431;5157
170755;202001;898;2513;610;1997;53;203;296;932;349;1135
170765;202001;1201;3088;820;2481;158;478;357;1142;515;1620
170770;202001;1826;5335;1479;4781;169;528;974;3247;1143;3775
170820;202001;3401;10255;2715;8977;504;1758;1298;4392;1802;6150
170825;202001;950;2297;756;2024;80;219;535;1432;615;1651
170830;202001;1400;3780;1151;3390;97;292;825;2446;922;2738
170900;202001;2697;8616;2255;7966;183;669;1758;6310;1941;6979
170930;202001;3710;10318;2822;8643;654;2110;943;2882;1597;4992
170950;202001;11321;31429;7707;24772;2155;7871;909;3166;3064;11037
170980;202001;444;1200;354;1056;15;68;253;715;268;783
171050;202001;1609;5120;1391;4735;51;260;1146;3863;1197;4123
171070;202001;1372;3949;1156;3628;304;970;487;1780;791;2750
171090;202001;1043;2608;829;2294;78;216;557;1532;635;1748
171110;202001;567;1530;397;1215;58;192;186;509;244;701
171150;202001;1103;2748;648;1951;72;247;380;1129;452;1376
171180;202001;775;2150;509;1631;79;232;209;674;288;906
171190;202001;1763;5959;1509;5508;251;997;872;3297;1123;4294
171195;202001;817;2634;652;2325;93;388;391;1368;484;1756
171200;202001;536;1515;402;1275;75;248;180;570;255;818
171215;202001;364;1025;289;895;42;142;189;568;231;710
171240;202001;759;2530;619;2249;36;177;410;1466;446;1643
171245;202001;655;1989;500;1657;49;190;300;948;349;1138
171250;202001;1044;2739;753;2304;142;468;348;1083;490;1551
171270;202001;449;1629;344;1398;72;313;136;589;208;902
171280;202001;860;2629;666;2272;66;219;377;1347;443;1566
171320;202001;4053;11454;3123;9804;644;2033;1177;3878;1821;5911
171330;202001;2729;7475;2082;6358;399;1177;978;3107;1377;4284
171360;202001;1429;4140;1124;3688;87;322;801;2681;888;3003
171370;202001;672;1720;514;1492;53;145;339;998;392;1143
171380;202001;1466;4154;1207;3773;107;319;852;2745;959;3064
171395;202001;953;2667;658;2101;62;234;384;1194;446;1428
171420;202001;1908;5697;1375;4618;229;853;619;2083;848;2936
171430;202001;1043;3106;854;2743;59;212;572;1773;631;1985
171488;202001;2329;6949;1813;6074;283;963;926;3210;1209;4173
171500;202001;1000;2489;751;2105;36;103;565;1586;601;1689
171510;202001;789;2621;680;2407;43;193;470;1650;513;1843
171515;202001;468;1221;324;984;28;98;192;554;220;652
171525;202001;683;1997;532;1748;30;129;307;960;337;1089
171550;202001;335;979;240;814;29;117;140;455;169;572
171570;202001;1118;3420;923;3064;128;432;537;1830;665;2262
171575;202001;1824;4862;1154;3637;130;440;500;1573;630;2013
171610;202001;5872;16467;4376;13866;916;3275;1197;4053;2113;7328
171620;202001;2672;7548;2222;6896;122;473;1761;5463;1883;5936
171630;202001;981;2621;773;2328;109;333;508;1572;617;1905
171650;202001;2101;6055;1599;5170;396;1391;472;1649;868;3040
171660;202001;2355;5998;1599;4731;240;671;810;2448;1050;3119
171665;202001;1310;3649;998;3139;162;589;463;1478;625;2067
171670;202001;1908;5113;1446;4341;204;680;787;2365;991;3045
171700;202001;1215;3497;882;2888;106;335;480;1606;586;1941
171720;202001;804;2066;619;1775;51;177;439;1231;490;1408
171750;202001;1286;3642;876;2892;222;764;107;449;329;1213
171780;202001;1248;3164;885;2631;91;298;583;1702;674;2000
171790;202001;1410;4687;1139;4109;222;832;512;1906;734;2738
171800;202001;740;2041;544;1744;69;275;298;946;367;1221
171820;202001;11227;31634;8246;26431;2019;6740;2545;8760;4564;15500
171830;202001;1500;4915;1249;4457;106;488;797;2808;903;3296
171840;202001;755;2012;585;1734;27;85;389;1153;416;1238
171845;202001;600;1532;432;1283;52;185;252;741;304;926
171850;202001;856;2921;726;2620;67;332;508;1764;575;2096
171855;202001;1039;3177;870;2870;72;247;531;1721;603;1968
171865;202001;386;1215;304;1067;54;210;145;480;199;690
171870;202001;807;2279;565;1827;65;228;289;942;354;1170
171875;202001;1288;3794;1013;3339;44;193;757;2484;801;2677
171880;202001;1168;3611;1021;3414;39;140;807;2751;846;2891
171884;202001;829;2348;606;1972;113;422;221;761;334;1183
171886;202001;1426;3967;1006;3246;288;1044;195;639;483;1683
171888;202001;721;2043;497;1616;31;120;314;998;345;1118
171889;202001;398;1221;320;1074;72;268;123;413;195;681
171890;202001;1178;3284;857;2767;182;563;463;1530;645;2093
171900;202001;533;1856;378;1460;78;294;150;604;228;898
172000;202001;564;1699;467;1511;46;160;264;831;310;991
172010;202001;1051;3664;882;3302;77;328;521;1903;598;2231
172015;202001;374;1317;278;1122;69;282;109;458;178;740
172020;202001;2590;7515;2283;7103;162;581;1697;5422;1859;6003
172025;202001;729;2021;526;1687;39;145;360;1151;399;1296
172030;202001;1235;3652;1047;3361;50;197;804;2579;854;2776
172049;202001;1301;3166;866;2551;172;480;465;1478;637;1958
172065;202001;1474;3632;1130;3214;104;220;892;2722;996;2942
172080;202001;2327;6891;1866;6077;105;397;1222;3957;1327;4354
172085;202001;460;1261;299;912;52;149;107;312;159;461
172090;202001;4036;10217;3067;8938;128;413;2308;6771;2436;7184
172093;202001;478;1416;339;1175;25;117;188;621;213;738
172097;202001;646;1707;455;1379;55;170;213;659;268;829
172100;202001;49707;123503;34048;98181;6192;19855;11469;34020;17661;53875
172110;202001;1614;5859;1379;5485;139;567;994;4172;1133;4739
172120;202001;5024;14847;3910;13041;519;1818;2170;7483;2689;9301
172125;202001;311;856;235;733;21;62;121;374;142;436
172130;202001;649;1603;516;1389;25;89;359;894;384;983
172208;202001;2527;6261;2019;5604;185;460;1434;4074;1619;4534
172210;202001;2719;6978;2058;6128;357;1144;1129;3490;1486;4634
210005;202001;19221;55432;14711;47917;4274;14513;5485;18775;9759;33288
210010;202001;1957;6024;1758;5767;75;326;1509;4968;1584;5294
210015;202001;3354;10020;2972;9522;105;306;2593;8406;2698;8712
210020;202001;7461;17449;6385;16211;80;233;5906;15052;5986;15285
210030;202001;4869;16012;4495;15453;212;937;3846;13202;4058;14139
210040;202001;1828;4381;1649;4162;26;44;1541;3931;1567;3975
210043;202001;6356;18047;5302;16625;472;1416;3952;12740;4424;14156
210047;202001;6777;20968;5461;19199;141;715;4694;16488;4835;17203
210050;202001;2262;7670;1759;6733;172;754;1210;4619;1382;5373
210055;202001;1880;6054;1696;5770;67;274;1415;4830;1482;5104
210060;202001;7288;26812;6457;25293;741;3043;4505;18176;5246;21219
210070;202001;7216;20487;6759;19911;41;165;6380;18813;6421;18978
210080;202001;4288;14601;4072;14364;46;273;3701;13144;3747;13417
210083;202001;5700;16264;4645;15150;44;228;4385;14334;4429;14562
210087;202001;3070;8357;2655;7817;109;261;2286;6900;2395;7161
210090;202001;9441;29541;8745;28309;525;1435;7362;24101;7887;25536
210095;202001;6347;20626;5855;20037;211;931;4991;17491;5202;18422
210100;202001;6870;20921;6137;19767;321;1113;4972;16103;5293;17216
210110;202001;3023;10070;2785;9781;56;346;2542;8867;2598;9213
210120;202001;23240;64378;19259;59137;2001;5190;12926;42233;14927;47423
210125;202001;4430;11873;3866;11200;772;1756;2746;8563;3518;10319
210130;202001;4466;11714;3672;10718;167;373;3101;9171;3268;9544
210135;202001;1470;4443;1262;4106;64;198;1014;3350;1078;3548
210140;202001;18638;49537;14204;43772;2676;8001;7917;25797;10593;33798
210150;202001;4423;10662;3897;9943;132;360;3372;8501;3504;8861
210160;202001;16767;49262;14504;46360;1323;4468;10191;33760;11514;38228
210170;202001;15227;47510;14162;46145;754;2296;12378;40617;13132;42913
210173;202001;2288;8704;2131;8427;64;400;1862;7408;1926;7808
210177;202001;3497;9509;3046;8969;113;198;2718;8302;2831;8500
210180;202001;1444;3925;1276;3716;24;77;1155;3358;1179;3435
210190;202001;5312;14654;4557;13607;78;381;3879;11402;3957;11783
210193;202001;1307;3818;1156;3586;35;149;903;2849;938;2998
210197;202001;2075;6554;1903;6314;144;500;1547;5207;1691;5707
210200;202001;7731;24862;6855;23409;433;1633;5473;18683;5906;20316
210203;202001;7054;20909;6039;19552;416;1403;4900;16159;5316;17562
210207;202001;3834;9606;3000;8698;145;334;2485;7406;2630;7740
210210;202001;8253;26601;7539;25629;131;794;6789;22974;6920;23768
210215;202001;2406;7696;2062;7183;51;273;1824;6372;1875;6645
210220;202001;6207;21366;5864;20839;188;1208;5126;17810;5314;19018
210230;202001;5271;15959;4730;15166;399;1036;3930;12921;4329;13957
210232;202001;11596;36332;9498;33157;1597;5638;5822;21766;7419;27404
210235;202001;3435;10220;2974;9599;70;311;2627;8498;2697;8809
210237;202001;2745;9105;2366;8660;33;201;2182;7993;2215;8194
210240;202001;2620;8312;2407;7940;86;348;2060;6716;2146;7064
210250;202001;5659;17269;5139;16626;76;441;4605;14871;4681;15312
210255;202001;2524;7784;2123;7040;293;991;1329;4382;1622;5373
210260;202001;5548;16576;4873;15591;221;821;4184;13370;4405;14191
210270;202001;4830;13438;4304;12781;107;490;3817;11254;3924;11744
210275;202001;3600;9050;3169;8535;57;124;2878;7856;2935;7980
210280;202001;5587;16032;4458;14264;267;1100;3192;10048;3459;11148
210290;202001;7315;19730;6533;18747;129;398;5989;17197;6118;17595
210300;202001;33779;91361;27503;82474;1873;5888;19852;61549;21725;67437
210310;202001;3098;7955;2719;7402;126;286;2353;6455;2479;6741
210312;202001;2719;7000;2381;6623;41;176;2197;6043;2238;6219
210315;202001;2974;8362;2521;7848;61;162;2297;7301;2358;7463
210317;202001;4147;13173;3745;12706;113;607;3345;11261;3458;11868
210320;202001;19139;58205;17419;55940;440;2153;15344;48972;15784;51125
210325;202001;3585;10264;3098;9645;84;257;2745;8723;2829;8980
210330;202001;25047;70846;20344;64650;6218;17870;9412;34833;15630;52703
210340;202001;10201;30068;9042;28476;726;2271;6890;22313;7616;24584
210350;202001;9434;27151;8202;25632;162;563;7243;22799;7405;23362
210355;202001;4322;14544;3781;13700;104;502;3208;11733;3312;12235
210360;202001;13565;42647;12091;40466;609;2787;9262;30518;9871;33305
210370;202001;10937;24582;8446;21948;248;440;7687;20477;7935;20917
210375;202001;3363;8871;2514;7734;664;2070;1130;3865;1794;5935
210380;202001;5608;14388;4825;13472;234;569;4088;11527;4322;12096
210390;202001;2596;9201;2391;8846;121;595;1995;7345;2116;7940
210400;202001;4552;13944;4006;13265;139;450;3553;11951;3692;12401
210405;202001;7107;19158;5707;17140;1097;3053;3131;10082;4228;13135
210407;202001;1973;6572;1646;5972;86;387;1310;4697;1396;5084
210408;202001;2533;9497;2364;9240;146;716;1914;7500;2060;8216
210409;202001;3816;13201;3478;12731;108;625;2860;10518;2968;11143
210410;202001;3457;10583;2920;9718;152;604;2194;7247;2346;7851
210420;202001;3915;12447;3518;11777;205;609;2939;9963;3144;10572
210430;202001;2280;6677;2036;6371;79;225;1788;5657;1867;5882
210440;202001;4407;11928;3863;11231;71;263;3539;10232;3610;10495
210450;202001;2455;7248;2101;6719;89;307;1726;5501;1815;5808
210455;202001;4331;11416;3259;10062;958;2995;1513;4913;2471;7908
210460;202001;3732;10675;3159;9940;78;336;2771;8659;2849;8995
210462;202001;1639;5014;1397;4618;40;166;1123;3734;1163;3900
210465;202001;2655;7789;2314;7322;56;230;2002;6328;2058;6558
210467;202001;5858;18930;5155;18016;307;1239;4261;15054;4568;16293
210470;202001;2104;5470;1446;4534;83;192;1099;3595;1182;3787
210480;202001;16538;48447;13690;44938;1211;3598;9936;35225;11147;38823
210490;202001;3746;9463;3009;8434;62;184;2606;7336;2668;7520
210500;202001;6300;24409;5802;23538;368;1816;4733;19105;5101;20921
210510;202001;6040;19979;5295;19167;125;556;4704;17335;4829;17891
210515;202001;3747;10988;3270;10454;109;390;2841;9208;2950;9598
210520;202001;2621;7446;2333;7085;78;263;2039;6166;2117;6429
210530;202001;54115;131502;41961;113549;6759;22852;11303;39009;18062;61861
210535;202001;3113;10583;2889;10238;121;466;2420;8677;2541;9143
210540;202001;14823;42833;12327;39352;1431;4280;8595;28723;10026;33003
210542;202001;6578;15312;5287;13901;324;542;4369;12268;4693;12810
210545;202001;2228;6959;2100;6751;45;200;1841;5838;1886;6038
210547;202001;3554;12864;3116;11987;316;1193;2251;8921;2567;10114
210550;202001;6311;18952;4976;16867;339;1343;3635;12595;3974;13938
210560;202001;3567;10908;3179;10283;122;396;2649;8527;2771;8923
210565;202001;1476;4886;1223;4504;63;332;963;3569;1026;3901
210570;202001;10764;29252;9501;27727;299;852;8388;24907;8687;25759
210580;202001;3013;8059;2486;7413;148;295;1984;6215;2132;6510
210590;202001;4370;13031;3771;12255;72;393;3320;10759;3392;11152
210592;202001;2626;7796;2427;7472;26;128;2157;6581;2183;6709
210594;202001;2519;6815;1928;5898;85;236;1419;4501;1504;4737
210596;202001;2529;9031;2261;8486;113;488;1814;6857;1927;7345
210598;202001;1849;5419;1694;5187;36;155;1520;4607;1556;4762
210600;202001;3131;8293;2492;7387;91;210;2002;6065;2093;6275
210610;202001;2673;7594;2301;7142;59;290;1961;6049;2020;6339
210620;202001;2725;7408;2260;6850;52;151;2061;6364;2113;6515
210630;202001;3076;10343;2795;9890;118;603;2302;8028;2420;8631
210632;202001;4454;14427;3944;13685;226;1014;3104;10654;3330;11668
210635;202001;1773;6284;1665;6093;121;422;1351;5069;1472;5491
210637;202001;2419;8031;2110;7584;153;669;1575;5731;1728;6400
210640;202001;4626;16555;4350;16207;90;489;3852;14300;3942;14789
210650;202001;7471;21304;6781;20430;57;268;6275;18963;6332;19231
210660;202001;8266;24445;7280;22881;259;1025;6274;19500;6533;20525
210663;202001;2586;7604;2382;7365;132;332;2036;6474;2168;6806
210667;202001;1909;6274;1762;6063;40;161;1590;5536;1630;5697
210670;202001;4473;15263;4086;14663;127;632;3528;12594;3655;13226
210675;202001;5102;13838;4354;12861;209;498;3637;11006;3846;11504
210680;202001;4395;10981;3693;10126;123;217;3293;9244;3416;9461
210690;202001;7778;23855;6588;22526;252;1130;5770;19838;6022;20968
210700;202001;2688;7442;2156;6724;143;419;1617;5266;1760;5685
210710;202001;4989;15643;4361;14753;114;622;3798;12719;3912;13341
210720;202001;2925;9645;2644;9300;55;338;2370;8281;2425;8619
210725;202001;1336;4503;1147;4208;43;185;819;3132;862;3317
210730;202001;1198;3177;1000;2901;52;137;827;2408;879;2545
210735;202001;4678;13797;3958;12827;191;606;3375;11187;3566;11793
210740;202001;5232;14104;4542;13337;111;380;3796;11137;3907;11517
210745;202001;4448;12131;4104;11682;120;356;3722;10592;3842;10948
210750;202001;23255;59302;20159;55444;1620;4205;14100;40921;15720;45126
210760;202001;6022;15860;5085;14874;30;68;4815;14227;4845;14295
210770;202001;6208;15983;5322;14968;53;226;4986;13960;5039;14186
210780;202001;7337;23368;6426;21848;553;1714;5005;17375;5558;19089
210790;202001;4415;13794;3969;13217;215;575;3163;11185;3378;11760
210800;202001;4958;13126;4217;12148;60;243;3804;10843;3864;11086
210805;202001;3976;14536;3790;14265;112;635;3365;12571;3477;13206
210810;202001;4968;14412;4518;13832;289;625;3771;11958;4060;12583
210820;202001;7011;19936;5829;18032;674;2177;3486;11131;4160;13308
210825;202001;6783;21022;6134;20171;250;848;5290;17642;5540;18490
210830;202001;7848;22086;7165;21253;411;925;6108;18668;6519;19593
210840;202001;3247;8621;2898;8157;59;212;2556;7081;2615;7293
210845;202001;6572;17776;5898;17043;19;72;5692;16514;5711;16586
210850;202001;5976;20366;4989;18882;250;1246;3898;14805;4148;16051
210860;202001;21115;54661;17598;50228;761;1928;14094;42386;14855;44314
210870;202001;7307;19134;5807;17423;211;594;5043;15256;5254;15850
210880;202001;4332;13308;3904;12809;191;729;3217;10584;3408;11313
210890;202001;3956;11680;3554;11214;230;609;2891;9449;3121;10058
210900;202001;4540;13322;3460;11304;1359;4766;550;2015;1909;6781
210905;202001;2003;5539;1665;5104;50;90;1506;4742;1556;4832
210910;202001;7350;22147;6108;20141;851;2849;3918;13089;4769;15938
210920;202001;3269;10741;2833;10158;73;429;2521;8960;2594;9389
210923;202001;1476;4511;1278;4180;66;229;953;3146;1019;3375
210927;202001;5306;16688;4652;15927;206;746;3895;13605;4101;14351
210930;202001;2503;8653;2188;8039;180;735;1615;5924;1795;6659
210940;202001;4079;11535;3782;11181;117;466;3446;10074;3563;10540
210945;202001;6335;18446;5691;17683;235;703;4799;15255;5034;15958
210950;202001;5223;14676;4017;12985;607;1580;2626;9229;3233;10809
210955;202001;1562;4981;1348;4606;134;472;945;3294;1079;3766
210960;202001;9110;27194;7809;25235;1289;3880;4941;16775;6230;20655
210970;202001;1333;4095;1059;3637;60;239;812;2718;872;2957
210975;202001;1697;5397;1512;5102;71;259;1204;4076;1275;4335
210980;202001;10292;23552;8976;22192;93;208;8468;21030;8561;21238
210990;202001;15993;45535;12613;41056;723;2621;9433;31382;10156;34003
211000;202001;14690;42988;12293;40093;668;2399;9825;33260;10493;35659
211003;202001;5648;16921;4728;15812;135;536;4068;13916;4203;14452
211010;202001;6525;23489;5864;22682;94;493;5286;20794;5380;21287
211020;202001;8227;24051;7189;22847;221;918;6088;19763;6309;20681
211023;202001;1997;6536;1869;6368;88;346;1579;5352;1667;5698
211027;202001;3090;9870;2933;9618;197;552;2513;8314;2710;8866
211030;202001;3966;10947;3536;10426;244;552;2865;8719;3109;9271
211040;202001;4569;16582;4233;15987;120;729;3758;14070;3878;14799
211050;202001;9293;24026;8398;22876;107;343;7714;21007;7821;21350
211060;202001;7013;21244;6398;20418;130;530;5872;18739;6002;19269
211065;202001;2194;6123;1812;5641;81;230;1486;4777;1567;5007
211070;202001;7711;24637;6547;22852;517;1828;5066;17923;5583;19751
211080;202001;1280;3583;1019;3171;37;200;777;2279;814;2479
211085;202001;2037;5815;1733;5399;80;187;1500;4826;1580;5013
211090;202001;3184;8805;2861;8417;41;185;2621;7669;2662;7854
211100;202001;6790;17244;6266;16608;50;159;5746;15317;5796;15476
211102;202001;3048;10535;2795;10166;129;609;2423;8725;2552;9334
211105;202001;2368;7544;1963;6800;170;612;1403;4825;1573;5437
211107;202001;4616;14651;3926;13646;136;621;3200;11397;3336;12018
211110;202001;5971;16454;4596;14335;385;1133;3333;10624;3718;11757
211120;202001;44659;110195;37339;101737;5019;12661;23770;69327;28789;81988
211125;202001;2101;6201;1758;5684;38;158;1476;4789;1514;4947
211130;202001;197704;470221;173348;438732;24918;62072;76850;222330;101768;284402
211140;202001;5003;14851;4367;14014;218;635;3663;11869;3881;12504
211150;202001;9400;25696;7933;23784;349;1000;6639;20033;6988;21033
211153;202001;2531;7375;2030;6774;277;987;1323;4649;1600;5636
211157;202001;1089;3479;905;3148;35;186;660;2261;695;2447
211160;202001;4085;11699;3216;10418;158;596;2378;7598;2536;8194
211163;202001;1679;5308;1538;5106;24;124;1378;4630;1402;4754
211167;202001;1540;4926;1440;4765;31;142;1323;4346;1354;4488
211170;202001;6498;15962;6050;15455;53;176;5743;14611;5796;14787
211172;202001;2461;6753;2131;6272;106;319;1719;4939;1825;5258
211174;202001;2872;8334;2603;8030;46;236;2400;7370;2446;7606
211176;202001;4278;12247;3298;10799;156;665;2609;8504;2765;9169
211178;202001;4686;10927;3998;10182;35;159;3781;9548;3816;9707
211180;202001;4047;13331;3729;12867;216;801;3143;10902;3359;11703
211190;202001;3055;9074;2591;8383;34;203;2256;7225;2290;7428
211195;202001;1357;3886;1153;3579;47;115;978;3099;1025;3214
211200;202001;2126;6084;1688;5504;214;672;1165;3897;1379;4569
211210;202001;6389;19504;5778;18692;260;1060;4956;15914;5216;16974
211220;202001;37473;94451;30513;85854;2918;7777;22324;64626;25242;72403
211223;202001;5177;13703;4320;12559;387;1124;3217;9411;3604;10535
211227;202001;1765;5868;1592;5622;35;167;1409;5055;1444;5222
211230;202001;7481;21894;6530;20443;398;1097;5219;16677;5617;17774
211240;202001;8187;26068;7733;25489;150;809;7126;23228;7276;24037
211245;202001;6967;17646;6248;16902;88;225;6022;16321;6110;16546
211250;202001;13294;41381;11958;39625;623;2535;9847;32333;10470;34868
211260;202001;7971;25935;7151;24844;199;898;6392;22350;6591;23248
211270;202001;10570;33693;9074;31637;393;1806;7347;25776;7740;27582
211280;202001;12861;35594;11404;33776;943;2255;9047;28046;9990;30301
211285;202001;1763;5876;1540;5550;156;621;1040;3859;1196;4480
211290;202001;7506;22593;6769;21618;179;775;5813;18482;5992;19257
211300;202001;7978;22654;7075;21367;170;585;6211;18642;6381;19227
211400;202001;11544;32955;9377;29948;1039;3310;6305;21178;7344;24488
220005;202001;1842;4885;1660;4626;39;155;1389;3793;1428;3948
220010;202001;1486;4252;1218;3771;31;123;935;2864;966;2987
220020;202001;3526;9976;3048;9264;159;572;2450;7368;2609;7940
220025;202001;2260;5148;1923;4643;25;68;1595;3734;1620;3802
220027;202001;1262;3219;1085;2988;17;57;915;2471;932;2528
220030;202001;3330;8448;3114;8156;80;245;2738;7067;2818;7312
220040;202001;7205;21877;6286;20078;1443;4254;3321;11139;4764;15393
220045;202001;1488;4567;1219;4108;33;177;976;3222;1009;3399
220050;202001;4764;12998;4028;12009;72;356;3658;10736;3730;11092
220060;202001;2416;5084;2031;4647;27;69;1905;4338;1932;4407
220070;202001;2522;6350;2150;5819;75;157;1770;4814;1845;4971
220080;202001;727;2046;616;1882;27;113;527;1579;554;1692
220090;202001;1801;4344;1480;3894;21;70;1220;3322;1241;3392
220095;202001;639;1633;605;1597;25;40;546;1452;571;1492
220100;202001;1369;3778;1092;3326;51;179;868;2576;919;2755
220105;202001;1999;6236;1749;5740;126;456;1316;4310;1442;4766
220110;202001;3432;9483;3187;9039;41;207;2839;7937;2880;8144
220115;202001;2713;7909;2501;7615;72;263;2253;6800;2325;7063
220117;202001;1358;3291;1042;2848;14;61;867;2319;881;2380
220120;202001;12831;34578;11718;33197;87;312;10935;30982;11022;31294
220130;202001;1097;2979;928;2750;16;85;826;2418;842;2503
220140;202001;2069;4359;1751;3981;115;301;1511;3363;1626;3664
220150;202001;6417;19142;5893;18263;135;660;4938;14973;5073;15633
220155;202001;1134;3291;903;2865;30;109;638;1991;668;2100
220157;202001;1059;2596;894;2346;21;85;721;1824;742;1909
220160;202001;2796;7849;2404;7147;34;168;1990;5807;2024;5975
220170;202001;1563;4119;1317;3760;13;68;1173;3308;1186;3376
220173;202001;2100;5875;1678;5126;39;178;1334;3982;1373;4160
220177;202001;2001;5686;1892;5562;11;39;1861;5477;1872;5516
220180;202001;1121;2783;915;2433;3;15;695;1733;698;1748
220190;202001;6831;17321;5740;15815;365;1111;4256;11860;4621;12971
220191;202001;1472;4541;1328;4295;69;263;975;3055;1044;3318
220192;202001;1901;5096;1452;4299;29;108;1184;3447;1213;3555
220194;202001;1682;4856;1496;4547;54;206;1220;3647;1274;3853
220196;202001;1994;5212;1797;4909;27;120;1526;4090;1553;4210
220198;202001;1291;3561;1079;3290;7;30;988;3048;995;3078
220200;202001;5164;14828;4449;13897;129;507;3744;11693;3873;12200
220202;202001;2175;6106;1863;5598;32;166;1586;4687;1618;4853
220205;202001;2528;7209;2241;6709;48;200;1882;5539;1930;5739
220207;202001;791;2354;641;2096;65;217;400;1317;465;1534
220208;202001;1669;5173;1358;4557;158;584;805;2632;963;3216
220209;202001;1594;4527;1380;4164;25;118;1115;3320;1140;3438
220210;202001;1676;4177;1430;3798;12;57;1216;3163;1228;3220
220211;202001;1571;4074;1445;3898;19;73;1254;3407;1273;3480
220213;202001;1762;4719;1521;4287;31;113;1219;3343;1250;3456
220217;202001;2096;6389;1972;6252;36;107;1843;5915;1879;6022
220220;202001;10445;27334;8610;24481;544;1380;5873;17445;6417;18825
220225;202001;1049;2733;842;2470;8;44;774;2239;782;2283
220230;202001;5786;14287;4924;13097;164;407;4225;11270;4389;11677
220240;202001;2925;8573;2666;8118;112;369;2137;6531;2249;6900
220245;202001;1678;4047;1294;3562;10;53;1173;3254;1183;3307
220250;202001;3032;8433;2653;7948;20;107;2460;7333;2480;7440
220253;202001;1623;4423;1405;4054;65;231;1168;3259;1233;3490
220255;202001;1868;4523;1571;4092;37;170;1313;3284;1350;3454
220260;202001;4215;13074;3720;12177;163;626;2961;9683;3124;10309
220265;202001;1290;4167;1164;3991;37;183;941;3149;978;3332
220270;202001;6317;19908;5924;19198;222;1046;4904;15365;5126;16411
220271;202001;1487;3793;1279;3508;30;115;1121;3064;1151;3179
220272;202001;1765;5086;1569;4728;65;204;1165;3414;1230;3618
220273;202001;1226;3503;1020;3127;43;168;771;2316;814;2484
220275;202001;2292;5484;1780;4789;30;99;1542;4168;1572;4267
220277;202001;2143;5421;1839;4965;25;78;1549;4101;1574;4179
220280;202001;1620;3832;1336;3448;30;110;1138;2890;1168;3000
220285;202001;1459;3682;1224;3406;13;58;1108;3057;1121;3115
220290;202001;6329;18128;4955;16179;352;1290;3600;11981;3952;13271
220300;202001;1979;5728;1595;5215;39;240;1314;4247;1353;4487
220310;202001;3090;8267;2372;7429;42;207;1980;6160;2022;6367
220320;202001;3032;8961;2321;7596;98;443;1775;5632;1873;6075
220323;202001;1623;4786;1277;4217;58;237;1046;3395;1104;3632
220325;202001;1275;3748;1077;3415;25;121;883;2751;908;2872
220327;202001;1504;4289;1311;3972;49;207;1077;3176;1126;3383
220330;202001;4366;10538;3617;9622;60;187;3242;8558;3302;8745
220335;202001;1712;5123;1524;4889;31;104;1360;4372;1391;4476
220340;202001;1856;4877;1422;4148;61;206;971;2738;1032;2944
220342;202001;1139;3356;1006;3155;44;205;790;2435;834;2640
220345;202001;3145;7057;2421;6020;13;45;2189;5416;2202;5461
220350;202001;3366;8619;2673;7575;140;422;1883;5326;2023;5748
220360;202001;1236;3170;970;2733;16;56;774;2158;790;2214
220370;202001;8765;25260;7941;23962;177;771;6900;20535;7077;21306
220375;202001;1613;4571;1425;4344;5;18;1345;4127;1350;4145
220380;202001;1509;3582;1213;3154;14;43;1050;2694;1064;2737
220385;202001;846;2013;671;1697;8;25;583;1457;591;1482
220390;202001;9967;26130;7623;22445;1947;5631;2861;9300;4808;14931
220400;202001;1497;3557;1138;3018;24;69;874;2261;898;2330
220410;202001;1176;3225;934;2811;47;145;753;2223;800;2368
220415;202001;812;2081;677;1863;19;56;541;1468;560;1524
220420;202001;1989;5477;1594;4733;50;141;1233;3622;1283;3763
220430;202001;2506;6766;2357;6545;81;262;1998;5482;2079;5744
220435;202001;1757;4511;1506;4152;41;134;1222;3305;1263;3439
220440;202001;2417;7578;2073;7028;112;464;1703;5675;1815;6139
220450;202001;2499;6482;2017;5878;72;252;1689;4931;1761;5183
220455;202001;1319;4045;1249;3949;16;81;1102;3471;1118;3552
220460;202001;972;2379;899;2290;35;88;769;1937;804;2025
220465;202001;2358;7302;2069;6842;181;611;1515;5108;1696;5719
220470;202001;3489;9678;3102;9069;84;231;2494;7203;2578;7434
220480;202001;2658;6946;2135;6084;154;379;1448;4138;1602;4517
220490;202001;2466;6224;2135;5799;28;134;1866;4995;1894;5129
220500;202001;2676;6999;2402;6574;48;182;1965;5207;2013;5389
220510;202001;2555;7238;1992;6219;86;260;1556;4895;1642;5155
220515;202001;1649;3986;1498;3771;32;54;1307;3280;1339;3334
220520;202001;4942;12825;4438;12122;102;292;3848;10448;3950;10740
220525;202001;1333;3353;1140;3106;10;47;1042;2804;1052;2851
220527;202001;1341;3734;1142;3443;13;54;968;2980;981;3034
220530;202001;1445;3589;1235;3323;32;105;1128;3000;1160;3105
220535;202001;807;2257;752;2184;42;145;602;1724;644;1869
220540;202001;3258;10371;3055;9998;118;422;2578;8390;2696;8812
220545;202001;1390;4249;1283;4077;64;253;1056;3316;1120;3569
220550;202001;8657;26455;7664;24771;503;1754;5718;18330;6221;20084
220551;202001;1403;4015;1227;3716;27;116;995;2952;1022;3068
220552;202001;1604;4639;1299;4097;33;166;1027;3110;1060;3276
220553;202001;1721;4497;1419;4091;58;130;1126;3367;1184;3497
220554;202001;875;2328;635;1925;45;105;407;1229;452;1334
220555;202001;2252;6771;2025;6451;47;215;1652;5366;1699;5581
220556;202001;1220;3543;1044;3190;58;235;738;2158;796;2393
220557;202001;1616;4936;1360;4420;65;249;988;3127;1053;3376
220558;202001;1392;3613;1084;3185;20;81;928;2707;948;2788
220559;202001;1689;4302;1426;3891;7;24;1142;3149;1149;3173
220560;202001;1757;3957;1408;3507;36;69;1268;3183;1304;3252
220570;202001;7276;21692;6588;20712;464;1473;5169;16349;5633;17822
220580;202001;7009;19234;6402;18251;89;324;5768;16315;5857;16639
220585;202001;1995;6322;1685;5750;44;158;1374;4734;1418;4892
220590;202001;1325;3619;1081;3248;74;222;779;2336;853;2558
220595;202001;2518;6884;2279;6568;23;105;2022;5780;2045;5885
220600;202001;1399;3125;1165;2830;94;123;960;2416;1054;2539
220605;202001;1634;4742;1379;4288;21;125;1106;3338;1127;3463
220610;202001;2745;8103;2573;7863;32;148;2385;7267;2417;7415
220620;202001;7988;24586;7304;23668;194;1004;6578;21039;6772;22043
220630;202001;360;1074;274;911;25;85;175;590;200;675
220635;202001;1611;5132;1420;4716;54;261;1056;3409;1110;3670
220640;202001;2524;6937;2144;6386;80;313;1723;5064;1803;5377
220650;202001;2091;5739;1806;5306;35;135;1427;4184;1462;4319
220660;202001;2680;8320;2279;7640;92;466;1857;6062;1949;6528
220665;202001;1243;3759;1040;3419;36;197;846;2696;882;2893
220667;202001;1601;5008;1428;4682;60;246;1153;3753;1213;3999
220669;202001;1670;5070;1596;4956;59;274;1377;4175;1436;4449
220670;202001;2210;5785;1754;5138;20;89;1509;4410;1529;4499
220672;202001;3242;7948;2602;7188;116;375;2255;6170;2371;6545
220675;202001;1236;3388;1106;3149;36;112;912;2572;948;2684
220680;202001;2676;7326;2552;7144;98;243;2326;6538;2424;6781
220690;202001;1557;4137;1376;3860;72;212;1074;3017;1146;3229
220695;202001;874;2437;812;2324;22;70;701;2002;723;2072
220700;202001;9871;24406;7870;21607;357;1045;5988;16305;6345;17350
220710;202001;890;2468;664;2037;27;99;497;1487;524;1586
220720;202001;2140;5048;1923;4756;16;62;1659;4045;1675;4107
220730;202001;1304;3670;1096;3316;16;89;929;2744;945;2833
220735;202001;980;2270;746;1910;14;51;632;1565;646;1616
220740;202001;1399;3640;1102;3257;35;97;910;2741;945;2838
220750;202001;3876;9826;3370;9091;202;474;2897;7853;3099;8327
220755;202001;1270;3145;1039;2796;26;95;835;2181;861;2276
220760;202001;3102;8663;2692;8107;89;301;2367;7204;2456;7505
220770;202001;22191;66840;18653;60654;5787;19848;6508;21870;12295;41718
220775;202001;1136;2930;1030;2796;12;52;987;2660;999;2712
220777;202001;1640;4158;1244;3548;30;72;941;2689;971;2761
220779;202001;1322;3307;1137;3045;21;64;978;2606;999;2670
220780;202001;5552;14109;4844;13024;215;699;3933;10311;4148;11010
220785;202001;1482;3282;1298;3047;8;20;1248;2914;1256;2934
220790;202001;10098;28786;9042;27274;231;1095;7563;22479;7794;23574
220793;202001;922;2415;721;2061;13;34;595;1718;608;1752
220795;202001;1393;3600;1239;3396;17;62;1093;3013;1110;3075
220800;202001;17902;40171;15052;36333;644;1539;11505;27607;12149;29146
220810;202001;2986;8310;2508;7455;50;160;2063;6074;2113;6234
220820;202001;5177;13418;4431;12337;302;732;3292;9162;3594;9894
220830;202001;7321;19397;6543;18323;240;808;5405;14914;5645;15722
220840;202001;12301;37741;10236;33471;2361;7389;4685;16017;7046;23406
220850;202001;3135;9682;2786;9249;65;350;2452;8130;2517;8480
220855;202001;684;1746;588;1601;14;50;528;1429;542;1479
220860;202001;1015;2543;869;2310;20;76;764;2003;784;2079
220865;202001;2504;6597;1938;5626;97;343;1406;3960;1503;4303
220870;202001;2968;8324;2443;7635;39;197;2229;6935;2268;7132
220880;202001;5300;12526;4561;11614;81;301;4167;10485;4248;10786
220885;202001;1395;4272;1143;3847;56;229;911;3097;967;3326
220887;202001;1547;3359;1272;3008;11;32;1177;2757;1188;2789
220890;202001;1421;4362;1229;4053;50;175;1000;3350;1050;3525
220900;202001;2046;4870;1701;4420;30;73;1476;3810;1506;3883
220910;202001;1528;4192;1283;3836;48;155;1054;3151;1102;3306
220915;202001;963;2598;771;2242;6;23;576;1634;582;1657
220920;202001;1357;4432;1165;4179;69;320;938;3360;1007;3680
220930;202001;1677;4581;1424;4213;25;79;1305;3844;1330;3923
220935;202001;1069;3064;867;2646;25;98;580;1681;605;1779
220937;202001;1410;3757;1204;3437;25;88;958;2700;983;2788
220940;202001;1520;4289;1200;3704;39;144;905;2753;944;2897
220945;202001;439;1524;375;1378;22;129;270;953;292;1082
220950;202001;1430;3304;924;2508;17;59;723;1901;740;1960
220955;202001;1610;4162;1340;3687;35;106;1122;3039;1157;3145
220960;202001;815;2067;607;1721;11;43;451;1218;462;1261
220965;202001;1776;4869;1544;4527;21;130;1330;3803;1351;3933
220970;202001;1886;4564;1379;3795;38;98;1136;3095;1174;3193
220975;202001;700;2042;599;1920;16;92;520;1603;536;1695
220980;202001;1167;3276;1030;3086;38;139;860;2552;898;2691
220985;202001;1215;3208;1061;2980;44;142;846;2298;890;2440
220987;202001;1460;4339;1258;3971;52;217;1005;3131;1057;3348
220990;202001;1705;4697;1497;4389;18;104;1254;3617;1272;3721
220995;202001;1092;3321;875;2918;37;131;636;2114;673;2245
220997;202001;2422;7169;2225;6856;48;224;1987;6057;2035;6281
221000;202001;4445;12227;3936;11463;96;459;3321;9509;3417;9968
221005;202001;1498;3949;1363;3724;27;134;1170;3073;1197;3207
221010;202001;1210;2794;964;2492;23;63;832;2100;855;2163
221020;202001;1510;4598;1398;4391;21;86;1071;3316;1092;3402
221030;202001;1631;4073;1402;3787;26;81;1201;3287;1227;3368
221035;202001;1508;3948;1293;3658;20;32;1128;3288;1148;3320
221037;202001;649;1832;540;1638;8;27;377;1101;385;1128
221038;202001;530;1488;410;1261;15;53;279;853;294;906
221039;202001;865;2360;740;2147;19;84;604;1682;623;1766
221040;202001;4018;12056;3515;11150;148;534;2774;8794;2922;9328
221050;202001;3895;10276;3410;9656;67;255;3041;8568;3108;8823
221060;202001;8558;23620;7024;21223;248;721;5677;17270;5925;17991
221062;202001;1163;3775;986;3471;42;198;786;2722;828;2920
221063;202001;1056;2951;885;2699;65;229;662;1989;727;2218
221065;202001;2600;6739;2299;6193;23;91;1998;5294;2021;5385
221070;202001;3251;10209;2662;8977;289;966;1665;5721;1954;6687
221080;202001;3553;8691;2870;7687;59;230;2338;6150;2397;6380
221090;202001;1408;3640;1148;3193;10;40;976;2649;986;2689
221093;202001;1356;3829;1245;3608;119;336;854;2435;973;2771
221095;202001;899;2331;748;2091;9;31;622;1705;631;1736
221097;202001;824;2157;633;1812;22;67;465;1278;487;1345
221100;202001;113409;303836;94296;271180;10544;32366;60496;169344;71040;201710
221110;202001;9934;29555;9067;28431;157;815;8078;25056;8235;25871
221120;202001;4831;13310;4270;12400;176;545;3672;10624;3848;11169
221130;202001;5249;13807;3864;11090;768;2093;1840;5356;2608;7449
221135;202001;1619;4325;1450;4097;41;142;1274;3593;1315;3735
221140;202001;1333;3147;1118;2867;11;38;991;2485;1002;2523
221150;202001;1111;2741;867;2308;24;106;659;1640;683;1746
221160;202001;747;1839;649;1711;16;26;529;1401;545;1427
221170;202001;990;2851;899;2685;21;69;770;2286;791;2355
230010;202001;3163;8216;2514;7098;47;160;1983;5491;2030;5651
230015;202001;3005;9799;2628;9039;179;717;1818;6194;1997;6911
230020;202001;12980;40942;12143;39659;360;1518;10159;32936;10519;34454
230030;202001;13118;32816;10945;29953;195;591;9548;26104;9743;26695
230040;202001;4481;11636;3692;10345;61;288;3060;8438;3121;8726
230050;202001;2801;8708;2098;7020;324;1044;922;3012;1246;4056
230060;202001;2350;6419;1868;5561;40;179;1469;4283;1509;4462
230070;202001;3932;10496;3160;8986;144;443;2176;6121;2320;6564
230075;202001;9154;29587;8346;28155;472;2032;6599;21901;7071;23933
230080;202001;3099;6445;2330;5495;6;25;2116;5002;2122;5027
230090;202001;4280;10600;3599;9498;154;414;2852;7486;3006;7900
230100;202001;18145;47479;15966;44457;1213;3526;11292;31459;12505;34985
230110;202001;12921;38364;10869;34256;1778;5566;5681;18007;7459;23573
230120;202001;7388;20068;6481;18547;508;1326;4742;13782;5250;15108
230125;202001;3127;8291;2532;7318;84;287;1935;5533;2019;5820
230130;202001;5727;17636;4621;15178;318;1126;3112;10045;3430;11171
230140;202001;3459;10354;2935;9264;105;419;2210;6812;2315;7231
230150;202001;1592;4751;1315;4122;206;555;761;2486;967;3041
230160;202001;6566;17055;5611;15567;204;724;4497;12215;4701;12939
230170;202001;6238;17775;5120;15480;310;943;3652;10849;3962;11792
230180;202001;1663;4583;1392;4069;22;97;1112;3142;1134;3239
230185;202001;4327;12408;3630;11230;242;833;2688;8298;2930;9131
230190;202001;13251;38663;11125;34708;1532;4995;6165;19092;7697;24087
230195;202001;5342;15676;4825;14731;345;1051;3661;11149;4006;12200
230200;202001;5029;13820;4212;12250;143;461;3210;9142;3353;9603
230205;202001;4065;12298;3571;11511;178;662;2665;8502;2843;9164
230210;202001;10461;25126;8767;22806;348;1128;6859;17527;7207;18655
230220;202001;14040;35131;12256;32530;603;1655;10062;26433;10665;28088
230230;202001;6843;20689;6104;19146;400;1274;4473;13980;4873;15254
230240;202001;12989;34641;11255;31699;282;1166;9243;25483;9525;26649
230250;202001;8957;25302;8382;24403;239;869;6661;18810;6900;19679
230260;202001;14751;44258;12728;40560;1641;5160;7296;23689;8937;28849
230270;202001;7469;20349;5679;16955;455;1358;3778;11307;4233;12665
230280;202001;20561;54834;16695;48310;491;2063;13054;36430;13545;38493
230290;202001;4823;13436;4021;11899;277;735;2996;8870;3273;9605
230300;202001;4806;12901;4359;12272;96;300;3782;10559;3878;10859
230310;202001;4682;13307;3920;11952;141;593;2788;8266;2929;8859
230320;202001;7812;22454;6553;20133;261;1073;4968;14926;5229;15999
230330;202001;4789;13035;3752;11021;152;507;2775;7977;2927;8484
230340;202001;3622;11270;3060;10132;275;949;2022;6637;2297;7586
230350;202001;18017;49691;15795;46334;893;3038;10415;30763;11308;33801
230360;202001;2853;7699;2252;6625;148;429;1489;4339;1637;4768
230365;202001;3065;7624;2515;6791;44;226;2118;5653;2162;5879
230370;202001;59122;164737;50190;151234;7638;23323;29102;89170;36740;112493
230380;202001;6433;17881;5035;15264;129;520;3668;10907;3797;11427
230390;202001;3400;10075;2927;9307;104;466;2244;7036;2348;7502
230393;202001;3199;9570;2543;8213;86;459;1936;5999;2022;6458
230395;202001;5930;16088;5146;14759;337;907;3564;10234;3901;11141
230400;202001;5597;15459;4946;14371;110;566;3924;11056;4034;11622
230410;202001;14588;42840;11916;37849;937;3210;7970;25225;8907;28435
230420;202001;28638;78992;23178;69296;2832;8827;12813;38130;15645;46957
230423;202001;4743;14020;4109;12744;88;376;3303;10073;3391;10449
230425;202001;5596;17245;5074;16163;412;1388;3578;11343;3990;12731
230426;202001;2732;7197;1967;5697;30;109;1466;4165;1496;4274
230427;202001;1882;5296;1333;4125;67;234;875;2602;942;2836
230428;202001;9798;26192;8441;24119;1141;3278;4924;13960;6065;17238
230430;202001;4941;13925;3906;12149;156;558;2927;8961;3083;9519
230435;202001;5801;15261;4855;13607;562;1529;3003;8440;3565;9969
230440;202001;415359;1033120;343112;925014;35994;102912;214911;572910;250905;675822
230445;202001;4313;11457;3474;9988;178;506;2346;6630;2524;7136
230450;202001;3632;10493;3154;9775;247;971;2257;6779;2504;7750
230460;202001;2150;5966;1857;5498;64;252;1531;4515;1595;4767
230465;202001;4028;11334;3400;10143;101;419;2513;7207;2614;7626
230470;202001;11275;37224;10085;35005;862;3454;7131;24317;7993;27771
230480;202001;1425;4135;1185;3690;83;321;842;2527;925;2848
230490;202001;2509;7016;2095;6250;162;540;1308;3692;1470;4232
230495;202001;5828;17249;5090;15919;377;1415;3328;10302;3705;11717
230500;202001;9323;29980;8369;28240;279;1140;6750;22704;7029;23844
230510;202001;1638;5003;1248;4136;185;656;598;1952;783;2608
230520;202001;4593;12971;3946;11798;331;923;2732;8193;3063;9116
230523;202001;15305;45243;12212;38571;2732;8596;3191;10718;5923;19314
230526;202001;3826;10821;3206;9735;173;530;2337;7123;2510;7653
230530;202001;5392;16794;4520;15088;300;1132;3234;10710;3534;11842
230533;202001;4401;10652;3656;9459;97;276;3015;7686;3112;7962
230535;202001;5363;14885;4524;13458;233;702;3140;9458;3373;10160
230540;202001;16311;44287;14028;40907;267;1075;11521;33252;11788;34327
230550;202001;20873;55600;16685;48365;1509;4515;10448;30109;11957;34624
230560;202001;8145;19910;6508;17311;52;225;5534;14608;5586;14833
230565;202001;3053;8514;2535;7565;85;354;1894;5533;1979;5887
230570;202001;3521;8944;2980;8214;73;235;2457;6741;2530;6976
230580;202001;10926;28358;9323;26048;330;984;7690;21320;8020;22304
230590;202001;8975;25575;7389;22652;407;1466;5379;15921;5786;17387
230600;202001;3655;9544;2835;8066;88;271;1946;5567;2034;5838
230610;202001;6684;18457;5874;17089;452;1291;4583;13276;5035;14567
230620;202001;2106;5699;1584;4661;122;391;957;2735;1079;3126
230625;202001;7840;22423;6572;20052;1942;6167;1766;5798;3708;11965
230630;202001;10774;32079;9302;29069;1545;4590;5225;16749;6770;21339
230640;202001;28010;84443;25136;79824;1329;5264;19706;61625;21035;66889
230650;202001;5185;14169;4379;12740;138;593;3492;9884;3630;10477
230655;202001;9372;31727;8785;30693;619;2291;6919;24379;7538;26670
230660;202001;6108;18139;4945;16049;155;829;3978;12638;4133;13467
230670;202001;6187;14779;4517;12090;130;428;3600;9410;3730;9838
230680;202001;2633;7239;2220;6503;133;386;1581;4647;1714;5033
230690;202001;7117;21104;6145;19156;407;1410;3858;11813;4265;13223
230700;202001;9974;25650;8198;22395;318;872;6070;16219;6388;17091
230710;202001;6729;21271;5843;19396;572;1991;3967;12969;4539;14960
230720;202001;1945;5704;1559;4905;119;359;1031;3169;1150;3528
230725;202001;3910;11860;3497;11092;380;1339;1963;6137;2343;7476
230730;202001;56989;155140;44573;135642;9837;32405;14530;46483;24367;78888
230740;202001;6113;16920;5159;15380;130;484;4120;12206;4250;12690
230750;202001;8501;22710;7038;20275;171;656;5503;15403;5674;16059
230760;202001;11261;29762;9800;27525;548;1798;7297;20010;7845;21808
230763;202001;4760;13177;3966;11697;121;563;3150;8991;3271;9554
230765;202001;41008;111743;33962;100155;5355;16468;16523;48388;21878;64856
230770;202001;25657;63656;21402;57958;2195;6046;14034;38081;16229;44127
230780;202001;6242;22134;5698;20861;773;2854;3349;12562;4122;15416
230790;202001;2964;8631;2644;8097;108;477;1971;5882;2079;6359
230800;202001;8058;25614;7071;23593;809;2954;4244;13896;5053;16850
230810;202001;11680;34722;10365;32582;411;1537;7899;24367;8310;25904
230820;202001;3349;10995;2765;9636;248;1062;1681;5561;1929;6623
230830;202001;7647;20798;6445;18761;146;622;5261;14929;5407;15551
230835;202001;4245;10148;3255;8569;83;246;2630;6832;2713;7078
230837;202001;3146;9667;2716;8889;112;538;2139;6807;2251;7345
230840;202001;9032;26546;7732;24370;768;2308;5513;17566;6281;19874
230850;202001;9547;27737;7994;24632;370;1337;5669;17234;6039;18571
230860;202001;5202;13307;4320;12026;64;231;3763;10406;3827;10637
230870;202001;16659;40648;14159;36496;385;1096;11521;29297;11906;30393
230880;202001;2105;6433;1910;6102;48;267;1502;4660;1550;4927
230890;202001;4609;14729;4176;13847;334;1218;2981;9704;3315;10922
230900;202001;3013;8708;2564;7826;183;643;1706;5075;1889;5718
230910;202001;3046;8220;2460;7283;60;284;1983;5833;2043;6117
230920;202001;4603;13015;3883;11879;146;595;2996;8946;3142;9541
230930;202001;6526;18298;5452;16339;302;904;3768;11290;4070;12194
230940;202001;7861;20344;6788;18707;196;519;5666;15520;5862;16039
230945;202001;6527;18791;5585;16959;324;1139;3921;11715;4245;12854
230950;202001;6358;15896;5606;14894;114;264;4880;13081;4994;13345
230960;202001;13043;38078;11511;35181;1789;5446;5844;18088;7633;23534
230970;202001;13591;36165;11307;32589;1766;5099;6153;17978;7919;23077
230980;202001;2727;7969;2368;7330;366;1090;1444;4600;1810;5690
230990;202001;1689;4781;1398;4186;70;289;961;2746;1031;3035
231000;202001;2476;6597;2032;5730;78;207;1481;4079;1559;4286
231010;202001;3448;8162;2732;6913;42;155;2356;5791;2398;5946
231020;202001;8074;25628;7194;23821;1314;4040;4010;13852;5324;17892
231025;202001;7541;20920;6537;19260;746;2165;4480;13320;5226;15485
231030;202001;7350;21896;5743;18486;917;2876;2970;9589;3887;12465
231040;202001;2973;8637;2581;7903;117;368;1994;6022;2111;6390
231050;202001;11842;30633;9501;26464;654;1784;6898;18799;7552;20583
231060;202001;2830;8030;2466;7435;63;229;2005;6028;2068;6257
231070;202001;7993;23130;6725;20892;737;2338;4239;13082;4976;15420
231080;202001;4018;11468;3421;10488;133;570;2573;7746;2706;8316
231085;202001;6792;16515;5367;14798;219;565;4125;11385;4344;11950
231090;202001;4420;11561;3272;9333;106;425;2246;6171;2352;6596
231095;202001;2291;6825;1791;5717;138;453;1182;3758;1320;4211
231100;202001;3131;9099;2577;8050;127;462;1934;5984;2061;6446
231110;202001;3545;10487;3224;9888;118;447;2421;7288;2539;7735
231120;202001;2233;6574;1846;5889;83;310;1291;4076;1374;4386
231123;202001;1925;4967;1599;4405;70;165;1158;3198;1228;3363
231126;202001;5463;15099;4391;13077;240;728;3161;9305;3401;10033
231130;202001;21145;54514;17588;49959;1053;3827;12832;35757;13885;39584
231135;202001;4157;11667;3442;10280;153;531;2453;7186;2606;7717
231140;202001;16869;47359;13420;41213;602;2522;9310;27819;9912;30341
231150;202001;5740;15742;4419;13196;706;2153;1959;5993;2665;8146
231160;202001;6223;18913;5444;17458;805;2467;3080;10149;3885;12616
231170;202001;4407;12937;3602;11370;192;714;2456;7493;2648;8207
231180;202001;14455;41127;11684;35216;3174;9284;3934;12305;7108;21589
231190;202001;3875;10924;3185;9648;69;311;2445;7200;2514;7511
231195;202001;4862;14745;4023;13016;218;836;2916;9307;3134;10143
231200;202001;7811;24501;6794;22422;218;1097;5254;16814;5472;17911
231210;202001;4846;14206;4115;12992;187;715;3060;9451;3247;10166
231220;202001;12118;31591;9358;26361;406;1248;6766;18406;7172;19654
231230;202001;9360;29735;8191;27633;471;1896;5990;20184;6461;22080
231240;202001;11587;33899;10155;31161;1551;4670;6044;18771;7595;23441
231250;202001;2106;5440;1368;3808;100;283;821;2224;921;2507
231260;202001;3232;9201;2799;8509;270;798;1882;5877;2152;6675
231270;202001;6476;16911;5250;14875;147;564;3951;10943;4098;11507
231280;202001;1699;5324;1558;5062;89;302;1165;3755;1254;4057
231290;202001;37856;113090;31419;99792;5280;16665;14408;45471;19688;62136
231300;202001;4061;11293;3163;9468;217;703;2060;6051;2277;6754
231310;202001;7291;19049;5807;16283;492;1392;3903;10748;4395;12140
231320;202001;7794;21444;6043;18296;90;440;4710;14048;4800;14488
231325;202001;2526;6694;2035;5934;165;420;1342;4004;1507;4424
231330;202001;9620;28908;7893;25435;1406;4357;4155;13963;5561;18320
231335;202001;5810;15207;4868;13701;86;363;4259;11848;4345;12211
231340;202001;17472;54382;15565;50944;1383;4577;11044;36595;12427;41172
231350;202001;15887;43210;14378;41077;313;1099;12758;36111;13071;37210
231355;202001;4418;13176;3929;12274;242;812;2991;9254;3233;10066
231360;202001;7480;22611;6438;20763;278;1033;5015;16106;5293;17139
231370;202001;2190;6003;1745;5218;35;117;1324;3944;1359;4061
231375;202001;4432;13703;4019;13016;138;615;3331;10664;3469;11279
231380;202001;6024;16301;5427;15483;183;498;4412;12763;4595;13261
231390;202001;3376;9854;3004;9233;141;550;2184;6513;2325;7063
231395;202001;3951;11695;3259;10584;424;1390;1904;6269;2328;7659
231400;202001;9522;27359;8008;24560;282;1177;6065;18197;6347;19374
231410;202001;14762;45877;13321;43489;601;2332;10623;34262;11224;36594
240010;202001;2511;6707;1938;5637;195;611;1158;3288;1353;3899
240020;202001;12394;34899;10385;31325;657;2474;6860;20306;7517;22780
240030;202001;2898;7127;2636;6720;95;279;2261;5707;2356;5986
240040;202001;812;2326;669;2056;33;126;463;1368;496;1494
240050;202001;3225;8655;2632;7562;46;135;2045;5787;2091;5922
240060;202001;1386;3726;1141;3276;26;92;926;2601;952;2693
240070;202001;2160;6298;1967;5909;188;614;1416;4128;1604;4742
240080;202001;2923;7885;2394;6921;55;212;1832;5186;1887;5398
240090;202001;2267;5575;1824;4815;20;60;1522;3966;1542;4026
240100;202001;10084;24970;7990;21126;231;742;6194;15790;6425;16532
240110;202001;4601;13019;3881;11697;197;714;2795;8241;2992;8955
240120;202001;3401;9268;2622;8345;194;705;1813;5923;2007;6628
240130;202001;3637;7605;3030;6817;29;95;2758;6108;2787;6203
240140;202001;1841;5481;1564;4947;167;568;1039;3260;1206;3828
240145;202001;6674;18616;5438;16440;841;2608;3026;9237;3867;11845
240150;202001;904;2663;810;2465;55;200;617;1811;672;2011
240160;202001;1436;4352;1196;3889;47;223;884;2882;931;3105
240165;202001;975;2667;801;2325;41;135;631;1801;672;1936
240170;202001;2444;6656;2052;5944;194;648;1377;3855;1571;4503
240180;202001;3031;8946;2400;7673;553;1686;1092;3703;1645;5389
240185;202001;1208;3847;1093;3658;56;229;898;2965;954;3194
240190;202001;1034;3053;891;2811;22;98;749;2368;771;2466
240200;202001;10870;28027;8652;24189;871;2661;4923;13440;5794;16101
240210;202001;2995;7556;2570;6918;29;147;2164;5638;2193;5785
240220;202001;7360;22043;6551;20756;360;1583;5049;15673;5409;17256
240230;202001;5898;15054;4712;13034;194;546;3723;10305;3917;10851
240240;202001;1855;5311;1152;3604;116;393;431;1177;547;1570
240250;202001;2901;7708;2561;7226;97;292;2128;5981;2225;6273
240260;202001;14227;41859;12270;38507;1723;5158;7531;24738;9254;29896
240270;202001;2266;6750;1967;6254;99;319;1434;4671;1533;4990
240280;202001;1687;4302;1428;3891;51;136;1139;3056;1190;3192
240290;202001;1185;3450;961;2958;28;125;667;1923;695;2048
240300;202001;2196;5677;1574;4511;75;245;1014;2828;1089;3073
240310;202001;8606;22765;6792;19486;888;2700;3508;9879;4396;12579
240320;202001;1998;5479;1481;4457;32;148;1099;3154;1131;3302
240325;202001;30472;82082;23798;70251;4367;13385;9947;29743;14314;43128
240330;202001;1730;4715;1311;3908;52;187;883;2517;935;2704
240340;202001;1992;4614;1618;4034;66;155;1307;3196;1373;3351
240350;202001;2126;5505;1919;5274;23;80;1733;4776;1756;4856
240360;202001;8599;23963;7658;22462;878;2597;5250;15641;6128;18238
240370;202001;1924;5130;1483;4207;74;219;1024;2839;1098;3058
240375;202001;899;2264;737;1964;27;97;595;1534;622;1631
240380;202001;2267;6429;1653;5054;134;392;967;2913;1101;3305
240390;202001;994;2473;677;1858;30;84;426;1090;456;1174
240400;202001;1393;3476;1093;2943;34;130;767;1951;801;2081
240410;202001;579;1759;482;1542;44;176;301;906;345;1082
240420;202001;4558;16077;4004;14821;471;2109;2332;8415;2803;10524
240430;202001;3387;8855;2812;7795;182;575;2054;5502;2236;6077
240440;202001;2589;5681;2172;5098;149;305;1714;4008;1863;4313
240450;202001;4525;12292;3543;10457;352;1091;2067;5866;2419;6957
240460;202001;2886;8248;2617;7813;260;831;1997;5936;2257;6767
240470;202001;3602;10839;2738;9034;455;1419;1432;4926;1887;6345
240480;202001;569;1577;385;1179;28;88;178;530;206;618
240485;202001;2131;6017;1737;5264;132;412;1178;3577;1310;3989
240490;202001;1636;4178;1276;3516;75;178;946;2623;1021;2801
240500;202001;2154;5805;1872;5337;85;249;1525;4332;1610;4581
240510;202001;1682;4371;1480;4083;72;266;1221;3270;1293;3536
240520;202001;1389;3468;1084;3048;44;149;829;2305;873;2454
240530;202001;2130;6152;1925;5817;102;310;1555;4684;1657;4994
240540;202001;2285;5726;1985;5252;65;145;1711;4523;1776;4668
240550;202001;702;1993;634;1860;21;90;513;1447;534;1537
240560;202001;3298;8591;2786;7899;299;772;1999;5770;2298;6542
240570;202001;2774;7289;1841;5210;269;788;729;1925;998;2713
240580;202001;8148;23669;7197;21927;567;1684;5701;17455;6268;19139
240590;202001;716;1885;622;1727;14;50;462;1259;476;1309
240600;202001;1792;4833;1314;3838;45;152;878;2483;923;2635
240610;202001;4264;11536;3585;10289;132;446;2696;7585;2828;8031
240615;202001;1187;3150;936;2664;68;212;648;1762;716;1974
240620;202001;1873;5257;1584;4731;88;251;1250;3711;1338;3962
240630;202001;2075;5941;1864;5580;136;320;1307;4044;1443;4364
240640;202001;932;2518;738;2186;27;103;546;1599;573;1702
240650;202001;4063;11189;3502;10122;190;567;2695;7678;2885;8245
240660;202001;3089;7922;2733;7464;53;165;2454;6710;2507;6875
240670;202001;2466;6924;1984;5923;144;445;1268;3685;1412;4130
240680;202001;1643;4341;1301;3760;53;164;986;2785;1039;2949
240690;202001;988;2490;783;2140;16;69;617;1613;633;1682
240700;202001;2427;7026;1972;6178;65;246;1532;4713;1597;4959
240710;202001;16333;42326;13604;37563;1816;4900;8271;22874;10087;27774
240720;202001;5229;12952;4518;11924;380;1078;3279;8531;3659;9609
240725;202001;1125;3215;860;2673;29;101;573;1729;602;1830
240730;202001;2159;6078;1794;5369;64;224;1363;4000;1427;4224
240740;202001;1843;4935;1483;4237;45;173;1082;2923;1127;3096
240750;202001;2196;7246;1837;6482;277;1087;951;3391;1228;4478
240760;202001;1574;3779;1102;3059;56;94;843;2417;899;2511
240770;202001;3205;8835;2692;8082;120;449;2157;6383;2277;6832
240780;202001;5017;13671;4009;11997;507;1533;2441;7460;2948;8993
240790;202001;860;2444;708;2150;13;54;530;1573;543;1627
240800;202001;46402;112859;35847;96608;4862;13535;18091;48806;22953;62341
240810;202001;88309;230744;74555;207552;9864;27965;45912;126225;55776;154190
240820;202001;5803;17307;4991;15836;656;2083;3101;9981;3757;12064
240830;202001;8757;25100;7818;23676;258;1130;6401;19129;6659;20259
240840;202001;1137;2832;907;2453;32;82;631;1641;663;1723
240850;202001;1328;3630;952;2825;41;132;542;1551;583;1683
240860;202001;1245;3377;933;2806;16;73;694;1986;710;2059
240870;202001;1128;2874;847;2370;135;384;460;1301;595;1685
240880;202001;1278;4030;1123;3726;87;367;862;2783;949;3150
240890;202001;4515;12330;3412;10200;461;1499;1706;4879;2167;6378
240895;202001;2676;8373;2431;8007;126;429;2117;7000;2243;7429
240910;202001;3298;9035;2809;8152;57;213;2295;6551;2352;6764
240920;202001;838;2339;697;2101;57;166;403;1264;460;1430
240930;202001;3726;8503;3082;7719;197;287;2312;6081;2509;6368
240933;202001;1782;4326;1452;3837;45;178;1245;3231;1290;3409
240940;202001;6195;15315;4807;12916;453;1254;3054;7963;3507;9217
240950;202001;999;2984;864;2733;29;125;695;2149;724;2274
240960;202001;686;2105;609;1943;31;120;469;1457;500;1577
240970;202001;1841;4739;1481;4130;57;210;1208;3267;1265;3477
240980;202001;3242;9699;2896;9070;126;530;2325;7139;2451;7669
240990;202001;2584;7323;2288;6738;262;863;1600;4519;1862;5382
241000;202001;939;2490;745;2125;30;77;543;1532;573;1609
241010;202001;2794;8936;2545;8396;167;674;1868;6057;2035;6731
241020;202001;2084;5606;1524;4463;160;466;950;2756;1110;3222
241025;202001;1731;4976;1370;4289;46;202;978;3012;1024;3214
241030;202001;2519;7824;2012;6740;225;791;1290;4307;1515;5098
241040;202001;2299;7263;2037;6822;100;439;1626;5407;1726;5846
241050;202001;1311;3637;1067;3185;37;138;793;2307;830;2445
241060;202001;731;2069;645;1883;25;86;458;1284;483;1370
241070;202001;655;1789;567;1632;14;53;442;1220;456;1273
241080;202001;1135;3206;858;2649;7;29;627;1921;634;1950
241090;202001;2020;5868;1633;5207;50;254;1282;4014;1332;4268
241100;202001;1158;3270;914;2749;65;207;600;1753;665;1960
241105;202001;1008;3068;823;2713;258;846;260;885;518;1731
241110;202001;931;2638;697;2134;35;122;453;1333;488;1455
241120;202001;7690;21681;6496;19571;972;2852;3764;11680;4736;14532
241140;202001;3329;8784;2611;7329;165;472;1873;5122;2038;5594
241142;202001;768;2063;560;1650;27;97;329;908;356;1005
241150;202001;5960;15555;5269;14404;155;534;4297;11529;4452;12063
241160;202001;1155;3105;938;2706;141;406;583;1641;724;2047
241170;202001;1328;3396;1138;3066;30;121;949;2443;979;2564
241180;202001;1024;2653;742;2103;88;253;384;1055;472;1308
241190;202001;1120;2960;915;2546;18;74;668;1787;686;1861
241200;202001;19201;50491;16494;46119;2630;7344;9471;26583;12101;33927
241210;202001;1413;3792;1009;2975;120;380;570;1630;690;2010
241220;202001;8786;26081;7619;24090;1810;5655;3510;11617;5320;17272
241230;202001;2907;7690;2577;7179;96;327;2134;5853;2230;6180
241240;202001;1186;3331;709;2247;58;194;319;1014;377;1208
241250;202001;5333;15534;4284;13535;166;769;3113;9446;3279;10215
241255;202001;2160;6846;1893;6263;109;468;1392;4491;1501;4959
241260;202001;4883;12785;3797;10952;85;366;2984;8401;3069;8767
241270;202001;1788;5146;1469;4519;112;389;1033;3149;1145;3538
241280;202001;2190;5499;1880;4936;65;181;1571;4052;1636;4233
241290;202001;3417;8362;2551;6945;74;282;2017;5320;2091;5602
241300;202001;1445;3876;1143;3322;35;119;785;2224;820;2343
241310;202001;2106;5301;1791;4848;14;62;1506;4114;1520;4176
241320;202001;1002;3211;832;2874;95;397;520;1772;615;2169
241330;202001;1778;4611;1373;4081;19;90;1178;3485;1197;3575
241335;202001;3230;9005;2857;8312;106;353;2359;6784;2465;7137
241340;202001;1562;4440;1205;3680;253;803;497;1483;750;2286
241350;202001;2028;5859;1785;5423;97;332;1360;4066;1457;4398
241355;202001;1302;3525;1061;3069;17;60;819;2344;836;2404
241360;202001;2080;5390;1547;4294;46;140;1106;2951;1152;3091
241370;202001;1356;3730;1046;3082;52;179;723;2028;775;2207
241380;202001;623;1768;486;1484;74;206;245;766;319;972
241390;202001;2754;8113;2432;7622;184;535;1866;5918;2050;6453
241400;202001;3530;9821;3138;9202;159;507;2538;7383;2697;7890
241410;202001;2383;7082;1931;6150;340;1106;973;3111;1313;4217
241415;202001;1663;4923;1350;4305;61;237;944;2937;1005;3174
241420;202001;2255;7263;1919;6659;455;1735;903;3106;1358;4841
241430;202001;590;1625;405;1202;22;71;258;741;280;812
241440;202001;7436;23137;6633;21729;354;1373;5231;16937;5585;18310
241445;202001;1108;2838;982;2676;24;53;877;2458;901;2511
241450;202001;2616;6574;2249;5978;380;843;1472;4050;1852;4893
241460;202001;3693;10009;2988;8521;185;579;2107;5857;2292;6436
241470;202001;1433;3749;1151;3338;26;96;946;2742;972;2838
241475;202001;1201;3401;936;2882;22;114;660;1939;682;2053
241480;202001;2912;9110;2401;8000;727;2374;800;2969;1527;5343
241490;202001;654;1560;526;1384;23;68;362;924;385;992
241500;202001;811;2321;717;2200;6;26;654;2015;660;2041
250010;202001;2583;7686;2128;6756;60;244;1529;4736;1589;4980
250020;202001;1589;4303;1129;3391;29;75;817;2435;846;2510
250030;202001;6928;19032;6095;17718;507;1548;4551;13042;5058;14590
250040;202001;4088;12560;3520;11500;223;856;2514;8061;2737;8917
250050;202001;3594;9711;3245;9217;100;398;2676;7532;2776;7930
250053;202001;1177;3344;1064;3164;76;243;762;2264;838;2507
250057;202001;658;2360;615;2295;8;33;547;2093;555;2126
250060;202001;5480;14361;4947;13699;300;781;4028;11240;4328;12021
250070;202001;3978;11164;3395;10124;43;182;2698;7848;2741;8030
250073;202001;761;2028;616;1807;7;27;500;1421;507;1448
250077;202001;2240;6026;1667;5071;64;223;1235;3735;1299;3958
250080;202001;4854;12183;4140;11254;67;309;3573;9553;3640;9862
250090;202001;3257;8030;2847;7477;55;168;2451;6313;2506;6481
250100;202001;3684;11251;3328;10580;168;613;2589;8067;2757;8680
250110;202001;4916;13726;4418;13003;272;1001;3425;9855;3697;10856
250115;202001;682;1788;491;1494;8;44;344;1036;352;1080
250120;202001;1837;5395;1531;4871;30;146;1206;3806;1236;3952
250130;202001;5466;15095;4608;13859;75;405;3849;11399;3924;11804
250135;202001;1161;3217;1029;2999;28;112;896;2584;924;2696
250140;202001;2263;6673;2103;6466;118;522;1784;5378;1902;5900
250150;202001;4864;15131;4356;14251;144;645;3478;11162;3622;11807
250153;202001;1423;3727;1189;3376;28;83;948;2663;976;2746
250157;202001;1723;5134;1543;4785;64;264;1223;3730;1287;3994
250160;202001;3922;9774;3136;8703;32;142;2767;7654;2799;7796
250170;202001;1849;4730;1640;4423;27;106;1416;3764;1443;3870
250180;202001;20198;49035;17232;45197;782;2477;13296;33961;14078;36438
250190;202001;4091;10957;3410;9910;345;993;2301;6561;2646;7554
250200;202001;1940;5206;1648;4788;60;201;1371;3972;1431;4173
250205;202001;851;2620;728;2418;17;79;602;1980;619;2059
250210;202001;1568;4773;1409;4512;53;271;1120;3512;1173;3783
250215;202001;1541;4266;1287;3892;72;243;774;2325;846;2568
250220;202001;663;1860;536;1663;31;119;355;1063;386;1182
250230;202001;1583;3589;1136;2919;24;72;910;2268;934;2340
250240;202001;2300;6966;2012;6433;42;198;1664;5228;1706;5426
250250;202001;4599;12756;3986;11855;83;294;3362;10008;3445;10302
250260;202001;1710;4755;1416;4251;43;128;1119;3326;1162;3454
250270;202001;1205;3618;1075;3459;66;229;804;2673;870;2902
250280;202001;3288;9222;2910;8642;98;295;2311;6846;2409;7141
250290;202001;1613;4234;1364;3880;24;73;1063;3045;1087;3118
250300;202001;5519;14718;4977;14093;203;907;4107;11177;4310;12084
250310;202001;1139;3128;943;2800;37;124;723;2116;760;2240
250320;202001;11712;26596;10037;24644;274;783;8864;21453;9138;22236
250330;202001;2351;6566;1960;6038;105;345;1566;4812;1671;5157
250340;202001;1096;2799;966;2626;7;19;878;2367;885;2386
250350;202001;4035;11239;3611;10564;159;408;2839;8549;2998;8957
250355;202001;1986;6003;1763;5692;30;162;1572;5037;1602;5199
250360;202001;1764;4900;1574;4632;41;153;1300;3799;1341;3952
250370;202001;13295;34538;10930;30955;273;1029;9015;25138;9288;26167
250375;202001;1195;3091;951;2792;6;18;886;2632;892;2650
250380;202001;1615;4175;1476;4000;29;133;1278;3334;1307;3467
250390;202001;1805;4625;1514;4154;97;253;1185;3237;1282;3490
250400;202001;71291;174588;51329;143342;13857;41281;15080;44198;28937;85479
250403;202001;1726;4841;1536;4610;71;372;1177;3359;1248;3731
250407;202001;1202;3042;969;2700;60;136;701;1989;761;2125
250410;202001;609;1635;531;1507;6;14;436;1219;442;1233
250415;202001;1825;5184;1606;4828;35;157;1372;4098;1407;4255
250420;202001;1206;3393;1086;3231;24;94;965;2845;989;2939
250430;202001;6338;15538;5329;14168;137;449;4367;11374;4504;11823
250435;202001;1548;4273;1245;3748;13;60;942;2805;955;2865
250440;202001;4613;12157;3945;11323;67;199;3480;9985;3547;10184
250450;202001;1802;4824;1496;4404;26;108;1230;3623;1256;3731
250460;202001;7469;20125;6586;18826;323;1001;5284;15032;5607;16033
250470;202001;1551;3998;1275;3573;51;167;984;2706;1035;2873
250480;202001;4149;11061;3522;10331;24;89;3137;9317;3161;9406
250485;202001;721;1639;530;1371;35;69;381;955;416;1024
250490;202001;5180;12293;4597;11621;176;534;4035;10011;4211;10545
250500;202001;1984;5478;1749;5073;75;242;1413;4090;1488;4332
250510;202001;5505;13778;4723;12754;83;230;4117;11214;4200;11444
250520;202001;1854;5019;1578;4624;133;439;1108;3213;1241;3652
250523;202001;2250;5513;1992;5187;72;308;1653;4156;1725;4464
250527;202001;1685;4321;1519;4134;25;70;1328;3656;1353;3726
250530;202001;634;1631;536;1500;6;17;466;1303;472;1320
250535;202001;1350;3956;1222;3702;28;128;994;2913;1022;3041
250540;202001;3030;6882;2492;6282;69;121;2174;5590;2243;5711
250550;202001;770;2468;671;2278;23;92;502;1674;525;1766
250560;202001;1703;4689;1493;4377;40;153;1249;3572;1289;3725
250570;202001;2642;7929;2259;7231;81;319;1763;5530;1844;5849
250580;202001;1067;2755;938;2569;46;168;781;2092;827;2260
250590;202001;829;2310;732;2170;21;82;601;1785;622;1867
250600;202001;8287;21088;6909;19315;273;872;5685;15741;5958;16613
250610;202001;3049;8469;2717;7985;125;473;2238;6472;2363;6945
250620;202001;758;2030;638;1814;12;50;478;1329;490;1379
250625;202001;2543;7317;2259;6844;42;223;1898;5576;1940;5799
250630;202001;10175;28264;8229;24786;873;2694;5229;15410;6102;18104
250640;202001;3356;9276;3030;8854;70;340;2613;7463;2683;7803
250650;202001;965;2340;802;2115;15;52;693;1787;708;1839
250660;202001;1570;3911;1324;3586;39;110;1094;2883;1133;2993
250670;202001;2341;7310;2124;6914;44;199;1838;5872;1882;6071
250680;202001;5942;13556;5251;12771;78;284;4798;11476;4876;11760
250690;202001;6903;15605;5876;14322;104;276;5175;12458;5279;12734
250700;202001;4345;12169;3775;11294;425;1262;2632;7819;3057;9081
250710;202001;4478;12783;3832;11889;303;1049;2747;8502;3050;9551
250720;202001;2772;7342;2483;6934;36;178;2170;5977;2206;6155
250730;202001;4152;10967;3613;10259;102;418;3012;8300;3114;8718
250740;202001;1986;4940;1615;4452;94;244;1241;3420;1335;3664
250750;202001;103841;256585;87951;234263;7275;21151;62953;164257;70228;185408
250760;202001;2362;6078;2053;5585;88;267;1621;4296;1709;4563
250770;202001;4029;12159;3605;11593;368;1203;2597;8387;2965;9590
250780;202001;1740;4671;1445;4131;59;206;1097;3058;1156;3264
250790;202001;2465;7319;2124;6801;156;624;1423;4437;1579;5061
250800;202001;2482;6569;2145;6034;90;192;1733;4915;1823;5107
250810;202001;1272;3392;1018;3022;20;49;864;2583;884;2632
250820;202001;1976;5517;1825;5350;37;153;1659;4830;1696;4983
250830;202001;5794;17299;4773;15258;262;1035;3287;10167;3549;11202
250840;202001;776;2434;659;2202;15;58;488;1641;503;1699
250850;202001;1794;5382;1599;5036;31;162;1312;4021;1343;4183
250855;202001;944;2769;819;2555;59;201;612;1899;671;2100
250860;202001;3141;9290;2595;8344;447;1524;1489;4784;1936;6308
250870;202001;1041;2857;869;2567;36;132;707;2066;743;2198
250880;202001;1613;4138;1321;3715;83;257;997;2786;1080;3043
250890;202001;10126;26698;8967;25109;443;1903;7073;18768;7516;20671
250900;202001;2801;7849;2403;7120;60;241;2022;5846;2082;6087
250905;202001;2391;6810;2188;6513;49;183;1963;5842;2012;6025
250910;202001;6049;14954;4951;13689;83;296;4225;11767;4308;12063
250915;202001;2139;5001;1517;4325;25;55;1321;3865;1346;3920
250920;202001;3573;9030;3106;8300;327;764;2263;6050;2590;6814
250930;202001;2236;5990;2019;5701;59;236;1728;4784;1787;5020
250933;202001;1171;3471;1029;3217;23;122;778;2350;801;2472
250937;202001;708;1900;576;1679;21;73;434;1285;455;1358
250939;202001;1731;4632;1504;4332;64;205;1172;3356;1236;3561
250940;202001;3932;10598;3440;9943;27;102;3018;8723;3045;8825
250950;202001;1695;4326;1363;3911;24;105;1133;3207;1157;3312
250960;202001;1107;3236;968;3012;25;136;782;2342;807;2478
250970;202001;8422;21656;7344;19935;254;800;5956;15838;6210;16638
250980;202001;2495;6609;2227;6202;38;158;1886;5116;1924;5274
250990;202001;2028;6155;1685;5537;59;277;1242;4023;1301;4300
251000;202001;2044;5757;1646;5077;38;166;1328;4058;1366;4224
251010;202001;2634;7387;2373;6991;22;97;2153;6331;2175;6428
251020;202001;1653;4475;1486;4220;30;137;1291;3584;1321;3721
251030;202001;1001;2659;820;2324;34;95;570;1590;604;1685
251040;202001;1857;5283;1560;4769;41;194;1236;3742;1277;3936
251050;202001;1074;2925;903;2593;47;156;641;1779;688;1935
251060;202001;1077;2310;819;1989;7;29;651;1545;658;1574
251065;202001;481;1314;373;1113;13;37;252;728;265;765
251070;202001;718;1869;610;1715;10;40;516;1421;526;1461
251080;202001;18667;47934;15249;42784;1802;5297;9868;27690;11670;32987
251090;202001;2753;7915;2325;7151;55;196;1869;5705;1924;5901
251100;202001;803;2558;715;2397;29;115;530;1703;559;1818
251110;202001;1709;4585;1438;4108;44;120;1096;3105;1140;3225
251120;202001;7224;20388;6078;18959;266;1033;4795;14877;5061;15910
251130;202001;3946;8794;3470;8259;71;185;3118;7387;3189;7572
251140;202001;4249;11857;3813;11247;76;321;3178;9252;3254;9573
251150;202001;2686;7772;2398;7314;112;452;1931;5747;2043;6199
251160;202001;2116;6209;1838;5805;54;234;1559;4836;1613;5070
251170;202001;1558;4244;1361;3983;36;128;1169;3410;1205;3538
251180;202001;2658;7104;2169;6419;173;521;1455;4274;1628;4795
251190;202001;4387;11381;4014;10955;46;244;3631;9708;3677;9952
251200;202001;4354;12739;3855;12088;80;339;3364;10586;3444;10925
251203;202001;944;3070;867;2900;23;106;657;2136;680;2242
251207;202001;1083;2980;838;2568;20;103;582;1739;602;1842
251210;202001;7515;19254;6084;17339;259;639;4605;13389;4864;14028
251220;202001;1193;2893;925;2530;51;125;712;1981;763;2106
251230;202001;4637;12831;3987;11727;127;485;3135;8982;3262;9467
251240;202001;3674;10018;3064;9016;139;411;2298;6619;2437;7030
251250;202001;10230;27613;8957;25480;757;2308;6543;18010;7300;20318
251260;202001;482;1388;439;1316;12;62;346;997;358;1059
251270;202001;4262;13234;3821;12643;108;442;3114;10519;3222;10961
251272;202001;1363;3700;1224;3513;43;170;1009;2815;1052;2985
251274;202001;905;2504;723;2180;58;190;483;1390;541;1580
251275;202001;1227;3411;1045;3125;35;164;799;2299;834;2463
251276;202001;1331;3582;1158;3356;33;173;931;2601;964;2774
251278;202001;581;1623;516;1526;42;106;373;1125;415;1231
251280;202001;2266;6179;2004;5772;51;195;1658;4692;1709;4887
251290;202001;5920;14037;5355;13339;148;517;4663;11204;4811;11721
251300;202001;842;2494;759;2367;8;41;647;2010;655;2051
251310;202001;2763;7926;2398;7350;52;267;1888;5647;1940;5914
251315;202001;1709;5364;1564;5102;80;248;1168;3766;1248;4014
251320;202001;1626;4284;1139;3440;30;99;846;2522;876;2621
251330;202001;2094;4852;1705;4393;19;70;1542;4001;1561;4071
251335;202001;1052;3138;937;2958;24;103;811;2497;835;2600
251340;202001;3698;8972;2940;7949;116;358;2213;5917;2329;6275
251350;202001;1070;3102;954;2912;30;132;781;2329;811;2461
251360;202001;1815;5112;1457;4610;20;93;1246;3949;1266;4042
251365;202001;716;1968;562;1655;7;23;433;1262;440;1285
251370;202001;23327;62176;20021;57478;2407;7134;12726;36966;15133;44100
251380;202001;1207;3439;1052;3173;19;108;873;2543;892;2651
251385;202001;741;1919;571;1607;17;53;423;1152;440;1205
251390;202001;6464;18871;5674;17606;484;1593;3702;11463;4186;13056
251392;202001;989;2695;818;2435;25;114;629;1822;654;1936
251394;202001;615;1808;503;1608;21;87;375;1174;396;1261
251396;202001;699;1868;592;1686;17;46;407;1135;424;1181
251398;202001;941;2389;667;1917;13;58;495;1386;508;1444
251400;202001;1224;3020;982;2683;28;102;772;2037;800;2139
251410;202001;1466;3487;1193;3091;17;74;1013;2533;1030;2607
251420;202001;1931;5082;1552;4640;42;158;1205;3569;1247;3727
251430;202001;1538;4702;1367;4415;32;157;1172;3775;1204;3932
251440;202001;1131;3173;910;2747;39;104;713;2172;752;2276
251445;202001;1537;4341;1416;4169;35;146;1183;3401;1218;3547
251450;202001;4527;13277;4014;12520;95;386;3303;10207;3398;10593
251455;202001;875;2659;791;2510;23;100;609;1889;632;1989
251460;202001;893;2558;783;2385;18;68;647;1969;665;2037
251465;202001;435;1279;367;1148;4;17;276;848;280;865
251470;202001;1167;3231;873;2620;66;215;510;1450;576;1665
251480;202001;982;2607;803;2287;20;88;616;1674;636;1762
251490;202001;1887;4971;1486;4415;52;167;1094;3242;1146;3409
251500;202001;1958;5486;1782;5248;30;109;1608;4733;1638;4842
251510;202001;2662;7990;2188;7027;120;447;1455;4556;1575;5003
251520;202001;949;2500;717;2068;62;175;473;1333;535;1508
251530;202001;14686;35224;11835;31651;112;615;10428;27361;10540;27976
251540;202001;2881;8418;2595;7884;83;304;2122;6343;2205;6647
251550;202001;3738;8936;2965;7964;94;207;2461;6647;2555;6854
251560;202001;571;1712;497;1598;62;214;337;1047;399;1261
251570;202001;932;2633;752;2272;20;90;589;1725;609;1815
251580;202001;1935;4587;1718;4267;47;187;1483;3536;1530;3723
251590;202001;1583;4000;1338;3711;59;181;1083;2913;1142;3094
251593;202001;888;2617;804;2480;78;254;520;1565;598;1819
251597;202001;2113;5930;1896;5642;19;92;1669;4902;1688;4994
251600;202001;6431;17377;5646;16172;164;540;4649;13114;4813;13654
251610;202001;3259;9236;2790;8363;252;694;1909;5824;2161;6518
251615;202001;1243;3107;997;2727;23;62;793;2115;816;2177
251620;202001;18783;43555;14436;38206;121;400;12186;32807;12307;33207
251630;202001;4732;11100;3786;9796;197;541;2874;7342;3071;7883
251640;202001;2135;5860;1889;5465;32;158;1621;4566;1653;4724
251650;202001;4025;10740;3497;10049;122;389;2964;8495;3086;8884
251660;202001;3506;10469;3066;9685;79;375;2531;7840;2610;8215
251670;202001;4062;11495;3590;10831;47;245;3181;9506;3228;9751
251675;202001;654;1862;582;1772;73;229;387;1187;460;1416
251680;202001;2574;6825;2115;6217;42;150;1694;5000;1736;5150
251690;202001;3170;8904;2670;8013;89;280;1977;5856;2066;6136
251700;202001;2066;5931;1748;5536;42;199;1475;4583;1517;4782
251710;202001;783;2034;522;1488;42;147;303;837;345;984
251720;202001;1312;3704;1061;3263;22;98;808;2406;830;2504
251740;202001;611;1722;491;1496;41;147;338;987;379;1134
260005;202001;30082;63303;24593;56233;1654;3773;18839;42211;20493;45984
260010;202001;10213;26837;8391;23888;468;1397;4988;14284;5456;15681
260020;202001;6868;16119;5829;14625;112;511;4860;11979;4972;12490
260030;202001;6739;17336;5653;15733;149;464;4558;12603;4707;13067
260040;202001;7761;20254;6432;18256;485;1325;4404;12755;4889;14080
260050;202001;13883;36082;11496;33437;166;754;10486;30530;10652;31284
260060;202001;4019;10113;3450;9184;186;459;2706;7195;2892;7654
260070;202001;10563;26669;9033;24435;358;1232;7143;18816;7501;20048
260080;202001;6622;15056;5782;13923;120;384;4819;11364;4939;11748
260090;202001;4743;12235;4209;11504;500;1383;2906;7963;3406;9346
260100;202001;3057;8258;2549;7498;59;276;2063;5974;2122;6250
260105;202001;4988;13586;4454;12880;143;515;3707;10586;3850;11101
260110;202001;22502;61962;19941;58259;991;3394;16301;46896;17292;50290
260120;202001;14691;39273;12246;35580;1536;4386;7590;22437;9126;26823
260130;202001;3056;7922;2739;7453;209;594;2030;5418;2239;6012
260140;202001;13055;29692;11192;27436;596;1629;9273;22435;9869;24064
260150;202001;3625;8408;3097;7755;85;256;2700;6682;2785;6938
260160;202001;6588;17175;5526;15867;91;355;4907;14221;4998;14576
260170;202001;19571;47024;16537;42874;970;2543;13013;33359;13983;35902
260180;202001;3484;9295;2998;8633;78;297;2555;7239;2633;7536
260190;202001;18542;37247;15475;33641;172;481;13591;28890;13763;29371
260200;202001;11212;26806;9590;24748;445;1036;7997;20851;8442;21887
260210;202001;11883;33541;9999;30470;323;1281;7913;23905;8236;25186
260220;202001;10381;25056;9568;24014;167;564;8396;20725;8563;21289
260230;202001;10764;26441;9354;24560;198;657;7835;20177;8033;20834
260240;202001;2699;8075;2345;7394;127;446;1790;5597;1917;6043
260250;202001;2200;5801;1908;5352;130;300;1432;4016;1562;4316
260260;202001;13010;33929;11527;31639;396;1350;9046;24281;9442;25631
260270;202001;4178;10229;3657;9586;141;535;3012;7724;3153;8259
260280;202001;12834;38594;11469;36663;473;2027;9655;30448;10128;32475
260290;202001;40258;102871;34610;94523;3756;10460;23193;63063;26949;73523
260300;202001;9750;26221;8416;24405;218;956;6988;20182;7206;21138
260310;202001;5034;13032;4434;12261;291;774;3420;9575;3711;10349
260320;202001;7760;22278;6551;20197;261;833;5282;16276;5543;17109
260330;202001;2540;7806;2229;7167;65;251;1777;5567;1842;5818
260340;202001;2069;5521;1771;5064;30;136;1496;4176;1526;4312
260345;202001;25140;65740;21007;59603;3163;9583;10964;30486;14127;40069
260350;202001;5474;12956;4736;12094;82;240;4180;10607;4262;10847
260360;202001;2516;6558;2273;6114;45;210;1577;4154;1622;4364
260370;202001;5596;16007;4795;14651;242;864;3661;11077;3903;11941
260380;202001;4970;14731;4225;13491;154;569;3131;9874;3285;10443
260390;202001;4497;13478;3726;11893;208;684;2514;7848;2722;8532
260392;202001;3416;10893;3038;10410;122;724;2410;8266;2532;8990
260400;202001;17543;40988;15116;37797;497;1447;11786;28374;12283;29821
260410;202001;72947;177743;56295;154158;9967;28797;25103;70656;35070;99453
260415;202001;4525;12268;3894;11197;68;282;3148;8903;3216;9185
260420;202001;12898;26728;10877;24472;115;334;9998;22267;10113;22601
260430;202001;2785;8613;2375;7820;105;419;1667;5461;1772;5880
260440;202001;3723;9739;3267;9015;73;274;2710;7321;2783;7595
260450;202001;5755;14535;5150;13767;303;658;4192;11403;4495;12061
260460;202001;5282;15740;4488;14311;482;1722;2649;8276;3131;9998
260470;202001;4964;13025;4169;12095;89;220;3782;11156;3871;11376
260480;202001;4009;10643;3347;9685;209;771;2320;6711;2529;7482
260490;202001;5380;12360;4732;11393;42;161;4268;10086;4310;10247
260500;202001;6179;15515;5291;14243;460;1168;3685;10027;4145;11195
260510;202001;9682;23945;8084;21720;124;484;7091;18878;7215;19362
260515;202001;4247;11668;3282;9831;138;422;2167;6306;2305;6728
260520;202001;17364;40188;15154;37331;839;2044;12171;29586;13010;31630
260530;202001;9840;28069;8375;25805;165;794;7100;21551;7265;22345
260540;202001;7236;15653;6386;14574;172;388;5675;12853;5847;13241
260545;202001;53;164;22;85;2;7;6;20;8;27
260550;202001;3064;8535;2506;7599;121;498;1667;4940;1788;5438
260560;202001;6040;15374;5073;13983;134;534;4206;11342;4340;11876
260570;202001;7804;21181;6832;19857;406;1286;5307;15478;5713;16764
260580;202001;4516;10681;4025;10024;22;82;3679;9136;3701;9218
260590;202001;6770;15642;5653;14388;220;558;4690;12047;4910;12605
260600;202001;30897;80140;25012;70998;1141;3631;18677;52082;19818;55713
260610;202001;7263;18813;6506;17811;399;1208;4830;13085;5229;14293
260620;202001;16215;42322;14156;39312;1337;4188;10101;27451;11438;31639
260630;202001;2414;6462;1948;5713;33;141;1563;4473;1596;4614
260640;202001;21393;48832;17955;44851;832;2104;14338;35528;15170;37632
260650;202001;6061;15927;4781;14353;154;636;4047;12062;4201;12698
260660;202001;7201;18966;6146;17555;162;710;5203;14522;5365;15232
260670;202001;2198;5738;1816;5170;75;186;1339;3773;1414;3959
260680;202001;27706;66331;23241;59910;1656;4562;16141;40769;17797;45331
260690;202001;3613;9311;2939;8282;103;386;2280;6375;2383;6761
260700;202001;6078;17482;5702;17047;22;69;5505;16596;5527;16665
260710;202001;1357;3610;1179;3366;40;151;898;2571;938;2722
260720;202001;22899;58275;20048;54315;2081;5830;14103;37758;16184;43588
260730;202001;7595;22016;6631;20655;283;1064;5466;16739;5749;17803
260740;202001;1342;3771;1116;3410;9;53;885;2764;894;2817
260750;202001;7076;19486;5908;18004;113;379;5234;16202;5347;16581
260760;202001;5694;13483;4882;12511;196;549;3966;10194;4162;10743
260765;202001;7957;23049;6906;21573;418;1761;4850;14798;5268;16559
260770;202001;3862;9877;3227;8817;106;361;2523;6789;2629;7150
260775;202001;5300;14096;4661;13116;204;753;3586;9735;3790;10488
260780;202001;3627;10750;3214;10078;289;1085;2058;6241;2347;7326
260790;202001;120009;269413;99328;242135;15196;36058;60655;148012;75851;184070
260795;202001;3058;7857;2602;7240;95;326;1994;5571;2089;5897
260800;202001;5442;12624;4851;11819;139;441;4209;9912;4348;10353
260805;202001;3657;10365;3064;9305;164;594;2261;6734;2425;7328
260810;202001;6663;17957;5818;16334;496;1328;4139;11392;4635;12720
260820;202001;4454;10491;3914;9845;118;415;3216;7932;3334;8347
260825;202001;2959;8799;2553;8099;108;395;1876;5874;1984;6269
260830;202001;4307;12502;3575;11167;462;1289;2245;7210;2707;8499
260840;202001;4211;10971;3754;10333;214;545;3078;8505;3292;9050
260845;202001;4272;11333;3810;10528;235;642;2834;7760;3069;8402
260850;202001;4957;13687;4130;12075;347;1089;2665;7539;3012;8628
260860;202001;3532;9919;2978;8957;96;344;2356;6910;2452;7254
260870;202001;4562;10949;3888;10125;76;302;3440;8807;3516;9109
260875;202001;6983;17341;5714;15452;586;1596;3857;10444;4443;12040
260880;202001;9932;27690;8587;25343;505;1507;6652;19632;7157;21139
260890;202001;13262;34044;11462;31272;631;1877;8258;21982;8889;23859
260900;202001;5366;15134;4427;13744;322;1123;2908;8943;3230;10066
260910;202001;3196;8734;2758;8058;99;320;2157;6264;2256;6584
260915;202001;5183;15185;4544;14433;55;281;4122;13106;4177;13387
260920;202001;3332;8287;2808;7713;88;248;2373;6571;2461;6819
260930;202001;3736;11736;3196;10768;183;742;2338;7706;2521;8448
260940;202001;14674;35185;12731;32397;978;2499;9457;23679;10435;26178
260950;202001;6838;18324;5511;16006;369;1242;3494;9693;3863;10935
260960;202001;69709;156782;55916;138807;6239;16061;35010;85561;41249;101622
260970;202001;5515;14558;4885;13703;231;559;3690;10432;3921;10991
260980;202001;4560;13249;4025;12573;62;218;3645;11513;3707;11731
260990;202001;18183;50129;15269;46162;874;2955;11722;35137;12596;38092
261000;202001;16363;38652;13697;35168;405;1450;10918;27309;11323;28759
261010;202001;2418;6276;2108;5860;76;195;1824;5098;1900;5293
261020;202001;6243;16867;5306;15249;209;753;4230;11686;4439;12439
261030;202001;4099;11746;3513;10762;134;554;2759;8204;2893;8758
261040;202001;5236;15334;4207;13321;164;663;3096;9576;3260;10239
261050;202001;7830;20444;7089;19267;451;954;5283;14418;5734;15372
261060;202001;14193;35489;12342;33221;291;970;10197;27166;10488;28136
261070;202001;63611;138881;52591;124235;2826;6646;39851;92145;42677;98791
261080;202001;6602;15929;6014;15174;138;346;5512;13876;5650;14222
261090;202001;18909;45118;16742;42322;311;1113;14471;35938;14782;37051
261100;202001;8395;23281;7234;21549;517;1657;5215;15542;5732;17199
261110;202001;63700;178309;53100;159347;7961;25061;30069;89636;38030;114697
261120;202001;3794;9399;3241;8651;92;234;2761;7395;2853;7629
261130;202001;7391;18021;6475;16791;132;389;5664;14576;5796;14965
261140;202001;3628;8369;3228;7839;170;453;2580;6159;2750;6612
261150;202001;5392;14028;4738;13048;79;307;4105;11165;4184;11472
261153;202001;1898;5681;1615;5135;63;234;1092;3479;1155;3713
261160;202001;210256;490546;170241;434399;41424;108862;69484;180136;110908;288998
261170;202001;6062;15099;5354;14029;340;819;4227;11009;4567;11828
261180;202001;9709;24191;8478;22552;448;1214;6107;16257;6555;17471
261190;202001;4612;13542;4103;12679;214;892;3141;9403;3355;10295
261200;202001;3402;7867;3034;7370;135;363;2513;5974;2648;6337
261210;202001;1938;4648;1626;4217;62;191;1360;3454;1422;3645
261220;202001;13968;39372;11542;34836;1442;4698;6528;19375;7970;24073
261230;202001;4098;11694;3422;10742;59;240;2818;8920;2877;9160
261240;202001;5348;13407;4660;12311;259;702;3823;9953;4082;10655
261245;202001;3594;10131;3011;9102;77;361;2372;6936;2449;7297
261247;202001;2923;8752;2413;7814;144;532;1651;5285;1795;5817
261250;202001;22102;50615;19088;47087;1686;3765;14405;36435;16091;40200
261255;202001;4089;12010;3324;10533;138;603;2422;7429;2560;8032
261260;202001;12928;34618;11106;32262;351;1466;9470;27118;9821;28584
261270;202001;4318;10849;3788;10156;169;514;3143;8284;3312;8798
261280;202001;2570;7145;2254;6601;69;253;1785;5102;1854;5355
261290;202001;2952;7647;2492;7113;72;294;2003;5753;2075;6047
261300;202001;12227;34352;10282;30978;608;2193;7325;21578;7933;23771
261310;202001;8877;22632;7528;20754;679;2108;5402;14483;6081;16591
261320;202001;6034;17038;5235;15698;88;397;4346;12811;4434;13208
261330;202001;6008;14670;5399;13864;133;474;4659;11726;4792;12200
261340;202001;4249;12031;3677;11274;157;580;2961;8986;3118;9566
261350;202001;8831;25628;7841;23978;123;577;6366;19145;6489;19722
261360;202001;8301;20049;6999;18197;233;723;5535;13959;5768;14682
261370;202001;23170;58250;19494;53106;2144;5800;12464;34148;14608;39948
261380;202001;4057;12240;3579;11404;452;1552;2319;7273;2771;8825
261390;202001;16638;47292;13948;42891;1199;4023;9134;27876;10333;31899
261400;202001;4666;14789;4024;13418;164;754;2985;9678;3149;10432
261410;202001;9610;24078;7880;21368;521;1468;6056;16090;6577;17558
261420;202001;7447;22334;6705;21411;796;2928;4658;14761;5454;17689
261430;202001;3485;9782;2904;8855;63;267;2395;7194;2458;7461
261440;202001;1464;4350;1222;3883;42;207;872;2632;914;2839
261450;202001;15171;40879;13385;38068;218;824;10993;31234;11211;32058
261460;202001;7581;20848;6684;19469;182;691;5473;15771;5655;16462
261470;202001;4243;10532;3695;9816;27;140;3143;8329;3170;8469
261480;202001;5112;15656;4395;14439;200;830;3370;10810;3570;11640
261485;202001;5080;14355;4334;13178;367;1209;3008;8993;3375;10202
261500;202001;5890;15131;5141;14110;374;913;3558;10135;3932;11048
261510;202001;1901;5661;1638;5217;64;241;1214;3925;1278;4166
261520;202001;2398;7328;2156;6822;80;287;1535;4856;1615;5143
261530;202001;11749;34562;9513;30387;967;3718;4734;14503;5701;18221
261540;202001;8160;23325;7328;22124;1068;3205;4122;13068;5190;16273
261550;202001;3657;9716;3153;8923;224;705;2247;6219;2471;6924
261560;202001;7911;23401;6805;21741;317;1192;5129;16410;5446;17602
261570;202001;3516;9426;2807;8278;207;733;1902;5492;2109;6225
261580;202001;6686;17602;5827;16451;123;581;5167;14369;5290;14950
261590;202001;2694;6888;2142;6102;69;221;1604;4519;1673;4740
261600;202001;5116;13025;4278;11758;328;819;2933;8312;3261;9131
261610;202001;2281;6360;1828;5561;91;347;1247;3741;1338;4088
261618;202001;2557;6399;2213;5894;63;191;1779;4686;1842;4877
261620;202001;4190;11776;3820;11236;889;2346;2298;7137;3187;9483
261630;202001;6424;17929;5413;16013;371;1319;3588;10183;3959;11502
261640;202001;37446;83910;31895;77030;1759;3527;24089;59692;25848;63219
261650;202001;4179;10337;3570;9529;155;497;2657;7031;2812;7528
270010;202001;4354;14597;3730;13509;170;964;2908;10247;3078;11211
270020;202001;3925;9852;3410;9189;149;513;2879;7581;3028;8094
270030;202001;33184;90493;27741;81728;3679;10695;18195;53700;21874;64395
270040;202001;10983;29442;9400;27574;373;1478;7734;22425;8107;23903
270050;202001;5609;12860;4753;11891;212;499;4149;10441;4361;10940
270060;202001;2115;5414;1757;5004;115;311;1421;4094;1536;4405
270070;202001;4665;13089;4045;12212;152;574;3365;9966;3517;10540
270080;202001;1439;3917;1196;3505;44;136;911;2558;955;2694
270090;202001;1817;5521;1615;5135;69;297;1302;4018;1371;4315
270100;202001;5551;14749;4789;13622;170;651;3908;10861;4078;11512
270110;202001;3290;7746;2631;6965;127;326;2062;5692;2189;6018
270120;202001;2840;7679;2451;7161;74;320;2058;5920;2132;6240
270130;202001;5140;13241;4444;12419;129;423;3791;10610;3920;11033
270135;202001;2022;4855;1709;4505;53;160;1527;4011;1580;4171
270140;202001;9801;22701;7819;19950;315;1113;6161;14950;6476;16063
270150;202001;2733;8152;2507;7829;5;34;2364;7358;2369;7392
270160;202001;6217;16828;5250;15730;55;335;4830;14404;4885;14739
270170;202001;3426;9977;2879;9215;191;897;2146;6588;2337;7485
270180;202001;2278;6990;2063;6714;42;207;1834;5918;1876;6125
270190;202001;1662;4932;1468;4689;40;197;1269;4017;1309;4214
270200;202001;2412;7314;2086;6867;115;457;1514;4926;1629;5383
270210;202001;5754;13560;4909;12612;84;342;4487;11335;4571;11677
270220;202001;1448;3816;1143;3384;204;628;639;1870;843;2498
270230;202001;9395;26085;7729;23502;665;2261;5395;16191;6060;18452
270235;202001;5832;17882;5031;16592;133;600;4075;13272;4208;13872
270240;202001;10800;29454;8678;26512;843;2894;6147;18706;6990;21600
270250;202001;2792;7046;2420;6516;192;509;1876;5058;2068;5567
270255;202001;4507;12894;3482;11006;113;466;2604;8093;2717;8559
270260;202001;5665;16645;5127;15756;108;552;4448;13311;4556;13863
270270;202001;1054;2740;881;2523;117;344;627;1780;744;2124
270280;202001;3984;9431;3144;8374;478;769;2183;6282;2661;7051
270290;202001;7584;24076;6768;22703;191;891;5771;19154;5962;20045
270300;202001;4216;10995;3280;9972;156;434;2522;7840;2678;8274
270310;202001;7024;19554;6016;18028;117;604;5086;14821;5203;15425
270320;202001;5571;16235;4827;14833;465;1486;3370;10112;3835;11598
270330;202001;3912;12745;3450;12045;277;1113;2600;9038;2877;10151
270340;202001;1622;4418;1402;4129;54;173;1161;3375;1215;3548
270350;202001;1831;4392;1505;4000;152;457;1037;2773;1189;3230
270360;202001;2585;6532;2294;6203;72;194;2098;5679;2170;5873
270370;202001;1377;4298;1253;4060;42;206;1017;3233;1059;3439
270375;202001;3111;7221;2578;6630;18;51;2420;6240;2438;6291
270380;202001;5481;15596;4599;14434;618;1907;2915;9519;3533;11426
270390;202001;1206;3025;987;2769;23;100;807;2254;830;2354
270400;202001;6292;16664;5260;15079;229;707;4078;11518;4307;12225
270410;202001;4629;13371;4001;12390;172;615;3282;10107;3454;10722
270420;202001;5557;16423;4988;15591;128;621;4285;13126;4413;13747
270430;202001;139850;334164;110133;295864;22007;61728;51021;138950;73028;200678
270440;202001;4799;12929;4121;12095;90;402;3546;10263;3636;10665
270450;202001;6979;18831;6138;17812;246;901;5129;14875;5375;15776
270460;202001;3798;8364;3267;7742;121;275;2952;6947;3073;7222
270470;202001;11206;31196;9687;29008;721;2404;7282;21777;8003;24181
270480;202001;2959;7855;2505;7207;109;426;2007;5626;2116;6052
270490;202001;960;2671;830;2510;50;172;660;1965;710;2137
270500;202001;4951;15151;4383;14218;296;1117;3349;10728;3645;11845
270510;202001;5652;15006;4764;13848;344;1392;3534;9774;3878;11166
270520;202001;3848;11052;3018;9611;643;2128;1217;4010;1860;6138
270530;202001;1228;3548;1053;3283;53;158;748;2363;801;2521
270540;202001;2198;6367;1893;5972;64;305;1628;5024;1692;5329
270550;202001;6772;17422;5392;15901;581;1405;4018;12327;4599;13732
270560;202001;3002;7830;2600;7287;144;460;2065;5721;2209;6181
270570;202001;4168;11718;3524;10739;114;405;2833;8550;2947;8955
270580;202001;2303;6489;2085;6172;96;291;1781;5234;1877;5525
270590;202001;1619;4842;1490;4675;17;91;1401;4369;1418;4460
270600;202001;2762;8504;2487;8089;52;275;2185;7006;2237;7281
270610;202001;3712;9647;3169;8926;79;297;2810;7829;2889;8126
270620;202001;1200;3708;1097;3505;34;156;930;2887;964;3043
270630;202001;17623;43036;15128;39569;600;1905;12600;32205;13200;34110
270640;202001;5427;15559;4672;14349;163;659;3778;11343;3941;12002
270642;202001;2516;8083;2222;7593;158;685;1687;5617;1845;6302
270644;202001;3631;9015;2961;8134;270;667;2213;6229;2483;6896
270650;202001;3140;9253;2748;8687;385;1311;1892;5908;2277;7219
270660;202001;2052;5163;1688;4639;82;308;1254;3387;1336;3695
270670;202001;16217;37580;13472;34224;423;1320;11372;28252;11795;29572
270680;202001;5470;13188;4853;12512;126;186;4517;11816;4643;12002
270690;202001;9016;22439;7454;20493;606;1610;5640;15532;6246;17142
270700;202001;530;1575;461;1464;30;127;338;1053;368;1180
270710;202001;5515;16626;4904;15701;232;987;3942;12356;4174;13343
270720;202001;3504;10427;3085;9710;68;375;2692;8289;2760;8664
270730;202001;8230;18253;7214;17153;237;495;5660;14865;5897;15360
270740;202001;2373;6212;2089;5877;97;339;1728;4765;1825;5104
270750;202001;5684;15090;4952;14144;103;455;4309;12236;4412;12691
270760;202001;3315;9359;2868;8755;57;291;2406;7245;2463;7536
270770;202001;21097;51272;16723;45906;2571;6407;10341;29970;12912;36377
270780;202001;1737;5020;1591;4808;105;383;1270;3767;1375;4150
270790;202001;1579;4456;1325;4087;101;340;927;2830;1028;3170
270800;202001;10836;29847;9675;28198;361;1352;8203;23436;8564;24788
270810;202001;3293;9383;2574;8148;176;666;1791;5567;1967;6233
270820;202001;1681;5012;1408;4557;56;260;1083;3420;1139;3680
270830;202001;5228;12453;4223;11221;172;572;3382;8831;3554;9403
270840;202001;8270;24529;7362;23252;190;1078;6423;19700;6613;20778
270850;202001;9077;21570;8025;20301;650;1893;6594;16345;7244;18238
270860;202001;13491;30825;10828;27733;476;1346;8828;22327;9304;23673
270870;202001;2141;6058;1779;5464;228;711;1167;3640;1395;4351
270880;202001;8172;24404;7269;23029;232;999;5979;18599;6211;19598
270890;202001;2778;7557;2342;6933;181;567;1633;4810;1814;5377
270895;202001;3061;9565;2788;9197;78;416;2446;7904;2524;8320
270900;202001;1794;4623;1347;3902;41;120;1046;3020;1087;3140
270910;202001;3944;11448;3366;10500;105;390;2678;8235;2783;8625
270915;202001;9341;26902;7563;23933;670;2492;5091;15720;5761;18212
270920;202001;5187;16157;4667;15271;175;853;3792;11975;3967;12828
270930;202001;17388;40536;13446;35914;1885;4582;9004;25075;10889;29657
270940;202001;6512;17261;5575;16126;193;943;4498;12610;4691;13553
280010;202001;673;1856;536;1568;15;61;379;994;394;1055
280020;202001;4807;12276;4092;11144;499;1246;2694;7441;3193;8687
280030;202001;75056;176748;58719;153493;12594;33299;25493;69507;38087;102806
280040;202001;2965;8305;2577;7710;252;815;1719;5072;1971;5887
280050;202001;3938;11184;3381;10278;573;1812;1975;5989;2548;7801
280060;202001;5680;15028;4529;13241;811;2520;2181;6615;2992;9135
280067;202001;6938;17313;5870;15704;321;880;4255;11157;4576;12037
280070;202001;1976;5823;1829;5586;123;376;1493;4520;1616;4896
280100;202001;3987;10665;3334;9605;326;989;2293;6566;2619;7555
280110;202001;1385;3764;1204;3492;20;92;1052;2974;1072;3066
280120;202001;7570;21951;6746;20621;750;2151;4907;15320;5657;17471
280130;202001;9147;21481;7990;19818;448;1179;6397;15751;6845;16930
280140;202001;5586;13325;4886;12395;216;621;4102;10295;4318;10916
280150;202001;4074;10188;3525;9487;270;701;2795;7534;3065;8235
280160;202001;1250;3565;1034;3195;101;343;686;2060;787;2403
280170;202001;5253;13780;4682;13022;240;670;3741;10422;3981;11092
280190;202001;1257;2793;1076;2548;53;137;856;1971;909;2108
280200;202001;1305;3402;1056;3036;91;317;750;2103;841;2420
280210;202001;16449;41346;14250;38150;1583;4420;9068;24216;10651;28636
280220;202001;1778;4760;1514;4394;42;208;1236;3554;1278;3762
280230;202001;4198;10582;3532;9614;274;674;2538;6930;2812;7604
280240;202001;3369;8962;3015;8432;58;303;2561;6928;2619;7231
280250;202001;879;2184;704;1918;58;186;459;1205;517;1391
280260;202001;2139;5214;1906;4933;36;99;1738;4528;1774;4627
280270;202001;2325;6430;2055;6005;116;388;1703;4892;1819;5280
280280;202001;4237;12598;3757;11903;468;1309;2626;8681;3094;9990
280290;202001;18189;48026;15533;44256;1378;4245;10322;29576;11700;33821
280300;202001;11705;28670;10170;27002;289;846;7710;22147;7999;22993
280310;202001;1370;3516;1127;3097;32;113;847;2257;879;2370
280320;202001;8706;23509;7522;21720;849;2524;5007;14238;5856;16762
280330;202001;4728;11701;3988;10656;273;751;2885;7627;3158;8378
280340;202001;5547;11576;4627;10580;218;397;3995;9275;4213;9672
280350;202001;26010;61161;22612;56618;1162;3165;17586;43275;18748;46440
280360;202001;5830;16184;5064;14884;782;2333;2922;8668;3704;11001
280370;202001;2202;5426;1814;4771;60;161;1417;3659;1477;3820
280380;202001;984;2695;833;2486;71;224;555;1659;626;1883
280390;202001;3684;9127;3035;8078;134;354;2398;6324;2532;6678
280400;202001;3935;9973;3370;9176;507;1240;2026;5812;2533;7052
280410;202001;2270;6321;1815;5564;197;636;1041;3118;1238;3754
280420;202001;4378;11695;3982;11183;81;304;3609;10071;3690;10375
280430;202001;2069;5042;1803;4690;65;250;1448;3630;1513;3880
280440;202001;4282;11526;3733;10699;158;554;3107;8679;3265;9233
280445;202001;2297;5817;2038;5363;52;164;1548;3899;1600;4063
280450;202001;10398;23849;9071;22070;901;1817;6407;16143;7308;17960
280460;202001;6939;16497;6245;15520;376;908;5231;12856;5607;13764
280470;202001;1703;4850;1465;4426;59;216;1071;3152;1130;3368
280480;202001;42389;103128;36518;94860;2926;8295;25867;65703;28793;73998
280490;202001;3698;10504;3189;9627;104;449;2441;7118;2545;7567
280500;202001;993;2371;842;2169;35;132;701;1763;736;1895
280510;202001;2564;6593;2204;6074;82;312;1679;4498;1761;4810
280520;202001;1630;4151;1422;3871;66;182;1130;3033;1196;3215
280530;202001;2556;6369;2182;5849;303;689;1504;4144;1807;4833
280540;202001;9078;24293;8199;23009;262;912;7115;19674;7377;20586
280550;202001;6701;15621;5439;13809;212;753;4389;10717;4601;11470
280560;202001;7155;20016;6681;19294;139;557;5846;16675;5985;17232
280570;202001;6557;15916;5300;14311;220;706;3912;10467;4132;11173
280580;202001;5628;15145;4822;13917;559;1485;3351;9803;3910;11288
280590;202001;2968;6663;2507;6127;113;422;1960;4575;2073;4997
280600;202001;3637;9691;3185;9035;169;544;2253;6375;2422;6919
280610;202001;2492;6128;2238;5747;139;351;1819;4640;1958;4991
280620;202001;5445;13380;4630;12296;416;924;3216;8916;3632;9840
280630;202001;3856;10896;3494;10369;170;602;2820;8282;2990;8884
280640;202001;2408;6444;2117;6111;61;191;1872;5402;1933;5593
280650;202001;1206;3159;960;2790;93;312;685;1910;778;2222
280660;202001;3530;7900;3039;7302;167;363;2560;6204;2727;6567
280670;202001;19945;44845;17135;41230;904;2333;13596;32400;14500;34733
280680;202001;2817;6737;2395;6139;224;422;1710;4446;1934;4868
280690;202001;927;2320;772;2108;32;103;593;1589;625;1692
280700;202001;1160;2920;993;2664;25;98;779;2051;804;2149
280710;202001;15340;34444;12873;31637;494;1007;10940;27474;11434;28481
280720;202001;2694;6085;2215;5521;68;214;1541;4016;1609;4230
280730;202001;1055;2714;939;2521;45;142;714;1861;759;2003
280740;202001;14263;34811;12063;31435;769;2143;8554;21776;9323;23919
280750;202001;3609;10089;3138;9262;177;592;2246;6506;2423;7098
280760;202001;6402;17160;5550;15831;564;1485;3688;10833;4252;12318
290010;202001;3199;6699;2080;4949;7;25;1691;3834;1698;3859
290020;202001;5476;14464;4942;13774;355;692;4123;11901;4478;12593
290030;202001;4480;10431;3638;9498;167;425;3061;8050;3228;8475
290035;202001;5263;11480;4281;10203;398;633;3315;8273;3713;8906
290040;202001;4268;10380;3603;9581;119;309;2827;7864;2946;8173
290050;202001;2046;6553;1714;5840;126;508;1132;3760;1258;4268
290060;202001;1325;3190;962;2608;73;241;631;1679;704;1920
290070;202001;37308;81824;31905;75037;1852;4584;24415;56760;26267;61344
290080;202001;5475;16017;4665;14794;463;1614;3217;10299;3680;11913
290090;202001;2180;4185;1533;3493;19;58;1396;3153;1415;3211
290100;202001;10010;26183;8092;23257;1319;3576;4331;13021;5650;16597
290110;202001;5278;13948;4669;12949;352;1018;3309;9098;3661;10116
290115;202001;3992;11541;3341;10376;221;749;2475;7647;2696;8396
290120;202001;6581;16258;5495;14761;143;497;4677;12350;4820;12847
290130;202001;4742;11471;3700;10119;161;474;2864;7806;3025;8280
290135;202001;4305;10070;3483;8723;205;524;2650;6443;2855;6967
290140;202001;4558;11992;3541;10643;103;405;2961;8818;3064;9223
290150;202001;2502;6473;2137;6011;143;408;1631;4588;1774;4996
290160;202001;3256;7644;2870;7113;320;679;2165;5426;2485;6105
290170;202001;3414;8639;2998;8177;116;326;2649;7285;2765;7611
290180;202001;3002;8196;2458;7302;82;299;1977;5824;2059;6123
290190;202001;4209;11980;3674;11257;150;655;2999;9022;3149;9677
290195;202001;2432;5937;1903;5223;29;154;1589;4315;1618;4469
290200;202001;4166;11517;3371;10199;215;724;2523;7564;2738;8288
290205;202001;3421;8804;3002;8189;133;483;2336;6143;2469;6626
290210;202001;13469;37150;11770;34586;937;2491;8877;26633;9814;29124
290220;202001;2867;7140;2512;6685;122;345;2045;5405;2167;5750
290225;202001;3332;7073;2571;6267;163;287;2143;5330;2306;5617
290230;202001;2504;6584;2265;6300;32;104;2023;5604;2055;5708
290240;202001;3714;9349;2962;8383;79;282;2486;7006;2565;7288
290250;202001;4071;11801;3408;10820;123;422;2741;8867;2864;9289
290260;202001;5434;13453;4421;12005;180;645;3605;9535;3785;10180
290265;202001;3482;10225;2800;8911;163;618;2032;6374;2195;6992
290270;202001;11318;38315;10567;37007;551;2442;8386;29031;8937;31473
290280;202001;6107;18301;5254;16621;304;1088;3733;11644;4037;12732
290290;202001;10013;29110;8064;25489;801;2755;5216;16274;6017;19029
290300;202001;4316;11650;3167;9459;166;543;2239;6657;2405;7200
290310;202001;1596;3969;1283;3582;64;265;975;2631;1039;2896
290320;202001;25021;65221;19692;56978;4341;12373;9156;27915;13497;40288
290323;202001;3822;10322;3305;9537;102;327;2600;7461;2702;7788
290327;202001;4209;12185;3557;10919;264;766;2482;7574;2746;8340
290330;202001;2214;4638;1718;4097;45;80;1517;3657;1562;3737
290340;202001;5758;14516;4426;12862;475;1430;3133;9257;3608;10687
290350;202001;4810;13287;3951;11834;269;821;2804;8439;3073;9260
290360;202001;5069;13303;4430;12467;131;386;3819;10787;3950;11173
290370;202001;5286;12816;3880;10977;177;432;2827;8155;3004;8587
290380;202001;5731;15132;4765;13808;119;316;4057;11971;4176;12287
290390;202001;14822;41652;12244;37640;1281;3845;7996;25029;9277;28874
290395;202001;2856;8308;2288;7316;71;336;1742;5462;1813;5798
290400;202001;3820;10197;3042;8917;85;370;2312;6589;2397;6959
290405;202001;4624;13528;3907;12270;298;987;2680;8572;2978;9559
290410;202001;5805;15859;4438;13622;110;528;3357;10003;3467;10531
290420;202001;3016;8421;2465;7542;73;270;1886;5726;1959;5996
290430;202001;3172;8715;2587;7802;241;778;1706;5081;1947;5859
290440;202001;2825;7115;2001;5817;38;123;1405;4172;1443;4295
290450;202001;3445;8888;2696;7765;149;440;2003;5782;2152;6222
290460;202001;11967;33549;10029;29863;2019;6144;4480;13254;6499;19398
290470;202001;4588;11335;3382;9643;383;1208;1910;5505;2293;6713
290475;202001;6586;19040;5485;17085;107;563;4403;13400;4510;13963
290480;202001;1796;4543;1466;4055;87;295;1000;2640;1087;2935
290485;202001;4571;13326;4013;12527;114;579;3385;10357;3499;10936
290490;202001;9349;21843;8304;20410;535;1218;6433;16029;6968;17247
290500;202001;4021;12098;3081;10036;544;1849;1341;4247;1885;6096
290510;202001;3491;8683;2881;7885;74;261;2465;6681;2539;6942
290515;202001;3772;10289;3219;9539;50;145;2845;8612;2895;8757
290520;202001;11592;32956;8896;27730;546;1864;5447;16725;5993;18589
290530;202001;4991;14253;4203;12957;135;509;3510;10788;3645;11297
290540;202001;3491;9201;3119;8766;72;242;2842;7950;2914;8192
290550;202001;4355;11323;3747;10612;12;59;3436;9853;3448;9912
290560;202001;6553;16931;4958;14549;426;1528;3233;9156;3659;10684
290570;202001;44889;110117;39829;103665;2510;6761;31784;82112;34294;88873
290580;202001;7995;23259;6889;21651;648;2024;4934;15890;5582;17914
290590;202001;7107;21864;6000;19875;141;586;4833;16076;4974;16662
290600;202001;18899;52436;16633;48762;704;2207;13245;38787;13949;40994
290610;202001;2549;7991;1976;6802;96;400;1370;4665;1466;5065
290620;202001;6568;18326;5625;16755;211;620;4668;13871;4879;14491
290630;202001;9327;22538;7374;19981;575;1524;5638;15417;6213;16941
290640;202001;2784;7192;2126;6224;80;248;1544;4550;1624;4798
290650;202001;13081;32772;11576;31031;2657;6834;6933;19468;9590;26302
290660;202001;3702;9492;3074;8577;51;134;2300;6670;2351;6804
290670;202001;6758;18759;5688;16985;385;1094;4329;13063;4714;14157
290680;202001;10830;30076;9070;27458;198;1076;7435;21990;7633;23066
290682;202001;4789;12429;4132;11548;132;327;3470;9789;3602;10116
290685;202001;3430;7759;2468;6391;191;474;1546;4264;1737;4738
290687;202001;6696;18056;5390;15894;708;2008;3391;10253;4099;12261
290689;202001;2858;7981;2210;6799;127;380;1608;4976;1735;5356
290690;202001;5715;14713;4593;13117;341;1053;3280;9221;3621;10274
290700;202001;2630;7178;2311;6769;72;245;1909;5617;1981;5862
290710;202001;8418;23619;7146;21848;151;645;5995;18354;6146;18999
290720;202001;19021;51834;17156;48976;947;3060;13541;38069;14488;41129
290730;202001;7188;17116;6115;15855;300;626;4758;12508;5058;13134
290740;202001;1049;2845;788;2407;35;131;630;1928;665;2059
290750;202001;11323;28252;9737;25661;681;1939;7087;18078;7768;20017
290755;202001;2117;5943;1691;5147;93;295;1163;3566;1256;3861
290760;202001;3849;11166;3067;9664;201;596;2038;6579;2239;7175
290770;202001;2635;8480;2401;8187;52;276;1997;6907;2049;7183
290780;202001;8407;20660;7200;19057;282;625;5605;15156;5887;15781
290790;202001;4718;12877;4074;11987;162;479;3383;10094;3545;10573
290800;202001;7267;15030;5135;12509;312;725;3776;9278;4088;10003
290810;202001;5575;14562;4423;12855;116;380;3283;9724;3399;10104
290820;202001;4918;13214;4399;12461;182;536;3305;9505;3487;10041
290830;202001;4608;10447;4084;9779;34;101;3564;8408;3598;8509
290840;202001;17305;45810;14813;41910;1911;4484;9447;28367;11358;32851
290850;202001;6648;16070;5954;15319;252;635;5035;13092;5287;13727
290860;202001;6158;17681;5351;16730;228;738;4478;14302;4706;15040
290870;202001;4894;13411;3672;11129;121;415;2579;7734;2700;8149
290880;202001;1410;3521;1109;3122;65;178;776;2245;841;2423
290890;202001;9365;18866;8335;17700;174;382;7774;16423;7948;16805
290900;202001;2356;6191;1760;5176;97;269;1098;3195;1195;3464
290910;202001;5199;12418;3927;10510;46;158;3290;8722;3336;8880
290920;202001;5125;12896;4640;12324;47;105;4360;11678;4407;11783
290930;202001;7867;21880;6242;19038;199;896;4830;14281;5029;15177
290940;202001;3784;10526;3086;9515;161;634;2430;7491;2591;8125
290950;202001;1505;3760;1213;3330;64;183;848;2333;912;2516
290960;202001;5581;14578;4958;13793;171;447;4151;11570;4322;12017
290970;202001;3486;10169;2814;8957;117;429;2124;6753;2241;7182
290980;202001;12475;29864;10399;26621;817;2275;6399;15891;7216;18166
290990;202001;9584;25497;8377;23544;271;1096;6972;18935;7243;20031
291000;202001;3412;8891;2655;7932;127;381;2154;6521;2281;6902
291005;202001;15603;38245;13670;35721;1199;2956;10638;27853;11837;30809
291010;202001;3005;9116;2416;7877;114;431;1589;5042;1703;5473
291020;202001;1287;3175;1025;2692;24;81;740;1837;764;1918
291030;202001;2509;6099;1728;4735;107;277;1070;2861;1177;3138
291040;202001;5478;15068;4579;13789;177;690;3560;10679;3737;11369
291050;202001;7790;20472;6672;18891;701;2215;4707;13071;5408;15286
291060;202001;6048;18554;5166;17345;329;1392;3878;12941;4207;14333
291070;202001;16027;43184;13276;38756;441;1573;10694;30959;11135;32532
291072;202001;24966;64249;17936;51930;3315;9927;7508;22004;10823;31931
291075;202001;5371;13369;4784;12459;111;309;3946;10072;4057;10381
291077;202001;1583;4134;1225;3512;41;99;867;2482;908;2581
291080;202001;97588;248047;76696;218249;23664;69072;20119;61378;43783;130450
291085;202001;5694;14364;4768;12966;198;626;3955;10677;4153;11303
291090;202001;2012;3746;1451;3123;39;85;1184;2523;1223;2608
291100;202001;3224;7056;2218;5851;111;319;1684;4378;1795;4697
291110;202001;6026;17854;5084;16231;333;1372;3788;11624;4121;12996
291120;202001;7769;18975;6554;17416;320;926;4968;13156;5288;14082
291125;202001;2209;3880;1630;3235;109;160;1268;2596;1377;2756
291130;202001;3215;9195;2382;7542;75;346;1721;5255;1796;5601
291140;202001;4832;13088;3532;10702;425;1137;2169;6614;2594;7751
291150;202001;2457;5347;1901;4720;6;22;1780;4399;1786;4421
291160;202001;5259;14325;4304;12920;403;1256;2812;8390;3215;9646
291165;202001;2159;5907;1631;4895;40;174;1170;3369;1210;3543
291170;202001;21266;53793;17692;47722;965;2863;11501;30501;12466;33364
291180;202001;6249;14561;4561;12252;293;742;3463;9344;3756;10086
291185;202001;3138;8468;2741;7821;91;281;2084;5938;2175;6219
291190;202001;7702;18931;6351;17171;328;1019;4953;13325;5281;14344
291200;202001;2786;7674;2053;6285;98;334;1247;3685;1345;4019
291210;202001;7009;15196;5304;13216;146;483;3935;9837;4081;10320
291220;202001;4098;11641;3671;10989;192;707;2864;8455;3056;9162
291230;202001;4498;9680;3425;8500;44;100;3050;7657;3094;7757
291240;202001;4318;11046;3692;10005;69;234;3136;8367;3205;8601
291250;202001;3473;10178;2689;8742;166;537;1725;5622;1891;6159
291260;202001;1452;3380;1194;3045;35;106;959;2454;994;2560
291270;202001;5387;14069;4180;12273;628;1814;2612;7865;3240;9679
291280;202001;2556;6323;1901;5366;133;438;1220;3332;1353;3770
291290;202001;6002;15762;4631;13603;349;1109;3169;9229;3518;10338
291300;202001;3891;10435;2974;8925;110;401;2252;6651;2362;7052
291310;202001;5132;13701;4357;12273;108;365;3640;10084;3748;10449
291320;202001;6284;17392;4851;14715;1112;3157;2308;7458;3420;10615
291330;202001;1804;4557;1487;4024;85;238;1086;2893;1171;3131
291340;202001;4299;11111;3465;9660;87;277;2628;7190;2715;7467
291345;202001;2993;8954;2706;8509;116;411;2244;7051;2360;7462
291350;202001;6972;17256;5398;15309;69;222;4606;13324;4675;13546
291360;202001;38091;87238;29884;77190;2954;7738;19151;50549;22105;58287
291370;202001;7964;21901;7027;20468;511;1597;5166;14785;5677;16382
291380;202001;3475;9456;3042;8850;106;428;2495;7205;2601;7633
291390;202001;13348;28727;10351;25397;432;1083;8514;20829;8946;21912
291400;202001;14032;35914;11517;32106;1570;3873;6731;20247;8301;24120
291410;202001;2928;7671;2222;6460;38;164;1634;4654;1672;4818
291420;202001;1946;4800;1515;4263;33;133;1296;3640;1329;3773
291430;202001;2843;8017;2435;7339;94;411;1914;5601;2008;6012
291440;202001;6429;18427;5481;16847;320;1083;4277;13117;4597;14200
291450;202001;9103;22777;7498;20934;81;147;6565;18933;6646;19080
291460;202001;15698;41649;13713;38659;678;2176;10305;28780;10983;30956
291465;202001;9224;22879;7239;20589;153;695;6174;17434;6327;18129
291470;202001;16437;37028;13680;33928;701;1564;10132;25883;10833;27447
291480;202001;42219;93769;30876;78070;3682;9646;16077;40625;19759;50271
291490;202001;5679;14092;4894;13183;148;479;4383;11747;4531;12226
291500;202001;5098;12373;4198;11168;72;318;3780;9979;3852;10297
291510;202001;4291;10623;3200;9243;58;309;2644;7568;2702;7877
291520;202001;4602;10456;3460;8945;171;482;2648;6790;2819;7272
291530;202001;2298;5283;1613;4375;304;751;910;2718;1214;3469
291535;202001;3404;9958;3040;9316;178;490;2308;7241;2486;7731
291540;202001;2286;5122;1586;4277;62;222;1310;3460;1372;3682
291550;202001;5692;13064;4436;11453;408;886;3012;7937;3420;8823
291560;202001;19260;44859;13748;37731;1271;3397;8338;23804;9609;27201
291570;202001;2437;5791;1918;5146;55;144;1553;4336;1608;4480
291580;202001;6339;16410;4972;14579;221;730;3673;10664;3894;11394
291590;202001;2079;5191;1795;4845;81;306;1548;4072;1629;4378
291600;202001;5233;12616;3889;10515;365;1080;2558;6703;2923;7783
291610;202001;5807;15229;5241;14594;89;341;4775;13261;4864;13602
291620;202001;3188;7068;2341;6134;104;269;1810;4831;1914;5100
291630;202001;3248;7306;2410;6209;227;646;1748;4424;1975;5070
291640;202001;15858;39276;11934;33548;1774;4829;5227;15386;7001;20215
291650;202001;9621;23914;8444;22516;574;1113;7041;19270;7615;20383
291660;202001;2077;5123;1502;4227;130;446;965;2534;1095;2980
291670;202001;2111;5508;1776;5032;98;238;1341;3860;1439;4098
291680;202001;4150;10210;3342;9021;295;820;2333;6261;2628;7081
291685;202001;4768;11322;3779;10045;235;472;2840;7865;3075;8337
291690;202001;4256;9356;2896;7397;211;436;2217;5690;2428;6126
291700;202001;8734;25228;7627;23264;336;1246;6152;18388;6488;19634
291710;202001;5384;12792;3973;10803;220;696;2863;7627;3083;8323
291720;202001;4451;13564;3697;12046;389;1370;2428;7725;2817;9095
291730;202001;6447;16447;5531;15241;270;821;4527;12416;4797;13237
291733;202001;2941;7448;2471;6825;66;181;1785;5175;1851;5356
291735;202001;2954;7736;2343;6665;85;224;1748;4948;1833;5172
291740;202001;3914;10087;2890;8231;94;270;2083;5833;2177;6103
291750;202001;19926;47474;16090;41792;1508;3858;10781;28215;12289;32073
291760;202001;10534;30380;8238;26633;2447;8984;2202;7127;4649;16111
291770;202001;7140;19256;5891;17042;387;1197;4316;12181;4703;13378
291780;202001;5147;13689;4619;12924;88;341;4018;11117;4106;11458
291790;202001;2693;7552;2442;7230;238;629;1829;5567;2067;6196
291800;202001;29468;74427;21965;63088;3438;9584;10755;32061;14193;41645
291810;202001;10847;25728;8977;23441;258;682;7612;19912;7870;20594
291820;202001;3862;10139;3327;9432;97;316;2633;7488;2730;7804
291830;202001;4444;10510;3683;9485;192;456;2917;7545;3109;8001
291835;202001;6483;19353;5053;16571;575;2015;3154;10470;3729;12485
291840;202001;48923;133107;41917;122353;4597;14328;28806;83642;33403;97970
291845;202001;2513;6543;1992;5891;116;368;1578;4726;1694;5094
291850;202001;3965;11289;3262;10111;272;798;2300;7328;2572;8126
291855;202001;2166;4303;1679;3758;40;103;1513;3385;1553;3488
291860;202001;2263;5888;1559;4528;44;130;1047;2932;1091;3062
291870;202001;1333;3329;885;2552;50;148;584;1645;634;1793
291875;202001;2885;8630;2478;7786;70;285;1816;5546;1886;5831
291880;202001;5612;15845;4813;14525;229;669;3611;10927;3840;11596
291890;202001;1636;3374;1047;2683;127;296;704;1808;831;2104
291900;202001;1196;2927;911;2475;19;82;716;1883;735;1965
291905;202001;2564;6461;2051;5633;80;283;1533;4058;1613;4341
291910;202001;2978;7503;2505;6939;56;205;2159;6044;2215;6249
291915;202001;7480;21174;6059;18724;242;846;4517;14084;4759;14930
291920;202001;26928;70152;22785;64298;2299;7033;15431;42729;17730;49762
291930;202001;2557;6905;2172;6354;251;753;1416;4169;1667;4922
291940;202001;3982;10139;2613;7799;198;598;1510;4473;1708;5071
291950;202001;9379;28116;7926;25290;315;1166;5448;17183;5763;18349
291955;202001;15711;39436;13951;37162;1236;3431;10704;28614;11940;32045
291960;202001;3125;8191;2562;7405;122;365;1984;5854;2106;6219
291970;202001;4554;11490;3799;10511;138;472;2856;7907;2994;8379
291980;202001;9961;28258;7822;24600;807;2409;4930;15834;5737;18243
291990;202001;2247;5838;1885;5413;33;147;1745;4991;1778;5138
291992;202001;4057;9782;3151;8578;238;562;2462;6825;2700;7387
291995;202001;2121;5783;1708;5144;47;218;1307;3836;1354;4054
292000;202001;2679;6299;2153;5654;98;389;1671;4314;1769;4703
292010;202001;5945;13740;4778;12073;190;586;3920;9672;4110;10258
292020;202001;4567;13246;3761;11779;207;783;2719;8249;2926;9032
292030;202001;1841;5617;1680;5320;80;286;1064;3314;1144;3600
292040;202001;4381;11295;3427;9882;226;602;2599;7667;2825;8269
292045;202001;4009;10528;2982;9016;40;108;2603;8059;2643;8167
292050;202001;6590;18461;5271;16081;251;899;3339;10000;3590;10899
292060;202001;11721;27003;10717;25749;516;1172;9250;21965;9766;23137
292070;202001;5860;15176;5131;14296;294;851;4392;12146;4686;12997
292080;202001;3187;7960;2604;7215;82;270;2289;6310;2371;6580
292090;202001;4629;9983;3287;8373;252;676;2472;6348;2724;7024
292100;202001;10933;26619;9288;24534;997;2770;6307;16586;7304;19356
292105;202001;3504;8763;3045;8136;101;248;2463;6605;2564;6853
292110;202001;6004;14734;4209;11825;1001;2852;1887;5303;2888;8155
292120;202001;7020;17925;5745;15791;363;1076;4321;11631;4684;12707
292130;202001;3427;8202;2803;7427;104;317;2196;5739;2300;6056
292140;202001;5149;12094;4267;10775;308;778;3365;8447;3673;9225
292145;202001;2378;6841;1986;6165;57;162;1520;4764;1577;4926
292150;202001;14017;38342;12205;35392;324;1252;9949;28471;10273;29723
292160;202001;3059;7423;2290;6428;51;137;1850;5412;1901;5549
292170;202001;8511;22549;7064;20170;369;1221;5253;14719;5622;15940
292180;202001;2873;7827;2076;6381;175;527;1276;3856;1451;4383
292190;202001;2995;7825;2537;7126;107;355;1949;5427;2056;5782
292200;202001;8427;21198;6253;18064;1046;3121;3260;9678;4306;12799
292205;202001;3931;10775;3392;9977;66;314;2940;8588;3006;8902
292210;202001;6515;15187;5236;13561;88;390;4677;11951;4765;12341
292220;202001;2154;5186;1880;4757;50;145;1474;3597;1524;3742
292225;202001;3238;9447;2824;8821;72;337;2373;7274;2445;7611
292230;202001;8721;20616;7738;19353;170;574;6630;16270;6800;16844
292240;202001;4819;13910;4160;12717;316;943;2849;8725;3165;9668
292250;202001;5541;14671;4959;13776;447;1202;3534;9860;3981;11062
292260;202001;3441;8930;3037;8409;100;285;2623;7253;2723;7538
292265;202001;3406;9238;2832;8357;76;332;2216;6397;2292;6729
292270;202001;4453;10118;3526;9012;128;308;2878;7368;3006;7676
292273;202001;2684;5803;2135;5126;59;106;1582;4020;1641;4126
292275;202001;1687;4355;1327;3862;61;167;985;2926;1046;3093
292280;202001;2652;6267;2118;5651;87;184;1783;4904;1870;5088
292285;202001;2611;6290;2054;5543;85;201;1642;4470;1727;4671
292290;202001;7483;19884;5917;17668;172;655;4799;14294;4971;14949
292300;202001;10432;26322;8153;23271;764;2341;5531;15861;6295;18202
292303;202001;2945;8411;2561;7801;82;212;2125;6514;2207;6726
292305;202001;2386;6362;2197;6097;45;213;1964;5337;2009;5550
292310;202001;6817;17140;5844;15953;161;549;5039;13601;5200;14150
292320;202001;6164;16766;4870;14373;244;796;3581;10321;3825;11117
292330;202001;2823;6137;2222;5467;100;225;1709;4358;1809;4583
292335;202001;4814;12384;4263;11593;228;540;3581;9821;3809;10361
292340;202001;5780;15994;4732;13977;228;672;3479;10189;3707;10861
292350;202001;2554;6832;2093;6197;79;282;1673;4964;1752;5246
292360;202001;4923;13181;4075;11728;243;803;2858;7995;3101;8798
292370;202001;10827;24925;9203;22764;138;471;8473;20630;8611;21101
292380;202001;6934;19242;6155;17845;420;1230;4637;13357;5057;14587
292390;202001;4506;8678;3302;7272;105;185;2880;6380;2985;6565
292400;202001;22610;64360;19458;59293;1863;5843;13210;40368;15073;46211
292405;202001;4236;10561;3563;9514;105;283;2903;7666;3008;7949
292410;202001;2184;5193;1829;4747;65;160;1614;4206;1679;4366
292420;202001;3559;10741;3228;10210;120;603;2731;8404;2851;9007
292430;202001;4925;14625;3720;12420;303;1047;2401;8018;2704;9065
292440;202001;8604;27164;7901;26091;138;703;7015;23074;7153;23777
292450;202001;4031;11531;3135;9767;93;367;2418;7481;2511;7848
292460;202001;4946;13543;4025;11970;367;1059;2842;8462;3209;9521
292465;202001;2651;6895;2220;6311;88;191;1523;4680;1611;4871
292467;202001;1901;5331;1688;5042;245;648;1150;3577;1395;4225
292470;202001;3055;7698;2341;6578;60;134;1811;5105;1871;5239
292480;202001;6422;15197;5109;13608;72;277;4600;12149;4672;12426
292490;202001;2122;5509;1763;4977;120;288;1302;3770;1422;4058
292500;202001;6648;18142;5317;15740;523;1617;3432;10026;3955;11643
292510;202001;13150;35464;10248;30836;523;1896;7188;21533;7711;23429
292520;202001;7071;17576;6224;16369;486;1328;4753;12374;5239;13702
292525;202001;5959;14105;4832;12843;104;261;4178;11260;4282;11521
292530;202001;28298;75563;21691;64153;5382;16099;7991;24314;13373;40413
292540;202001;4347;8114;3411;7103;114;192;3042;6365;3156;6557
292550;202001;8461;21993;6509;19622;463;1416;4613;14710;5076;16126
292560;202001;4363;10889;3737;10066;82;257;3068;8289;3150;8546
292570;202001;3674;9633;3072;8569;73;285;2570;6970;2643;7255
292575;202001;7087;20086;6470;19255;375;1102;5164;15519;5539;16621
292580;202001;7584;19053;6272;17121;140;471;5251;14182;5391;14653
292590;202001;7456;19803;6370;17942;240;789;5313;14660;5553;15449
292593;202001;2859;7022;2355;6183;71;172;1960;5121;2031;5293
292595;202001;5543;14658;4726;13657;156;521;3929;11277;4085;11798
292600;202001;11167;30152;9528;27651;309;893;7484;21803;7793;22696
292610;202001;4185;10905;3518;9749;196;457;2603;7319;2799;7776
292620;202001;6613;17832;5414;16406;123;294;4943;15259;5066;15553
292630;202001;8622;21054;6924;18328;676;1803;4504;11951;5180;13754
292640;202001;8247;24289;7165;22509;195;811;5072;16030;5267;16841
292650;202001;4547;11124;4070;10505;114;316;3671;9366;3785;9682
292660;202001;11556;30938;9779;28327;462;1485;7443;21513;7905;22998
292665;202001;2197;6468;1903;6084;70;202;1599;5183;1669;5385
292670;202001;3601;9648;2746;8059;117;382;1857;5346;1974;5728
292680;202001;4015;10596;3155;9063;209;551;2265;6391;2474;6942
292690;202001;2677;6887;1837;5506;200;564;1078;3386;1278;3950
292700;202001;9978;27014;8635;24961;765;2017;5873;17485;6638;19502
292710;202001;2466;7677;2272;7411;48;164;2030;6689;2078;6853
292720;202001;9117;21620;7658;19952;229;629;6051;16022;6280;16651
292730;202001;4547;10421;4266;10084;210;312;3748;9046;3958;9358
292740;202001;332938;805179;287779;739146;41007;105847;176197;449944;217204;555791
292750;202001;6243;16658;5430;15462;238;683;4130;11954;4368;12637
292760;202001;3963;11367;3438;10429;230;772;2495;7498;2725;8270
292770;202001;6188;16417;4946;14652;793;2428;3009;9160;3802;11588
292780;202001;2084;4205;1542;3520;41;140;1230;2653;1271;2793
292790;202001;4119;8752;3151;7706;156;407;2611;6420;2767;6827
292800;202001;11331;28313;9669;25795;318;925;8016;21081;8334;22006
292805;202001;3525;8512;2750;7480;110;338;2153;5801;2263;6139
292810;202001;10919;28563;8558;24886;212;914;6356;17886;6568;18800
292820;202001;7620;20768;5471;17197;453;1509;3753;11622;4206;13131
292830;202001;2921;6860;2484;6315;92;301;2100;5318;2192;5619
292840;202001;8918;23180;7519;21272;156;625;6490;18000;6646;18625
292850;202001;2534;6679;2112;6052;146;442;1469;4184;1615;4626
292860;202001;17391;38094;15540;35852;467;1140;13301;30285;13768;31425
292870;202001;18124;44962;15524;41288;956;2666;10417;27335;11373;30001
292880;202001;11248;30422;9570;27914;296;1210;7445;20974;7741;22184
292890;202001;7120;19748;6241;18455;207;862;5350;15657;5557;16519
292895;202001;2992;6438;2173;5213;86;213;1745;4132;1831;4345
292900;202001;2646;7147;2411;6777;60;240;1956;5334;2016;5574
292905;202001;4439;11467;3479;10048;146;492;2540;7258;2686;7750
292910;202001;4982;13488;4513;12825;227;644;3405;9619;3632;10263
292920;202001;9825;26863;9088;25824;262;998;7805;21761;8067;22759
292925;202001;5503;15438;4600;13848;232;710;3304;9826;3536;10536
292930;202001;6642;19453;5643;17552;486;1699;3532;10663;4018;12362
292935;202001;2458;6207;1901;5583;28;145;1693;4987;1721;5132
292937;202001;3013;7279;2613;6758;63;188;2286;5885;2349;6073
292940;202001;2931;7415;2326;6501;185;437;1665;4814;1850;5251
292950;202001;9802;24775;8531;22866;526;1263;6362;16978;6888;18241
292960;202001;5314;12776;4431;11529;132;355;3527;9062;3659;9417
292970;202001;3843;11093;3380;10379;88;418;2789;8585;2877;9003
292975;202001;4587;9743;4053;9141;143;257;3652;8339;3795;8596
292980;202001;3343;8041;2669;7036;92;283;2139;5525;2231;5808
292990;202001;11612;31579;9613;28036;673;2066;6943;19962;7616;22028
293000;202001;2628;6246;2238;5665;41;148;1761;4464;1802;4612
293010;202001;18371;46885;14693;41026;1974;5704;8877;24736;10851;30440
293015;202001;8249;25231;6455;21728;423;1551;4326;14763;4749;16314
293020;202001;10007;28798;8970;27322;147;654;7972;24448;8119;25102
293030;202001;5396;14228;4065;12185;106;368;2780;8556;2886;8924
293040;202001;4086;11142;3438;10239;72;279;2960;8817;3032;9096
293050;202001;22288;55124;19657;51257;993;2788;14793;37988;15786;40776
293060;202001;3524;9325;2860;8110;248;744;1957;5452;2205;6196
293070;202001;25773;61983;21831;56926;2120;5829;15275;39884;17395;45713
293075;202001;3465;10954;2998;10166;174;734;2370;8032;2544;8766
293076;202001;3650;8897;3284;8453;69;189;2857;7426;2926;7615
293077;202001;6224;17220;4968;15205;448;1493;3175;9969;3623;11462
293080;202001;4777;14044;4090;12885;98;448;3258;10079;3356;10527
293090;202001;3290;9511;2503;8196;209;706;1645;5429;1854;6135
293100;202001;5723;15335;4670;13447;212;660;3648;10369;3860;11029
293105;202001;3730;11790;3261;10832;230;805;2308;7587;2538;8392
293110;202001;2424;6017;2002;5382;69;243;1642;4306;1711;4549
293120;202001;4402;11981;3898;11179;116;308;3221;9256;3337;9564
293130;202001;3769;10294;3287;9658;82;320;2808;8177;2890;8497
293135;202001;31069;72821;22830;61708;3465;10181;10606;28947;14071;39128
293140;202001;2400;5326;2071;4918;62;144;1719;4076;1781;4220
293150;202001;5470;16243;4513;14424;347;1163;3087;9873;3434;11036
293160;202001;3866;9370;3288;8741;246;416;2721;7598;2967;8014
293170;202001;4833;10277;4146;9416;132;306;3564;8028;3696;8334
293180;202001;4355;12247;3554;10799;105;429;2770;8189;2875;8618
293190;202001;14116;38511;12349;35964;169;736;10834;31373;11003;32109
293200;202001;8313;20633;6639;18005;203;756;5279;14006;5482;14762
293210;202001;5279;13924;4477;12687;290;821;3395;9617;3685;10438
293220;202001;5148;13305;3772;10930;881;2548;1460;4352;2341;6900
293230;202001;3965;10160;2928;8661;214;710;1987;5942;2201;6652
293240;202001;4502;11862;3593;10391;74;192;2723;8160;2797;8352
293245;202001;3863;10393;3458;9819;152;495;2906;8124;3058;8619
293250;202001;5944;13789;4873;12427;155;388;4061;10330;4216;10718
293260;202001;4543;12265;3693;10951;146;472;2544;7554;2690;8026
293270;202001;7266;16037;5740;14396;416;641;4448;11989;4864;12630
293280;202001;4616;12098;4009;11244;246;609;3091;8751;3337;9360
293290;202001;14360;42257;12655;39582;1829;5801;7991;25424;9820;31225
293300;202001;5875;14176;5027;12943;289;735;3649;9409;3938;10144
293305;202001;4089;9853;3527;9145;46;127;3145;8137;3191;8264
293310;202001;2182;5542;1807;4943;48;147;1414;3806;1462;3953
293315;202001;4122;9864;3364;8720;193;440;2735;7095;2928;7535
293317;202001;2632;6241;2310;5781;156;307;1806;4557;1962;4864
293320;202001;11908;29061;10581;27562;282;790;9349;24234;9631;25024
293325;202001;1778;4442;1383;3902;188;528;863;2465;1051;2993
293330;202001;52155;152048;42324;134441;8299;27060;19134;61627;27433;88687
293340;202001;2236;6258;1843;5574;93;309;1295;3860;1388;4169
293345;202001;3501;9476;2780;8418;341;802;1839;6052;2180;6854
293350;202001;6716;19078;5811;18008;63;304;5274;16571;5337;16875
293360;202001;15700;38827;13204;35524;322;1321;11541;30454;11863;31775
310010;202001;946;2133;596;1644;43;151;215;537;258;688
310020;202001;2242;6288;1600;5113;346;1223;291;880;637;2103
310030;202001;1948;5521;1491;4711;227;789;911;2768;1138;3557
310040;202001;929;2430;736;2099;34;137;493;1315;527;1452
310050;202001;1524;4585;1297;4219;137;558;823;2578;960;3136
310060;202001;3215;9066;2767;8474;101;421;2251;6806;2352;7227
310070;202001;348;781;239;623;6;14;181;470;187;484
310080;202001;741;1954;506;1514;78;272;216;595;294;867
310090;202001;4695;12567;3811;11101;296;941;2725;7805;3021;8746
310100;202001;3371;9512;2813;8561;78;351;2253;6681;2331;7032
310110;202001;4736;12501;3660;10593;779;2441;1545;4295;2324;6736
310120;202001;640;1571;407;1193;45;157;235;626;280;783
310130;202001;375;981;312;887;32;122;219;588;251;710
310140;202001;263;751;187;620;37;141;75;223;112;364
310150;202001;5344;14161;3921;11488;527;1798;1807;4989;2334;6787
310160;202001;7664;19321;5461;15668;1059;3310;1876;5412;2935;8722
310163;202001;1027;3061;823;2673;194;715;263;785;457;1500
310170;202001;9158;23603;7277;20590;608;1792;5075;14339;5683;16131
310180;202001;1779;4436;1298;3642;164;516;763;2053;927;2569
310190;202001;2588;7605;2054;6619;460;1676;309;916;769;2592
310200;202001;1835;5476;1313;4426;209;812;573;1890;782;2702
310205;202001;1129;3123;855;2684;148;524;371;1148;519;1672
310210;202001;2660;7083;2140;6161;119;374;1558;4371;1677;4745
310220;202001;1200;3287;922;2771;98;332;605;1751;703;2083
310230;202001;2241;6241;1796;5402;232;790;1084;3040;1316;3830
310240;202001;917;2855;762;2577;50;192;537;1791;587;1983
310250;202001;1039;2779;821;2423;21;84;582;1689;603;1773
310260;202001;2907;7571;1783;5580;497;1820;447;1057;944;2877
310270;202001;2747;6823;2136;5991;100;354;1735;4856;1835;5210
310280;202001;2362;5544;1805;4736;280;774;990;2485;1270;3259
310285;202001;1878;6001;1556;5406;173;683;944;3251;1117;3934
310290;202001;1125;2957;908;2566;210;695;473;1185;683;1880
310300;202001;1483;4383;1260;3982;150;595;720;2121;870;2716
310310;202001;311;774;198;570;34;101;99;281;133;382
310320;202001;509;1318;335;1026;25;95;178;526;203;621
310330;202001;482;1132;286;782;41;134;116;279;157;413
310340;202001;7861;21367;6295;18696;892;2578;3083;9439;3975;12017
310350;202001;12559;30345;8419;23582;1650;4914;3530;9599;5180;14513
310360;202001;484;1114;364;952;11;33;249;657;260;690
310370;202001;1275;3979;1059;3560;220;805;335;1139;555;1944
310375;202001;833;2075;564;1674;88;270;288;848;376;1118
310380;202001;392;875;210;584;33;101;95;241;128;342
310390;202001;442;1329;349;1148;82;294;96;266;178;560
310400;202001;9833;23929;6899;19435;748;2476;3995;10977;4743;13453
310410;202001;885;2540;571;1953;93;345;201;641;294;986
310420;202001;4293;11049;2844;8236;388;1276;1093;2907;1481;4183
310430;202001;1517;4118;976;3103;208;741;336;942;544;1683
310440;202001;652;1690;442;1296;40;145;234;647;274;792
310445;202001;1376;3950;989;3172;49;175;694;2201;743;2376
310450;202001;4791;11991;3556;10015;149;551;2645;7198;2794;7749
310460;202001;1599;4210;1108;3302;189;610;356;1010;545;1620
310470;202001;3833;8346;2951;7208;287;706;2081;5174;2368;5880
310480;202001;925;2422;710;2033;85;265;453;1265;538;1530
310490;202001;2840;7768;2191;6657;252;944;1177;3339;1429;4283
310500;202001;1382;3938;1013;3293;178;668;504;1581;682;2249
310510;202001;2046;5349;1282;3895;247;847;452;1383;699;2230
310520;202001;1215;3153;869;2535;137;380;456;1327;593;1707
310530;202001;758;1925;432;1288;58;217;138;331;196;548
310540;202001;3092;8835;2557;7912;570;1865;1124;3336;1694;5201
310550;202001;1230;3170;842;2511;62;227;479;1342;541;1569
310560;202001;14744;38643;10422;30992;1630;5524;4157;11123;5787;16647
310570;202001;1065;2799;843;2491;62;220;595;1731;657;1951
310590;202001;4092;10956;3245;9401;216;738;1861;5086;2077;5824
310600;202001;1347;3994;1091;3478;159;575;549;1625;708;2200
310610;202001;481;1266;298;956;51;185;148;446;199;631
310620;202001;174451;444420;125725;355606;18963;62044;58853;150101;77816;212145
310630;202001;4453;12268;3504;10425;294;992;2214;6338;2508;7330
310640;202001;1031;3089;842;2703;180;626;337;1024;517;1650
310650;202001;2431;6992;1743;5663;182;631;975;3078;1157;3709
310660;202001;1273;3459;1043;3159;36;133;876;2622;912;2755
310665;202001;1396;3625;1104;3190;31;118;901;2605;932;2723
310670;202001;55040;142768;46086;127339;4504;14367;31001;81419;35505;95786
310680;202001;736;1776;597;1578;19;70;487;1239;506;1309
310690;202001;1897;5008;1350;4065;114;400;742;2111;856;2511
310700;202001;493;1078;386;952;29;93;290;685;319;778
310710;202001;5475;15671;3916;13406;887;3544;584;1857;1471;5401
310720;202001;971;2338;754;2056;39;134;550;1450;589;1584
310730;202001;9786;26502;8348;24193;364;1360;6168;17495;6532;18855
310740;202001;5929;16439;3954;12253;649;2206;1300;3712;1949;5918
310750;202001;1227;2941;878;2429;119;367;422;1088;541;1455
310760;202001;562;1458;402;1217;24;75;218;673;242;748
310770;202001;1087;2996;744;2454;82;326;363;1112;445;1438
310780;202001;4364;10508;3586;9423;73;221;2859;7516;2932;7737
310790;202001;1813;5752;1568;5232;362;1294;246;744;608;2038
310800;202001;2235;6655;1589;5309;363;1433;105;291;468;1724
310810;202001;1163;2971;939;2555;43;132;655;1727;698;1859
310820;202001;1179;3057;706;2232;154;528;165;513;319;1041
310825;202001;2501;7746;1995;6876;76;450;1575;5224;1651;5674
310830;202001;1670;4798;1145;3723;228;854;464;1399;692;2253
310840;202001;1924;5252;1363;4303;364;1292;325;887;689;2179
310850;202001;1496;4106;1243;3752;48;249;958;2743;1006;2992
310855;202001;3176;8394;2438;7202;176;601;1689;4855;1865;5456
310860;202001;6959;20152;5527;17303;521;1742;3365;10613;3886;12355
310870;202001;1021;2421;771;2051;56;139;563;1504;619;1643
310880;202001;989;2960;768;2504;102;346;452;1436;554;1782
310890;202001;2308;6590;1460;4871;273;979;212;601;485;1580
310900;202001;3930;11039;2612;8071;375;1207;1098;3145;1473;4352
310910;202001;2014;5019;1363;3941;116;406;251;653;367;1059
310920;202001;1911;5017;1443;4287;209;664;790;2289;999;2953
310925;202001;952;2624;758;2302;80;280;495;1427;575;1707
310930;202001;5756;15218;4093;12513;787;2478;1898;6021;2685;8499
310940;202001;6522;15744;5174;13731;198;704;3863;9917;4061;10621
310945;202001;1297;3378;1014;2926;117;375;563;1598;680;1973
310950;202001;1903;5661;1215;4087;217;815;420;1250;637;2065
310960;202001;752;2015;419;1315;75;268;88;245;163;513
310970;202001;1142;3402;797;2649;203;739;148;448;351;1187
310980;202001;286;694;185;534;16;58;116;323;132;381
310990;202001;1284;3593;979;3053;168;550;484;1477;652;2027
311000;202001;4034;11323;2930;9440;712;2457;1185;3696;1897;6153
311010;202001;855;2532;682;2175;206;736;278;854;484;1590
311020;202001;1024;2660;643;1958;38;120;346;1036;384;1156
311030;202001;1609;4016;1101;3165;197;654;516;1368;713;2022
311040;202001;302;942;241;802;72;258;66;202;138;460
311050;202001;2781;6885;2052;5803;371;1196;1003;2710;1374;3906
311060;202001;3044;7864;2166;6176;317;1047;835;2158;1152;3205
311070;202001;2270;5723;1617;4676;186;679;828;2233;1014;2912
311080;202001;1085;2501;878;2164;44;152;675;1567;719;1719
311090;202001;2012;6431;1560;5569;352;1410;463;1609;815;3019
311100;202001;2327;6674;1352;4622;250;978;225;679;475;1657
311110;202001;3709;7615;2059;5312;373;1041;753;1982;1126;3023
311115;202001;1347;3128;1102;2790;68;180;878;2194;946;2374
311120;202001;6500;17086;4817;14007;710;2349;1767;4499;2477;6848
311130;202001;1882;4907;1410;4243;115;449;768;2232;883;2681
311140;202001;1373;3389;1042;2930;77;254;674;1866;751;2120
311150;202001;1524;4807;1193;4166;194;766;630;2136;824;2902
311160;202001;3678;10584;2527;8397;628;2344;735;2360;1363;4704
311170;202001;892;2266;701;2003;35;97;435;1318;470;1415
311180;202001;1343;3039;829;2273;154;456;364;982;518;1438
311190;202001;946;2601;692;2108;120;418;265;707;385;1125
311200;202001;1952;5310;1385;4215;274;915;469;1277;743;2192
311205;202001;869;2630;706;2301;50;225;430;1329;480;1554
311210;202001;1027;2983;890;2805;119;344;641;2072;760;2416
311220;202001;748;2100;616;1866;50;170;373;1073;423;1243
311230;202001;7717;23264;5752;19216;997;3501;2129;7263;3126;10764
311240;202001;1003;2632;766;2291;163;526;326;962;489;1488
311250;202001;980;2824;751;2388;179;545;288;899;467;1444
311260;202001;2560;6368;1603;4702;251;811;661;1789;912;2600
311265;202001;1302;3407;957;2821;43;172;656;1866;699;2038
311270;202001;3001;8927;2597;8251;164;721;1886;5718;2050;6439
311280;202001;1151;2977;527;1699;108;391;49;139;157;530
311290;202001;1846;5613;1678;5256;148;480;1137;3557;1285;4037
311300;202001;4695;13240;3824;11745;210;895;2976;8913;3186;9808
311310;202001;562;1565;468;1397;39;119;269;773;308;892
311320;202001;3089;9495;2605;8411;393;1477;1194;3496;1587;4973
311330;202001;4974;13231;3963;11555;430;1400;2178;6469;2608;7869
311340;202001;10346;29233;8110;25191;2183;7360;2081;6148;4264;13508
311350;202001;2283;5730;1588;4456;140;460;875;2199;1015;2659
311360;202001;1126;2781;708;2112;201;682;216;595;417;1277
311370;202001;4604;11261;3349;9247;155;618;2173;5668;2328;6286
311380;202001;362;1117;264;911;66;231;104;375;170;606
311390;202001;1694;5191;1318;4663;565;2288;308;938;873;3226
311400;202001;1389;3869;1000;3116;141;457;400;1133;541;1590
311410;202001;1593;4713;1306;4310;200;769;740;2428;940;3197
311420;202001;1454;4256;998;3314;175;647;222;597;397;1244
311430;202001;3793;10102;2448;7405;492;1529;734;2229;1226;3758
311440;202001;2538;7251;1825;6013;413;1606;502;1567;915;3173
311450;202001;1701;5117;1218;4200;304;1183;318;944;622;2127
311455;202001;990;2243;658;1751;175;473;246;685;421;1158
311460;202001;483;1496;321;1155;68;320;86;264;154;584
311470;202001;483;1513;320;1120;75;304;49;156;124;460
311480;202001;1083;2840;898;2565;56;158;695;2003;751;2161
311490;202001;236;695;176;575;30;117;84;241;114;358
311500;202001;433;1069;324;907;26;85;199;535;225;620
311510;202001;3146;8263;2088;6396;301;1043;841;2403;1142;3446
311520;202001;582;1674;517;1543;70;258;298;848;368;1106
311530;202001;8854;20579;5448;15038;1307;4007;1406;3705;2713;7712
311535;202001;770;2105;499;1552;77;255;168;481;245;736
311540;202001;499;1564;437;1448;85;310;270;874;355;1184
311545;202001;2068;5886;1755;5414;95;357;1334;4034;1429;4391
311547;202001;1475;3795;1269;3474;46;133;872;2433;918;2566
311550;202001;2732;7699;2155;6618;323;1129;912;2658;1235;3787
311560;202001;290;639;182;479;23;73;99;228;122;301
311570;202001;1754;4060;1223;3332;45;137;954;2642;999;2779
311580;202001;2187;4046;1423;3152;138;286;954;2133;1092;2419
311590;202001;496;1319;396;1172;64;217;215;624;279;841
311600;202001;1779;3980;1492;3611;59;137;1271;3030;1330;3167
311610;202001;2241;7383;1843;6506;222;846;994;3470;1216;4316
311615;202001;3085;8874;2482;7849;124;466;1914;5942;2038;6408
311620;202001;442;1163;380;1089;11;43;316;895;327;938
311630;202001;1325;3654;1064;3137;101;322;688;1947;789;2269
311640;202001;565;1554;433;1321;61;220;202;570;263;790
311650;202001;1860;4833;1526;4309;129;414;1018;2793;1147;3207
311660;202001;2779;7922;2000;6421;358;1268;504;1387;862;2655
311670;202001;1524;4011;1090;3239;159;540;460;1373;619;1913
311680;202001;2147;6182;1575;5123;180;593;1010;3273;1190;3866
311690;202001;594;1272;456;1098;38;79;330;844;368;923
311700;202001;2247;5393;1736;4673;29;139;1450;3785;1479;3924
311710;202001;1514;4336;1056;3497;248;903;400;1291;648;2194
311720;202001;397;1193;314;1037;19;84;182;585;201;669
311730;202001;3944;10100;2496;7324;731;2295;461;1389;1192;3684
311740;202001;851;2276;717;2116;32;82;618;1880;650;1962
311750;202001;3859;11651;3109;10288;432;1571;1749;5549;2181;7120
311760;202001;598;1709;493;1522;70;276;233;622;303;898
311770;202001;2056;5926;1591;5078;253;876;742;2271;995;3147
311780;202001;1273;3673;838;2775;178;673;235;680;413;1353
311783;202001;2223;6107;1784;5342;46;210;1414;4067;1460;4277
311787;202001;695;2005;510;1577;72;244;207;543;279;787
311790;202001;1480;3987;945;3003;242;857;251;763;493;1620
311800;202001;4827;14477;3902;12482;825;2843;646;1798;1471;4641
311810;202001;947;2894;749;2535;58;232;468;1561;526;1793
311820;202001;789;1945;576;1605;79;257;343;901;422;1158
311830;202001;8465;24458;5713;18403;1561;5460;665;2065;2226;7525
311840;202001;3454;8918;2807;7980;262;785;2029;5727;2291;6512
311850;202001;331;896;267;774;14;41;178;499;192;540
311860;202001;57311;145291;43382;121569;6466;19545;23644;63445;30110;82990
311870;202001;1901;5059;1260;3882;210;727;462;1293;672;2020
311880;202001;6284;16293;5229;14817;291;762;3913;11264;4204;12026
311890;202001;1621;3957;1242;3410;85;280;874;2285;959;2565
311900;202001;725;1899;541;1638;52;186;366;1088;418;1274
311910;202001;4248;10871;3162;9438;562;1667;1566;4807;2128;6474
311920;202001;2025;5492;1598;4856;117;327;1000;3105;1117;3432
311930;202001;3587;8506;2545;7024;815;2428;736;1906;1551;4334
311940;202001;14630;38770;10658;31225;1541;5021;4785;13073;6326;18094
311950;202001;2193;6042;1625;5075;101;420;1036;3182;1137;3602
311960;202001;493;1215;395;1068;25;103;252;609;277;712
311970;202001;434;1408;301;1069;52;212;67;204;119;416
311980;202001;438;1189;223;761;27;95;69;234;96;329
311990;202001;556;1302;348;991;71;250;151;378;222;628
311995;202001;957;2676;478;1553;20;64;64;157;84;221
312000;202001;612;1618;506;1465;49;153;328;947;377;1100
312010;202001;927;2613;707;2224;53;189;430;1305;483;1494
312015;202001;1363;4042;1190;3751;56;258;936;2865;992;3123
312020;202001;1415;4364;1073;3648;234;843;261;829;495;1672
312030;202001;2032;5066;1757;4755;26;106;1613;4344;1639;4450
312040;202001;869;2578;599;2030;70;258;260;853;330;1111
312050;202001;1181;3766;943;3288;215;877;277;861;492;1738
312060;202001;875;2167;570;1783;145;446;263;846;408;1292
312070;202001;871;2536;615;2024;55;200;312;971;367;1171
312080;202001;2703;6653;1998;5603;116;386;1266;3385;1382;3771
312083;202001;865;2263;638;1912;56;201;407;1172;463;1373
312087;202001;2413;6354;1959;5639;48;164;1528;4387;1576;4551
312090;202001;9714;25751;7396;21987;1146;3795;3564;10318;4710;14113
312100;202001;1525;4505;1147;3807;102;444;627;1999;729;2443
312110;202001;1000;3122;831;2770;198;769;281;829;479;1598
312120;202001;790;2152;534;1698;159;586;162;426;321;1012
312125;202001;1722;4467;1419;4029;117;385;1044;2858;1161;3243
312130;202001;961;2365;713;1953;54;162;296;743;350;905
312140;202001;706;2046;577;1787;120;420;252;713;372;1133
312150;202001;454;1282;379;1115;13;63;270;732;283;795
312160;202001;8104;22561;6074;18891;768;2818;2856;8421;3624;11239
312170;202001;895;2439;675;2003;39;145;444;1278;483;1423
312180;202001;1344;3654;1046;3072;152;476;519;1464;671;1940
312190;202001;620;1759;421;1350;76;269;124;376;200;645
312200;202001;4688;12642;3673;11013;1092;3294;1305;3992;2397;7286
312210;202001;1341;3070;945;2485;38;115;691;1783;729;1898
312220;202001;1726;5326;1481;4859;116;411;915;3003;1031;3414
312230;202001;12685;33234;8260;25018;2015;6862;1576;4128;3591;10990
312235;202001;1900;4912;1501;4292;83;308;1065;2951;1148;3259
312240;202001;699;2273;524;1894;116;476;141;477;257;953
312245;202001;2576;6803;2079;6036;62;212;1669;4818;1731;5030
312247;202001;927;2309;662;1907;129;396;322;942;451;1338
312250;202001;988;2629;630;1910;80;257;237;707;317;964
312260;202001;879;2451;688;2143;39;164;504;1520;543;1684
312270;202001;697;1915;527;1587;29;123;294;804;323;927
312280;202001;422;1233;318;1040;97;324;45;135;142;459
312290;202001;738;2196;588;1914;119;442;188;579;307;1021
312300;202001;971;2957;646;2147;159;575;116;319;275;894
312310;202001;831;2623;660;2262;106;401;294;970;400;1371
312320;202001;1896;4916;1360;3968;328;996;299;846;627;1842
312330;202001;858;2544;674;2162;67;231;409;1288;476;1519
312340;202001;263;683;183;547;43;155;72;188;115;343
312350;202001;251;521;180;444;16;50;125;291;141;341
312352;202001;1628;4842;1437;4499;93;308;875;2912;968;3220
312360;202001;2578;7542;1860;6116;368;1320;526;1662;894;2982
312370;202001;1791;4775;1447;4178;193;624;814;2229;1007;2853
312380;202001;2164;4901;1765;4395;9;36;1564;3853;1573;3889
312385;202001;1240;3436;946;2890;157;509;435;1312;592;1821
312390;202001;1893;5488;1403;4561;210;793;500;1465;710;2258
312400;202001;2857;8333;2331;7372;708;2403;724;2263;1432;4666
312410;202001;11583;32125;9379;28366;1646;5168;5042;15056;6688;20224
312420;202001;3679;10171;3050;9102;565;1856;1587;4588;2152;6444
312430;202001;7844;20931;6304;18150;410;1390;4354;12204;4764;13594
312440;202001;881;2851;678;2384;362;1334;74;227;436;1561
312450;202001;1161;3446;885;2957;254;916;289;988;543;1904
312460;202001;434;1142;291;918;37;128;151;488;188;616
312470;202001;478;1162;301;847;36;115;115;282;151;397
312480;202001;1071;2654;733;2157;99;313;350;985;449;1298
312490;202001;2061;5033;1551;4268;207;596;829;2214;1036;2810
312500;202001;937;2342;747;2065;47;167;507;1378;554;1545
312510;202001;3676;9839;2656;7906;701;1994;709;2169;1410;4163
312520;202001;168;480;132;417;34;114;55;170;89;284
312530;202001;597;1460;503;1345;16;55;441;1187;457;1242
312540;202001;1522;4331;1008;3251;148;534;531;1649;679;2183
312550;202001;748;2031;555;1632;46;149;343;924;389;1073
312560;202001;1951;5023;1561;4421;73;232;1182;3361;1255;3593
312570;202001;2139;5338;1617;4676;457;1383;628;1847;1085;3230
312580;202001;609;1712;436;1345;58;207;199;558;257;765
312590;202001;1609;4748;1271;4052;91;410;784;2314;875;2724
312595;202001;1854;5589;1552;5056;279;861;897;3075;1176;3936
312600;202001;1087;2652;615;1765;104;381;128;411;232;792
312610;202001;6178;15769;3895;11428;575;1824;1321;3640;1896;5464
312620;202001;2564;6593;1866;5614;54;247;1451;4471;1505;4718
312630;202001;274;820;198;684;37;154;77;254;114;408
312640;202001;523;1434;350;1132;45;148;128;434;173;582
312650;202001;2071;5384;1401;4098;70;224;960;2686;1030;2910
312660;202001;1327;3249;988;2669;79;256;667;1713;746;1969
312670;202001;4864;13009;4009;11630;182;811;2863;7902;3045;8713
312675;202001;1243;3315;1003;2951;58;196;793;2301;851;2497
312680;202001;1388;3937;1163;3590;58;259;935;2786;993;3045
312690;202001;2800;6008;2166;5241;58;167;1789;4329;1847;4496
312695;202001;951;2641;785;2353;34;91;601;1812;635;1903
312700;202001;2070;5512;1505;4468;155;539;843;2370;998;2909
312705;202001;1340;3336;1122;2993;20;71;979;2585;999;2656
312707;202001;1373;4039;1042;3431;63;318;653;2019;716;2337
312710;202001;6627;15229;3871;10875;999;3031;1061;3087;2060;6118
312720;202001;1059;2894;791;2453;102;344;478;1433;580;1777
312730;202001;1643;3911;1169;3254;90;293;677;1809;767;2102
312733;202001;1405;3709;1052;3041;40;156;703;1926;743;2082
312735;202001;635;1735;535;1544;70;235;332;850;402;1085
312737;202001;811;1870;554;1489;68;205;331;843;399;1048
312738;202001;619;1597;429;1267;46;160;232;640;278;800
312740;202001;430;1065;244;747;56;191;60;147;116;338
312750;202001;1447;4346;1141;3775;193;703;487;1501;680;2204
312760;202001;1822;5396;1282;4265;226;810;449;1435;675;2245
312770;202001;44394;107115;27329;77616;5665;17226;8677;24257;14342;41483
312780;202001;2427;7305;2044;6664;233;839;1308;4231;1541;5070
312790;202001;257;626;141;439;8;39;46;116;54;155
312800;202001;4980;14210;3765;11822;919;3061;1253;3835;2172;6896
312810;202001;1603;4263;1027;3300;250;900;350;1008;600;1908
312820;202001;1771;4759;1404;4116;45;170;1029;2941;1074;3111
312825;202001;1332;3163;1139;2908;24;87;957;2388;981;2475
312830;202001;2805;7937;1604;5413;333;1266;369;1186;702;2452
312840;202001;1243;3489;956;2969;110;433;466;1361;576;1794
312850;202001;887;2167;607;1742;25;109;359;942;384;1051
312860;202001;1213;3083;800;2461;209;678;180;526;389;1204
312870;202001;6113;16616;3678;11836;632;2216;793;2443;1425;4659
312880;202001;1420;3570;1085;3003;37;139;632;1748;669;1887
312890;202001;2178;5601;1522;4449;105;308;776;2305;881;2613
312900;202001;1177;3003;939;2706;76;245;529;1652;605;1897
312910;202001;1613;2987;839;1966;144;286;332;767;476;1053
312920;202001;990;2683;666;2128;128;482;256;743;384;1225
312930;202001;2206;5513;1700;4761;370;1070;763;2132;1133;3202
312940;202001;942;2626;730;2302;84;323;362;1073;446;1396
312950;202001;3186;7978;2052;6096;533;1728;625;1781;1158;3509
312960;202001;1799;4801;1512;4351;76;201;1157;3433;1233;3634
312965;202001;1645;4666;1361;4202;119;404;928;2803;1047;3207
312970;202001;1274;3621;979;3121;158;608;529;1567;687;2175
312980;202001;22500;62592;18043;54508;3339;11146;8803;24959;12142;36105
312990;202001;459;1193;285;885;49;178;129;381;178;559
313000;202001;475;1359;352;1129;31;133;202;596;233;729
313005;202001;2503;7245;2099;6549;161;492;1465;4544;1626;5036
313010;202001;4858;13516;3862;11862;697;2355;2201;6596;2898;8951
313020;202001;940;2885;628;2158;107;400;111;331;218;731
313030;202001;1117;2632;738;2058;66;239;476;1248;542;1487
313040;202001;785;2433;632;2097;45;187;362;1139;407;1326
313050;202001;1736;4860;1194;4019;198;805;371;1108;569;1913
313055;202001;1880;5118;1671;4808;60;192;1408;4017;1468;4209
313060;202001;984;2389;710;1912;185;602;152;340;337;942
313065;202001;1632;4936;1419;4567;59;248;1061;3325;1120;3573
313070;202001;953;2518;711;2086;71;218;405;1160;476;1378
313080;202001;386;1066;273;839;56;200;97;247;153;447
313090;202001;5007;13502;4240;12241;369;1232;2767;7872;3136;9104
313100;202001;1332;3475;1017;3014;30;127;768;2216;798;2343
313110;202001;1468;3918;1034;3133;93;357;583;1640;676;1997
313115;202001;2501;7338;2035;6448;271;939;1053;3146;1324;4085
313120;202001;3770;8869;2748;7516;250;798;1729;4701;1979;5499
313130;202001;30135;78885;22836;65217;2533;8209;12583;33882;15116;42091
313140;202001;588;1319;355;973;26;76;235;642;261;718
313150;202001;1358;3823;994;3134;283;964;246;706;529;1670
313160;202001;1065;2700;814;2293;30;108;603;1652;633;1760
313170;202001;11360;32585;7983;26040;1381;4899;3014;9231;4395;14130
313180;202001;2148;5700;1504;4433;185;573;830;2403;1015;2976
313190;202001;4210;12120;3025;9690;560;1930;1013;3020;1573;4950
313200;202001;1085;3071;940;2824;19;79;785;2283;804;2362
313210;202001;3763;10988;3037;9708;372;1367;1799;5526;2171;6893
313220;202001;1754;4638;1135;3420;176;604;443;1169;619;1773
313230;202001;2977;8348;2458;7729;59;224;2008;6452;2067;6676
313240;202001;9439;23271;5775;17281;991;3423;2333;6425;3324;9848
313250;202001;6210;18212;4670;15008;823;2703;2032;6415;2855;9118
313260;202001;610;1616;425;1272;56;216;192;534;248;750
313270;202001;5642;14472;4467;12767;584;1696;2895;8441;3479;10137
313280;202001;438;1243;275;902;37;127;110;346;147;473
313290;202001;940;2938;693;2504;229;896;217;758;446;1654
313300;202001;1579;4257;1133;3456;295;967;241;629;536;1596
313310;202001;1071;3192;813;2639;123;466;216;595;339;1061
313320;202001;2138;5672;1503;4632;271;939;624;1926;895;2865
313330;202001;4062;10773;3057;9223;168;682;1974;5882;2142;6564
313340;202001;1384;3130;978;2556;91;247;668;1751;759;1998
313350;202001;2407;6850;1536;4841;207;715;558;1551;765;2266
313360;202001;1330;3293;881;2571;144;507;427;1165;571;1672
313370;202001;1364;3891;1131;3423;141;503;624;1742;765;2245
313375;202001;1691;4380;1003;3109;183;626;210;614;393;1240
313380;202001;5928;15069;4161;11783;769;2407;1860;4705;2629;7112
313390;202001;830;2666;720;2483;49;230;470;1540;519;1770
313400;202001;3715;9209;2849;8007;168;525;2166;5979;2334;6504
313410;202001;1294;3392;973;2811;65;232;700;1972;765;2204
313420;202001;15007;33611;7438;20735;1644;5138;1033;2823;2677;7961
313430;202001;913;2720;681;2236;119;478;277;809;396;1287
313440;202001;6262;13604;4066;10705;357;992;2506;6584;2863;7576
313450;202001;717;1953;483;1461;82;267;158;404;240;671
313460;202001;2131;6166;1701;5484;348;1279;787;2397;1135;3676
313470;202001;2866;7364;2241;6444;272;764;1377;4037;1649;4801
313480;202001;969;2795;529;1789;78;285;132;408;210;693
313490;202001;2388;5742;1120;3505;314;1111;151;470;465;1581
313500;202001;441;1287;342;1064;40;122;126;373;166;495
313505;202001;9897;26364;8379;24310;341;1227;6684;19320;7025;20547
313507;202001;1473;3881;1190;3438;29;115;941;2656;970;2771
313510;202001;13310;36918;10454;31449;1283;4131;4966;14531;6249;18662
313520;202001;14132;40196;11223;35102;643;2422;8156;24942;8799;27364
313530;202001;526;1551;389;1248;42;149;150;434;192;583
313535;202001;2362;6540;1979;5799;251;656;1230;3595;1481;4251
313540;202001;761;2272;591;1857;114;368;245;713;359;1081
313545;202001;1180;3914;982;3499;155;580;521;1774;676;2354
313550;202001;1722;5276;1413;4551;329;1183;691;2112;1020;3295
313560;202001;2634;5231;1941;4390;60;112;1625;3692;1685;3804
313570;202001;940;2816;762;2476;181;616;310;954;491;1570
313580;202001;5584;14810;4225;12520;514;1637;2360;7058;2874;8695
313590;202001;970;2790;769;2497;205;707;331;1138;536;1845
313600;202001;3843;10458;3184;9417;96;400;2640;7661;2736;8061
313610;202001;994;2525;791;2170;90;268;492;1282;582;1550
313620;202001;5530;14775;4322;12535;588;1874;2356;6595;2944;8469
313630;202001;8620;20924;5911;16824;621;2056;3379;9391;4000;11447
313640;202001;1037;2434;630;1894;165;505;218;691;383;1196
313650;202001;1740;5263;1394;4660;94;380;909;3054;1003;3434
313652;202001;751;2414;674;2242;115;416;412;1328;527;1744
313655;202001;1146;2930;899;2605;47;146;698;2020;745;2166
313657;202001;1223;3259;953;2823;44;175;699;1958;743;2133
313660;202001;864;2443;693;2124;86;320;411;1176;497;1496
313665;202001;4612;12477;3506;10448;430;1423;2097;5986;2527;7409
313670;202001;48648;119653;30365;88233;4593;14670;12841;35252;17434;49922
313680;202001;1018;2718;837;2437;64;211;547;1544;611;1755
313690;202001;795;2529;608;2171;146;565;158;536;304;1101
313695;202001;1775;4882;1355;4191;85;272;909;2808;994;3080
313700;202001;3030;9755;2586;9155;264;991;1892;6701;2156;7692
313710;202001;1348;3146;963;2623;77;217;639;1758;716;1975
313720;202001;5384;14902;3753;11544;592;2064;1498;4176;2090;6240
313730;202001;1295;2962;971;2517;77;174;642;1655;719;1829
313740;202001;1648;5880;1340;5079;317;1372;222;727;539;2099
313750;202001;1961;5273;1484;4406;272;888;680;1884;952;2772
313753;202001;2117;5085;1385;3899;128;383;779;2125;907;2508
313760;202001;5029;13951;3698;11370;792;2642;1515;4367;2307;7009
313770;202001;3948;11152;3087;9754;210;715;2226;7089;2436;7804
313780;202001;4100;10981;2923;8974;249;912;800;2516;1049;3428
313790;202001;476;1498;418;1389;47;180;229;736;276;916
313800;202001;1379;3217;999;2660;129;397;525;1317;654;1714
313810;202001;1579;4044;1236;3557;54;213;928;2596;982;2809
313820;202001;17231;43559;10732;29843;1672;4931;3069;8229;4741;13160
313830;202001;391;1135;269;845;56;183;86;249;142;432
313835;202001;919;2724;743;2392;63;250;402;1220;465;1470
313840;202001;6796;17832;4909;14612;1237;3890;1017;3074;2254;6964
313850;202001;951;2350;755;2077;135;453;367;883;502;1336
313860;202001;2577;6993;1893;5664;304;1037;763;2104;1067;3141
313862;202001;1423;3018;680;1901;44;134;328;913;372;1047
313865;202001;2478;6669;2044;5957;94;300;1516;4336;1610;4636
313867;202001;1212;3684;1008;3304;141;467;660;2193;801;2660
313868;202001;1708;5273;1393;4625;51;256;1062;3410;1113;3666
313870;202001;773;2110;558;1711;100;322;205;566;305;888
313880;202001;1548;4144;1139;3453;176;586;516;1412;692;1998
313890;202001;2004;4396;1490;3725;54;174;1084;2646;1138;2820
313900;202001;4010;11744;2843;9334;737;2677;685;2069;1422;4746
313910;202001;614;1831;457;1525;94;349;102;323;196;672
313920;202001;2919;9110;2442;8096;499;1644;1207;4015;1706;5659
313925;202001;1567;4026;1243;3433;188;497;781;2154;969;2651
313930;202001;4682;14186;3748;12485;282;1079;2406;7919;2688;8998
313940;202001;8694;25277;6149;20802;846;3465;1489;5528;2335;8993
313950;202001;5191;11664;3698;9774;427;1414;2150;5636;2577;7050
313960;202001;5521;13674;3635;10458;806;2599;1103;2885;1909;5484
313970;202001;1462;3991;1220;3580;19;61;765;2207;784;2268
313980;202001;1361;3543;893;2794;137;494;340;1007;477;1501
313990;202001;1834;5934;1301;4677;353;1416;387;1227;740;2643
314000;202001;9511;24814;7963;22158;572;2040;5252;14397;5824;16437
314010;202001;1472;3567;1139;3098;48;166;843;2226;891;2392
314015;202001;1906;5295;1419;4447;191;722;726;2204;917;2926
314020;202001;487;1340;306;1004;61;246;61;214;122;460
314030;202001;742;2135;585;1833;54;181;310;959;364;1140
314040;202001;634;1712;504;1460;72;233;268;742;340;975
314050;202001;1779;4797;1271;3842;163;570;639;1808;802;2378
314053;202001;1807;5384;1441;4659;272;872;720;2435;992;3307
314055;202001;2298;6157;1931;5581;46;177;1569;4532;1615;4709
314060;202001;1251;3356;924;2827;35;144;630;1901;665;2045
314070;202001;4514;12505;3497;10635;728;2207;1495;4452;2223;6659
314080;202001;2135;5644;1414;4365;190;709;570;1576;760;2285
314085;202001;2108;6067;1709;5439;245;825;930;3003;1175;3828
314090;202001;4416;12169;3768;11149;238;909;2380;7108;2618;8017
314100;202001;3183;7538;2455;6532;57;165;1828;4865;1885;5030
314110;202001;4445;12676;3602;11030;397;1425;2056;5898;2453;7323
314120;202001;837;1955;343;1022;71;255;66;187;137;442
314130;202001;622;1609;373;1148;26;106;210;638;236;744
314140;202001;4609;13167;3577;11141;485;1606;1744;5314;2229;6920
314150;202001;1498;3772;1086;3046;86;249;720;1963;806;2212
314160;202001;2187;5866;1570;4719;212;708;655;1963;867;2671
314170;202001;943;2697;756;2319;49;180;468;1339;517;1519
314180;202001;5461;15272;4385;13519;382;1288;2572;7930;2954;9218
314190;202001;607;1515;414;1216;73;233;183;497;256;730
314200;202001;2892;8124;2348;7193;142;504;1664;4960;1806;5464
314210;202001;1989;5274;1550;4466;172;528;771;2170;943;2698
314220;202001;1302;3619;916;2940;194;723;331;966;525;1689
314225;202001;1106;3143;911;2831;79;215;642;2041;721;2256
314230;202001;760;1967;618;1794;74;241;396;1178;470;1419
314240;202001;1020;2778;781;2406;193;623;302;932;495;1555
314250;202001;510;1430;319;1036;49;159;116;344;165;503
314260;202001;935;2582;733;2290;154;524;403;1215;557;1739
314270;202001;3271;9335;2656;8360;87;374;1940;6027;2027;6401
314280;202001;3361;7774;2176;5947;256;777;1121;2893;1377;3670
314290;202001;4536;11779;3696;10279;298;861;2482;6766;2780;7627
314300;202001;1880;5424;1230;4003;254;919;388;1189;642;2108
314310;202001;4213;11068;2830;8666;891;2983;453;1217;1344;4200
314315;202001;916;3177;779;2887;57;276;529;1885;586;2161
314320;202001;2904;7956;1832;5884;338;1196;644;2004;982;3200
314330;202001;49494;138766;37061;116550;9949;32687;7558;24987;17507;57674
314340;202001;2306;5710;1318;3903;272;948;327;809;599;1757
314345;202001;1396;4189;1127;3693;157;534;640;2071;797;2605
314350;202001;863;2375;567;1844;113;391;128;360;241;751
314360;202001;574;1661;346;1159;50;181;106;322;156;503
314370;202001;706;1915;556;1691;31;118;399;1171;430;1289
314380;202001;1144;3128;754;2409;163;605;172;533;335;1138
314390;202001;12638;32503;7926;23697;1633;5261;2357;6365;3990;11626
314400;202001;4005;11983;3018;10057;775;2685;1081;3746;1856;6431
314410;202001;2743;7650;1884;6016;260;943;643;2164;903;3107
314420;202001;823;2028;594;1680;32;138;404;1067;436;1205
314430;202001;7453;18566;5129;14559;778;2347;2279;6168;3057;8515
314435;202001;1659;4508;1305;3898;54;199;947;2790;1001;2989
314437;202001;926;2383;659;1920;66;215;319;920;385;1135
314440;202001;623;1790;439;1405;120;420;87;237;207;657
314450;202001;1370;3675;1137;3311;115;386;659;1844;774;2230
314460;202001;3267;9982;2330;7939;581;2090;521;1729;1102;3819
314465;202001;2210;6393;1874;5742;53;201;1401;4148;1454;4349
314467;202001;865;2320;721;2083;19;58;575;1608;594;1666
314470;202001;2130;6181;1702;5293;286;984;758;2184;1044;3168
314480;202001;6483;18646;4618;14670;764;2728;1594;4479;2358;7207
314490;202001;993;2727;734;2164;66;221;456;1281;522;1502
314500;202001;1721;4198;1236;3497;286;794;441;1290;727;2084
314505;202001;2030;5010;1650;4467;109;309;1164;3083;1273;3392
314510;202001;1850;4863;1287;4006;241;838;556;1715;797;2553
314520;202001;4837;14959;3497;12064;685;2594;423;1272;1108;3866
314530;202001;5467;17739;4869;16559;351;1484;3490;11582;3841;13066
314535;202001;2597;6761;2070;5980;101;360;1559;4468;1660;4828
314537;202001;1114;3205;847;2754;53;212;584;1857;637;2069
314540;202001;387;976;256;746;17;60;138;375;155;435
314545;202001;1829;4501;1612;4239;35;98;1361;3697;1396;3795
314550;202001;638;1582;475;1343;37;142;256;654;293;796
314560;202001;4010;12216;2935;9769;483;1806;1000;3022;1483;4828
314570;202001;304;836;223;684;28;103;95;293;123;396
314580;202001;425;1276;324;1069;90;308;91;297;181;605
314585;202001;644;2039;483;1670;66;279;207;685;273;964
314587;202001;2009;5483;1516;4683;206;587;847;2699;1053;3286
314590;202001;3809;10532;2660;8287;371;1293;1092;3184;1463;4477
314600;202001;1862;5160;1070;3581;212;774;131;398;343;1172
314610;202001;8760;22219;6150;18288;1069;3761;2453;7417;3522;11178
314620;202001;2194;5202;1708;4574;45;163;1402;3707;1447;3870
314625;202001;1521;4260;1279;3920;34;206;1070;3213;1104;3419
314630;202001;5322;13721;4310;12365;113;470;3552;10194;3665;10664
314640;202001;640;1568;458;1277;61;202;245;635;306;837
314650;202001;830;1915;488;1378;52;168;246;601;298;769
314655;202001;1587;4386;1115;3526;166;515;542;1696;708;2211
314660;202001;336;784;214;559;13;29;127;314;140;343
314670;202001;1680;3826;1131;3029;20;63;729;1940;749;2003
314675;202001;1710;4573;1460;4154;83;286;1112;3056;1195;3342
314690;202001;2090;5855;1592;5098;438;1551;514;1621;952;3172
314700;202001;10069;28461;6484;21356;1236;4524;1807;5783;3043;10307
314710;202001;7652;21569;5416;16807;959;3245;1705;4686;2664;7931
314720;202001;2060;6100;1386;4683;291;1104;357;1141;648;2245
314730;202001;2116;5740;1499;4562;287;938;504;1443;791;2381
314740;202001;2859;8091;2216;6930;283;952;1117;3419;1400;4371
314750;202001;318;879;243;725;25;88;137;364;162;452
314760;202001;1805;5490;1147;3943;179;717;259;720;438;1437
314770;202001;1079;3183;548;1786;45;159;163;493;208;652
314780;202001;352;835;229;645;42;140;122;302;164;442
314790;202001;10140;27375;6874;21309;1497;5367;2177;6226;3674;11593
314795;202001;1452;3900;1209;3470;30;137;942;2589;972;2726
314800;202001;10763;27396;6318;19049;1171;3885;1386;3684;2557;7569
314810;202001;8630;23014;6192;18698;1554;5052;2004;5848;3558;10900
314820;202001;1155;2881;899;2499;50;191;564;1506;614;1697
314830;202001;1458;4456;1200;3945;232;843;556;1802;788;2645
314840;202001;867;2761;680;2444;53;265;475;1632;528;1897
314850;202001;1960;4718;1568;4206;39;128;1341;3625;1380;3753
314860;202001;3182;9514;2616;8413;224;888;1744;5449;1968;6337
314870;202001;6303;16183;4743;14062;278;915;3447;10308;3725;11223
314875;202001;1727;5201;1504;4904;105;289;1211;4019;1316;4308
314880;202001;835;2052;636;1745;29;90;392;1076;421;1166
314890;202001;423;1259;313;1013;48;180;126;376;174;556
314900;202001;669;1823;516;1561;91;309;200;582;291;891
314910;202001;1628;4661;1194;3941;225;856;541;1660;766;2516
314915;202001;2195;6542;1831;5912;126;415;1198;3826;1324;4241
314920;202001;472;1229;304;964;8;28;199;647;207;675
314930;202001;5335;15259;3989;12721;691;2380;1519;4539;2210;6919
314940;202001;389;997;319;874;29;76;202;525;231;601
314950;202001;482;1234;309;941;30;123;152;413;182;536
314960;202001;795;1944;611;1640;28;89;440;1126;468;1215
314970;202001;857;2467;643;2034;128;452;265;761;393;1213
314980;202001;1426;3707;1035;3122;202;700;437;1296;639;1996
314990;202001;2367;6865;1604;5121;330;1145;312;878;642;2023
314995;202001;1623;4517;1275;3903;46;196;833;2434;879;2630
315000;202001;1126;2901;800;2386;62;205;516;1509;578;1714
315010;202001;380;1063;281;885;43;158;132;390;175;548
315015;202001;2247;6397;1942;5884;190;650;1251;3730;1441;4380
315020;202001;772;2262;557;1782;73;297;228;644;301;941
315030;202001;571;1527;367;1134;83;258;81;228;164;486
315040;202001;794;2285;657;2012;87;291;402;1220;489;1511
315050;202001;1200;3102;846;2525;58;216;441;1275;499;1491
315053;202001;1108;2904;842;2435;51;160;484;1344;535;1504
315057;202001;1674;5171;1376;4612;146;497;906;3072;1052;3569
315060;202001;560;1700;408;1399;78;284;103;332;181;616
315070;202001;520;1377;351;1074;84;292;93;258;177;550
315080;202001;2833;8140;2128;6756;293;985;1196;3664;1489;4649
315090;202001;799;2452;584;2031;88;335;209;691;297;1026
315100;202001;1238;3735;764;2631;140;553;311;963;451;1516
315110;202001;1740;4300;1263;3553;139;382;614;1773;753;2155
315120;202001;11628;27598;8430;22660;1160;2941;4380;12230;5540;15171
315130;202001;1369;3920;1109;3444;135;487;448;1313;583;1800
315140;202001;2897;8066;2199;6797;402;1370;1063;3076;1465;4446
315150;202001;4299;10390;2972;8212;463;1496;1357;3607;1820;5103
315160;202001;1648;4097;1066;3145;236;743;466;1358;702;2101
315170;202001;1413;4481;960;3392;224;861;205;698;429;1559
315180;202001;16636;40664;8561;25439;1171;3929;2522;6570;3693;10499
315190;202001;2121;4715;1633;4072;196;470;1181;2974;1377;3444
315200;202001;3788;10998;2711;9015;803;2872;668;2122;1471;4994
315210;202001;7941;20887;5391;15428;643;1995;2596;6746;3239;8741
315213;202001;1110;2909;941;2677;18;59;764;2154;782;2213
315217;202001;2694;8001;2048;6886;92;471;1396;4482;1488;4953
315220;202001;8249;22485;6424;19226;1241;3939;2595;7778;3836;11717
315230;202001;3113;7307;2597;6647;157;267;2005;5416;2162;5683
315240;202001;2428;7124;2014;6391;450;1498;985;3104;1435;4602
315250;202001;11948;32609;8347;25656;1367;4580;3443;10124;4810;14704
315260;202001;948;2643;498;1644;83;275;36;98;119;373
315270;202001;813;2368;567;1884;77;274;180;517;257;791
315280;202001;2913;7322;1692;5067;407;1333;260;775;667;2108
315290;202001;1178;2925;693;2139;196;686;181;526;377;1212
315300;202001;628;1523;410;1203;99;333;181;529;280;862
315310;202001;1277;3607;934;2942;75;263;511;1524;586;1787
315320;202001;670;1966;461;1542;66;257;196;604;262;861
315330;202001;751;2595;409;1646;68;307;119;428;187;735
315340;202001;3053;7441;2187;6178;211;653;1246;3501;1457;4154
315350;202001;1567;4303;1204;3721;175;626;656;1991;831;2617
315360;202001;1668;4986;1226;4038;180;641;483;1495;663;2136
315370;202001;449;1317;355;1122;65;190;144;447;209;637
315380;202001;180;537;135;433;31;100;26;56;57;156
315390;202001;1102;3177;843;2678;150;549;355;1024;505;1573
315400;202001;3971;11064;3097;9432;452;1450;1606;4707;2058;6157
315410;202001;2277;5279;1712;4459;460;1279;237;680;697;1959
315415;202001;1310;3586;1055;3204;209;751;427;1324;636;2075
315420;202001;1276;3700;835;2824;168;602;141;448;309;1050
315430;202001;3606;8779;2511;7101;440;1459;1074;2838;1514;4297
315440;202001;996;2680;792;2338;71;243;455;1262;526;1505
315445;202001;1969;4779;1399;3950;89;295;995;2764;1084;3059
315450;202001;2235;6272;1808;5584;241;708;1093;3417;1334;4125
315460;202001;35222;99616;28914;88065;4780;16331;14900;42646;19680;58977
315470;202001;571;1638;408;1254;31;111;237;687;268;798
315480;202001;1197;3476;825;2662;158;537;252;780;410;1317
315490;202001;2923;7343;1969;5813;294;886;687;1992;981;2878
315500;202001;498;1355;297;909;41;148;132;349;173;497
315510;202001;1221;3235;1034;2961;24;111;883;2476;907;2587
315520;202001;1046;2877;814;2472;59;218;590;1737;649;1955
315530;202001;574;1653;447;1417;135;480;201;596;336;1076
315540;202001;1366;3739;936;2920;100;373;408;1252;508;1625
315550;202001;1912;4979;1237;3738;256;882;293;875;549;1757
315560;202001;6270;19188;5288;17370;303;969;3482;11639;3785;12608
315570;202001;1975;5413;1594;4792;92;365;944;2734;1036;3099
315580;202001;2611;6222;1935;5151;281;885;748;1876;1029;2761
315590;202001;871;2291;675;1978;74;264;355;973;429;1237
315600;202001;2433;7733;1743;6367;259;896;903;3448;1162;4344
315610;202001;914;2343;675;1895;109;380;288;695;397;1075
315620;202001;446;1229;336;1059;43;154;204;657;247;811
315630;202001;924;2471;712;2111;134;420;294;798;428;1218
315640;202001;353;893;266;784;29;111;159;436;188;547
315645;202001;955;2492;642;1969;157;520;158;473;315;993
315650;202001;1743;4262;1373;3740;34;121;1116;2935;1150;3056
315660;202001;2427;5959;1797;4865;97;294;1280;3339;1377;3633
315670;202001;13564;37531;10283;31497;2031;6472;4468;13199;6499;19671
315680;202001;3036;8926;2195;7296;327;1239;1064;3359;1391;4598
315690;202001;3156;7721;1842;5457;402;1206;555;1781;957;2987
315700;202001;7794;21994;5829;17985;927;3067;2575;7563;3502;10630
315710;202001;1841;4617;1292;3770;43;207;906;2523;949;2730
315720;202001;4359;12189;3652;10923;168;697;2588;7421;2756;8118
315725;202001;2045;5499;1555;4618;145;411;1039;3154;1184;3565
315727;202001;556;1449;409;1201;57;194;163;462;220;656
315730;202001;589;1852;516;1695;84;316;196;610;280;926
315733;202001;1259;3212;863;2499;129;456;320;877;449;1333
315737;202001;1122;3255;878;2762;36;150;611;1862;647;2012
315740;202001;870;2442;675;2035;85;305;405;1130;490;1435
315750;202001;1257;3360;989;2900;90;276;601;1782;691;2058
315760;202001;1128;2697;996;2523;49;138;836;2083;885;2221
315765;202001;1876;4990;1526;4535;27;114;1330;3942;1357;4056
315770;202001;988;2799;752;2463;298;1072;145;384;443;1456
315780;202001;27750;76783;23187;68683;1433;5274;15633;44273;17066;49547
315790;202001;3560;11018;3006;9949;383;1333;1748;5885;2131;7218
315800;202001;1221;4396;871;3451;137;615;244;851;381;1466
315810;202001;1319;3311;1078;2892;57;197;819;2090;876;2287
315820;202001;2595;7140;2088;6379;174;645;1420;4281;1594;4926
315830;202001;1209;3573;821;2751;82;298;294;940;376;1238
315840;202001;812;1983;534;1477;43;139;258;663;301;802
315850;202001;1125;3384;896;2965;174;626;432;1337;606;1963
315860;202001;474;1372;327;1099;74;268;93;279;167;547
315870;202001;451;1180;353;1027;24;85;244;665;268;750
315880;202001;1053;2765;700;2154;92;351;161;454;253;805
315890;202001;1641;4730;1292;4220;318;1131;624;2006;942;3137
315895;202001;6001;16256;4451;13198;432;1456;2286;6290;2718;7746
315900;202001;808;2091;693;1923;61;181;509;1369;570;1550
315910;202001;515;1461;433;1328;58;200;292;870;350;1070
315920;202001;1526;3876;825;2539;134;478;255;731;389;1209
315930;202001;1094;2490;708;1908;127;333;305;829;432;1162
315935;202001;805;2444;637;2122;124;443;211;701;335;1144
315940;202001;588;1657;464;1458;50;173;243;724;293;897
315950;202001;1162;3198;950;2850;88;263;713;2140;801;2403
315960;202001;4400;12504;2606;8798;815;3177;189;398;1004;3575
315970;202001;627;1665;490;1482;59;206;324;981;383;1187
315980;202001;4236;9231;2263;5996;393;1115;786;1910;1179;3025
315990;202001;3650;9282;2810;7842;260;789;1610;4362;1870;5151
316000;202001;532;1388;397;1184;53;196;185;516;238;712
316010;202001;819;2165;592;1781;40;144;374;1044;414;1188
316020;202001;923;2827;737;2457;78;317;434;1361;512;1678
316030;202001;2758;7784;2063;6526;241;788;1280;4116;1521;4904
316040;202001;2414;6938;1756;5696;323;1167;402;1135;725;2302
316045;202001;2057;5382;1862;5140;73;166;1582;4492;1655;4658
316050;202001;360;1020;269;866;39;140;144;437;183;577
316060;202001;677;1739;493;1457;23;104;337;947;360;1051
316070;202001;5335;15016;4330;13077;754;2367;1985;5807;2739;8174
316080;202001;713;2235;544;1883;128;471;77;260;205;731
316090;202001;404;1206;292;968;36;139;133;391;169;530
316095;202001;1295;4034;1023;3350;267;915;331;1062;598;1977
316100;202001;2436;7247;1721;5661;311;1107;603;1803;914;2910
316105;202001;854;2274;660;1981;38;126;457;1412;495;1538
316110;202001;13360;39142;11094;35304;848;3127;7417;23340;8265;26467
316120;202001;1139;3314;702;2252;117;390;200;533;317;923
316130;202001;1233;2798;778;2062;63;195;445;1147;508;1342
316140;202001;1149;3104;731;2324;100;351;358;1119;458;1470
316150;202001;1841;4070;1518;3658;178;554;609;1393;787;1947
316160;202001;1010;2818;814;2463;47;172;529;1543;576;1715
316165;202001;858;2149;646;1808;97;327;329;853;426;1180
316170;202001;1117;2827;833;2392;57;206;558;1545;615;1751
316180;202001;1299;3715;853;2771;138;541;154;450;292;991
316190;202001;2592;7389;1476;4706;221;727;530;1508;751;2235
316200;202001;3244;9416;2323;7695;572;2020;456;1505;1028;3525
316210;202001;4497;13303;3191;10288;1156;4026;207;549;1363;4575
316220;202001;606;1854;398;1368;99;381;43;165;142;546
316225;202001;1512;3466;1119;2820;42;165;849;1984;891;2149
316230;202001;400;1097;298;917;30;97;173;540;203;637
316240;202001;5636;16334;4896;15044;389;1313;3655;11051;4044;12364
316245;202001;2986;9836;2656;9272;135;787;1982;6541;2117;7328
316250;202001;10066;24508;7069;19650;1518;4646;2374;6501;3892;11147
316255;202001;2969;8248;2576;7628;131;421;1905;5708;2036;6129
316257;202001;1321;3288;920;2567;142;397;464;1263;606;1660
316260;202001;1980;5184;1507;4386;117;369;801;2385;918;2754
316265;202001;1143;3093;891;2674;23;84;635;1849;658;1933
316270;202001;3611;11297;3067;10072;508;1786;1423;4449;1931;6235
316280;202001;2846;8345;2414;7499;333;1120;1316;3945;1649;5065
316290;202001;3508;9698;2764;8295;307;1086;1159;3350;1466;4436
316292;202001;4981;13381;3958;11632;492;1581;2566;7269;3058;8850
316294;202001;804;2402;585;2009;98;377;151;498;249;875
316295;202001;2937;8300;2389;7348;147;564;1642;4789;1789;5353
316300;202001;986;2908;810;2622;49;186;565;1817;614;2003
316310;202001;811;2156;504;1608;103;402;82;220;185;622
316320;202001;614;1731;458;1465;49;194;218;676;267;870
316330;202001;1046;2802;775;2307;47;189;559;1587;606;1776
316340;202001;1017;2813;743;2293;74;303;408;1180;482;1483
316350;202001;1272;3644;1054;3290;95;321;720;2226;815;2547
316360;202001;630;1665;500;1446;49;154;359;1007;408;1161
316370;202001;4909;13354;3608;10911;707;2462;1231;3278;1938;5740
316380;202001;1707;4084;1321;3542;47;106;950;2555;997;2661
316390;202001;813;2193;579;1767;227;790;99;272;326;1062
316400;202001;1147;3285;724;2421;117;431;237;712;354;1143
316410;202001;1082;3135;903;2859;65;215;696;2175;761;2390
316420;202001;1908;5262;1650;4928;50;194;1367;3992;1417;4186
316430;202001;867;2308;540;1700;96;343;162;480;258;823
316440;202001;705;2243;559;1991;123;504;111;375;234;879
316443;202001;540;1518;399;1246;99;349;80;233;179;582
316447;202001;1876;5118;1621;4697;34;129;1341;3816;1375;3945
316450;202001;2148;6580;1618;5476;210;756;961;3184;1171;3940
316460;202001;1041;2694;834;2360;140;440;507;1347;647;1787
316470;202001;6513;18805;4579;14703;775;2825;1711;5052;2486;7877
316480;202001;202;556;170;509;39;116;83;243;122;359
316490;202001;315;848;223;682;27;90;85;220;112;310
316500;202001;1135;3623;739;2646;153;595;159;533;312;1128
316510;202001;720;2364;569;2071;119;454;247;906;366;1360
316520;202001;1150;2890;892;2461;123;422;431;1091;554;1513
316530;202001;1066;2825;776;2301;88;347;383;1000;471;1347
316540;202001;826;2193;650;1918;115;397;294;796;409;1193
316550;202001;1397;4111;1188;3700;62;227;892;2746;954;2973
316553;202001;3763;11361;2611;8555;444;1620;853;2508;1297;4128
316555;202001;2436;7935;2213;7628;115;418;1773;6165;1888;6583
316556;202001;558;1350;388;1058;29;90;222;564;251;654
316557;202001;991;3121;846;2864;316;1142;229;763;545;1905
316560;202001;337;950;228;778;57;245;64;179;121;424
316570;202001;1199;3538;990;3150;239;775;366;1167;605;1942
316580;202001;379;813;223;557;37;106;112;264;149;370
316590;202001;1310;3446;912;2646;169;444;470;1321;639;1765
316600;202001;948;2960;807;2659;130;461;417;1348;547;1809
316610;202001;570;1835;474;1684;52;236;282;963;334;1199
316620;202001;2006;5491;1719;5093;95;302;1288;3844;1383;4146
316630;202001;1567;4693;1259;4110;330;1095;489;1724;819;2819
316640;202001;146;387;113;337;18;60;48;120;66;180
316650;202001;1021;3303;815;2974;69;277;504;1874;573;2151
316660;202001;189;478;79;241;7;24;12;34;19;58
316670;202001;1814;4623;1328;3826;313;982;479;1340;792;2322
316680;202001;2198;5602;1647;4599;102;309;1248;3413;1350;3722
316690;202001;1284;3740;976;3132;184;654;430;1338;614;1992
316695;202001;1004;2929;820;2592;37;152;550;1705;587;1857
316700;202001;383;901;315;820;14;46;236;572;250;618
316710;202001;3007;9942;2257;8348;475;1873;855;3148;1330;5021
316720;202001;20143;55709;14584;44795;2684;8796;5863;17123;8547;25919
316730;202001;412;1152;329;987;42;140;163;453;205;593
316740;202001;687;2068;592;1915;67;260;358;1158;425;1418
316750;202001;380;1138;291;971;61;248;130;390;191;638
316760;202001;3627;11515;2920;10064;1149;4297;631;2049;1780;6346
316770;202001;1585;3692;1227;3183;23;77;1007;2673;1030;2750
316780;202001;544;1656;425;1414;155;579;63;185;218;764
316790;202001;691;1874;480;1450;107;341;135;370;242;711
316800;202001;6087;17340;4787;14945;458;1684;2505;7505;2963;9189
316805;202001;1022;2248;820;2027;65;182;621;1557;686;1739
316810;202001;649;1818;436;1363;83;298;207;600;290;898
316820;202001;311;751;162;477;10;37;70;197;80;234
316830;202001;699;1937;558;1702;72;268;349;1009;421;1277
316840;202001;2773;7338;2213;6361;207;744;1448;3951;1655;4695
316850;202001;1952;5187;1367;4114;221;714;585;1714;806;2428
316860;202001;18851;49169;13917;41658;2283;7917;6240;18198;8523;26115
316870;202001;7521;20710;5528;16865;854;2894;2416;6852;3270;9746
316880;202001;814;2220;657;2004;133;454;294;854;427;1308
316890;202001;1114;2500;645;1861;99;359;363;945;462;1304
316900;202001;2199;6054;1678;4986;335;1111;538;1470;873;2581
316905;202001;525;1573;413;1350;102;369;161;535;263;904
316910;202001;871;2321;549;1746;139;487;45;131;184;618
316920;202001;1653;4164;1080;3258;204;661;436;1289;640;1950
316930;202001;7622;22166;5449;18156;1154;4146;1341;4306;2495;8452
316935;202001;3984;10912;2876;8800;509;1688;1147;3380;1656;5068
316940;202001;6443;19113;4877;15770;778;2805;1847;5548;2625;8353
316950;202001;1866;4401;1431;3793;48;155;1169;3043;1217;3198
316960;202001;5102;11602;3660;9559;377;1092;2394;6098;2771;7190
316970;202001;3622;10447;3128;9483;514;1645;1280;3709;1794;5354
316980;202001;668;2022;499;1693;158;599;66;229;224;828
316990;202001;10651;29372;7423;22575;1992;6559;1008;2711;3000;9270
317000;202001;2567;7638;2261;7187;178;540;1644;5248;1822;5788
317005;202001;2605;7508;2042;6324;324;1046;1046;3175;1370;4221
317010;202001;24048;56615;14674;42251;3053;9651;5181;15434;8234;25085
317020;202001;63848;152470;36191;103907;6570;20719;10614;28089;17184;48808
317030;202001;658;1775;508;1569;19;85;392;1195;411;1280
317040;202001;10935;27952;7580;22119;1684;5278;2687;8020;4371;13298
317043;202001;846;1929;606;1596;61;165;426;1116;487;1281
317047;202001;1162;2805;792;2192;91;252;480;1302;571;1554
317050;202001;1182;3648;811;2773;105;358;331;1001;436;1359
317052;202001;2337;6671;1866;5892;291;931;1102;3507;1393;4438
317057;202001;1808;4447;1314;3616;40;156;837;2253;877;2409
317060;202001;446;1187;264;807;34;117;116;316;150;433
317065;202001;1203;3553;970;3103;47;172;594;1769;641;1941
317070;202001;7555;20903;5237;16372;1009;3581;1400;4107;2409;7688
317075;202001;887;2321;624;1854;104;351;239;640;343;991
317080;202001;6044;14314;4430;11690;1204;3419;1390;3499;2594;6918
317090;202001;4409;13358;3914;12540;302;937;2840;9105;3142;10042
317100;202001;2657;6337;1676;4696;385;1141;601;1620;986;2761
317103;202001;1991;5746;1663;5200;101;506;1207;3575;1308;4081
317107;202001;1379;3716;1050;3068;68;261;649;1681;717;1942
317110;202001;723;1672;364;1109;49;176;118;375;167;551
317115;202001;1073;3077;904;2770;49;129;626;1940;675;2069
317120;202001;12514;34773;9775;30202;1184;4242;5353;16028;6537;20270
317130;202001;10752;25110;6637;18315;1104;3407;2137;5884;3241;9291
317140;202001;739;1918;566;1648;38;105;378;1137;416;1242
317150;202001;1004;2407;745;2069;31;105;575;1566;606;1671
317160;202001;3621;8818;2345;6767;184;589;1275;3722;1459;4311
317170;202001;1867;4729;1305;3729;210;704;504;1241;714;1945
317180;202001;1882;6010;1372;4744;266;988;345;1126;611;2114
317190;202001;1232;3338;901;2810;103;333;518;1601;621;1934
317200;202001;4942;13085;3694;10899;1023;3285;706;1895;1729;5180
317210;202001;1172;2870;908;2513;30;113;652;1841;682;1954
317220;202001;252;785;214;707;54;179;76;269;130;448
320010;202001;4550;13327;3621;11474;385;1359;2304;7142;2689;8501
320013;202001;1769;4999;1161;3750;178;584;517;1732;695;2316
320016;202001;3030;7812;2349;6763;149;412;1803;5207;1952;5619
320020;202001;3881;10276;2879;8537;651;2112;1004;3096;1655;5208
320030;202001;1562;4548;1075;3520;197;705;368;1148;565;1853
320035;202001;1823;5087;1499;4522;376;1266;645;1885;1021;3151
320040;202001;3906;11228;3185;9862;434;1454;1743;5221;2177;6675
320050;202001;1755;4007;1509;3657;203;585;873;2041;1076;2626
320060;202001;11778;33019;8715;26885;1348;4587;3999;11676;5347;16263
320070;202001;1467;4163;998;3194;183;658;340;1041;523;1699
320080;202001;5555;14433;3892;11142;833;2522;1388;3810;2221;6332
320090;202001;8180;22067;5379;16212;1198;3901;1916;5367;3114;9268
320100;202001;2779;7865;2227;6863;380;1311;1166;3531;1546;4842
320110;202001;1529;3824;1128;3157;178;533;556;1496;734;2029
320115;202001;1785;5808;1523;5365;650;2413;421;1541;1071;3954
320120;202001;20225;52484;13874;41068;2036;6533;6144;17419;8180;23952
320130;202001;43433;122329;35565;107944;4895;16352;20245;59747;25140;76099
320140;202001;3007;8667;2204;6999;351;1269;921;2874;1272;4143
320150;202001;13233;34778;9173;26758;2380;7544;1568;4105;3948;11649
320160;202001;5588;15885;4106;13020;689;2331;1870;5843;2559;8174
320170;202001;1463;4312;1077;3545;284;942;429;1466;713;2408
320180;202001;701;2248;570;1985;203;753;150;491;353;1244
320190;202001;2720;8792;2094;7359;496;1844;539;1802;1035;3646
320200;202001;1081;2995;785;2447;188;647;269;851;457;1498
320210;202001;4479;11507;3414;9625;552;1707;1777;4769;2329;6476
320220;202001;2596;7013;1936;5889;358;1204;891;2591;1249;3795
320225;202001;1345;4236;930;3221;332;1234;180;618;512;1852
320230;202001;4661;13165;3516;11226;840;2900;1326;4142;2166;7042
320240;202001;15068;39038;11087;32521;2662;8455;3807;10881;6469;19336
320245;202001;3021;9112;2402;7820;936;3186;461;1469;1397;4655
320250;202001;2034;5846;1337;4164;307;1060;359;1007;666;2067
320255;202001;1721;5528;1519;5168;459;1589;724;2576;1183;4165
320260;202001;1051;3148;751;2409;174;646;202;545;376;1191
320265;202001;2410;7542;1980;6680;920;3283;358;1203;1278;4486
320270;202001;2214;6409;1655;5279;369;1264;666;2130;1035;3394
320280;202001;6655;18095;5292;15680;1176;3733;2201;6355;3377;10088
320290;202001;1319;3966;847;2806;229;820;198;614;427;1434
320300;202001;3493;10814;2826;9390;827;2973;609;1875;1436;4848
320305;202001;5070;14529;3919;12223;755;2546;1869;5636;2624;8182
320310;202001;1948;5501;1337;4175;245;803;568;1714;813;2517
320313;202001;2338;5961;1441;4193;303;1000;347;916;650;1916
320316;202001;1492;4240;1207;3744;187;603;709;2207;896;2810
320320;202001;21348;56557;14972;45464;3474;11056;5460;16605;8934;27661
320330;202001;2958;8082;2287;6861;452;1347;1155;3539;1607;4886
320332;202001;6183;17232;4877;14917;1219;3971;2173;6637;3392;10608
320334;202001;1755;5091;1220;3969;258;1009;257;658;515;1667
320335;202001;1444;4284;956;3134;235;842;224;673;459;1515
320340;202001;4729;12068;3927;10861;500;1504;2267;6311;2767;7815
320350;202001;5277;13286;3652;10260;463;1376;1874;5038;2337;6414
320360;202001;1429;3648;1042;2915;124;331;517;1396;641;1727
320370;202001;2405;7658;1878;6478;581;2081;606;2073;1187;4154
320380;202001;2472;6726;2038;6003;246;776;1262;3636;1508;4412
320390;202001;7161;19648;5254;15768;1095;3486;2053;5814;3148;9300
320400;202001;3213;9226;2485;7685;693;2270;885;2628;1578;4898
320405;202001;4484;11964;3338;9995;565;1806;1503;4429;2068;6235
320410;202001;4793;12539;3586;10569;632;1855;1755;5401;2387;7256
320420;202001;2958;7863;2239;6641;686;2299;421;1211;1107;3510
320425;202001;2062;4951;1554;4119;89;260;1037;2666;1126;2926
320430;202001;2941;7432;2297;6237;309;939;1456;3776;1765;4715
320435;202001;2240;7039;1769;6108;613;2220;531;1865;1144;4085
320440;202001;1380;3829;995;3085;153;511;431;1290;584;1801
320450;202001;1616;4731;1254;4039;299;1089;540;1616;839;2705
320455;202001;3993;12184;2648;8971;678;2453;663;2087;1341;4540
320460;202001;2112;6295;1459;4858;349;1241;354;1097;703;2338
320465;202001;1205;3471;910;2888;133;457;483;1530;616;1987
320470;202001;3716;10323;2578;7885;596;1950;592;1624;1188;3574
320480;202001;1662;4648;1363;4128;217;755;752;2200;969;2955
320490;202001;20828;55063;15136;44882;2611;8538;6115;17876;8726;26414
320495;202001;1372;3778;937;2925;196;707;334;993;530;1700
320500;202001;52466;140797;41853;122187;6065;19177;23655;66091;29720;85268
320501;202001;4399;12763;3196;10577;888;3304;1060;3437;1948;6741
320503;202001;2000;6061;1413;4791;405;1483;444;1403;849;2886
320506;202001;2538;7624;1765;5880;521;1878;180;601;701;2479
320510;202001;9941;27203;7998;23783;930;3205;4839;13882;5769;17087
320515;202001;1732;4786;1318;3920;362;1172;420;1205;782;2377
320517;202001;2125;6471;1675;5513;555;1987;451;1439;1006;3426
320520;202001;35485;92986;26204;77175;4728;15287;10722;30547;15450;45834
320530;202001;30762;82545;23953;70295;2400;8369;14557;40338;16957;48707
330010;202001;21476;57978;17375;50984;2533;7916;10658;30615;13191;38531
330015;202001;1520;3781;1174;3230;206;647;625;1625;831;2272
330020;202001;20351;50957;17174;46341;2439;7460;11858;31104;14297;38564
330022;202001;1925;5152;1453;4337;248;755;816;2421;1064;3176
330023;202001;4985;11966;3496;9824;609;1882;1807;4933;2416;6815
330025;202001;5095;12469;3355;9526;945;2926;917;2500;1862;5426
330030;202001;10402;28016;7771;23575;858;3024;4634;13395;5492;16419
330040;202001;14685;38483;11569;33088;1162;3755;7546;20669;8708;24424
330045;202001;85025;201606;69491;181767;5368;14188;54443;141340;59811;155528
330050;202001;2522;6711;1828;5527;386;1240;825;2379;1211;3619
330060;202001;4853;13027;3983;11502;793;2536;1742;4642;2535;7178
330070;202001;23122;59248;18643;52584;3034;9101;10645;29784;13679;38885
330080;202001;8894;22656;7547;20707;964;2788;5122;13896;6086;16684
330090;202001;3498;7327;2289;5683;139;379;1526;3789;1665;4168
330093;202001;2489;6144;1806;5141;129;388;1311;3742;1440;4130
330095;202001;1238;3537;942;2960;79;301;555;1605;634;1906
330100;202001;70518;188440;59654;172056;3814;13142;44689;126842;48503;139984
330110;202001;2102;5918;1709;5254;278;943;915;2701;1193;3644
330115;202001;2182;5427;1634;4628;247;797;958;2603;1205;3400
330120;202001;3590;8110;2622;6824;263;766;1717;4296;1980;5062
330130;202001;4068;11145;3337;10054;483;1531;2055;6137;2538;7668
330140;202001;3616;9530;2845;8388;422;1368;1752;5032;2174;6400
330150;202001;2179;5823;1656;4990;324;1033;761;2244;1085;3277
330160;202001;1396;3825;1045;3192;180;602;546;1590;726;2192
330170;202001;105069;264868;84086;235985;11713;32705;54987;156204;66700;188909
330180;202001;2087;5094;1587;4356;111;348;1051;2783;1162;3131
330185;202001;9813;24876;8105;22415;562;1897;6279;16881;6841;18778
330187;202001;4301;11063;3363;9541;474;1496;1934;5439;2408;6935
330190;202001;32639;79995;27583;72962;2057;5899;21534;56216;23591;62115
330200;202001;15779;40660;12829;36955;2581;7140;7889;23352;10470;30492
330205;202001;2061;5165;1566;4350;85;283;1064;2842;1149;3125
330210;202001;3356;8499;2434;6862;353;1115;1160;3004;1513;4119
330220;202001;11482;29026;8054;23168;1786;5724;2674;7095;4460;12819
330225;202001;3751;9616;2820;8177;217;762;1976;5563;2193;6325
330227;202001;17777;43039;14925;39502;662;1999;12672;33040;13334;35039
330230;202001;1712;3951;1202;3298;104;306;793;2152;897;2458
330240;202001;23958;62643;19414;55368;2579;8048;12250;34008;14829;42056
330245;202001;1679;4199;995;2999;193;623;355;1072;548;1695
330250;202001;37492;97073;31027;87405;5621;16159;18289;51563;23910;67722
330260;202001;4314;10788;3239;9289;375;1214;2123;5856;2498;7070
330270;202001;28798;62563;17573;45247;2951;8194;7096;17746;10047;25940
330280;202001;2391;6358;1772;5274;184;606;1034;2960;1218;3566
330285;202001;23098;56069;18194;48944;1565;4906;13045;33861;14610;38767
330290;202001;3707;9130;2948;8114;323;1009;2035;5434;2358;6443
330300;202001;5791;13749;4088;11236;326;1024;2749;7399;3075;8423
330310;202001;2422;6092;1793;5058;117;303;1205;3390;1322;3693
330320;202001;16433;39413;12575;34528;1480;4083;8966;24717;10446;28800
330330;202001;36244;80679;27753;69119;2629;7206;19615;47820;22244;55026
330340;202001;14752;36692;10563;29981;1728;5430;5203;14109;6931;19539
330350;202001;128062;301633;104352;272477;7133;19512;83748;217735;90881;237247
330360;202001;7577;18379;6466;17013;230;618;5435;14228;5665;14846
330370;202001;4816;13849;3562;11672;818;2753;1452;4959;2270;7712
330380;202001;5459;14849;4069;12315;734;2533;1913;5528;2647;8061
330385;202001;3965;11525;3212;10403;776;2765;1484;4762;2260;7527
330390;202001;26129;71421;19781;60097;2883;9994;10908;31262;13791;41256
330395;202001;3202;8014;2627;7257;169;526;1857;5027;2026;5553
330400;202001;3188;8581;2705;7807;157;569;2011;5473;2168;6042
330410;202001;2948;8101;2224;6810;413;1414;1030;2991;1443;4405
330411;202001;2795;7578;2149;6327;152;517;1482;4187;1634;4704
330412;202001;1505;4337;1205;3821;136;495;722;2150;858;2645
330414;202001;23441;59460;18724;52958;1736;5046;13341;37469;15077;42515
330415;202001;4137;11283;3187;9635;331;1038;1856;5611;2187;6649
330420;202001;10737;26717;7238;20968;948;3086;3474;9439;4422;12525
330430;202001;9513;23018;7986;20889;364;1196;6135;15512;6499;16708
330440;202001;2365;6426;1747;5381;308;1126;944;2768;1252;3894
330450;202001;1315;3831;1046;3358;138;483;548;1727;686;2210
330452;202001;16243;41901;12844;36627;1770;5628;7867;21764;9637;27392
330455;202001;558041;1331645;422816;1133316;62105;177326;259888;684852;321993;862178
330460;202001;1206;3294;889;2813;159;535;473;1455;632;1990
330470;202001;4900;12377;3548;10260;1109;3312;1079;3185;2188;6497
330475;202001;9287;24338;7447;21904;1221;4082;4645;13370;5866;17452
330480;202001;5993;15575;5014;14129;407;1286;3425;9386;3832;10672
330490;202001;114847;265642;92915;235825;10406;27803;65571;164321;75977;192124
330500;202001;7282;18161;6069;16471;657;1988;4314;11519;4971;13507
330510;202001;40402;101150;30097;86397;5427;16545;17562;49747;22989;66292
330513;202001;1251;3277;978;2882;210;672;480;1411;690;2083
330515;202001;2542;6768;2018;6002;410;1305;1056;3060;1466;4365
330520;202001;11300;30126;9136;26630;1248;4020;5433;15385;6681;19405
330530;202001;1677;4149;1214;3418;249;753;545;1501;794;2254
330540;202001;2963;7874;2256;6631;552;1692;914;2616;1466;4308
330550;202001;8946;23766;6880;20926;2009;6611;2644;7940;4653;14551
330555;202001;16750;36305;13871;32854;929;2481;10891;25961;11820;28442
330560;202001;4267;11477;3422;10030;522;1583;1985;5670;2507;7253
330570;202001;2790;7687;2297;6889;366;1184;1437;4259;1803;5443
330575;202001;5516;14338;4728;12971;305;954;3713;9821;4018;10775
330580;202001;16450;44472;12473;37151;2367;7610;5707;16273;8074;23883
330590;202001;1450;3952;1209;3633;222;671;755;2298;977;2969
330600;202001;11807;31393;9372;27378;1014;3369;5694;16253;6708;19622
330610;202001;9367;25044;7521;22112;629;2198;5141;14682;5770;16880
330615;202001;2108;5761;1593;5047;309;1008;969;3127;1278;4135
330620;202001;3976;11470;3142;10007;722;2507;1298;3872;2020;6379
330630;202001;24736;62502;19224;53677;1535;5086;13374;35966;14909;41052
350010;202001;2120;5487;1041;3129;226;719;154;335;380;1054
350020;202001;684;1758;371;1139;48;142;150;425;198;567
350030;202001;3743;10495;2720;8640;674;2308;1033;3111;1707;5419
350040;202001;691;2002;389;1350;58;230;121;327;179;557
350050;202001;1184;2984;762;2223;175;586;245;577;420;1163
350055;202001;925;2421;698;2060;82;265;388;1080;470;1345
350060;202001;118;294;77;230;10;36;43;132;53;168
350070;202001;3518;9286;2161;6767;423;1484;623;1759;1046;3243
350075;202001;585;1746;426;1425;169;608;35;107;204;715
350080;202001;663;1726;408;1260;58;202;154;434;212;636
350090;202001;633;1498;363;1015;72;221;144;367;216;588
350100;202001;2159;5832;1438;4515;120;464;837;2492;957;2956
350110;202001;483;1244;326;957;19;70;185;532;204;602
350115;202001;1291;3769;1046;3240;195;679;528;1477;723;2156
350120;202001;639;1500;334;917;37;118;161;396;198;514
350130;202001;3076;8242;2404;6999;425;1293;1135;3130;1560;4423
350140;202001;759;2162;490;1605;52;233;254;756;306;989
350150;202001;490;1506;396;1322;99;316;100;311;199;627
350160;202001;11162;27794;7221;20681;918;3023;4199;11345;5117;14368
350170;202001;2010;5881;1573;4902;303;984;646;1889;949;2873
350180;202001;1040;2575;511;1538;110;332;90;258;200;590
350190;202001;2889;8230;1970;6244;378;1383;796;2111;1174;3494
350200;202001;420;1192;327;1020;20;69;213;628;233;697
350210;202001;5551;12793;3651;9913;516;1509;2142;5595;2658;7104
350220;202001;2871;7869;1906;5938;432;1431;610;1708;1042;3139
350230;202001;984;2594;810;2332;163;514;422;1180;585;1694
350240;202001;675;1968;420;1365;85;274;115;354;200;628
350250;202001;2358;6984;1746;5907;633;2322;279;996;912;3318
350260;202001;792;1914;494;1389;54;162;301;826;355;988
350270;202001;4546;12343;3563;10442;555;1753;1808;4950;2363;6703
350275;202001;2406;6515;1898;5684;321;1094;1072;3017;1393;4111
350280;202001;18950;42475;10880;29399;1898;5469;3931;10226;5829;15695
350290;202001;3122;8638;2100;6533;387;1324;815;2346;1202;3670
350300;202001;658;1796;477;1452;74;235;231;652;305;887
350310;202001;852;2466;617;1969;106;406;233;657;339;1063
350315;202001;557;1445;359;1096;26;101;166;463;192;564
350320;202001;14496;37633;10617;30717;2343;7436;3726;10044;6069;17480
350330;202001;14160;35021;9863;26629;1150;3418;5984;15181;7134;18599
350335;202001;361;1032;274;864;34;122;137;409;171;531
350340;202001;1158;2986;683;2112;120;414;255;718;375;1132
350350;202001;759;1952;585;1755;76;277;332;967;408;1244
350360;202001;1085;3244;821;2676;222;736;243;797;465;1533
350370;202001;610;1542;418;1192;154;423;109;321;263;744
350380;202001;4419;11916;2941;9029;805;2491;659;2083;1464;4574
350390;202001;9786;26364;7572;22510;1810;5581;3089;8995;4899;14576
350395;202001;432;1106;214;681;23;67;73;210;96;277
350400;202001;8001;19983;5476;15726;1343;4172;1509;4176;2852;8348
350410;202001;9600;26960;6812;21438;1469;5152;2371;6874;3840;12026
350420;202001;702;1884;488;1458;85;280;117;307;202;587
350430;202001;652;1768;518;1541;70;251;310;826;380;1077
350440;202001;1874;4772;1498;4204;112;366;982;2695;1094;3061
350450;202001;6750;18662;5203;15912;1127;3749;2106;6020;3233;9769
350460;202001;1696;4421;852;2657;136;441;164;445;300;886
350470;202001;268;687;198;566;9;34;131;357;140;391
350480;202001;946;2434;580;1761;119;416;101;257;220;673
350490;202001;1883;5006;1326;4071;307;988;385;1089;692;2077
350500;202001;684;1826;512;1502;80;257;246;670;326;927
350510;202001;1129;2943;812;2352;100;339;460;1269;560;1608
350520;202001;2110;6514;1625;5541;259;982;718;2223;977;3205
350530;202001;2741;6915;1974;5451;219;669;1128;2918;1347;3587
350535;202001;1397;3874;1197;3590;172;589;738;2117;910;2706
350540;202001;1785;4494;1292;3725;183;567;760;2127;943;2694
350550;202001;8498;21109;5830;16627;639;2152;3312;8770;3951;10922
350560;202001;3930;11137;3091;9599;299;998;1874;5627;2173;6625
350570;202001;24205;68103;19313;58416;3737;12373;9352;26978;13089;39351
350580;202001;1964;5405;1054;3402;273;963;171;447;444;1410
350590;202001;4856;13339;3482;10215;501;1669;1973;5321;2474;6990
350600;202001;37070;86301;22534;60564;3311;9927;10401;25657;13712;35584
350610;202001;6621;18343;4716;14470;870;2910;2069;6066;2939;8976
350620;202001;402;1005;242;771;26;93;130;392;156;485
350630;202001;1457;3859;1055;3116;74;277;662;1824;736;2101
350635;202001;8304;20943;6213;17665;1064;3359;3414;9145;4478;12504
350640;202001;938;2555;492;1531;71;229;141;369;212;598
350650;202001;7939;21453;5266;16036;1066;3502;1812;5093;2878;8595
350660;202001;4632;12164;3508;10282;607;1789;1769;5175;2376;6964
350670;202001;1876;4961;1511;4423;157;487;999;2911;1156;3398
350680;202001;1125;3036;731;2299;157;511;268;816;425;1327
350690;202001;1256;3299;891;2673;150;478;474;1368;624;1846
350700;202001;4802;12210;3284;9839;581;1958;1409;3972;1990;5930
350710;202001;2761;7660;2300;6848;374;1294;1227;3410;1601;4704
350715;202001;836;2398;674;2088;70;284;350;981;420;1265
350720;202001;164;424;114;332;17;49;33;77;50;126
350730;202001;603;1641;493;1444;27;112;361;990;388;1102
350740;202001;1613;4397;1070;3245;202;645;317;890;519;1535
350745;202001;539;1426;308;943;30;112;153;437;183;549
350750;202001;9974;26157;7508;21811;1321;4419;3280;8469;4601;12888
350760;202001;13697;34534;9490;27180;2160;6787;3330;8587;5490;15374
350770;202001;949;2389;587;1751;42;139;358;1038;400;1177
350775;202001;682;1644;457;1289;46;136;215;589;261;725
350780;202001;2005;5014;1387;4097;250;825;482;1606;732;2431
350790;202001;1698;4576;1046;3366;201;695;254;665;455;1360
350800;202001;3272;9643;2799;8789;311;1104;1788;5443;2099;6547
350810;202001;2620;6549;2041;5700;270;755;1156;3263;1426;4018
350820;202001;910;2134;501;1403;49;160;237;606;286;766
350830;202001;837;2363;461;1521;74;237;134;391;208;628
350840;202001;3009;8945;2172;7281;524;1942;858;2616;1382;4558
350850;202001;6687;18875;5077;15897;1070;3640;2102;6337;3172;9977
350860;202001;3540;9593;3046;8898;141;519;2270;6525;2411;7044
350870;202001;2668;7575;1933;6361;278;1041;1019;3249;1297;4290
350880;202001;1258;3656;968;3059;235;765;278;846;513;1611
350890;202001;548;1424;350;1018;52;163;125;333;177;496
350900;202001;6834;18810;4232;13105;1024;3458;1158;3239;2182;6697
350910;202001;878;2232;736;1998;95;274;508;1353;603;1627
350920;202001;11827;29579;9874;26347;479;1579;7846;20126;8325;21705
350925;202001;4437;12175;3133;9740;598;1994;1428;4093;2026;6087
350930;202001;1474;3828;977;2866;111;338;558;1606;669;1944
350940;202001;2241;6026;1732;5175;200;653;1057;3044;1257;3697
350945;202001;839;2354;616;1922;97;360;313;876;410;1236
350950;202001;85412;222025;64736;182296;8787;27229;38198;102320;46985;129549
350960;202001;6283;17227;4828;14447;596;2044;2843;8053;3439;10097
350970;202001;3564;10221;2586;8262;771;2742;457;1235;1228;3977
350980;202001;625;1730;501;1512;140;446;214;637;354;1083
350990;202001;1771;5032;1279;4193;302;1108;439;1351;741;2459
350995;202001;763;2389;685;2232;54;211;468;1466;522;1677
351000;202001;2792;7300;1949;5774;351;1120;710;2002;1061;3122
351010;202001;321;790;208;594;22;71;115;313;137;384
351015;202001;777;2342;616;2006;90;337;283;819;373;1156
351020;202001;8959;24656;6676;20672;1348;4302;3187;9594;4535;13896
351030;202001;2680;8016;2150;6949;328;1171;1133;3558;1461;4729
351040;202001;4920;12343;4082;11057;206;696;3300;8650;3506;9346
351050;202001;17581;42946;12150;34318;2452;7299;4975;13859;7427;21158
351060;202001;48351;122301;36506;101861;3995;12298;23791;64191;27786;76489
351070;202001;1474;3679;792;2463;192;649;133;395;325;1044
351080;202001;2753;6784;1948;5800;233;848;1251;3505;1484;4353
351090;202001;320;942;223;758;49;164;58;195;107;359
351100;202001;2532;6820;1605;4939;344;1114;442;1430;786;2544
351110;202001;5959;15332;3787;11234;656;2141;1562;4325;2218;6466
351120;202001;781;2006;510;1543;58;178;199;593;257;771
351130;202001;1112;2924;484;1566;97;332;98;296;195;628
351140;202001;1909;5505;1361;4414;295;1059;487;1425;782;2484
351150;202001;2163;6284;1409;4603;253;912;533;1537;786;2449
351160;202001;1111;3479;830;2805;184;657;228;681;412;1338
351170;202001;1385;3853;1193;3500;104;334;819;2321;923;2655
351190;202001;1014;2807;639;2027;117;386;209;600;326;986
351200;202001;1603;3871;1185;3240;96;294;801;2063;897;2357
351210;202001;1523;3769;912;2576;73;239;532;1413;605;1652
351220;202001;3229;9216;2742;8398;342;1071;1762;5367;2104;6438
351230;202001;1804;4963;1301;4056;246;882;564;1589;810;2471
351240;202001;2370;6073;1406;4011;284;846;554;1426;838;2272
351250;202001;1082;2884;619;1939;79;257;216;668;295;925
351260;202001;907;2330;647;1861;138;383;222;637;360;1020
351270;202001;398;1091;326;969;36;121;191;496;227;617
351280;202001;3852;10207;2921;8454;550;1674;1323;3668;1873;5342
351290;202001;1188;3012;800;2314;126;386;423;1177;549;1563
351300;202001;16582;45638;11112;34921;2066;7031;4446;13448;6512;20479
351310;202001;3296;8261;2445;6898;191;668;1706;4533;1897;5201
351320;202001;924;2717;667;2157;128;441;226;657;354;1098
351330;202001;479;1124;393;968;32;91;278;610;310;701
351340;202001;6364;18316;5055;15998;1229;4046;2165;6821;3394;10867
351350;202001;11752;29757;9639;26344;1078;3178;6889;18265;7967;21443
351360;202001;3800;10282;3119;9224;748;2379;1150;3175;1898;5554
351370;202001;2110;5971;1381;4416;340;1159;418;1209;758;2368
351380;202001;47575;116508;33103;90646;4544;13340;18003;47030;22547;60370
351385;202001;307;799;150;452;27;81;43;123;70;204
351390;202001;1383;3379;806;2509;127;467;442;1281;569;1748
351400;202001;931;2607;757;2256;135;401;435;1265;570;1666
351410;202001;2636;7437;1857;5870;331;1064;690;2133;1021;3197
351420;202001;372;889;192;575;27;74;104;295;131;369
351430;202001;933;2587;713;2219;69;226;453;1369;522;1595
351440;202001;3348;8928;2123;6327;383;1197;570;1450;953;2647
351450;202001;1712;4583;1078;3359;217;744;166;402;383;1146
351460;202001;825;2167;622;1821;152;439;330;958;482;1397
351470;202001;1190;3039;899;2546;87;288;557;1482;644;1770
351480;202001;2531;7479;1986;6513;370;1326;819;2512;1189;3838
351490;202001;1945;5574;1649;5022;84;339;1282;3737;1366;4076
351492;202001;339;937;279;809;9;27;195;556;204;583
351495;202001;193;510;140;401;15;39;74;207;89;246
351500;202001;36831;91951;27012;74911;4234;12635;15255;40340;19489;52975
351510;202001;12847;32128;9215;25751;1171;3745;5603;14907;6774;18652
351512;202001;478;1282;319;934;54;157;103;270;157;427
351515;202001;3260;7326;1949;5225;339;1016;546;1557;885;2573
351518;202001;2438;6222;1533;4552;214;713;827;2222;1041;2935
351519;202001;721;2013;425;1410;84;278;58;185;142;463
351520;202001;1185;2950;465;1453;55;191;180;492;235;683
351530;202001;348;932;195;599;26;85;76;184;102;269
351535;202001;1946;4720;1377;3755;212;638;690;1769;902;2407
351540;202001;2301;5804;1468;4320;312;1056;455;1173;767;2229
351550;202001;6825;17117;4441;12681;453;1515;2447;6448;2900;7963
351560;202001;445;1279;348;1085;88;306;95;270;183;576
351565;202001;196;569;153;491;36;133;41;118;77;251
351570;202001;19969;54471;14762;43505;1706;5452;8845;24887;10551;30339
351580;202001;258;663;145;444;13;42;62;195;75;237
351590;202001;506;1145;263;713;24;83;141;346;165;429
351600;202001;1343;3500;1019;2914;95;308;633;1703;728;2011
351610;202001;760;1802;466;1279;31;102;250;639;281;741
351620;202001;22397;60161;16198;48992;2708;9273;7053;19165;9761;28438
351630;202001;25917;69401;20523;59873;3219;9878;12220;34587;15439;44465
351640;202001;16418;44087;12521;36688;1285;4302;8262;23203;9547;27505
351650;202001;387;1024;164;543;17;62;41;113;58;175
351660;202001;754;2157;463;1476;86;286;63;162;149;448
351670;202001;5858;15787;3745;11177;787;2356;1617;4527;2404;6883
351680;202001;432;1245;269;866;49;161;54;132;103;293
351685;202001;431;1252;344;1105;94;302;100;290;194;592
351690;202001;1042;2672;606;1787;91;298;239;629;330;927
351700;202001;1348;3403;959;2704;137;379;536;1447;673;1826
351710;202001;759;2045;504;1556;44;159;261;726;305;885
351720;202001;1441;3736;925;2813;148;490;351;1019;499;1509
351730;202001;901;2376;747;2127;64;227;492;1338;556;1565
351740;202001;3585;9087;2782;7533;480;1409;1373;3434;1853;4843
351750;202001;1301;3453;803;2560;156;520;291;914;447;1434
351760;202001;3265;9244;2319;7282;491;1728;813;2288;1304;4016
351770;202001;1775;5311;1440;4644;287;969;722;2283;1009;3252
351780;202001;1315;3388;735;2226;113;396;237;678;350;1074
351790;202001;1344;3190;1041;2788;170;461;606;1645;776;2106
351800;202001;503;1166;237;666;20;55;89;214;109;269
351810;202001;1027;2682;818;2351;40;123;578;1580;618;1703
351820;202001;2510;7087;1720;5534;441;1553;354;1052;795;2605
351830;202001;4481;12202;3390;10269;332;1217;2041;5860;2373;7077
351840;202001;8455;23798;6331;19730;955;3310;3150;9173;4105;12483
351850;202001;1672;4519;1051;3283;182;658;330;871;512;1529
351860;202001;2807;8217;2147;6948;382;1312;1129;3669;1511;4981
351870;202001;23530;60818;17572;50811;4856;14403;6695;19831;11551;34234
351880;202001;120263;316643;88135;259932;21713;69925;35253;99139;56966;169064
351885;202001;901;2463;711;2128;73;261;448;1275;521;1536
351890;202001;760;2025;485;1547;117;384;71;195;188;579
351900;202001;1081;2916;828;2530;119;369;451;1371;570;1740
351905;202001;408;1127;268;843;19;67;106;283;125;350
351907;202001;21474;56626;16315;47271;1909;6052;10241;28629;12150;34681
351910;202001;1352;3567;934;2679;75;238;519;1347;594;1585
351920;202001;832;2216;609;1785;84;290;284;762;368;1052
351925;202001;864;2372;664;1982;89;289;327;905;416;1194
351930;202001;3210;9056;2876;8431;575;1693;1894;5481;2469;7174
351940;202001;1095;2859;788;2329;121;388;377;1094;498;1482
351950;202001;1601;3750;1145;3068;70;203;766;1985;836;2188
351960;202001;5320;13564;3807;10831;823;2527;1646;4331;2469;6858
351970;202001;6902;20800;5502;18268;892;3308;2964;9561;3856;12869
351980;202001;1053;2473;651;1815;84;269;363;938;447;1207
351990;202001;1433;3399;996;2740;64;240;456;1120;520;1360
352000;202001;2557;7371;2179;6585;268;936;1403;3948;1671;4884
352010;202001;2182;5947;1733;5173;444;1452;354;1081;798;2533
352020;202001;1474;4056;1119;3447;182;606;521;1515;703;2121
352030;202001;5463;14625;4261;12666;841;2775;2122;6096;2963;8871
352040;202001;2802;7645;1846;5652;280;933;631;1660;911;2593
352042;202001;3120;7660;1958;5721;386;1260;796;2251;1182;3511
352044;202001;2098;5642;1170;3818;186;690;246;727;432;1417
352050;202001;12000;32048;7505;23074;1838;6450;1227;3166;3065;9616
352060;202001;712;1933;513;1556;69;229;228;637;297;866
352070;202001;867;1765;553;1344;62;165;255;536;317;701
352080;202001;455;1154;278;808;29;91;103;264;132;355
352090;202001;1441;4258;1167;3698;142;531;525;1489;667;2020
352100;202001;3060;8692;2510;7654;577;1912;1135;3292;1712;5204
352110;202001;577;1714;437;1421;96;324;171;519;267;843
352115;202001;493;1372;400;1225;55;193;226;682;281;875
352120;202001;858;2593;684;2235;85;297;394;1203;479;1500
352130;202001;1909;5440;1252;3801;206;665;488;1376;694;2041
352140;202001;1264;3351;837;2522;143;465;380;1091;523;1556
352150;202001;831;2243;631;1889;91;291;396;1150;487;1441
352160;202001;989;2454;704;2013;83;284;379;1031;462;1315
352170;202001;2965;8079;2298;6714;352;1166;1295;3462;1647;4628
352180;202001;2590;7067;1995;5935;469;1561;572;1469;1041;3030
352190;202001;1203;3259;918;2809;162;483;430;1360;592;1843
352200;202001;359;1077;250;854;35;135;91;297;126;432
352210;202001;19266;46074;14933;40232;1134;3351;11270;29883;12404;33234
352215;202001;575;1516;499;1418;62;202;340;926;402;1128
352220;202001;18410;46449;12028;34802;2807;8558;4181;11502;6988;20060
352230;202001;13025;38342;9843;32250;2324;8505;3471;10501;5795;19006
352240;202001;10704;27928;8101;23410;1796;5837;3343;8847;5139;14684
352250;202001;23487;65940;18619;57291;3189;10471;10750;32464;13939;42935
352260;202001;4932;12516;3310;9311;496;1625;1849;4679;2345;6304
352265;202001;906;2560;795;2392;49;197;589;1712;638;1909
352270;202001;1462;4416;1074;3560;226;818;360;1124;586;1942
352280;202001;2426;6225;1825;5315;196;713;1051;2807;1247;3520
352290;202001;1151;3391;919;2921;133;482;465;1321;598;1803
352300;202001;910;2463;593;1786;81;276;303;847;384;1123
352310;202001;46042;122739;33567;100371;8345;25609;13957;41922;22302;67531
352320;202001;6390;17054;4832;13934;754;2431;2474;6459;3228;8890
352330;202001;2216;5885;1648;5086;308;1116;816;2359;1124;3475
352340;202001;5522;14639;3960;11778;657;2248;1918;5241;2575;7489
352350;202001;2162;6241;1696;5182;198;740;887;2410;1085;3150
352360;202001;1254;3364;1039;2978;89;313;770;2105;859;2418
352370;202001;1063;3055;916;2794;23;101;711;2114;734;2215
352380;202001;824;2270;615;1886;125;399;211;615;336;1014
352390;202001;15686;38550;10470;29421;1688;5173;5616;14898;7304;20071
352400;202001;3511;9742;2884;8554;603;2079;1497;4097;2100;6176
352410;202001;3197;8286;2398;6923;230;800;1446;3956;1676;4756
352420;202001;838;2053;583;1666;101;310;208;562;309;872
352430;202001;7696;19400;5424;15382;1226;3910;2362;6294;3588;10204
352440;202001;17720;48470;13100;39417;3177;9956;4844;14118;8021;24074
352450;202001;809;2062;395;1289;52;183;120;362;172;545
352460;202001;2927;8170;1969;6378;403;1441;730;2212;1133;3653
352470;202001;3330;8366;2403;6865;306;997;1323;3517;1629;4514
352480;202001;3673;8801;2352;6422;375;1168;1112;2755;1487;3923
352490;202001;711;2093;556;1789;103;355;252;763;355;1118
352500;202001;10523;27239;7008;20593;2955;9544;786;1343;3741;10887
352510;202001;3622;9789;2660;8110;581;1907;1161;3340;1742;5247
352520;202001;2648;7058;2031;5969;395;1316;1087;2884;1482;4200
352530;202001;9728;25712;6096;18401;1165;4006;1431;3553;2596;7559
352540;202001;536;1620;382;1263;63;233;114;334;177;567
352550;202001;975;2778;685;2210;137;474;205;598;342;1072
352560;202001;592;1644;447;1361;73;236;205;577;278;813
352570;202001;2145;6273;1315;4402;322;1168;146;416;468;1584
352580;202001;652;1683;532;1471;59;197;336;880;395;1077
352585;202001;263;754;199;629;16;64;109;307;125;371
352590;202001;12934;34042;8914;26282;2394;7669;3758;10297;6152;17966
352600;202001;1967;5336;1520;4478;180;590;905;2502;1085;3092
352610;202001;3013;8448;2246;7087;467;1661;885;2599;1352;4260
352620;202001;5665;14735;4328;12730;1276;3827;1605;4774;2881;8601
352630;202001;821;2070;612;1750;106;356;274;700;380;1056
352640;202001;2979;7731;2105;6200;224;684;1180;3334;1404;4018
352650;202001;583;1657;406;1246;57;204;149;433;206;637
352660;202001;1025;3049;815;2598;162;534;357;1097;519;1631
352670;202001;8952;24441;5650;17798;1522;5083;975;2968;2497;8051
352680;202001;3201;9611;2236;7353;353;1394;1091;3252;1444;4646
352690;202001;27017;68298;20416;56700;1525;5016;13824;36727;15349;41743
352700;202001;567;1412;416;1204;153;498;88;239;241;737
352710;202001;4997;13043;3467;10219;821;2683;1406;3798;2227;6481
352720;202001;7807;21581;6010;18119;2617;7980;1060;2973;3677;10953
352725;202001;540;1356;294;866;17;50;140;390;157;440
352730;202001;2769;7899;2294;6798;331;1093;1357;3683;1688;4776
352740;202001;2264;5361;1642;4439;176;547;974;2494;1150;3041
352750;202001;402;1011;230;709;35;117;92;252;127;369
352760;202001;1652;4640;1232;3777;145;471;619;1864;764;2335
352770;202001;894;2416;592;1819;126;401;225;659;351;1060
352780;202001;624;1790;432;1405;82;271;121;388;203;659
352790;202001;433;1171;291;877;32;109;110;293;142;402
352800;202001;1269;3948;891;3054;246;889;120;355;366;1244
352810;202001;1130;2706;701;1923;83;238;419;1090;502;1328
352820;202001;515;1375;336;1066;72;233;71;249;143;482
352830;202001;575;1457;251;773;23;78;51;129;74;207
352840;202001;3884;11205;3164;9897;1086;3679;986;2983;2072;6662
352850;202001;10705;26382;7099;20485;1955;6144;2125;5540;4080;11684
352860;202001;1023;2830;724;2264;145;485;242;722;387;1207
352870;202001;894;2238;619;1665;41;135;405;1029;446;1164
352880;202001;1784;4205;1235;3251;173;478;734;1825;907;2303
352885;202001;305;873;223;716;24;84;128;389;152;473
352890;202001;691;1643;430;1115;43;123;241;560;284;683
352900;202001;17888;46852;11718;34614;1936;6142;5106;14149;7042;20291
352910;202001;439;1164;221;691;23;72;58;165;81;237
352920;202001;2691;6954;1925;5584;145;455;1278;3580;1423;4035
352930;202001;5646;15349;4099;12294;736;2410;1866;5197;2602;7607
352940;202001;22312;61837;16022;48240;3487;11523;6038;17064;9525;28587
352950;202001;485;1282;280;887;72;237;38;103;110;340
352960;202001;722;1953;385;1231;60;211;83;237;143;448
352965;202001;266;716;148;488;44;144;35;104;79;248
352970;202001;3016;7205;2271;5986;259;729;1451;3778;1710;4507
352980;202001;1401;3743;1091;3257;268;860;539;1567;807;2427
352990;202001;4109;11548;3214;10077;646;2249;1579;4738;2225;6987
353000;202001;458;1255;244;755;35;114;57;146;92;260
353010;202001;2496;6239;1624;4683;366;1198;626;1643;992;2841
353020;202001;3655;9502;2061;6141;297;1020;697;1913;994;2933
353030;202001;4288;11069;2871;8481;683;2185;725;2059;1408;4244
353040;202001;635;1499;454;1233;60;177;266;675;326;852
353050;202001;5172;15010;3661;11857;736;2593;1582;4896;2318;7489
353060;202001;48493;124148;39432;109646;2856;9607;29035;77697;31891;87304
353070;202001;9399;26897;6546;20792;1315;4560;2418;7083;3733;11643
353080;202001;4075;11412;2731;8741;524;1896;1024;2872;1548;4768
353090;202001;547;1673;408;1373;36;132;233;758;269;890
353100;202001;295;804;126;409;26;88;31;77;57;165
353110;202001;7632;20776;6111;18528;1192;3689;3256;10131;4448;13820
353120;202001;400;1015;285;819;39;132;115;290;154;422
353130;202001;2426;5810;1540;4353;411;1282;487;1268;898;2550
353140;202001;2699;6754;1920;5371;130;430;1279;3378;1409;3808
353150;202001;1520;3779;1064;3027;204;616;459;1222;663;1838
353160;202001;559;1463;392;1187;71;244;162;448;233;692
353170;202001;516;1414;390;1231;82;296;172;517;254;813
353180;202001;9730;24036;7517;20468;725;2245;5475;14454;6200;16699
353190;202001;3215;8721;2532;7373;301;953;1523;4173;1824;5126
353200;202001;2022;5396;978;3151;156;551;220;646;376;1197
353205;202001;349;1064;293;941;55;188;138;434;193;622
353210;202001;965;2251;602;1643;30;97;383;1018;413;1115
353215;202001;387;1098;296;918;48;158;137;379;185;537
353220;202001;745;2039;442;1375;96;287;53;156;149;443
353230;202001;816;2271;635;1981;175;597;240;681;415;1278
353240;202001;2294;6280;1840;5480;251;865;1050;2985;1301;3850
353250;202001;1267;2847;747;1974;101;290;398;997;499;1287
353260;202001;1144;2696;619;1805;96;323;284;784;380;1107
353270;202001;682;1745;560;1528;42;137;386;995;428;1132
353280;202001;719;1949;491;1515;105;336;145;414;250;750
353282;202001;1773;5036;1488;4499;169;580;900;2564;1069;3144
353284;202001;359;837;180;498;23;86;76;180;99;266
353286;202001;162;407;94;292;16;53;38;113;54;166
353290;202001;1529;4052;914;2791;141;448;299;842;440;1290
353300;202001;1825;4957;1311;3924;209;700;580;1554;789;2254
353310;202001;392;961;273;749;22;78;180;466;202;544
353320;202001;665;1660;555;1492;11;40;476;1274;487;1314
353325;202001;659;1939;438;1447;99;313;155;499;254;812
353330;202001;525;1336;339;971;45;133;177;471;222;604
353340;202001;2807;7605;1936;5909;416;1400;836;2392;1252;3792
353350;202001;3400;8935;2320;6726;500;1594;624;1562;1124;3156
353360;202001;587;1670;455;1435;59;196;242;754;301;950
353370;202001;547;1597;443;1430;34;110;306;948;340;1058
353380;202001;271;811;215;694;31;113;106;306;137;419
353390;202001;5766;14393;4172;11673;509;1609;2273;6009;2782;7618
353400;202001;420;1177;313;967;51;183;105;270;156;453
353410;202001;512;1375;386;1149;68;217;217;638;285;855
353420;202001;455;1222;266;796;59;166;19;42;78;208
353430;202001;2169;6081;1600;5012;372;1273;645;1887;1017;3160
353440;202001;64713;176423;45585;138597;7719;25353;23119;66526;30838;91879
353450;202001;379;974;252;748;37;132;117;317;154;449
353460;202001;3257;8865;2322;7003;167;608;1090;3171;1257;3779
353470;202001;7736;20443;5412;16073;931;3139;2208;5964;3139;9103
353475;202001;1405;3636;974;2759;146;463;479;1243;625;1706
353480;202001;1622;4353;1271;3724;66;240;859;2416;925;2656
353490;202001;1087;2889;686;2096;102;334;285;822;387;1156
353500;202001;1036;2442;770;2035;169;455;412;1090;581;1545
353510;202001;806;2444;570;1862;131;475;143;396;274;871
353520;202001;1080;2843;675;2090;87;307;302;858;389;1165
353530;202001;2444;6515;1862;5434;253;827;962;2601;1215;3428
353540;202001;2049;5611;1664;4984;272;858;944;2750;1216;3608
353550;202001;5853;15176;4602;13134;772;2341;2539;6963;3311;9304
353560;202001;2029;5606;1471;4707;451;1578;364;1055;815;2633
353570;202001;575;1475;420;1224;47;140;257;713;304;853
353580;202001;2086;5516;1585;4542;350;998;730;2052;1080;3050
353590;202001;711;1898;455;1387;99;327;168;511;267;838
353600;202001;1760;4388;1307;3578;162;441;699;1866;861;2307
353610;202001;553;1641;387;1311;85;347;107;330;192;677
353620;202001;2656;7205;1822;5661;366;1285;587;1644;953;2929
353625;202001;486;1198;312;894;20;68;199;560;219;628
353630;202001;1254;3933;1024;3405;230;850;337;1015;567;1865
353640;202001;1370;3536;1090;3111;152;460;607;1718;759;2178
353650;202001;8419;22697;6114;18174;653;2175;3484;9683;4137;11858
353657;202001;379;997;258;783;31;98;103;288;134;386
353660;202001;1263;2744;854;2175;357;895;218;536;575;1431
353670;202001;4069;11415;3131;9552;624;2108;1516;4286;2140;6394
353680;202001;667;1781;483;1503;85;283;261;776;346;1059
353690;202001;453;1157;191;593;16;49;32;87;48;136
353700;202001;2010;5309;1637;4661;131;427;1176;3219;1307;3646
353710;202001;4538;10042;2551;6577;242;671;1558;3620;1800;4291
353715;202001;439;1158;250;785;13;52;75;219;88;271
353720;202001;1919;5232;1465;4541;184;643;877;2663;1061;3306
353730;202001;4338;11633;3205;9506;490;1663;1534;4160;2024;5823
353740;202001;2013;5359;1382;4214;331;1105;447;1231;778;2336
353750;202001;800;2436;555;1958;134;506;95;362;229;868
353760;202001;12622;29740;9538;25438;1793;4949;5215;13559;7008;18508
353770;202001;717;2159;387;1302;66;238;58;167;124;405
353780;202001;5196;14685;4013;12296;829;2848;1800;5043;2629;7891
353790;202001;2543;7820;1838;6312;512;2001;378;1136;890;3137
353800;202001;17503;46519;13358;39638;1990;6278;7187;21267;9177;27545
353810;202001;1095;2966;713;2167;113;389;294;844;407;1233
353820;202001;1721;4740;1185;3638;261;853;371;1071;632;1924
353830;202001;625;1563;436;1247;76;227;193;519;269;746
353850;202001;1611;4544;1220;3783;286;917;415;1260;701;2177
353860;202001;2545;7164;1956;6073;471;1673;839;2326;1310;3999
353870;202001;28840;76477;20046;59005;2692;8960;10193;27277;12885;36237
353880;202001;2998;8409;2339;7121;193;707;1417;4126;1610;4833
353890;202001;2437;5430;1591;4224;144;393;1050;2669;1194;3062
353900;202001;736;2062;515;1615;88;307;194;562;282;869
353910;202001;2084;5915;1700;5287;218;812;1094;3299;1312;4111
353920;202001;1768;4931;1221;3854;273;973;324;845;597;1818
353930;202001;4234;11284;2794;8634;533;1880;1049;2857;1582;4737
353940;202001;1092;3168;750;2444;141;475;243;730;384;1205
353950;202001;3150;8614;2411;7255;442;1475;1325;3667;1767;5142
353960;202001;730;1923;476;1425;93;303;181;509;274;812
353970;202001;685;1638;503;1367;44;130;330;869;374;999
353980;202001;15093;38704;11453;32163;904;2870;7946;21475;8850;24345
353990;202001;908;2235;532;1533;83;256;246;674;329;930
354000;202001;2491;6063;1360;3883;290;875;217;591;507;1466
354010;202001;354;928;254;765;37;125;143;417;180;542
354020;202001;3404;9550;2645;7908;680;2176;1029;2824;1709;5000
354025;202001;731;2012;461;1485;72;267;101;310;173;577
354030;202001;497;1101;254;692;50;145;116;306;166;451
354040;202001;809;1918;504;1392;27;94;352;933;379;1027
354050;202001;964;2737;660;2176;160;556;192;632;352;1188
354060;202001;3468;9901;2338;7465;545;1837;774;2296;1319;4133
354070;202001;3520;9513;2391;7280;438;1528;900;2317;1338;3845
354075;202001;2509;7359;1907;6207;246;942;1053;3310;1299;4252
354080;202001;1359;3756;890;2827;188;640;196;557;384;1197
354085;202001;414;884;321;765;1;3;231;512;232;515
354090;202001;1568;4423;1338;3937;94;297;1014;2950;1108;3247
354100;202001;19146;53024;13144;42292;2944;10190;4875;15562;7819;25752
354105;202001;1526;3857;1018;2905;135;392;451;1203;586;1595
354110;202001;488;1349;323;1042;53;188;105;335;158;523
354120;202001;1454;3930;956;2857;184;596;323;842;507;1438
354130;202001;5662;14988;3632;11044;914;2974;227;446;1141;3420
354140;202001;19276;47148;12511;34843;2213;6760;5062;13015;7275;19775
354150;202001;3058;7360;2241;6029;506;1392;865;2283;1371;3675
354160;202001;2969;8642;2176;7019;627;2181;594;1748;1221;3929
354165;202001;612;1850;464;1554;82;325;228;710;310;1035
354170;202001;1642;4604;1347;4019;82;295;862;2450;944;2745
354180;202001;413;1141;292;883;53;163;116;315;169;478
354190;202001;1473;4189;992;3165;73;267;406;1269;479;1536
354200;202001;849;2116;650;1801;77;228;401;1058;478;1286
354210;202001;745;1996;586;1727;42;148;415;1148;457;1296
354220;202001;3062;8344;2206;6585;401;1280;1051;2986;1452;4266
354230;202001;722;1829;561;1623;39;152;392;1076;431;1228
354240;202001;1582;4441;1037;3301;180;638;305;847;485;1485
354250;202001;518;1288;317;970;92;288;72;234;164;522
354260;202001;8224;21970;6179;18325;1326;4168;2485;7141;3811;11309
354270;202001;1035;3146;820;2717;191;620;306;1000;497;1620
354280;202001;764;1960;642;1782;59;205;398;1033;457;1238
354290;202001;890;2836;738;2507;120;410;366;1276;486;1686
354300;202001;3559;10522;3009;9504;910;2865;1016;3203;1926;6068
354310;202001;660;1977;532;1709;123;419;185;553;308;972
354320;202001;906;2253;570;1659;76;267;225;585;301;852
354323;202001;456;1120;305;846;34;77;128;345;162;422
354325;202001;1233;3669;867;2871;151;501;332;1070;483;1571
354330;202001;9115;23261;5831;16476;737;2472;3285;8588;4022;11060
354340;202001;30727;78390;20305;59700;3475;11308;9640;26986;13115;38294
354350;202001;1169;3019;918;2577;90;275;620;1663;710;1938
354360;202001;606;1580;332;1102;59;206;59;192;118;398
354370;202001;996;2890;789;2542;130;455;438;1385;568;1840
354380;202001;730;1949;517;1593;92;354;118;287;210;641
354390;202001;13477;32820;8329;23609;1589;4779;3002;8100;4591;12879
354400;202001;1550;4999;1180;4105;206;772;406;1376;612;2148
354410;202001;5551;15261;4104;12284;928;2966;1704;4875;2632;7841
354420;202001;1481;3902;1069;3122;131;404;648;1814;779;2218
354425;202001;2650;6533;1835;5098;437;1236;735;2047;1172;3283
354430;202001;1564;4186;1190;3559;132;459;687;1910;819;2369
354440;202001;569;1525;356;1080;59;209;145;395;204;604
354450;202001;424;1109;223;724;35;120;58;167;93;287
354460;202001;887;2240;567;1665;80;247;302;861;382;1108
354470;202001;489;1250;314;898;21;70;145;365;166;435
354480;202001;1172;2664;748;1994;65;183;494;1258;559;1441
354490;202001;796;2394;565;1872;116;408;235;727;351;1135
354500;202001;1988;5671;1619;5097;496;1682;368;1174;864;2856
354510;202001;734;2077;573;1738;59;191;300;825;359;1016
354515;202001;320;957;232;768;36;135;90;287;126;422
354520;202001;6624;18494;4419;13564;650;2274;2350;6710;3000;8984
354530;202001;4246;12292;3220;10200;764;2475;1220;3858;1984;6333
354540;202001;1309;3486;940;2828;223;705;331;1002;554;1707
354550;202001;532;1409;404;1155;54;164;228;611;282;775
354560;202001;2074;5103;1107;3191;148;439;536;1446;684;1885
354570;202001;1206;3044;471;1366;85;268;62;177;147;445
354580;202001;9046;23709;5739;17393;883;2948;2786;8060;3669;11008
354600;202001;1798;4933;1360;4080;153;528;854;2432;1007;2960
354610;202001;412;1074;225;675;28;89;94;271;122;360
354620;202001;429;1249;268;920;46;178;93;282;139;460
354625;202001;318;871;173;565;28;101;30;68;58;169
354630;202001;1925;5821;1522;4984;543;1849;244;743;787;2592
354640;202001;3135;9071;2257;7263;392;1405;755;2242;1147;3647
354650;202001;872;2278;685;1964;59;168;424;1208;483;1376
354660;202001;3750;8833;1929;5732;184;657;886;2391;1070;3048
354670;202001;1067;2978;720;2276;146;494;255;721;401;1215
354680;202001;4952;13270;3797;11325;916;2844;1847;5619;2763;8463
354690;202001;516;1651;364;1301;79;293;97;342;176;635
354700;202001;875;2339;610;1815;92;294;293;825;385;1119
354710;202001;476;1292;335;1018;48;167;140;367;188;534
354720;202001;322;777;136;401;42;132;29;85;71;217
354730;202001;9732;27509;7163;22483;1033;3572;3864;11711;4897;15283
354740;202001;312;866;122;428;21;86;18;60;39;146
354750;202001;2459;6436;1525;4642;266;870;634;1727;900;2597
354760;202001;1949;5365;1334;4166;329;1115;392;1121;721;2236
354765;202001;361;952;136;439;21;70;24;65;45;135
354770;202001;2317;5747;1649;4600;303;940;767;1983;1070;2923
354780;202001;54642;140084;40465;111439;4734;14604;24059;62039;28793;76643
354790;202001;986;2756;769;2387;93;322;451;1340;544;1662
354800;202001;2573;6712;1983;5751;508;1515;814;2231;1322;3746
354805;202001;1350;3109;897;2427;103;277;487;1209;590;1486
354810;202001;650;1890;352;1237;45;178;72;227;117;405
354820;202001;934;2736;657;2172;125;453;158;435;283;888
354830;202001;457;1135;282;809;54;163;93;254;147;417
354840;202001;913;2260;506;1455;45;143;284;768;329;911
354850;202001;21599;56473;14810;43910;1766;6063;8640;24045;10406;30108
354860;202001;1702;4837;1042;3401;193;691;312;906;505;1597
354870;202001;57379;145781;43744;120101;5028;15153;26131;67713;31159;82866
354880;202001;5761;14373;2675;7673;329;1094;924;2115;1253;3209
354890;202001;17067;42783;13046;35915;1795;5584;7488;19839;9283;25423
354900;202001;401;1025;253;761;41;132;66;178;107;310
354910;202001;5265;14015;3062;9889;664;2274;460;1428;1124;3702
354920;202001;459;1224;207;699;25;97;43;146;68;243
354925;202001;285;819;167;547;21;74;35;100;56;174
354930;202001;399;945;217;635;13;47;101;265;114;312
354940;202001;2231;6835;1540;5230;516;1884;262;809;778;2693
354950;202001;1439;3796;1131;3349;64;267;814;2267;878;2534
354960;202001;893;2382;676;2060;58;209;397;1150;455;1359
354970;202001;4163;11771;3191;10023;398;1376;1922;5849;2320;7225
354980;202001;31706;75767;20480;56099;2320;7546;11673;29601;13993;37147
354990;202001;62116;158940;45394;127972;4119;13329;28262;75250;32381;88579
354995;202001;2795;6444;2087;5500;199;647;1454;3632;1653;4279
355000;202001;1559;3943;1175;3382;185;621;543;1433;728;2054
355010;202001;3735;10255;2161;6876;714;2353;210;697;924;3050
355020;202001;3549;10083;2546;8267;644;2259;833;2583;1477;4842
355030;202001;1358121;3353966;952929;2552921;149449;439034;455464;1120505;604913;1559539
355040;202001;2841;7314;2224;6481;354;1014;1452;4286;1806;5300
355050;202001;945;2231;672;1815;172;498;262;650;434;1148
355060;202001;5978;16400;4365;13321;745;2620;2077;5742;2822;8362
355070;202001;8569;22427;6768;19467;799;2666;4194;11341;4993;14007
355080;202001;913;2633;551;1912;108;412;78;204;186;616
355090;202001;1106;3249;818;2732;220;709;226;802;446;1511
355100;202001;22679;59642;17297;51503;2910;9160;10089;29740;12999;38900
355110;202001;877;2456;626;2046;189;687;102;309;291;996
355120;202001;699;1837;494;1524;37;131;197;572;234;703
355130;202001;870;1912;397;1059;26;79;217;546;243;625
355140;202001;1793;4178;1498;3753;109;338;1210;2924;1319;3262
355150;202001;4356;11578;3415;9877;399;1282;2126;5883;2525;7165
355160;202001;1902;5271;1346;4240;329;1149;310;938;639;2087
355170;202001;9838;25408;7547;21467;1518;4642;3833;10547;5351;15189
355180;202001;2709;7389;1892;5966;410;1436;667;1911;1077;3347
355190;202001;1879;4916;1462;4260;347;1035;752;2307;1099;3342
355200;202001;839;2598;705;2378;187;701;282;885;469;1586
355210;202001;2889;7998;2233;6603;421;1416;1106;3053;1527;4469
355220;202001;44552;119499;34527;99851;8292;25520;13581;36215;21873;61735
355230;202001;1145;2875;607;1798;101;288;205;580;306;868
355240;202001;23974;63577;16368;48243;2351;7578;8435;23489;10786;31067
355250;202001;37309;100572;26938;80225;6710;21093;9721;27468;16431;48561
355255;202001;723;1820;375;1153;62;205;132;382;194;587
355260;202001;1431;3629;1019;2903;135;471;583;1532;718;2003
355270;202001;1206;3558;909;2941;214;712;283;855;497;1567
355280;202001;28982;75431;19962;57832;3071;9569;9164;25070;12235;34639
355290;202001;875;2439;640;1993;140;417;255;769;395;1186
355300;202001;1228;3626;940;3021;179;625;302;924;481;1549
355310;202001;998;2740;739;2302;93;285;411;1295;504;1580
355320;202001;523;1386;382;1123;70;238;152;366;222;604
355330;202001;2566;6730;1922;5578;146;533;1380;3810;1526;4343
355340;202001;3949;8770;3018;7512;388;875;1863;4728;2251;5603
355350;202001;1332;3915;982;3218;213;735;327;1045;540;1780
355360;202001;1185;3038;894;2596;118;371;525;1503;643;1874
355365;202001;375;996;194;660;43;134;29;102;72;236
355370;202001;5528;14070;4190;11990;999;2670;1828;5733;2827;8403
355380;202001;2913;7913;2168;6480;412;1336;742;1926;1154;3262
355385;202001;1410;3753;1139;3345;105;391;714;1932;819;2323
355390;202001;794;2184;553;1639;120;384;226;613;346;997
355395;202001;1920;5338;1307;4100;219;730;456;1278;675;2008
355400;202001;9093;26519;7157;22548;1823;6530;2374;6641;4197;13171
355410;202001;21595;59254;13791;44125;3040;10733;3283;10404;6323;21137
355420;202001;633;2060;513;1815;136;540;125;424;261;964
355430;202001;3723;9496;2774;7806;697;1934;1210;3396;1907;5330
355440;202001;811;2229;479;1512;79;255;142;414;221;669
355450;202001;3268;8508;2043;6058;389;1209;775;2088;1164;3297
355460;202001;505;1245;312;916;38;132;149;404;187;536
355465;202001;382;1046;287;878;46;149;129;390;175;539
355470;202001;1112;2894;612;1880;172;578;177;475;349;1053
355475;202001;356;841;282;732;18;41;202;518;220;559
355480;202001;3698;10410;3003;9357;457;1632;1909;5744;2366;7376
355490;202001;961;2571;506;1578;35;124;254;717;289;841
355495;202001;773;2197;558;1809;69;249;194;591;263;840
355500;202001;6788;17767;3871;11807;587;1990;1232;3438;1819;5428
355510;202001;1320;3277;806;2368;112;380;328;855;440;1235
355520;202001;389;862;170;494;28;82;47;118;75;200
355530;202001;406;930;145;412;19;70;57;147;76;217
355535;202001;509;1403;380;1190;79;304;160;443;239;747
355540;202001;10363;26655;8411;23783;1383;4232;5137;14078;6520;18310
355550;202001;638;1903;519;1684;72;256;268;821;340;1077
355560;202001;1113;2898;588;1868;128;453;38;124;166;577
355570;202001;252;723;133;438;23;79;34;100;57;179
355580;202001;1222;3026;806;2308;146;464;332;888;478;1352
355590;202001;179;451;134;374;17;52;79;206;96;258
355600;202001;1478;3644;971;2779;193;589;400;1116;593;1705
355610;202001;1752;4395;1158;3320;138;433;583;1578;721;2011
355620;202001;4561;12371;3307;9874;383;1391;1756;4781;2139;6172
355630;202001;2319;6429;1575;4967;258;846;748;2325;1006;3171
355635;202001;893;2620;645;2119;126;459;184;537;310;996
355640;202001;2829;8034;1896;6135;369;1299;510;1569;879;2868
355645;202001;4286;12087;3117;9997;441;1533;1664;5243;2105;6776
355650;202001;6588;17933;5168;15333;1454;4480;1785;4755;3239;9235
355660;202001;1307;3448;884;2636;139;496;294;857;433;1353
355670;202001;3505;9549;2249;6668;292;1044;1106;2844;1398;3888
355680;202001;2937;8146;1212;4012;307;1064;123;425;430;1489
355690;202001;784;2344;493;1751;113;424;16;32;129;456
355695;202001;238;684;135;449;12;57;23;50;35;107
355700;202001;7081;20553;5686;17372;1000;3180;2903;8422;3903;11602
355710;202001;8549;20247;5228;14111;838;2468;2226;5356;3064;7824
355715;202001;471;1233;249;771;54;184;45;118;99;302
355720;202001;1470;4210;1141;3600;185;626;600;1761;785;2387
355730;202001;932;2635;741;2249;145;479;314;872;459;1351
410010;202001;1242;3440;914;2738;197;643;183;526;380;1169
410020;202001;973;3091;748;2536;268;850;177;628;445;1478
410030;202001;1511;4249;1270;3857;181;619;664;2012;845;2631
410040;202001;11879;33380;8606;27094;1849;6190;2661;7798;4510;13988
410045;202001;864;2309;593;1806;81;286;202;575;283;861
410050;202001;2415;6114;1558;4568;305;987;456;1214;761;2201
410060;202001;2052;5924;1553;4889;369;1208;473;1428;842;2636
410070;202001;1817;4675;1280;3663;214;698;480;1249;694;1947
410080;202001;1395;3708;979;2925;197;605;345;1030;542;1635
410090;202001;1077;2818;925;2567;84;231;568;1642;652;1873
410100;202001;1871;5474;1243;3913;174;626;175;510;349;1136
410105;202001;475;1228;247;757;33;112;67;193;100;305
410110;202001;3084;7950;2107;6023;296;918;847;2279;1143;3197
410115;202001;550;1426;384;1131;53;178;137;382;190;560
410120;202001;2403;7050;2077;6512;508;1758;948;2861;1456;4619
410130;202001;1153;3173;1002;2880;221;697;462;1232;683;1929
410140;202001;14370;35025;8634;24502;1637;5075;1912;4928;3549;10003
410150;202001;16481;39304;7753;21747;1281;3951;1697;4366;2978;8317
410160;202001;2907;8144;2316;7089;511;1719;797;2435;1308;4154
410165;202001;726;1958;605;1715;55;186;359;951;414;1137
410170;202001;2571;6744;1696;4858;380;1172;144;420;524;1592
410180;202001;14861;41827;11330;34397;1579;5222;5823;16478;7402;21700
410185;202001;446;1288;309;945;54;174;87;247;141;421
410190;202001;2264;5683;1618;4525;325;928;434;1167;759;2095
410200;202001;4938;11662;2634;7595;439;1482;481;1345;920;2827
410210;202001;3041;7716;1838;5464;300;1018;617;1590;917;2608
410220;202001;505;1293;319;950;47;155;64;183;111;338
410230;202001;1660;4488;1264;3660;164;558;678;1827;842;2385
410240;202001;4727;12762;3256;9888;832;2813;250;717;1082;3530
410250;202001;2586;6234;1853;4995;135;470;899;2351;1034;2821
410260;202001;1837;4654;1156;3372;204;611;490;1410;694;2021
410270;202001;466;1234;327;982;44;150;115;330;159;480
410275;202001;618;1768;403;1301;52;182;188;569;240;751
410280;202001;2266;6119;1478;4526;227;772;568;1601;795;2373
410290;202001;3145;8919;2129;6707;564;1792;562;1746;1126;3538
410300;202001;639;1628;504;1400;38;117;248;646;286;763
410302;202001;396;983;204;618;29;94;94;277;123;371
410304;202001;1213;3206;1011;2829;120;331;579;1574;699;1905
410305;202001;1749;4273;1174;3415;141;448;689;1939;830;2387
410310;202001;2612;7528;2033;6327;370;1239;860;2656;1230;3895
410315;202001;718;1730;367;1141;131;406;81;250;212;656
410320;202001;1081;3013;711;2238;106;381;118;362;224;743
410322;202001;554;1483;290;879;29;98;133;365;162;463
410330;202001;1498;3711;1026;2803;169;507;298;801;467;1308
410335;202001;846;2326;650;1945;93;302;288;799;381;1101
410337;202001;809;1952;553;1456;54;144;232;580;286;724
410340;202001;463;1310;308;923;28;97;141;352;169;449
410345;202001;2414;6252;1231;3626;251;780;344;906;595;1686
410347;202001;693;1767;498;1405;47;161;150;416;197;577
410350;202001;1275;3263;891;2604;113;349;359;996;472;1345
410360;202001;4290;10468;3282;8726;342;1037;1924;4889;2266;5926
410370;202001;12712;34877;8055;23619;1011;3269;3210;8287;4221;11556
410380;202001;1441;3715;1050;2971;151;468;364;938;515;1406
410390;202001;2598;6752;1640;4942;397;1335;441;1210;838;2545
410395;202001;850;2492;688;2135;134;460;297;909;431;1369
410400;202001;5595;14992;4169;12332;675;2125;1878;5301;2553;7426
410405;202001;794;1926;594;1634;118;371;248;635;366;1006
410410;202001;1199;3251;1121;3133;169;578;695;1996;864;2574
410420;202001;8946;25295;6646;20618;1143;3910;2247;6226;3390;10136
410425;202001;2994;8559;2080;6647;351;1242;749;2167;1100;3409
410430;202001;12801;32484;8676;24778;1435;4497;2855;7676;4290;12173
410440;202001;2321;7009;1964;6329;302;1086;1019;3215;1321;4301
410442;202001;2160;6710;1791;5875;500;1658;535;1715;1035;3373
410445;202001;2254;6585;1678;5447;336;1228;390;1335;726;2563
410450;202001;1435;3613;1027;2921;184;596;343;895;527;1491
410460;202001;1941;4818;1503;4144;167;484;721;1923;888;2407
410465;202001;2611;7658;2009;6464;371;1238;687;2066;1058;3304
410470;202001;1990;5594;1399;4452;382;1380;209;683;591;2063
410480;202001;37143;88508;19338;56516;3075;10094;3998;9982;7073;20076
410490;202001;10917;30626;7630;23655;1428;4806;2812;8229;4240;13035
410500;202001;1719;4668;1162;3545;250;894;330;858;580;1752
410510;202001;1915;4786;1247;3512;244;678;347;989;591;1667
410520;202001;3060;9718;2722;9006;893;3038;968;3268;1861;6306
410530;202001;1617;4062;765;2217;108;304;173;414;281;718
410540;202001;2596;7045;1801;5453;296;981;836;2445;1132;3426
410550;202001;7121;19208;4513;13357;783;2500;1176;3008;1959;5508
410560;202001;1416;3732;1039;2967;227;704;365;906;592;1610
410570;202001;2494;6932;1824;5706;507;1874;192;653;699;2527
410580;202001;24709;64872;17876;52215;3632;11318;7355;20037;10987;31355
410590;202001;1545;4469;1000;3119;154;500;293;812;447;1312
410600;202001;1776;4823;1344;3965;285;809;476;1451;761;2260
410610;202001;721;1903;519;1513;56;194;227;632;283;826
410620;202001;2183;6463;1387;4547;304;1091;246;759;550;1850
410630;202001;2368;6349;1520;4581;291;990;276;682;567;1672
410640;202001;4665;11052;3085;8254;688;2161;395;1054;1083;3215
410645;202001;1030;3003;844;2756;270;903;350;1169;620;2072
410650;202001;2092;5783;1394;4329;284;947;473;1363;757;2310
410655;202001;904;2197;629;1697;23;77;319;816;342;893
410657;202001;603;1612;376;1147;55;205;138;354;193;559
410660;202001;3268;8479;1790;5208;320;988;439;1209;759;2197
410670;202001;1051;2646;623;1803;134;397;223;591;357;988
410680;202001;2630;8012;1882;6097;472;1552;352;1180;824;2732
410685;202001;552;1420;414;1178;97;321;161;405;258;726
410690;202001;123413;306349;79149;222733;13013;41766;27767;68574;40780;110340
410700;202001;2410;6167;2012;5547;280;811;1069;2848;1349;3659
410710;202001;821;2087;529;1557;80;243;230;651;310;894
410712;202001;633;1870;523;1639;132;451;185;556;317;1007
410715;202001;837;2431;509;1675;82;282;161;500;243;782
410720;202001;3150;8073;2415;6623;327;1054;506;1320;833;2374
410725;202001;1071;2692;603;1795;117;364;89;216;206;580
410730;202001;627;1667;477;1387;102;342;97;277;199;619
410740;202001;925;2594;672;2114;93;325;269;829;362;1154
410750;202001;1738;4447;1367;3775;216;663;594;1546;810;2209
410752;202001;357;900;165;498;19;64;71;196;90;260
410753;202001;263;800;185;622;26;102;42;127;68;229
410754;202001;1097;2855;893;2533;61;156;605;1827;666;1983
410755;202001;570;1482;395;1136;57;179;165;417;222;596
410760;202001;3324;8655;2334;6872;601;2011;493;1305;1094;3316
410765;202001;12511;35495;9566;29612;1590;5414;1810;5025;3400;10439
410770;202001;1034;2473;694;1893;72;212;353;953;425;1165
410773;202001;1278;3433;1108;3165;116;372;672;1863;788;2235
410775;202001;1468;3706;1260;3390;78;225;794;2110;872;2335
410780;202001;626;1568;400;1113;62;183;100;270;162;453
410785;202001;728;1946;549;1629;92;308;187;551;279;859
410790;202001;710;2027;571;1756;165;556;64;145;229;701
410800;202001;3357;7513;2670;6483;51;176;1703;4020;1754;4196
410810;202001;381;1033;289;856;26;82;132;368;158;450
410820;202001;801;2283;412;1287;85;270;73;203;158;473
410830;202001;33137;81592;21766;62051;4557;14795;7124;19129;11681;33924
410832;202001;977;2558;767;2186;87;287;441;1160;528;1447
410840;202001;7854;20289;4611;13943;864;2841;1150;3147;2014;5988
410845;202001;1130;2915;878;2519;161;475;367;1035;528;1510
410850;202001;2224;6470;1926;5930;318;1066;934;2794;1252;3860
410855;202001;774;1947;493;1405;45;131;235;630;280;761
410860;202001;4314;11012;3446;9561;382;1189;1867;4971;2249;6160
410865;202001;1346;4052;1184;3725;139;496;693;2207;832;2703
410870;202001;1282;3471;1070;3115;71;228;728;2084;799;2312
410880;202001;4311;11880;2999;9373;515;1769;441;1512;956;3281
410890;202001;965;2727;696;2185;155;545;185;570;340;1115
410895;202001;971;3164;809;2792;261;969;149;482;410;1451
410900;202001;853;2271;560;1679;102;309;102;247;204;556
410910;202001;371;872;214;575;11;37;131;328;142;365
410920;202001;840;2008;563;1569;74;229;256;703;330;932
410930;202001;1620;4255;1131;3373;280;976;230;665;510;1641
410940;202001;22108;61280;15765;49509;3257;11306;4674;14404;7931;25710
410950;202001;1929;5652;1710;5308;54;197;1401;4294;1455;4491
410960;202001;7100;18088;4559;13597;1039;3434;1614;4712;2653;8146
410965;202001;1005;2608;709;2041;90;289;391;1104;481;1393
410970;202001;3884;10529;2678;8178;610;2230;365;944;975;3174
410975;202001;1300;3288;963;2735;103;309;444;1265;547;1574
410980;202001;6908;17543;4308;12744;524;1744;1794;4933;2318;6677
410990;202001;1342;3332;865;2556;235;803;254;691;489;1494
411000;202001;600;1625;389;1210;52;189;116;310;168;499
411005;202001;405;1087;246;738;47;148;56;152;103;300
411007;202001;2265;6398;1843;5643;429;1381;625;1914;1054;3295
411010;202001;4202;12723;3298;10822;829;2950;364;1091;1193;4041
411020;202001;2280;6595;1851;5812;537;1771;509;1536;1046;3307
411030;202001;722;1794;481;1289;34;125;268;635;302;760
411040;202001;924;2350;446;1277;45;139;143;352;188;491
411050;202001;1828;5825;1508;5078;406;1465;231;665;637;2130
411060;202001;1801;4712;1131;3399;256;909;171;459;427;1368
411065;202001;371;981;247;743;36;122;102;292;138;414
411070;202001;6694;17444;5270;15000;756;2402;2516;6914;3272;9316
411080;202001;2137;5651;1654;4779;427;1400;326;905;753;2305
411090;202001;823;2163;521;1576;36;137;142;406;178;543
411095;202001;1546;3652;1038;2852;118;363;350;911;468;1274
411100;202001;1111;2913;738;2237;86;293;223;686;309;979
411110;202001;649;1678;286;891;38;107;18;40;56;147
411120;202001;1198;3414;983;2988;321;1113;209;555;530;1668
411125;202001;5091;15058;4486;13876;932;2928;2145;6870;3077;9798
411130;202001;687;1869;478;1456;86;241;178;568;264;809
411140;202001;2251;6980;1874;6135;552;1938;494;1578;1046;3516
411150;202001;3803;9861;2539;7262;514;1708;246;526;760;2234
411155;202001;964;2467;557;1686;75;219;230;663;305;882
411160;202001;358;833;234;656;32;100;47;139;79;239
411170;202001;712;2145;523;1693;108;332;166;535;274;867
411180;202001;5333;14288;4053;11946;629;2048;1812;5023;2441;7071
411190;202001;1588;4130;1171;3365;182;565;462;1227;644;1792
411200;202001;4944;13481;3364;10437;845;2885;603;1621;1448;4506
411210;202001;2925;6484;1906;4890;347;1001;571;1366;918;2367
411220;202001;846;2223;613;1765;139;433;171;472;310;905
411230;202001;823;2215;569;1709;113;362;217;648;330;1010
411240;202001;1558;3794;955;2633;96;313;463;1163;559;1476
411250;202001;2199;5914;1604;4823;324;1118;494;1431;818;2549
411260;202001;319;860;199;609;24;64;75;214;99;278
411270;202001;1988;5413;1481;4375;229;699;697;1916;926;2615
411275;202001;1399;3247;934;2474;150;466;410;1016;560;1482
411280;202001;1341;3666;880;2755;232;740;115;350;347;1090
411290;202001;777;2076;495;1510;48;135;246;781;294;916
411295;202001;1206;3042;863;2363;102;292;383;989;485;1281
411300;202001;1023;2549;623;1767;62;198;257;637;319;835
411310;202001;864;2047;651;1723;43;110;290;758;333;868
411320;202001;5278;13898;3775;11130;686;2126;1510;4027;2196;6153
411325;202001;1423;4046;1201;3656;196;588;672;2102;868;2690
411330;202001;3376;9173;2422;7393;554;1843;744;2275;1298;4118
411340;202001;830;2270;484;1489;67;227;167;492;234;719
411342;202001;1004;2432;583;1608;96;285;243;645;339;930
411345;202001;1073;2794;799;2343;71;229;553;1628;624;1857
411350;202001;2623;7239;1661;5230;428;1464;208;607;636;2071
411360;202001;654;1589;467;1299;64;184;149;407;213;591
411370;202001;52380;129436;36783;102678;2744;9311;21648;56611;24392;65922
411373;202001;1367;3483;1096;3072;88;297;587;1656;675;1953
411375;202001;1098;2780;778;2169;128;368;293;777;421;1145
411380;202001;1110;2612;714;1845;37;108;414;989;451;1097
411390;202001;1542;4279;1175;3462;187;611;463;1193;650;1804
411400;202001;2224;5636;1686;4615;187;612;831;2143;1018;2755
411410;202001;2331;6503;1689;5093;359;1192;378;1106;737;2298
411420;202001;4032;10014;2131;6324;300;1007;372;849;672;1856
411430;202001;3398;9277;2569;7683;580;1899;898;2447;1478;4346
411435;202001;423;1194;262;842;50;150;81;219;131;369
411440;202001;2452;6992;1966;6027;386;1308;691;2079;1077;3387
411450;202001;2529;6732;1911;5724;257;751;1018;3106;1275;3857
411460;202001;3813;10019;2231;6840;394;1407;411;1183;805;2590
411470;202001;738;1940;532;1523;95;285;186;484;281;769
411480;202001;4540;12447;3241;9958;678;2450;1008;2781;1686;5231
411490;202001;1634;4248;1239;3566;157;531;499;1293;656;1824
411500;202001;1309;3539;855;2557;147;487;166;423;313;910
411510;202001;2256;5849;1781;5009;391;1277;408;1160;799;2437
411520;202001;30600;74805;17010;48049;2046;6637;6209;15652;8255;22289
411530;202001;899;2381;536;1664;99;343;88;244;187;587
411535;202001;467;1367;252;834;27;97;55;146;82;243
411540;202001;2827;6939;1859;5143;204;662;883;2335;1087;2997
411545;202001;919;2654;760;2371;72;220;489;1540;561;1760
411550;202001;680;1753;478;1361;75;238;89;260;164;498
411560;202001;1930;5180;1091;3380;159;547;85;245;244;792
411570;202001;7016;16585;4591;12743;980;2979;841;2274;1821;5253
411573;202001;762;2078;639;1885;95;300;333;959;428;1259
411575;202001;1863;5153;1383;4185;282;909;313;933;595;1842
411580;202001;4502;10363;2617;7418;366;1280;461;1195;827;2475
411585;202001;634;1862;284;947;68;236;51;156;119;392
411590;202001;373;1049;253;781;26;86;132;361;158;447
411600;202001;290;733;177;553;40;128;51;154;91;282
411605;202001;1562;3604;924;2554;118;409;481;1302;599;1711
411610;202001;2420;5910;1684;4520;84;288;1068;2656;1152;2944
411620;202001;2824;7591;2387;6894;415;1269;1307;3743;1722;5012
411630;202001;742;1937;482;1436;73;252;159;423;232;675
411640;202001;472;1250;325;928;44;143;121;314;165;457
411650;202001;218;647;135;452;27;96;22;59;49;155
411660;202001;892;2257;632;1788;42;129;306;839;348;968
411670;202001;1325;3320;880;2401;102;302;397;1007;499;1309
411680;202001;1473;3952;1100;3225;152;513;480;1362;632;1875
411690;202001;3588;9330;2672;7737;559;1675;807;2436;1366;4111
411695;202001;668;2045;417;1370;43;151;168;526;211;677
411700;202001;1617;4259;1039;3147;226;742;145;408;371;1150
411705;202001;1876;5859;1582;5347;309;997;858;3140;1167;4137
411710;202001;1829;4692;1223;3528;298;871;198;564;496;1435
411720;202001;1081;2558;759;1974;132;360;305;735;437;1095
411721;202001;930;2378;681;1914;133;370;160;455;293;825
411722;202001;761;2076;403;1206;54;184;140;339;194;523
411725;202001;1162;3332;776;2544;173;594;169;576;342;1170
411727;202001;1483;4161;946;2982;215;711;160;469;375;1180
411729;202001;713;1738;446;1221;54;195;159;377;213;572
411730;202001;5222;14027;3942;11472;860;2678;1549;4413;2409;7091
411740;202001;542;1418;268;815;54;157;62;173;116;330
411745;202001;740;2114;489;1540;65;221;83;195;148;416
411750;202001;5043;13394;3561;10423;459;1453;1729;4736;2188;6189
411760;202001;6816;18364;5184;15456;1723;5312;990;3282;2713;8594
411770;202001;2956;8694;2113;6755;515;1770;289;859;804;2629
411780;202001;2819;8058;2383;7197;649;2071;790;2366;1439;4437
411790;202001;2833;6902;1501;4445;311;1051;209;514;520;1565
411800;202001;983;2777;686;2109;111;360;134;391;245;751
411810;202001;1530;4035;1102;3161;179;517;511;1397;690;1914
411820;202001;11115;32262;8920;28240;2303;7759;3565;11019;5868;18778
411830;202001;591;1445;418;1154;73;213;94;290;167;503
411840;202001;11832;31866;7700;23060;1330;4310;1923;5264;3253;9574
411845;202001;504;1450;254;824;32;125;46;136;78;261
411850;202001;7354;19029;4994;14759;1262;4189;755;2005;2017;6194
411860;202001;700;2019;508;1603;77;252;128;363;205;615
411870;202001;613;1816;420;1359;88;315;95;272;183;587
411880;202001;2189;5568;1577;4559;236;766;502;1416;738;2182
411885;202001;1053;2738;739;2160;92;304;247;673;339;977
411890;202001;1171;3135;757;2330;138;477;69;180;207;657
411900;202001;797;2233;470;1506;105;362;61;192;166;554
411910;202001;908;2702;649;2136;159;582;204;612;363;1194
411915;202001;15373;37910;9805;27728;1512;4823;3556;8990;5068;13813
411920;202001;1061;3208;876;2805;204;738;289;863;493;1601
411925;202001;470;1245;326;978;64;217;131;365;195;582
411930;202001;5006;15612;4204;14011;1785;6492;253;974;2038;7466
411940;202001;3268;9840;2497;8088;603;2047;746;2169;1349;4216
411950;202001;13450;36732;10893;32431;1686;5592;6002;17179;7688;22771
411960;202001;5870;15958;4637;13415;855;2743;1708;4626;2563;7369
411965;202001;424;1195;296;939;40;142;113;324;153;466
411970;202001;1063;2513;799;2146;160;404;319;986;479;1390
411980;202001;1480;3742;1059;3022;265;770;368;1007;633;1777
411990;202001;38052;100769;23959;74125;4518;15408;7969;23431;12487;38839
411995;202001;2991;7568;2199;6311;627;1996;588;1592;1215;3588
412000;202001;1985;4563;1378;3533;35;108;970;2338;1005;2446
412010;202001;587;1837;417;1456;59;225;107;301;166;526
412015;202001;547;1540;448;1362;56;190;262;794;318;984
412020;202001;444;1240;268;867;38;155;113;349;151;504
412030;202001;614;1734;417;1357;67;225;115;365;182;590
412033;202001;843;2281;585;1726;60;176;204;538;264;714
412035;202001;775;2083;484;1536;55;210;257;771;312;981
412040;202001;587;1585;365;1123;51;160;70;211;121;371
412050;202001;1684;4251;1119;3202;221;711;270;769;491;1480
412060;202001;7102;21226;5866;18693;1549;5578;1625;4917;3174;10495
412065;202001;624;1735;446;1356;91;288;116;354;207;642
412070;202001;1127;2895;858;2362;112;332;343;881;455;1213
412080;202001;1995;5695;1245;4043;184;620;202;603;386;1223
412085;202001;287;701;93;294;10;25;14;35;24;60
412090;202001;5816;15185;4322;12346;1153;3455;1472;4269;2625;7724
412100;202001;1591;4455;1195;3713;343;1153;256;869;599;2022
412110;202001;858;2273;597;1746;83;252;204;566;287;818
412120;202001;1937;5692;1489;4785;281;1005;416;1170;697;2175
412125;202001;649;1854;461;1456;98;317;119;350;217;667
412130;202001;738;1901;496;1433;78;229;131;392;209;621
412135;202001;606;1610;267;808;39;118;89;249;128;367
412140;202001;1632;4023;1059;2975;191;656;208;535;399;1191
412150;202001;2773;7391;2316;6561;324;1057;1378;3658;1702;4715
412160;202001;972;3021;581;1978;104;394;102;310;206;704
412170;202001;4210;11792;3518;10650;720;2356;1431;3997;2151;6353
412175;202001;1305;3793;1083;3415;224;729;455;1454;679;2183
412180;202001;1655;4628;1169;3693;152;566;517;1490;669;2056
412190;202001;3368;8452;2456;6837;323;983;1085;2992;1408;3975
412200;202001;1732;5235;1245;4058;341;1206;195;582;536;1788
412210;202001;621;1537;359;1042;51;164;116;304;167;468
412215;202001;3375;9159;2663;7785;688;1952;1116;3651;1804;5603
412217;202001;925;2437;770;2182;57;177;502;1382;559;1559
412220;202001;5799;16262;4616;14033;1126;3437;1469;4709;2595;8146
412230;202001;2589;7755;2070;6733;356;1315;553;1553;909;2868
412240;202001;6817;17506;4239;12476;728;2329;1244;3359;1972;5688
412250;202001;1999;5131;1474;4158;340;993;340;914;680;1907
412260;202001;1216;3305;854;2513;147;454;243;679;390;1133
412265;202001;870;2422;695;2115;135;436;291;838;426;1274
412270;202001;944;2591;581;1809;74;263;214;591;288;854
412280;202001;434;1221;335;1050;67;223;98;277;165;500
412290;202001;989;2538;650;1904;99;312;198;558;297;870
412300;202001;1692;4392;1149;3397;246;757;237;708;483;1465
412310;202001;749;2063;608;1797;78;295;257;700;335;995
412320;202001;824;2117;540;1557;70;252;183;523;253;775
412330;202001;1489;4037;987;3041;193;650;323;1011;516;1661
412340;202001;1125;3183;680;2182;106;384;113;343;219;727
412350;202001;2850;7456;1801;5354;356;1095;319;877;675;1972
412360;202001;253;691;168;513;6;28;91;257;97;285
412370;202001;828;2388;555;1802;107;381;42;149;149;530
412380;202001;1538;4203;1063;3209;285;896;143;486;428;1382
412382;202001;511;1294;330;985;45;155;126;333;171;488
412385;202001;2192;6095;1762;5252;544;1538;524;1737;1068;3275
412390;202001;2401;5889;1918;5152;324;881;773;2116;1097;2997
412395;202001;703;2010;478;1494;51;147;194;610;245;757
412400;202001;874;2349;620;1837;123;402;161;482;284;884
412402;202001;1963;4921;1312;3803;310;936;167;482;477;1418
412405;202001;3017;8025;1947;5930;493;1800;52;152;545;1952
412410;202001;5736;15147;4135;12393;768;2653;1296;3671;2064;6324
412420;202001;502;1315;323;949;23;80;145;371;168;451
412430;202001;560;1410;322;934;24;79;137;377;161;456
412440;202001;2713;7596;1798;5746;449;1544;285;929;734;2473
412450;202001;386;1144;256;805;43;128;22;46;65;174
412460;202001;1025;2739;798;2345;141;455;362;1047;503;1502
412470;202001;1515;4955;1236;4304;322;1173;277;964;599;2137
412480;202001;974;2636;612;1835;115;369;167;464;282;833
412490;202001;1238;3155;971;2657;125;350;504;1312;629;1662
412500;202001;1918;4898;1418;3930;302;816;397;1046;699;1862
412510;202001;1915;5941;1312;4354;288;1020;123;336;411;1356
412520;202001;1299;3403;687;2038;160;468;60;161;220;629
412530;202001;658;1748;471;1356;73;234;110;306;183;540
412535;202001;804;2101;538;1578;84;270;116;296;200;566
412540;202001;1194;3139;833;2425;86;316;280;847;366;1163
412545;202001;685;1763;463;1291;71;195;157;423;228;618
412550;202001;30627;82800;20846;62759;3530;11569;7830;21675;11360;33244
412555;202001;267;703;172;486;17;46;50;108;67;154
412560;202001;4738;13899;3449;10811;562;1941;1025;3218;1587;5159
412570;202001;4276;11067;2359;7213;515;1770;286;965;801;2735
412575;202001;974;2489;767;2118;76;233;430;1121;506;1354
412580;202001;1423;3785;975;2893;95;336;488;1383;583;1719
412590;202001;415;1093;222;697;30;103;19;44;49;147
412600;202001;1439;4016;1048;3211;173;606;414;1190;587;1796
412610;202001;770;2047;534;1538;51;149;270;703;321;852
412620;202001;1231;3268;919;2782;166;592;298;841;464;1433
412625;202001;8878;23831;5376;16645;736;2582;328;903;1064;3485
412627;202001;1134;3217;707;2292;137;471;181;588;318;1059
412630;202001;2868;8427;2043;6596;394;1293;632;1854;1026;3147
412635;202001;370;1000;250;741;38;133;79;186;117;319
412640;202001;1016;2694;547;1665;61;187;147;415;208;602
412650;202001;1582;4413;1251;3721;227;743;454;1181;681;1924
412660;202001;2408;6236;1641;4748;266;825;478;1255;744;2080
412665;202001;373;967;283;793;43;129;126;337;169;466
412667;202001;1675;4444;1243;3594;171;536;504;1397;675;1933
412670;202001;795;1937;519;1465;89;293;163;415;252;708
412680;202001;1730;4681;1150;3525;155;540;429;1182;584;1722
412690;202001;944;2558;704;2074;101;312;282;786;383;1098
412700;202001;2015;5377;1653;4803;197;675;884;2478;1081;3153
412710;202001;5889;17431;4377;14106;859;3106;1205;3477;2064;6583
412720;202001;1194;3540;901;2882;141;478;175;471;316;949
412730;202001;2275;6136;1426;4339;269;900;426;1217;695;2117
412740;202001;1833;5150;1228;3865;223;805;171;544;394;1349
412750;202001;3854;10219;3193;9261;325;1116;2060;5640;2385;6756
412760;202001;2902;7930;2363;6991;416;1374;1246;3474;1662;4848
412770;202001;10371;26314;5389;16390;740;2373;1198;3138;1938;5511
412780;202001;1192;3170;876;2591;187;606;334;969;521;1575
412785;202001;1993;4992;1376;3881;169;493;808;2246;977;2739
412788;202001;1287;3643;1053;3218;281;868;433;1290;714;2158
412790;202001;1270;3369;677;2105;105;381;215;598;320;979
412795;202001;1302;3381;675;2053;104;360;130;364;234;724
412796;202001;2243;6548;1837;5728;383;1267;586;1720;969;2987
412800;202001;3407;8333;2260;6186;269;834;970;2372;1239;3206
412810;202001;11232;28700;6879;19753;848;2834;2511;6385;3359;9219
412820;202001;6485;17878;4524;13869;1062;3459;1280;3916;2342;7375
412830;202001;338;969;231;732;32;98;56;182;88;280
412840;202001;1808;4609;1256;3524;142;444;506;1326;648;1770
412850;202001;2833;7520;2034;6089;320;1020;815;2390;1135;3410
412853;202001;1559;3945;1287;3437;188;550;636;1516;824;2066
412855;202001;1218;3266;785;2322;141;487;231;645;372;1132
412860;202001;785;1960;539;1574;78;255;284;787;362;1042
412862;202001;698;1705;457;1299;85;250;191;529;276;779
412863;202001;1233;3767;1131;3600;185;602;706;2231;891;2833
412865;202001;730;1990;521;1573;122;375;151;467;273;842
412870;202001;881;2293;642;1902;173;591;128;390;301;981
412880;202001;802;2192;522;1606;94;319;82;225;176;544
420005;202001;436;1301;249;874;34;126;107;379;141;505
420010;202001;3311;8128;2152;6149;149;473;1546;4447;1695;4920
420020;202001;462;1437;291;1008;49;199;58;163;107;362
420030;202001;85;286;58;228;16;69;16;61;32;130
420040;202001;541;1667;318;1157;57;229;23;64;80;293
420050;202001;710;1655;450;1189;61;194;271;639;332;833
420055;202001;169;497;90;308;19;81;31;89;50;170
420060;202001;105;293;59;177;12;41;16;35;28;76
420070;202001;702;2179;521;1770;120;430;189;621;309;1051
420075;202001;81;215;40;124;8;25;9;19;17;44
420080;202001;334;972;261;810;70;239;98;302;168;541
420090;202001;412;1295;239;866;57;225;47;159;104;384
420100;202001;1213;3234;1001;2905;53;192;798;2278;851;2470
420110;202001;240;776;216;725;47;182;93;285;140;467
420120;202001;483;1334;311;955;59;212;131;341;190;553
420125;202001;339;1058;240;832;59;218;104;340;163;558
420127;202001;278;756;98;324;19;66;21;71;40;137
420130;202001;2869;8039;2142;6777;311;1220;1055;3103;1366;4323
420140;202001;3499;9517;2464;7707;669;2385;336;1031;1005;3416
420150;202001;620;1603;412;1245;47;156;237;692;284;848
420160;202001;221;545;85;269;11;35;22;68;33;103
420165;202001;152;434;83;270;20;69;25;72;45;141
420170;202001;267;824;168;585;22;66;38;114;60;180
420180;202001;172;543;100;368;13;46;26;92;39;138
420190;202001;189;623;115;426;40;165;22;72;62;237
420195;202001;1366;3571;979;2924;296;1036;114;269;410;1305
420200;202001;4025;10006;2307;6715;318;1155;867;2131;1185;3286
420205;202001;1644;4460;1104;3392;168;534;591;1824;759;2358
420207;202001;1747;4625;1064;3298;202;716;418;1224;620;1940
420208;202001;312;886;183;650;39;153;75;258;114;411
420209;202001;134;453;83;296;22;87;24;86;46;173
420210;202001;2796;7229;1777;5557;352;1218;791;2426;1143;3644
420213;202001;749;2354;627;2102;138;502;303;1004;441;1506
420215;202001;191;580;130;444;34;132;18;51;52;183
420220;202001;238;718;141;491;24;98;64;200;88;298
420230;202001;4770;13223;3573;10926;549;1828;1858;5487;2407;7315
420240;202001;12452;34437;7489;23178;970;3441;3572;9780;4542;13221
420243;202001;383;1108;305;948;45;151;175;515;220;666
420245;202001;1288;3377;891;2682;70;267;505;1448;575;1715
420250;202001;450;1291;375;1163;64;230;189;534;253;764
420253;202001;495;1227;350;1018;37;117;193;564;230;681
420257;202001;165;435;107;329;22;79;53;157;75;236
420260;202001;1080;2889;769;2429;131;461;455;1420;586;1881
420270;202001;500;1333;232;698;32;111;84;245;116;356
420280;202001;1120;3338;825;2745;165;615;265;861;430;1476
420285;202001;76;198;43;131;8;36;9;22;17;58
420287;202001;449;1044;311;839;80;219;109;299;189;518
420290;202001;4270;12231;3188;9760;462;1665;1768;4933;2230;6598
420300;202001;6951;19751;3857;12400;753;2695;976;2781;1729;5476
420310;202001;830;1953;408;1147;47;145;200;512;247;657
420315;202001;770;2184;516;1711;113;401;209;700;322;1101
420320;202001;4631;12994;3399;10819;980;3478;775;2264;1755;5742
420325;202001;263;756;189;616;32;110;78;236;110;346
420330;202001;874;2638;568;1956;106;413;168;504;274;917
420340;202001;955;2693;696;2206;163;539;88;245;251;784
420350;202001;1247;3288;884;2612;74;256;585;1698;659;1954
420360;202001;2547;7242;1358;4560;259;963;131;424;390;1387
420370;202001;996;2726;782;2370;94;338;487;1406;581;1744
420380;202001;4341;11682;2886;8982;613;2070;1004;2993;1617;5063
420390;202001;1078;2614;726;1874;128;408;317;559;445;967
420395;202001;972;2831;639;2135;104;408;79;202;183;610
420400;202001;880;2562;587;1900;105;381;193;591;298;972
420410;202001;505;1377;382;1130;35;115;248;709;283;824
420415;202001;281;855;211;697;53;196;76;255;129;451
420417;202001;615;1838;479;1554;129;419;167;560;296;979
420419;202001;142;507;110;422;40;165;7;24;47;189
420420;202001;10490;27537;6824;20750;1963;6734;1766;4897;3729;11631
420425;202001;649;1726;425;1277;41;146;192;555;233;701
420430;202001;3073;8424;1783;5527;404;1342;545;1537;949;2879
420435;202001;262;670;118;390;14;47;56;184;70;231
420440;202001;708;1971;447;1414;113;400;178;518;291;918
420445;202001;267;669;161;463;30;95;63;166;93;261
420450;202001;658;1936;473;1533;87;350;165;459;252;809
420455;202001;1929;4858;1391;4012;196;706;668;1794;864;2500
420460;202001;8758;23622;6443;19323;1008;3381;3131;8980;4139;12361
420470;202001;590;1558;320;1022;65;237;71;189;136;426
420475;202001;64;164;27;86;7;23;3;10;10;33
420480;202001;5546;13798;3293;9951;675;2224;998;3008;1673;5232
420490;202001;352;1033;252;824;57;214;92;308;149;522
420500;202001;1396;3953;901;2986;157;571;366;1220;523;1791
420510;202001;163;466;88;283;12;51;24;69;36;120
420515;202001;42;107;27;75;1;1;13;38;14;39
420517;202001;744;2084;645;1908;52;148;480;1431;532;1579
420519;202001;287;689;196;553;26;82;102;299;128;381
420520;202001;312;844;150;514;26;91;12;42;38;133
420530;202001;773;2254;529;1740;92;360;181;517;273;877
420535;202001;218;639;90;312;13;49;38;124;51;173
420540;202001;33985;80920;21156;58994;3278;10354;7129;16901;10407;27255
420543;202001;207;625;156;501;22;73;83;253;105;326
420545;202001;1099;3291;825;2675;157;541;318;944;475;1485
420550;202001;3448;9313;2123;6987;364;1377;861;2895;1225;4272
420555;202001;292;847;199;650;28;106;108;336;136;442
420560;202001;406;1014;266;804;57;182;141;418;198;600
420570;202001;2074;5860;1582;4916;290;989;646;1911;936;2900
420580;202001;1806;4647;1242;3764;296;959;415;1273;711;2232
420590;202001;2851;7678;1630;5011;301;1091;404;930;705;2021
420600;202001;952;2798;721;2333;111;411;364;1140;475;1551
420610;202001;353;1037;191;659;44;158;61;216;105;374
420620;202001;656;1636;419;1242;95;299;166;481;261;780
420630;202001;820;2468;583;1875;75;276;337;1020;412;1296
420640;202001;491;1365;220;774;59;209;19;61;78;270
420650;202001;3365;8979;1943;5951;298;1024;694;1811;992;2835
420660;202001;359;931;223;654;48;148;55;150;103;298
420665;202001;573;1523;354;1136;64;231;151;432;215;663
420670;202001;1337;3690;859;2723;138;533;327;910;465;1443
420675;202001;154;435;85;293;21;91;35;103;56;194
420680;202001;335;772;158;518;27;108;72;218;99;326
420690;202001;818;2500;482;1677;70;294;110;304;180;598
420700;202001;2723;7217;2007;5969;256;848;1071;3067;1327;3915
420710;202001;803;2328;597;1866;59;238;347;992;406;1230
420720;202001;1244;3447;869;2793;188;624;397;1234;585;1858
420730;202001;2881;7591;2137;6372;350;1140;1136;3273;1486;4413
420740;202001;535;1645;329;1169;99;370;32;128;131;498
420750;202001;1829;5384;1168;3811;197;756;446;1320;643;2076
420757;202001;76;183;36;114;4;8;17;53;21;61
420760;202001;347;1026;153;479;37;130;32;79;69;209
420765;202001;400;1192;206;693;24;102;92;297;116;399
420768;202001;1257;3639;1075;3323;147;446;768;2358;915;2804
420770;202001;434;1173;207;716;28;109;91;298;119;407
420775;202001;275;836;193;642;44;168;43;115;87;283
420780;202001;856;2354;506;1592;117;394;93;263;210;657
420785;202001;187;505;127;378;17;56;59;144;76;200
420790;202001;992;3087;728;2525;130;530;363;1199;493;1729
420800;202001;674;1707;314;972;83;290;68;201;151;491
420810;202001;1417;4496;1143;3926;328;1289;353;1023;681;2312
420820;202001;11405;28683;7994;23057;1552;5066;3583;9368;5135;14434
420830;202001;3377;9036;2463;7366;468;1548;999;2900;1467;4448
420840;202001;487;1435;224;820;65;264;26;80;91;344
420845;202001;2223;5776;1305;4100;239;913;505;1503;744;2416
420850;202001;1026;3379;630;2309;121;487;100;332;221;819
420860;202001;291;755;152;505;33;117;35;104;68;221
420870;202001;775;2123;572;1741;145;535;243;662;388;1197
420880;202001;946;2921;730;2472;153;610;264;824;417;1434
420890;202001;7467;20302;4431;13988;680;2396;1454;4022;2134;6418
420895;202001;157;462;95;303;22;74;29;95;51;169
420900;202001;1360;3400;785;2373;110;403;319;827;429;1230
420910;202001;27284;72122;16575;51164;2567;9048;6294;17370;8861;26418
420915;202001;529;1922;375;1471;60;238;190;754;250;992
420917;202001;338;845;175;497;28;82;80;228;108;310
420920;202001;76;207;25;92;0;0;4;10;4;10
420930;202001;16651;43650;11539;34515;2083;6918;4966;14082;7049;21000
420940;202001;2640;6508;1505;4529;376;1286;254;609;630;1895
420945;202001;131;378;103;314;24;87;41;106;65;193
420950;202001;320;926;169;561;24;93;41;122;65;215
420960;202001;990;2471;687;1945;119;411;279;682;398;1093
420970;202001;2302;6537;1534;5007;437;1488;285;954;722;2442
420980;202001;259;855;227;792;114;396;65;245;179;641
420985;202001;308;895;152;545;36;135;45;141;81;276
420990;202001;325;1003;168;610;31;112;29;89;60;201
421000;202001;502;1564;343;1201;74;282;83;261;157;543
421003;202001;462;1066;150;415;10;32;26;62;36;94
421005;202001;60;169;47;149;10;32;24;74;34;106
421010;202001;3114;8637;2214;6956;464;1651;574;1603;1038;3254
421020;202001;368;1142;282;981;42;175;142;468;184;643
421030;202001;743;2299;573;1930;171;650;173;534;344;1184
421040;202001;702;1616;405;1170;31;102;246;700;277;802
421050;202001;972;2688;606;1842;115;383;202;537;317;920
421055;202001;162;444;78;244;11;40;36;100;47;140
421060;202001;570;1693;361;1194;68;250;140;411;208;661
421070;202001;612;1874;326;1145;73;273;76;271;149;544
421080;202001;476;1378;398;1224;47;168;243;744;290;912
421085;202001;369;1079;131;479;21;78;16;45;37;123
421090;202001;247;630;149;446;15;52;51;134;66;186
421100;202001;858;1919;342;1024;102;354;69;168;171;522
421105;202001;1488;4119;1011;3135;173;546;440;1306;613;1852
421110;202001;1056;2879;877;2628;24;64;631;2007;655;2071
421120;202001;878;2738;627;2139;93;356;204;646;297;1002
421125;202001;272;720;196;580;70;228;67;159;137;387
421130;202001;4500;13337;3663;11679;908;3295;1756;5246;2664;8541
421140;202001;335;908;186;585;29;96;53;152;82;248
421145;202001;427;1203;274;876;60;213;111;324;171;537
421150;202001;565;1528;323;1020;65;236;121;342;186;578
421160;202001;517;1393;358;1091;46;153;226;678;272;831
421165;202001;189;563;118;392;24;80;48;156;72;236
421170;202001;1067;2807;813;2415;141;403;478;1473;619;1876
421175;202001;1033;2606;624;1957;120;426;259;780;379;1206
421180;202001;372;964;199;618;36;142;73;206;109;348
421185;202001;312;841;210;624;28;97;118;345;146;442
421187;202001;282;857;172;568;30;103;53;160;83;263
421189;202001;360;1043;271;862;47;148;100;306;147;454
421190;202001;10118;27483;6601;20812;1271;4411;2063;5996;3334;10407
421200;202001;647;1911;520;1663;57;207;316;981;373;1188
421205;202001;178;475;131;396;28;97;64;179;92;276
421210;202001;1066;2801;633;2049;135;432;218;728;353;1160
421220;202001;1295;3983;998;3319;224;809;287;873;511;1682
421223;202001;356;997;219;725;53;170;98;333;151;503
421225;202001;889;2663;757;2423;137;494;434;1390;571;1884
421227;202001;914;2415;517;1615;89;309;212;666;301;975
421230;202001;596;1597;368;1174;69;249;121;384;190;633
421240;202001;266;801;116;428;15;66;17;62;32;128
421250;202001;1781;4571;1215;3650;162;559;623;1801;785;2360
421260;202001;173;502;46;180;11;49;11;42;22;91
421265;202001;627;1654;564;1576;7;23;526;1476;533;1499
421270;202001;328;881;138;500;18;65;55;193;73;258
421280;202001;1644;4614;1209;3820;199;780;622;1817;821;2597
421290;202001;809;2212;440;1349;78;252;99;282;177;534
421300;202001;272;721;136;443;17;66;25;84;42;150
421310;202001;184;538;129;428;25;88;68;228;93;316
421315;202001;217;608;138;423;37;107;37;117;74;224
421320;202001;600;1794;298;988;40;137;45;104;85;241
421330;202001;588;1760;427;1414;79;304;123;388;202;692
421335;202001;345;1047;279;925;69;260;111;360;180;620
421340;202001;1271;3637;903;2907;172;623;353;1048;525;1671
421350;202001;1344;3516;877;2686;182;661;348;977;530;1638
421360;202001;2239;6121;1306;4184;257;1012;475;1306;732;2318
421370;202001;534;1796;320;1215;63;255;77;254;140;509
421380;202001;758;2058;650;1882;85;286;399;1116;484;1402
421390;202001;177;479;59;201;12;37;20;53;32;90
421400;202001;298;953;199;718;34;134;95;329;129;463
421410;202001;208;555;82;288;17;67;24;73;41;140
421415;202001;191;586;105;350;24;76;20;57;44;133
421420;202001;495;1380;398;1194;36;123;244;703;280;826
421430;202001;111;347;85;285;10;36;23;70;33;106
421440;202001;612;1645;365;1189;79;252;147;469;226;721
421450;202001;418;1240;250;849;34;141;39;147;73;288
421460;202001;347;1027;190;679;23;89;35;101;58;190
421470;202001;254;741;139;480;27;97;51;179;78;276
421480;202001;2708;7312;1712;5357;365;1366;616;1744;981;3110
421490;202001;114;372;66;233;6;24;20;49;26;73
421500;202001;2078;6184;1434;4832;389;1531;314;934;703;2465
421505;202001;298;848;246;768;36;128;158;470;194;598
421507;202001;401;1158;219;742;58;208;65;206;123;414
421510;202001;269;788;155;501;27;99;75;220;102;319
421520;202001;472;1248;288;833;33;104;165;454;198;558
421530;202001;304;938;170;609;31;143;47;140;78;283
421535;202001;382;1022;230;745;36;140;115;348;151;488
421540;202001;265;642;132;420;17;61;45;133;62;194
421545;202001;695;2063;513;1722;115;457;231;717;346;1174
421550;202001;1919;5255;1529;4658;265;863;856;2582;1121;3445
421555;202001;186;590;73;270;13;57;9;24;22;81
421560;202001;75;256;49;195;13;53;11;38;24;91
421565;202001;906;2369;606;1890;151;526;163;510;314;1036
421567;202001;437;1481;279;1015;104;397;63;209;167;606
421568;202001;324;978;244;793;33;127;113;351;146;478
421569;202001;181;513;78;260;18;62;34;112;52;174
421570;202001;1000;2729;704;2157;174;605;198;560;372;1165
421575;202001;270;812;201;635;32;119;82;221;114;340
421580;202001;3211;9004;2068;6589;369;1380;761;2062;1130;3442
421590;202001;134;426;107;361;36;132;26;74;62;206
421600;202001;511;1406;343;1054;81;269;94;244;175;513
421605;202001;715;1873;494;1505;87;236;241;778;328;1014
421610;202001;994;2738;613;1992;115;399;176;558;291;957
421620;202001;3829;10222;2171;7106;480;1760;550;1727;1030;3487
421625;202001;169;470;67;219;13;42;14;45;27;87
421630;202001;2298;6108;1342;4189;239;868;406;1059;645;1927
421635;202001;245;672;161;492;21;65;90;254;111;319
421640;202001;685;1890;487;1576;102;366;191;618;293;984
421650;202001;2204;6065;1376;4475;315;1195;368;1002;683;2197
421660;202001;8951;25174;6203;19829;959;3492;2549;7436;3508;10928
421670;202001;737;2127;509;1591;82;284;246;754;328;1038
421680;202001;967;2725;726;2278;193;659;319;900;512;1559
421690;202001;1233;3612;838;2754;159;604;305;992;464;1596
421700;202001;472;1440;264;927;54;200;82;268;136;468
421710;202001;215;681;93;321;19;70;27;87;46;157
421715;202001;97;278;73;222;17;45;47;140;64;185
421720;202001;1859;5141;1051;3378;257;922;282;785;539;1707
421725;202001;220;541;106;337;20;72;41;95;61;167
421730;202001;399;1164;212;638;28;93;100;278;128;371
421740;202001;630;1754;415;1288;111;356;98;267;209;623
421750;202001;866;2029;381;1125;80;266;139;365;219;631
421755;202001;161;433;88;266;15;63;42;105;57;168
421760;202001;865;2306;541;1711;91;323;187;502;278;825
421770;202001;2344;6285;1686;5112;426;1307;590;1930;1016;3237
421775;202001;184;477;115;344;18;56;54;148;72;204
421780;202001;803;2413;510;1764;104;412;198;644;302;1056
421790;202001;748;1931;420;1342;94;313;196;613;290;926
421795;202001;200;554;131;390;23;81;44;117;67;198
421800;202001;2455;6739;1763;5464;239;876;945;2767;1184;3643
421810;202001;599;1667;405;1299;51;186;236;740;287;926
421820;202001;938;2746;515;1708;104;390;142;379;246;769
421825;202001;1293;3672;1146;3441;123;397;787;2303;910;2700
421830;202001;1986;6016;1614;5295;312;1105;709;2258;1021;3363
421835;202001;196;492;110;344;20;72;30;83;50;155
421840;202001;212;683;141;508;29;111;32;110;61;221
421850;202001;365;1033;196;677;43;164;61;161;104;325
421860;202001;308;882;176;608;23;95;59;180;82;275
421870;202001;3908;9984;2707;7682;499;1675;1237;3095;1736;4770
421875;202001;218;631;105;351;15;56;28;72;43;128
421880;202001;539;1535;350;1124;99;369;68;226;167;595
421885;202001;196;559;122;392;29;101;35;103;64;204
421890;202001;778;2403;572;1985;113;459;266;860;379;1319
421895;202001;401;1057;330;961;39;128;219;662;258;790
421900;202001;946;2464;640;1833;98;322;272;707;370;1029
421910;202001;295;878;203;670;38;147;55;162;93;309
421915;202001;370;1054;202;652;39;126;27;76;66;202
421917;202001;574;1373;315;1025;113;407;72;246;185;653
421920;202001;383;1194;276;977;115;428;72;247;187;675
421930;202001;2403;6126;1136;3626;277;1002;267;740;544;1742
421935;202001;393;1263;307;1066;61;227;167;546;228;773
421940;202001;313;938;128;429;21;81;35;105;56;186
421950;202001;2961;7404;1511;4648;313;1082;346;933;659;2015
421960;202001;175;450;90;290;20;75;22;60;42;135
421970;202001;1835;4757;1051;3156;219;773;358;902;577;1675
421985;202001;283;746;154;486;16;54;57;168;73;222
422000;202001;1812;4820;1441;4192;158;536;944;2706;1102;3242
430003;202001;533;1477;346;1116;68;244;140;440;208;684
430005;202001;266;704;169;529;33;115;77;228;110;343
430010;202001;1690;4182;1352;3641;141;424;951;2471;1092;2895
430020;202001;564;1308;422;1111;49;159;274;688;323;847
430030;202001;989;2357;549;1575;145;462;163;430;308;892
430040;202001;9852;24072;5663;16488;1433;4527;597;1884;2030;6411
430045;202001;509;1289;337;971;21;72;216;606;237;678
430047;202001;245;522;87;241;20;61;23;63;43;124
430050;202001;859;2192;491;1441;108;335;121;333;229;668
430055;202001;237;600;108;323;11;46;61;167;72;213
430057;202001;83;182;27;73;6;22;6;13;12;35
430060;202001;16227;44078;12393;37954;2633;8564;5529;16877;8162;25441
430063;202001;845;2371;660;1979;126;373;362;1082;488;1455
430064;202001;984;2747;724;2186;208;651;261;761;469;1412
430066;202001;99;218;71;174;5;11;54;122;59;133
430070;202001;697;1772;89;306;8;30;15;43;23;73
430080;202001;787;1952;470;1327;79;262;230;559;309;821
430085;202001;863;1994;517;1428;100;293;216;576;316;869
430087;202001;508;1299;408;1162;67;193;252;725;319;918
430090;202001;536;1371;176;547;14;56;58;166;72;222
430100;202001;667;1624;363;1037;66;222;149;360;215;582
430105;202001;1091;2934;678;2213;129;484;304;971;433;1455
430107;202001;167;498;97;314;18;69;25;61;43;130
430110;202001;2072;5216;1482;4344;223;708;805;2323;1028;3031
430120;202001;1260;3749;780;2533;137;469;335;1094;472;1563
430130;202001;3327;7819;2429;6543;946;2545;441;1452;1387;3997
430140;202001;898;2503;617;1953;144;454;285;871;429;1325
430150;202001;546;1408;287;880;68;218;95;283;163;501
430155;202001;252;646;113;342;18;51;23;61;41;112
430160;202001;18467;44565;14200;38309;1758;5166;7994;21508;9752;26674
430163;202001;2672;6588;1796;5141;98;316;1234;3520;1332;3836
430165;202001;325;795;87;285;17;42;14;38;31;80
430170;202001;902;2403;315;1098;50;187;49;155;99;342
430175;202001;644;1973;535;1733;139;458;244;768;383;1226
430180;202001;645;1594;514;1371;66;179;347;916;413;1095
430185;202001;478;1150;273;771;64;179;70;168;134;347
430187;202001;668;1566;468;1302;73;219;232;684;305;903
430190;202001;1356;3651;1078;3197;226;734;496;1392;722;2126
430192;202001;136;371;48;145;7;20;10;25;17;45
430195;202001;387;1156;48;172;7;19;7;22;14;41
430200;202001;1077;3248;860;2853;278;964;243;822;521;1786
430205;202001;458;1223;395;1104;13;43;335;911;348;954
430210;202001;4765;12281;3170;8908;610;1824;1010;2320;1620;4144
430215;202001;303;785;189;556;41;127;71;209;112;336
430220;202001;626;1540;163;561;28;122;30;75;58;197
430222;202001;172;499;124;390;11;42;49;149;60;191
430223;202001;235;628;185;541;18;60;117;334;135;394
430225;202001;15;29;10;21;1;2;9;19;10;21
430230;202001;1744;4954;1499;4575;136;449;1106;3357;1242;3806
430235;202001;293;847;189;605;43;157;55;154;98;311
430237;202001;516;1254;357;988;22;69;243;647;265;716
430240;202001;1135;2586;613;1692;76;263;325;827;401;1090
430245;202001;679;1992;519;1682;158;515;227;764;385;1279
430250;202001;893;2255;643;1857;220;700;46;114;266;814
430258;202001;114;305;89;256;9;21;47;146;56;167
430260;202001;620;1657;431;1289;62;192;236;698;298;890
430265;202001;203;593;137;460;28;95;40;131;68;226
430270;202001;2738;6886;2146;5946;393;1185;1251;3356;1644;4541
430280;202001;4984;11948;3402;9175;716;1965;1416;3773;2132;5738
430290;202001;2163;5020;1771;4560;50;173;1508;3786;1558;3959
430300;202001;9183;23821;6925;19780;1148;3566;3548;9946;4696;13512
430310;202001;10943;27387;7095;20101;948;3044;3299;8659;4247;11703
430320;202001;958;2536;514;1610;70;198;270;865;340;1063
430330;202001;639;1590;395;1092;65;197;177;425;242;622
430340;202001;708;1552;372;1032;51;154;208;558;259;712
430350;202001;6900;18106;5045;14648;896;2739;2578;7219;3474;9958
430355;202001;329;845;114;372;18;58;15;43;33;101
430360;202001;815;1947;531;1452;107;334;208;519;315;853
430367;202001;306;730;161;458;36;109;73;203;109;312
430370;202001;461;1246;202;631;41;132;46;125;87;257
430380;202001;660;1641;318;998;75;283;82;238;157;521
430390;202001;2984;7274;1644;4774;285;942;209;413;494;1355
430400;202001;1069;2281;813;1911;62;175;604;1349;666;1524
430410;202001;539;1303;364;1010;48;154;224;596;272;750
430420;202001;2607;7284;1983;5875;530;1633;809;2283;1339;3916
430430;202001;597;1527;284;861;69;203;63;190;132;393
430435;202001;1469;3767;1111;3179;206;630;537;1547;743;2177
430440;202001;3635;10228;2706;8463;341;1225;1541;4729;1882;5954
430450;202001;6551;16779;5152;14261;726;2281;2778;7400;3504;9681
430460;202001;29211;75394;20725;61146;3859;12634;9595;27029;13454;39663
430461;202001;315;816;95;295;12;40;29;76;41;116
430462;202001;231;616;132;421;17;54;43;146;60;200
430463;202001;5154;14002;3790;11539;765;2585;1689;4927;2454;7512
430465;202001;418;1099;344;965;51;163;211;570;262;733
430466;202001;3967;10078;3061;8572;763;2209;1399;3713;2162;5922
430467;202001;480;1179;329;938;45;150;168;456;213;606
430468;202001;1278;3157;984;2712;96;281;603;1624;699;1905
430469;202001;624;1735;73;246;8;29;13;17;21;46
430470;202001;5368;13904;3515;10571;1027;3361;908;2568;1935;5929
430471;202001;517;1508;424;1332;64;224;230;687;294;911
430480;202001;753;2022;391;1233;48;162;84;239;132;401
430485;202001;171;463;62;200;15;44;8;26;23;70
430490;202001;392;1017;217;636;26;93;102;266;128;359
430495;202001;361;989;209;677;25;86;78;243;103;329
430500;202001;979;2572;664;2024;211;688;186;512;397;1200
430510;202001;23863;62935;16688;48528;2919;9628;7170;19069;10089;28697
430511;202001;319;946;125;423;15;59;16;45;31;104
430512;202001;928;2119;712;1802;176;449;253;649;429;1098
430513;202001;769;1931;351;1021;50;161;176;485;226;646
430515;202001;365;1028;258;807;35;101;129;404;164;505
430517;202001;1046;3254;787;2642;138;461;388;1344;526;1805
430520;202001;1256;3279;624;1871;107;351;127;340;234;691
430530;202001;976;2499;372;1162;72;221;94;285;166;506
430535;202001;3094;8162;2199;6490;318;984;1088;3116;1406;4100
430537;202001;317;1124;292;1043;22;67;233;837;255;904
430540;202001;561;1388;329;984;48;144;155;462;203;606
430543;202001;734;1342;411;971;55;110;193;504;248;614
430544;202001;649;1877;444;1410;103;322;188;597;291;919
430545;202001;2156;5686;1588;4798;315;970;772;2404;1087;3374
430550;202001;374;1047;245;765;46;144;86;257;132;401
430558;202001;110;250;45;125;5;10;12;33;17;43
430560;202001;340;764;138;418;16;52;44;132;60;184
430570;202001;779;1902;535;1452;92;283;274;700;366;983
430580;202001;850;2123;599;1728;143;448;262;733;405;1181
430583;202001;196;486;35;115;3;11;6;18;9;29
430585;202001;227;555;114;314;13;35;54;137;67;172
430587;202001;204;579;143;445;19;59;60;190;79;249
430590;202001;1386;3305;1145;2938;54;156;951;2402;1005;2558
430593;202001;18;63;12;41;1;3;6;19;7;22
430595;202001;412;982;98;321;4;19;25;63;29;82
430597;202001;409;1081;218;664;19;64;71;162;90;226
430600;202001;1831;4730;789;2308;142;451;218;593;360;1044
430605;202001;1135;3124;824;2517;109;397;360;1053;469;1450
430607;202001;524;1241;418;1071;26;75;298;750;324;825
430610;202001;5543;13241;3650;10300;1044;3253;743;2114;1787;5367
430613;202001;258;603;68;195;9;28;17;39;26;67
430620;202001;589;1470;430;1167;60;179;239;597;299;776
430630;202001;420;1156;118;384;20;68;23;65;43;133
430632;202001;503;1343;214;664;24;80;98;282;122;362
430635;202001;528;1279;384;1031;45;128;268;719;313;847
430637;202001;448;1109;346;953;39;126;217;568;256;694
430640;202001;1015;2642;573;1724;82;263;190;535;272;798
430642;202001;340;937;253;736;43;117;134;366;177;483
430645;202001;163;382;56;152;9;27;17;47;26;74
430650;202001;1544;4547;1237;4028;327;1071;578;1965;905;3036
430655;202001;266;659;152;429;24;77;71;174;95;251
430660;202001;4913;12826;3672;10696;837;2599;1553;4462;2390;7061
430670;202001;641;1574;483;1285;30;82;290;786;320;868
430673;202001;537;1226;205;599;38;117;74;198;112;315
430675;202001;223;637;52;182;9;33;24;82;33;115
430676;202001;4530;11509;3526;9941;442;1387;2182;5987;2624;7374
430680;202001;909;2463;542;1690;154;490;131;400;285;890
430690;202001;2829;7749;2231;6661;750;2329;582;1675;1332;4004
430692;202001;205;638;153;547;10;45;109;389;119;434
430693;202001;976;2585;577;1764;109;397;147;400;256;797
430695;202001;459;1186;243;721;32;89;128;366;160;455
430697;202001;386;972;291;818;73;192;140;424;213;616
430700;202001;6511;16347;3607;10858;771;2521;563;1624;1334;4145
430705;202001;401;978;195;588;23;81;76;205;99;286
430710;202001;1645;3601;1142;2900;146;414;664;1652;810;2066
430720;202001;713;1712;360;1088;55;165;175;532;230;697
430730;202001;1031;2812;688;2151;97;286;359;1125;456;1411
430740;202001;587;1623;296;991;53;185;79;278;132;463
430745;202001;405;1103;224;694;37;130;73;190;110;320
430750;202001;1318;3408;915;2704;194;594;478;1369;672;1963
430755;202001;457;1114;284;766;18;57;164;405;182;462
430760;202001;1999;5010;1518;4246;366;1097;646;1729;1012;2826
430770;202001;6016;15182;4566;12975;616;2001;2827;7746;3443;9747
430780;202001;1911;4703;1084;3260;224;737;392;1134;616;1871
430781;202001;436;1219;235;736;33;102;68;185;101;287
430783;202001;393;886;226;627;22;75;131;348;153;423
430786;202001;31;106;22;84;4;16;4;20;8;36
430790;202001;4289;10555;2904;8110;355;1182;1723;4481;2078;5663
430800;202001;750;1765;543;1435;36;96;358;946;394;1042
430805;202001;384;1031;229;692;22;81;141;396;163;477
430807;202001;404;948;202;564;14;44;94;235;108;279
430810;202001;745;1770;258;797;30;114;95;279;125;393
430820;202001;1275;3375;695;2249;142;480;165;523;307;1003
430825;202001;248;617;80;204;13;33;24;56;37;89
430830;202001;1648;4777;1317;4134;62;224;930;2892;992;3116
430840;202001;947;2421;681;1959;93;295;455;1269;548;1564
430843;202001;120;288;49;137;4;16;23;57;27;73
430845;202001;405;971;264;730;58;172;100;261;158;433
430850;202001;2315;6075;1566;4593;237;764;642;1890;879;2654
430860;202001;895;2083;403;1153;48;170;190;465;238;635
430865;202001;491;1236;363;1018;58;179;201;541;259;720
430870;202001;615;1608;259;824;39;147;83;231;122;378
430880;202001;1344;3124;886;2423;145;425;460;1217;605;1642
430885;202001;177;477;85;292;9;33;49;168;58;201
430890;202001;1012;2538;660;1927;58;248;122;329;180;577
430900;202001;2951;6507;1981;5077;179;540;1264;3045;1443;3585
430905;202001;761;1939;462;1360;88;281;164;456;252;737
430910;202001;1492;3986;1021;3011;163;567;473;1241;636;1808
430912;202001;493;1360;326;1036;27;82;213;692;240;774
430915;202001;486;1493;355;1240;124;443;99;351;223;794
430920;202001;22996;58525;17319;48916;2455;7681;10149;27791;12604;35472
430925;202001;111;248;40;120;5;13;16;50;21;63
430930;202001;10016;23786;6242;17921;1191;3506;2533;7583;3724;11089
430940;202001;1041;2772;579;1737;163;513;123;304;286;817
430950;202001;722;1731;449;1245;38;133;270;677;308;810
430955;202001;319;857;79;249;18;56;18;46;36;102
430957;202001;179;615;164;577;27;99;95;330;122;429
430960;202001;1328;3179;740;2089;157;477;321;881;478;1358
430965;202001;1590;3798;1207;3194;64;184;941;2517;1005;2701
430970;202001;363;893;178;518;28;85;85;225;113;310
430975;202001;480;1475;361;1187;78;268;168;540;246;808
430980;202001;376;859;208;574;30;96;95;237;125;333
430990;202001;544;1555;321;1008;36;114;158;492;194;606
430995;202001;552;1427;392;1160;48;154;210;605;258;759
431000;202001;1337;3180;536;1568;90;293;38;98;128;391
431010;202001;2019;5218;1191;3798;225;785;192;524;417;1309
431020;202001;8064;17673;4674;12465;1056;3160;1522;3537;2578;6697
431030;202001;325;885;153;521;26;92;23;71;49;163
431033;202001;3484;8351;2130;6165;486;1470;717;2087;1203;3557
431036;202001;336;724;71;199;7;19;20;48;27;67
431040;202001;895;2303;570;1706;89;301;235;646;324;947
431041;202001;451;1038;327;858;25;62;195;506;220;568
431043;202001;376;904;184;576;37;128;86;268;123;396
431046;202001;110;286;45;138;3;8;11;33;14;41
431050;202001;1337;3280;947;2651;165;486;479;1357;644;1843
431053;202001;599;1643;316;1020;67;244;94;275;161;519
431055;202001;573;1418;477;1272;52;126;344;918;396;1044
431057;202001;257;735;120;402;23;76;34;104;57;180
431060;202001;5142;13571;3435;10545;840;2792;855;2630;1695;5422
431065;202001;412;1055;288;848;51;158;117;335;168;493
431070;202001;427;1217;234;766;54;192;49;155;103;347
431075;202001;222;662;138;463;24;81;39;129;63;210
431080;202001;578;1599;381;1176;76;263;125;367;201;630
431085;202001;695;1855;444;1253;67;187;214;594;281;781
431087;202001;422;1188;339;1016;23;62;230;714;253;776
431090;202001;402;942;148;463;26;83;43;137;69;220
431100;202001;3301;7382;2261;5957;337;929;1096;2925;1433;3854
431110;202001;1360;3164;906;2371;265;707;331;815;596;1522
431112;202001;514;1492;425;1314;78;271;222;651;300;922
431113;202001;346;964;295;865;49;157;178;508;227;665
431115;202001;983;2807;754;2380;108;402;428;1272;536;1674
431120;202001;2280;6466;1539;4916;488;1774;345;970;833;2744
431123;202001;379;1064;241;767;44;124;132;441;176;565
431125;202001;989;2934;745;2428;271;862;244;850;515;1712
431127;202001;229;587;57;183;8;26;10;27;18;53
431130;202001;2966;7725;2138;6266;333;1110;1125;3187;1458;4297
431140;202001;5062;12004;2821;7746;357;1047;1203;2911;1560;3958
431142;202001;491;1315;359;1073;53;163;212;634;265;797
431150;202001;1001;2703;692;2108;137;450;284;843;421;1293
431160;202001;668;1912;440;1403;73;261;135;426;208;687
431162;202001;501;1205;258;759;23;80;147;402;170;482
431164;202001;183;423;39;120;8;24;4;7;12;31
431170;202001;483;1355;330;1025;100;305;84;253;184;558
431171;202001;615;1457;492;1293;100;243;295;793;395;1036
431173;202001;402;1064;295;895;86;293;112;316;198;609
431175;202001;1133;2688;671;1887;110;317;235;625;345;942
431177;202001;708;2021;521;1706;139;494;268;858;407;1352
431179;202001;339;733;84;246;14;45;15;40;29;85
431180;202001;2196;5553;1303;3806;328;930;336;999;664;1929
431190;202001;434;1167;209;662;26;89;60;151;86;240
431198;202001;332;991;271;880;100;341;73;262;173;603
431200;202001;360;919;70;208;13;37;6;17;19;54
431205;202001;198;553;95;317;25;87;32;109;57;196
431210;202001;590;1508;471;1336;113;316;231;691;344;1007
431213;202001;245;661;181;546;13;40;88;278;101;318
431215;202001;579;1376;243;711;26;84;112;305;138;389
431217;202001;160;420;106;322;5;22;61;170;66;192
431220;202001;568;1480;326;990;35;133;180;504;215;637
431225;202001;1519;3634;1135;2976;108;303;788;2081;896;2384
431230;202001;670;1938;495;1516;60;210;297;868;357;1078
431235;202001;150;379;23;78;2;5;3;14;5;19
431237;202001;310;997;256;869;50;183;131;429;181;612
431238;202001;29;78;24;68;7;20;7;17;14;37
431240;202001;4028;10180;3057;8619;501;1558;1623;4420;2124;5978
431242;202001;264;723;219;644;50;158;110;315;160;473
431244;202001;318;767;158;444;22;78;56;133;78;211
431245;202001;1267;2974;783;2123;85;247;394;1012;479;1259
431247;202001;227;609;116;361;22;76;32;77;54;153
431250;202001;1605;4101;1162;3474;258;785;582;1811;840;2596
431260;202001;224;632;136;454;20;86;47;146;67;232
431261;202001;230;722;184;644;16;64;98;329;114;393
431262;202001;377;1042;174;567;14;47;111;365;125;412
431265;202001;1506;3559;581;1709;73;262;199;502;272;764
431267;202001;261;709;152;457;5;22;102;271;107;293
431270;202001;2684;6161;1404;3971;343;1021;422;1215;765;2236
431275;202001;131;377;66;211;22;69;10;31;32;100
431280;202001;227;605;65;210;7;25;8;15;15;40
431290;202001;302;881;192;607;33;116;36;89;69;205
431295;202001;72;192;23;76;1;4;8;25;9;29
431300;202001;306;776;53;168;5;18;12;29;17;47
431301;202001;304;866;69;222;10;23;6;17;16;40
431303;202001;568;1504;329;977;22;72;149;416;171;488
431306;202001;2088;4917;1195;3403;176;559;472;1201;648;1760
431308;202001;26;80;23;74;10;35;10;31;20;66
431310;202001;513;1470;361;1113;42;144;166;476;208;620
431320;202001;597;1628;282;939;39;124;46;141;85;265
431330;202001;1617;3838;737;2158;167;576;240;610;407;1186
431333;202001;218;589;102;300;17;46;38;106;55;152
431335;202001;40;116;22;75;4;8;2;5;6;13
431337;202001;2538;6811;1810;5565;365;1269;862;2547;1227;3816
431339;202001;389;1025;282;822;79;244;116;327;195;571
431340;202001;19141;46622;12913;36024;2311;7055;5397;14128;7708;21183
431342;202001;439;956;316;782;15;39;280;688;295;727
431344;202001;388;997;224;671;8;29;128;364;136;393
431346;202001;250;614;94;302;15;53;28;92;43;145
431349;202001;656;1723;344;1023;85;251;124;365;209;616
431350;202001;3950;10334;2863;8415;430;1421;1447;4122;1877;5543
431360;202001;575;1382;281;803;78;236;80;224;158;460
431365;202001;1858;4494;1474;3968;123;377;1080;2884;1203;3261
431370;202001;4205;10522;2961;8386;703;2082;1298;3799;2001;5881
431380;202001;781;2133;634;1887;37;127;443;1303;480;1430
431390;202001;2492;6075;1444;4179;177;608;641;1621;818;2229
431395;202001;1226;3123;849;2532;196;610;366;1121;562;1731
431400;202001;329;928;171;549;31;93;36;110;67;203
431402;202001;834;1900;595;1534;77;217;382;954;459;1171
431403;202001;182;512;144;442;23;82;70;177;93;259
431405;202001;4385;11650;3333;9904;632;2105;1543;4338;2175;6443
431406;202001;513;1493;370;1188;76;233;184;607;260;840
431407;202001;461;1288;303;947;59;205;141;419;200;624
431410;202001;16227;41398;10337;30543;1588;5440;4875;13415;6463;18855
431413;202001;234;607;62;203;5;14;13;46;18;60
431415;202001;668;1634;404;1196;76;264;177;463;253;727
431417;202001;547;1213;367;943;53;154;202;513;255;667
431420;202001;1500;3490;1119;2938;166;449;589;1553;755;2002
431430;202001;521;1337;240;768;34;119;72;194;106;313
431440;202001;29356;69562;20298;54949;3597;10479;7659;19536;11256;30015
431442;202001;108;293;46;152;6;16;9;26;15;42
431445;202001;387;1107;124;422;17;53;10;32;27;85
431446;202001;280;818;201;656;38;134;94;294;132;428
431447;202001;655;1775;390;1204;75;256;139;434;214;690
431449;202001;722;1910;429;1277;80;230;171;514;251;744
431450;202001;2150;4521;1687;3868;98;241;1291;2876;1389;3117
431454;202001;33;104;29;95;6;19;10;35;16;54
431455;202001;588;1421;286;783;35;105;143;352;178;457
431460;202001;2776;6919;1976;5476;517;1508;544;1534;1061;3042
431470;202001;1388;3910;990;3061;182;572;434;1366;616;1938
431475;202001;253;710;41;157;3;11;5;16;8;27
431477;202001;396;1034;232;696;40;117;92;236;132;353
431478;202001;274;714;53;167;14;40;6;16;20;56
431480;202001;3026;7655;2303;6494;549;1604;1113;3148;1662;4752
431490;202001;108379;258086;82389;217505;6428;20119;58981;149470;65409;169589
431500;202001;486;1235;349;973;61;172;186;500;247;672
431505;202001;296;718;197;559;18;57;129;360;147;417
431507;202001;336;794;132;390;41;130;37;100;78;230
431510;202001;1512;3953;1009;2965;215;691;374;1074;589;1765
431513;202001;222;497;120;323;9;22;81;214;90;236
431514;202001;95;247;62;186;4;11;41;120;45;131
431515;202001;471;1184;330;925;63;176;167;470;230;646
431517;202001;69;200;55;168;10;30;20;56;30;86
431520;202001;423;1041;159;505;26;93;64;171;90;264
431530;202001;3956;8453;2234;5936;528;1430;519;1395;1047;2825
431531;202001;202;514;122;354;11;37;55;143;66;180
431532;202001;547;1276;318;863;68;210;128;332;196;542
431535;202001;241;639;99;322;20;71;20;53;40;124
431540;202001;1781;5731;1656;5556;60;252;1339;4503;1399;4755
431545;202001;344;895;59;187;9;28;12;35;21;63
431550;202001;1951;5050;1492;4204;250;775;739;1996;989;2771
431555;202001;667;1509;419;1098;22;76;256;653;278;729
431560;202001;21659;53267;14220;41351;2885;8877;4589;14048;7474;22925
431570;202001;4634;11209;3559;9674;421;1298;2415;6318;2836;7616
431575;202001;226;577;166;470;36;90;47;130;83;220
431580;202001;577;1476;335;984;39;144;178;489;217;633
431590;202001;596;1643;448;1338;97;304;174;534;271;838
431595;202001;346;952;219;670;48;147;88;251;136;398
431600;202001;1280;2972;898;2445;229;680;338;957;567;1637
431610;202001;1318;3424;889;2613;134;374;457;1369;591;1743
431620;202001;442;1153;196;591;35;114;73;202;108;316
431630;202001;1279;3210;582;1755;95;317;206;564;301;881
431640;202001;6077;14969;5173;13792;565;1561;3701;9978;4266;11539
431642;202001;532;1310;327;889;21;53;172;429;193;482
431643;202001;354;886;157;466;18;50;48;142;66;192
431645;202001;1803;4099;1403;3532;78;244;1082;2687;1160;2931
431647;202001;229;585;83;249;8;24;18;50;26;74
431650;202001;127;339;85;264;9;32;44;126;53;158
431660;202001;872;2342;443;1452;73;276;117;344;190;620
431670;202001;1116;2676;713;1951;101;287;378;996;479;1283
431673;202001;228;571;77;266;13;43;14;46;27;89
431675;202001;552;1357;102;328;10;45;19;49;29;94
431680;202001;7299;18930;5230;14991;1264;3755;2163;6104;3427;9859
431690;202001;22370;55333;14417;40903;3095;9394;5274;15033;8369;24427
431695;202001;149;353;88;256;16;60;45;100;61;160
431697;202001;453;1077;341;902;50;121;189;522;239;643
431700;202001;1364;3556;1134;3131;157;410;684;1872;841;2282
431710;202001;12222;29973;8447;24458;1611;4949;3912;11620;5523;16569
431720;202001;5813;14827;3446;10056;847;2621;569;1448;1416;4069
431725;202001;24;63;18;53;5;14;7;21;12;35
431730;202001;3749;9153;2306;6788;546;1720;706;2216;1252;3936
431740;202001;4978;11964;3193;8865;888;2826;739;1716;1627;4542
431750;202001;7216;18597;5545;15944;1199;3725;2426;6845;3625;10570
431755;202001;313;846;67;233;7;26;11;37;18;63
431760;202001;5376;12084;3446;9043;346;1076;2035;5020;2381;6096
431770;202001;1828;4384;1423;3840;91;305;1063;2780;1154;3085
431775;202001;194;511;101;315;21;63;15;42;36;105
431780;202001;1978;5025;1247;3624;213;702;510;1420;723;2122
431790;202001;793;2165;563;1708;103;314;246;719;349;1033
431795;202001;229;587;106;325;22;69;30;83;52;152
431800;202001;7796;19066;4800;14178;1277;4310;548;1681;1825;5991
431805;202001;304;716;86;280;6;21;33;98;39;119
431810;202001;3202;7681;2006;5464;374;1077;847;2214;1221;3291
431820;202001;2137;5865;1680;5107;478;1513;570;1841;1048;3354
431830;202001;8736;19146;6300;15815;1619;4676;1993;4995;3612;9671
431840;202001;2530;6736;2016;5880;337;992;1200;3520;1537;4512
431842;202001;589;1482;196;617;23;82;61;173;84;255
431843;202001;322;862;240;691;29;99;120;318;149;417
431844;202001;206;540;59;201;14;53;19;70;33;123
431845;202001;511;1351;352;1026;27;79;201;585;228;664
431846;202001;286;748;240;680;11;35;209;586;220;621
431848;202001;114;293;67;202;8;26;8;19;16;45
431849;202001;400;973;63;189;1;1;7;22;8;23
431850;202001;3965;10880;3016;8949;720;2314;934;2741;1654;5055
431860;202001;633;1570;360;1037;60;181;188;515;248;696
431861;202001;94;263;52;165;13;43;16;44;29;87
431862;202001;429;1363;348;1221;72;281;173;582;245;863
431870;202001;18108;47031;14502;41170;1856;5907;8536;23365;10392;29272
431880;202001;3960;10234;2739;7991;444;1485;1220;3381;1664;4866
431890;202001;4221;10727;2564;7513;747;2395;423;1366;1170;3761
431900;202001;969;2477;601;1784;88;300;307;853;395;1153
431910;202001;757;1828;253;727;51;142;64;143;115;285
431912;202001;446;1251;350;1080;67;219;204;624;271;843
431915;202001;1031;2608;813;2253;29;94;610;1651;639;1745
431920;202001;1174;2845;981;2583;27;76;835;2190;862;2266
431930;202001;653;1754;429;1342;124;352;198;645;322;997
431935;202001;85;238;55;174;16;57;10;29;26;86
431936;202001;298;870;162;525;35;121;58;172;93;293
431937;202001;167;415;105;283;17;55;44;92;61;147
431940;202001;2859;6833;1631;4562;182;574;797;2128;979;2702
431950;202001;1757;4734;1413;4171;459;1364;528;1565;987;2929
431960;202001;2844;7090;2036;5598;580;1654;524;1428;1104;3082
431970;202001;421;1070;150;458;40;122;35;95;75;217
431971;202001;62;163;30;98;4;17;5;10;9;27
431973;202001;471;1512;389;1354;39;144;283;983;322;1127
431975;202001;110;235;23;80;4;17;3;7;7;24
431980;202001;1010;2664;773;2255;165;511;349;980;514;1491
431990;202001;5727;13791;3723;10821;501;1704;1712;4741;2213;6445
432000;202001;10567;25595;7528;20761;1833;5119;3198;8954;5031;14073
432010;202001;2021;5110;1463;4102;222;706;843;2223;1065;2929
432020;202001;1772;4510;1104;3175;219;659;479;1300;698;1959
432023;202001;509;1226;257;733;39;123;118;301;157;424
432026;202001;999;2784;703;2211;175;549;239;743;414;1292
432030;202001;325;822;180;533;25;71;95;281;120;352
432032;202001;340;879;227;663;26;88;120;322;146;410
432035;202001;647;1844;560;1698;184;559;214;686;398;1245
432040;202001;1083;2447;361;1110;58;198;113;316;171;514
432045;202001;176;483;103;335;23;76;36;120;59;196
432050;202001;461;1204;344;985;79;227;135;406;214;633
432055;202001;594;1627;396;1236;127;415;87;240;214;655
432057;202001;225;602;166;459;27;63;65;169;92;232
432060;202001;454;1086;141;440;33;113;42;113;75;226
432065;202001;213;602;146;456;27;82;57;172;84;254
432067;202001;714;2079;601;1830;51;180;434;1270;485;1450
432070;202001;1674;4431;1065;3207;242;798;316;859;558;1657
432080;202001;4163;10156;3144;8464;562;1752;1437;3679;1999;5431
432085;202001;356;922;241;739;73;223;93;302;166;525
432090;202001;1303;3293;858;2460;171;532;423;1156;594;1688
432100;202001;935;2435;429;1364;82;281;73;188;155;469
432110;202001;2071;5618;1379;4318;337;1208;118;341;455;1549
432120;202001;2742;7541;2110;6409;415;1402;771;2252;1186;3654
432130;202001;2482;6469;2036;5811;623;1816;870;2540;1493;4356
432132;202001;186;529;110;359;19;65;49;133;68;198
432135;202001;982;2373;631;1744;36;116;450;1226;486;1342
432140;202001;1492;4503;1123;3765;157;559;678;2271;835;2830
432143;202001;1382;3648;1054;3135;77;251;688;2032;765;2283
432145;202001;1351;3579;765;2314;108;359;224;570;332;929
432146;202001;100;277;63;209;21;74;18;56;39;130
432147;202001;483;1401;287;962;93;336;68;196;161;532
432149;202001;417;1052;198;592;14;45;94;267;108;312
432150;202001;2926;7613;2106;6115;457;1490;752;2116;1209;3606
432160;202001;5062;13562;3696;11288;944;3143;1250;3632;2194;6775
432162;202001;268;586;36;104;7;19;5;14;12;33
432163;202001;130;327;27;75;0;0;4;8;4;8
432166;202001;582;1675;434;1350;76;258;143;402;219;660
432170;202001;1289;3473;792;2518;148;523;287;844;435;1367
432180;202001;2600;6345;1350;3919;262;812;446;1156;708;1968
432183;202001;352;1037;232;753;61;228;64;192;125;420
432185;202001;793;2039;449;1371;35;126;238;687;273;813
432190;202001;1703;4193;1075;3158;216;704;506;1396;722;2100
432195;202001;929;2322;592;1700;162;430;210;641;372;1071
432200;202001;3104;8136;2191;6608;384;1170;1157;3568;1541;4738
432210;202001;363;960;213;658;38;145;99;260;137;405
432215;202001;614;1798;552;1705;51;140;401;1262;452;1402
432218;202001;255;644;114;331;16;54;48;125;64;179
432220;202001;3503;8313;2590;6872;440;1242;1429;3718;1869;4960
432225;202001;85;249;62;196;13;45;32;103;45;148
432230;202001;699;1658;372;1042;51;150;153;394;204;544
432232;202001;485;1192;292;848;61;196;104;278;165;474
432234;202001;264;666;119;347;20;46;16;42;36;88
432235;202001;70;192;22;70;4;12;6;24;10;36
432237;202001;336;865;291;788;10;21;234;621;244;642
432240;202001;14766;37509;10687;31899;786;2631;6736;20986;7522;23617
432250;202001;4620;13809;3690;11975;1007;3363;1451;4739;2458;8102
432252;202001;432;1031;263;739;33;98;129;351;162;449
432253;202001;931;2894;563;1940;141;519;41;132;182;651
432254;202001;693;1652;153;475;29;93;17;42;46;135
432255;202001;107;270;57;172;5;17;30;79;35;96
432260;202001;4629;12069;3318;9532;971;2899;950;2656;1921;5555
432270;202001;1765;4998;1380;4223;415;1381;249;721;664;2102
432280;202001;1155;2954;577;1767;91;308;207;538;298;846
432285;202001;170;500;23;68;1;3;3;5;4;8
432290;202001;333;944;174;557;59;184;32;77;91;261
432300;202001;25447;65325;18859;54441;2850;9276;10643;29567;13493;38843
432310;202001;775;2138;553;1718;49;158;374;1164;423;1322
432320;202001;209;484;70;208;8;31;26;67;34;98
432330;202001;211;483;61;189;7;19;14;42;21;61
432335;202001;198;564;73;262;7;30;12;37;19;67
432340;202001;317;761;132;416;13;42;44;129;57;171
432345;202001;642;1489;564;1393;22;59;450;1091;472;1150
432350;202001;336;894;181;590;28;103;68;214;96;317
432360;202001;223;666;44;148;2;8;17;54;19;62
432370;202001;302;741;195;560;17;52;126;356;143;408
432375;202001;476;1200;351;953;63;156;172;486;235;642
432377;202001;180;561;33;113;5;20;3;7;8;27
432380;202001;1607;4308;1014;3194;182;659;495;1483;677;2142
500020;202001;2455;6382;1723;5121;196;673;994;2850;1190;3523
500025;202001;1242;2998;764;2125;64;192;420;1126;484;1318
500060;202001;7526;21370;5141;16401;647;2163;2935;9631;3582;11794
500070;202001;4174;10929;2881;8699;523;1619;1219;3795;1742;5414
500080;202001;1367;3451;879;2584;163;543;359;937;522;1480
500085;202001;1990;4965;1310;3849;296;914;627;1769;923;2683
500090;202001;1948;5263;1316;4157;240;790;478;1571;718;2361
500100;202001;3519;9011;2648;7575;459;1481;1247;3377;1706;4858
500110;202001;7506;19446;4798;15102;1062;3698;1389;5119;2451;8817
500124;202001;1990;5957;1585;5256;259;800;847;2965;1106;3765
500150;202001;1296;2961;795;2217;154;444;283;772;437;1216
500190;202001;4420;11178;2873;8426;668;2006;775;2214;1443;4220
500200;202001;2161;5186;1557;4178;169;488;941;2386;1110;2874
500210;202001;4542;11266;3228;9494;838;2493;1393;4185;2231;6678
500215;202001;1328;3770;931;3015;93;338;477;1553;570;1891
500220;202001;2411;6861;1524;5142;265;952;372;1215;637;2167
500230;202001;2123;4974;1562;4179;196;510;1009;2680;1205;3190
500240;202001;3507;10538;2413;8243;390;1476;903;3210;1293;4686
500260;202001;3046;6540;1858;4901;263;679;947;2426;1210;3105
500270;202001;135196;319490;78559;221577;13480;41790;27290;72617;40770;114407
500280;202001;1221;3109;821;2483;100;329;478;1409;578;1738
500290;202001;3537;8339;1918;5653;348;1182;575;1520;923;2702
500295;202001;3184;7786;1913;5484;307;982;716;1791;1023;2773
500310;202001;920;1944;614;1555;101;212;303;813;404;1025
500315;202001;3517;10039;2759;8855;252;807;1883;6238;2135;7045
500320;202001;18133;50026;12500;40608;3242;11021;4234;14621;7476;25642
500325;202001;4201;9458;2841;7617;245;684;1851;5025;2096;5709
500330;202001;6660;15273;4294;11743;321;972;2362;6645;2683;7617
500345;202001;1979;4870;1268;3753;299;916;416;1204;715;2120
500348;202001;2361;6099;1807;5172;252;739;1001;2935;1253;3674
500350;202001;1244;3394;667;2128;74;243;283;884;357;1127
500370;202001;24287;63294;16621;50524;2299;7984;8324;25306;10623;33290
500375;202001;2420;6448;1582;4703;306;976;495;1388;801;2364
500380;202001;3420;8579;2293;6665;647;2017;564;1662;1211;3679
500390;202001;502;1093;309;847;52;167;180;486;232;653
500400;202001;1314;3404;842;2476;155;508;273;741;428;1249
500410;202001;2382;5989;1670;4886;168;492;971;2939;1139;3431
500430;202001;2571;6376;1701;5049;229;804;711;2211;940;3015
500440;202001;1117;2735;679;2032;93;310;252;817;345;1127
500450;202001;1409;3551;771;2341;150;480;163;471;313;951
500460;202001;3626;9829;2197;6972;376;1352;675;2138;1051;3490
500470;202001;2410;6565;1465;4595;429;1506;293;789;722;2295
500480;202001;2146;6481;1821;5962;160;563;1312;4386;1472;4949
500490;202001;979;2314;555;1668;125;458;149;440;274;898
500500;202001;4271;11524;2701;8921;952;3670;466;1565;1418;5235
500510;202001;677;1734;429;1255;28;98;255;728;283;826
500515;202001;1774;4471;1340;3778;144;449;823;2217;967;2666
500520;202001;2956;9547;2334;8346;640;2317;958;3596;1598;5913
500525;202001;845;2549;688;2303;60;212;418;1432;478;1644
500540;202001;4443;11554;2638;8321;684;2665;245;700;929;3365
500560;202001;5305;14747;4233;13341;277;946;3322;10623;3599;11569
500568;202001;4313;9458;2563;6853;584;1712;859;2328;1443;4040
500570;202001;7458;17538;4393;12249;831;2547;1430;3729;2261;6276
500580;202001;3031;8150;2205;6686;469;1488;1033;3130;1502;4618
500600;202001;3054;7662;2122;6225;447;1339;895;2734;1342;4073
500620;202001;7283;19498;4853;14797;1080;3487;1644;4938;2724;8425
500625;202001;488;1338;281;879;51;169;93;253;144;422
500627;202001;721;1890;432;1357;63;210;147;463;210;673
500630;202001;6337;14813;3602;10183;716;2235;1043;2996;1759;5231
500635;202001;2868;9080;2213;8208;169;702;1543;6188;1712;6890
500640;202001;1688;3722;1099;2925;39;129;744;1942;783;2071
500660;202001;16948;44761;11570;36632;3687;13184;2765;9048;6452;22232
500690;202001;2227;6186;1474;4940;551;2140;90;203;641;2343
500710;202001;2860;7802;2180;6589;632;2021;644;1851;1276;3872
500720;202001;4843;12315;3088;9386;701;2281;877;2711;1578;4992
500730;202001;932;2359;552;1670;65;181;192;600;257;781
500740;202001;4521;10832;3070;8487;392;1136;1597;4453;1989;5589
500750;202001;936;2410;612;1806;91;270;225;596;316;866
500755;202001;849;2250;459;1497;86;308;85;247;171;555
500769;202001;4799;11874;2541;7555;488;1655;383;883;871;2538
500770;202001;1443;3933;924;3001;170;627;303;974;473;1601
500780;202001;1237;3050;799;2309;163;514;211;580;374;1094
500790;202001;7362;19532;5707;16759;1132;3598;2834;8392;3966;11990
500793;202001;1941;4992;1336;3931;366;1164;377;1014;743;2178
500795;202001;2546;6531;2085;5934;92;264;1772;5159;1864;5423
500797;202001;671;1709;440;1286;124;380;148;439;272;819
500800;202001;2984;6874;1851;5204;575;1894;220;687;795;2581
500830;202001;17397;44171;11673;33581;2362;7392;4296;11599;6658;18991
500840;202001;1367;3354;791;2257;89;263;317;858;406;1121
510010;202001;1830;4127;1182;3268;107;297;816;2291;923;2588
510020;202001;3476;8890;1827;5587;370;1219;389;1056;759;2275
510025;202001;6723;16684;4085;12236;612;2056;1595;4620;2207;6676
510030;202001;2316;5249;1508;4062;331;904;532;1444;863;2348
510035;202001;1187;3103;734;2368;76;271;439;1497;515;1768
510040;202001;2216;5006;1598;4198;153;402;1006;2733;1159;3135
510050;202001;2024;4367;1312;3412;151;448;885;2242;1036;2690
510060;202001;1368;3471;982;2845;201;650;287;774;488;1424
510080;202001;1210;3197;778;2466;253;840;212;580;465;1420
510100;202001;650;1541;440;1205;52;146;227;603;279;749
510120;202001;251;474;137;342;3;12;105;267;108;279
510125;202001;2087;5166;1625;4501;176;649;823;2125;999;2774
510130;202001;1430;3612;992;2908;213;688;298;880;511;1568
510140;202001;2977;7810;2015;6586;731;2802;672;2032;1403;4834
510160;202001;1670;4349;1210;3745;168;502;848;2688;1016;3190
510170;202001;4455;11832;3233;9849;780;2483;1261;3960;2041;6443
510180;202001;13795;31611;8335;23375;1842;5674;2310;7504;4152;13178
510185;202001;1685;4423;1106;3584;441;1438;285;1196;726;2634
510190;202001;1977;5737;1304;4565;357;1390;218;825;575;2215
510250;202001;15762;40519;12009;35043;2241;6867;6278;19123;8519;25990
510260;202001;1980;8211;1605;7525;270;1375;940;4841;1210;6216
510263;202001;3081;8600;1860;6117;308;1141;217;637;525;1778
510267;202001;4656;13419;2691;9020;531;1895;309;983;840;2878
510268;202001;1266;3105;953;2619;117;308;608;1664;725;1972
510269;202001;994;2723;619;2017;157;558;184;554;341;1112
510270;202001;2829;8148;1932;6501;352;1315;760;2496;1112;3811
510279;202001;1749;4559;1108;3445;222;769;455;1354;677;2123
510285;202001;1054;2792;737;2267;231;791;151;413;382;1204
510300;202001;3651;9270;2669;7938;400;1235;1531;4778;1931;6013
510305;202001;1445;4012;862;2862;183;645;193;730;376;1375
510310;202001;912;2278;612;1763;178;549;166;497;344;1046
510320;202001;3589;9116;2459;7127;549;1739;624;1830;1173;3569
510325;202001;4332;12840;3248;10876;925;3272;999;3473;1924;6745
510330;202001;2733;8285;1821;6650;351;1305;660;2750;1011;4055
510335;202001;4653;13378;3461;11509;530;1901;1908;6557;2438;8458
510336;202001;464;1310;340;1113;60;195;153;547;213;742
510337;202001;1548;4616;1027;3661;398;1558;185;671;583;2229
510340;202001;90494;201585;55091;149679;13283;43023;15203;38410;28486;81433
510343;202001;1028;2835;696;2202;129;456;289;865;418;1321
510345;202001;1228;3489;917;2891;165;529;402;1226;567;1755
510350;202001;2782;7299;1778;5590;379;1260;664;2095;1043;3355
510360;202001;1863;3876;1186;3081;72;143;819;2306;891;2449
510370;202001;1708;4998;1233;4155;171;654;706;2447;877;3101
510380;202001;543;1374;288;912;53;195;101;314;154;509
510385;202001;1219;4124;885;3477;94;432;544;2219;638;2651
510390;202001;1157;3204;779;2685;239;803;300;1147;539;1950
510395;202001;725;1629;472;1257;28;74;278;798;306;872
510410;202001;4644;12996;3373;10710;635;2099;1764;5801;2399;7900
510420;202001;2287;4913;1544;3916;121;356;996;2519;1117;2875
510450;202001;480;1184;274;799;68;196;41;140;109;336
510452;202001;701;1970;479;1545;61;214;251;787;312;1001
510454;202001;893;2500;679;2135;68;192;427;1426;495;1618
510455;202001;874;2469;623;1957;97;354;242;692;339;1046
510460;202001;1768;4360;1234;3564;94;327;784;2165;878;2492
510480;202001;4616;11267;2978;8202;577;1773;1136;3013;1713;4786
510490;202001;1676;4391;1222;3795;195;624;742;2332;937;2956
510500;202001;1531;3839;919;2838;165;535;307;959;472;1494
510510;202001;3337;9861;2452;8240;638;2393;729;2586;1367;4979
510515;202001;5286;13810;3365;10249;812;2723;777;2124;1589;4847
510517;202001;1019;2986;773;2558;239;890;137;387;376;1277
510520;202001;2100;4246;1176;3110;82;227;603;1715;685;1942
510523;202001;1015;2628;733;2148;157;445;393;1185;550;1630
510525;202001;6521;18087;4827;14755;785;2691;2176;6288;2961;8979
510530;202001;537;1375;388;1160;31;99;235;688;266;787
510550;202001;2399;7087;1700;5851;409;1473;703;2456;1112;3929
510558;202001;2136;5773;1544;4847;217;647;684;2343;901;2990
510560;202001;1639;4700;963;3345;194;763;242;904;436;1667
510562;202001;5197;13827;3646;10941;905;2975;1192;3718;2097;6693
510590;202001;3099;7697;2207;6562;179;582;1551;4679;1730;5261
510600;202001;1438;3267;911;2478;176;494;380;1038;556;1532
510610;202001;2771;6725;1875;5512;181;606;1136;3370;1317;3976
510615;202001;2478;6335;1658;4988;296;903;818;2566;1114;3469
510617;202001;945;2854;714;2476;102;407;434;1572;536;1979
510618;202001;1216;3247;822;2547;175;619;383;1149;558;1768
510619;202001;744;1900;471;1429;71;240;111;311;182;551
510620;202001;1357;3059;640;1932;164;615;41;87;205;702
510621;202001;1456;3915;879;2823;185;668;261;795;446;1463
510622;202001;4423;12544;3033;9522;1041;3511;419;1192;1460;4703
510623;202001;2615;6558;1794;5255;413;1473;501;1400;914;2873
510624;202001;1631;4122;738;2457;89;326;159;474;248;800
510625;202001;2805;6869;1493;4500;257;918;332;1008;589;1926
510626;202001;1479;3581;911;2676;256;867;207;606;463;1473
510627;202001;590;1535;333;1027;86;293;78;252;164;545
510628;202001;1503;3440;976;2738;198;596;368;1028;566;1624
510629;202001;1561;4496;1161;3762;237;836;409;1310;646;2146
510630;202001;3176;8951;1852;6388;423;1565;309;1158;732;2723
510631;202001;571;1377;404;1128;13;39;305;876;318;915
510637;202001;3288;8011;2338;6595;597;1884;649;1831;1246;3715
510642;202001;5304;15421;4082;13554;1048;3761;1658;5680;2706;9441
510645;202001;812;1718;481;1286;108;307;210;523;318;830
510650;202001;6988;18043;5547;16458;633;1706;3803;12397;4436;14103
510665;202001;1788;3962;1056;2784;138;394;450;1222;588;1616
510670;202001;420;906;240;644;24;66;135;371;159;437
510675;202001;5757;16043;3855;12431;1141;4080;567;1770;1708;5850
510677;202001;2054;5342;1405;4358;211;742;707;2158;918;2900
510680;202001;676;1772;374;1185;74;259;74;214;148;473
510682;202001;1560;4627;1133;3896;366;1401;243;811;609;2212
510685;202001;556;1615;397;1277;57;202;194;618;251;820
510700;202001;3952;9647;2744;7917;291;950;1932;5531;2223;6481
510704;202001;10529;24815;6817;18441;1425;4181;1796;4697;3221;8878
510706;202001;1948;5823;1377;4910;252;932;714;2767;966;3699
510710;202001;2567;6538;1653;4797;356;1093;554;1535;910;2628
510715;202001;573;1283;417;1073;40;114;196;510;236;624
510718;202001;2364;5301;1365;3980;430;1265;399;1477;829;2742
510719;202001;415;874;241;645;27;70;138;354;165;424
510720;202001;912;2158;580;1647;109;354;256;678;365;1032
510724;202001;752;2047;505;1594;79;276;247;747;326;1023
510726;202001;1094;1986;581;1360;59;157;288;679;347;836
510729;202001;594;1403;258;774;37;129;56;180;93;309
510730;202001;2886;7051;1936;5538;277;894;910;2545;1187;3439
510735;202001;1011;2942;766;2595;77;308;548;1853;625;2161
510740;202001;865;2126;539;1514;86;244;248;695;334;939
510757;202001;532;1690;423;1510;143;571;145;484;288;1055
510760;202001;41962;93134;24547;66061;5123;15921;7262;17990;12385;33911
510770;202001;4255;9636;2899;7953;257;675;1928;5578;2185;6253
510774;202001;342;899;232;710;38;118;109;337;147;455
510775;202001;607;1636;390;1272;88;314;78;238;166;552
510776;202001;438;1102;307;853;76;214;99;294;175;508
510777;202001;1530;4092;1087;3515;141;529;702;2240;843;2769
510779;202001;630;1681;478;1445;50;149;281;895;331;1044
510780;202001;3655;9433;2651;8000;595;1788;1178;3993;1773;5781
510785;202001;2000;5330;1140;3727;291;1019;179;663;470;1682
510787;202001;2549;7255;1683;5413;569;1942;191;606;760;2548
510788;202001;619;1468;427;1170;62;176;187;592;249;768
510790;202001;16848;44005;9988;30957;2085;7308;1471;4015;3556;11323
510792;202001;8555;23227;5189;16702;1048;3806;885;2554;1933;6360
510794;202001;1198;3231;798;2533;250;896;152;411;402;1307
510795;202001;7944;21155;5099;15917;1164;4044;1286;3937;2450;7981
510800;202001;1679;4375;1093;3384;381;1186;124;379;505;1565
510805;202001;1511;4187;1003;3209;219;772;295;819;514;1591
510810;202001;642;1324;404;999;110;285;162;402;272;687
510820;202001;762;1472;413;1026;26;81;216;545;242;626
510830;202001;837;2049;593;1726;53;146;406;1261;459;1407
510835;202001;555;1353;360;1067;44;144;199;574;243;718
510840;202001;50739;109541;34746;89949;6546;16106;17479;49874;24025;65980
510850;202001;1792;4293;1009;3045;330;1146;95;227;425;1373
510860;202001;2332;6227;1458;4740;450;1700;128;408;578;2108
510880;202001;681;1956;509;1622;127;427;186;603;313;1030
510885;202001;537;1310;366;1071;67;223;121;344;188;567
510890;202001;630;1840;474;1583;101;369;213;701;314;1070
510895;202001;1233;3197;803;2487;171;637;322;917;493;1554
520005;202001;2402;6262;1839;5574;532;1626;797;2704;1329;4330
520010;202001;2195;6386;1566;5138;378;1400;439;1257;817;2657
520013;202001;2744;7121;1813;5404;393;1187;502;1652;895;2839
520015;202001;512;1296;362;1076;80;250;133;414;213;664
520017;202001;1104;2873;819;2430;101;325;531;1546;632;1871
520020;202001;391;905;294;782;28;98;211;538;239;636
520025;202001;33132;92949;28413;86353;2830;9415;20264;61291;23094;70706
520030;202001;5490;14159;4338;12553;333;1076;3013;8653;3346;9729
520050;202001;414;969;260;705;12;33;154;433;166;466
520055;202001;1649;4045;1097;3002;79;209;609;1614;688;1823
520060;202001;1450;4049;1053;3299;277;954;246;773;523;1727
520080;202001;1844;4732;1363;4085;244;748;640;2109;884;2857
520082;202001;889;2279;696;1955;79;211;363;1072;442;1283
520085;202001;809;2170;618;1855;110;345;289;828;399;1173
520090;202001;836;1639;568;1343;57;95;431;1069;488;1164
520110;202001;38581;104273;26724;84567;8148;29476;2176;6276;10324;35752
520120;202001;200;479;111;332;14;49;40;117;54;166
520130;202001;3606;8901;2800;7643;534;1493;1199;3332;1733;4825
520140;202001;40253;108594;28032;87457;9970;33781;3551;11445;13521;45226
520145;202001;563;1333;384;1072;62;194;211;547;273;741
520150;202001;617;1406;446;1185;82;214;239;653;321;867
520160;202001;778;1800;558;1461;104;252;253;703;357;955
520170;202001;5087;10277;3354;8285;191;522;2527;6155;2718;6677
520180;202001;2115;5842;1726;5269;325;1105;925;2788;1250;3893
520215;202001;1756;4253;1236;3435;302;910;431;1144;733;2054
520235;202001;597;1382;341;976;37;131;131;357;168;488
520250;202001;1482;3819;1067;3171;339;1094;239;749;578;1843
520260;202001;819;1911;502;1384;97;268;204;577;301;845
520280;202001;690;1714;519;1451;101;281;246;731;347;1012
520310;202001;1108;2420;707;1825;161;480;258;696;419;1176
520320;202001;1634;4419;1239;3787;150;520;664;1984;814;2504
520330;202001;3840;10443;2746;8622;416;1588;1377;4213;1793;5801
520340;202001;2354;5243;1465;4003;171;430;858;2467;1029;2897
520350;202001;2824;6783;2010;5544;596;1718;744;2076;1340;3794
520355;202001;1796;4934;1275;3893;369;1219;352;983;721;2202
520357;202001;756;1795;538;1472;36;91;391;1105;427;1196
520360;202001;688;1806;513;1500;146;451;133;418;279;869
520380;202001;1401;3483;816;2381;89;284;399;1091;488;1375
520390;202001;1016;2237;587;1702;171;543;184;574;355;1117
520393;202001;520;1239;344;959;43;143;159;404;202;547
520396;202001;806;2114;666;1890;44;142;472;1296;516;1438
520400;202001;1590;3951;1202;3415;162;496;778;2232;940;2728
520410;202001;1915;4273;1138;3109;176;533;468;1239;644;1772
520420;202001;358;818;274;684;26;69;206;488;232;557
520425;202001;1413;3412;827;2375;213;635;205;568;418;1203
520430;202001;2248;5160;1249;3618;227;790;57;146;284;936
520440;202001;2986;7220;1782;5083;432;1360;451;1233;883;2593
520450;202001;12027;28878;7821;22378;2431;7598;1301;3840;3732;11438
520455;202001;667;1826;475;1525;126;441;135;441;261;882
520460;202001;988;2335;763;2045;84;196;594;1633;678;1829
520465;202001;766;1977;611;1761;92;296;401;1111;493;1407
520470;202001;2086;5437;1603;4798;417;1246;709;2307;1126;3553
520480;202001;903;2505;619;2024;192;627;135;496;327;1123
520485;202001;1558;4352;1289;3976;180;568;895;2741;1075;3309
520490;202001;3983;10927;2931;9277;984;3223;1051;3479;2035;6702
520495;202001;1555;3396;1162;2873;50;130;920;2281;970;2411
520500;202001;1290;3432;865;2622;201;659;339;1035;540;1694
520505;202001;723;1632;492;1329;65;186;296;797;361;983
520510;202001;7727;19354;5084;15202;1157;3876;1355;4372;2512;8248
520520;202001;1131;2902;828;2416;196;603;273;813;469;1416
520530;202001;1953;5759;1448;4898;444;1577;459;1699;903;3276
520540;202001;2841;7539;1718;5288;319;1066;376;1104;695;2170
520545;202001;947;2489;712;2102;149;434;273;827;422;1261
520547;202001;800;2173;633;1894;155;470;301;900;456;1370
520549;202001;12929;35044;10557;31480;1520;4804;6827;20305;8347;25109
520551;202001;4421;12016;3675;10927;403;1408;2581;7487;2984;8895
520552;202001;845;2181;690;1983;139;386;397;1214;536;1600
520570;202001;548;1219;359;950;90;214;134;401;224;615
520580;202001;2140;5013;1625;4385;114;370;1167;3102;1281;3472
520590;202001;1156;2974;794;2363;239;725;197;599;436;1324
520620;202001;8119;22005;6321;19361;1588;5023;2782;8784;4370;13807
520630;202001;704;1812;449;1363;82;250;88;270;170;520
520640;202001;2393;5921;1814;4934;434;1166;729;2054;1163;3220
520650;202001;858;2022;604;1651;97;263;306;889;403;1152
520660;202001;520;1246;265;794;53;184;61;173;114;357
520670;202001;909;2537;768;2337;77;247;488;1445;565;1692
520680;202001;691;1728;506;1440;86;233;248;727;334;960
520690;202001;342;806;231;645;68;176;66;208;134;384
520710;202001;402;967;276;748;9;21;194;515;203;536
520725;202001;1559;3671;1060;2854;125;386;650;1678;775;2064
520735;202001;730;1799;475;1376;106;293;167;526;273;819
520740;202001;2069;4687;1543;4064;264;645;848;2407;1112;3052
520750;202001;663;1603;462;1279;76;204;226;639;302;843
520753;202001;1310;3490;989;2881;189;581;388;1068;577;1649
520760;202001;1180;2633;1035;2453;33;62;932;2249;965;2311
520780;202001;1479;3456;1043;2859;108;318;508;1341;616;1659
520790;202001;3367;7955;2340;6310;295;793;1277;3652;1572;4445
520800;202001;15927;41380;12307;36059;1988;6021;7031;21279;9019;27300
520810;202001;1271;2699;917;2290;152;406;563;1482;715;1888
520815;202001;585;1744;419;1409;74;271;110;387;184;658
520830;202001;1835;3915;1275;3282;46;125;1034;2623;1080;2748
520840;202001;2515;6776;2023;6133;857;2802;528;1721;1385;4523
520850;202001;667;1714;472;1423;162;559;103;333;265;892
520860;202001;6415;17285;4651;14430;1179;3921;1694;5217;2873;9138
520870;202001;101646;237244;67623;186401;15397;46097;22496;60995;37893;107092
520880;202001;6614;18924;5086;16222;1183;3940;1838;5905;3021;9845
520890;202001;3899;9511;2644;7522;550;1692;1069;3080;1619;4772
520910;202001;4570;11575;2876;8599;699;2288;626;1845;1325;4133
520915;202001;684;1890;396;1239;65;219;130;395;195;614
520920;202001;4393;9920;3021;8157;373;1035;1676;4670;2049;5705
520929;202001;684;1593;485;1292;87;210;221;641;308;851
520940;202001;969;2566;747;2255;49;160;540;1602;589;1762
520945;202001;479;1083;385;947;22;48;273;658;295;706
520960;202001;1013;2516;781;2135;138;353;462;1269;600;1622
520970;202001;2471;6829;1926;5941;487;1680;492;1608;979;3288
520980;202001;780;1897;561;1591;107;331;224;605;331;936
520990;202001;2972;8007;2373;7229;335;1007;1517;4710;1852;5717
520993;202001;1067;2511;716;1964;95;301;403;1055;498;1356
520995;202001;2230;5693;1677;4935;273;805;668;2032;941;2837
521000;202001;8627;22627;5712;17347;1173;3718;1668;5035;2841;8753
521010;202001;3670;9478;2709;7832;272;796;1542;4412;1814;5208
521015;202001;775;1914;528;1483;38;120;329;879;367;999
521020;202001;3144;8114;1835;5548;529;1759;140;441;669;2200
521030;202001;508;1092;332;829;60;128;137;387;197;515
521040;202001;7638;18575;5595;15408;1177;3401;2327;6541;3504;9942
521056;202001;897;2377;696;2072;221;651;197;657;418;1308
521060;202001;957;2525;705;2068;49;143;366;1087;415;1230
521080;202001;1108;2415;555;1528;74;227;232;550;306;777
521090;202001;3249;8751;2190;6655;618;2005;266;854;884;2859
521100;202001;1766;4089;1233;3341;198;532;702;1927;900;2459
521120;202001;4695;10954;3332;9274;213;539;1636;5267;1849;5806
521130;202001;951;2139;555;1484;19;55;296;841;315;896
521140;202001;1235;3169;875;2532;115;351;414;1201;529;1552
521150;202001;12491;27264;7632;20386;1306;4079;3506;9500;4812;13579
521160;202001;632;1314;441;1034;46;106;287;655;333;761
521170;202001;1027;2407;736;1967;60;173;498;1299;558;1472
521180;202001;7058;19643;5770;17395;955;3139;2939;8593;3894;11732
521190;202001;10455;26345;5955;18620;1467;4908;1169;3916;2636;8824
521200;202001;726;1796;494;1400;51;144;266;760;317;904
521205;202001;613;1517;458;1267;16;50;338;899;354;949
521210;202001;713;1815;406;1199;92;288;69;164;161;452
521220;202001;3724;9157;2392;7025;467;1554;777;2201;1244;3755
521225;202001;353;772;255;664;39;107;151;388;190;495
521230;202001;1289;3343;1147;3169;385;1074;568;1665;953;2739
521250;202001;30115;81512;23296;71431;8578;27715;6690;21873;15268;49588
521260;202001;568;1331;411;1083;56;151;228;590;284;741
521270;202001;1786;4531;1533;4228;87;222;1154;3208;1241;3430
521280;202001;1821;4884;1350;4097;328;1095;527;1625;855;2720
521290;202001;468;1113;319;915;46;156;187;524;233;680
521295;202001;1090;2349;835;2072;57;118;668;1734;725;1852
521300;202001;1870;4630;1456;4055;273;713;892;2565;1165;3278
521305;202001;697;1684;485;1363;58;150;276;783;334;933
521308;202001;4706;12603;3278;9883;314;953;1865;5531;2179;6484
521310;202001;8359;21392;5674;16816;1225;3969;2241;6376;3466;10345
521340;202001;412;967;296;795;21;60;204;531;225;591
521350;202001;2037;5205;1536;4451;143;505;1063;2947;1206;3452
521370;202001;1238;3165;736;2296;202;737;94;314;296;1051
521375;202001;1328;3273;894;2637;202;585;272;891;474;1476
521377;202001;1485;3155;1050;2620;76;139;855;2231;931;2370
521380;202001;6162;16422;4001;12406;415;1415;1012;3340;1427;4755
521385;202001;640;1545;486;1348;62;162;274;823;336;985
521390;202001;702;1723;489;1397;140;448;175;520;315;968
521400;202001;2569;5932;1963;5196;220;582;1364;3694;1584;4276
521405;202001;1286;3287;943;2712;184;534;440;1261;624;1795
521410;202001;784;2094;588;1759;107;299;298;955;405;1254
521440;202001;1216;3082;854;2522;280;905;240;712;520;1617
521450;202001;3868;11568;2824;9497;726;2502;734;2577;1460;5079
521460;202001;5719;15140;4000;12073;1376;4342;875;2693;2251;7035
521470;202001;655;1766;387;1205;47;143;127;388;174;531
521480;202001;351;872;203;591;39;117;61;169;100;286
521483;202001;2430;5795;1679;4632;360;1055;630;1702;990;2757
521486;202001;1755;4128;1289;3468;74;204;937;2514;1011;2718
521487;202001;419;1011;290;832;51;159;137;400;188;559
521490;202001;893;2396;655;2004;37;139;462;1379;499;1518
521500;202001;2150;5341;1562;4403;104;365;1090;2985;1194;3350
521520;202001;740;1705;520;1383;79;223;211;565;290;788
521523;202001;11336;35291;9340;32016;2542;9521;2474;8781;5016;18302
521525;202001;1046;2389;767;2002;76;206;534;1386;610;1592
521530;202001;2273;5899;1309;3917;271;855;318;974;589;1829
521540;202001;825;2077;542;1609;74;259;242;754;316;1013
521550;202001;1509;3777;822;2410;147;491;213;646;360;1137
521560;202001;4464;11824;3052;9906;488;1853;1521;5170;2009;7023
521565;202001;627;1516;478;1309;74;186;292;792;366;978
521570;202001;3540;9535;2317;7194;442;1600;238;784;680;2384
521580;202001;500;1219;279;843;37;122;77;203;114;325
521590;202001;639;1512;470;1273;89;265;256;681;345;946
521600;202001;384;1048;240;749;42;109;90;288;132;397
521630;202001;1675;3677;1005;2682;201;576;341;872;542;1448
521640;202001;1798;4215;1212;3369;269;803;394;1060;663;1863
521645;202001;552;1444;351;1082;81;224;116;365;197;589
521680;202001;1104;3362;849;2856;239;879;117;418;356;1297
521690;202001;523;1318;442;1201;62;179;268;716;330;895
521710;202001;3216;8015;2012;6021;361;1226;469;1319;830;2545
521720;202001;2200;5126;1429;3949;160;492;803;2210;963;2702
521730;202001;3577;10126;2723;8615;771;2810;671;1784;1442;4594
521740;202001;3898;10197;2902;8744;719;2361;1069;3344;1788;5705
521760;202001;14896;41023;11505;35759;2982;10243;4142;13416;7124;23659
521770;202001;2935;7099;1932;5434;592;1805;466;1310;1058;3115
521800;202001;6248;16904;4506;13975;1056;3370;1662;5623;2718;8993
521805;202001;505;1202;366;1004;118;314;147;413;265;727
521810;202001;635;1488;435;1211;63;175;239;683;302;858
521830;202001;5383;14971;4277;13294;301;1152;3037;9241;3338;10393
521839;202001;684;1685;485;1347;82;256;244;605;326;861
521850;202001;5460;12869;3373;9692;566;1831;407;1099;973;2930
521860;202001;1625;4268;1111;3368;191;636;342;1013;533;1649
521870;202001;681;1894;477;1498;97;345;118;325;215;670
521878;202001;651;1681;464;1334;65;221;236;619;301;840
521880;202001;18497;44782;12271;35271;3087;9444;4093;12051;7180;21495
521890;202001;3035;7907;1982;6021;553;1815;346;945;899;2760
521900;202001;1556;3667;901;2667;290;837;124;387;414;1224
521910;202001;1236;2629;815;2127;76;200;439;1247;515;1447
521920;202001;443;1247;326;1037;61;224;139;422;200;646
521925;202001;746;1965;548;1670;91;286;284;854;375;1140
521930;202001;5323;12861;3470;10015;898;2466;1289;4099;2187;6565
521935;202001;981;2355;662;1784;65;185;380;966;445;1151
521940;202001;1263;2826;824;2229;190;575;324;855;514;1430
521945;202001;537;1483;418;1274;99;304;211;663;310;967
521950;202001;744;1811;525;1473;130;388;227;592;357;980
521960;202001;711;1859;456;1371;52;175;239;670;291;845
521970;202001;2559;6247;2016;5602;159;442;1536;4318;1695;4760
521971;202001;742;1748;508;1405;132;356;146;416;278;772
521973;202001;1264;3294;969;2846;43;157;686;1968;729;2125
521975;202001;11870;31283;9712;28291;1503;4650;6071;17706;7574;22356
521980;202001;2541;5942;1934;5132;150;372;1430;3895;1580;4267
521990;202001;1071;3001;841;2598;170;544;325;1005;495;1549
522000;202001;2483;6718;1992;6084;249;748;1315;4149;1564;4897
522005;202001;333;805;249;681;51;134;118;335;169;469
522010;202001;3918;9593;2737;7684;646;1962;919;2520;1565;4482
522015;202001;972;2518;693;2085;184;542;265;826;449;1368
522020;202001;5347;12780;3509;9871;723;2149;1384;3982;2107;6131
522026;202001;672;1884;480;1513;84;282;162;497;246;779
522028;202001;433;1122;316;913;57;172;133;370;190;542
522040;202001;3087;7010;2163;5765;271;774;1422;3733;1693;4507
522045;202001;17392;48598;12728;40170;2987;10168;3365;10347;6352;20515
522050;202001;962;2531;648;2017;172;597;217;626;389;1223
522060;202001;2870;7568;1980;6071;176;552;1113;3533;1289;4085
522068;202001;1813;4680;1409;4189;143;382;1049;3194;1192;3576
522070;202001;609;1514;489;1327;21;68;406;1078;427;1146
522100;202001;711;1840;479;1466;60;204;246;733;306;937
522108;202001;956;2506;739;2188;58;240;577;1629;635;1869
522119;202001;1498;3782;1136;3305;177;542;600;1816;777;2358
522130;202001;383;947;262;778;38;113;152;484;190;597
522140;202001;17308;46126;12053;36783;3116;10207;3086;9026;6202;19233
522145;202001;801;1957;540;1565;143;408;207;610;350;1018
522150;202001;1052;2587;734;2060;197;545;214;639;411;1184
522155;202001;1046;2611;776;2179;135;361;433;1242;568;1603
522157;202001;554;1354;459;1231;24;82;350;945;374;1027
522160;202001;6092;15790;3905;11755;1044;3412;295;969;1339;4381
522170;202001;2693;6891;1982;5823;312;959;1081;3213;1393;4172
522180;202001;442;1052;289;789;63;187;33;108;96;295
522185;202001;17769;44324;12688;37313;5021;16051;2766;8844;7787;24895
522190;202001;768;1860;526;1439;100;279;190;509;290;788
522200;202001;1668;4746;1085;3600;219;790;163;489;382;1279
522205;202001;1628;3794;1230;3261;119;347;856;2255;975;2602
522220;202001;1291;3231;950;2703;147;431;499;1466;646;1897
522230;202001;1134;2926;915;2614;205;715;455;1216;660;1931
530010;202001;171969;464680;138599;414256;22028;72044;77947;229387;99975;301431
